profile,name,surname,birth_date,dni,email,password,iban,assets,timestamp,city,type,category,amount,balance
buyer_1,Aitor,López,1996-08-10,17033061C,aitor.lópez@awesomecode.net,185417,ES44209556455181134018,3547.89,2022-01-01T18:52:16,Bilbao,incomes,salary,2495.84,6043.73
buyer_1,Aitor,López,1996-08-10,17033061C,aitor.lópez@awesomecode.net,185417,ES44209556455181134018,3547.89,2022-01-01T09:45:07,Bilbao,expenses,cash,-100.0,5943.73
buyer_1,Aitor,López,1996-08-10,17033061C,aitor.lópez@awesomecode.net,185417,ES44209556455181134018,3547.89,2022-01-02T12:56:04,Bilbao,expenses,leisure,-46.96,5896.77
buyer_1,Aitor,López,1996-08-10,17033061C,aitor.lópez@awesomecode.net,185417,ES44209556455181134018,3547.89,2022-01-02T12:10:17,Bilbao,expenses,healthcare,-52.69,5844.08
buyer_1,Aitor,López,1996-08-10,17033061C,aitor.lópez@awesomecode.net,185417,ES44209556455181134018,3547.89,2022-01-02T17:31:06,Bilbao,expenses,education,-74.42,5769.66
buyer_1,Aitor,López,1996-08-10,17033061C,aitor.lópez@awesomecode.net,185417,ES44209556455181134018,3547.89,2022-01-02T08:50:25,Bilbao,expenses,repairs,-93.14,5676.52
buyer_1,Aitor,López,1996-08-10,17033061C,aitor.lópez@awesomecode.net,185417,ES44209556455181134018,3547.89,2022-01-03T14:43:05,Bilbao,expenses,food,-66.02,5610.5
buyer_1,Aitor,López,1996-08-10,17033061C,aitor.lópez@awesomecode.net,185417,ES44209556455181134018,3547.89,2022-01-03T03:50:43,Bilbao,expenses,leisure,-72.83,5537.67
buyer_1,Aitor,López,1996-08-10,17033061C,aitor.lópez@awesomecode.net,185417,ES44209556455181134018,3547.89,2022-01-03T22:21:59,Bilbao,expenses,repairs,-44.99,5492.68
buyer_1,Aitor,López,1996-08-10,17033061C,aitor.lópez@awesomecode.net,185417,ES44209556455181134018,3547.89,2022-01-05T20:38:57,Bilbao,expenses,rent,-865.66,4627.02
buyer_1,Aitor,López,1996-08-10,17033061C,aitor.lópez@awesomecode.net,185417,ES44209556455181134018,3547.89,2022-01-05T15:48:50,Bilbao,expenses,water,-49.17,4577.85
buyer_1,Aitor,López,1996-08-10,17033061C,aitor.lópez@awesomecode.net,185417,ES44209556455181134018,3547.89,2022-01-05T19:16:03,Bilbao,expenses,internet,-52.41,4525.44
buyer_1,Aitor,López,1996-08-10,17033061C,aitor.lópez@awesomecode.net,185417,ES44209556455181134018,3547.89,2022-01-06T07:51:55,Bilbao,expenses,electricity,-67.42,4458.02
buyer_1,Aitor,López,1996-08-10,17033061C,aitor.lópez@awesomecode.net,185417,ES44209556455181134018,3547.89,2022-01-06T14:00:51,Bilbao,expenses,gas,-69.68,4388.34
buyer_1,Aitor,López,1996-08-10,17033061C,aitor.lópez@awesomecode.net,185417,ES44209556455181134018,3547.89,2022-01-06T14:24:13,Bilbao,expenses,internet,-52.41,4335.93
buyer_1,Aitor,López,1996-08-10,17033061C,aitor.lópez@awesomecode.net,185417,ES44209556455181134018,3547.89,2022-01-07T08:37:43,Bilbao,expenses,gas,-72.03,4263.9
buyer_1,Aitor,López,1996-08-10,17033061C,aitor.lópez@awesomecode.net,185417,ES44209556455181134018,3547.89,2022-01-07T05:37:13,Bilbao,expenses,phone,-47.52,4216.38
buyer_1,Aitor,López,1996-08-10,17033061C,aitor.lópez@awesomecode.net,185417,ES44209556455181134018,3547.89,2022-01-08T12:50:50,Bilbao,expenses,gas,-118.55,4097.83
buyer_1,Aitor,López,1996-08-10,17033061C,aitor.lópez@awesomecode.net,185417,ES44209556455181134018,3547.89,2022-01-08T08:21:41,Bilbao,expenses,phone,-40.65,4057.18
buyer_1,Aitor,López,1996-08-10,17033061C,aitor.lópez@awesomecode.net,185417,ES44209556455181134018,3547.89,2022-01-08T13:56:22,Bilbao,expenses,food,-69.06,3988.12
buyer_1,Aitor,López,1996-08-10,17033061C,aitor.lópez@awesomecode.net,185417,ES44209556455181134018,3547.89,2022-01-08T20:14:23,Bilbao,expenses,transport,-60.01,3928.11
buyer_1,Aitor,López,1996-08-10,17033061C,aitor.lópez@awesomecode.net,185417,ES44209556455181134018,3547.89,2022-01-09T18:38:09,Bilbao,expenses,cash,-100.0,3828.11
buyer_1,Aitor,López,1996-08-10,17033061C,aitor.lópez@awesomecode.net,185417,ES44209556455181134018,3547.89,2022-01-14T18:16:09,Bilbao,expenses,education,-42.56,3785.55
buyer_1,Aitor,López,1996-08-10,17033061C,aitor.lópez@awesomecode.net,185417,ES44209556455181134018,3547.89,2022-01-15T21:37:50,Bilbao,expenses,gifts,-788.27,2997.28
buyer_1,Aitor,López,1996-08-10,17033061C,aitor.lópez@awesomecode.net,185417,ES44209556455181134018,3547.89,2022-01-16T02:11:12,Bilbao,expenses,cash,-100.0,2897.28
buyer_1,Aitor,López,1996-08-10,17033061C,aitor.lópez@awesomecode.net,185417,ES44209556455181134018,3547.89,2022-01-17T23:02:25,Bilbao,expenses,clothing,-99.09,2798.19
buyer_1,Aitor,López,1996-08-10,17033061C,aitor.lópez@awesomecode.net,185417,ES44209556455181134018,3547.89,2022-01-17T20:49:29,Bilbao,expenses,repairs,-203.32,2594.87
buyer_1,Aitor,López,1996-08-10,17033061C,aitor.lópez@awesomecode.net,185417,ES44209556455181134018,3547.89,2022-01-18T11:50:37,Bilbao,expenses,education,-73.11,2521.76
buyer_1,Aitor,López,1996-08-10,17033061C,aitor.lópez@awesomecode.net,185417,ES44209556455181134018,3547.89,2022-01-19T08:58:17,Bilbao,expenses,food,-100.25,2421.51
buyer_1,Aitor,López,1996-08-10,17033061C,aitor.lópez@awesomecode.net,185417,ES44209556455181134018,3547.89,2022-01-19T15:22:55,Bilbao,expenses,leisure,-40.04,2381.47
buyer_1,Aitor,López,1996-08-10,17033061C,aitor.lópez@awesomecode.net,185417,ES44209556455181134018,3547.89,2022-01-21T17:13:04,Bilbao,expenses,food,-109.69,2271.78
buyer_1,Aitor,López,1996-08-10,17033061C,aitor.lópez@awesomecode.net,185417,ES44209556455181134018,3547.89,2022-01-21T19:20:34,Bilbao,expenses,cash,-100.0,2171.78
buyer_1,Aitor,López,1996-08-10,17033061C,aitor.lópez@awesomecode.net,185417,ES44209556455181134018,3547.89,2022-01-22T10:53:15,Bilbao,expenses,leisure,-72.34,2099.44
buyer_1,Aitor,López,1996-08-10,17033061C,aitor.lópez@awesomecode.net,185417,ES44209556455181134018,3547.89,2022-01-23T12:12:53,Bilbao,expenses,transport,-48.11,2051.33
buyer_1,Aitor,López,1996-08-10,17033061C,aitor.lópez@awesomecode.net,185417,ES44209556455181134018,3547.89,2022-01-24T17:46:12,Bilbao,expenses,gifts,-493.6,1557.73
buyer_1,Aitor,López,1996-08-10,17033061C,aitor.lópez@awesomecode.net,185417,ES44209556455181134018,3547.89,2022-01-25T12:28:09,Bilbao,expenses,leisure,-67.7,1490.03
buyer_1,Aitor,López,1996-08-10,17033061C,aitor.lópez@awesomecode.net,185417,ES44209556455181134018,3547.89,2022-01-25T20:58:03,Bilbao,expenses,cash,-100.0,1390.03
buyer_1,Aitor,López,1996-08-10,17033061C,aitor.lópez@awesomecode.net,185417,ES44209556455181134018,3547.89,2022-01-27T20:39:29,Bilbao,expenses,education,-43.97,1346.06
buyer_1,Aitor,López,1996-08-10,17033061C,aitor.lópez@awesomecode.net,185417,ES44209556455181134018,3547.89,2022-01-29T14:04:50,Bilbao,expenses,travel,-614.55,731.51
buyer_1,Aitor,López,1996-08-10,17033061C,aitor.lópez@awesomecode.net,185417,ES44209556455181134018,3547.89,2022-01-29T10:46:32,Bilbao,expenses,repairs,-190.16,541.35
buyer_1,Aitor,López,1996-08-10,17033061C,aitor.lópez@awesomecode.net,185417,ES44209556455181134018,3547.89,2022-01-30T16:10:32,Bilbao,expenses,food,-105.81,435.54
buyer_1,Aitor,López,1996-08-10,17033061C,aitor.lópez@awesomecode.net,185417,ES44209556455181134018,3547.89,2022-01-30T10:48:08,Bilbao,expenses,transport,-48.6,386.94
buyer_1,Aitor,López,1996-08-10,17033061C,aitor.lópez@awesomecode.net,185417,ES44209556455181134018,3547.89,2022-01-30T15:18:04,Bilbao,expenses,repairs,-200.03,186.91
buyer_1,Aitor,López,1996-08-10,17033061C,aitor.lópez@awesomecode.net,185417,ES44209556455181134018,3547.89,2022-02-01T12:37:26,Bilbao,incomes,salary,2495.84,2682.75
buyer_1,Aitor,López,1996-08-10,17033061C,aitor.lópez@awesomecode.net,185417,ES44209556455181134018,3547.89,2022-02-01T08:20:56,Bilbao,expenses,gifts,-620.53,2062.22
buyer_1,Aitor,López,1996-08-10,17033061C,aitor.lópez@awesomecode.net,185417,ES44209556455181134018,3547.89,2022-02-02T16:42:53,Bilbao,expenses,food,-93.1,1969.12
buyer_1,Aitor,López,1996-08-10,17033061C,aitor.lópez@awesomecode.net,185417,ES44209556455181134018,3547.89,2022-02-04T17:10:07,Bilbao,expenses,gifts,-380.29,1588.83
buyer_1,Aitor,López,1996-08-10,17033061C,aitor.lópez@awesomecode.net,185417,ES44209556455181134018,3547.89,2022-02-05T09:02:22,Bilbao,expenses,rent,-865.66,723.17
buyer_1,Aitor,López,1996-08-10,17033061C,aitor.lópez@awesomecode.net,185417,ES44209556455181134018,3547.89,2022-02-05T09:40:43,Bilbao,expenses,food,-112.77,610.4
buyer_1,Aitor,López,1996-08-10,17033061C,aitor.lópez@awesomecode.net,185417,ES44209556455181134018,3547.89,2022-02-06T20:43:43,Bilbao,expenses,repairs,-139.08,471.32
buyer_1,Aitor,López,1996-08-10,17033061C,aitor.lópez@awesomecode.net,185417,ES44209556455181134018,3547.89,2022-02-07T16:52:25,Bilbao,expenses,water,-29.24,442.08
buyer_1,Aitor,López,1996-08-10,17033061C,aitor.lópez@awesomecode.net,185417,ES44209556455181134018,3547.89,2022-02-07T22:27:50,Bilbao,expenses,food,-115.08,327.0
buyer_1,Aitor,López,1996-08-10,17033061C,aitor.lópez@awesomecode.net,185417,ES44209556455181134018,3547.89,2022-02-07T18:46:13,Bilbao,expenses,education,-47.11,279.89
buyer_1,Aitor,López,1996-08-10,17033061C,aitor.lópez@awesomecode.net,185417,ES44209556455181134018,3547.89,2022-02-08T19:45:13,Bilbao,expenses,phone,-49.74,230.15
buyer_1,Aitor,López,1996-08-10,17033061C,aitor.lópez@awesomecode.net,185417,ES44209556455181134018,3547.89,2022-02-08T17:57:55,Bilbao,expenses,transport,-61.51,168.64
buyer_1,Aitor,López,1996-08-10,17033061C,aitor.lópez@awesomecode.net,185417,ES44209556455181134018,3547.89,2022-02-08T11:57:49,Bilbao,expenses,healthcare,-136.86,31.78
buyer_1,Aitor,López,1996-08-10,17033061C,aitor.lópez@awesomecode.net,185417,ES44209556455181134018,3547.89,2022-02-08T10:21:30,Bilbao,expenses,repairs,-312.81,-281.03
buyer_1,Aitor,López,1996-08-10,17033061C,aitor.lópez@awesomecode.net,185417,ES44209556455181134018,3547.89,2022-02-09T12:31:40,Bilbao,expenses,appliances,-187.73,-468.76
buyer_1,Aitor,López,1996-08-10,17033061C,aitor.lópez@awesomecode.net,185417,ES44209556455181134018,3547.89,2022-02-10T11:12:42,Bilbao,expenses,gifts,-282.38,-751.14
buyer_1,Aitor,López,1996-08-10,17033061C,aitor.lópez@awesomecode.net,185417,ES44209556455181134018,3547.89,2022-02-12T16:38:37,Bilbao,expenses,food,-75.3,-826.44
buyer_1,Aitor,López,1996-08-10,17033061C,aitor.lópez@awesomecode.net,185417,ES44209556455181134018,3547.89,2022-02-12T10:50:07,Bilbao,expenses,cash,-100.0,-926.44
buyer_1,Aitor,López,1996-08-10,17033061C,aitor.lópez@awesomecode.net,185417,ES44209556455181134018,3547.89,2022-02-13T11:02:11,Bilbao,expenses,food,-90.72,-1017.16
buyer_1,Aitor,López,1996-08-10,17033061C,aitor.lópez@awesomecode.net,185417,ES44209556455181134018,3547.89,2022-02-13T16:55:39,Bilbao,expenses,gifts,-544.95,-1562.11
buyer_1,Aitor,López,1996-08-10,17033061C,aitor.lópez@awesomecode.net,185417,ES44209556455181134018,3547.89,2022-02-14T07:38:29,Bilbao,expenses,leisure,-35.46,-1597.57
buyer_1,Aitor,López,1996-08-10,17033061C,aitor.lópez@awesomecode.net,185417,ES44209556455181134018,3547.89,2022-02-15T13:49:45,Bilbao,expenses,food,-82.34,-1679.91
buyer_1,Aitor,López,1996-08-10,17033061C,aitor.lópez@awesomecode.net,185417,ES44209556455181134018,3547.89,2022-02-15T08:23:46,Bilbao,expenses,cash,-100.0,-1779.91
buyer_1,Aitor,López,1996-08-10,17033061C,aitor.lópez@awesomecode.net,185417,ES44209556455181134018,3547.89,2022-02-16T23:35:19,Bilbao,expenses,repairs,-118.55,-1898.46
buyer_1,Aitor,López,1996-08-10,17033061C,aitor.lópez@awesomecode.net,185417,ES44209556455181134018,3547.89,2022-02-17T15:42:51,Bilbao,expenses,food,-116.54,-2015.0
buyer_1,Aitor,López,1996-08-10,17033061C,aitor.lópez@awesomecode.net,185417,ES44209556455181134018,3547.89,2022-02-17T09:22:29,Bilbao,expenses,cash,-100.0,-2115.0
buyer_1,Aitor,López,1996-08-10,17033061C,aitor.lópez@awesomecode.net,185417,ES44209556455181134018,3547.89,2022-02-19T18:09:28,Bilbao,expenses,transport,-70.92,-2185.92
buyer_1,Aitor,López,1996-08-10,17033061C,aitor.lópez@awesomecode.net,185417,ES44209556455181134018,3547.89,2022-02-20T09:22:37,Bilbao,expenses,healthcare,-102.01,-2287.93
buyer_1,Aitor,López,1996-08-10,17033061C,aitor.lópez@awesomecode.net,185417,ES44209556455181134018,3547.89,2022-02-20T14:53:01,Bilbao,expenses,cash,-100.0,-2387.93
buyer_1,Aitor,López,1996-08-10,17033061C,aitor.lópez@awesomecode.net,185417,ES44209556455181134018,3547.89,2022-02-21T10:43:43,Bilbao,expenses,cash,-100.0,-2487.93
buyer_1,Aitor,López,1996-08-10,17033061C,aitor.lópez@awesomecode.net,185417,ES44209556455181134018,3547.89,2022-02-22T09:18:36,Bilbao,expenses,clothing,-84.52,-2572.45
buyer_1,Aitor,López,1996-08-10,17033061C,aitor.lópez@awesomecode.net,185417,ES44209556455181134018,3547.89,2022-02-23T21:07:19,Bilbao,expenses,leisure,-33.7,-2606.15
buyer_1,Aitor,López,1996-08-10,17033061C,aitor.lópez@awesomecode.net,185417,ES44209556455181134018,3547.89,2022-02-23T14:06:02,Bilbao,expenses,repairs,-128.51,-2734.66
buyer_1,Aitor,López,1996-08-10,17033061C,aitor.lópez@awesomecode.net,185417,ES44209556455181134018,3547.89,2022-02-25T09:19:49,Bilbao,expenses,food,-98.65,-2833.31
buyer_1,Aitor,López,1996-08-10,17033061C,aitor.lópez@awesomecode.net,185417,ES44209556455181134018,3547.89,2022-02-25T08:57:57,Bilbao,expenses,cash,-100.0,-2933.31
buyer_1,Aitor,López,1996-08-10,17033061C,aitor.lópez@awesomecode.net,185417,ES44209556455181134018,3547.89,2022-02-26T04:36:36,Bilbao,expenses,repairs,-149.95,-3083.26
buyer_1,Aitor,López,1996-08-10,17033061C,aitor.lópez@awesomecode.net,185417,ES44209556455181134018,3547.89,2022-02-27T11:59:02,Bilbao,expenses,clothing,-126.79,-3210.05
buyer_1,Aitor,López,1996-08-10,17033061C,aitor.lópez@awesomecode.net,185417,ES44209556455181134018,3547.89,2022-02-28T10:11:55,Bilbao,expenses,leisure,-56.31,-3266.36
buyer_1,Aitor,López,1996-08-10,17033061C,aitor.lópez@awesomecode.net,185417,ES44209556455181134018,3547.89,2022-03-01T19:01:31,Bilbao,incomes,salary,2495.84,-770.52
buyer_1,Aitor,López,1996-08-10,17033061C,aitor.lópez@awesomecode.net,185417,ES44209556455181134018,3547.89,2022-03-01T19:01:31,Bilbao,incomes,extra_income,266.49,-504.03
buyer_1,Aitor,López,1996-08-10,17033061C,aitor.lópez@awesomecode.net,185417,ES44209556455181134018,3547.89,2022-03-02T09:06:18,Bilbao,expenses,cash,-100.0,-604.03
buyer_1,Aitor,López,1996-08-10,17033061C,aitor.lópez@awesomecode.net,185417,ES44209556455181134018,3547.89,2022-03-03T14:25:06,Bilbao,expenses,education,-46.84,-650.87
buyer_1,Aitor,López,1996-08-10,17033061C,aitor.lópez@awesomecode.net,185417,ES44209556455181134018,3547.89,2022-03-05T09:42:56,Bilbao,expenses,rent,-865.66,-1516.53
buyer_1,Aitor,López,1996-08-10,17033061C,aitor.lópez@awesomecode.net,185417,ES44209556455181134018,3547.89,2022-03-05T01:14:00,Bilbao,expenses,electricity,-43.81,-1560.34
buyer_1,Aitor,López,1996-08-10,17033061C,aitor.lópez@awesomecode.net,185417,ES44209556455181134018,3547.89,2022-03-05T13:44:37,Bilbao,expenses,phone,-52.46,-1612.8
buyer_1,Aitor,López,1996-08-10,17033061C,aitor.lópez@awesomecode.net,185417,ES44209556455181134018,3547.89,2022-03-05T12:44:06,Bilbao,expenses,transport,-84.58,-1697.38
buyer_1,Aitor,López,1996-08-10,17033061C,aitor.lópez@awesomecode.net,185417,ES44209556455181134018,3547.89,2022-03-05T21:18:09,Bilbao,expenses,repairs,-251.95,-1949.33
buyer_1,Aitor,López,1996-08-10,17033061C,aitor.lópez@awesomecode.net,185417,ES44209556455181134018,3547.89,2022-03-06T10:09:53,Bilbao,expenses,water,-53.23,-2002.56
buyer_1,Aitor,López,1996-08-10,17033061C,aitor.lópez@awesomecode.net,185417,ES44209556455181134018,3547.89,2022-03-07T13:19:44,Bilbao,expenses,water,-31.71,-2034.27
buyer_1,Aitor,López,1996-08-10,17033061C,aitor.lópez@awesomecode.net,185417,ES44209556455181134018,3547.89,2022-03-07T03:06:05,Bilbao,expenses,cash,-100.0,-2134.27
buyer_1,Aitor,López,1996-08-10,17033061C,aitor.lópez@awesomecode.net,185417,ES44209556455181134018,3547.89,2022-03-08T10:48:28,Bilbao,expenses,gas,-84.56,-2218.83
buyer_1,Aitor,López,1996-08-10,17033061C,aitor.lópez@awesomecode.net,185417,ES44209556455181134018,3547.89,2022-03-08T09:43:05,Bilbao,expenses,internet,-52.41,-2271.24
buyer_1,Aitor,López,1996-08-10,17033061C,aitor.lópez@awesomecode.net,185417,ES44209556455181134018,3547.89,2022-03-08T08:54:55,Bilbao,expenses,food,-96.74,-2367.98
buyer_1,Aitor,López,1996-08-10,17033061C,aitor.lópez@awesomecode.net,185417,ES44209556455181134018,3547.89,2022-03-12T16:30:30,Bilbao,expenses,food,-64.71,-2432.69
buyer_1,Aitor,López,1996-08-10,17033061C,aitor.lópez@awesomecode.net,185417,ES44209556455181134018,3547.89,2022-03-12T12:12:26,Bilbao,expenses,appliances,-95.76,-2528.45
buyer_1,Aitor,López,1996-08-10,17033061C,aitor.lópez@awesomecode.net,185417,ES44209556455181134018,3547.89,2022-03-13T08:02:08,Bilbao,expenses,gifts,-310.38,-2838.83
buyer_1,Aitor,López,1996-08-10,17033061C,aitor.lópez@awesomecode.net,185417,ES44209556455181134018,3547.89,2022-03-14T20:06:51,Bilbao,expenses,cash,-100.0,-2938.83
buyer_1,Aitor,López,1996-08-10,17033061C,aitor.lópez@awesomecode.net,185417,ES44209556455181134018,3547.89,2022-03-15T12:49:42,Bilbao,expenses,cash,-100.0,-3038.83
buyer_1,Aitor,López,1996-08-10,17033061C,aitor.lópez@awesomecode.net,185417,ES44209556455181134018,3547.89,2022-03-16T13:00:21,Bilbao,expenses,leisure,-20.4,-3059.23
buyer_1,Aitor,López,1996-08-10,17033061C,aitor.lópez@awesomecode.net,185417,ES44209556455181134018,3547.89,2022-03-16T15:21:06,Bilbao,expenses,education,-45.79,-3105.02
buyer_1,Aitor,López,1996-08-10,17033061C,aitor.lópez@awesomecode.net,185417,ES44209556455181134018,3547.89,2022-03-16T17:23:19,Bilbao,expenses,cash,-100.0,-3205.02
buyer_1,Aitor,López,1996-08-10,17033061C,aitor.lópez@awesomecode.net,185417,ES44209556455181134018,3547.89,2022-03-17T21:25:27,Bilbao,expenses,cash,-100.0,-3305.02
buyer_1,Aitor,López,1996-08-10,17033061C,aitor.lópez@awesomecode.net,185417,ES44209556455181134018,3547.89,2022-03-18T17:58:10,Bilbao,expenses,travel,-915.62,-4220.64
buyer_1,Aitor,López,1996-08-10,17033061C,aitor.lópez@awesomecode.net,185417,ES44209556455181134018,3547.89,2022-03-19T20:04:21,Bilbao,expenses,leisure,-67.49,-4288.13
buyer_1,Aitor,López,1996-08-10,17033061C,aitor.lópez@awesomecode.net,185417,ES44209556455181134018,3547.89,2022-03-20T16:21:13,Bilbao,expenses,healthcare,-116.38,-4404.51
buyer_1,Aitor,López,1996-08-10,17033061C,aitor.lópez@awesomecode.net,185417,ES44209556455181134018,3547.89,2022-03-22T16:31:59,Bilbao,expenses,leisure,-75.39,-4479.9
buyer_1,Aitor,López,1996-08-10,17033061C,aitor.lópez@awesomecode.net,185417,ES44209556455181134018,3547.89,2022-03-23T15:06:41,Bilbao,expenses,transport,-85.26,-4565.16
buyer_1,Aitor,López,1996-08-10,17033061C,aitor.lópez@awesomecode.net,185417,ES44209556455181134018,3547.89,2022-03-23T14:39:26,Bilbao,expenses,cash,-100.0,-4665.16
buyer_1,Aitor,López,1996-08-10,17033061C,aitor.lópez@awesomecode.net,185417,ES44209556455181134018,3547.89,2022-03-24T16:33:56,Bilbao,expenses,repairs,-31.3,-4696.46
buyer_1,Aitor,López,1996-08-10,17033061C,aitor.lópez@awesomecode.net,185417,ES44209556455181134018,3547.89,2022-03-25T11:25:07,Bilbao,expenses,leisure,-36.01,-4732.47
buyer_1,Aitor,López,1996-08-10,17033061C,aitor.lópez@awesomecode.net,185417,ES44209556455181134018,3547.89,2022-03-27T10:34:44,Bilbao,expenses,education,-57.73,-4790.2
buyer_1,Aitor,López,1996-08-10,17033061C,aitor.lópez@awesomecode.net,185417,ES44209556455181134018,3547.89,2022-03-28T20:58:37,Bilbao,expenses,leisure,-74.56,-4864.76
buyer_1,Aitor,López,1996-08-10,17033061C,aitor.lópez@awesomecode.net,185417,ES44209556455181134018,3547.89,2022-03-29T11:13:37,Bilbao,expenses,repairs,-46.84,-4911.6
buyer_1,Aitor,López,1996-08-10,17033061C,aitor.lópez@awesomecode.net,185417,ES44209556455181134018,3547.89,2022-03-30T17:51:08,Bilbao,expenses,cash,-100.0,-5011.6
buyer_1,Aitor,López,1996-08-10,17033061C,aitor.lópez@awesomecode.net,185417,ES44209556455181134018,3547.89,2022-03-30T13:44:06,Bilbao,expenses,travel,-712.04,-5723.64
buyer_1,Aitor,López,1996-08-10,17033061C,aitor.lópez@awesomecode.net,185417,ES44209556455181134018,3547.89,2022-03-31T03:26:11,Bilbao,expenses,food,-60.57,-5784.21
buyer_1,Aitor,López,1996-08-10,17033061C,aitor.lópez@awesomecode.net,185417,ES44209556455181134018,3547.89,2022-04-01T12:46:08,Bilbao,incomes,salary,2495.84,-3288.37
buyer_1,Aitor,López,1996-08-10,17033061C,aitor.lópez@awesomecode.net,185417,ES44209556455181134018,3547.89,2022-04-01T15:12:35,Bilbao,expenses,transport,-73.09,-3361.46
buyer_1,Aitor,López,1996-08-10,17033061C,aitor.lópez@awesomecode.net,185417,ES44209556455181134018,3547.89,2022-04-01T11:00:03,Bilbao,expenses,gifts,-375.69,-3737.15
buyer_1,Aitor,López,1996-08-10,17033061C,aitor.lópez@awesomecode.net,185417,ES44209556455181134018,3547.89,2022-04-02T11:37:43,Bilbao,expenses,food,-65.49,-3802.64
buyer_1,Aitor,López,1996-08-10,17033061C,aitor.lópez@awesomecode.net,185417,ES44209556455181134018,3547.89,2022-04-02T12:44:59,Bilbao,expenses,appliances,-207.33,-4009.97
buyer_1,Aitor,López,1996-08-10,17033061C,aitor.lópez@awesomecode.net,185417,ES44209556455181134018,3547.89,2022-04-03T16:08:11,Bilbao,expenses,education,-57.3,-4067.27
buyer_1,Aitor,López,1996-08-10,17033061C,aitor.lópez@awesomecode.net,185417,ES44209556455181134018,3547.89,2022-04-03T19:41:39,Bilbao,expenses,cash,-100.0,-4167.27
buyer_1,Aitor,López,1996-08-10,17033061C,aitor.lópez@awesomecode.net,185417,ES44209556455181134018,3547.89,2022-04-03T13:20:07,Bilbao,expenses,gifts,-623.99,-4791.26
buyer_1,Aitor,López,1996-08-10,17033061C,aitor.lópez@awesomecode.net,185417,ES44209556455181134018,3547.89,2022-04-05T20:45:33,Bilbao,expenses,rent,-865.66,-5656.92
buyer_1,Aitor,López,1996-08-10,17033061C,aitor.lópez@awesomecode.net,185417,ES44209556455181134018,3547.89,2022-04-05T20:47:27,Bilbao,expenses,electricity,-86.95,-5743.87
buyer_1,Aitor,López,1996-08-10,17033061C,aitor.lópez@awesomecode.net,185417,ES44209556455181134018,3547.89,2022-04-07T15:06:49,Bilbao,expenses,gas,-127.03,-5870.9
buyer_1,Aitor,López,1996-08-10,17033061C,aitor.lópez@awesomecode.net,185417,ES44209556455181134018,3547.89,2022-04-07T00:02:12,Bilbao,expenses,internet,-52.41,-5923.31
buyer_1,Aitor,López,1996-08-10,17033061C,aitor.lópez@awesomecode.net,185417,ES44209556455181134018,3547.89,2022-04-07T11:14:07,Bilbao,expenses,cash,-100.0,-6023.31
buyer_1,Aitor,López,1996-08-10,17033061C,aitor.lópez@awesomecode.net,185417,ES44209556455181134018,3547.89,2022-04-08T08:58:22,Bilbao,expenses,phone,-42.41,-6065.72
buyer_1,Aitor,López,1996-08-10,17033061C,aitor.lópez@awesomecode.net,185417,ES44209556455181134018,3547.89,2022-04-11T17:09:35,Bilbao,expenses,cash,-100.0,-6165.72
buyer_1,Aitor,López,1996-08-10,17033061C,aitor.lópez@awesomecode.net,185417,ES44209556455181134018,3547.89,2022-04-12T10:05:11,Bilbao,expenses,transport,-47.46,-6213.18
buyer_1,Aitor,López,1996-08-10,17033061C,aitor.lópez@awesomecode.net,185417,ES44209556455181134018,3547.89,2022-04-12T15:57:18,Bilbao,expenses,cash,-100.0,-6313.18
buyer_1,Aitor,López,1996-08-10,17033061C,aitor.lópez@awesomecode.net,185417,ES44209556455181134018,3547.89,2022-04-12T08:42:00,Bilbao,expenses,repairs,-261.76,-6574.94
buyer_1,Aitor,López,1996-08-10,17033061C,aitor.lópez@awesomecode.net,185417,ES44209556455181134018,3547.89,2022-04-14T10:48:47,Bilbao,expenses,cash,-100.0,-6674.94
buyer_1,Aitor,López,1996-08-10,17033061C,aitor.lópez@awesomecode.net,185417,ES44209556455181134018,3547.89,2022-04-15T11:13:28,Bilbao,expenses,food,-76.72,-6751.66
buyer_1,Aitor,López,1996-08-10,17033061C,aitor.lópez@awesomecode.net,185417,ES44209556455181134018,3547.89,2022-04-15T21:15:42,Bilbao,expenses,education,-63.75,-6815.41
buyer_1,Aitor,López,1996-08-10,17033061C,aitor.lópez@awesomecode.net,185417,ES44209556455181134018,3547.89,2022-04-15T14:59:06,Bilbao,expenses,travel,-333.12,-7148.53
buyer_1,Aitor,López,1996-08-10,17033061C,aitor.lópez@awesomecode.net,185417,ES44209556455181134018,3547.89,2022-04-16T17:27:19,Bilbao,expenses,repairs,-230.77,-7379.3
buyer_1,Aitor,López,1996-08-10,17033061C,aitor.lópez@awesomecode.net,185417,ES44209556455181134018,3547.89,2022-04-18T21:29:00,Bilbao,expenses,healthcare,-48.5,-7427.8
buyer_1,Aitor,López,1996-08-10,17033061C,aitor.lópez@awesomecode.net,185417,ES44209556455181134018,3547.89,2022-04-19T16:28:10,Bilbao,expenses,appliances,-314.9,-7742.7
buyer_1,Aitor,López,1996-08-10,17033061C,aitor.lópez@awesomecode.net,185417,ES44209556455181134018,3547.89,2022-04-20T22:00:33,Bilbao,expenses,education,-70.97,-7813.67
buyer_1,Aitor,López,1996-08-10,17033061C,aitor.lópez@awesomecode.net,185417,ES44209556455181134018,3547.89,2022-04-21T15:02:23,Bilbao,expenses,food,-80.47,-7894.14
buyer_1,Aitor,López,1996-08-10,17033061C,aitor.lópez@awesomecode.net,185417,ES44209556455181134018,3547.89,2022-04-21T09:03:04,Bilbao,expenses,cash,-100.0,-7994.14
buyer_1,Aitor,López,1996-08-10,17033061C,aitor.lópez@awesomecode.net,185417,ES44209556455181134018,3547.89,2022-04-22T22:08:46,Bilbao,expenses,food,-85.0,-8079.14
buyer_1,Aitor,López,1996-08-10,17033061C,aitor.lópez@awesomecode.net,185417,ES44209556455181134018,3547.89,2022-04-23T17:54:32,Bilbao,expenses,leisure,-40.25,-8119.39
buyer_1,Aitor,López,1996-08-10,17033061C,aitor.lópez@awesomecode.net,185417,ES44209556455181134018,3547.89,2022-04-24T21:25:19,Bilbao,expenses,cash,-100.0,-8219.39
buyer_1,Aitor,López,1996-08-10,17033061C,aitor.lópez@awesomecode.net,185417,ES44209556455181134018,3547.89,2022-04-25T16:24:55,Bilbao,expenses,transport,-49.06,-8268.45
buyer_1,Aitor,López,1996-08-10,17033061C,aitor.lópez@awesomecode.net,185417,ES44209556455181134018,3547.89,2022-04-25T14:05:41,Bilbao,expenses,gifts,-138.86,-8407.31
buyer_1,Aitor,López,1996-08-10,17033061C,aitor.lópez@awesomecode.net,185417,ES44209556455181134018,3547.89,2022-04-27T18:56:53,Bilbao,expenses,cash,-100.0,-8507.31
buyer_1,Aitor,López,1996-08-10,17033061C,aitor.lópez@awesomecode.net,185417,ES44209556455181134018,3547.89,2022-04-29T15:52:46,Bilbao,expenses,food,-96.44,-8603.75
buyer_1,Aitor,López,1996-08-10,17033061C,aitor.lópez@awesomecode.net,185417,ES44209556455181134018,3547.89,2022-04-29T10:42:10,Bilbao,expenses,cash,-100.0,-8703.75
buyer_1,Aitor,López,1996-08-10,17033061C,aitor.lópez@awesomecode.net,185417,ES44209556455181134018,3547.89,2022-05-01T20:14:42,Bilbao,incomes,salary,2495.84,-6207.91
buyer_1,Aitor,López,1996-08-10,17033061C,aitor.lópez@awesomecode.net,185417,ES44209556455181134018,3547.89,2022-05-01T17:32:57,Bilbao,expenses,transport,-89.76,-6297.67
buyer_1,Aitor,López,1996-08-10,17033061C,aitor.lópez@awesomecode.net,185417,ES44209556455181134018,3547.89,2022-05-02T16:51:52,Bilbao,expenses,education,-57.52,-6355.19
buyer_1,Aitor,López,1996-08-10,17033061C,aitor.lópez@awesomecode.net,185417,ES44209556455181134018,3547.89,2022-05-03T17:32:48,Bilbao,expenses,transport,-79.36,-6434.55
buyer_1,Aitor,López,1996-08-10,17033061C,aitor.lópez@awesomecode.net,185417,ES44209556455181134018,3547.89,2022-05-04T11:32:58,Bilbao,expenses,cash,-100.0,-6534.55
buyer_1,Aitor,López,1996-08-10,17033061C,aitor.lópez@awesomecode.net,185417,ES44209556455181134018,3547.89,2022-05-05T19:26:25,Bilbao,expenses,rent,-865.66,-7400.21
buyer_1,Aitor,López,1996-08-10,17033061C,aitor.lópez@awesomecode.net,185417,ES44209556455181134018,3547.89,2022-05-05T15:24:01,Bilbao,expenses,internet,-52.41,-7452.62
buyer_1,Aitor,López,1996-08-10,17033061C,aitor.lópez@awesomecode.net,185417,ES44209556455181134018,3547.89,2022-05-05T09:18:19,Bilbao,expenses,phone,-39.03,-7491.65
buyer_1,Aitor,López,1996-08-10,17033061C,aitor.lópez@awesomecode.net,185417,ES44209556455181134018,3547.89,2022-05-05T14:10:44,Bilbao,expenses,transport,-68.76,-7560.41
buyer_1,Aitor,López,1996-08-10,17033061C,aitor.lópez@awesomecode.net,185417,ES44209556455181134018,3547.89,2022-05-05T13:10:12,Bilbao,expenses,travel,-723.31,-8283.72
buyer_1,Aitor,López,1996-08-10,17033061C,aitor.lópez@awesomecode.net,185417,ES44209556455181134018,3547.89,2022-05-06T02:05:32,Bilbao,expenses,gas,-37.81,-8321.53
buyer_1,Aitor,López,1996-08-10,17033061C,aitor.lópez@awesomecode.net,185417,ES44209556455181134018,3547.89,2022-05-06T18:20:37,Bilbao,expenses,food,-117.05,-8438.58
buyer_1,Aitor,López,1996-08-10,17033061C,aitor.lópez@awesomecode.net,185417,ES44209556455181134018,3547.89,2022-05-07T03:23:51,Bilbao,expenses,internet,-52.41,-8490.99
buyer_1,Aitor,López,1996-08-10,17033061C,aitor.lópez@awesomecode.net,185417,ES44209556455181134018,3547.89,2022-05-07T18:43:06,Bilbao,expenses,leisure,-76.87,-8567.86
buyer_1,Aitor,López,1996-08-10,17033061C,aitor.lópez@awesomecode.net,185417,ES44209556455181134018,3547.89,2022-05-08T04:37:30,Bilbao,expenses,internet,-52.41,-8620.27
buyer_1,Aitor,López,1996-08-10,17033061C,aitor.lópez@awesomecode.net,185417,ES44209556455181134018,3547.89,2022-05-08T09:32:56,Bilbao,expenses,phone,-45.72,-8665.99
buyer_1,Aitor,López,1996-08-10,17033061C,aitor.lópez@awesomecode.net,185417,ES44209556455181134018,3547.89,2022-05-08T08:51:41,Bilbao,expenses,transport,-45.86,-8711.85
buyer_1,Aitor,López,1996-08-10,17033061C,aitor.lópez@awesomecode.net,185417,ES44209556455181134018,3547.89,2022-05-10T17:06:13,Bilbao,expenses,clothing,-81.0,-8792.85
buyer_1,Aitor,López,1996-08-10,17033061C,aitor.lópez@awesomecode.net,185417,ES44209556455181134018,3547.89,2022-05-12T10:17:52,Bilbao,expenses,cash,-100.0,-8892.85
buyer_1,Aitor,López,1996-08-10,17033061C,aitor.lópez@awesomecode.net,185417,ES44209556455181134018,3547.89,2022-05-14T18:55:30,Bilbao,expenses,education,-64.42,-8957.27
buyer_1,Aitor,López,1996-08-10,17033061C,aitor.lópez@awesomecode.net,185417,ES44209556455181134018,3547.89,2022-05-15T14:29:53,Bilbao,expenses,repairs,-241.87,-9199.14
buyer_1,Aitor,López,1996-08-10,17033061C,aitor.lópez@awesomecode.net,185417,ES44209556455181134018,3547.89,2022-05-18T08:15:28,Bilbao,expenses,food,-122.03,-9321.17
buyer_1,Aitor,López,1996-08-10,17033061C,aitor.lópez@awesomecode.net,185417,ES44209556455181134018,3547.89,2022-05-22T09:53:49,Bilbao,expenses,repairs,-44.23,-9365.4
buyer_1,Aitor,López,1996-08-10,17033061C,aitor.lópez@awesomecode.net,185417,ES44209556455181134018,3547.89,2022-05-24T13:15:51,Bilbao,expenses,leisure,-20.36,-9385.76
buyer_1,Aitor,López,1996-08-10,17033061C,aitor.lópez@awesomecode.net,185417,ES44209556455181134018,3547.89,2022-05-24T11:51:42,Bilbao,expenses,healthcare,-70.84,-9456.6
buyer_1,Aitor,López,1996-08-10,17033061C,aitor.lópez@awesomecode.net,185417,ES44209556455181134018,3547.89,2022-05-24T16:12:34,Bilbao,expenses,appliances,-144.73,-9601.33
buyer_1,Aitor,López,1996-08-10,17033061C,aitor.lópez@awesomecode.net,185417,ES44209556455181134018,3547.89,2022-05-25T09:00:33,Bilbao,expenses,transport,-47.0,-9648.33
buyer_1,Aitor,López,1996-08-10,17033061C,aitor.lópez@awesomecode.net,185417,ES44209556455181134018,3547.89,2022-05-25T10:36:27,Bilbao,expenses,leisure,-75.93,-9724.26
buyer_1,Aitor,López,1996-08-10,17033061C,aitor.lópez@awesomecode.net,185417,ES44209556455181134018,3547.89,2022-05-25T21:20:17,Bilbao,expenses,clothing,-66.98,-9791.24
buyer_1,Aitor,López,1996-08-10,17033061C,aitor.lópez@awesomecode.net,185417,ES44209556455181134018,3547.89,2022-05-27T20:32:33,Bilbao,expenses,transport,-62.08,-9853.32
buyer_1,Aitor,López,1996-08-10,17033061C,aitor.lópez@awesomecode.net,185417,ES44209556455181134018,3547.89,2022-06-01T13:36:06,Bilbao,incomes,salary,2495.84,-7357.48
buyer_1,Aitor,López,1996-08-10,17033061C,aitor.lópez@awesomecode.net,185417,ES44209556455181134018,3547.89,2022-06-01T13:36:06,Bilbao,incomes,extra_income,266.49,-7090.99
buyer_1,Aitor,López,1996-08-10,17033061C,aitor.lópez@awesomecode.net,185417,ES44209556455181134018,3547.89,2022-06-01T13:36:06,Bilbao,incomes,salary_bonus,1802.41,-5288.58
buyer_1,Aitor,López,1996-08-10,17033061C,aitor.lópez@awesomecode.net,185417,ES44209556455181134018,3547.89,2022-06-01T18:07:11,Bilbao,expenses,taxes,-1899.13,-7187.71
buyer_1,Aitor,López,1996-08-10,17033061C,aitor.lópez@awesomecode.net,185417,ES44209556455181134018,3547.89,2022-06-01T13:28:57,Bilbao,expenses,insurance,-727.19,-7914.9
buyer_1,Aitor,López,1996-08-10,17033061C,aitor.lópez@awesomecode.net,185417,ES44209556455181134018,3547.89,2022-06-05T16:21:18,Bilbao,expenses,rent,-865.66,-8780.56
buyer_1,Aitor,López,1996-08-10,17033061C,aitor.lópez@awesomecode.net,185417,ES44209556455181134018,3547.89,2022-06-05T16:03:01,Bilbao,expenses,gas,-119.97,-8900.53
buyer_1,Aitor,López,1996-08-10,17033061C,aitor.lópez@awesomecode.net,185417,ES44209556455181134018,3547.89,2022-06-05T17:25:28,Bilbao,expenses,clothing,-108.43,-9008.96
buyer_1,Aitor,López,1996-08-10,17033061C,aitor.lópez@awesomecode.net,185417,ES44209556455181134018,3547.89,2022-06-05T02:43:13,Bilbao,expenses,repairs,-150.89,-9159.85
buyer_1,Aitor,López,1996-08-10,17033061C,aitor.lópez@awesomecode.net,185417,ES44209556455181134018,3547.89,2022-06-06T11:52:20,Bilbao,expenses,water,-29.2,-9189.05
buyer_1,Aitor,López,1996-08-10,17033061C,aitor.lópez@awesomecode.net,185417,ES44209556455181134018,3547.89,2022-06-06T11:09:33,Bilbao,expenses,internet,-52.41,-9241.46
buyer_1,Aitor,López,1996-08-10,17033061C,aitor.lópez@awesomecode.net,185417,ES44209556455181134018,3547.89,2022-06-07T21:09:45,Bilbao,expenses,electricity,-93.32,-9334.78
buyer_1,Aitor,López,1996-08-10,17033061C,aitor.lópez@awesomecode.net,185417,ES44209556455181134018,3547.89,2022-06-07T12:36:46,Bilbao,expenses,phone,-49.03,-9383.81
buyer_1,Aitor,López,1996-08-10,17033061C,aitor.lópez@awesomecode.net,185417,ES44209556455181134018,3547.89,2022-06-08T11:30:34,Bilbao,expenses,gas,-38.34,-9422.15
buyer_1,Aitor,López,1996-08-10,17033061C,aitor.lópez@awesomecode.net,185417,ES44209556455181134018,3547.89,2022-06-08T17:14:29,Bilbao,expenses,cash,-100.0,-9522.15
buyer_1,Aitor,López,1996-08-10,17033061C,aitor.lópez@awesomecode.net,185417,ES44209556455181134018,3547.89,2022-06-10T11:23:18,Bilbao,expenses,food,-76.5,-9598.65
buyer_1,Aitor,López,1996-08-10,17033061C,aitor.lópez@awesomecode.net,185417,ES44209556455181134018,3547.89,2022-06-10T08:51:00,Bilbao,expenses,repairs,-266.98,-9865.63
buyer_1,Aitor,López,1996-08-10,17033061C,aitor.lópez@awesomecode.net,185417,ES44209556455181134018,3547.89,2022-06-13T21:47:48,Bilbao,expenses,cash,-100.0,-9965.63
buyer_1,Aitor,López,1996-08-10,17033061C,aitor.lópez@awesomecode.net,185417,ES44209556455181134018,3547.89,2022-06-14T10:05:27,Bilbao,expenses,food,-63.65,-10029.28
buyer_1,Aitor,López,1996-08-10,17033061C,aitor.lópez@awesomecode.net,185417,ES44209556455181134018,3547.89,2022-06-14T14:18:31,Bilbao,expenses,gifts,-800.4,-10829.68
buyer_1,Aitor,López,1996-08-10,17033061C,aitor.lópez@awesomecode.net,185417,ES44209556455181134018,3547.89,2022-06-15T23:35:08,Bilbao,expenses,food,-95.75,-10925.43
buyer_1,Aitor,López,1996-08-10,17033061C,aitor.lópez@awesomecode.net,185417,ES44209556455181134018,3547.89,2022-06-15T09:11:03,Bilbao,expenses,gifts,-115.63,-11041.06
buyer_1,Aitor,López,1996-08-10,17033061C,aitor.lópez@awesomecode.net,185417,ES44209556455181134018,3547.89,2022-06-17T18:29:47,Bilbao,expenses,food,-86.38,-11127.44
buyer_1,Aitor,López,1996-08-10,17033061C,aitor.lópez@awesomecode.net,185417,ES44209556455181134018,3547.89,2022-06-17T21:28:37,Bilbao,expenses,transport,-67.6,-11195.04
buyer_1,Aitor,López,1996-08-10,17033061C,aitor.lópez@awesomecode.net,185417,ES44209556455181134018,3547.89,2022-06-18T02:07:12,Bilbao,expenses,food,-89.85,-11284.89
buyer_1,Aitor,López,1996-08-10,17033061C,aitor.lópez@awesomecode.net,185417,ES44209556455181134018,3547.89,2022-06-18T02:47:49,Bilbao,expenses,leisure,-18.71,-11303.6
buyer_1,Aitor,López,1996-08-10,17033061C,aitor.lópez@awesomecode.net,185417,ES44209556455181134018,3547.89,2022-06-21T20:54:18,Bilbao,expenses,car,-329.19,-11632.79
buyer_1,Aitor,López,1996-08-10,17033061C,aitor.lópez@awesomecode.net,185417,ES44209556455181134018,3547.89,2022-06-22T15:37:29,Bilbao,expenses,leisure,-61.47,-11694.26
buyer_1,Aitor,López,1996-08-10,17033061C,aitor.lópez@awesomecode.net,185417,ES44209556455181134018,3547.89,2022-06-22T12:25:27,Bilbao,expenses,cash,-100.0,-11794.26
buyer_1,Aitor,López,1996-08-10,17033061C,aitor.lópez@awesomecode.net,185417,ES44209556455181134018,3547.89,2022-06-23T13:38:08,Bilbao,expenses,leisure,-49.87,-11844.13
buyer_1,Aitor,López,1996-08-10,17033061C,aitor.lópez@awesomecode.net,185417,ES44209556455181134018,3547.89,2022-06-24T00:55:15,Bilbao,expenses,education,-56.11,-11900.24
buyer_1,Aitor,López,1996-08-10,17033061C,aitor.lópez@awesomecode.net,185417,ES44209556455181134018,3547.89,2022-06-24T23:37:37,Bilbao,expenses,repairs,-277.48,-12177.72
buyer_1,Aitor,López,1996-08-10,17033061C,aitor.lópez@awesomecode.net,185417,ES44209556455181134018,3547.89,2022-06-26T14:35:34,Bilbao,expenses,cash,-100.0,-12277.72
buyer_1,Aitor,López,1996-08-10,17033061C,aitor.lópez@awesomecode.net,185417,ES44209556455181134018,3547.89,2022-06-27T18:00:42,Bilbao,expenses,cash,-100.0,-12377.72
buyer_1,Aitor,López,1996-08-10,17033061C,aitor.lópez@awesomecode.net,185417,ES44209556455181134018,3547.89,2022-06-27T10:14:31,Bilbao,expenses,gifts,-482.45,-12860.17
buyer_1,Aitor,López,1996-08-10,17033061C,aitor.lópez@awesomecode.net,185417,ES44209556455181134018,3547.89,2022-06-30T18:18:16,Bilbao,expenses,food,-73.38,-12933.55
buyer_1,Aitor,López,1996-08-10,17033061C,aitor.lópez@awesomecode.net,185417,ES44209556455181134018,3547.89,2022-07-01T10:10:33,Bilbao,incomes,salary,2495.84,-10437.71
buyer_1,Aitor,López,1996-08-10,17033061C,aitor.lópez@awesomecode.net,185417,ES44209556455181134018,3547.89,2022-07-01T11:24:46,Bilbao,expenses,clothing,-136.31,-10574.02
buyer_1,Aitor,López,1996-08-10,17033061C,aitor.lópez@awesomecode.net,185417,ES44209556455181134018,3547.89,2022-07-02T13:32:04,Bilbao,expenses,transport,-64.84,-10638.86
buyer_1,Aitor,López,1996-08-10,17033061C,aitor.lópez@awesomecode.net,185417,ES44209556455181134018,3547.89,2022-07-03T22:08:44,Bilbao,expenses,cash,-100.0,-10738.86
buyer_1,Aitor,López,1996-08-10,17033061C,aitor.lópez@awesomecode.net,185417,ES44209556455181134018,3547.89,2022-07-05T20:12:06,Bilbao,expenses,rent,-865.66,-11604.52
buyer_1,Aitor,López,1996-08-10,17033061C,aitor.lópez@awesomecode.net,185417,ES44209556455181134018,3547.89,2022-07-05T13:17:06,Bilbao,expenses,phone,-44.62,-11649.14
buyer_1,Aitor,López,1996-08-10,17033061C,aitor.lópez@awesomecode.net,185417,ES44209556455181134018,3547.89,2022-07-06T14:04:54,Bilbao,expenses,electricity,-67.69,-11716.83
buyer_1,Aitor,López,1996-08-10,17033061C,aitor.lópez@awesomecode.net,185417,ES44209556455181134018,3547.89,2022-07-06T11:21:49,Bilbao,expenses,phone,-44.18,-11761.01
buyer_1,Aitor,López,1996-08-10,17033061C,aitor.lópez@awesomecode.net,185417,ES44209556455181134018,3547.89,2022-07-07T14:18:15,Bilbao,expenses,water,-53.93,-11814.94
buyer_1,Aitor,López,1996-08-10,17033061C,aitor.lópez@awesomecode.net,185417,ES44209556455181134018,3547.89,2022-07-07T08:42:10,Bilbao,expenses,internet,-52.41,-11867.35
buyer_1,Aitor,López,1996-08-10,17033061C,aitor.lópez@awesomecode.net,185417,ES44209556455181134018,3547.89,2022-07-08T08:06:14,Bilbao,expenses,appliances,-395.74,-12263.09
buyer_1,Aitor,López,1996-08-10,17033061C,aitor.lópez@awesomecode.net,185417,ES44209556455181134018,3547.89,2022-07-09T16:04:51,Bilbao,expenses,transport,-83.38,-12346.47
buyer_1,Aitor,López,1996-08-10,17033061C,aitor.lópez@awesomecode.net,185417,ES44209556455181134018,3547.89,2022-07-11T12:58:29,Bilbao,expenses,leisure,-49.29,-12395.76
buyer_1,Aitor,López,1996-08-10,17033061C,aitor.lópez@awesomecode.net,185417,ES44209556455181134018,3547.89,2022-07-15T08:46:43,Bilbao,expenses,food,-79.01,-12474.77
buyer_1,Aitor,López,1996-08-10,17033061C,aitor.lópez@awesomecode.net,185417,ES44209556455181134018,3547.89,2022-07-15T14:21:47,Bilbao,expenses,leisure,-81.25,-12556.02
buyer_1,Aitor,López,1996-08-10,17033061C,aitor.lópez@awesomecode.net,185417,ES44209556455181134018,3547.89,2022-07-15T14:02:38,Bilbao,expenses,repairs,-150.32,-12706.34
buyer_1,Aitor,López,1996-08-10,17033061C,aitor.lópez@awesomecode.net,185417,ES44209556455181134018,3547.89,2022-07-18T08:08:43,Bilbao,expenses,repairs,-315.59,-13021.93
buyer_1,Aitor,López,1996-08-10,17033061C,aitor.lópez@awesomecode.net,185417,ES44209556455181134018,3547.89,2022-07-19T11:55:45,Bilbao,expenses,leisure,-35.42,-13057.35
buyer_1,Aitor,López,1996-08-10,17033061C,aitor.lópez@awesomecode.net,185417,ES44209556455181134018,3547.89,2022-07-21T01:24:56,Bilbao,expenses,clothing,-132.24,-13189.59
buyer_1,Aitor,López,1996-08-10,17033061C,aitor.lópez@awesomecode.net,185417,ES44209556455181134018,3547.89,2022-07-21T12:15:43,Bilbao,expenses,travel,-692.57,-13882.16
buyer_1,Aitor,López,1996-08-10,17033061C,aitor.lópez@awesomecode.net,185417,ES44209556455181134018,3547.89,2022-07-25T17:15:56,Bilbao,expenses,transport,-41.39,-13923.55
buyer_1,Aitor,López,1996-08-10,17033061C,aitor.lópez@awesomecode.net,185417,ES44209556455181134018,3547.89,2022-07-26T13:39:45,Bilbao,expenses,gifts,-201.03,-14124.58
buyer_1,Aitor,López,1996-08-10,17033061C,aitor.lópez@awesomecode.net,185417,ES44209556455181134018,3547.89,2022-07-27T20:19:59,Bilbao,expenses,leisure,-63.3,-14187.88
buyer_1,Aitor,López,1996-08-10,17033061C,aitor.lópez@awesomecode.net,185417,ES44209556455181134018,3547.89,2022-07-28T12:37:29,Bilbao,expenses,food,-81.26,-14269.14
buyer_1,Aitor,López,1996-08-10,17033061C,aitor.lópez@awesomecode.net,185417,ES44209556455181134018,3547.89,2022-07-28T11:18:58,Bilbao,expenses,cash,-100.0,-14369.14
buyer_1,Aitor,López,1996-08-10,17033061C,aitor.lópez@awesomecode.net,185417,ES44209556455181134018,3547.89,2022-07-28T15:38:52,Bilbao,expenses,gifts,-426.52,-14795.66
buyer_1,Aitor,López,1996-08-10,17033061C,aitor.lópez@awesomecode.net,185417,ES44209556455181134018,3547.89,2022-07-29T14:13:24,Bilbao,expenses,leisure,-64.54,-14860.2
buyer_1,Aitor,López,1996-08-10,17033061C,aitor.lópez@awesomecode.net,185417,ES44209556455181134018,3547.89,2022-07-29T16:15:59,Bilbao,expenses,cash,-100.0,-14960.2
buyer_1,Aitor,López,1996-08-10,17033061C,aitor.lópez@awesomecode.net,185417,ES44209556455181134018,3547.89,2022-07-30T11:17:57,Bilbao,expenses,food,-97.99,-15058.19
buyer_1,Aitor,López,1996-08-10,17033061C,aitor.lópez@awesomecode.net,185417,ES44209556455181134018,3547.89,2022-07-30T08:38:58,Bilbao,expenses,repairs,-29.93,-15088.12
buyer_1,Aitor,López,1996-08-10,17033061C,aitor.lópez@awesomecode.net,185417,ES44209556455181134018,3547.89,2022-07-30T08:32:24,Bilbao,expenses,gifts,-779.07,-15867.19
buyer_1,Aitor,López,1996-08-10,17033061C,aitor.lópez@awesomecode.net,185417,ES44209556455181134018,3547.89,2022-08-01T15:26:43,Bilbao,incomes,salary,2495.84,-13371.35
buyer_1,Aitor,López,1996-08-10,17033061C,aitor.lópez@awesomecode.net,185417,ES44209556455181134018,3547.89,2022-08-01T08:28:25,Bilbao,expenses,transport,-82.65,-13454.0
buyer_1,Aitor,López,1996-08-10,17033061C,aitor.lópez@awesomecode.net,185417,ES44209556455181134018,3547.89,2022-08-03T10:10:56,Bilbao,expenses,transport,-71.55,-13525.55
buyer_1,Aitor,López,1996-08-10,17033061C,aitor.lópez@awesomecode.net,185417,ES44209556455181134018,3547.89,2022-08-04T13:37:39,Bilbao,expenses,leisure,-48.71,-13574.26
buyer_1,Aitor,López,1996-08-10,17033061C,aitor.lópez@awesomecode.net,185417,ES44209556455181134018,3547.89,2022-08-04T12:06:05,Bilbao,expenses,cash,-100.0,-13674.26
buyer_1,Aitor,López,1996-08-10,17033061C,aitor.lópez@awesomecode.net,185417,ES44209556455181134018,3547.89,2022-08-05T08:09:26,Bilbao,expenses,rent,-865.66,-14539.92
buyer_1,Aitor,López,1996-08-10,17033061C,aitor.lópez@awesomecode.net,185417,ES44209556455181134018,3547.89,2022-08-05T09:21:27,Bilbao,expenses,water,-28.46,-14568.38
buyer_1,Aitor,López,1996-08-10,17033061C,aitor.lópez@awesomecode.net,185417,ES44209556455181134018,3547.89,2022-08-05T14:16:11,Bilbao,expenses,leisure,-50.84,-14619.22
buyer_1,Aitor,López,1996-08-10,17033061C,aitor.lópez@awesomecode.net,185417,ES44209556455181134018,3547.89,2022-08-05T20:55:38,Bilbao,expenses,gifts,-373.14,-14992.36
buyer_1,Aitor,López,1996-08-10,17033061C,aitor.lópez@awesomecode.net,185417,ES44209556455181134018,3547.89,2022-08-06T18:19:16,Bilbao,expenses,electricity,-87.72,-15080.08
buyer_1,Aitor,López,1996-08-10,17033061C,aitor.lópez@awesomecode.net,185417,ES44209556455181134018,3547.89,2022-08-06T17:18:54,Bilbao,expenses,internet,-52.41,-15132.49
buyer_1,Aitor,López,1996-08-10,17033061C,aitor.lópez@awesomecode.net,185417,ES44209556455181134018,3547.89,2022-08-06T17:15:52,Bilbao,expenses,phone,-51.8,-15184.29
buyer_1,Aitor,López,1996-08-10,17033061C,aitor.lópez@awesomecode.net,185417,ES44209556455181134018,3547.89,2022-08-06T12:39:34,Bilbao,expenses,food,-74.53,-15258.82
buyer_1,Aitor,López,1996-08-10,17033061C,aitor.lópez@awesomecode.net,185417,ES44209556455181134018,3547.89,2022-08-07T18:19:25,Bilbao,expenses,internet,-52.41,-15311.23
buyer_1,Aitor,López,1996-08-10,17033061C,aitor.lópez@awesomecode.net,185417,ES44209556455181134018,3547.89,2022-08-07T05:52:50,Bilbao,expenses,clothing,-135.97,-15447.2
buyer_1,Aitor,López,1996-08-10,17033061C,aitor.lópez@awesomecode.net,185417,ES44209556455181134018,3547.89,2022-08-08T08:50:07,Bilbao,expenses,water,-25.84,-15473.04
buyer_1,Aitor,López,1996-08-10,17033061C,aitor.lópez@awesomecode.net,185417,ES44209556455181134018,3547.89,2022-08-08T13:18:57,Bilbao,expenses,transport,-50.9,-15523.94
buyer_1,Aitor,López,1996-08-10,17033061C,aitor.lópez@awesomecode.net,185417,ES44209556455181134018,3547.89,2022-08-10T01:15:17,Bilbao,expenses,leisure,-84.71,-15608.65
buyer_1,Aitor,López,1996-08-10,17033061C,aitor.lópez@awesomecode.net,185417,ES44209556455181134018,3547.89,2022-08-10T18:24:18,Bilbao,expenses,appliances,-259.48,-15868.13
buyer_1,Aitor,López,1996-08-10,17033061C,aitor.lópez@awesomecode.net,185417,ES44209556455181134018,3547.89,2022-08-11T10:08:02,Bilbao,expenses,cash,-100.0,-15968.13
buyer_1,Aitor,López,1996-08-10,17033061C,aitor.lópez@awesomecode.net,185417,ES44209556455181134018,3547.89,2022-08-12T19:12:20,Bilbao,expenses,food,-93.25,-16061.38
buyer_1,Aitor,López,1996-08-10,17033061C,aitor.lópez@awesomecode.net,185417,ES44209556455181134018,3547.89,2022-08-13T12:23:21,Bilbao,expenses,healthcare,-108.13,-16169.51
buyer_1,Aitor,López,1996-08-10,17033061C,aitor.lópez@awesomecode.net,185417,ES44209556455181134018,3547.89,2022-08-15T19:03:01,Bilbao,expenses,transport,-63.62,-16233.13
buyer_1,Aitor,López,1996-08-10,17033061C,aitor.lópez@awesomecode.net,185417,ES44209556455181134018,3547.89,2022-08-18T17:42:03,Bilbao,expenses,repairs,-76.32,-16309.45
buyer_1,Aitor,López,1996-08-10,17033061C,aitor.lópez@awesomecode.net,185417,ES44209556455181134018,3547.89,2022-08-19T12:16:01,Bilbao,expenses,food,-112.36,-16421.81
buyer_1,Aitor,López,1996-08-10,17033061C,aitor.lópez@awesomecode.net,185417,ES44209556455181134018,3547.89,2022-08-19T19:21:52,Bilbao,expenses,repairs,-198.36,-16620.17
buyer_1,Aitor,López,1996-08-10,17033061C,aitor.lópez@awesomecode.net,185417,ES44209556455181134018,3547.89,2022-08-23T08:05:40,Bilbao,expenses,appliances,-283.01,-16903.18
buyer_1,Aitor,López,1996-08-10,17033061C,aitor.lópez@awesomecode.net,185417,ES44209556455181134018,3547.89,2022-08-24T04:51:09,Bilbao,expenses,food,-65.11,-16968.29
buyer_1,Aitor,López,1996-08-10,17033061C,aitor.lópez@awesomecode.net,185417,ES44209556455181134018,3547.89,2022-08-28T22:05:10,Bilbao,expenses,cash,-100.0,-17068.29
buyer_1,Aitor,López,1996-08-10,17033061C,aitor.lópez@awesomecode.net,185417,ES44209556455181134018,3547.89,2022-08-31T15:29:51,Bilbao,expenses,leisure,-36.5,-17104.79
buyer_1,Aitor,López,1996-08-10,17033061C,aitor.lópez@awesomecode.net,185417,ES44209556455181134018,3547.89,2022-08-31T22:58:39,Bilbao,expenses,cash,-100.0,-17204.79
buyer_1,Aitor,López,1996-08-10,17033061C,aitor.lópez@awesomecode.net,185417,ES44209556455181134018,3547.89,2022-09-01T12:24:32,Bilbao,incomes,salary,2495.84,-14708.95
buyer_1,Aitor,López,1996-08-10,17033061C,aitor.lópez@awesomecode.net,185417,ES44209556455181134018,3547.89,2022-09-01T12:24:32,Bilbao,incomes,extra_income,266.49,-14442.46
buyer_1,Aitor,López,1996-08-10,17033061C,aitor.lópez@awesomecode.net,185417,ES44209556455181134018,3547.89,2022-09-03T00:25:12,Bilbao,expenses,cash,-100.0,-14542.46
buyer_1,Aitor,López,1996-08-10,17033061C,aitor.lópez@awesomecode.net,185417,ES44209556455181134018,3547.89,2022-09-05T10:02:21,Bilbao,expenses,rent,-865.66,-15408.12
buyer_1,Aitor,López,1996-08-10,17033061C,aitor.lópez@awesomecode.net,185417,ES44209556455181134018,3547.89,2022-09-05T13:31:41,Bilbao,expenses,internet,-52.41,-15460.53
buyer_1,Aitor,López,1996-08-10,17033061C,aitor.lópez@awesomecode.net,185417,ES44209556455181134018,3547.89,2022-09-06T18:16:26,Bilbao,expenses,gas,-124.96,-15585.49
buyer_1,Aitor,López,1996-08-10,17033061C,aitor.lópez@awesomecode.net,185417,ES44209556455181134018,3547.89,2022-09-06T10:09:31,Bilbao,expenses,phone,-51.37,-15636.86
buyer_1,Aitor,López,1996-08-10,17033061C,aitor.lópez@awesomecode.net,185417,ES44209556455181134018,3547.89,2022-09-06T18:05:16,Bilbao,expenses,transport,-88.82,-15725.68
buyer_1,Aitor,López,1996-08-10,17033061C,aitor.lópez@awesomecode.net,185417,ES44209556455181134018,3547.89,2022-09-06T18:50:41,Bilbao,expenses,leisure,-45.26,-15770.94
buyer_1,Aitor,López,1996-08-10,17033061C,aitor.lópez@awesomecode.net,185417,ES44209556455181134018,3547.89,2022-09-06T09:25:38,Bilbao,expenses,clothing,-126.92,-15897.86
buyer_1,Aitor,López,1996-08-10,17033061C,aitor.lópez@awesomecode.net,185417,ES44209556455181134018,3547.89,2022-09-06T11:28:33,Bilbao,expenses,healthcare,-151.68,-16049.54
buyer_1,Aitor,López,1996-08-10,17033061C,aitor.lópez@awesomecode.net,185417,ES44209556455181134018,3547.89,2022-09-07T12:53:25,Bilbao,expenses,water,-30.07,-16079.61
buyer_1,Aitor,López,1996-08-10,17033061C,aitor.lópez@awesomecode.net,185417,ES44209556455181134018,3547.89,2022-09-07T10:50:06,Bilbao,expenses,gas,-126.63,-16206.24
buyer_1,Aitor,López,1996-08-10,17033061C,aitor.lópez@awesomecode.net,185417,ES44209556455181134018,3547.89,2022-09-07T15:54:11,Bilbao,expenses,internet,-52.41,-16258.65
buyer_1,Aitor,López,1996-08-10,17033061C,aitor.lópez@awesomecode.net,185417,ES44209556455181134018,3547.89,2022-09-07T09:21:37,Bilbao,expenses,gifts,-522.26,-16780.91
buyer_1,Aitor,López,1996-08-10,17033061C,aitor.lópez@awesomecode.net,185417,ES44209556455181134018,3547.89,2022-09-08T06:39:59,Bilbao,expenses,electricity,-35.93,-16816.84
buyer_1,Aitor,López,1996-08-10,17033061C,aitor.lópez@awesomecode.net,185417,ES44209556455181134018,3547.89,2022-09-08T08:29:44,Bilbao,expenses,food,-84.33,-16901.17
buyer_1,Aitor,López,1996-08-10,17033061C,aitor.lópez@awesomecode.net,185417,ES44209556455181134018,3547.89,2022-09-08T12:56:42,Bilbao,expenses,education,-61.82,-16962.99
buyer_1,Aitor,López,1996-08-10,17033061C,aitor.lópez@awesomecode.net,185417,ES44209556455181134018,3547.89,2022-09-09T09:55:02,Bilbao,expenses,leisure,-57.0,-17019.99
buyer_1,Aitor,López,1996-08-10,17033061C,aitor.lópez@awesomecode.net,185417,ES44209556455181134018,3547.89,2022-09-11T23:50:59,Bilbao,expenses,education,-48.98,-17068.97
buyer_1,Aitor,López,1996-08-10,17033061C,aitor.lópez@awesomecode.net,185417,ES44209556455181134018,3547.89,2022-09-13T20:20:45,Bilbao,expenses,transport,-45.17,-17114.14
buyer_1,Aitor,López,1996-08-10,17033061C,aitor.lópez@awesomecode.net,185417,ES44209556455181134018,3547.89,2022-09-13T11:07:38,Bilbao,expenses,leisure,-79.61,-17193.75
buyer_1,Aitor,López,1996-08-10,17033061C,aitor.lópez@awesomecode.net,185417,ES44209556455181134018,3547.89,2022-09-16T15:19:30,Bilbao,expenses,transport,-81.04,-17274.79
buyer_1,Aitor,López,1996-08-10,17033061C,aitor.lópez@awesomecode.net,185417,ES44209556455181134018,3547.89,2022-09-16T14:39:38,Bilbao,expenses,repairs,-145.63,-17420.42
buyer_1,Aitor,López,1996-08-10,17033061C,aitor.lópez@awesomecode.net,185417,ES44209556455181134018,3547.89,2022-09-17T08:33:25,Bilbao,expenses,leisure,-31.59,-17452.01
buyer_1,Aitor,López,1996-08-10,17033061C,aitor.lópez@awesomecode.net,185417,ES44209556455181134018,3547.89,2022-09-18T01:51:10,Bilbao,expenses,clothing,-97.45,-17549.46
buyer_1,Aitor,López,1996-08-10,17033061C,aitor.lópez@awesomecode.net,185417,ES44209556455181134018,3547.89,2022-09-19T18:31:49,Bilbao,expenses,leisure,-81.61,-17631.07
buyer_1,Aitor,López,1996-08-10,17033061C,aitor.lópez@awesomecode.net,185417,ES44209556455181134018,3547.89,2022-09-21T06:43:17,Bilbao,expenses,clothing,-159.65,-17790.72
buyer_1,Aitor,López,1996-08-10,17033061C,aitor.lópez@awesomecode.net,185417,ES44209556455181134018,3547.89,2022-09-22T03:23:34,Bilbao,expenses,food,-96.97,-17887.69
buyer_1,Aitor,López,1996-08-10,17033061C,aitor.lópez@awesomecode.net,185417,ES44209556455181134018,3547.89,2022-09-22T20:40:44,Bilbao,expenses,gifts,-321.5,-18209.19
buyer_1,Aitor,López,1996-08-10,17033061C,aitor.lópez@awesomecode.net,185417,ES44209556455181134018,3547.89,2022-09-23T06:17:00,Bilbao,expenses,food,-110.65,-18319.84
buyer_1,Aitor,López,1996-08-10,17033061C,aitor.lópez@awesomecode.net,185417,ES44209556455181134018,3547.89,2022-09-24T12:56:10,Bilbao,expenses,food,-94.46,-18414.3
buyer_1,Aitor,López,1996-08-10,17033061C,aitor.lópez@awesomecode.net,185417,ES44209556455181134018,3547.89,2022-09-25T18:08:42,Bilbao,expenses,leisure,-60.26,-18474.56
buyer_1,Aitor,López,1996-08-10,17033061C,aitor.lópez@awesomecode.net,185417,ES44209556455181134018,3547.89,2022-09-28T19:59:05,Bilbao,expenses,cash,-100.0,-18574.56
buyer_1,Aitor,López,1996-08-10,17033061C,aitor.lópez@awesomecode.net,185417,ES44209556455181134018,3547.89,2022-09-29T10:31:58,Bilbao,expenses,transport,-69.93,-18644.49
buyer_1,Aitor,López,1996-08-10,17033061C,aitor.lópez@awesomecode.net,185417,ES44209556455181134018,3547.89,2022-09-29T04:22:04,Bilbao,expenses,cash,-100.0,-18744.49
buyer_1,Aitor,López,1996-08-10,17033061C,aitor.lópez@awesomecode.net,185417,ES44209556455181134018,3547.89,2022-09-29T23:32:37,Bilbao,expenses,repairs,-145.46,-18889.95
buyer_1,Aitor,López,1996-08-10,17033061C,aitor.lópez@awesomecode.net,185417,ES44209556455181134018,3547.89,2022-10-01T15:39:41,Bilbao,incomes,salary,2495.84,-16394.11
buyer_1,Aitor,López,1996-08-10,17033061C,aitor.lópez@awesomecode.net,185417,ES44209556455181134018,3547.89,2022-10-02T13:01:12,Bilbao,expenses,education,-49.3,-16443.41
buyer_1,Aitor,López,1996-08-10,17033061C,aitor.lópez@awesomecode.net,185417,ES44209556455181134018,3547.89,2022-10-03T10:42:31,Bilbao,expenses,transport,-65.69,-16509.1
buyer_1,Aitor,López,1996-08-10,17033061C,aitor.lópez@awesomecode.net,185417,ES44209556455181134018,3547.89,2022-10-03T17:54:09,Bilbao,expenses,cash,-100.0,-16609.1
buyer_1,Aitor,López,1996-08-10,17033061C,aitor.lópez@awesomecode.net,185417,ES44209556455181134018,3547.89,2022-10-04T02:22:57,Bilbao,expenses,food,-124.63,-16733.73
buyer_1,Aitor,López,1996-08-10,17033061C,aitor.lópez@awesomecode.net,185417,ES44209556455181134018,3547.89,2022-10-05T17:26:38,Bilbao,expenses,rent,-865.66,-17599.39
buyer_1,Aitor,López,1996-08-10,17033061C,aitor.lópez@awesomecode.net,185417,ES44209556455181134018,3547.89,2022-10-05T14:38:08,Bilbao,expenses,gas,-57.18,-17656.57
buyer_1,Aitor,López,1996-08-10,17033061C,aitor.lópez@awesomecode.net,185417,ES44209556455181134018,3547.89,2022-10-05T08:48:47,Bilbao,expenses,cash,-100.0,-17756.57
buyer_1,Aitor,López,1996-08-10,17033061C,aitor.lópez@awesomecode.net,185417,ES44209556455181134018,3547.89,2022-10-06T17:42:56,Bilbao,expenses,internet,-52.41,-17808.98
buyer_1,Aitor,López,1996-08-10,17033061C,aitor.lópez@awesomecode.net,185417,ES44209556455181134018,3547.89,2022-10-07T16:58:30,Bilbao,expenses,electricity,-106.27,-17915.25
buyer_1,Aitor,López,1996-08-10,17033061C,aitor.lópez@awesomecode.net,185417,ES44209556455181134018,3547.89,2022-10-08T19:22:40,Bilbao,expenses,electricity,-81.84,-17997.09
buyer_1,Aitor,López,1996-08-10,17033061C,aitor.lópez@awesomecode.net,185417,ES44209556455181134018,3547.89,2022-10-08T20:10:48,Bilbao,expenses,gas,-50.54,-18047.63
buyer_1,Aitor,López,1996-08-10,17033061C,aitor.lópez@awesomecode.net,185417,ES44209556455181134018,3547.89,2022-10-08T19:10:30,Bilbao,expenses,internet,-52.41,-18100.04
buyer_1,Aitor,López,1996-08-10,17033061C,aitor.lópez@awesomecode.net,185417,ES44209556455181134018,3547.89,2022-10-09T10:59:16,Bilbao,expenses,cash,-100.0,-18200.04
buyer_1,Aitor,López,1996-08-10,17033061C,aitor.lópez@awesomecode.net,185417,ES44209556455181134018,3547.89,2022-10-09T13:22:31,Bilbao,expenses,travel,-444.72,-18644.76
buyer_1,Aitor,López,1996-08-10,17033061C,aitor.lópez@awesomecode.net,185417,ES44209556455181134018,3547.89,2022-10-12T08:39:24,Bilbao,expenses,transport,-73.34,-18718.1
buyer_1,Aitor,López,1996-08-10,17033061C,aitor.lópez@awesomecode.net,185417,ES44209556455181134018,3547.89,2022-10-14T20:43:11,Bilbao,expenses,food,-95.04,-18813.14
buyer_1,Aitor,López,1996-08-10,17033061C,aitor.lópez@awesomecode.net,185417,ES44209556455181134018,3547.89,2022-10-15T15:34:34,Bilbao,expenses,transport,-55.64,-18868.78
buyer_1,Aitor,López,1996-08-10,17033061C,aitor.lópez@awesomecode.net,185417,ES44209556455181134018,3547.89,2022-10-16T14:45:15,Bilbao,expenses,cash,-100.0,-18968.78
buyer_1,Aitor,López,1996-08-10,17033061C,aitor.lópez@awesomecode.net,185417,ES44209556455181134018,3547.89,2022-10-17T21:32:43,Bilbao,expenses,transport,-78.27,-19047.05
buyer_1,Aitor,López,1996-08-10,17033061C,aitor.lópez@awesomecode.net,185417,ES44209556455181134018,3547.89,2022-10-19T12:38:24,Bilbao,expenses,leisure,-57.5,-19104.55
buyer_1,Aitor,López,1996-08-10,17033061C,aitor.lópez@awesomecode.net,185417,ES44209556455181134018,3547.89,2022-10-21T12:14:49,Bilbao,expenses,cash,-100.0,-19204.55
buyer_1,Aitor,López,1996-08-10,17033061C,aitor.lópez@awesomecode.net,185417,ES44209556455181134018,3547.89,2022-10-21T06:54:19,Bilbao,expenses,repairs,-172.71,-19377.26
buyer_1,Aitor,López,1996-08-10,17033061C,aitor.lópez@awesomecode.net,185417,ES44209556455181134018,3547.89,2022-10-22T17:33:18,Bilbao,expenses,transport,-66.5,-19443.76
buyer_1,Aitor,López,1996-08-10,17033061C,aitor.lópez@awesomecode.net,185417,ES44209556455181134018,3547.89,2022-10-22T11:27:44,Bilbao,expenses,leisure,-24.77,-19468.53
buyer_1,Aitor,López,1996-08-10,17033061C,aitor.lópez@awesomecode.net,185417,ES44209556455181134018,3547.89,2022-10-23T09:03:33,Bilbao,expenses,education,-64.0,-19532.53
buyer_1,Aitor,López,1996-08-10,17033061C,aitor.lópez@awesomecode.net,185417,ES44209556455181134018,3547.89,2022-10-23T13:27:39,Bilbao,expenses,cash,-100.0,-19632.53
buyer_1,Aitor,López,1996-08-10,17033061C,aitor.lópez@awesomecode.net,185417,ES44209556455181134018,3547.89,2022-10-23T15:40:03,Bilbao,expenses,appliances,-399.52,-20032.05
buyer_1,Aitor,López,1996-08-10,17033061C,aitor.lópez@awesomecode.net,185417,ES44209556455181134018,3547.89,2022-10-25T16:41:39,Bilbao,expenses,repairs,-259.48,-20291.53
buyer_1,Aitor,López,1996-08-10,17033061C,aitor.lópez@awesomecode.net,185417,ES44209556455181134018,3547.89,2022-10-29T12:05:39,Bilbao,expenses,gifts,-759.6,-21051.13
buyer_1,Aitor,López,1996-08-10,17033061C,aitor.lópez@awesomecode.net,185417,ES44209556455181134018,3547.89,2022-11-01T10:10:36,Bilbao,incomes,salary,2495.84,-18555.29
buyer_1,Aitor,López,1996-08-10,17033061C,aitor.lópez@awesomecode.net,185417,ES44209556455181134018,3547.89,2022-11-01T12:14:22,Bilbao,expenses,leisure,-61.56,-18616.85
buyer_1,Aitor,López,1996-08-10,17033061C,aitor.lópez@awesomecode.net,185417,ES44209556455181134018,3547.89,2022-11-01T11:54:50,Bilbao,expenses,cash,-100.0,-18716.85
buyer_1,Aitor,López,1996-08-10,17033061C,aitor.lópez@awesomecode.net,185417,ES44209556455181134018,3547.89,2022-11-02T14:57:46,Bilbao,expenses,cash,-100.0,-18816.85
buyer_1,Aitor,López,1996-08-10,17033061C,aitor.lópez@awesomecode.net,185417,ES44209556455181134018,3547.89,2022-11-03T15:04:22,Bilbao,expenses,appliances,-172.59,-18989.44
buyer_1,Aitor,López,1996-08-10,17033061C,aitor.lópez@awesomecode.net,185417,ES44209556455181134018,3547.89,2022-11-05T20:25:56,Bilbao,expenses,rent,-865.66,-19855.1
buyer_1,Aitor,López,1996-08-10,17033061C,aitor.lópez@awesomecode.net,185417,ES44209556455181134018,3547.89,2022-11-05T13:33:14,Bilbao,expenses,electricity,-99.09,-19954.19
buyer_1,Aitor,López,1996-08-10,17033061C,aitor.lópez@awesomecode.net,185417,ES44209556455181134018,3547.89,2022-11-05T11:02:28,Bilbao,expenses,gas,-78.91,-20033.1
buyer_1,Aitor,López,1996-08-10,17033061C,aitor.lópez@awesomecode.net,185417,ES44209556455181134018,3547.89,2022-11-07T08:25:02,Bilbao,expenses,electricity,-30.26,-20063.36
buyer_1,Aitor,López,1996-08-10,17033061C,aitor.lópez@awesomecode.net,185417,ES44209556455181134018,3547.89,2022-11-07T18:21:13,Bilbao,expenses,gas,-134.9,-20198.26
buyer_1,Aitor,López,1996-08-10,17033061C,aitor.lópez@awesomecode.net,185417,ES44209556455181134018,3547.89,2022-11-08T16:49:08,Bilbao,expenses,electricity,-39.39,-20237.65
buyer_1,Aitor,López,1996-08-10,17033061C,aitor.lópez@awesomecode.net,185417,ES44209556455181134018,3547.89,2022-11-08T08:30:32,Bilbao,expenses,internet,-52.41,-20290.06
buyer_1,Aitor,López,1996-08-10,17033061C,aitor.lópez@awesomecode.net,185417,ES44209556455181134018,3547.89,2022-11-10T05:10:53,Bilbao,expenses,gifts,-51.66,-20341.72
buyer_1,Aitor,López,1996-08-10,17033061C,aitor.lópez@awesomecode.net,185417,ES44209556455181134018,3547.89,2022-11-11T15:06:19,Bilbao,expenses,transport,-46.89,-20388.61
buyer_1,Aitor,López,1996-08-10,17033061C,aitor.lópez@awesomecode.net,185417,ES44209556455181134018,3547.89,2022-11-12T05:19:23,Bilbao,expenses,cash,-100.0,-20488.61
buyer_1,Aitor,López,1996-08-10,17033061C,aitor.lópez@awesomecode.net,185417,ES44209556455181134018,3547.89,2022-11-13T08:48:26,Bilbao,expenses,food,-96.8,-20585.41
buyer_1,Aitor,López,1996-08-10,17033061C,aitor.lópez@awesomecode.net,185417,ES44209556455181134018,3547.89,2022-11-13T22:34:07,Bilbao,expenses,transport,-81.04,-20666.45
buyer_1,Aitor,López,1996-08-10,17033061C,aitor.lópez@awesomecode.net,185417,ES44209556455181134018,3547.89,2022-11-15T14:16:45,Bilbao,expenses,cash,-100.0,-20766.45
buyer_1,Aitor,López,1996-08-10,17033061C,aitor.lópez@awesomecode.net,185417,ES44209556455181134018,3547.89,2022-11-17T10:18:14,Bilbao,expenses,cash,-100.0,-20866.45
buyer_1,Aitor,López,1996-08-10,17033061C,aitor.lópez@awesomecode.net,185417,ES44209556455181134018,3547.89,2022-11-17T10:24:11,Bilbao,expenses,repairs,-235.02,-21101.47
buyer_1,Aitor,López,1996-08-10,17033061C,aitor.lópez@awesomecode.net,185417,ES44209556455181134018,3547.89,2022-11-18T14:40:11,Bilbao,expenses,cash,-100.0,-21201.47
buyer_1,Aitor,López,1996-08-10,17033061C,aitor.lópez@awesomecode.net,185417,ES44209556455181134018,3547.89,2022-11-20T20:29:15,Bilbao,expenses,food,-101.27,-21302.74
buyer_1,Aitor,López,1996-08-10,17033061C,aitor.lópez@awesomecode.net,185417,ES44209556455181134018,3547.89,2022-11-20T18:33:08,Bilbao,expenses,repairs,-71.47,-21374.21
buyer_1,Aitor,López,1996-08-10,17033061C,aitor.lópez@awesomecode.net,185417,ES44209556455181134018,3547.89,2022-11-21T23:03:02,Bilbao,expenses,leisure,-45.21,-21419.42
buyer_1,Aitor,López,1996-08-10,17033061C,aitor.lópez@awesomecode.net,185417,ES44209556455181134018,3547.89,2022-11-24T20:13:00,Bilbao,expenses,gifts,-387.72,-21807.14
buyer_1,Aitor,López,1996-08-10,17033061C,aitor.lópez@awesomecode.net,185417,ES44209556455181134018,3547.89,2022-11-25T11:45:46,Bilbao,expenses,leisure,-53.64,-21860.78
buyer_1,Aitor,López,1996-08-10,17033061C,aitor.lópez@awesomecode.net,185417,ES44209556455181134018,3547.89,2022-11-26T17:56:09,Bilbao,expenses,leisure,-18.88,-21879.66
buyer_1,Aitor,López,1996-08-10,17033061C,aitor.lópez@awesomecode.net,185417,ES44209556455181134018,3547.89,2022-11-27T20:15:10,Bilbao,expenses,food,-121.9,-22001.56
buyer_1,Aitor,López,1996-08-10,17033061C,aitor.lópez@awesomecode.net,185417,ES44209556455181134018,3547.89,2022-11-27T17:46:20,Bilbao,expenses,repairs,-51.08,-22052.64
buyer_1,Aitor,López,1996-08-10,17033061C,aitor.lópez@awesomecode.net,185417,ES44209556455181134018,3547.89,2022-11-28T15:51:23,Bilbao,expenses,food,-117.91,-22170.55
buyer_1,Aitor,López,1996-08-10,17033061C,aitor.lópez@awesomecode.net,185417,ES44209556455181134018,3547.89,2022-11-28T16:03:40,Bilbao,expenses,gifts,-825.8,-22996.35
buyer_1,Aitor,López,1996-08-10,17033061C,aitor.lópez@awesomecode.net,185417,ES44209556455181134018,3547.89,2022-11-29T11:53:54,Bilbao,expenses,leisure,-74.1,-23070.45
buyer_1,Aitor,López,1996-08-10,17033061C,aitor.lópez@awesomecode.net,185417,ES44209556455181134018,3547.89,2022-11-29T09:14:29,Bilbao,expenses,clothing,-109.74,-23180.19
buyer_1,Aitor,López,1996-08-10,17033061C,aitor.lópez@awesomecode.net,185417,ES44209556455181134018,3547.89,2022-11-29T08:29:32,Bilbao,expenses,cash,-100.0,-23280.19
buyer_1,Aitor,López,1996-08-10,17033061C,aitor.lópez@awesomecode.net,185417,ES44209556455181134018,3547.89,2022-11-30T13:13:02,Bilbao,expenses,cash,-100.0,-23380.19
buyer_1,Aitor,López,1996-08-10,17033061C,aitor.lópez@awesomecode.net,185417,ES44209556455181134018,3547.89,2022-12-01T10:38:36,Bilbao,incomes,salary,2495.84,-20884.35
buyer_1,Aitor,López,1996-08-10,17033061C,aitor.lópez@awesomecode.net,185417,ES44209556455181134018,3547.89,2022-12-01T10:38:36,Bilbao,incomes,extra_income,266.49,-20617.86
buyer_1,Aitor,López,1996-08-10,17033061C,aitor.lópez@awesomecode.net,185417,ES44209556455181134018,3547.89,2022-12-01T10:38:36,Bilbao,incomes,salary_bonus,1854.08,-18763.78
buyer_1,Aitor,López,1996-08-10,17033061C,aitor.lópez@awesomecode.net,185417,ES44209556455181134018,3547.89,2022-12-02T22:13:11,Bilbao,expenses,cash,-100.0,-18863.78
buyer_1,Aitor,López,1996-08-10,17033061C,aitor.lópez@awesomecode.net,185417,ES44209556455181134018,3547.89,2022-12-03T20:53:11,Bilbao,expenses,food,-101.25,-18965.03
buyer_1,Aitor,López,1996-08-10,17033061C,aitor.lópez@awesomecode.net,185417,ES44209556455181134018,3547.89,2022-12-04T19:15:53,Bilbao,expenses,repairs,-86.64,-19051.67
buyer_1,Aitor,López,1996-08-10,17033061C,aitor.lópez@awesomecode.net,185417,ES44209556455181134018,3547.89,2022-12-05T12:24:35,Bilbao,expenses,rent,-865.66,-19917.33
buyer_1,Aitor,López,1996-08-10,17033061C,aitor.lópez@awesomecode.net,185417,ES44209556455181134018,3547.89,2022-12-05T19:22:45,Bilbao,expenses,electricity,-109.56,-20026.89
buyer_1,Aitor,López,1996-08-10,17033061C,aitor.lópez@awesomecode.net,185417,ES44209556455181134018,3547.89,2022-12-05T23:12:20,Bilbao,expenses,transport,-54.58,-20081.47
buyer_1,Aitor,López,1996-08-10,17033061C,aitor.lópez@awesomecode.net,185417,ES44209556455181134018,3547.89,2022-12-06T13:00:35,Bilbao,expenses,phone,-38.72,-20120.19
buyer_1,Aitor,López,1996-08-10,17033061C,aitor.lópez@awesomecode.net,185417,ES44209556455181134018,3547.89,2022-12-07T14:52:29,Bilbao,expenses,internet,-52.41,-20172.6
buyer_1,Aitor,López,1996-08-10,17033061C,aitor.lópez@awesomecode.net,185417,ES44209556455181134018,3547.89,2022-12-07T14:00:23,Bilbao,expenses,phone,-48.82,-20221.42
buyer_1,Aitor,López,1996-08-10,17033061C,aitor.lópez@awesomecode.net,185417,ES44209556455181134018,3547.89,2022-12-07T20:12:39,Bilbao,expenses,repairs,-86.12,-20307.54
buyer_1,Aitor,López,1996-08-10,17033061C,aitor.lópez@awesomecode.net,185417,ES44209556455181134018,3547.89,2022-12-09T19:50:20,Bilbao,expenses,leisure,-31.2,-20338.74
buyer_1,Aitor,López,1996-08-10,17033061C,aitor.lópez@awesomecode.net,185417,ES44209556455181134018,3547.89,2022-12-09T16:53:30,Bilbao,expenses,gifts,-396.27,-20735.01
buyer_1,Aitor,López,1996-08-10,17033061C,aitor.lópez@awesomecode.net,185417,ES44209556455181134018,3547.89,2022-12-10T23:39:30,Bilbao,expenses,cash,-100.0,-20835.01
buyer_1,Aitor,López,1996-08-10,17033061C,aitor.lópez@awesomecode.net,185417,ES44209556455181134018,3547.89,2022-12-12T11:08:30,Bilbao,expenses,food,-61.18,-20896.19
buyer_1,Aitor,López,1996-08-10,17033061C,aitor.lópez@awesomecode.net,185417,ES44209556455181134018,3547.89,2022-12-15T22:52:46,Bilbao,expenses,cash,-100.0,-20996.19
buyer_1,Aitor,López,1996-08-10,17033061C,aitor.lópez@awesomecode.net,185417,ES44209556455181134018,3547.89,2022-12-15T19:23:26,Bilbao,expenses,appliances,-237.09,-21233.28
buyer_1,Aitor,López,1996-08-10,17033061C,aitor.lópez@awesomecode.net,185417,ES44209556455181134018,3547.89,2022-12-16T11:20:22,Bilbao,expenses,food,-99.07,-21332.35
buyer_1,Aitor,López,1996-08-10,17033061C,aitor.lópez@awesomecode.net,185417,ES44209556455181134018,3547.89,2022-12-16T16:47:25,Bilbao,expenses,transport,-47.94,-21380.29
buyer_1,Aitor,López,1996-08-10,17033061C,aitor.lópez@awesomecode.net,185417,ES44209556455181134018,3547.89,2022-12-17T12:27:51,Bilbao,expenses,repairs,-127.3,-21507.59
buyer_1,Aitor,López,1996-08-10,17033061C,aitor.lópez@awesomecode.net,185417,ES44209556455181134018,3547.89,2022-12-18T02:11:42,Bilbao,expenses,repairs,-220.87,-21728.46
buyer_1,Aitor,López,1996-08-10,17033061C,aitor.lópez@awesomecode.net,185417,ES44209556455181134018,3547.89,2022-12-20T22:36:50,Bilbao,expenses,food,-63.2,-21791.66
buyer_1,Aitor,López,1996-08-10,17033061C,aitor.lópez@awesomecode.net,185417,ES44209556455181134018,3547.89,2022-12-21T18:13:28,Bilbao,expenses,cash,-100.0,-21891.66
buyer_1,Aitor,López,1996-08-10,17033061C,aitor.lópez@awesomecode.net,185417,ES44209556455181134018,3547.89,2022-12-23T09:35:41,Bilbao,expenses,leisure,-59.34,-21951.0
buyer_1,Aitor,López,1996-08-10,17033061C,aitor.lópez@awesomecode.net,185417,ES44209556455181134018,3547.89,2022-12-23T11:36:58,Bilbao,expenses,repairs,-139.33,-22090.33
buyer_1,Aitor,López,1996-08-10,17033061C,aitor.lópez@awesomecode.net,185417,ES44209556455181134018,3547.89,2022-12-23T14:39:18,Bilbao,expenses,gifts,-67.59,-22157.92
buyer_1,Aitor,López,1996-08-10,17033061C,aitor.lópez@awesomecode.net,185417,ES44209556455181134018,3547.89,2022-12-24T20:13:35,Bilbao,expenses,cash,-100.0,-22257.92
buyer_1,Aitor,López,1996-08-10,17033061C,aitor.lópez@awesomecode.net,185417,ES44209556455181134018,3547.89,2022-12-24T21:55:52,Bilbao,expenses,repairs,-219.45,-22477.37
buyer_1,Aitor,López,1996-08-10,17033061C,aitor.lópez@awesomecode.net,185417,ES44209556455181134018,3547.89,2022-12-25T17:29:40,Bilbao,expenses,transport,-63.19,-22540.56
buyer_1,Aitor,López,1996-08-10,17033061C,aitor.lópez@awesomecode.net,185417,ES44209556455181134018,3547.89,2022-12-26T16:45:50,Bilbao,expenses,food,-119.07,-22659.63
buyer_1,Aitor,López,1996-08-10,17033061C,aitor.lópez@awesomecode.net,185417,ES44209556455181134018,3547.89,2022-12-26T21:12:48,Bilbao,expenses,repairs,-203.48,-22863.11
buyer_1,Aitor,López,1996-08-10,17033061C,aitor.lópez@awesomecode.net,185417,ES44209556455181134018,3547.89,2022-12-27T09:40:44,Bilbao,expenses,transport,-60.32,-22923.43
buyer_1,Aitor,López,1996-08-10,17033061C,aitor.lópez@awesomecode.net,185417,ES44209556455181134018,3547.89,2022-12-28T18:14:09,Bilbao,expenses,cash,-100.0,-23023.43
buyer_1,Aitor,López,1996-08-10,17033061C,aitor.lópez@awesomecode.net,185417,ES44209556455181134018,3547.89,2022-12-29T09:20:41,Bilbao,expenses,healthcare,-105.53,-23128.96
buyer_1,Aitor,López,1996-08-10,17033061C,aitor.lópez@awesomecode.net,185417,ES44209556455181134018,3547.89,2022-12-29T15:26:48,Bilbao,expenses,cash,-100.0,-23228.96
buyer_1,Aitor,López,1996-08-10,17033061C,aitor.lópez@awesomecode.net,185417,ES44209556455181134018,3547.89,2022-12-30T10:39:30,Bilbao,expenses,food,-112.99,-23341.95
buyer_1,Aitor,López,1996-08-10,17033061C,aitor.lópez@awesomecode.net,185417,ES44209556455181134018,3547.89,2023-01-01T21:01:29,Bilbao,incomes,salary,2581.67,-20760.28
buyer_1,Aitor,López,1996-08-10,17033061C,aitor.lópez@awesomecode.net,185417,ES44209556455181134018,3547.89,2023-01-01T18:40:50,Bilbao,expenses,clothing,-112.78,-20873.06
buyer_1,Aitor,López,1996-08-10,17033061C,aitor.lópez@awesomecode.net,185417,ES44209556455181134018,3547.89,2023-01-01T15:03:01,Bilbao,expenses,cash,-100.0,-20973.06
buyer_1,Aitor,López,1996-08-10,17033061C,aitor.lópez@awesomecode.net,185417,ES44209556455181134018,3547.89,2023-01-02T11:45:00,Bilbao,expenses,clothing,-105.69,-21078.75
buyer_1,Aitor,López,1996-08-10,17033061C,aitor.lópez@awesomecode.net,185417,ES44209556455181134018,3547.89,2023-01-02T11:56:15,Bilbao,expenses,repairs,-173.25,-21252.0
buyer_1,Aitor,López,1996-08-10,17033061C,aitor.lópez@awesomecode.net,185417,ES44209556455181134018,3547.89,2023-01-03T22:21:06,Bilbao,expenses,education,-53.75,-21305.75
buyer_1,Aitor,López,1996-08-10,17033061C,aitor.lópez@awesomecode.net,185417,ES44209556455181134018,3547.89,2023-01-05T09:35:30,Bilbao,expenses,rent,-842.94,-22148.69
buyer_1,Aitor,López,1996-08-10,17033061C,aitor.lópez@awesomecode.net,185417,ES44209556455181134018,3547.89,2023-01-05T16:20:53,Bilbao,expenses,water,-47.03,-22195.72
buyer_1,Aitor,López,1996-08-10,17033061C,aitor.lópez@awesomecode.net,185417,ES44209556455181134018,3547.89,2023-01-05T09:48:51,Bilbao,expenses,internet,-54.22,-22249.94
buyer_1,Aitor,López,1996-08-10,17033061C,aitor.lópez@awesomecode.net,185417,ES44209556455181134018,3547.89,2023-01-05T21:19:41,Bilbao,expenses,phone,-41.56,-22291.5
buyer_1,Aitor,López,1996-08-10,17033061C,aitor.lópez@awesomecode.net,185417,ES44209556455181134018,3547.89,2023-01-05T09:55:46,Bilbao,expenses,transport,-65.56,-22357.06
buyer_1,Aitor,López,1996-08-10,17033061C,aitor.lópez@awesomecode.net,185417,ES44209556455181134018,3547.89,2023-01-05T20:34:32,Bilbao,expenses,cash,-100.0,-22457.06
buyer_1,Aitor,López,1996-08-10,17033061C,aitor.lópez@awesomecode.net,185417,ES44209556455181134018,3547.89,2023-01-06T10:00:40,Bilbao,expenses,water,-51.71,-22508.77
buyer_1,Aitor,López,1996-08-10,17033061C,aitor.lópez@awesomecode.net,185417,ES44209556455181134018,3547.89,2023-01-06T19:24:54,Bilbao,expenses,phone,-47.39,-22556.16
buyer_1,Aitor,López,1996-08-10,17033061C,aitor.lópez@awesomecode.net,185417,ES44209556455181134018,3547.89,2023-01-06T18:14:23,Bilbao,expenses,appliances,-96.7,-22652.86
buyer_1,Aitor,López,1996-08-10,17033061C,aitor.lópez@awesomecode.net,185417,ES44209556455181134018,3547.89,2023-01-07T21:37:00,Bilbao,expenses,water,-38.26,-22691.12
buyer_1,Aitor,López,1996-08-10,17033061C,aitor.lópez@awesomecode.net,185417,ES44209556455181134018,3547.89,2023-01-07T19:08:21,Bilbao,expenses,electricity,-97.58,-22788.7
buyer_1,Aitor,López,1996-08-10,17033061C,aitor.lópez@awesomecode.net,185417,ES44209556455181134018,3547.89,2023-01-07T17:03:07,Bilbao,expenses,gas,-112.45,-22901.15
buyer_1,Aitor,López,1996-08-10,17033061C,aitor.lópez@awesomecode.net,185417,ES44209556455181134018,3547.89,2023-01-07T16:43:47,Bilbao,expenses,internet,-54.22,-22955.37
buyer_1,Aitor,López,1996-08-10,17033061C,aitor.lópez@awesomecode.net,185417,ES44209556455181134018,3547.89,2023-01-08T18:07:31,Bilbao,expenses,internet,-54.22,-23009.59
buyer_1,Aitor,López,1996-08-10,17033061C,aitor.lópez@awesomecode.net,185417,ES44209556455181134018,3547.89,2023-01-09T09:07:17,Bilbao,expenses,appliances,-143.43,-23153.02
buyer_1,Aitor,López,1996-08-10,17033061C,aitor.lópez@awesomecode.net,185417,ES44209556455181134018,3547.89,2023-01-11T15:20:45,Bilbao,expenses,leisure,-33.39,-23186.41
buyer_1,Aitor,López,1996-08-10,17033061C,aitor.lópez@awesomecode.net,185417,ES44209556455181134018,3547.89,2023-01-12T17:39:56,Bilbao,expenses,gifts,-267.61,-23454.02
buyer_1,Aitor,López,1996-08-10,17033061C,aitor.lópez@awesomecode.net,185417,ES44209556455181134018,3547.89,2023-01-13T17:22:24,Bilbao,expenses,cash,-100.0,-23554.02
buyer_1,Aitor,López,1996-08-10,17033061C,aitor.lópez@awesomecode.net,185417,ES44209556455181134018,3547.89,2023-01-14T19:09:58,Bilbao,expenses,cash,-100.0,-23654.02
buyer_1,Aitor,López,1996-08-10,17033061C,aitor.lópez@awesomecode.net,185417,ES44209556455181134018,3547.89,2023-01-15T19:02:33,Bilbao,expenses,transport,-78.66,-23732.68
buyer_1,Aitor,López,1996-08-10,17033061C,aitor.lópez@awesomecode.net,185417,ES44209556455181134018,3547.89,2023-01-15T09:51:55,Bilbao,expenses,education,-59.17,-23791.85
buyer_1,Aitor,López,1996-08-10,17033061C,aitor.lópez@awesomecode.net,185417,ES44209556455181134018,3547.89,2023-01-16T19:39:54,Bilbao,expenses,repairs,-310.79,-24102.64
buyer_1,Aitor,López,1996-08-10,17033061C,aitor.lópez@awesomecode.net,185417,ES44209556455181134018,3547.89,2023-01-17T20:44:13,Bilbao,expenses,cash,-100.0,-24202.64
buyer_1,Aitor,López,1996-08-10,17033061C,aitor.lópez@awesomecode.net,185417,ES44209556455181134018,3547.89,2023-01-19T09:24:30,Bilbao,expenses,gifts,-761.01,-24963.65
buyer_1,Aitor,López,1996-08-10,17033061C,aitor.lópez@awesomecode.net,185417,ES44209556455181134018,3547.89,2023-01-20T02:53:33,Bilbao,expenses,transport,-47.26,-25010.91
buyer_1,Aitor,López,1996-08-10,17033061C,aitor.lópez@awesomecode.net,185417,ES44209556455181134018,3547.89,2023-01-20T19:54:11,Bilbao,expenses,leisure,-82.86,-25093.77
buyer_1,Aitor,López,1996-08-10,17033061C,aitor.lópez@awesomecode.net,185417,ES44209556455181134018,3547.89,2023-01-20T19:41:26,Bilbao,expenses,clothing,-153.34,-25247.11
buyer_1,Aitor,López,1996-08-10,17033061C,aitor.lópez@awesomecode.net,185417,ES44209556455181134018,3547.89,2023-01-20T11:10:58,Bilbao,expenses,repairs,-143.8,-25390.91
buyer_1,Aitor,López,1996-08-10,17033061C,aitor.lópez@awesomecode.net,185417,ES44209556455181134018,3547.89,2023-01-22T23:23:56,Bilbao,expenses,cash,-100.0,-25490.91
buyer_1,Aitor,López,1996-08-10,17033061C,aitor.lópez@awesomecode.net,185417,ES44209556455181134018,3547.89,2023-01-23T19:42:28,Bilbao,expenses,food,-94.74,-25585.65
buyer_1,Aitor,López,1996-08-10,17033061C,aitor.lópez@awesomecode.net,185417,ES44209556455181134018,3547.89,2023-01-23T01:09:21,Bilbao,expenses,gifts,-424.78,-26010.43
buyer_1,Aitor,López,1996-08-10,17033061C,aitor.lópez@awesomecode.net,185417,ES44209556455181134018,3547.89,2023-01-25T16:23:48,Bilbao,expenses,cash,-100.0,-26110.43
buyer_1,Aitor,López,1996-08-10,17033061C,aitor.lópez@awesomecode.net,185417,ES44209556455181134018,3547.89,2023-01-27T18:03:34,Bilbao,expenses,transport,-48.16,-26158.59
buyer_1,Aitor,López,1996-08-10,17033061C,aitor.lópez@awesomecode.net,185417,ES44209556455181134018,3547.89,2023-01-27T16:24:55,Bilbao,expenses,healthcare,-150.43,-26309.02
buyer_1,Aitor,López,1996-08-10,17033061C,aitor.lópez@awesomecode.net,185417,ES44209556455181134018,3547.89,2023-01-27T21:22:15,Bilbao,expenses,cash,-100.0,-26409.02
buyer_1,Aitor,López,1996-08-10,17033061C,aitor.lópez@awesomecode.net,185417,ES44209556455181134018,3547.89,2023-01-28T16:20:37,Bilbao,expenses,gifts,-616.89,-27025.91
buyer_1,Aitor,López,1996-08-10,17033061C,aitor.lópez@awesomecode.net,185417,ES44209556455181134018,3547.89,2023-01-29T19:14:17,Bilbao,expenses,gifts,-232.69,-27258.6
buyer_1,Aitor,López,1996-08-10,17033061C,aitor.lópez@awesomecode.net,185417,ES44209556455181134018,3547.89,2023-01-31T12:03:29,Bilbao,expenses,food,-97.27,-27355.87
buyer_1,Aitor,López,1996-08-10,17033061C,aitor.lópez@awesomecode.net,185417,ES44209556455181134018,3547.89,2023-01-31T16:35:29,Bilbao,expenses,transport,-80.92,-27436.79
buyer_1,Aitor,López,1996-08-10,17033061C,aitor.lópez@awesomecode.net,185417,ES44209556455181134018,3547.89,2023-01-31T03:34:05,Bilbao,expenses,appliances,-187.11,-27623.9
buyer_1,Aitor,López,1996-08-10,17033061C,aitor.lópez@awesomecode.net,185417,ES44209556455181134018,3547.89,2023-02-01T14:47:18,Bilbao,incomes,salary,2581.67,-25042.23
buyer_1,Aitor,López,1996-08-10,17033061C,aitor.lópez@awesomecode.net,185417,ES44209556455181134018,3547.89,2023-02-01T11:56:34,Bilbao,expenses,leisure,-64.32,-25106.55
buyer_1,Aitor,López,1996-08-10,17033061C,aitor.lópez@awesomecode.net,185417,ES44209556455181134018,3547.89,2023-02-02T14:33:05,Bilbao,expenses,leisure,-49.88,-25156.43
buyer_1,Aitor,López,1996-08-10,17033061C,aitor.lópez@awesomecode.net,185417,ES44209556455181134018,3547.89,2023-02-03T23:07:28,Bilbao,expenses,leisure,-64.04,-25220.47
buyer_1,Aitor,López,1996-08-10,17033061C,aitor.lópez@awesomecode.net,185417,ES44209556455181134018,3547.89,2023-02-04T12:44:58,Bilbao,expenses,healthcare,-128.11,-25348.58
buyer_1,Aitor,López,1996-08-10,17033061C,aitor.lópez@awesomecode.net,185417,ES44209556455181134018,3547.89,2023-02-05T17:21:46,Bilbao,expenses,rent,-842.94,-26191.52
buyer_1,Aitor,López,1996-08-10,17033061C,aitor.lópez@awesomecode.net,185417,ES44209556455181134018,3547.89,2023-02-05T11:30:38,Bilbao,expenses,water,-41.9,-26233.42
buyer_1,Aitor,López,1996-08-10,17033061C,aitor.lópez@awesomecode.net,185417,ES44209556455181134018,3547.89,2023-02-05T11:33:58,Bilbao,expenses,gas,-138.59,-26372.01
buyer_1,Aitor,López,1996-08-10,17033061C,aitor.lópez@awesomecode.net,185417,ES44209556455181134018,3547.89,2023-02-05T20:00:30,Bilbao,expenses,cash,-100.0,-26472.01
buyer_1,Aitor,López,1996-08-10,17033061C,aitor.lópez@awesomecode.net,185417,ES44209556455181134018,3547.89,2023-02-06T02:04:28,Bilbao,expenses,phone,-39.28,-26511.29
buyer_1,Aitor,López,1996-08-10,17033061C,aitor.lópez@awesomecode.net,185417,ES44209556455181134018,3547.89,2023-02-06T16:09:19,Bilbao,expenses,cash,-100.0,-26611.29
buyer_1,Aitor,López,1996-08-10,17033061C,aitor.lópez@awesomecode.net,185417,ES44209556455181134018,3547.89,2023-02-07T16:06:22,Bilbao,expenses,electricity,-33.24,-26644.53
buyer_1,Aitor,López,1996-08-10,17033061C,aitor.lópez@awesomecode.net,185417,ES44209556455181134018,3547.89,2023-02-07T16:48:12,Bilbao,expenses,food,-74.44,-26718.97
buyer_1,Aitor,López,1996-08-10,17033061C,aitor.lópez@awesomecode.net,185417,ES44209556455181134018,3547.89,2023-02-08T09:11:15,Bilbao,expenses,electricity,-31.72,-26750.69
buyer_1,Aitor,López,1996-08-10,17033061C,aitor.lópez@awesomecode.net,185417,ES44209556455181134018,3547.89,2023-02-08T14:58:42,Bilbao,expenses,gas,-108.65,-26859.34
buyer_1,Aitor,López,1996-08-10,17033061C,aitor.lópez@awesomecode.net,185417,ES44209556455181134018,3547.89,2023-02-08T04:35:01,Bilbao,expenses,phone,-42.14,-26901.48
buyer_1,Aitor,López,1996-08-10,17033061C,aitor.lópez@awesomecode.net,185417,ES44209556455181134018,3547.89,2023-02-08T20:30:17,Bilbao,expenses,cash,-100.0,-27001.48
buyer_1,Aitor,López,1996-08-10,17033061C,aitor.lópez@awesomecode.net,185417,ES44209556455181134018,3547.89,2023-02-09T15:07:43,Bilbao,expenses,leisure,-40.94,-27042.42
buyer_1,Aitor,López,1996-08-10,17033061C,aitor.lópez@awesomecode.net,185417,ES44209556455181134018,3547.89,2023-02-11T10:39:40,Bilbao,expenses,cash,-100.0,-27142.42
buyer_1,Aitor,López,1996-08-10,17033061C,aitor.lópez@awesomecode.net,185417,ES44209556455181134018,3547.89,2023-02-19T13:14:11,Bilbao,expenses,food,-112.39,-27254.81
buyer_1,Aitor,López,1996-08-10,17033061C,aitor.lópez@awesomecode.net,185417,ES44209556455181134018,3547.89,2023-02-19T20:34:03,Bilbao,expenses,leisure,-79.52,-27334.33
buyer_1,Aitor,López,1996-08-10,17033061C,aitor.lópez@awesomecode.net,185417,ES44209556455181134018,3547.89,2023-02-19T16:22:46,Bilbao,expenses,repairs,-327.36,-27661.69
buyer_1,Aitor,López,1996-08-10,17033061C,aitor.lópez@awesomecode.net,185417,ES44209556455181134018,3547.89,2023-02-20T14:49:34,Bilbao,expenses,leisure,-56.07,-27717.76
buyer_1,Aitor,López,1996-08-10,17033061C,aitor.lópez@awesomecode.net,185417,ES44209556455181134018,3547.89,2023-02-20T12:28:52,Bilbao,expenses,cash,-100.0,-27817.76
buyer_1,Aitor,López,1996-08-10,17033061C,aitor.lópez@awesomecode.net,185417,ES44209556455181134018,3547.89,2023-02-21T09:38:47,Bilbao,expenses,food,-78.75,-27896.51
buyer_1,Aitor,López,1996-08-10,17033061C,aitor.lópez@awesomecode.net,185417,ES44209556455181134018,3547.89,2023-02-23T19:38:53,Bilbao,expenses,transport,-51.17,-27947.68
buyer_1,Aitor,López,1996-08-10,17033061C,aitor.lópez@awesomecode.net,185417,ES44209556455181134018,3547.89,2023-02-24T16:54:25,Bilbao,expenses,clothing,-78.83,-28026.51
buyer_1,Aitor,López,1996-08-10,17033061C,aitor.lópez@awesomecode.net,185417,ES44209556455181134018,3547.89,2023-02-24T08:37:17,Bilbao,expenses,gifts,-590.84,-28617.35
buyer_1,Aitor,López,1996-08-10,17033061C,aitor.lópez@awesomecode.net,185417,ES44209556455181134018,3547.89,2023-02-25T19:43:25,Bilbao,expenses,food,-77.23,-28694.58
buyer_1,Aitor,López,1996-08-10,17033061C,aitor.lópez@awesomecode.net,185417,ES44209556455181134018,3547.89,2023-02-26T20:17:28,Bilbao,expenses,leisure,-49.75,-28744.33
buyer_1,Aitor,López,1996-08-10,17033061C,aitor.lópez@awesomecode.net,185417,ES44209556455181134018,3547.89,2023-02-27T20:38:05,Bilbao,expenses,food,-81.64,-28825.97
buyer_1,Aitor,López,1996-08-10,17033061C,aitor.lópez@awesomecode.net,185417,ES44209556455181134018,3547.89,2023-02-28T08:22:51,Bilbao,expenses,leisure,-76.67,-28902.64
buyer_1,Aitor,López,1996-08-10,17033061C,aitor.lópez@awesomecode.net,185417,ES44209556455181134018,3547.89,2023-02-28T20:09:29,Bilbao,expenses,appliances,-214.66,-29117.3
buyer_1,Aitor,López,1996-08-10,17033061C,aitor.lópez@awesomecode.net,185417,ES44209556455181134018,3547.89,2023-03-01T19:13:39,Bilbao,incomes,salary,2581.67,-26535.63
buyer_1,Aitor,López,1996-08-10,17033061C,aitor.lópez@awesomecode.net,185417,ES44209556455181134018,3547.89,2023-03-01T20:14:37,Bilbao,expenses,repairs,-304.88,-26840.51
buyer_1,Aitor,López,1996-08-10,17033061C,aitor.lópez@awesomecode.net,185417,ES44209556455181134018,3547.89,2023-03-04T19:31:19,Bilbao,expenses,food,-67.03,-26907.54
buyer_1,Aitor,López,1996-08-10,17033061C,aitor.lópez@awesomecode.net,185417,ES44209556455181134018,3547.89,2023-03-05T13:29:53,Bilbao,expenses,rent,-842.94,-27750.48
buyer_1,Aitor,López,1996-08-10,17033061C,aitor.lópez@awesomecode.net,185417,ES44209556455181134018,3547.89,2023-03-05T20:49:16,Bilbao,expenses,water,-41.03,-27791.51
buyer_1,Aitor,López,1996-08-10,17033061C,aitor.lópez@awesomecode.net,185417,ES44209556455181134018,3547.89,2023-03-05T19:13:35,Bilbao,expenses,electricity,-96.65,-27888.16
buyer_1,Aitor,López,1996-08-10,17033061C,aitor.lópez@awesomecode.net,185417,ES44209556455181134018,3547.89,2023-03-05T08:13:05,Bilbao,expenses,gas,-128.63,-28016.79
buyer_1,Aitor,López,1996-08-10,17033061C,aitor.lópez@awesomecode.net,185417,ES44209556455181134018,3547.89,2023-03-05T08:10:08,Bilbao,expenses,phone,-54.41,-28071.2
buyer_1,Aitor,López,1996-08-10,17033061C,aitor.lópez@awesomecode.net,185417,ES44209556455181134018,3547.89,2023-03-06T17:32:34,Bilbao,expenses,gas,-80.66,-28151.86
buyer_1,Aitor,López,1996-08-10,17033061C,aitor.lópez@awesomecode.net,185417,ES44209556455181134018,3547.89,2023-03-06T16:35:41,Bilbao,expenses,internet,-54.22,-28206.08
buyer_1,Aitor,López,1996-08-10,17033061C,aitor.lópez@awesomecode.net,185417,ES44209556455181134018,3547.89,2023-03-07T12:07:26,Bilbao,expenses,electricity,-31.21,-28237.29
buyer_1,Aitor,López,1996-08-10,17033061C,aitor.lópez@awesomecode.net,185417,ES44209556455181134018,3547.89,2023-03-07T13:14:52,Bilbao,expenses,repairs,-310.45,-28547.74
buyer_1,Aitor,López,1996-08-10,17033061C,aitor.lópez@awesomecode.net,185417,ES44209556455181134018,3547.89,2023-03-08T09:59:53,Bilbao,expenses,internet,-54.22,-28601.96
buyer_1,Aitor,López,1996-08-10,17033061C,aitor.lópez@awesomecode.net,185417,ES44209556455181134018,3547.89,2023-03-08T18:56:41,Bilbao,expenses,transport,-75.55,-28677.51
buyer_1,Aitor,López,1996-08-10,17033061C,aitor.lópez@awesomecode.net,185417,ES44209556455181134018,3547.89,2023-03-08T09:35:23,Bilbao,expenses,cash,-100.0,-28777.51
buyer_1,Aitor,López,1996-08-10,17033061C,aitor.lópez@awesomecode.net,185417,ES44209556455181134018,3547.89,2023-03-09T15:03:56,Bilbao,expenses,healthcare,-142.86,-28920.37
buyer_1,Aitor,López,1996-08-10,17033061C,aitor.lópez@awesomecode.net,185417,ES44209556455181134018,3547.89,2023-03-09T18:58:04,Bilbao,expenses,repairs,-29.49,-28949.86
buyer_1,Aitor,López,1996-08-10,17033061C,aitor.lópez@awesomecode.net,185417,ES44209556455181134018,3547.89,2023-03-10T23:39:46,Bilbao,expenses,food,-120.32,-29070.18
buyer_1,Aitor,López,1996-08-10,17033061C,aitor.lópez@awesomecode.net,185417,ES44209556455181134018,3547.89,2023-03-11T13:07:41,Bilbao,expenses,appliances,-163.08,-29233.26
buyer_1,Aitor,López,1996-08-10,17033061C,aitor.lópez@awesomecode.net,185417,ES44209556455181134018,3547.89,2023-03-12T20:38:26,Bilbao,expenses,repairs,-280.22,-29513.48
buyer_1,Aitor,López,1996-08-10,17033061C,aitor.lópez@awesomecode.net,185417,ES44209556455181134018,3547.89,2023-03-14T13:56:51,Bilbao,expenses,travel,-839.42,-30352.9
buyer_1,Aitor,López,1996-08-10,17033061C,aitor.lópez@awesomecode.net,185417,ES44209556455181134018,3547.89,2023-03-15T21:34:17,Bilbao,expenses,repairs,-299.19,-30652.09
buyer_1,Aitor,López,1996-08-10,17033061C,aitor.lópez@awesomecode.net,185417,ES44209556455181134018,3547.89,2023-03-16T09:05:08,Bilbao,expenses,repairs,-216.91,-30869.0
buyer_1,Aitor,López,1996-08-10,17033061C,aitor.lópez@awesomecode.net,185417,ES44209556455181134018,3547.89,2023-03-17T11:54:12,Bilbao,expenses,transport,-83.69,-30952.69
buyer_1,Aitor,López,1996-08-10,17033061C,aitor.lópez@awesomecode.net,185417,ES44209556455181134018,3547.89,2023-03-19T11:56:55,Bilbao,expenses,food,-88.92,-31041.61
buyer_1,Aitor,López,1996-08-10,17033061C,aitor.lópez@awesomecode.net,185417,ES44209556455181134018,3547.89,2023-03-20T09:40:10,Bilbao,expenses,cash,-100.0,-31141.61
buyer_1,Aitor,López,1996-08-10,17033061C,aitor.lópez@awesomecode.net,185417,ES44209556455181134018,3547.89,2023-03-21T04:00:07,Bilbao,expenses,transport,-67.28,-31208.89
buyer_1,Aitor,López,1996-08-10,17033061C,aitor.lópez@awesomecode.net,185417,ES44209556455181134018,3547.89,2023-03-22T10:08:33,Bilbao,expenses,food,-95.47,-31304.36
buyer_1,Aitor,López,1996-08-10,17033061C,aitor.lópez@awesomecode.net,185417,ES44209556455181134018,3547.89,2023-03-22T15:48:16,Bilbao,expenses,appliances,-195.76,-31500.12
buyer_1,Aitor,López,1996-08-10,17033061C,aitor.lópez@awesomecode.net,185417,ES44209556455181134018,3547.89,2023-03-23T16:22:53,Bilbao,expenses,cash,-100.0,-31600.12
buyer_1,Aitor,López,1996-08-10,17033061C,aitor.lópez@awesomecode.net,185417,ES44209556455181134018,3547.89,2023-03-24T13:54:05,Bilbao,expenses,travel,-800.13,-32400.25
buyer_1,Aitor,López,1996-08-10,17033061C,aitor.lópez@awesomecode.net,185417,ES44209556455181134018,3547.89,2023-03-25T16:15:44,Bilbao,expenses,leisure,-43.46,-32443.71
buyer_1,Aitor,López,1996-08-10,17033061C,aitor.lópez@awesomecode.net,185417,ES44209556455181134018,3547.89,2023-03-30T13:32:23,Bilbao,expenses,healthcare,-132.36,-32576.07
buyer_1,Aitor,López,1996-08-10,17033061C,aitor.lópez@awesomecode.net,185417,ES44209556455181134018,3547.89,2023-03-30T14:28:34,Bilbao,expenses,gifts,-337.07,-32913.14
buyer_1,Aitor,López,1996-08-10,17033061C,aitor.lópez@awesomecode.net,185417,ES44209556455181134018,3547.89,2023-04-01T09:10:35,Bilbao,incomes,salary,2581.67,-30331.47
buyer_1,Aitor,López,1996-08-10,17033061C,aitor.lópez@awesomecode.net,185417,ES44209556455181134018,3547.89,2023-04-01T09:10:35,Bilbao,incomes,extra_income,266.49,-30064.98
buyer_1,Aitor,López,1996-08-10,17033061C,aitor.lópez@awesomecode.net,185417,ES44209556455181134018,3547.89,2023-04-01T15:37:08,Bilbao,expenses,food,-82.34,-30147.32
buyer_1,Aitor,López,1996-08-10,17033061C,aitor.lópez@awesomecode.net,185417,ES44209556455181134018,3547.89,2023-04-02T14:13:17,Bilbao,expenses,leisure,-45.0,-30192.32
buyer_1,Aitor,López,1996-08-10,17033061C,aitor.lópez@awesomecode.net,185417,ES44209556455181134018,3547.89,2023-04-02T10:53:32,Bilbao,expenses,clothing,-145.67,-30337.99
buyer_1,Aitor,López,1996-08-10,17033061C,aitor.lópez@awesomecode.net,185417,ES44209556455181134018,3547.89,2023-04-03T19:26:32,Bilbao,expenses,cash,-100.0,-30437.99
buyer_1,Aitor,López,1996-08-10,17033061C,aitor.lópez@awesomecode.net,185417,ES44209556455181134018,3547.89,2023-04-05T10:44:26,Bilbao,expenses,rent,-842.94,-31280.93
buyer_1,Aitor,López,1996-08-10,17033061C,aitor.lópez@awesomecode.net,185417,ES44209556455181134018,3547.89,2023-04-05T19:51:45,Bilbao,expenses,phone,-45.9,-31326.83
buyer_1,Aitor,López,1996-08-10,17033061C,aitor.lópez@awesomecode.net,185417,ES44209556455181134018,3547.89,2023-04-05T10:41:47,Bilbao,expenses,transport,-54.15,-31380.98
buyer_1,Aitor,López,1996-08-10,17033061C,aitor.lópez@awesomecode.net,185417,ES44209556455181134018,3547.89,2023-04-06T12:58:36,Bilbao,expenses,electricity,-33.81,-31414.79
buyer_1,Aitor,López,1996-08-10,17033061C,aitor.lópez@awesomecode.net,185417,ES44209556455181134018,3547.89,2023-04-06T16:14:59,Bilbao,expenses,phone,-54.99,-31469.78
buyer_1,Aitor,López,1996-08-10,17033061C,aitor.lópez@awesomecode.net,185417,ES44209556455181134018,3547.89,2023-04-06T10:36:57,Bilbao,expenses,leisure,-49.46,-31519.24
buyer_1,Aitor,López,1996-08-10,17033061C,aitor.lópez@awesomecode.net,185417,ES44209556455181134018,3547.89,2023-04-08T08:32:51,Bilbao,expenses,water,-39.65,-31558.89
buyer_1,Aitor,López,1996-08-10,17033061C,aitor.lópez@awesomecode.net,185417,ES44209556455181134018,3547.89,2023-04-08T09:03:55,Bilbao,expenses,electricity,-77.84,-31636.73
buyer_1,Aitor,López,1996-08-10,17033061C,aitor.lópez@awesomecode.net,185417,ES44209556455181134018,3547.89,2023-04-08T15:52:30,Bilbao,expenses,internet,-54.22,-31690.95
buyer_1,Aitor,López,1996-08-10,17033061C,aitor.lópez@awesomecode.net,185417,ES44209556455181134018,3547.89,2023-04-08T14:57:11,Bilbao,expenses,cash,-100.0,-31790.95
buyer_1,Aitor,López,1996-08-10,17033061C,aitor.lópez@awesomecode.net,185417,ES44209556455181134018,3547.89,2023-04-09T19:08:14,Bilbao,expenses,cash,-100.0,-31890.95
buyer_1,Aitor,López,1996-08-10,17033061C,aitor.lópez@awesomecode.net,185417,ES44209556455181134018,3547.89,2023-04-10T15:33:23,Bilbao,expenses,leisure,-82.09,-31973.04
buyer_1,Aitor,López,1996-08-10,17033061C,aitor.lópez@awesomecode.net,185417,ES44209556455181134018,3547.89,2023-04-11T12:19:01,Bilbao,expenses,transport,-62.72,-32035.76
buyer_1,Aitor,López,1996-08-10,17033061C,aitor.lópez@awesomecode.net,185417,ES44209556455181134018,3547.89,2023-04-13T23:49:01,Bilbao,expenses,repairs,-148.92,-32184.68
buyer_1,Aitor,López,1996-08-10,17033061C,aitor.lópez@awesomecode.net,185417,ES44209556455181134018,3547.89,2023-04-14T14:36:34,Bilbao,expenses,food,-71.58,-32256.26
buyer_1,Aitor,López,1996-08-10,17033061C,aitor.lópez@awesomecode.net,185417,ES44209556455181134018,3547.89,2023-04-16T17:07:18,Bilbao,expenses,food,-116.5,-32372.76
buyer_1,Aitor,López,1996-08-10,17033061C,aitor.lópez@awesomecode.net,185417,ES44209556455181134018,3547.89,2023-04-16T21:21:59,Bilbao,expenses,leisure,-29.76,-32402.52
buyer_1,Aitor,López,1996-08-10,17033061C,aitor.lópez@awesomecode.net,185417,ES44209556455181134018,3547.89,2023-04-16T11:39:00,Bilbao,expenses,repairs,-88.63,-32491.15
buyer_1,Aitor,López,1996-08-10,17033061C,aitor.lópez@awesomecode.net,185417,ES44209556455181134018,3547.89,2023-04-18T12:52:20,Bilbao,expenses,leisure,-75.86,-32567.01
buyer_1,Aitor,López,1996-08-10,17033061C,aitor.lópez@awesomecode.net,185417,ES44209556455181134018,3547.89,2023-04-20T14:56:01,Bilbao,expenses,clothing,-81.77,-32648.78
buyer_1,Aitor,López,1996-08-10,17033061C,aitor.lópez@awesomecode.net,185417,ES44209556455181134018,3547.89,2023-04-21T15:18:39,Bilbao,expenses,food,-94.79,-32743.57
buyer_1,Aitor,López,1996-08-10,17033061C,aitor.lópez@awesomecode.net,185417,ES44209556455181134018,3547.89,2023-04-21T05:10:36,Bilbao,expenses,cash,-100.0,-32843.57
buyer_1,Aitor,López,1996-08-10,17033061C,aitor.lópez@awesomecode.net,185417,ES44209556455181134018,3547.89,2023-04-22T13:16:53,Bilbao,expenses,food,-109.32,-32952.89
buyer_1,Aitor,López,1996-08-10,17033061C,aitor.lópez@awesomecode.net,185417,ES44209556455181134018,3547.89,2023-04-22T15:15:34,Bilbao,expenses,transport,-71.03,-33023.92
buyer_1,Aitor,López,1996-08-10,17033061C,aitor.lópez@awesomecode.net,185417,ES44209556455181134018,3547.89,2023-04-22T11:47:48,Bilbao,expenses,cash,-100.0,-33123.92
buyer_1,Aitor,López,1996-08-10,17033061C,aitor.lópez@awesomecode.net,185417,ES44209556455181134018,3547.89,2023-04-25T17:11:22,Bilbao,expenses,food,-97.4,-33221.32
buyer_1,Aitor,López,1996-08-10,17033061C,aitor.lópez@awesomecode.net,185417,ES44209556455181134018,3547.89,2023-04-27T17:54:02,Bilbao,expenses,leisure,-62.21,-33283.53
buyer_1,Aitor,López,1996-08-10,17033061C,aitor.lópez@awesomecode.net,185417,ES44209556455181134018,3547.89,2023-04-27T08:32:07,Bilbao,expenses,gifts,-503.42,-33786.95
buyer_1,Aitor,López,1996-08-10,17033061C,aitor.lópez@awesomecode.net,185417,ES44209556455181134018,3547.89,2023-05-01T15:06:49,Bilbao,incomes,salary,2581.67,-31205.28
buyer_1,Aitor,López,1996-08-10,17033061C,aitor.lópez@awesomecode.net,185417,ES44209556455181134018,3547.89,2023-05-01T14:02:31,Bilbao,expenses,clothing,-77.14,-31282.42
buyer_1,Aitor,López,1996-08-10,17033061C,aitor.lópez@awesomecode.net,185417,ES44209556455181134018,3547.89,2023-05-02T16:11:05,Bilbao,expenses,cash,-100.0,-31382.42
buyer_1,Aitor,López,1996-08-10,17033061C,aitor.lópez@awesomecode.net,185417,ES44209556455181134018,3547.89,2023-05-03T15:32:58,Bilbao,expenses,travel,-725.34,-32107.76
buyer_1,Aitor,López,1996-08-10,17033061C,aitor.lópez@awesomecode.net,185417,ES44209556455181134018,3547.89,2023-05-03T15:23:44,Bilbao,expenses,repairs,-62.64,-32170.4
buyer_1,Aitor,López,1996-08-10,17033061C,aitor.lópez@awesomecode.net,185417,ES44209556455181134018,3547.89,2023-05-04T18:41:11,Bilbao,expenses,cash,-100.0,-32270.4
buyer_1,Aitor,López,1996-08-10,17033061C,aitor.lópez@awesomecode.net,185417,ES44209556455181134018,3547.89,2023-05-04T09:34:18,Bilbao,expenses,gifts,-768.35,-33038.75
buyer_1,Aitor,López,1996-08-10,17033061C,aitor.lópez@awesomecode.net,185417,ES44209556455181134018,3547.89,2023-05-05T23:54:42,Bilbao,expenses,rent,-842.94,-33881.69
buyer_1,Aitor,López,1996-08-10,17033061C,aitor.lópez@awesomecode.net,185417,ES44209556455181134018,3547.89,2023-05-05T14:56:50,Bilbao,expenses,water,-50.24,-33931.93
buyer_1,Aitor,López,1996-08-10,17033061C,aitor.lópez@awesomecode.net,185417,ES44209556455181134018,3547.89,2023-05-07T17:41:39,Bilbao,expenses,gas,-114.79,-34046.72
buyer_1,Aitor,López,1996-08-10,17033061C,aitor.lópez@awesomecode.net,185417,ES44209556455181134018,3547.89,2023-05-07T01:29:06,Bilbao,expenses,cash,-100.0,-34146.72
buyer_1,Aitor,López,1996-08-10,17033061C,aitor.lópez@awesomecode.net,185417,ES44209556455181134018,3547.89,2023-05-08T14:34:07,Bilbao,expenses,electricity,-41.41,-34188.13
buyer_1,Aitor,López,1996-08-10,17033061C,aitor.lópez@awesomecode.net,185417,ES44209556455181134018,3547.89,2023-05-08T20:58:36,Bilbao,expenses,leisure,-81.03,-34269.16
buyer_1,Aitor,López,1996-08-10,17033061C,aitor.lópez@awesomecode.net,185417,ES44209556455181134018,3547.89,2023-05-08T12:27:58,Bilbao,expenses,education,-68.86,-34338.02
buyer_1,Aitor,López,1996-08-10,17033061C,aitor.lópez@awesomecode.net,185417,ES44209556455181134018,3547.89,2023-05-08T19:56:51,Bilbao,expenses,repairs,-169.54,-34507.56
buyer_1,Aitor,López,1996-08-10,17033061C,aitor.lópez@awesomecode.net,185417,ES44209556455181134018,3547.89,2023-05-09T12:29:42,Bilbao,expenses,gifts,-100.99,-34608.55
buyer_1,Aitor,López,1996-08-10,17033061C,aitor.lópez@awesomecode.net,185417,ES44209556455181134018,3547.89,2023-05-10T17:00:29,Bilbao,expenses,food,-101.92,-34710.47
buyer_1,Aitor,López,1996-08-10,17033061C,aitor.lópez@awesomecode.net,185417,ES44209556455181134018,3547.89,2023-05-10T14:54:35,Bilbao,expenses,transport,-61.75,-34772.22
buyer_1,Aitor,López,1996-08-10,17033061C,aitor.lópez@awesomecode.net,185417,ES44209556455181134018,3547.89,2023-05-10T22:55:45,Bilbao,expenses,repairs,-203.6,-34975.82
buyer_1,Aitor,López,1996-08-10,17033061C,aitor.lópez@awesomecode.net,185417,ES44209556455181134018,3547.89,2023-05-15T12:32:36,Bilbao,expenses,education,-74.91,-35050.73
buyer_1,Aitor,López,1996-08-10,17033061C,aitor.lópez@awesomecode.net,185417,ES44209556455181134018,3547.89,2023-05-16T12:51:54,Bilbao,expenses,transport,-46.33,-35097.06
buyer_1,Aitor,López,1996-08-10,17033061C,aitor.lópez@awesomecode.net,185417,ES44209556455181134018,3547.89,2023-05-16T16:29:09,Bilbao,expenses,leisure,-48.7,-35145.76
buyer_1,Aitor,López,1996-08-10,17033061C,aitor.lópez@awesomecode.net,185417,ES44209556455181134018,3547.89,2023-05-17T09:58:23,Bilbao,expenses,transport,-50.31,-35196.07
buyer_1,Aitor,López,1996-08-10,17033061C,aitor.lópez@awesomecode.net,185417,ES44209556455181134018,3547.89,2023-05-17T08:51:41,Bilbao,expenses,cash,-100.0,-35296.07
buyer_1,Aitor,López,1996-08-10,17033061C,aitor.lópez@awesomecode.net,185417,ES44209556455181134018,3547.89,2023-05-18T18:35:41,Bilbao,expenses,cash,-100.0,-35396.07
buyer_1,Aitor,López,1996-08-10,17033061C,aitor.lópez@awesomecode.net,185417,ES44209556455181134018,3547.89,2023-05-19T22:44:14,Bilbao,expenses,clothing,-96.59,-35492.66
buyer_1,Aitor,López,1996-08-10,17033061C,aitor.lópez@awesomecode.net,185417,ES44209556455181134018,3547.89,2023-05-19T12:16:09,Bilbao,expenses,education,-69.2,-35561.86
buyer_1,Aitor,López,1996-08-10,17033061C,aitor.lópez@awesomecode.net,185417,ES44209556455181134018,3547.89,2023-05-21T02:52:38,Bilbao,expenses,food,-106.78,-35668.64
buyer_1,Aitor,López,1996-08-10,17033061C,aitor.lópez@awesomecode.net,185417,ES44209556455181134018,3547.89,2023-05-23T02:57:22,Bilbao,expenses,transport,-46.36,-35715.0
buyer_1,Aitor,López,1996-08-10,17033061C,aitor.lópez@awesomecode.net,185417,ES44209556455181134018,3547.89,2023-05-25T14:38:08,Bilbao,expenses,appliances,-178.68,-35893.68
buyer_1,Aitor,López,1996-08-10,17033061C,aitor.lópez@awesomecode.net,185417,ES44209556455181134018,3547.89,2023-05-25T10:40:29,Bilbao,expenses,gifts,-77.66,-35971.34
buyer_1,Aitor,López,1996-08-10,17033061C,aitor.lópez@awesomecode.net,185417,ES44209556455181134018,3547.89,2023-05-28T04:26:29,Bilbao,expenses,food,-74.11,-36045.45
buyer_1,Aitor,López,1996-08-10,17033061C,aitor.lópez@awesomecode.net,185417,ES44209556455181134018,3547.89,2023-05-28T18:34:43,Bilbao,expenses,transport,-76.81,-36122.26
buyer_1,Aitor,López,1996-08-10,17033061C,aitor.lópez@awesomecode.net,185417,ES44209556455181134018,3547.89,2023-05-28T08:25:03,Bilbao,expenses,gifts,-635.77,-36758.03
buyer_1,Aitor,López,1996-08-10,17033061C,aitor.lópez@awesomecode.net,185417,ES44209556455181134018,3547.89,2023-05-29T12:21:16,Bilbao,expenses,clothing,-92.58,-36850.61
buyer_1,Aitor,López,1996-08-10,17033061C,aitor.lópez@awesomecode.net,185417,ES44209556455181134018,3547.89,2023-06-01T08:10:38,Bilbao,incomes,salary,2581.67,-34268.94
buyer_1,Aitor,López,1996-08-10,17033061C,aitor.lópez@awesomecode.net,185417,ES44209556455181134018,3547.89,2023-06-01T08:10:38,Bilbao,incomes,salary_bonus,1948.85,-32320.09
buyer_1,Aitor,López,1996-08-10,17033061C,aitor.lópez@awesomecode.net,185417,ES44209556455181134018,3547.89,2023-06-01T10:21:39,Bilbao,expenses,transport,-61.2,-32381.29
buyer_1,Aitor,López,1996-08-10,17033061C,aitor.lópez@awesomecode.net,185417,ES44209556455181134018,3547.89,2023-06-04T04:55:43,Bilbao,expenses,taxes,-2187.88,-34569.17
buyer_1,Aitor,López,1996-08-10,17033061C,aitor.lópez@awesomecode.net,185417,ES44209556455181134018,3547.89,2023-06-04T14:55:44,Bilbao,expenses,insurance,-655.29,-35224.46
buyer_1,Aitor,López,1996-08-10,17033061C,aitor.lópez@awesomecode.net,185417,ES44209556455181134018,3547.89,2023-06-04T11:38:22,Bilbao,expenses,repairs,-28.14,-35252.6
buyer_1,Aitor,López,1996-08-10,17033061C,aitor.lópez@awesomecode.net,185417,ES44209556455181134018,3547.89,2023-06-05T23:06:35,Bilbao,expenses,rent,-842.94,-36095.54
buyer_1,Aitor,López,1996-08-10,17033061C,aitor.lópez@awesomecode.net,185417,ES44209556455181134018,3547.89,2023-06-05T17:31:35,Bilbao,expenses,gas,-48.85,-36144.39
buyer_1,Aitor,López,1996-08-10,17033061C,aitor.lópez@awesomecode.net,185417,ES44209556455181134018,3547.89,2023-06-05T19:53:45,Bilbao,expenses,phone,-40.13,-36184.52
buyer_1,Aitor,López,1996-08-10,17033061C,aitor.lópez@awesomecode.net,185417,ES44209556455181134018,3547.89,2023-06-05T10:26:10,Bilbao,expenses,clothing,-143.02,-36327.54
buyer_1,Aitor,López,1996-08-10,17033061C,aitor.lópez@awesomecode.net,185417,ES44209556455181134018,3547.89,2023-06-06T19:21:54,Bilbao,expenses,internet,-54.22,-36381.76
buyer_1,Aitor,López,1996-08-10,17033061C,aitor.lópez@awesomecode.net,185417,ES44209556455181134018,3547.89,2023-06-07T06:45:25,Bilbao,expenses,phone,-39.38,-36421.14
buyer_1,Aitor,López,1996-08-10,17033061C,aitor.lópez@awesomecode.net,185417,ES44209556455181134018,3547.89,2023-06-08T00:28:23,Bilbao,expenses,water,-35.75,-36456.89
buyer_1,Aitor,López,1996-08-10,17033061C,aitor.lópez@awesomecode.net,185417,ES44209556455181134018,3547.89,2023-06-08T10:13:40,Bilbao,expenses,internet,-54.22,-36511.11
buyer_1,Aitor,López,1996-08-10,17033061C,aitor.lópez@awesomecode.net,185417,ES44209556455181134018,3547.89,2023-06-08T19:23:29,Bilbao,expenses,phone,-47.56,-36558.67
buyer_1,Aitor,López,1996-08-10,17033061C,aitor.lópez@awesomecode.net,185417,ES44209556455181134018,3547.89,2023-06-13T08:09:45,Bilbao,expenses,food,-96.29,-36654.96
buyer_1,Aitor,López,1996-08-10,17033061C,aitor.lópez@awesomecode.net,185417,ES44209556455181134018,3547.89,2023-06-13T09:08:14,Bilbao,expenses,transport,-54.29,-36709.25
buyer_1,Aitor,López,1996-08-10,17033061C,aitor.lópez@awesomecode.net,185417,ES44209556455181134018,3547.89,2023-06-14T12:37:14,Bilbao,expenses,cash,-100.0,-36809.25
buyer_1,Aitor,López,1996-08-10,17033061C,aitor.lópez@awesomecode.net,185417,ES44209556455181134018,3547.89,2023-06-15T19:50:10,Bilbao,expenses,leisure,-74.59,-36883.84
buyer_1,Aitor,López,1996-08-10,17033061C,aitor.lópez@awesomecode.net,185417,ES44209556455181134018,3547.89,2023-06-17T19:21:40,Bilbao,expenses,leisure,-21.12,-36904.96
buyer_1,Aitor,López,1996-08-10,17033061C,aitor.lópez@awesomecode.net,185417,ES44209556455181134018,3547.89,2023-06-17T14:18:57,Bilbao,expenses,clothing,-132.51,-37037.47
buyer_1,Aitor,López,1996-08-10,17033061C,aitor.lópez@awesomecode.net,185417,ES44209556455181134018,3547.89,2023-06-18T15:43:26,Bilbao,expenses,repairs,-28.94,-37066.41
buyer_1,Aitor,López,1996-08-10,17033061C,aitor.lópez@awesomecode.net,185417,ES44209556455181134018,3547.89,2023-06-21T16:58:43,Bilbao,expenses,repairs,-124.93,-37191.34
buyer_1,Aitor,López,1996-08-10,17033061C,aitor.lópez@awesomecode.net,185417,ES44209556455181134018,3547.89,2023-06-22T08:29:46,Bilbao,expenses,transport,-72.11,-37263.45
buyer_1,Aitor,López,1996-08-10,17033061C,aitor.lópez@awesomecode.net,185417,ES44209556455181134018,3547.89,2023-06-22T19:25:57,Bilbao,expenses,cash,-100.0,-37363.45
buyer_1,Aitor,López,1996-08-10,17033061C,aitor.lópez@awesomecode.net,185417,ES44209556455181134018,3547.89,2023-06-23T10:29:23,Bilbao,expenses,food,-64.91,-37428.36
buyer_1,Aitor,López,1996-08-10,17033061C,aitor.lópez@awesomecode.net,185417,ES44209556455181134018,3547.89,2023-06-24T04:28:31,Bilbao,expenses,clothing,-119.63,-37547.99
buyer_1,Aitor,López,1996-08-10,17033061C,aitor.lópez@awesomecode.net,185417,ES44209556455181134018,3547.89,2023-06-24T19:33:57,Bilbao,expenses,cash,-100.0,-37647.99
buyer_1,Aitor,López,1996-08-10,17033061C,aitor.lópez@awesomecode.net,185417,ES44209556455181134018,3547.89,2023-06-25T13:46:20,Bilbao,expenses,cash,-100.0,-37747.99
buyer_1,Aitor,López,1996-08-10,17033061C,aitor.lópez@awesomecode.net,185417,ES44209556455181134018,3547.89,2023-06-26T19:04:45,Bilbao,expenses,leisure,-82.89,-37830.88
buyer_1,Aitor,López,1996-08-10,17033061C,aitor.lópez@awesomecode.net,185417,ES44209556455181134018,3547.89,2023-06-29T06:19:42,Bilbao,expenses,cash,-100.0,-37930.88
buyer_1,Aitor,López,1996-08-10,17033061C,aitor.lópez@awesomecode.net,185417,ES44209556455181134018,3547.89,2023-06-30T22:54:00,Bilbao,expenses,leisure,-30.22,-37961.1
buyer_1,Aitor,López,1996-08-10,17033061C,aitor.lópez@awesomecode.net,185417,ES44209556455181134018,3547.89,2023-07-01T10:28:20,Bilbao,incomes,salary,2581.67,-35379.43
buyer_1,Aitor,López,1996-08-10,17033061C,aitor.lópez@awesomecode.net,185417,ES44209556455181134018,3547.89,2023-07-01T22:33:30,Bilbao,expenses,leisure,-72.94,-35452.37
buyer_1,Aitor,López,1996-08-10,17033061C,aitor.lópez@awesomecode.net,185417,ES44209556455181134018,3547.89,2023-07-01T23:17:54,Bilbao,expenses,gifts,-803.96,-36256.33
buyer_1,Aitor,López,1996-08-10,17033061C,aitor.lópez@awesomecode.net,185417,ES44209556455181134018,3547.89,2023-07-05T19:11:00,Bilbao,expenses,rent,-842.94,-37099.27
buyer_1,Aitor,López,1996-08-10,17033061C,aitor.lópez@awesomecode.net,185417,ES44209556455181134018,3547.89,2023-07-05T15:40:30,Bilbao,expenses,water,-31.17,-37130.44
buyer_1,Aitor,López,1996-08-10,17033061C,aitor.lópez@awesomecode.net,185417,ES44209556455181134018,3547.89,2023-07-05T12:29:37,Bilbao,expenses,phone,-48.61,-37179.05
buyer_1,Aitor,López,1996-08-10,17033061C,aitor.lópez@awesomecode.net,185417,ES44209556455181134018,3547.89,2023-07-05T18:51:50,Bilbao,expenses,transport,-59.02,-37238.07
buyer_1,Aitor,López,1996-08-10,17033061C,aitor.lópez@awesomecode.net,185417,ES44209556455181134018,3547.89,2023-07-06T15:27:59,Bilbao,expenses,water,-40.96,-37279.03
buyer_1,Aitor,López,1996-08-10,17033061C,aitor.lópez@awesomecode.net,185417,ES44209556455181134018,3547.89,2023-07-06T11:28:40,Bilbao,expenses,gas,-50.52,-37329.55
buyer_1,Aitor,López,1996-08-10,17033061C,aitor.lópez@awesomecode.net,185417,ES44209556455181134018,3547.89,2023-07-06T12:17:55,Bilbao,expenses,transport,-74.32,-37403.87
buyer_1,Aitor,López,1996-08-10,17033061C,aitor.lópez@awesomecode.net,185417,ES44209556455181134018,3547.89,2023-07-06T18:46:08,Bilbao,expenses,cash,-100.0,-37503.87
buyer_1,Aitor,López,1996-08-10,17033061C,aitor.lópez@awesomecode.net,185417,ES44209556455181134018,3547.89,2023-07-07T01:06:58,Bilbao,expenses,gas,-144.48,-37648.35
buyer_1,Aitor,López,1996-08-10,17033061C,aitor.lópez@awesomecode.net,185417,ES44209556455181134018,3547.89,2023-07-07T20:59:54,Bilbao,expenses,internet,-54.22,-37702.57
buyer_1,Aitor,López,1996-08-10,17033061C,aitor.lópez@awesomecode.net,185417,ES44209556455181134018,3547.89,2023-07-08T09:53:53,Bilbao,expenses,water,-52.08,-37754.65
buyer_1,Aitor,López,1996-08-10,17033061C,aitor.lópez@awesomecode.net,185417,ES44209556455181134018,3547.89,2023-07-08T13:25:42,Bilbao,expenses,gas,-120.6,-37875.25
buyer_1,Aitor,López,1996-08-10,17033061C,aitor.lópez@awesomecode.net,185417,ES44209556455181134018,3547.89,2023-07-08T14:57:12,Bilbao,expenses,phone,-44.58,-37919.83
buyer_1,Aitor,López,1996-08-10,17033061C,aitor.lópez@awesomecode.net,185417,ES44209556455181134018,3547.89,2023-07-08T12:01:58,Bilbao,expenses,cash,-100.0,-38019.83
buyer_1,Aitor,López,1996-08-10,17033061C,aitor.lópez@awesomecode.net,185417,ES44209556455181134018,3547.89,2023-07-09T09:11:28,Bilbao,expenses,leisure,-20.79,-38040.62
buyer_1,Aitor,López,1996-08-10,17033061C,aitor.lópez@awesomecode.net,185417,ES44209556455181134018,3547.89,2023-07-10T14:18:20,Bilbao,expenses,cash,-100.0,-38140.62
buyer_1,Aitor,López,1996-08-10,17033061C,aitor.lópez@awesomecode.net,185417,ES44209556455181134018,3547.89,2023-07-10T13:49:53,Bilbao,expenses,gifts,-779.43,-38920.05
buyer_1,Aitor,López,1996-08-10,17033061C,aitor.lópez@awesomecode.net,185417,ES44209556455181134018,3547.89,2023-07-11T19:04:56,Bilbao,expenses,leisure,-65.66,-38985.71
buyer_1,Aitor,López,1996-08-10,17033061C,aitor.lópez@awesomecode.net,185417,ES44209556455181134018,3547.89,2023-07-11T19:58:13,Bilbao,expenses,cash,-100.0,-39085.71
buyer_1,Aitor,López,1996-08-10,17033061C,aitor.lópez@awesomecode.net,185417,ES44209556455181134018,3547.89,2023-07-12T08:10:33,Bilbao,expenses,transport,-75.13,-39160.84
buyer_1,Aitor,López,1996-08-10,17033061C,aitor.lópez@awesomecode.net,185417,ES44209556455181134018,3547.89,2023-07-13T15:01:15,Bilbao,expenses,food,-81.46,-39242.3
buyer_1,Aitor,López,1996-08-10,17033061C,aitor.lópez@awesomecode.net,185417,ES44209556455181134018,3547.89,2023-07-14T14:49:06,Bilbao,expenses,healthcare,-141.1,-39383.4
buyer_1,Aitor,López,1996-08-10,17033061C,aitor.lópez@awesomecode.net,185417,ES44209556455181134018,3547.89,2023-07-15T11:28:56,Bilbao,expenses,cash,-100.0,-39483.4
buyer_1,Aitor,López,1996-08-10,17033061C,aitor.lópez@awesomecode.net,185417,ES44209556455181134018,3547.89,2023-07-16T12:17:23,Bilbao,expenses,healthcare,-158.29,-39641.69
buyer_1,Aitor,López,1996-08-10,17033061C,aitor.lópez@awesomecode.net,185417,ES44209556455181134018,3547.89,2023-07-21T19:41:16,Bilbao,expenses,education,-51.53,-39693.22
buyer_1,Aitor,López,1996-08-10,17033061C,aitor.lópez@awesomecode.net,185417,ES44209556455181134018,3547.89,2023-07-23T23:01:47,Bilbao,expenses,transport,-57.36,-39750.58
buyer_1,Aitor,López,1996-08-10,17033061C,aitor.lópez@awesomecode.net,185417,ES44209556455181134018,3547.89,2023-07-23T09:43:13,Bilbao,expenses,cash,-100.0,-39850.58
buyer_1,Aitor,López,1996-08-10,17033061C,aitor.lópez@awesomecode.net,185417,ES44209556455181134018,3547.89,2023-07-25T21:34:15,Bilbao,expenses,travel,-321.45,-40172.03
buyer_1,Aitor,López,1996-08-10,17033061C,aitor.lópez@awesomecode.net,185417,ES44209556455181134018,3547.89,2023-07-27T14:10:32,Bilbao,expenses,transport,-40.02,-40212.05
buyer_1,Aitor,López,1996-08-10,17033061C,aitor.lópez@awesomecode.net,185417,ES44209556455181134018,3547.89,2023-07-28T12:50:27,Bilbao,expenses,food,-75.97,-40288.02
buyer_1,Aitor,López,1996-08-10,17033061C,aitor.lópez@awesomecode.net,185417,ES44209556455181134018,3547.89,2023-07-28T09:26:09,Bilbao,expenses,leisure,-52.1,-40340.12
buyer_1,Aitor,López,1996-08-10,17033061C,aitor.lópez@awesomecode.net,185417,ES44209556455181134018,3547.89,2023-07-29T11:12:56,Bilbao,expenses,cash,-100.0,-40440.12
buyer_1,Aitor,López,1996-08-10,17033061C,aitor.lópez@awesomecode.net,185417,ES44209556455181134018,3547.89,2023-07-30T12:24:40,Bilbao,expenses,food,-73.11,-40513.23
buyer_1,Aitor,López,1996-08-10,17033061C,aitor.lópez@awesomecode.net,185417,ES44209556455181134018,3547.89,2023-07-31T10:23:53,Bilbao,expenses,clothing,-92.16,-40605.39
buyer_1,Aitor,López,1996-08-10,17033061C,aitor.lópez@awesomecode.net,185417,ES44209556455181134018,3547.89,2023-08-01T16:53:01,Bilbao,incomes,salary,2581.67,-38023.72
buyer_1,Aitor,López,1996-08-10,17033061C,aitor.lópez@awesomecode.net,185417,ES44209556455181134018,3547.89,2023-08-01T16:53:01,Bilbao,incomes,extra_income,266.49,-37757.23
buyer_1,Aitor,López,1996-08-10,17033061C,aitor.lópez@awesomecode.net,185417,ES44209556455181134018,3547.89,2023-08-01T07:20:03,Bilbao,expenses,clothing,-86.51,-37843.74
buyer_1,Aitor,López,1996-08-10,17033061C,aitor.lópez@awesomecode.net,185417,ES44209556455181134018,3547.89,2023-08-01T12:38:35,Bilbao,expenses,appliances,-294.35,-38138.09
buyer_1,Aitor,López,1996-08-10,17033061C,aitor.lópez@awesomecode.net,185417,ES44209556455181134018,3547.89,2023-08-02T10:55:22,Bilbao,expenses,transport,-71.63,-38209.72
buyer_1,Aitor,López,1996-08-10,17033061C,aitor.lópez@awesomecode.net,185417,ES44209556455181134018,3547.89,2023-08-04T08:29:12,Bilbao,expenses,appliances,-89.54,-38299.26
buyer_1,Aitor,López,1996-08-10,17033061C,aitor.lópez@awesomecode.net,185417,ES44209556455181134018,3547.89,2023-08-05T17:38:31,Bilbao,expenses,rent,-842.94,-39142.2
buyer_1,Aitor,López,1996-08-10,17033061C,aitor.lópez@awesomecode.net,185417,ES44209556455181134018,3547.89,2023-08-05T16:00:44,Bilbao,expenses,electricity,-77.18,-39219.38
buyer_1,Aitor,López,1996-08-10,17033061C,aitor.lópez@awesomecode.net,185417,ES44209556455181134018,3547.89,2023-08-07T12:58:11,Bilbao,expenses,water,-27.06,-39246.44
buyer_1,Aitor,López,1996-08-10,17033061C,aitor.lópez@awesomecode.net,185417,ES44209556455181134018,3547.89,2023-08-07T12:19:34,Bilbao,expenses,phone,-55.37,-39301.81
buyer_1,Aitor,López,1996-08-10,17033061C,aitor.lópez@awesomecode.net,185417,ES44209556455181134018,3547.89,2023-08-07T19:02:27,Bilbao,expenses,cash,-100.0,-39401.81
buyer_1,Aitor,López,1996-08-10,17033061C,aitor.lópez@awesomecode.net,185417,ES44209556455181134018,3547.89,2023-08-07T12:27:23,Bilbao,expenses,gifts,-224.89,-39626.7
buyer_1,Aitor,López,1996-08-10,17033061C,aitor.lópez@awesomecode.net,185417,ES44209556455181134018,3547.89,2023-08-08T11:47:22,Bilbao,expenses,water,-37.74,-39664.44
buyer_1,Aitor,López,1996-08-10,17033061C,aitor.lópez@awesomecode.net,185417,ES44209556455181134018,3547.89,2023-08-08T17:57:40,Bilbao,expenses,phone,-55.67,-39720.11
buyer_1,Aitor,López,1996-08-10,17033061C,aitor.lópez@awesomecode.net,185417,ES44209556455181134018,3547.89,2023-08-08T09:41:44,Bilbao,expenses,food,-96.6,-39816.71
buyer_1,Aitor,López,1996-08-10,17033061C,aitor.lópez@awesomecode.net,185417,ES44209556455181134018,3547.89,2023-08-08T20:03:32,Bilbao,expenses,cash,-100.0,-39916.71
buyer_1,Aitor,López,1996-08-10,17033061C,aitor.lópez@awesomecode.net,185417,ES44209556455181134018,3547.89,2023-08-09T17:58:50,Bilbao,expenses,transport,-84.47,-40001.18
buyer_1,Aitor,López,1996-08-10,17033061C,aitor.lópez@awesomecode.net,185417,ES44209556455181134018,3547.89,2023-08-09T14:15:27,Bilbao,expenses,leisure,-45.42,-40046.6
buyer_1,Aitor,López,1996-08-10,17033061C,aitor.lópez@awesomecode.net,185417,ES44209556455181134018,3547.89,2023-08-10T18:36:21,Bilbao,expenses,clothing,-49.6,-40096.2
buyer_1,Aitor,López,1996-08-10,17033061C,aitor.lópez@awesomecode.net,185417,ES44209556455181134018,3547.89,2023-08-15T10:38:37,Bilbao,expenses,transport,-59.68,-40155.88
buyer_1,Aitor,López,1996-08-10,17033061C,aitor.lópez@awesomecode.net,185417,ES44209556455181134018,3547.89,2023-08-16T10:47:48,Bilbao,expenses,food,-62.02,-40217.9
buyer_1,Aitor,López,1996-08-10,17033061C,aitor.lópez@awesomecode.net,185417,ES44209556455181134018,3547.89,2023-08-17T22:22:18,Bilbao,expenses,cash,-100.0,-40317.9
buyer_1,Aitor,López,1996-08-10,17033061C,aitor.lópez@awesomecode.net,185417,ES44209556455181134018,3547.89,2023-08-17T21:20:36,Bilbao,expenses,gifts,-322.19,-40640.09
buyer_1,Aitor,López,1996-08-10,17033061C,aitor.lópez@awesomecode.net,185417,ES44209556455181134018,3547.89,2023-08-19T20:38:55,Bilbao,expenses,cash,-100.0,-40740.09
buyer_1,Aitor,López,1996-08-10,17033061C,aitor.lópez@awesomecode.net,185417,ES44209556455181134018,3547.89,2023-08-21T18:27:16,Bilbao,expenses,food,-77.36,-40817.45
buyer_1,Aitor,López,1996-08-10,17033061C,aitor.lópez@awesomecode.net,185417,ES44209556455181134018,3547.89,2023-08-22T15:49:01,Bilbao,expenses,gifts,-263.14,-41080.59
buyer_1,Aitor,López,1996-08-10,17033061C,aitor.lópez@awesomecode.net,185417,ES44209556455181134018,3547.89,2023-08-24T16:56:26,Bilbao,expenses,leisure,-30.61,-41111.2
buyer_1,Aitor,López,1996-08-10,17033061C,aitor.lópez@awesomecode.net,185417,ES44209556455181134018,3547.89,2023-08-24T17:47:10,Bilbao,expenses,cash,-100.0,-41211.2
buyer_1,Aitor,López,1996-08-10,17033061C,aitor.lópez@awesomecode.net,185417,ES44209556455181134018,3547.89,2023-08-26T14:50:00,Bilbao,expenses,clothing,-131.59,-41342.79
buyer_1,Aitor,López,1996-08-10,17033061C,aitor.lópez@awesomecode.net,185417,ES44209556455181134018,3547.89,2023-08-27T12:48:04,Bilbao,expenses,food,-121.3,-41464.09
buyer_1,Aitor,López,1996-08-10,17033061C,aitor.lópez@awesomecode.net,185417,ES44209556455181134018,3547.89,2023-08-28T21:54:27,Bilbao,expenses,transport,-51.93,-41516.02
buyer_1,Aitor,López,1996-08-10,17033061C,aitor.lópez@awesomecode.net,185417,ES44209556455181134018,3547.89,2023-08-29T17:06:23,Bilbao,expenses,leisure,-65.88,-41581.9
buyer_1,Aitor,López,1996-08-10,17033061C,aitor.lópez@awesomecode.net,185417,ES44209556455181134018,3547.89,2023-08-29T20:26:34,Bilbao,expenses,repairs,-77.53,-41659.43
buyer_1,Aitor,López,1996-08-10,17033061C,aitor.lópez@awesomecode.net,185417,ES44209556455181134018,3547.89,2023-09-01T18:29:09,Bilbao,incomes,salary,2581.67,-39077.76
buyer_1,Aitor,López,1996-08-10,17033061C,aitor.lópez@awesomecode.net,185417,ES44209556455181134018,3547.89,2023-09-04T10:35:19,Bilbao,expenses,food,-83.21,-39160.97
buyer_1,Aitor,López,1996-08-10,17033061C,aitor.lópez@awesomecode.net,185417,ES44209556455181134018,3547.89,2023-09-04T09:59:46,Bilbao,expenses,gifts,-520.9,-39681.87
buyer_1,Aitor,López,1996-08-10,17033061C,aitor.lópez@awesomecode.net,185417,ES44209556455181134018,3547.89,2023-09-05T10:50:41,Bilbao,expenses,rent,-842.94,-40524.81
buyer_1,Aitor,López,1996-08-10,17033061C,aitor.lópez@awesomecode.net,185417,ES44209556455181134018,3547.89,2023-09-05T23:37:04,Bilbao,expenses,water,-48.35,-40573.16
buyer_1,Aitor,López,1996-08-10,17033061C,aitor.lópez@awesomecode.net,185417,ES44209556455181134018,3547.89,2023-09-05T15:54:10,Bilbao,expenses,leisure,-66.66,-40639.82
buyer_1,Aitor,López,1996-08-10,17033061C,aitor.lópez@awesomecode.net,185417,ES44209556455181134018,3547.89,2023-09-05T16:24:22,Bilbao,expenses,cash,-100.0,-40739.82
buyer_1,Aitor,López,1996-08-10,17033061C,aitor.lópez@awesomecode.net,185417,ES44209556455181134018,3547.89,2023-09-06T12:46:50,Bilbao,expenses,internet,-54.22,-40794.04
buyer_1,Aitor,López,1996-08-10,17033061C,aitor.lópez@awesomecode.net,185417,ES44209556455181134018,3547.89,2023-09-07T16:43:08,Bilbao,expenses,water,-30.92,-40824.96
buyer_1,Aitor,López,1996-08-10,17033061C,aitor.lópez@awesomecode.net,185417,ES44209556455181134018,3547.89,2023-09-07T15:59:04,Bilbao,expenses,gas,-45.2,-40870.16
buyer_1,Aitor,López,1996-08-10,17033061C,aitor.lópez@awesomecode.net,185417,ES44209556455181134018,3547.89,2023-09-07T12:34:49,Bilbao,expenses,leisure,-23.76,-40893.92
buyer_1,Aitor,López,1996-08-10,17033061C,aitor.lópez@awesomecode.net,185417,ES44209556455181134018,3547.89,2023-09-08T20:48:17,Bilbao,expenses,phone,-45.09,-40939.01
buyer_1,Aitor,López,1996-08-10,17033061C,aitor.lópez@awesomecode.net,185417,ES44209556455181134018,3547.89,2023-09-08T10:32:16,Bilbao,expenses,repairs,-76.22,-41015.23
buyer_1,Aitor,López,1996-08-10,17033061C,aitor.lópez@awesomecode.net,185417,ES44209556455181134018,3547.89,2023-09-09T09:25:53,Bilbao,expenses,appliances,-299.49,-41314.72
buyer_1,Aitor,López,1996-08-10,17033061C,aitor.lópez@awesomecode.net,185417,ES44209556455181134018,3547.89,2023-09-10T19:07:24,Bilbao,expenses,food,-67.35,-41382.07
buyer_1,Aitor,López,1996-08-10,17033061C,aitor.lópez@awesomecode.net,185417,ES44209556455181134018,3547.89,2023-09-10T12:19:08,Bilbao,expenses,leisure,-47.17,-41429.24
buyer_1,Aitor,López,1996-08-10,17033061C,aitor.lópez@awesomecode.net,185417,ES44209556455181134018,3547.89,2023-09-11T12:21:02,Bilbao,expenses,cash,-100.0,-41529.24
buyer_1,Aitor,López,1996-08-10,17033061C,aitor.lópez@awesomecode.net,185417,ES44209556455181134018,3547.89,2023-09-12T09:39:22,Bilbao,expenses,leisure,-43.38,-41572.62
buyer_1,Aitor,López,1996-08-10,17033061C,aitor.lópez@awesomecode.net,185417,ES44209556455181134018,3547.89,2023-09-12T16:45:13,Bilbao,expenses,cash,-100.0,-41672.62
buyer_1,Aitor,López,1996-08-10,17033061C,aitor.lópez@awesomecode.net,185417,ES44209556455181134018,3547.89,2023-09-13T09:22:51,Bilbao,expenses,food,-66.16,-41738.78
buyer_1,Aitor,López,1996-08-10,17033061C,aitor.lópez@awesomecode.net,185417,ES44209556455181134018,3547.89,2023-09-16T13:28:04,Bilbao,expenses,food,-110.5,-41849.28
buyer_1,Aitor,López,1996-08-10,17033061C,aitor.lópez@awesomecode.net,185417,ES44209556455181134018,3547.89,2023-09-16T12:25:15,Bilbao,expenses,gifts,-708.64,-42557.92
buyer_1,Aitor,López,1996-08-10,17033061C,aitor.lópez@awesomecode.net,185417,ES44209556455181134018,3547.89,2023-09-17T17:14:37,Bilbao,expenses,leisure,-18.84,-42576.76
buyer_1,Aitor,López,1996-08-10,17033061C,aitor.lópez@awesomecode.net,185417,ES44209556455181134018,3547.89,2023-09-17T12:15:11,Bilbao,expenses,gifts,-154.48,-42731.24
buyer_1,Aitor,López,1996-08-10,17033061C,aitor.lópez@awesomecode.net,185417,ES44209556455181134018,3547.89,2023-09-20T14:38:32,Bilbao,expenses,leisure,-72.59,-42803.83
buyer_1,Aitor,López,1996-08-10,17033061C,aitor.lópez@awesomecode.net,185417,ES44209556455181134018,3547.89,2023-09-21T17:41:30,Bilbao,expenses,clothing,-50.28,-42854.11
buyer_1,Aitor,López,1996-08-10,17033061C,aitor.lópez@awesomecode.net,185417,ES44209556455181134018,3547.89,2023-09-23T15:28:13,Bilbao,expenses,transport,-85.77,-42939.88
buyer_1,Aitor,López,1996-08-10,17033061C,aitor.lópez@awesomecode.net,185417,ES44209556455181134018,3547.89,2023-09-23T14:44:34,Bilbao,expenses,education,-45.49,-42985.37
buyer_1,Aitor,López,1996-08-10,17033061C,aitor.lópez@awesomecode.net,185417,ES44209556455181134018,3547.89,2023-09-25T11:37:31,Bilbao,expenses,leisure,-18.98,-43004.35
buyer_1,Aitor,López,1996-08-10,17033061C,aitor.lópez@awesomecode.net,185417,ES44209556455181134018,3547.89,2023-09-25T13:20:14,Bilbao,expenses,repairs,-210.5,-43214.85
buyer_1,Aitor,López,1996-08-10,17033061C,aitor.lópez@awesomecode.net,185417,ES44209556455181134018,3547.89,2023-09-27T13:11:18,Bilbao,expenses,transport,-56.74,-43271.59
buyer_1,Aitor,López,1996-08-10,17033061C,aitor.lópez@awesomecode.net,185417,ES44209556455181134018,3547.89,2023-09-30T15:22:40,Bilbao,expenses,cash,-100.0,-43371.59
buyer_1,Aitor,López,1996-08-10,17033061C,aitor.lópez@awesomecode.net,185417,ES44209556455181134018,3547.89,2023-10-01T21:25:26,Bilbao,incomes,salary,2581.67,-40789.92
buyer_1,Aitor,López,1996-08-10,17033061C,aitor.lópez@awesomecode.net,185417,ES44209556455181134018,3547.89,2023-10-01T15:16:10,Bilbao,expenses,cash,-100.0,-40889.92
buyer_1,Aitor,López,1996-08-10,17033061C,aitor.lópez@awesomecode.net,185417,ES44209556455181134018,3547.89,2023-10-02T19:16:00,Bilbao,expenses,transport,-71.95,-40961.87
buyer_1,Aitor,López,1996-08-10,17033061C,aitor.lópez@awesomecode.net,185417,ES44209556455181134018,3547.89,2023-10-03T23:49:56,Bilbao,expenses,leisure,-20.59,-40982.46
buyer_1,Aitor,López,1996-08-10,17033061C,aitor.lópez@awesomecode.net,185417,ES44209556455181134018,3547.89,2023-10-03T09:59:16,Bilbao,expenses,cash,-100.0,-41082.46
buyer_1,Aitor,López,1996-08-10,17033061C,aitor.lópez@awesomecode.net,185417,ES44209556455181134018,3547.89,2023-10-04T13:29:43,Bilbao,expenses,leisure,-83.72,-41166.18
buyer_1,Aitor,López,1996-08-10,17033061C,aitor.lópez@awesomecode.net,185417,ES44209556455181134018,3547.89,2023-10-04T15:19:35,Bilbao,expenses,clothing,-144.15,-41310.33
buyer_1,Aitor,López,1996-08-10,17033061C,aitor.lópez@awesomecode.net,185417,ES44209556455181134018,3547.89,2023-10-04T09:41:44,Bilbao,expenses,education,-43.02,-41353.35
buyer_1,Aitor,López,1996-08-10,17033061C,aitor.lópez@awesomecode.net,185417,ES44209556455181134018,3547.89,2023-10-05T12:34:59,Bilbao,expenses,rent,-842.94,-42196.29
buyer_1,Aitor,López,1996-08-10,17033061C,aitor.lópez@awesomecode.net,185417,ES44209556455181134018,3547.89,2023-10-05T01:55:30,Bilbao,expenses,water,-36.87,-42233.16
buyer_1,Aitor,López,1996-08-10,17033061C,aitor.lópez@awesomecode.net,185417,ES44209556455181134018,3547.89,2023-10-05T13:33:02,Bilbao,expenses,electricity,-52.54,-42285.7
buyer_1,Aitor,López,1996-08-10,17033061C,aitor.lópez@awesomecode.net,185417,ES44209556455181134018,3547.89,2023-10-05T11:57:23,Bilbao,expenses,gas,-63.28,-42348.98
buyer_1,Aitor,López,1996-08-10,17033061C,aitor.lópez@awesomecode.net,185417,ES44209556455181134018,3547.89,2023-10-05T22:39:10,Bilbao,expenses,food,-77.7,-42426.68
buyer_1,Aitor,López,1996-08-10,17033061C,aitor.lópez@awesomecode.net,185417,ES44209556455181134018,3547.89,2023-10-05T11:57:41,Bilbao,expenses,transport,-57.13,-42483.81
buyer_1,Aitor,López,1996-08-10,17033061C,aitor.lópez@awesomecode.net,185417,ES44209556455181134018,3547.89,2023-10-05T12:09:41,Bilbao,expenses,travel,-415.63,-42899.44
buyer_1,Aitor,López,1996-08-10,17033061C,aitor.lópez@awesomecode.net,185417,ES44209556455181134018,3547.89,2023-10-06T18:32:32,Bilbao,expenses,gas,-89.29,-42988.73
buyer_1,Aitor,López,1996-08-10,17033061C,aitor.lópez@awesomecode.net,185417,ES44209556455181134018,3547.89,2023-10-06T07:41:55,Bilbao,expenses,internet,-54.22,-43042.95
buyer_1,Aitor,López,1996-08-10,17033061C,aitor.lópez@awesomecode.net,185417,ES44209556455181134018,3547.89,2023-10-07T12:28:24,Bilbao,expenses,water,-26.41,-43069.36
buyer_1,Aitor,López,1996-08-10,17033061C,aitor.lópez@awesomecode.net,185417,ES44209556455181134018,3547.89,2023-10-07T09:01:41,Bilbao,expenses,internet,-54.22,-43123.58
buyer_1,Aitor,López,1996-08-10,17033061C,aitor.lópez@awesomecode.net,185417,ES44209556455181134018,3547.89,2023-10-07T20:59:46,Bilbao,expenses,phone,-42.01,-43165.59
buyer_1,Aitor,López,1996-08-10,17033061C,aitor.lópez@awesomecode.net,185417,ES44209556455181134018,3547.89,2023-10-07T19:02:16,Bilbao,expenses,leisure,-57.6,-43223.19
buyer_1,Aitor,López,1996-08-10,17033061C,aitor.lópez@awesomecode.net,185417,ES44209556455181134018,3547.89,2023-10-08T10:17:03,Bilbao,expenses,internet,-54.22,-43277.41
buyer_1,Aitor,López,1996-08-10,17033061C,aitor.lópez@awesomecode.net,185417,ES44209556455181134018,3547.89,2023-10-08T13:46:22,Bilbao,expenses,transport,-41.17,-43318.58
buyer_1,Aitor,López,1996-08-10,17033061C,aitor.lópez@awesomecode.net,185417,ES44209556455181134018,3547.89,2023-10-08T18:28:52,Bilbao,expenses,cash,-100.0,-43418.58
buyer_1,Aitor,López,1996-08-10,17033061C,aitor.lópez@awesomecode.net,185417,ES44209556455181134018,3547.89,2023-10-10T18:01:26,Bilbao,expenses,food,-76.84,-43495.42
buyer_1,Aitor,López,1996-08-10,17033061C,aitor.lópez@awesomecode.net,185417,ES44209556455181134018,3547.89,2023-10-11T14:14:20,Bilbao,expenses,transport,-67.77,-43563.19
buyer_1,Aitor,López,1996-08-10,17033061C,aitor.lópez@awesomecode.net,185417,ES44209556455181134018,3547.89,2023-10-12T18:52:38,Bilbao,expenses,cash,-100.0,-43663.19
buyer_1,Aitor,López,1996-08-10,17033061C,aitor.lópez@awesomecode.net,185417,ES44209556455181134018,3547.89,2023-10-12T08:32:58,Bilbao,expenses,repairs,-89.39,-43752.58
buyer_1,Aitor,López,1996-08-10,17033061C,aitor.lópez@awesomecode.net,185417,ES44209556455181134018,3547.89,2023-10-14T15:52:11,Bilbao,expenses,food,-79.8,-43832.38
buyer_1,Aitor,López,1996-08-10,17033061C,aitor.lópez@awesomecode.net,185417,ES44209556455181134018,3547.89,2023-10-14T18:26:40,Bilbao,expenses,gifts,-640.33,-44472.71
buyer_1,Aitor,López,1996-08-10,17033061C,aitor.lópez@awesomecode.net,185417,ES44209556455181134018,3547.89,2023-10-16T10:44:39,Bilbao,expenses,cash,-100.0,-44572.71
buyer_1,Aitor,López,1996-08-10,17033061C,aitor.lópez@awesomecode.net,185417,ES44209556455181134018,3547.89,2023-10-18T09:48:32,Bilbao,expenses,cash,-100.0,-44672.71
buyer_1,Aitor,López,1996-08-10,17033061C,aitor.lópez@awesomecode.net,185417,ES44209556455181134018,3547.89,2023-10-19T08:04:45,Bilbao,expenses,food,-62.93,-44735.64
buyer_1,Aitor,López,1996-08-10,17033061C,aitor.lópez@awesomecode.net,185417,ES44209556455181134018,3547.89,2023-10-23T12:10:33,Bilbao,expenses,education,-61.76,-44797.4
buyer_1,Aitor,López,1996-08-10,17033061C,aitor.lópez@awesomecode.net,185417,ES44209556455181134018,3547.89,2023-10-25T08:42:23,Bilbao,expenses,education,-73.86,-44871.26
buyer_1,Aitor,López,1996-08-10,17033061C,aitor.lópez@awesomecode.net,185417,ES44209556455181134018,3547.89,2023-10-31T16:16:43,Bilbao,expenses,education,-72.66,-44943.92
buyer_1,Aitor,López,1996-08-10,17033061C,aitor.lópez@awesomecode.net,185417,ES44209556455181134018,3547.89,2023-11-01T14:06:14,Bilbao,incomes,salary,2581.67,-42362.25
buyer_1,Aitor,López,1996-08-10,17033061C,aitor.lópez@awesomecode.net,185417,ES44209556455181134018,3547.89,2023-11-02T17:26:38,Bilbao,expenses,transport,-86.5,-42448.75
buyer_1,Aitor,López,1996-08-10,17033061C,aitor.lópez@awesomecode.net,185417,ES44209556455181134018,3547.89,2023-11-03T17:22:56,Bilbao,expenses,food,-67.23,-42515.98
buyer_1,Aitor,López,1996-08-10,17033061C,aitor.lópez@awesomecode.net,185417,ES44209556455181134018,3547.89,2023-11-03T08:08:38,Bilbao,expenses,clothing,-156.64,-42672.62
buyer_1,Aitor,López,1996-08-10,17033061C,aitor.lópez@awesomecode.net,185417,ES44209556455181134018,3547.89,2023-11-04T15:47:28,Bilbao,expenses,food,-74.07,-42746.69
buyer_1,Aitor,López,1996-08-10,17033061C,aitor.lópez@awesomecode.net,185417,ES44209556455181134018,3547.89,2023-11-04T23:22:42,Bilbao,expenses,gifts,-814.07,-43560.76
buyer_1,Aitor,López,1996-08-10,17033061C,aitor.lópez@awesomecode.net,185417,ES44209556455181134018,3547.89,2023-11-05T18:07:40,Bilbao,expenses,rent,-842.94,-44403.7
buyer_1,Aitor,López,1996-08-10,17033061C,aitor.lópez@awesomecode.net,185417,ES44209556455181134018,3547.89,2023-11-05T20:10:37,Bilbao,expenses,phone,-58.03,-44461.73
buyer_1,Aitor,López,1996-08-10,17033061C,aitor.lópez@awesomecode.net,185417,ES44209556455181134018,3547.89,2023-11-05T21:42:54,Bilbao,expenses,cash,-100.0,-44561.73
buyer_1,Aitor,López,1996-08-10,17033061C,aitor.lópez@awesomecode.net,185417,ES44209556455181134018,3547.89,2023-11-06T23:48:36,Bilbao,expenses,water,-50.82,-44612.55
buyer_1,Aitor,López,1996-08-10,17033061C,aitor.lópez@awesomecode.net,185417,ES44209556455181134018,3547.89,2023-11-06T12:30:18,Bilbao,expenses,gas,-57.53,-44670.08
buyer_1,Aitor,López,1996-08-10,17033061C,aitor.lópez@awesomecode.net,185417,ES44209556455181134018,3547.89,2023-11-06T12:39:37,Bilbao,expenses,appliances,-375.67,-45045.75
buyer_1,Aitor,López,1996-08-10,17033061C,aitor.lópez@awesomecode.net,185417,ES44209556455181134018,3547.89,2023-11-07T17:49:59,Bilbao,expenses,water,-53.33,-45099.08
buyer_1,Aitor,López,1996-08-10,17033061C,aitor.lópez@awesomecode.net,185417,ES44209556455181134018,3547.89,2023-11-07T10:41:42,Bilbao,expenses,phone,-42.17,-45141.25
buyer_1,Aitor,López,1996-08-10,17033061C,aitor.lópez@awesomecode.net,185417,ES44209556455181134018,3547.89,2023-11-10T08:54:49,Bilbao,expenses,cash,-100.0,-45241.25
buyer_1,Aitor,López,1996-08-10,17033061C,aitor.lópez@awesomecode.net,185417,ES44209556455181134018,3547.89,2023-11-11T10:08:46,Bilbao,expenses,food,-89.42,-45330.67
buyer_1,Aitor,López,1996-08-10,17033061C,aitor.lópez@awesomecode.net,185417,ES44209556455181134018,3547.89,2023-11-13T09:47:46,Bilbao,expenses,food,-99.75,-45430.42
buyer_1,Aitor,López,1996-08-10,17033061C,aitor.lópez@awesomecode.net,185417,ES44209556455181134018,3547.89,2023-11-14T12:29:53,Bilbao,expenses,gifts,-170.72,-45601.14
buyer_1,Aitor,López,1996-08-10,17033061C,aitor.lópez@awesomecode.net,185417,ES44209556455181134018,3547.89,2023-11-15T14:11:03,Bilbao,expenses,leisure,-36.84,-45637.98
buyer_1,Aitor,López,1996-08-10,17033061C,aitor.lópez@awesomecode.net,185417,ES44209556455181134018,3547.89,2023-11-15T18:24:51,Bilbao,expenses,clothing,-127.29,-45765.27
buyer_1,Aitor,López,1996-08-10,17033061C,aitor.lópez@awesomecode.net,185417,ES44209556455181134018,3547.89,2023-11-15T11:37:46,Bilbao,expenses,education,-44.85,-45810.12
buyer_1,Aitor,López,1996-08-10,17033061C,aitor.lópez@awesomecode.net,185417,ES44209556455181134018,3547.89,2023-11-19T10:31:53,Bilbao,expenses,gifts,-849.49,-46659.61
buyer_1,Aitor,López,1996-08-10,17033061C,aitor.lópez@awesomecode.net,185417,ES44209556455181134018,3547.89,2023-11-24T10:59:16,Bilbao,expenses,food,-62.98,-46722.59
buyer_1,Aitor,López,1996-08-10,17033061C,aitor.lópez@awesomecode.net,185417,ES44209556455181134018,3547.89,2023-11-25T18:40:33,Bilbao,expenses,cash,-100.0,-46822.59
buyer_1,Aitor,López,1996-08-10,17033061C,aitor.lópez@awesomecode.net,185417,ES44209556455181134018,3547.89,2023-11-26T12:30:18,Bilbao,expenses,food,-94.62,-46917.21
buyer_1,Aitor,López,1996-08-10,17033061C,aitor.lópez@awesomecode.net,185417,ES44209556455181134018,3547.89,2023-11-26T17:09:21,Bilbao,expenses,transport,-57.91,-46975.12
buyer_1,Aitor,López,1996-08-10,17033061C,aitor.lópez@awesomecode.net,185417,ES44209556455181134018,3547.89,2023-11-28T01:53:26,Bilbao,expenses,transport,-77.96,-47053.08
buyer_1,Aitor,López,1996-08-10,17033061C,aitor.lópez@awesomecode.net,185417,ES44209556455181134018,3547.89,2023-11-28T08:23:26,Bilbao,expenses,appliances,-125.81,-47178.89
buyer_1,Aitor,López,1996-08-10,17033061C,aitor.lópez@awesomecode.net,185417,ES44209556455181134018,3547.89,2023-11-30T17:12:24,Bilbao,expenses,leisure,-76.24,-47255.13
buyer_1,Aitor,López,1996-08-10,17033061C,aitor.lópez@awesomecode.net,185417,ES44209556455181134018,3547.89,2023-12-01T10:51:15,Bilbao,incomes,salary,2581.67,-44673.46
buyer_1,Aitor,López,1996-08-10,17033061C,aitor.lópez@awesomecode.net,185417,ES44209556455181134018,3547.89,2023-12-01T10:51:15,Bilbao,incomes,extra_income,266.49,-44406.97
buyer_1,Aitor,López,1996-08-10,17033061C,aitor.lópez@awesomecode.net,185417,ES44209556455181134018,3547.89,2023-12-01T10:51:15,Bilbao,incomes,salary_bonus,1827.98,-42578.99
buyer_1,Aitor,López,1996-08-10,17033061C,aitor.lópez@awesomecode.net,185417,ES44209556455181134018,3547.89,2023-12-01T19:42:51,Bilbao,expenses,leisure,-28.74,-42607.73
buyer_1,Aitor,López,1996-08-10,17033061C,aitor.lópez@awesomecode.net,185417,ES44209556455181134018,3547.89,2023-12-01T13:09:40,Bilbao,expenses,appliances,-192.39,-42800.12
buyer_1,Aitor,López,1996-08-10,17033061C,aitor.lópez@awesomecode.net,185417,ES44209556455181134018,3547.89,2023-12-03T15:06:47,Bilbao,expenses,healthcare,-160.91,-42961.03
buyer_1,Aitor,López,1996-08-10,17033061C,aitor.lópez@awesomecode.net,185417,ES44209556455181134018,3547.89,2023-12-05T19:44:31,Bilbao,expenses,rent,-842.94,-43803.97
buyer_1,Aitor,López,1996-08-10,17033061C,aitor.lópez@awesomecode.net,185417,ES44209556455181134018,3547.89,2023-12-05T17:32:27,Bilbao,expenses,electricity,-36.05,-43840.02
buyer_1,Aitor,López,1996-08-10,17033061C,aitor.lópez@awesomecode.net,185417,ES44209556455181134018,3547.89,2023-12-05T18:08:04,Bilbao,expenses,gas,-120.98,-43961.0
buyer_1,Aitor,López,1996-08-10,17033061C,aitor.lópez@awesomecode.net,185417,ES44209556455181134018,3547.89,2023-12-05T23:16:44,Bilbao,expenses,phone,-49.25,-44010.25
buyer_1,Aitor,López,1996-08-10,17033061C,aitor.lópez@awesomecode.net,185417,ES44209556455181134018,3547.89,2023-12-05T08:46:08,Bilbao,expenses,cash,-100.0,-44110.25
buyer_1,Aitor,López,1996-08-10,17033061C,aitor.lópez@awesomecode.net,185417,ES44209556455181134018,3547.89,2023-12-05T10:33:14,Bilbao,expenses,repairs,-56.79,-44167.04
buyer_1,Aitor,López,1996-08-10,17033061C,aitor.lópez@awesomecode.net,185417,ES44209556455181134018,3547.89,2023-12-06T20:36:32,Bilbao,expenses,internet,-54.22,-44221.26
buyer_1,Aitor,López,1996-08-10,17033061C,aitor.lópez@awesomecode.net,185417,ES44209556455181134018,3547.89,2023-12-07T06:37:33,Bilbao,expenses,water,-54.63,-44275.89
buyer_1,Aitor,López,1996-08-10,17033061C,aitor.lópez@awesomecode.net,185417,ES44209556455181134018,3547.89,2023-12-07T09:10:08,Bilbao,expenses,electricity,-34.73,-44310.62
buyer_1,Aitor,López,1996-08-10,17033061C,aitor.lópez@awesomecode.net,185417,ES44209556455181134018,3547.89,2023-12-07T08:07:22,Bilbao,expenses,gas,-52.83,-44363.45
buyer_1,Aitor,López,1996-08-10,17033061C,aitor.lópez@awesomecode.net,185417,ES44209556455181134018,3547.89,2023-12-08T08:54:58,Bilbao,expenses,water,-32.11,-44395.56
buyer_1,Aitor,López,1996-08-10,17033061C,aitor.lópez@awesomecode.net,185417,ES44209556455181134018,3547.89,2023-12-09T13:52:05,Bilbao,expenses,transport,-47.17,-44442.73
buyer_1,Aitor,López,1996-08-10,17033061C,aitor.lópez@awesomecode.net,185417,ES44209556455181134018,3547.89,2023-12-11T20:13:14,Bilbao,expenses,repairs,-72.91,-44515.64
buyer_1,Aitor,López,1996-08-10,17033061C,aitor.lópez@awesomecode.net,185417,ES44209556455181134018,3547.89,2023-12-12T15:33:09,Bilbao,expenses,food,-102.42,-44618.06
buyer_1,Aitor,López,1996-08-10,17033061C,aitor.lópez@awesomecode.net,185417,ES44209556455181134018,3547.89,2023-12-13T22:18:39,Bilbao,expenses,leisure,-79.35,-44697.41
buyer_1,Aitor,López,1996-08-10,17033061C,aitor.lópez@awesomecode.net,185417,ES44209556455181134018,3547.89,2023-12-16T10:23:18,Bilbao,expenses,clothing,-82.69,-44780.1
buyer_1,Aitor,López,1996-08-10,17033061C,aitor.lópez@awesomecode.net,185417,ES44209556455181134018,3547.89,2023-12-17T13:29:31,Bilbao,expenses,transport,-53.44,-44833.54
buyer_1,Aitor,López,1996-08-10,17033061C,aitor.lópez@awesomecode.net,185417,ES44209556455181134018,3547.89,2023-12-17T20:58:47,Bilbao,expenses,cash,-100.0,-44933.54
buyer_1,Aitor,López,1996-08-10,17033061C,aitor.lópez@awesomecode.net,185417,ES44209556455181134018,3547.89,2023-12-19T09:38:33,Bilbao,expenses,food,-124.72,-45058.26
buyer_1,Aitor,López,1996-08-10,17033061C,aitor.lópez@awesomecode.net,185417,ES44209556455181134018,3547.89,2023-12-21T09:49:13,Bilbao,expenses,food,-122.95,-45181.21
buyer_1,Aitor,López,1996-08-10,17033061C,aitor.lópez@awesomecode.net,185417,ES44209556455181134018,3547.89,2023-12-21T18:04:04,Bilbao,expenses,clothing,-70.94,-45252.15
buyer_1,Aitor,López,1996-08-10,17033061C,aitor.lópez@awesomecode.net,185417,ES44209556455181134018,3547.89,2023-12-22T13:04:41,Bilbao,expenses,gifts,-538.13,-45790.28
buyer_1,Aitor,López,1996-08-10,17033061C,aitor.lópez@awesomecode.net,185417,ES44209556455181134018,3547.89,2023-12-23T10:55:20,Bilbao,expenses,food,-119.9,-45910.18
buyer_1,Aitor,López,1996-08-10,17033061C,aitor.lópez@awesomecode.net,185417,ES44209556455181134018,3547.89,2023-12-23T10:36:58,Bilbao,expenses,gifts,-836.23,-46746.41
buyer_1,Aitor,López,1996-08-10,17033061C,aitor.lópez@awesomecode.net,185417,ES44209556455181134018,3547.89,2023-12-25T20:32:40,Bilbao,expenses,cash,-100.0,-46846.41
buyer_1,Aitor,López,1996-08-10,17033061C,aitor.lópez@awesomecode.net,185417,ES44209556455181134018,3547.89,2023-12-26T13:17:19,Bilbao,expenses,gifts,-275.98,-47122.39
buyer_1,Aitor,López,1996-08-10,17033061C,aitor.lópez@awesomecode.net,185417,ES44209556455181134018,3547.89,2023-12-27T11:06:16,Bilbao,expenses,transport,-45.14,-47167.53
buyer_1,Aitor,López,1996-08-10,17033061C,aitor.lópez@awesomecode.net,185417,ES44209556455181134018,3547.89,2023-12-28T18:12:01,Bilbao,expenses,cash,-100.0,-47267.53
buyer_1,Aitor,López,1996-08-10,17033061C,aitor.lópez@awesomecode.net,185417,ES44209556455181134018,3547.89,2023-12-29T19:24:49,Bilbao,expenses,healthcare,-170.6,-47438.13
buyer_1,Aitor,López,1996-08-10,17033061C,aitor.lópez@awesomecode.net,185417,ES44209556455181134018,3547.89,2023-12-29T17:38:33,Bilbao,expenses,cash,-100.0,-47538.13
buyer_1,Aitor,López,1996-08-10,17033061C,aitor.lópez@awesomecode.net,185417,ES44209556455181134018,3547.89,2023-12-30T12:19:11,Bilbao,expenses,gifts,-274.26,-47812.39
buyer_1,Aitor,López,1996-08-10,17033061C,aitor.lópez@awesomecode.net,185417,ES44209556455181134018,3547.89,2023-12-31T13:38:59,Bilbao,expenses,transport,-79.76,-47892.15
buyer_1,Aitor,López,1996-08-10,17033061C,aitor.lópez@awesomecode.net,185417,ES44209556455181134018,3547.89,2024-01-01T16:24:38,Bilbao,incomes,salary,2676.25,-45215.9
buyer_1,Aitor,López,1996-08-10,17033061C,aitor.lópez@awesomecode.net,185417,ES44209556455181134018,3547.89,2024-01-01T15:27:20,Bilbao,expenses,repairs,-311.75,-45527.65
buyer_1,Aitor,López,1996-08-10,17033061C,aitor.lópez@awesomecode.net,185417,ES44209556455181134018,3547.89,2024-01-02T22:05:49,Bilbao,expenses,food,-101.3,-45628.95
buyer_1,Aitor,López,1996-08-10,17033061C,aitor.lópez@awesomecode.net,185417,ES44209556455181134018,3547.89,2024-01-04T03:21:41,Bilbao,expenses,transport,-72.92,-45701.87
buyer_1,Aitor,López,1996-08-10,17033061C,aitor.lópez@awesomecode.net,185417,ES44209556455181134018,3547.89,2024-01-04T18:47:20,Bilbao,expenses,clothing,-151.56,-45853.43
buyer_1,Aitor,López,1996-08-10,17033061C,aitor.lópez@awesomecode.net,185417,ES44209556455181134018,3547.89,2024-01-05T15:55:19,Bilbao,expenses,rent,-833.31,-46686.74
buyer_1,Aitor,López,1996-08-10,17033061C,aitor.lópez@awesomecode.net,185417,ES44209556455181134018,3547.89,2024-01-05T21:46:46,Bilbao,expenses,internet,-56.2,-46742.94
buyer_1,Aitor,López,1996-08-10,17033061C,aitor.lópez@awesomecode.net,185417,ES44209556455181134018,3547.89,2024-01-06T01:44:40,Bilbao,expenses,food,-81.46,-46824.4
buyer_1,Aitor,López,1996-08-10,17033061C,aitor.lópez@awesomecode.net,185417,ES44209556455181134018,3547.89,2024-01-06T05:27:31,Bilbao,expenses,repairs,-95.04,-46919.44
buyer_1,Aitor,López,1996-08-10,17033061C,aitor.lópez@awesomecode.net,185417,ES44209556455181134018,3547.89,2024-01-07T13:11:01,Bilbao,expenses,water,-34.0,-46953.44
buyer_1,Aitor,López,1996-08-10,17033061C,aitor.lópez@awesomecode.net,185417,ES44209556455181134018,3547.89,2024-01-07T15:46:09,Bilbao,expenses,gas,-139.12,-47092.56
buyer_1,Aitor,López,1996-08-10,17033061C,aitor.lópez@awesomecode.net,185417,ES44209556455181134018,3547.89,2024-01-07T06:43:47,Bilbao,expenses,internet,-56.2,-47148.76
buyer_1,Aitor,López,1996-08-10,17033061C,aitor.lópez@awesomecode.net,185417,ES44209556455181134018,3547.89,2024-01-07T11:30:52,Bilbao,expenses,clothing,-150.28,-47299.04
buyer_1,Aitor,López,1996-08-10,17033061C,aitor.lópez@awesomecode.net,185417,ES44209556455181134018,3547.89,2024-01-08T02:27:18,Bilbao,expenses,electricity,-60.9,-47359.94
buyer_1,Aitor,López,1996-08-10,17033061C,aitor.lópez@awesomecode.net,185417,ES44209556455181134018,3547.89,2024-01-11T23:38:55,Bilbao,expenses,travel,-896.72,-48256.66
buyer_1,Aitor,López,1996-08-10,17033061C,aitor.lópez@awesomecode.net,185417,ES44209556455181134018,3547.89,2024-01-13T17:04:18,Bilbao,expenses,repairs,-266.16,-48522.82
buyer_1,Aitor,López,1996-08-10,17033061C,aitor.lópez@awesomecode.net,185417,ES44209556455181134018,3547.89,2024-01-14T03:00:50,Bilbao,expenses,repairs,-241.48,-48764.3
buyer_1,Aitor,López,1996-08-10,17033061C,aitor.lópez@awesomecode.net,185417,ES44209556455181134018,3547.89,2024-01-14T08:10:53,Bilbao,expenses,gifts,-50.81,-48815.11
buyer_1,Aitor,López,1996-08-10,17033061C,aitor.lópez@awesomecode.net,185417,ES44209556455181134018,3547.89,2024-01-15T04:25:00,Bilbao,expenses,repairs,-28.18,-48843.29
buyer_1,Aitor,López,1996-08-10,17033061C,aitor.lópez@awesomecode.net,185417,ES44209556455181134018,3547.89,2024-01-15T20:10:58,Bilbao,expenses,gifts,-163.1,-49006.39
buyer_1,Aitor,López,1996-08-10,17033061C,aitor.lópez@awesomecode.net,185417,ES44209556455181134018,3547.89,2024-01-16T12:51:31,Bilbao,expenses,leisure,-35.18,-49041.57
buyer_1,Aitor,López,1996-08-10,17033061C,aitor.lópez@awesomecode.net,185417,ES44209556455181134018,3547.89,2024-01-17T11:30:56,Bilbao,expenses,transport,-83.76,-49125.33
buyer_1,Aitor,López,1996-08-10,17033061C,aitor.lópez@awesomecode.net,185417,ES44209556455181134018,3547.89,2024-01-21T19:19:26,Bilbao,expenses,food,-71.5,-49196.83
buyer_1,Aitor,López,1996-08-10,17033061C,aitor.lópez@awesomecode.net,185417,ES44209556455181134018,3547.89,2024-01-22T15:27:10,Bilbao,expenses,food,-82.33,-49279.16
buyer_1,Aitor,López,1996-08-10,17033061C,aitor.lópez@awesomecode.net,185417,ES44209556455181134018,3547.89,2024-01-22T10:43:28,Bilbao,expenses,leisure,-27.66,-49306.82
buyer_1,Aitor,López,1996-08-10,17033061C,aitor.lópez@awesomecode.net,185417,ES44209556455181134018,3547.89,2024-01-23T11:30:36,Bilbao,expenses,cash,-100.0,-49406.82
buyer_1,Aitor,López,1996-08-10,17033061C,aitor.lópez@awesomecode.net,185417,ES44209556455181134018,3547.89,2024-01-25T20:18:51,Bilbao,expenses,leisure,-83.16,-49489.98
buyer_1,Aitor,López,1996-08-10,17033061C,aitor.lópez@awesomecode.net,185417,ES44209556455181134018,3547.89,2024-01-28T17:09:51,Bilbao,expenses,food,-65.26,-49555.24
buyer_1,Aitor,López,1996-08-10,17033061C,aitor.lópez@awesomecode.net,185417,ES44209556455181134018,3547.89,2024-01-29T14:52:02,Bilbao,expenses,food,-64.6,-49619.84
buyer_1,Aitor,López,1996-08-10,17033061C,aitor.lópez@awesomecode.net,185417,ES44209556455181134018,3547.89,2024-01-30T22:00:01,Bilbao,expenses,food,-61.86,-49681.7
buyer_1,Aitor,López,1996-08-10,17033061C,aitor.lópez@awesomecode.net,185417,ES44209556455181134018,3547.89,2024-01-30T10:04:26,Bilbao,expenses,cash,-100.0,-49781.7
buyer_1,Aitor,López,1996-08-10,17033061C,aitor.lópez@awesomecode.net,185417,ES44209556455181134018,3547.89,2024-02-01T17:45:58,Bilbao,incomes,salary,2676.25,-47105.45
buyer_1,Aitor,López,1996-08-10,17033061C,aitor.lópez@awesomecode.net,185417,ES44209556455181134018,3547.89,2024-02-02T14:23:08,Bilbao,expenses,education,-42.9,-47148.35
buyer_1,Aitor,López,1996-08-10,17033061C,aitor.lópez@awesomecode.net,185417,ES44209556455181134018,3547.89,2024-02-04T14:15:07,Bilbao,expenses,repairs,-76.68,-47225.03
buyer_1,Aitor,López,1996-08-10,17033061C,aitor.lópez@awesomecode.net,185417,ES44209556455181134018,3547.89,2024-02-05T16:29:40,Bilbao,expenses,rent,-833.31,-48058.34
buyer_1,Aitor,López,1996-08-10,17033061C,aitor.lópez@awesomecode.net,185417,ES44209556455181134018,3547.89,2024-02-05T15:15:08,Bilbao,expenses,internet,-56.2,-48114.54
buyer_1,Aitor,López,1996-08-10,17033061C,aitor.lópez@awesomecode.net,185417,ES44209556455181134018,3547.89,2024-02-05T15:30:35,Bilbao,expenses,cash,-100.0,-48214.54
buyer_1,Aitor,López,1996-08-10,17033061C,aitor.lópez@awesomecode.net,185417,ES44209556455181134018,3547.89,2024-02-05T05:15:01,Bilbao,expenses,gifts,-453.76,-48668.3
buyer_1,Aitor,López,1996-08-10,17033061C,aitor.lópez@awesomecode.net,185417,ES44209556455181134018,3547.89,2024-02-06T14:37:16,Bilbao,expenses,leisure,-60.45,-48728.75
buyer_1,Aitor,López,1996-08-10,17033061C,aitor.lópez@awesomecode.net,185417,ES44209556455181134018,3547.89,2024-02-07T10:57:06,Bilbao,expenses,internet,-56.2,-48784.95
buyer_1,Aitor,López,1996-08-10,17033061C,aitor.lópez@awesomecode.net,185417,ES44209556455181134018,3547.89,2024-02-07T20:48:39,Bilbao,expenses,phone,-57.52,-48842.47
buyer_1,Aitor,López,1996-08-10,17033061C,aitor.lópez@awesomecode.net,185417,ES44209556455181134018,3547.89,2024-02-07T19:38:02,Bilbao,expenses,food,-117.49,-48959.96
buyer_1,Aitor,López,1996-08-10,17033061C,aitor.lópez@awesomecode.net,185417,ES44209556455181134018,3547.89,2024-02-07T17:04:50,Bilbao,expenses,education,-62.92,-49022.88
buyer_1,Aitor,López,1996-08-10,17033061C,aitor.lópez@awesomecode.net,185417,ES44209556455181134018,3547.89,2024-02-08T09:36:47,Bilbao,expenses,internet,-56.2,-49079.08
buyer_1,Aitor,López,1996-08-10,17033061C,aitor.lópez@awesomecode.net,185417,ES44209556455181134018,3547.89,2024-02-08T10:13:28,Bilbao,expenses,clothing,-92.03,-49171.11
buyer_1,Aitor,López,1996-08-10,17033061C,aitor.lópez@awesomecode.net,185417,ES44209556455181134018,3547.89,2024-02-10T17:57:41,Bilbao,expenses,gifts,-105.58,-49276.69
buyer_1,Aitor,López,1996-08-10,17033061C,aitor.lópez@awesomecode.net,185417,ES44209556455181134018,3547.89,2024-02-13T16:16:14,Bilbao,expenses,healthcare,-188.08,-49464.77
buyer_1,Aitor,López,1996-08-10,17033061C,aitor.lópez@awesomecode.net,185417,ES44209556455181134018,3547.89,2024-02-14T12:08:53,Bilbao,expenses,cash,-100.0,-49564.77
buyer_1,Aitor,López,1996-08-10,17033061C,aitor.lópez@awesomecode.net,185417,ES44209556455181134018,3547.89,2024-02-14T14:15:21,Bilbao,expenses,repairs,-279.99,-49844.76
buyer_1,Aitor,López,1996-08-10,17033061C,aitor.lópez@awesomecode.net,185417,ES44209556455181134018,3547.89,2024-02-15T22:58:45,Bilbao,expenses,healthcare,-131.6,-49976.36
buyer_1,Aitor,López,1996-08-10,17033061C,aitor.lópez@awesomecode.net,185417,ES44209556455181134018,3547.89,2024-02-15T19:33:00,Bilbao,expenses,cash,-100.0,-50076.36
buyer_1,Aitor,López,1996-08-10,17033061C,aitor.lópez@awesomecode.net,185417,ES44209556455181134018,3547.89,2024-02-16T08:07:48,Bilbao,expenses,food,-74.0,-50150.36
buyer_1,Aitor,López,1996-08-10,17033061C,aitor.lópez@awesomecode.net,185417,ES44209556455181134018,3547.89,2024-02-17T22:23:10,Bilbao,expenses,gifts,-358.65,-50509.01
buyer_1,Aitor,López,1996-08-10,17033061C,aitor.lópez@awesomecode.net,185417,ES44209556455181134018,3547.89,2024-02-20T23:18:38,Bilbao,expenses,travel,-628.96,-51137.97
buyer_1,Aitor,López,1996-08-10,17033061C,aitor.lópez@awesomecode.net,185417,ES44209556455181134018,3547.89,2024-02-23T15:10:21,Bilbao,expenses,cash,-100.0,-51237.97
buyer_1,Aitor,López,1996-08-10,17033061C,aitor.lópez@awesomecode.net,185417,ES44209556455181134018,3547.89,2024-02-26T22:11:35,Bilbao,expenses,cash,-100.0,-51337.97
buyer_1,Aitor,López,1996-08-10,17033061C,aitor.lópez@awesomecode.net,185417,ES44209556455181134018,3547.89,2024-02-27T09:02:43,Bilbao,expenses,food,-73.68,-51411.65
buyer_1,Aitor,López,1996-08-10,17033061C,aitor.lópez@awesomecode.net,185417,ES44209556455181134018,3547.89,2024-02-27T21:41:25,Bilbao,expenses,leisure,-29.83,-51441.48
buyer_1,Aitor,López,1996-08-10,17033061C,aitor.lópez@awesomecode.net,185417,ES44209556455181134018,3547.89,2024-02-28T08:51:47,Bilbao,expenses,leisure,-44.15,-51485.63
buyer_1,Aitor,López,1996-08-10,17033061C,aitor.lópez@awesomecode.net,185417,ES44209556455181134018,3547.89,2024-02-28T13:50:06,Bilbao,expenses,gifts,-344.11,-51829.74
buyer_1,Aitor,López,1996-08-10,17033061C,aitor.lópez@awesomecode.net,185417,ES44209556455181134018,3547.89,2024-03-01T16:56:20,Bilbao,incomes,salary,2676.25,-49153.49
buyer_1,Aitor,López,1996-08-10,17033061C,aitor.lópez@awesomecode.net,185417,ES44209556455181134018,3547.89,2024-03-01T16:56:20,Bilbao,incomes,extra_income,266.49,-48887.0
buyer_1,Aitor,López,1996-08-10,17033061C,aitor.lópez@awesomecode.net,185417,ES44209556455181134018,3547.89,2024-03-03T19:10:33,Bilbao,expenses,transport,-61.68,-48948.68
buyer_1,Aitor,López,1996-08-10,17033061C,aitor.lópez@awesomecode.net,185417,ES44209556455181134018,3547.89,2024-03-03T20:36:21,Bilbao,expenses,cash,-100.0,-49048.68
buyer_1,Aitor,López,1996-08-10,17033061C,aitor.lópez@awesomecode.net,185417,ES44209556455181134018,3547.89,2024-03-05T10:50:29,Bilbao,expenses,rent,-833.31,-49881.99
buyer_1,Aitor,López,1996-08-10,17033061C,aitor.lópez@awesomecode.net,185417,ES44209556455181134018,3547.89,2024-03-05T06:12:31,Bilbao,expenses,electricity,-65.21,-49947.2
buyer_1,Aitor,López,1996-08-10,17033061C,aitor.lópez@awesomecode.net,185417,ES44209556455181134018,3547.89,2024-03-05T08:16:43,Bilbao,expenses,healthcare,-51.51,-49998.71
buyer_1,Aitor,López,1996-08-10,17033061C,aitor.lópez@awesomecode.net,185417,ES44209556455181134018,3547.89,2024-03-05T13:59:18,Bilbao,expenses,gifts,-324.97,-50323.68
buyer_1,Aitor,López,1996-08-10,17033061C,aitor.lópez@awesomecode.net,185417,ES44209556455181134018,3547.89,2024-03-06T20:41:27,Bilbao,expenses,water,-53.77,-50377.45
buyer_1,Aitor,López,1996-08-10,17033061C,aitor.lópez@awesomecode.net,185417,ES44209556455181134018,3547.89,2024-03-06T17:21:24,Bilbao,expenses,electricity,-65.05,-50442.5
buyer_1,Aitor,López,1996-08-10,17033061C,aitor.lópez@awesomecode.net,185417,ES44209556455181134018,3547.89,2024-03-06T15:52:05,Bilbao,expenses,phone,-55.4,-50497.9
buyer_1,Aitor,López,1996-08-10,17033061C,aitor.lópez@awesomecode.net,185417,ES44209556455181134018,3547.89,2024-03-07T12:52:02,Bilbao,expenses,electricity,-83.66,-50581.56
buyer_1,Aitor,López,1996-08-10,17033061C,aitor.lópez@awesomecode.net,185417,ES44209556455181134018,3547.89,2024-03-07T19:46:38,Bilbao,expenses,phone,-46.99,-50628.55
buyer_1,Aitor,López,1996-08-10,17033061C,aitor.lópez@awesomecode.net,185417,ES44209556455181134018,3547.89,2024-03-07T15:12:55,Bilbao,expenses,cash,-100.0,-50728.55
buyer_1,Aitor,López,1996-08-10,17033061C,aitor.lópez@awesomecode.net,185417,ES44209556455181134018,3547.89,2024-03-08T20:10:13,Bilbao,expenses,electricity,-28.57,-50757.12
buyer_1,Aitor,López,1996-08-10,17033061C,aitor.lópez@awesomecode.net,185417,ES44209556455181134018,3547.89,2024-03-08T17:16:09,Bilbao,expenses,phone,-47.24,-50804.36
buyer_1,Aitor,López,1996-08-10,17033061C,aitor.lópez@awesomecode.net,185417,ES44209556455181134018,3547.89,2024-03-11T12:44:32,Bilbao,expenses,clothing,-147.5,-50951.86
buyer_1,Aitor,López,1996-08-10,17033061C,aitor.lópez@awesomecode.net,185417,ES44209556455181134018,3547.89,2024-03-13T12:52:13,Bilbao,expenses,food,-105.81,-51057.67
buyer_1,Aitor,López,1996-08-10,17033061C,aitor.lópez@awesomecode.net,185417,ES44209556455181134018,3547.89,2024-03-14T10:58:44,Bilbao,expenses,food,-102.82,-51160.49
buyer_1,Aitor,López,1996-08-10,17033061C,aitor.lópez@awesomecode.net,185417,ES44209556455181134018,3547.89,2024-03-14T13:21:22,Bilbao,expenses,education,-46.28,-51206.77
buyer_1,Aitor,López,1996-08-10,17033061C,aitor.lópez@awesomecode.net,185417,ES44209556455181134018,3547.89,2024-03-14T21:42:45,Bilbao,expenses,repairs,-88.8,-51295.57
buyer_1,Aitor,López,1996-08-10,17033061C,aitor.lópez@awesomecode.net,185417,ES44209556455181134018,3547.89,2024-03-15T10:38:42,Bilbao,expenses,transport,-48.34,-51343.91
buyer_1,Aitor,López,1996-08-10,17033061C,aitor.lópez@awesomecode.net,185417,ES44209556455181134018,3547.89,2024-03-15T19:20:33,Bilbao,expenses,repairs,-284.15,-51628.06
buyer_1,Aitor,López,1996-08-10,17033061C,aitor.lópez@awesomecode.net,185417,ES44209556455181134018,3547.89,2024-03-19T11:34:28,Bilbao,expenses,food,-100.0,-51728.06
buyer_1,Aitor,López,1996-08-10,17033061C,aitor.lópez@awesomecode.net,185417,ES44209556455181134018,3547.89,2024-03-21T18:23:19,Bilbao,expenses,healthcare,-88.87,-51816.93
buyer_1,Aitor,López,1996-08-10,17033061C,aitor.lópez@awesomecode.net,185417,ES44209556455181134018,3547.89,2024-03-23T12:07:36,Bilbao,expenses,transport,-72.59,-51889.52
buyer_1,Aitor,López,1996-08-10,17033061C,aitor.lópez@awesomecode.net,185417,ES44209556455181134018,3547.89,2024-03-23T14:34:30,Bilbao,expenses,cash,-100.0,-51989.52
buyer_1,Aitor,López,1996-08-10,17033061C,aitor.lópez@awesomecode.net,185417,ES44209556455181134018,3547.89,2024-03-23T17:08:36,Bilbao,expenses,appliances,-149.7,-52139.22
buyer_1,Aitor,López,1996-08-10,17033061C,aitor.lópez@awesomecode.net,185417,ES44209556455181134018,3547.89,2024-03-23T00:18:10,Bilbao,expenses,gifts,-550.95,-52690.17
buyer_1,Aitor,López,1996-08-10,17033061C,aitor.lópez@awesomecode.net,185417,ES44209556455181134018,3547.89,2024-03-24T15:42:54,Bilbao,expenses,cash,-100.0,-52790.17
buyer_1,Aitor,López,1996-08-10,17033061C,aitor.lópez@awesomecode.net,185417,ES44209556455181134018,3547.89,2024-03-28T19:15:41,Bilbao,expenses,travel,-780.3,-53570.47
buyer_1,Aitor,López,1996-08-10,17033061C,aitor.lópez@awesomecode.net,185417,ES44209556455181134018,3547.89,2024-03-29T16:30:23,Bilbao,expenses,food,-104.32,-53674.79
buyer_1,Aitor,López,1996-08-10,17033061C,aitor.lópez@awesomecode.net,185417,ES44209556455181134018,3547.89,2024-03-30T15:33:26,Bilbao,expenses,education,-50.24,-53725.03
buyer_1,Aitor,López,1996-08-10,17033061C,aitor.lópez@awesomecode.net,185417,ES44209556455181134018,3547.89,2024-04-01T09:48:37,Bilbao,incomes,salary,2676.25,-51048.78
buyer_1,Aitor,López,1996-08-10,17033061C,aitor.lópez@awesomecode.net,185417,ES44209556455181134018,3547.89,2024-04-03T17:02:49,Bilbao,expenses,transport,-83.41,-51132.19
buyer_1,Aitor,López,1996-08-10,17033061C,aitor.lópez@awesomecode.net,185417,ES44209556455181134018,3547.89,2024-04-04T14:01:03,Bilbao,expenses,food,-60.28,-51192.47
buyer_1,Aitor,López,1996-08-10,17033061C,aitor.lópez@awesomecode.net,185417,ES44209556455181134018,3547.89,2024-04-05T09:09:58,Bilbao,expenses,rent,-833.31,-52025.78
buyer_1,Aitor,López,1996-08-10,17033061C,aitor.lópez@awesomecode.net,185417,ES44209556455181134018,3547.89,2024-04-05T22:06:49,Bilbao,expenses,water,-59.15,-52084.93
buyer_1,Aitor,López,1996-08-10,17033061C,aitor.lópez@awesomecode.net,185417,ES44209556455181134018,3547.89,2024-04-05T09:34:09,Bilbao,expenses,electricity,-63.62,-52148.55
buyer_1,Aitor,López,1996-08-10,17033061C,aitor.lópez@awesomecode.net,185417,ES44209556455181134018,3547.89,2024-04-05T20:55:20,Bilbao,expenses,gas,-80.49,-52229.04
buyer_1,Aitor,López,1996-08-10,17033061C,aitor.lópez@awesomecode.net,185417,ES44209556455181134018,3547.89,2024-04-05T19:39:47,Bilbao,expenses,internet,-56.2,-52285.24
buyer_1,Aitor,López,1996-08-10,17033061C,aitor.lópez@awesomecode.net,185417,ES44209556455181134018,3547.89,2024-04-05T20:31:36,Bilbao,expenses,phone,-55.39,-52340.63
buyer_1,Aitor,López,1996-08-10,17033061C,aitor.lópez@awesomecode.net,185417,ES44209556455181134018,3547.89,2024-04-06T11:05:43,Bilbao,expenses,electricity,-104.06,-52444.69
buyer_1,Aitor,López,1996-08-10,17033061C,aitor.lópez@awesomecode.net,185417,ES44209556455181134018,3547.89,2024-04-06T19:18:24,Bilbao,expenses,gas,-48.67,-52493.36
buyer_1,Aitor,López,1996-08-10,17033061C,aitor.lópez@awesomecode.net,185417,ES44209556455181134018,3547.89,2024-04-06T16:26:13,Bilbao,expenses,internet,-56.2,-52549.56
buyer_1,Aitor,López,1996-08-10,17033061C,aitor.lópez@awesomecode.net,185417,ES44209556455181134018,3547.89,2024-04-07T08:25:18,Bilbao,expenses,phone,-41.54,-52591.1
buyer_1,Aitor,López,1996-08-10,17033061C,aitor.lópez@awesomecode.net,185417,ES44209556455181134018,3547.89,2024-04-07T06:59:36,Bilbao,expenses,cash,-100.0,-52691.1
buyer_1,Aitor,López,1996-08-10,17033061C,aitor.lópez@awesomecode.net,185417,ES44209556455181134018,3547.89,2024-04-08T20:42:56,Bilbao,expenses,gas,-56.13,-52747.23
buyer_1,Aitor,López,1996-08-10,17033061C,aitor.lópez@awesomecode.net,185417,ES44209556455181134018,3547.89,2024-04-08T09:47:24,Bilbao,expenses,internet,-56.2,-52803.43
buyer_1,Aitor,López,1996-08-10,17033061C,aitor.lópez@awesomecode.net,185417,ES44209556455181134018,3547.89,2024-04-08T18:40:27,Bilbao,expenses,food,-66.45,-52869.88
buyer_1,Aitor,López,1996-08-10,17033061C,aitor.lópez@awesomecode.net,185417,ES44209556455181134018,3547.89,2024-04-08T08:40:29,Bilbao,expenses,cash,-100.0,-52969.88
buyer_1,Aitor,López,1996-08-10,17033061C,aitor.lópez@awesomecode.net,185417,ES44209556455181134018,3547.89,2024-04-09T12:54:36,Bilbao,expenses,food,-96.29,-53066.17
buyer_1,Aitor,López,1996-08-10,17033061C,aitor.lópez@awesomecode.net,185417,ES44209556455181134018,3547.89,2024-04-09T17:07:35,Bilbao,expenses,transport,-50.19,-53116.36
buyer_1,Aitor,López,1996-08-10,17033061C,aitor.lópez@awesomecode.net,185417,ES44209556455181134018,3547.89,2024-04-09T22:25:37,Bilbao,expenses,education,-44.92,-53161.28
buyer_1,Aitor,López,1996-08-10,17033061C,aitor.lópez@awesomecode.net,185417,ES44209556455181134018,3547.89,2024-04-12T15:41:26,Bilbao,expenses,transport,-45.77,-53207.05
buyer_1,Aitor,López,1996-08-10,17033061C,aitor.lópez@awesomecode.net,185417,ES44209556455181134018,3547.89,2024-04-12T10:55:24,Bilbao,expenses,cash,-100.0,-53307.05
buyer_1,Aitor,López,1996-08-10,17033061C,aitor.lópez@awesomecode.net,185417,ES44209556455181134018,3547.89,2024-04-13T09:38:21,Bilbao,expenses,leisure,-46.55,-53353.6
buyer_1,Aitor,López,1996-08-10,17033061C,aitor.lópez@awesomecode.net,185417,ES44209556455181134018,3547.89,2024-04-16T09:06:52,Bilbao,expenses,transport,-62.84,-53416.44
buyer_1,Aitor,López,1996-08-10,17033061C,aitor.lópez@awesomecode.net,185417,ES44209556455181134018,3547.89,2024-04-19T13:28:27,Bilbao,expenses,food,-92.15,-53508.59
buyer_1,Aitor,López,1996-08-10,17033061C,aitor.lópez@awesomecode.net,185417,ES44209556455181134018,3547.89,2024-04-19T21:46:53,Bilbao,expenses,cash,-100.0,-53608.59
buyer_1,Aitor,López,1996-08-10,17033061C,aitor.lópez@awesomecode.net,185417,ES44209556455181134018,3547.89,2024-04-20T12:59:44,Bilbao,expenses,leisure,-73.16,-53681.75
buyer_1,Aitor,López,1996-08-10,17033061C,aitor.lópez@awesomecode.net,185417,ES44209556455181134018,3547.89,2024-04-22T12:08:37,Bilbao,expenses,cash,-100.0,-53781.75
buyer_1,Aitor,López,1996-08-10,17033061C,aitor.lópez@awesomecode.net,185417,ES44209556455181134018,3547.89,2024-04-22T20:44:18,Bilbao,expenses,appliances,-390.55,-54172.3
buyer_1,Aitor,López,1996-08-10,17033061C,aitor.lópez@awesomecode.net,185417,ES44209556455181134018,3547.89,2024-04-24T23:09:19,Bilbao,expenses,food,-107.94,-54280.24
buyer_1,Aitor,López,1996-08-10,17033061C,aitor.lópez@awesomecode.net,185417,ES44209556455181134018,3547.89,2024-04-24T05:48:42,Bilbao,expenses,leisure,-41.21,-54321.45
buyer_1,Aitor,López,1996-08-10,17033061C,aitor.lópez@awesomecode.net,185417,ES44209556455181134018,3547.89,2024-04-24T22:54:39,Bilbao,expenses,gifts,-701.08,-55022.53
buyer_1,Aitor,López,1996-08-10,17033061C,aitor.lópez@awesomecode.net,185417,ES44209556455181134018,3547.89,2024-04-25T23:45:11,Bilbao,expenses,cash,-100.0,-55122.53
buyer_1,Aitor,López,1996-08-10,17033061C,aitor.lópez@awesomecode.net,185417,ES44209556455181134018,3547.89,2024-04-26T17:19:08,Bilbao,expenses,transport,-61.38,-55183.91
buyer_1,Aitor,López,1996-08-10,17033061C,aitor.lópez@awesomecode.net,185417,ES44209556455181134018,3547.89,2024-04-27T22:47:52,Bilbao,expenses,food,-79.71,-55263.62
buyer_1,Aitor,López,1996-08-10,17033061C,aitor.lópez@awesomecode.net,185417,ES44209556455181134018,3547.89,2024-04-28T10:46:05,Bilbao,expenses,education,-71.43,-55335.05
buyer_1,Aitor,López,1996-08-10,17033061C,aitor.lópez@awesomecode.net,185417,ES44209556455181134018,3547.89,2024-04-28T16:02:26,Bilbao,expenses,repairs,-254.21,-55589.26
buyer_1,Aitor,López,1996-08-10,17033061C,aitor.lópez@awesomecode.net,185417,ES44209556455181134018,3547.89,2024-05-01T18:59:10,Bilbao,incomes,salary,2676.25,-52913.01
buyer_1,Aitor,López,1996-08-10,17033061C,aitor.lópez@awesomecode.net,185417,ES44209556455181134018,3547.89,2024-05-03T12:43:11,Bilbao,expenses,food,-111.72,-53024.73
buyer_1,Aitor,López,1996-08-10,17033061C,aitor.lópez@awesomecode.net,185417,ES44209556455181134018,3547.89,2024-05-03T10:17:32,Bilbao,expenses,cash,-100.0,-53124.73
buyer_1,Aitor,López,1996-08-10,17033061C,aitor.lópez@awesomecode.net,185417,ES44209556455181134018,3547.89,2024-05-04T08:04:41,Bilbao,expenses,food,-120.02,-53244.75
buyer_1,Aitor,López,1996-08-10,17033061C,aitor.lópez@awesomecode.net,185417,ES44209556455181134018,3547.89,2024-05-05T17:03:49,Bilbao,expenses,rent,-833.31,-54078.06
buyer_1,Aitor,López,1996-08-10,17033061C,aitor.lópez@awesomecode.net,185417,ES44209556455181134018,3547.89,2024-05-05T13:03:00,Bilbao,expenses,transport,-81.48,-54159.54
buyer_1,Aitor,López,1996-08-10,17033061C,aitor.lópez@awesomecode.net,185417,ES44209556455181134018,3547.89,2024-05-06T20:36:34,Bilbao,expenses,electricity,-100.73,-54260.27
buyer_1,Aitor,López,1996-08-10,17033061C,aitor.lópez@awesomecode.net,185417,ES44209556455181134018,3547.89,2024-05-06T19:31:08,Bilbao,expenses,transport,-48.08,-54308.35
buyer_1,Aitor,López,1996-08-10,17033061C,aitor.lópez@awesomecode.net,185417,ES44209556455181134018,3547.89,2024-05-06T11:44:42,Bilbao,expenses,education,-70.52,-54378.87
buyer_1,Aitor,López,1996-08-10,17033061C,aitor.lópez@awesomecode.net,185417,ES44209556455181134018,3547.89,2024-05-06T17:06:28,Bilbao,expenses,gifts,-295.35,-54674.22
buyer_1,Aitor,López,1996-08-10,17033061C,aitor.lópez@awesomecode.net,185417,ES44209556455181134018,3547.89,2024-05-07T18:51:01,Bilbao,expenses,gas,-150.12,-54824.34
buyer_1,Aitor,López,1996-08-10,17033061C,aitor.lópez@awesomecode.net,185417,ES44209556455181134018,3547.89,2024-05-07T15:26:27,Bilbao,expenses,food,-92.03,-54916.37
buyer_1,Aitor,López,1996-08-10,17033061C,aitor.lópez@awesomecode.net,185417,ES44209556455181134018,3547.89,2024-05-07T09:48:21,Bilbao,expenses,leisure,-70.46,-54986.83
buyer_1,Aitor,López,1996-08-10,17033061C,aitor.lópez@awesomecode.net,185417,ES44209556455181134018,3547.89,2024-05-08T19:35:32,Bilbao,expenses,electricity,-88.64,-55075.47
buyer_1,Aitor,López,1996-08-10,17033061C,aitor.lópez@awesomecode.net,185417,ES44209556455181134018,3547.89,2024-05-08T18:00:35,Bilbao,expenses,internet,-56.2,-55131.67
buyer_1,Aitor,López,1996-08-10,17033061C,aitor.lópez@awesomecode.net,185417,ES44209556455181134018,3547.89,2024-05-08T09:49:54,Bilbao,expenses,phone,-46.3,-55177.97
buyer_1,Aitor,López,1996-08-10,17033061C,aitor.lópez@awesomecode.net,185417,ES44209556455181134018,3547.89,2024-05-08T11:48:17,Bilbao,expenses,food,-123.97,-55301.94
buyer_1,Aitor,López,1996-08-10,17033061C,aitor.lópez@awesomecode.net,185417,ES44209556455181134018,3547.89,2024-05-09T11:25:09,Bilbao,expenses,transport,-41.12,-55343.06
buyer_1,Aitor,López,1996-08-10,17033061C,aitor.lópez@awesomecode.net,185417,ES44209556455181134018,3547.89,2024-05-10T11:35:10,Bilbao,expenses,food,-85.61,-55428.67
buyer_1,Aitor,López,1996-08-10,17033061C,aitor.lópez@awesomecode.net,185417,ES44209556455181134018,3547.89,2024-05-11T11:41:21,Bilbao,expenses,leisure,-80.54,-55509.21
buyer_1,Aitor,López,1996-08-10,17033061C,aitor.lópez@awesomecode.net,185417,ES44209556455181134018,3547.89,2024-05-11T17:06:46,Bilbao,expenses,cash,-100.0,-55609.21
buyer_1,Aitor,López,1996-08-10,17033061C,aitor.lópez@awesomecode.net,185417,ES44209556455181134018,3547.89,2024-05-13T15:56:15,Bilbao,expenses,food,-96.67,-55705.88
buyer_1,Aitor,López,1996-08-10,17033061C,aitor.lópez@awesomecode.net,185417,ES44209556455181134018,3547.89,2024-05-13T12:11:25,Bilbao,expenses,cash,-100.0,-55805.88
buyer_1,Aitor,López,1996-08-10,17033061C,aitor.lópez@awesomecode.net,185417,ES44209556455181134018,3547.89,2024-05-14T23:46:28,Bilbao,expenses,cash,-100.0,-55905.88
buyer_1,Aitor,López,1996-08-10,17033061C,aitor.lópez@awesomecode.net,185417,ES44209556455181134018,3547.89,2024-05-15T14:55:28,Bilbao,expenses,healthcare,-65.34,-55971.22
buyer_1,Aitor,López,1996-08-10,17033061C,aitor.lópez@awesomecode.net,185417,ES44209556455181134018,3547.89,2024-05-16T08:05:53,Bilbao,expenses,cash,-100.0,-56071.22
buyer_1,Aitor,López,1996-08-10,17033061C,aitor.lópez@awesomecode.net,185417,ES44209556455181134018,3547.89,2024-05-18T08:23:46,Bilbao,expenses,food,-107.23,-56178.45
buyer_1,Aitor,López,1996-08-10,17033061C,aitor.lópez@awesomecode.net,185417,ES44209556455181134018,3547.89,2024-05-20T18:32:56,Bilbao,expenses,food,-108.98,-56287.43
buyer_1,Aitor,López,1996-08-10,17033061C,aitor.lópez@awesomecode.net,185417,ES44209556455181134018,3547.89,2024-05-20T11:26:15,Bilbao,expenses,repairs,-325.36,-56612.79
buyer_1,Aitor,López,1996-08-10,17033061C,aitor.lópez@awesomecode.net,185417,ES44209556455181134018,3547.89,2024-05-22T11:00:10,Bilbao,expenses,transport,-65.32,-56678.11
buyer_1,Aitor,López,1996-08-10,17033061C,aitor.lópez@awesomecode.net,185417,ES44209556455181134018,3547.89,2024-05-22T10:55:10,Bilbao,expenses,leisure,-78.19,-56756.3
buyer_1,Aitor,López,1996-08-10,17033061C,aitor.lópez@awesomecode.net,185417,ES44209556455181134018,3547.89,2024-05-23T18:44:45,Bilbao,expenses,cash,-100.0,-56856.3
buyer_1,Aitor,López,1996-08-10,17033061C,aitor.lópez@awesomecode.net,185417,ES44209556455181134018,3547.89,2024-05-25T15:37:56,Bilbao,expenses,transport,-85.04,-56941.34
buyer_1,Aitor,López,1996-08-10,17033061C,aitor.lópez@awesomecode.net,185417,ES44209556455181134018,3547.89,2024-05-25T00:44:11,Bilbao,expenses,clothing,-114.14,-57055.48
buyer_1,Aitor,López,1996-08-10,17033061C,aitor.lópez@awesomecode.net,185417,ES44209556455181134018,3547.89,2024-05-25T14:49:58,Bilbao,expenses,cash,-100.0,-57155.48
buyer_1,Aitor,López,1996-08-10,17033061C,aitor.lópez@awesomecode.net,185417,ES44209556455181134018,3547.89,2024-05-25T20:22:57,Bilbao,expenses,gifts,-78.58,-57234.06
buyer_1,Aitor,López,1996-08-10,17033061C,aitor.lópez@awesomecode.net,185417,ES44209556455181134018,3547.89,2024-05-26T16:31:14,Bilbao,expenses,food,-94.06,-57328.12
buyer_1,Aitor,López,1996-08-10,17033061C,aitor.lópez@awesomecode.net,185417,ES44209556455181134018,3547.89,2024-05-27T06:08:41,Bilbao,expenses,leisure,-52.17,-57380.29
buyer_1,Aitor,López,1996-08-10,17033061C,aitor.lópez@awesomecode.net,185417,ES44209556455181134018,3547.89,2024-05-27T19:06:06,Bilbao,expenses,travel,-373.02,-57753.31
buyer_1,Aitor,López,1996-08-10,17033061C,aitor.lópez@awesomecode.net,185417,ES44209556455181134018,3547.89,2024-05-27T13:00:06,Bilbao,expenses,gifts,-440.67,-58193.98
buyer_1,Aitor,López,1996-08-10,17033061C,aitor.lópez@awesomecode.net,185417,ES44209556455181134018,3547.89,2024-05-28T11:14:25,Bilbao,expenses,food,-81.55,-58275.53
buyer_1,Aitor,López,1996-08-10,17033061C,aitor.lópez@awesomecode.net,185417,ES44209556455181134018,3547.89,2024-05-28T09:41:40,Bilbao,expenses,education,-42.76,-58318.29
buyer_1,Aitor,López,1996-08-10,17033061C,aitor.lópez@awesomecode.net,185417,ES44209556455181134018,3547.89,2024-05-29T09:12:08,Bilbao,expenses,transport,-52.52,-58370.81
buyer_1,Aitor,López,1996-08-10,17033061C,aitor.lópez@awesomecode.net,185417,ES44209556455181134018,3547.89,2024-05-30T13:58:01,Bilbao,expenses,leisure,-24.83,-58395.64
buyer_1,Aitor,López,1996-08-10,17033061C,aitor.lópez@awesomecode.net,185417,ES44209556455181134018,3547.89,2024-05-30T11:16:53,Bilbao,expenses,gifts,-658.73,-59054.37
buyer_1,Aitor,López,1996-08-10,17033061C,aitor.lópez@awesomecode.net,185417,ES44209556455181134018,3547.89,2024-05-31T09:06:12,Bilbao,expenses,transport,-71.05,-59125.42
buyer_1,Aitor,López,1996-08-10,17033061C,aitor.lópez@awesomecode.net,185417,ES44209556455181134018,3547.89,2024-05-31T18:39:03,Bilbao,expenses,gifts,-445.66,-59571.08
buyer_1,Aitor,López,1996-08-10,17033061C,aitor.lópez@awesomecode.net,185417,ES44209556455181134018,3547.89,2024-06-01T02:30:12,Bilbao,incomes,salary,2676.25,-56894.83
buyer_1,Aitor,López,1996-08-10,17033061C,aitor.lópez@awesomecode.net,185417,ES44209556455181134018,3547.89,2024-06-01T02:30:12,Bilbao,incomes,salary_bonus,2021.6,-54873.23
buyer_1,Aitor,López,1996-08-10,17033061C,aitor.lópez@awesomecode.net,185417,ES44209556455181134018,3547.89,2024-06-02T08:14:33,Bilbao,expenses,taxes,-2370.04,-57243.27
buyer_1,Aitor,López,1996-08-10,17033061C,aitor.lópez@awesomecode.net,185417,ES44209556455181134018,3547.89,2024-06-02T14:02:22,Bilbao,expenses,insurance,-446.26,-57689.53
buyer_1,Aitor,López,1996-08-10,17033061C,aitor.lópez@awesomecode.net,185417,ES44209556455181134018,3547.89,2024-06-02T16:31:16,Bilbao,expenses,leisure,-35.17,-57724.7
buyer_1,Aitor,López,1996-08-10,17033061C,aitor.lópez@awesomecode.net,185417,ES44209556455181134018,3547.89,2024-06-03T23:35:41,Bilbao,expenses,cash,-100.0,-57824.7
buyer_1,Aitor,López,1996-08-10,17033061C,aitor.lópez@awesomecode.net,185417,ES44209556455181134018,3547.89,2024-06-05T19:46:07,Bilbao,expenses,rent,-833.31,-58658.01
buyer_1,Aitor,López,1996-08-10,17033061C,aitor.lópez@awesomecode.net,185417,ES44209556455181134018,3547.89,2024-06-05T19:31:11,Bilbao,expenses,water,-59.62,-58717.63
buyer_1,Aitor,López,1996-08-10,17033061C,aitor.lópez@awesomecode.net,185417,ES44209556455181134018,3547.89,2024-06-05T22:30:33,Bilbao,expenses,leisure,-53.14,-58770.77
buyer_1,Aitor,López,1996-08-10,17033061C,aitor.lópez@awesomecode.net,185417,ES44209556455181134018,3547.89,2024-06-05T15:34:47,Bilbao,expenses,education,-72.5,-58843.27
buyer_1,Aitor,López,1996-08-10,17033061C,aitor.lópez@awesomecode.net,185417,ES44209556455181134018,3547.89,2024-06-07T20:37:27,Bilbao,expenses,internet,-56.2,-58899.47
buyer_1,Aitor,López,1996-08-10,17033061C,aitor.lópez@awesomecode.net,185417,ES44209556455181134018,3547.89,2024-06-08T13:57:39,Bilbao,expenses,water,-38.5,-58937.97
buyer_1,Aitor,López,1996-08-10,17033061C,aitor.lópez@awesomecode.net,185417,ES44209556455181134018,3547.89,2024-06-11T10:23:14,Bilbao,expenses,education,-51.19,-58989.16
buyer_1,Aitor,López,1996-08-10,17033061C,aitor.lópez@awesomecode.net,185417,ES44209556455181134018,3547.89,2024-06-11T07:19:01,Bilbao,expenses,repairs,-197.7,-59186.86
buyer_1,Aitor,López,1996-08-10,17033061C,aitor.lópez@awesomecode.net,185417,ES44209556455181134018,3547.89,2024-06-12T21:20:35,Bilbao,expenses,healthcare,-123.76,-59310.62
buyer_1,Aitor,López,1996-08-10,17033061C,aitor.lópez@awesomecode.net,185417,ES44209556455181134018,3547.89,2024-06-13T09:40:43,Bilbao,expenses,food,-114.83,-59425.45
buyer_1,Aitor,López,1996-08-10,17033061C,aitor.lópez@awesomecode.net,185417,ES44209556455181134018,3547.89,2024-06-15T16:54:15,Bilbao,expenses,healthcare,-92.11,-59517.56
buyer_1,Aitor,López,1996-08-10,17033061C,aitor.lópez@awesomecode.net,185417,ES44209556455181134018,3547.89,2024-06-15T15:35:25,Bilbao,expenses,repairs,-165.53,-59683.09
buyer_1,Aitor,López,1996-08-10,17033061C,aitor.lópez@awesomecode.net,185417,ES44209556455181134018,3547.89,2024-06-16T01:47:49,Bilbao,expenses,cash,-100.0,-59783.09
buyer_1,Aitor,López,1996-08-10,17033061C,aitor.lópez@awesomecode.net,185417,ES44209556455181134018,3547.89,2024-06-19T09:52:41,Bilbao,expenses,travel,-1011.38,-60794.47
buyer_1,Aitor,López,1996-08-10,17033061C,aitor.lópez@awesomecode.net,185417,ES44209556455181134018,3547.89,2024-06-19T14:14:01,Bilbao,expenses,gifts,-66.39,-60860.86
buyer_1,Aitor,López,1996-08-10,17033061C,aitor.lópez@awesomecode.net,185417,ES44209556455181134018,3547.89,2024-06-20T12:03:38,Bilbao,expenses,repairs,-329.04,-61189.9
buyer_1,Aitor,López,1996-08-10,17033061C,aitor.lópez@awesomecode.net,185417,ES44209556455181134018,3547.89,2024-06-21T13:15:00,Bilbao,expenses,transport,-72.62,-61262.52
buyer_1,Aitor,López,1996-08-10,17033061C,aitor.lópez@awesomecode.net,185417,ES44209556455181134018,3547.89,2024-06-22T07:55:56,Bilbao,expenses,food,-113.83,-61376.35
buyer_1,Aitor,López,1996-08-10,17033061C,aitor.lópez@awesomecode.net,185417,ES44209556455181134018,3547.89,2024-06-23T15:42:15,Bilbao,expenses,transport,-58.07,-61434.42
buyer_1,Aitor,López,1996-08-10,17033061C,aitor.lópez@awesomecode.net,185417,ES44209556455181134018,3547.89,2024-06-23T08:06:14,Bilbao,expenses,cash,-100.0,-61534.42
buyer_1,Aitor,López,1996-08-10,17033061C,aitor.lópez@awesomecode.net,185417,ES44209556455181134018,3547.89,2024-06-23T12:15:52,Bilbao,expenses,gifts,-49.64,-61584.06
buyer_1,Aitor,López,1996-08-10,17033061C,aitor.lópez@awesomecode.net,185417,ES44209556455181134018,3547.89,2024-06-24T13:40:58,Bilbao,expenses,food,-87.36,-61671.42
buyer_1,Aitor,López,1996-08-10,17033061C,aitor.lópez@awesomecode.net,185417,ES44209556455181134018,3547.89,2024-06-24T17:41:20,Bilbao,expenses,cash,-100.0,-61771.42
buyer_1,Aitor,López,1996-08-10,17033061C,aitor.lópez@awesomecode.net,185417,ES44209556455181134018,3547.89,2024-06-25T09:09:55,Bilbao,expenses,cash,-100.0,-61871.42
buyer_1,Aitor,López,1996-08-10,17033061C,aitor.lópez@awesomecode.net,185417,ES44209556455181134018,3547.89,2024-06-30T12:24:33,Bilbao,expenses,food,-87.26,-61958.68
buyer_1,Aitor,López,1996-08-10,17033061C,aitor.lópez@awesomecode.net,185417,ES44209556455181134018,3547.89,2024-07-01T04:25:46,Bilbao,incomes,salary,2676.25,-59282.43
buyer_1,Aitor,López,1996-08-10,17033061C,aitor.lópez@awesomecode.net,185417,ES44209556455181134018,3547.89,2024-07-01T04:25:46,Bilbao,incomes,extra_income,266.49,-59015.94
buyer_1,Aitor,López,1996-08-10,17033061C,aitor.lópez@awesomecode.net,185417,ES44209556455181134018,3547.89,2024-07-01T08:52:04,Bilbao,expenses,transport,-40.99,-59056.93
buyer_1,Aitor,López,1996-08-10,17033061C,aitor.lópez@awesomecode.net,185417,ES44209556455181134018,3547.89,2024-07-01T16:30:56,Bilbao,expenses,gifts,-579.81,-59636.74
buyer_1,Aitor,López,1996-08-10,17033061C,aitor.lópez@awesomecode.net,185417,ES44209556455181134018,3547.89,2024-07-03T13:29:33,Bilbao,expenses,transport,-74.92,-59711.66
buyer_1,Aitor,López,1996-08-10,17033061C,aitor.lópez@awesomecode.net,185417,ES44209556455181134018,3547.89,2024-07-04T13:26:30,Bilbao,expenses,food,-89.08,-59800.74
buyer_1,Aitor,López,1996-08-10,17033061C,aitor.lópez@awesomecode.net,185417,ES44209556455181134018,3547.89,2024-07-04T13:27:20,Bilbao,expenses,transport,-79.19,-59879.93
buyer_1,Aitor,López,1996-08-10,17033061C,aitor.lópez@awesomecode.net,185417,ES44209556455181134018,3547.89,2024-07-04T00:20:13,Bilbao,expenses,leisure,-67.27,-59947.2
buyer_1,Aitor,López,1996-08-10,17033061C,aitor.lópez@awesomecode.net,185417,ES44209556455181134018,3547.89,2024-07-04T20:19:44,Bilbao,expenses,cash,-100.0,-60047.2
buyer_1,Aitor,López,1996-08-10,17033061C,aitor.lópez@awesomecode.net,185417,ES44209556455181134018,3547.89,2024-07-05T14:51:39,Bilbao,expenses,rent,-833.31,-60880.51
buyer_1,Aitor,López,1996-08-10,17033061C,aitor.lópez@awesomecode.net,185417,ES44209556455181134018,3547.89,2024-07-05T08:13:56,Bilbao,expenses,internet,-56.2,-60936.71
buyer_1,Aitor,López,1996-08-10,17033061C,aitor.lópez@awesomecode.net,185417,ES44209556455181134018,3547.89,2024-07-05T12:10:46,Bilbao,expenses,leisure,-41.11,-60977.82
buyer_1,Aitor,López,1996-08-10,17033061C,aitor.lópez@awesomecode.net,185417,ES44209556455181134018,3547.89,2024-07-06T05:47:23,Bilbao,expenses,electricity,-72.29,-61050.11
buyer_1,Aitor,López,1996-08-10,17033061C,aitor.lópez@awesomecode.net,185417,ES44209556455181134018,3547.89,2024-07-06T19:03:33,Bilbao,expenses,internet,-56.2,-61106.31
buyer_1,Aitor,López,1996-08-10,17033061C,aitor.lópez@awesomecode.net,185417,ES44209556455181134018,3547.89,2024-07-06T16:42:06,Bilbao,expenses,food,-119.91,-61226.22
buyer_1,Aitor,López,1996-08-10,17033061C,aitor.lópez@awesomecode.net,185417,ES44209556455181134018,3547.89,2024-07-07T12:40:39,Bilbao,expenses,water,-28.65,-61254.87
buyer_1,Aitor,López,1996-08-10,17033061C,aitor.lópez@awesomecode.net,185417,ES44209556455181134018,3547.89,2024-07-07T16:51:31,Bilbao,expenses,phone,-41.24,-61296.11
buyer_1,Aitor,López,1996-08-10,17033061C,aitor.lópez@awesomecode.net,185417,ES44209556455181134018,3547.89,2024-07-07T21:18:55,Bilbao,expenses,food,-102.39,-61398.5
buyer_1,Aitor,López,1996-08-10,17033061C,aitor.lópez@awesomecode.net,185417,ES44209556455181134018,3547.89,2024-07-07T12:50:01,Bilbao,expenses,leisure,-38.19,-61436.69
buyer_1,Aitor,López,1996-08-10,17033061C,aitor.lópez@awesomecode.net,185417,ES44209556455181134018,3547.89,2024-07-07T18:07:55,Bilbao,expenses,cash,-100.0,-61536.69
buyer_1,Aitor,López,1996-08-10,17033061C,aitor.lópez@awesomecode.net,185417,ES44209556455181134018,3547.89,2024-07-08T19:05:38,Bilbao,expenses,water,-36.68,-61573.37
buyer_1,Aitor,López,1996-08-10,17033061C,aitor.lópez@awesomecode.net,185417,ES44209556455181134018,3547.89,2024-07-08T14:36:30,Bilbao,expenses,internet,-56.2,-61629.57
buyer_1,Aitor,López,1996-08-10,17033061C,aitor.lópez@awesomecode.net,185417,ES44209556455181134018,3547.89,2024-07-10T19:22:55,Bilbao,expenses,leisure,-38.53,-61668.1
buyer_1,Aitor,López,1996-08-10,17033061C,aitor.lópez@awesomecode.net,185417,ES44209556455181134018,3547.89,2024-07-11T10:18:15,Bilbao,expenses,transport,-77.7,-61745.8
buyer_1,Aitor,López,1996-08-10,17033061C,aitor.lópez@awesomecode.net,185417,ES44209556455181134018,3547.89,2024-07-12T21:45:20,Bilbao,expenses,food,-100.28,-61846.08
buyer_1,Aitor,López,1996-08-10,17033061C,aitor.lópez@awesomecode.net,185417,ES44209556455181134018,3547.89,2024-07-16T16:27:37,Bilbao,expenses,repairs,-49.98,-61896.06
buyer_1,Aitor,López,1996-08-10,17033061C,aitor.lópez@awesomecode.net,185417,ES44209556455181134018,3547.89,2024-07-17T17:49:37,Bilbao,expenses,transport,-43.51,-61939.57
buyer_1,Aitor,López,1996-08-10,17033061C,aitor.lópez@awesomecode.net,185417,ES44209556455181134018,3547.89,2024-07-18T18:40:19,Bilbao,expenses,food,-98.69,-62038.26
buyer_1,Aitor,López,1996-08-10,17033061C,aitor.lópez@awesomecode.net,185417,ES44209556455181134018,3547.89,2024-07-18T15:54:54,Bilbao,expenses,repairs,-58.2,-62096.46
buyer_1,Aitor,López,1996-08-10,17033061C,aitor.lópez@awesomecode.net,185417,ES44209556455181134018,3547.89,2024-07-20T13:47:47,Bilbao,expenses,leisure,-59.65,-62156.11
buyer_1,Aitor,López,1996-08-10,17033061C,aitor.lópez@awesomecode.net,185417,ES44209556455181134018,3547.89,2024-07-21T13:34:17,Bilbao,expenses,leisure,-68.07,-62224.18
buyer_1,Aitor,López,1996-08-10,17033061C,aitor.lópez@awesomecode.net,185417,ES44209556455181134018,3547.89,2024-07-21T10:32:17,Bilbao,expenses,cash,-100.0,-62324.18
buyer_1,Aitor,López,1996-08-10,17033061C,aitor.lópez@awesomecode.net,185417,ES44209556455181134018,3547.89,2024-07-22T16:43:04,Bilbao,expenses,education,-64.66,-62388.84
buyer_1,Aitor,López,1996-08-10,17033061C,aitor.lópez@awesomecode.net,185417,ES44209556455181134018,3547.89,2024-07-24T11:15:57,Bilbao,expenses,leisure,-25.39,-62414.23
buyer_1,Aitor,López,1996-08-10,17033061C,aitor.lópez@awesomecode.net,185417,ES44209556455181134018,3547.89,2024-07-24T23:24:23,Bilbao,expenses,cash,-100.0,-62514.23
buyer_1,Aitor,López,1996-08-10,17033061C,aitor.lópez@awesomecode.net,185417,ES44209556455181134018,3547.89,2024-07-24T17:00:01,Bilbao,expenses,repairs,-160.69,-62674.92
buyer_1,Aitor,López,1996-08-10,17033061C,aitor.lópez@awesomecode.net,185417,ES44209556455181134018,3547.89,2024-07-25T18:41:19,Bilbao,expenses,leisure,-81.46,-62756.38
buyer_1,Aitor,López,1996-08-10,17033061C,aitor.lópez@awesomecode.net,185417,ES44209556455181134018,3547.89,2024-07-26T11:27:27,Bilbao,expenses,gifts,-603.38,-63359.76
buyer_1,Aitor,López,1996-08-10,17033061C,aitor.lópez@awesomecode.net,185417,ES44209556455181134018,3547.89,2024-07-27T09:46:55,Bilbao,expenses,travel,-744.54,-64104.3
buyer_1,Aitor,López,1996-08-10,17033061C,aitor.lópez@awesomecode.net,185417,ES44209556455181134018,3547.89,2024-07-29T20:33:38,Bilbao,expenses,transport,-70.92,-64175.22
buyer_1,Aitor,López,1996-08-10,17033061C,aitor.lópez@awesomecode.net,185417,ES44209556455181134018,3547.89,2024-08-01T21:49:25,Bilbao,incomes,salary,2676.25,-61498.97
buyer_1,Aitor,López,1996-08-10,17033061C,aitor.lópez@awesomecode.net,185417,ES44209556455181134018,3547.89,2024-08-01T19:01:29,Bilbao,expenses,cash,-100.0,-61598.97
buyer_1,Aitor,López,1996-08-10,17033061C,aitor.lópez@awesomecode.net,185417,ES44209556455181134018,3547.89,2024-08-02T09:51:28,Bilbao,expenses,food,-63.34,-61662.31
buyer_1,Aitor,López,1996-08-10,17033061C,aitor.lópez@awesomecode.net,185417,ES44209556455181134018,3547.89,2024-08-03T20:46:35,Bilbao,expenses,transport,-77.06,-61739.37
buyer_1,Aitor,López,1996-08-10,17033061C,aitor.lópez@awesomecode.net,185417,ES44209556455181134018,3547.89,2024-08-03T22:03:42,Bilbao,expenses,clothing,-152.52,-61891.89
buyer_1,Aitor,López,1996-08-10,17033061C,aitor.lópez@awesomecode.net,185417,ES44209556455181134018,3547.89,2024-08-04T20:14:39,Bilbao,expenses,food,-99.48,-61991.37
buyer_1,Aitor,López,1996-08-10,17033061C,aitor.lópez@awesomecode.net,185417,ES44209556455181134018,3547.89,2024-08-04T06:49:47,Bilbao,expenses,transport,-42.56,-62033.93
buyer_1,Aitor,López,1996-08-10,17033061C,aitor.lópez@awesomecode.net,185417,ES44209556455181134018,3547.89,2024-08-05T14:32:41,Bilbao,expenses,rent,-833.31,-62867.24
buyer_1,Aitor,López,1996-08-10,17033061C,aitor.lópez@awesomecode.net,185417,ES44209556455181134018,3547.89,2024-08-05T18:40:32,Bilbao,expenses,phone,-54.56,-62921.8
buyer_1,Aitor,López,1996-08-10,17033061C,aitor.lópez@awesomecode.net,185417,ES44209556455181134018,3547.89,2024-08-05T16:08:14,Bilbao,expenses,appliances,-274.25,-63196.05
buyer_1,Aitor,López,1996-08-10,17033061C,aitor.lópez@awesomecode.net,185417,ES44209556455181134018,3547.89,2024-08-05T09:34:47,Bilbao,expenses,repairs,-270.17,-63466.22
buyer_1,Aitor,López,1996-08-10,17033061C,aitor.lópez@awesomecode.net,185417,ES44209556455181134018,3547.89,2024-08-06T11:46:48,Bilbao,expenses,water,-38.05,-63504.27
buyer_1,Aitor,López,1996-08-10,17033061C,aitor.lópez@awesomecode.net,185417,ES44209556455181134018,3547.89,2024-08-06T17:43:10,Bilbao,expenses,gas,-62.24,-63566.51
buyer_1,Aitor,López,1996-08-10,17033061C,aitor.lópez@awesomecode.net,185417,ES44209556455181134018,3547.89,2024-08-06T14:10:16,Bilbao,expenses,internet,-56.2,-63622.71
buyer_1,Aitor,López,1996-08-10,17033061C,aitor.lópez@awesomecode.net,185417,ES44209556455181134018,3547.89,2024-08-06T20:33:41,Bilbao,expenses,cash,-100.0,-63722.71
buyer_1,Aitor,López,1996-08-10,17033061C,aitor.lópez@awesomecode.net,185417,ES44209556455181134018,3547.89,2024-08-07T15:16:02,Bilbao,expenses,gas,-74.63,-63797.34
buyer_1,Aitor,López,1996-08-10,17033061C,aitor.lópez@awesomecode.net,185417,ES44209556455181134018,3547.89,2024-08-08T08:17:17,Bilbao,expenses,electricity,-119.23,-63916.57
buyer_1,Aitor,López,1996-08-10,17033061C,aitor.lópez@awesomecode.net,185417,ES44209556455181134018,3547.89,2024-08-08T11:00:23,Bilbao,expenses,gas,-95.62,-64012.19
buyer_1,Aitor,López,1996-08-10,17033061C,aitor.lópez@awesomecode.net,185417,ES44209556455181134018,3547.89,2024-08-08T09:11:58,Bilbao,expenses,food,-121.22,-64133.41
buyer_1,Aitor,López,1996-08-10,17033061C,aitor.lópez@awesomecode.net,185417,ES44209556455181134018,3547.89,2024-08-08T08:47:15,Bilbao,expenses,education,-48.05,-64181.46
buyer_1,Aitor,López,1996-08-10,17033061C,aitor.lópez@awesomecode.net,185417,ES44209556455181134018,3547.89,2024-08-11T16:00:06,Bilbao,expenses,education,-72.64,-64254.1
buyer_1,Aitor,López,1996-08-10,17033061C,aitor.lópez@awesomecode.net,185417,ES44209556455181134018,3547.89,2024-08-13T17:48:29,Bilbao,expenses,food,-120.99,-64375.09
buyer_1,Aitor,López,1996-08-10,17033061C,aitor.lópez@awesomecode.net,185417,ES44209556455181134018,3547.89,2024-08-13T15:16:43,Bilbao,expenses,transport,-83.61,-64458.7
buyer_1,Aitor,López,1996-08-10,17033061C,aitor.lópez@awesomecode.net,185417,ES44209556455181134018,3547.89,2024-08-13T13:11:40,Bilbao,expenses,leisure,-21.93,-64480.63
buyer_1,Aitor,López,1996-08-10,17033061C,aitor.lópez@awesomecode.net,185417,ES44209556455181134018,3547.89,2024-08-14T11:33:42,Bilbao,expenses,food,-86.34,-64566.97
buyer_1,Aitor,López,1996-08-10,17033061C,aitor.lópez@awesomecode.net,185417,ES44209556455181134018,3547.89,2024-08-15T18:16:34,Bilbao,expenses,transport,-86.63,-64653.6
buyer_1,Aitor,López,1996-08-10,17033061C,aitor.lópez@awesomecode.net,185417,ES44209556455181134018,3547.89,2024-08-19T17:21:54,Bilbao,expenses,cash,-100.0,-64753.6
buyer_1,Aitor,López,1996-08-10,17033061C,aitor.lópez@awesomecode.net,185417,ES44209556455181134018,3547.89,2024-08-20T17:13:57,Bilbao,expenses,food,-107.82,-64861.42
buyer_1,Aitor,López,1996-08-10,17033061C,aitor.lópez@awesomecode.net,185417,ES44209556455181134018,3547.89,2024-08-24T11:19:58,Bilbao,expenses,gifts,-656.83,-65518.25
buyer_1,Aitor,López,1996-08-10,17033061C,aitor.lópez@awesomecode.net,185417,ES44209556455181134018,3547.89,2024-08-25T03:01:37,Bilbao,expenses,transport,-59.29,-65577.54
buyer_1,Aitor,López,1996-08-10,17033061C,aitor.lópez@awesomecode.net,185417,ES44209556455181134018,3547.89,2024-08-27T11:51:43,Bilbao,expenses,cash,-100.0,-65677.54
buyer_1,Aitor,López,1996-08-10,17033061C,aitor.lópez@awesomecode.net,185417,ES44209556455181134018,3547.89,2024-08-28T08:27:37,Bilbao,expenses,transport,-43.86,-65721.4
buyer_1,Aitor,López,1996-08-10,17033061C,aitor.lópez@awesomecode.net,185417,ES44209556455181134018,3547.89,2024-08-30T09:25:56,Bilbao,expenses,cash,-100.0,-65821.4
buyer_1,Aitor,López,1996-08-10,17033061C,aitor.lópez@awesomecode.net,185417,ES44209556455181134018,3547.89,2024-08-31T15:57:06,Bilbao,expenses,food,-62.1,-65883.5
buyer_1,Aitor,López,1996-08-10,17033061C,aitor.lópez@awesomecode.net,185417,ES44209556455181134018,3547.89,2024-08-31T09:58:04,Bilbao,expenses,cash,-100.0,-65983.5
buyer_1,Aitor,López,1996-08-10,17033061C,aitor.lópez@awesomecode.net,185417,ES44209556455181134018,3547.89,2024-09-01T12:11:54,Bilbao,incomes,salary,2676.25,-63307.25
buyer_1,Aitor,López,1996-08-10,17033061C,aitor.lópez@awesomecode.net,185417,ES44209556455181134018,3547.89,2024-09-01T17:48:42,Bilbao,expenses,cash,-100.0,-63407.25
buyer_1,Aitor,López,1996-08-10,17033061C,aitor.lópez@awesomecode.net,185417,ES44209556455181134018,3547.89,2024-09-02T08:38:56,Bilbao,expenses,leisure,-20.0,-63427.25
buyer_1,Aitor,López,1996-08-10,17033061C,aitor.lópez@awesomecode.net,185417,ES44209556455181134018,3547.89,2024-09-03T15:18:34,Bilbao,expenses,transport,-79.16,-63506.41
buyer_1,Aitor,López,1996-08-10,17033061C,aitor.lópez@awesomecode.net,185417,ES44209556455181134018,3547.89,2024-09-03T15:32:05,Bilbao,expenses,repairs,-247.37,-63753.78
buyer_1,Aitor,López,1996-08-10,17033061C,aitor.lópez@awesomecode.net,185417,ES44209556455181134018,3547.89,2024-09-05T17:29:59,Bilbao,expenses,rent,-833.31,-64587.09
buyer_1,Aitor,López,1996-08-10,17033061C,aitor.lópez@awesomecode.net,185417,ES44209556455181134018,3547.89,2024-09-05T20:16:59,Bilbao,expenses,electricity,-40.62,-64627.71
buyer_1,Aitor,López,1996-08-10,17033061C,aitor.lópez@awesomecode.net,185417,ES44209556455181134018,3547.89,2024-09-05T19:45:12,Bilbao,expenses,internet,-56.2,-64683.91
buyer_1,Aitor,López,1996-08-10,17033061C,aitor.lópez@awesomecode.net,185417,ES44209556455181134018,3547.89,2024-09-05T13:22:31,Bilbao,expenses,gifts,-664.08,-65347.99
buyer_1,Aitor,López,1996-08-10,17033061C,aitor.lópez@awesomecode.net,185417,ES44209556455181134018,3547.89,2024-09-06T09:07:25,Bilbao,expenses,water,-54.71,-65402.7
buyer_1,Aitor,López,1996-08-10,17033061C,aitor.lópez@awesomecode.net,185417,ES44209556455181134018,3547.89,2024-09-06T13:19:39,Bilbao,expenses,electricity,-99.18,-65501.88
buyer_1,Aitor,López,1996-08-10,17033061C,aitor.lópez@awesomecode.net,185417,ES44209556455181134018,3547.89,2024-09-06T18:55:05,Bilbao,expenses,food,-72.21,-65574.09
buyer_1,Aitor,López,1996-08-10,17033061C,aitor.lópez@awesomecode.net,185417,ES44209556455181134018,3547.89,2024-09-07T10:29:41,Bilbao,expenses,electricity,-114.79,-65688.88
buyer_1,Aitor,López,1996-08-10,17033061C,aitor.lópez@awesomecode.net,185417,ES44209556455181134018,3547.89,2024-09-07T09:53:43,Bilbao,expenses,phone,-41.23,-65730.11
buyer_1,Aitor,López,1996-08-10,17033061C,aitor.lópez@awesomecode.net,185417,ES44209556455181134018,3547.89,2024-09-08T09:16:18,Bilbao,expenses,electricity,-82.86,-65812.97
buyer_1,Aitor,López,1996-08-10,17033061C,aitor.lópez@awesomecode.net,185417,ES44209556455181134018,3547.89,2024-09-09T20:30:49,Bilbao,expenses,transport,-51.66,-65864.63
buyer_1,Aitor,López,1996-08-10,17033061C,aitor.lópez@awesomecode.net,185417,ES44209556455181134018,3547.89,2024-09-09T13:22:08,Bilbao,expenses,cash,-100.0,-65964.63
buyer_1,Aitor,López,1996-08-10,17033061C,aitor.lópez@awesomecode.net,185417,ES44209556455181134018,3547.89,2024-09-10T15:25:23,Bilbao,expenses,cash,-100.0,-66064.63
buyer_1,Aitor,López,1996-08-10,17033061C,aitor.lópez@awesomecode.net,185417,ES44209556455181134018,3547.89,2024-09-11T13:09:21,Bilbao,expenses,food,-60.29,-66124.92
buyer_1,Aitor,López,1996-08-10,17033061C,aitor.lópez@awesomecode.net,185417,ES44209556455181134018,3547.89,2024-09-11T10:26:57,Bilbao,expenses,gifts,-633.48,-66758.4
buyer_1,Aitor,López,1996-08-10,17033061C,aitor.lópez@awesomecode.net,185417,ES44209556455181134018,3547.89,2024-09-12T17:48:00,Bilbao,expenses,food,-79.65,-66838.05
buyer_1,Aitor,López,1996-08-10,17033061C,aitor.lópez@awesomecode.net,185417,ES44209556455181134018,3547.89,2024-09-12T08:52:48,Bilbao,expenses,education,-46.73,-66884.78
buyer_1,Aitor,López,1996-08-10,17033061C,aitor.lópez@awesomecode.net,185417,ES44209556455181134018,3547.89,2024-09-13T15:15:33,Bilbao,expenses,clothing,-119.88,-67004.66
buyer_1,Aitor,López,1996-08-10,17033061C,aitor.lópez@awesomecode.net,185417,ES44209556455181134018,3547.89,2024-09-16T16:45:18,Bilbao,expenses,transport,-68.95,-67073.61
buyer_1,Aitor,López,1996-08-10,17033061C,aitor.lópez@awesomecode.net,185417,ES44209556455181134018,3547.89,2024-09-16T18:07:27,Bilbao,expenses,gifts,-610.26,-67683.87
buyer_1,Aitor,López,1996-08-10,17033061C,aitor.lópez@awesomecode.net,185417,ES44209556455181134018,3547.89,2024-09-17T18:17:32,Bilbao,expenses,appliances,-253.47,-67937.34
buyer_1,Aitor,López,1996-08-10,17033061C,aitor.lópez@awesomecode.net,185417,ES44209556455181134018,3547.89,2024-09-18T13:38:40,Bilbao,expenses,cash,-100.0,-68037.34
buyer_1,Aitor,López,1996-08-10,17033061C,aitor.lópez@awesomecode.net,185417,ES44209556455181134018,3547.89,2024-09-19T12:06:51,Bilbao,expenses,cash,-100.0,-68137.34
buyer_1,Aitor,López,1996-08-10,17033061C,aitor.lópez@awesomecode.net,185417,ES44209556455181134018,3547.89,2024-09-20T20:22:00,Bilbao,expenses,leisure,-80.97,-68218.31
buyer_1,Aitor,López,1996-08-10,17033061C,aitor.lópez@awesomecode.net,185417,ES44209556455181134018,3547.89,2024-09-21T19:11:20,Bilbao,expenses,leisure,-79.57,-68297.88
buyer_1,Aitor,López,1996-08-10,17033061C,aitor.lópez@awesomecode.net,185417,ES44209556455181134018,3547.89,2024-09-24T09:05:36,Bilbao,expenses,repairs,-229.66,-68527.54
buyer_1,Aitor,López,1996-08-10,17033061C,aitor.lópez@awesomecode.net,185417,ES44209556455181134018,3547.89,2024-09-25T14:29:55,Bilbao,expenses,transport,-70.22,-68597.76
buyer_1,Aitor,López,1996-08-10,17033061C,aitor.lópez@awesomecode.net,185417,ES44209556455181134018,3547.89,2024-09-25T13:22:03,Bilbao,expenses,cash,-100.0,-68697.76
buyer_1,Aitor,López,1996-08-10,17033061C,aitor.lópez@awesomecode.net,185417,ES44209556455181134018,3547.89,2024-09-26T15:12:58,Bilbao,expenses,leisure,-77.59,-68775.35
buyer_1,Aitor,López,1996-08-10,17033061C,aitor.lópez@awesomecode.net,185417,ES44209556455181134018,3547.89,2024-09-26T14:37:16,Bilbao,expenses,healthcare,-88.84,-68864.19
buyer_1,Aitor,López,1996-08-10,17033061C,aitor.lópez@awesomecode.net,185417,ES44209556455181134018,3547.89,2024-09-27T19:31:30,Bilbao,expenses,leisure,-22.11,-68886.3
buyer_1,Aitor,López,1996-08-10,17033061C,aitor.lópez@awesomecode.net,185417,ES44209556455181134018,3547.89,2024-09-28T17:06:35,Bilbao,expenses,cash,-100.0,-68986.3
buyer_1,Aitor,López,1996-08-10,17033061C,aitor.lópez@awesomecode.net,185417,ES44209556455181134018,3547.89,2024-09-29T09:07:35,Bilbao,expenses,healthcare,-144.86,-69131.16
buyer_1,Aitor,López,1996-08-10,17033061C,aitor.lópez@awesomecode.net,185417,ES44209556455181134018,3547.89,2024-10-01T09:37:40,Bilbao,incomes,salary,2676.25,-66454.91
buyer_1,Aitor,López,1996-08-10,17033061C,aitor.lópez@awesomecode.net,185417,ES44209556455181134018,3547.89,2024-10-01T09:37:40,Bilbao,incomes,extra_income,266.49,-66188.42
buyer_1,Aitor,López,1996-08-10,17033061C,aitor.lópez@awesomecode.net,185417,ES44209556455181134018,3547.89,2024-10-01T18:51:18,Bilbao,expenses,leisure,-18.48,-66206.9
buyer_1,Aitor,López,1996-08-10,17033061C,aitor.lópez@awesomecode.net,185417,ES44209556455181134018,3547.89,2024-10-01T11:36:09,Bilbao,expenses,healthcare,-122.28,-66329.18
buyer_1,Aitor,López,1996-08-10,17033061C,aitor.lópez@awesomecode.net,185417,ES44209556455181134018,3547.89,2024-10-01T18:02:18,Bilbao,expenses,education,-72.46,-66401.64
buyer_1,Aitor,López,1996-08-10,17033061C,aitor.lópez@awesomecode.net,185417,ES44209556455181134018,3547.89,2024-10-05T23:52:16,Bilbao,expenses,rent,-833.31,-67234.95
buyer_1,Aitor,López,1996-08-10,17033061C,aitor.lópez@awesomecode.net,185417,ES44209556455181134018,3547.89,2024-10-07T10:40:16,Bilbao,expenses,gas,-53.21,-67288.16
buyer_1,Aitor,López,1996-08-10,17033061C,aitor.lópez@awesomecode.net,185417,ES44209556455181134018,3547.89,2024-10-09T20:27:47,Bilbao,expenses,cash,-100.0,-67388.16
buyer_1,Aitor,López,1996-08-10,17033061C,aitor.lópez@awesomecode.net,185417,ES44209556455181134018,3547.89,2024-10-10T13:40:37,Bilbao,expenses,food,-69.15,-67457.31
buyer_2,Aitxiber,Beitia,1984-09-05,00436370Z,aitxiber.beitia@hypernet.io,050240,ES09209580768975132020,11113.43,2022-01-01T10:59:55,Gernika,incomes,salary,2007.05,13120.48
buyer_2,Aitxiber,Beitia,1984-09-05,00436370Z,aitxiber.beitia@hypernet.io,050240,ES09209580768975132020,11113.43,2022-01-01T15:55:13,Gernika,expenses,food,-95.52,13024.96
buyer_2,Aitxiber,Beitia,1984-09-05,00436370Z,aitxiber.beitia@hypernet.io,050240,ES09209580768975132020,11113.43,2022-01-01T03:12:29,Gernika,expenses,transport,-52.63,12972.33
buyer_2,Aitxiber,Beitia,1984-09-05,00436370Z,aitxiber.beitia@hypernet.io,050240,ES09209580768975132020,11113.43,2022-01-01T14:18:16,Gernika,expenses,leisure,-77.94,12894.39
buyer_2,Aitxiber,Beitia,1984-09-05,00436370Z,aitxiber.beitia@hypernet.io,050240,ES09209580768975132020,11113.43,2022-01-01T09:57:20,Gernika,expenses,cash,-100.0,12794.39
buyer_2,Aitxiber,Beitia,1984-09-05,00436370Z,aitxiber.beitia@hypernet.io,050240,ES09209580768975132020,11113.43,2022-01-02T08:04:53,Gernika,expenses,food,-73.32,12721.07
buyer_2,Aitxiber,Beitia,1984-09-05,00436370Z,aitxiber.beitia@hypernet.io,050240,ES09209580768975132020,11113.43,2022-01-04T00:11:53,Gernika,expenses,food,-84.79,12636.28
buyer_2,Aitxiber,Beitia,1984-09-05,00436370Z,aitxiber.beitia@hypernet.io,050240,ES09209580768975132020,11113.43,2022-01-05T10:02:28,Gernika,expenses,mortgage,-935.82,11700.46
buyer_2,Aitxiber,Beitia,1984-09-05,00436370Z,aitxiber.beitia@hypernet.io,050240,ES09209580768975132020,11113.43,2022-01-05T17:19:41,Gernika,expenses,water,-44.57,11655.89
buyer_2,Aitxiber,Beitia,1984-09-05,00436370Z,aitxiber.beitia@hypernet.io,050240,ES09209580768975132020,11113.43,2022-01-06T16:23:46,Gernika,expenses,leisure,-51.64,11604.25
buyer_2,Aitxiber,Beitia,1984-09-05,00436370Z,aitxiber.beitia@hypernet.io,050240,ES09209580768975132020,11113.43,2022-01-06T08:41:35,Gernika,expenses,education,-66.03,11538.22
buyer_2,Aitxiber,Beitia,1984-09-05,00436370Z,aitxiber.beitia@hypernet.io,050240,ES09209580768975132020,11113.43,2022-01-06T00:21:06,Gernika,expenses,cash,-100.0,11438.22
buyer_2,Aitxiber,Beitia,1984-09-05,00436370Z,aitxiber.beitia@hypernet.io,050240,ES09209580768975132020,11113.43,2022-01-08T16:09:00,Gernika,expenses,gas,-113.21,11325.01
buyer_2,Aitxiber,Beitia,1984-09-05,00436370Z,aitxiber.beitia@hypernet.io,050240,ES09209580768975132020,11113.43,2022-01-08T22:53:24,Gernika,expenses,transport,-86.35,11238.66
buyer_2,Aitxiber,Beitia,1984-09-05,00436370Z,aitxiber.beitia@hypernet.io,050240,ES09209580768975132020,11113.43,2022-01-08T05:05:12,Gernika,expenses,leisure,-61.12,11177.54
buyer_2,Aitxiber,Beitia,1984-09-05,00436370Z,aitxiber.beitia@hypernet.io,050240,ES09209580768975132020,11113.43,2022-01-10T08:13:35,Gernika,expenses,cash,-100.0,11077.54
buyer_2,Aitxiber,Beitia,1984-09-05,00436370Z,aitxiber.beitia@hypernet.io,050240,ES09209580768975132020,11113.43,2022-01-11T16:04:53,Gernika,expenses,leisure,-40.08,11037.46
buyer_2,Aitxiber,Beitia,1984-09-05,00436370Z,aitxiber.beitia@hypernet.io,050240,ES09209580768975132020,11113.43,2022-01-11T23:18:53,Gernika,expenses,healthcare,-112.5,10924.96
buyer_2,Aitxiber,Beitia,1984-09-05,00436370Z,aitxiber.beitia@hypernet.io,050240,ES09209580768975132020,11113.43,2022-01-14T19:21:51,Gernika,expenses,food,-114.69,10810.27
buyer_2,Aitxiber,Beitia,1984-09-05,00436370Z,aitxiber.beitia@hypernet.io,050240,ES09209580768975132020,11113.43,2022-01-17T15:21:46,Gernika,expenses,gifts,-607.13,10203.14
buyer_2,Aitxiber,Beitia,1984-09-05,00436370Z,aitxiber.beitia@hypernet.io,050240,ES09209580768975132020,11113.43,2022-01-20T13:39:32,Gernika,expenses,food,-116.97,10086.17
buyer_2,Aitxiber,Beitia,1984-09-05,00436370Z,aitxiber.beitia@hypernet.io,050240,ES09209580768975132020,11113.43,2022-01-21T19:32:26,Gernika,expenses,repairs,-110.86,9975.31
buyer_2,Aitxiber,Beitia,1984-09-05,00436370Z,aitxiber.beitia@hypernet.io,050240,ES09209580768975132020,11113.43,2022-01-22T14:44:29,Gernika,expenses,clothing,-142.57,9832.74
buyer_2,Aitxiber,Beitia,1984-09-05,00436370Z,aitxiber.beitia@hypernet.io,050240,ES09209580768975132020,11113.43,2022-01-22T13:28:49,Gernika,expenses,repairs,-238.23,9594.51
buyer_2,Aitxiber,Beitia,1984-09-05,00436370Z,aitxiber.beitia@hypernet.io,050240,ES09209580768975132020,11113.43,2022-01-23T17:31:10,Gernika,expenses,food,-101.98,9492.53
buyer_2,Aitxiber,Beitia,1984-09-05,00436370Z,aitxiber.beitia@hypernet.io,050240,ES09209580768975132020,11113.43,2022-01-23T14:53:58,Gernika,expenses,gifts,-310.68,9181.85
buyer_2,Aitxiber,Beitia,1984-09-05,00436370Z,aitxiber.beitia@hypernet.io,050240,ES09209580768975132020,11113.43,2022-01-24T16:51:25,Gernika,expenses,food,-111.01,9070.84
buyer_2,Aitxiber,Beitia,1984-09-05,00436370Z,aitxiber.beitia@hypernet.io,050240,ES09209580768975132020,11113.43,2022-01-24T11:28:54,Gernika,expenses,transport,-77.47,8993.37
buyer_2,Aitxiber,Beitia,1984-09-05,00436370Z,aitxiber.beitia@hypernet.io,050240,ES09209580768975132020,11113.43,2022-01-24T13:58:01,Gernika,expenses,clothing,-156.42,8836.95
buyer_2,Aitxiber,Beitia,1984-09-05,00436370Z,aitxiber.beitia@hypernet.io,050240,ES09209580768975132020,11113.43,2022-01-25T14:44:10,Gernika,expenses,repairs,-283.08,8553.87
buyer_2,Aitxiber,Beitia,1984-09-05,00436370Z,aitxiber.beitia@hypernet.io,050240,ES09209580768975132020,11113.43,2022-01-28T10:52:54,Gernika,expenses,education,-61.62,8492.25
buyer_2,Aitxiber,Beitia,1984-09-05,00436370Z,aitxiber.beitia@hypernet.io,050240,ES09209580768975132020,11113.43,2022-02-01T15:18:54,Gernika,incomes,salary,2007.05,10499.3
buyer_2,Aitxiber,Beitia,1984-09-05,00436370Z,aitxiber.beitia@hypernet.io,050240,ES09209580768975132020,11113.43,2022-02-01T10:55:08,Gernika,expenses,food,-91.95,10407.35
buyer_2,Aitxiber,Beitia,1984-09-05,00436370Z,aitxiber.beitia@hypernet.io,050240,ES09209580768975132020,11113.43,2022-02-01T14:22:04,Gernika,expenses,leisure,-63.65,10343.7
buyer_2,Aitxiber,Beitia,1984-09-05,00436370Z,aitxiber.beitia@hypernet.io,050240,ES09209580768975132020,11113.43,2022-02-01T20:13:42,Gernika,expenses,education,-66.43,10277.27
buyer_2,Aitxiber,Beitia,1984-09-05,00436370Z,aitxiber.beitia@hypernet.io,050240,ES09209580768975132020,11113.43,2022-02-02T13:20:03,Gernika,expenses,transport,-82.94,10194.33
buyer_2,Aitxiber,Beitia,1984-09-05,00436370Z,aitxiber.beitia@hypernet.io,050240,ES09209580768975132020,11113.43,2022-02-02T15:29:20,Gernika,expenses,gifts,-131.62,10062.71
buyer_2,Aitxiber,Beitia,1984-09-05,00436370Z,aitxiber.beitia@hypernet.io,050240,ES09209580768975132020,11113.43,2022-02-05T17:17:26,Gernika,expenses,mortgage,-935.82,9126.89
buyer_2,Aitxiber,Beitia,1984-09-05,00436370Z,aitxiber.beitia@hypernet.io,050240,ES09209580768975132020,11113.43,2022-02-05T17:25:53,Gernika,expenses,internet,-42.15,9084.74
buyer_2,Aitxiber,Beitia,1984-09-05,00436370Z,aitxiber.beitia@hypernet.io,050240,ES09209580768975132020,11113.43,2022-02-05T19:21:51,Gernika,expenses,phone,-37.67,9047.07
buyer_2,Aitxiber,Beitia,1984-09-05,00436370Z,aitxiber.beitia@hypernet.io,050240,ES09209580768975132020,11113.43,2022-02-05T18:18:21,Gernika,expenses,food,-69.73,8977.34
buyer_2,Aitxiber,Beitia,1984-09-05,00436370Z,aitxiber.beitia@hypernet.io,050240,ES09209580768975132020,11113.43,2022-02-07T20:01:41,Gernika,expenses,electricity,-29.66,8947.68
buyer_2,Aitxiber,Beitia,1984-09-05,00436370Z,aitxiber.beitia@hypernet.io,050240,ES09209580768975132020,11113.43,2022-02-07T12:31:30,Gernika,expenses,cash,-100.0,8847.68
buyer_2,Aitxiber,Beitia,1984-09-05,00436370Z,aitxiber.beitia@hypernet.io,050240,ES09209580768975132020,11113.43,2022-02-08T01:33:23,Gernika,expenses,water,-43.15,8804.53
buyer_2,Aitxiber,Beitia,1984-09-05,00436370Z,aitxiber.beitia@hypernet.io,050240,ES09209580768975132020,11113.43,2022-02-08T13:46:31,Gernika,expenses,electricity,-60.78,8743.75
buyer_2,Aitxiber,Beitia,1984-09-05,00436370Z,aitxiber.beitia@hypernet.io,050240,ES09209580768975132020,11113.43,2022-02-08T16:00:32,Gernika,expenses,internet,-42.15,8701.6
buyer_2,Aitxiber,Beitia,1984-09-05,00436370Z,aitxiber.beitia@hypernet.io,050240,ES09209580768975132020,11113.43,2022-02-08T20:35:57,Gernika,expenses,healthcare,-85.41,8616.19
buyer_2,Aitxiber,Beitia,1984-09-05,00436370Z,aitxiber.beitia@hypernet.io,050240,ES09209580768975132020,11113.43,2022-02-08T17:25:45,Gernika,expenses,education,-67.01,8549.18
buyer_2,Aitxiber,Beitia,1984-09-05,00436370Z,aitxiber.beitia@hypernet.io,050240,ES09209580768975132020,11113.43,2022-02-08T11:34:05,Gernika,expenses,cash,-100.0,8449.18
buyer_2,Aitxiber,Beitia,1984-09-05,00436370Z,aitxiber.beitia@hypernet.io,050240,ES09209580768975132020,11113.43,2022-02-09T09:12:07,Gernika,expenses,children,-668.12,7781.06
buyer_2,Aitxiber,Beitia,1984-09-05,00436370Z,aitxiber.beitia@hypernet.io,050240,ES09209580768975132020,11113.43,2022-02-11T09:59:22,Gernika,expenses,repairs,-163.91,7617.15
buyer_2,Aitxiber,Beitia,1984-09-05,00436370Z,aitxiber.beitia@hypernet.io,050240,ES09209580768975132020,11113.43,2022-02-13T17:15:31,Gernika,expenses,food,-84.64,7532.51
buyer_2,Aitxiber,Beitia,1984-09-05,00436370Z,aitxiber.beitia@hypernet.io,050240,ES09209580768975132020,11113.43,2022-02-17T21:36:45,Gernika,expenses,cash,-100.0,7432.51
buyer_2,Aitxiber,Beitia,1984-09-05,00436370Z,aitxiber.beitia@hypernet.io,050240,ES09209580768975132020,11113.43,2022-02-19T13:08:58,Gernika,expenses,cash,-100.0,7332.51
buyer_2,Aitxiber,Beitia,1984-09-05,00436370Z,aitxiber.beitia@hypernet.io,050240,ES09209580768975132020,11113.43,2022-02-22T12:10:52,Gernika,expenses,repairs,-242.83,7089.68
buyer_2,Aitxiber,Beitia,1984-09-05,00436370Z,aitxiber.beitia@hypernet.io,050240,ES09209580768975132020,11113.43,2022-02-23T13:06:30,Gernika,expenses,travel,-482.3,6607.38
buyer_2,Aitxiber,Beitia,1984-09-05,00436370Z,aitxiber.beitia@hypernet.io,050240,ES09209580768975132020,11113.43,2022-02-23T11:58:33,Gernika,expenses,gifts,-190.29,6417.09
buyer_2,Aitxiber,Beitia,1984-09-05,00436370Z,aitxiber.beitia@hypernet.io,050240,ES09209580768975132020,11113.43,2022-02-24T12:23:42,Gernika,expenses,leisure,-84.3,6332.79
buyer_2,Aitxiber,Beitia,1984-09-05,00436370Z,aitxiber.beitia@hypernet.io,050240,ES09209580768975132020,11113.43,2022-02-25T09:03:31,Gernika,expenses,leisure,-83.51,6249.28
buyer_2,Aitxiber,Beitia,1984-09-05,00436370Z,aitxiber.beitia@hypernet.io,050240,ES09209580768975132020,11113.43,2022-02-26T21:20:24,Gernika,expenses,repairs,-175.29,6073.99
buyer_2,Aitxiber,Beitia,1984-09-05,00436370Z,aitxiber.beitia@hypernet.io,050240,ES09209580768975132020,11113.43,2022-02-27T09:35:45,Gernika,expenses,repairs,-144.12,5929.87
buyer_2,Aitxiber,Beitia,1984-09-05,00436370Z,aitxiber.beitia@hypernet.io,050240,ES09209580768975132020,11113.43,2022-03-01T15:59:05,Gernika,incomes,salary,2007.05,7936.92
buyer_2,Aitxiber,Beitia,1984-09-05,00436370Z,aitxiber.beitia@hypernet.io,050240,ES09209580768975132020,11113.43,2022-03-01T15:59:05,Gernika,incomes,extra_income,263.98,8200.9
buyer_2,Aitxiber,Beitia,1984-09-05,00436370Z,aitxiber.beitia@hypernet.io,050240,ES09209580768975132020,11113.43,2022-03-03T22:05:37,Gernika,expenses,food,-75.96,8124.94
buyer_2,Aitxiber,Beitia,1984-09-05,00436370Z,aitxiber.beitia@hypernet.io,050240,ES09209580768975132020,11113.43,2022-03-05T08:03:49,Gernika,expenses,mortgage,-935.82,7189.12
buyer_2,Aitxiber,Beitia,1984-09-05,00436370Z,aitxiber.beitia@hypernet.io,050240,ES09209580768975132020,11113.43,2022-03-05T11:32:39,Gernika,expenses,water,-28.74,7160.38
buyer_2,Aitxiber,Beitia,1984-09-05,00436370Z,aitxiber.beitia@hypernet.io,050240,ES09209580768975132020,11113.43,2022-03-05T20:40:12,Gernika,expenses,cash,-100.0,7060.38
buyer_2,Aitxiber,Beitia,1984-09-05,00436370Z,aitxiber.beitia@hypernet.io,050240,ES09209580768975132020,11113.43,2022-03-06T15:43:02,Gernika,expenses,water,-30.54,7029.84
buyer_2,Aitxiber,Beitia,1984-09-05,00436370Z,aitxiber.beitia@hypernet.io,050240,ES09209580768975132020,11113.43,2022-03-06T15:55:43,Gernika,expenses,gas,-41.31,6988.53
buyer_2,Aitxiber,Beitia,1984-09-05,00436370Z,aitxiber.beitia@hypernet.io,050240,ES09209580768975132020,11113.43,2022-03-07T21:15:49,Gernika,expenses,leisure,-43.38,6945.15
buyer_2,Aitxiber,Beitia,1984-09-05,00436370Z,aitxiber.beitia@hypernet.io,050240,ES09209580768975132020,11113.43,2022-03-07T19:24:22,Gernika,expenses,repairs,-140.97,6804.18
buyer_2,Aitxiber,Beitia,1984-09-05,00436370Z,aitxiber.beitia@hypernet.io,050240,ES09209580768975132020,11113.43,2022-03-08T17:02:52,Gernika,expenses,gas,-94.94,6709.24
buyer_2,Aitxiber,Beitia,1984-09-05,00436370Z,aitxiber.beitia@hypernet.io,050240,ES09209580768975132020,11113.43,2022-03-08T17:24:54,Gernika,expenses,internet,-42.15,6667.09
buyer_2,Aitxiber,Beitia,1984-09-05,00436370Z,aitxiber.beitia@hypernet.io,050240,ES09209580768975132020,11113.43,2022-03-08T16:18:16,Gernika,expenses,repairs,-151.39,6515.7
buyer_2,Aitxiber,Beitia,1984-09-05,00436370Z,aitxiber.beitia@hypernet.io,050240,ES09209580768975132020,11113.43,2022-03-09T18:08:38,Gernika,expenses,leisure,-74.07,6441.63
buyer_2,Aitxiber,Beitia,1984-09-05,00436370Z,aitxiber.beitia@hypernet.io,050240,ES09209580768975132020,11113.43,2022-03-10T11:58:17,Gernika,expenses,food,-79.73,6361.9
buyer_2,Aitxiber,Beitia,1984-09-05,00436370Z,aitxiber.beitia@hypernet.io,050240,ES09209580768975132020,11113.43,2022-03-10T16:30:05,Gernika,expenses,children,-441.79,5920.11
buyer_2,Aitxiber,Beitia,1984-09-05,00436370Z,aitxiber.beitia@hypernet.io,050240,ES09209580768975132020,11113.43,2022-03-12T15:44:31,Gernika,expenses,healthcare,-44.22,5875.89
buyer_2,Aitxiber,Beitia,1984-09-05,00436370Z,aitxiber.beitia@hypernet.io,050240,ES09209580768975132020,11113.43,2022-03-12T11:24:18,Gernika,expenses,repairs,-36.52,5839.37
buyer_2,Aitxiber,Beitia,1984-09-05,00436370Z,aitxiber.beitia@hypernet.io,050240,ES09209580768975132020,11113.43,2022-03-13T01:25:06,Gernika,expenses,cash,-100.0,5739.37
buyer_2,Aitxiber,Beitia,1984-09-05,00436370Z,aitxiber.beitia@hypernet.io,050240,ES09209580768975132020,11113.43,2022-03-16T18:54:43,Gernika,expenses,food,-116.36,5623.01
buyer_2,Aitxiber,Beitia,1984-09-05,00436370Z,aitxiber.beitia@hypernet.io,050240,ES09209580768975132020,11113.43,2022-03-17T11:21:50,Gernika,expenses,healthcare,-153.83,5469.18
buyer_2,Aitxiber,Beitia,1984-09-05,00436370Z,aitxiber.beitia@hypernet.io,050240,ES09209580768975132020,11113.43,2022-03-17T18:12:06,Gernika,expenses,cash,-100.0,5369.18
buyer_2,Aitxiber,Beitia,1984-09-05,00436370Z,aitxiber.beitia@hypernet.io,050240,ES09209580768975132020,11113.43,2022-03-19T08:23:02,Gernika,expenses,leisure,-22.21,5346.97
buyer_2,Aitxiber,Beitia,1984-09-05,00436370Z,aitxiber.beitia@hypernet.io,050240,ES09209580768975132020,11113.43,2022-03-19T01:11:46,Gernika,expenses,education,-46.29,5300.68
buyer_2,Aitxiber,Beitia,1984-09-05,00436370Z,aitxiber.beitia@hypernet.io,050240,ES09209580768975132020,11113.43,2022-03-19T16:17:21,Gernika,expenses,children,-290.91,5009.77
buyer_2,Aitxiber,Beitia,1984-09-05,00436370Z,aitxiber.beitia@hypernet.io,050240,ES09209580768975132020,11113.43,2022-03-21T13:58:27,Gernika,expenses,repairs,-65.74,4944.03
buyer_2,Aitxiber,Beitia,1984-09-05,00436370Z,aitxiber.beitia@hypernet.io,050240,ES09209580768975132020,11113.43,2022-03-22T17:28:56,Gernika,expenses,food,-73.19,4870.84
buyer_2,Aitxiber,Beitia,1984-09-05,00436370Z,aitxiber.beitia@hypernet.io,050240,ES09209580768975132020,11113.43,2022-03-23T23:30:49,Gernika,expenses,gifts,-185.24,4685.6
buyer_2,Aitxiber,Beitia,1984-09-05,00436370Z,aitxiber.beitia@hypernet.io,050240,ES09209580768975132020,11113.43,2022-03-28T04:10:22,Gernika,expenses,food,-107.8,4577.8
buyer_2,Aitxiber,Beitia,1984-09-05,00436370Z,aitxiber.beitia@hypernet.io,050240,ES09209580768975132020,11113.43,2022-03-28T13:11:03,Gernika,expenses,cash,-100.0,4477.8
buyer_2,Aitxiber,Beitia,1984-09-05,00436370Z,aitxiber.beitia@hypernet.io,050240,ES09209580768975132020,11113.43,2022-03-29T16:24:15,Gernika,expenses,cash,-100.0,4377.8
buyer_2,Aitxiber,Beitia,1984-09-05,00436370Z,aitxiber.beitia@hypernet.io,050240,ES09209580768975132020,11113.43,2022-03-30T10:20:38,Gernika,expenses,food,-110.26,4267.54
buyer_2,Aitxiber,Beitia,1984-09-05,00436370Z,aitxiber.beitia@hypernet.io,050240,ES09209580768975132020,11113.43,2022-03-30T10:54:22,Gernika,expenses,leisure,-30.47,4237.07
buyer_2,Aitxiber,Beitia,1984-09-05,00436370Z,aitxiber.beitia@hypernet.io,050240,ES09209580768975132020,11113.43,2022-03-30T12:26:43,Gernika,expenses,clothing,-126.36,4110.71
buyer_2,Aitxiber,Beitia,1984-09-05,00436370Z,aitxiber.beitia@hypernet.io,050240,ES09209580768975132020,11113.43,2022-03-31T19:49:05,Gernika,expenses,food,-113.18,3997.53
buyer_2,Aitxiber,Beitia,1984-09-05,00436370Z,aitxiber.beitia@hypernet.io,050240,ES09209580768975132020,11113.43,2022-04-01T13:58:53,Gernika,incomes,salary,2007.05,6004.58
buyer_2,Aitxiber,Beitia,1984-09-05,00436370Z,aitxiber.beitia@hypernet.io,050240,ES09209580768975132020,11113.43,2022-04-01T12:59:33,Gernika,expenses,repairs,-305.42,5699.16
buyer_2,Aitxiber,Beitia,1984-09-05,00436370Z,aitxiber.beitia@hypernet.io,050240,ES09209580768975132020,11113.43,2022-04-01T20:31:27,Gernika,expenses,gifts,-266.23,5432.93
buyer_2,Aitxiber,Beitia,1984-09-05,00436370Z,aitxiber.beitia@hypernet.io,050240,ES09209580768975132020,11113.43,2022-04-01T15:48:13,Gernika,expenses,children,-192.373333333333,5240.56
buyer_2,Aitxiber,Beitia,1984-09-05,00436370Z,aitxiber.beitia@hypernet.io,050240,ES09209580768975132020,11113.43,2022-04-03T16:54:19,Gernika,expenses,transport,-84.07,5156.49
buyer_2,Aitxiber,Beitia,1984-09-05,00436370Z,aitxiber.beitia@hypernet.io,050240,ES09209580768975132020,11113.43,2022-04-05T20:13:10,Gernika,expenses,mortgage,-935.82,4220.67
buyer_2,Aitxiber,Beitia,1984-09-05,00436370Z,aitxiber.beitia@hypernet.io,050240,ES09209580768975132020,11113.43,2022-04-05T11:57:14,Gernika,expenses,phone,-34.45,4186.22
buyer_2,Aitxiber,Beitia,1984-09-05,00436370Z,aitxiber.beitia@hypernet.io,050240,ES09209580768975132020,11113.43,2022-04-06T19:09:03,Gernika,expenses,water,-39.37,4146.85
buyer_2,Aitxiber,Beitia,1984-09-05,00436370Z,aitxiber.beitia@hypernet.io,050240,ES09209580768975132020,11113.43,2022-04-06T17:17:15,Gernika,expenses,electricity,-24.76,4122.09
buyer_2,Aitxiber,Beitia,1984-09-05,00436370Z,aitxiber.beitia@hypernet.io,050240,ES09209580768975132020,11113.43,2022-04-06T13:19:28,Gernika,expenses,phone,-35.93,4086.16
buyer_2,Aitxiber,Beitia,1984-09-05,00436370Z,aitxiber.beitia@hypernet.io,050240,ES09209580768975132020,11113.43,2022-04-06T02:58:50,Gernika,expenses,cash,-100.0,3986.16
buyer_2,Aitxiber,Beitia,1984-09-05,00436370Z,aitxiber.beitia@hypernet.io,050240,ES09209580768975132020,11113.43,2022-04-06T08:30:57,Gernika,expenses,travel,-470.59,3515.57
buyer_2,Aitxiber,Beitia,1984-09-05,00436370Z,aitxiber.beitia@hypernet.io,050240,ES09209580768975132020,11113.43,2022-04-07T06:58:59,Gernika,expenses,gas,-86.69,3428.88
buyer_2,Aitxiber,Beitia,1984-09-05,00436370Z,aitxiber.beitia@hypernet.io,050240,ES09209580768975132020,11113.43,2022-04-07T08:02:41,Gernika,expenses,internet,-42.15,3386.73
buyer_2,Aitxiber,Beitia,1984-09-05,00436370Z,aitxiber.beitia@hypernet.io,050240,ES09209580768975132020,11113.43,2022-04-07T14:08:08,Gernika,expenses,leisure,-38.81,3347.92
buyer_2,Aitxiber,Beitia,1984-09-05,00436370Z,aitxiber.beitia@hypernet.io,050240,ES09209580768975132020,11113.43,2022-04-08T16:45:56,Gernika,expenses,water,-29.0,3318.92
buyer_2,Aitxiber,Beitia,1984-09-05,00436370Z,aitxiber.beitia@hypernet.io,050240,ES09209580768975132020,11113.43,2022-04-10T15:35:11,Gernika,expenses,clothing,-66.78,3252.14
buyer_2,Aitxiber,Beitia,1984-09-05,00436370Z,aitxiber.beitia@hypernet.io,050240,ES09209580768975132020,11113.43,2022-04-10T10:49:14,Gernika,expenses,gifts,-158.03,3094.11
buyer_2,Aitxiber,Beitia,1984-09-05,00436370Z,aitxiber.beitia@hypernet.io,050240,ES09209580768975132020,11113.43,2022-04-11T02:54:50,Gernika,expenses,cash,-100.0,2994.11
buyer_2,Aitxiber,Beitia,1984-09-05,00436370Z,aitxiber.beitia@hypernet.io,050240,ES09209580768975132020,11113.43,2022-04-12T11:53:50,Gernika,expenses,food,-82.7,2911.41
buyer_2,Aitxiber,Beitia,1984-09-05,00436370Z,aitxiber.beitia@hypernet.io,050240,ES09209580768975132020,11113.43,2022-04-14T11:16:48,Gernika,expenses,healthcare,-51.7,2859.71
buyer_2,Aitxiber,Beitia,1984-09-05,00436370Z,aitxiber.beitia@hypernet.io,050240,ES09209580768975132020,11113.43,2022-04-15T21:25:26,Gernika,expenses,food,-78.53,2781.18
buyer_2,Aitxiber,Beitia,1984-09-05,00436370Z,aitxiber.beitia@hypernet.io,050240,ES09209580768975132020,11113.43,2022-04-15T09:31:14,Gernika,expenses,cash,-100.0,2681.18
buyer_2,Aitxiber,Beitia,1984-09-05,00436370Z,aitxiber.beitia@hypernet.io,050240,ES09209580768975132020,11113.43,2022-04-16T18:00:49,Gernika,expenses,gifts,-204.86,2476.32
buyer_2,Aitxiber,Beitia,1984-09-05,00436370Z,aitxiber.beitia@hypernet.io,050240,ES09209580768975132020,11113.43,2022-04-17T12:57:37,Gernika,expenses,leisure,-54.53,2421.79
buyer_2,Aitxiber,Beitia,1984-09-05,00436370Z,aitxiber.beitia@hypernet.io,050240,ES09209580768975132020,11113.43,2022-04-17T19:21:34,Gernika,expenses,cash,-100.0,2321.79
buyer_2,Aitxiber,Beitia,1984-09-05,00436370Z,aitxiber.beitia@hypernet.io,050240,ES09209580768975132020,11113.43,2022-04-20T12:06:55,Gernika,expenses,leisure,-44.44,2277.35
buyer_2,Aitxiber,Beitia,1984-09-05,00436370Z,aitxiber.beitia@hypernet.io,050240,ES09209580768975132020,11113.43,2022-04-20T13:38:42,Gernika,expenses,education,-59.85,2217.5
buyer_2,Aitxiber,Beitia,1984-09-05,00436370Z,aitxiber.beitia@hypernet.io,050240,ES09209580768975132020,11113.43,2022-04-21T17:50:12,Gernika,expenses,transport,-66.29,2151.21
buyer_2,Aitxiber,Beitia,1984-09-05,00436370Z,aitxiber.beitia@hypernet.io,050240,ES09209580768975132020,11113.43,2022-04-24T12:42:02,Gernika,expenses,education,-70.66,2080.55
buyer_2,Aitxiber,Beitia,1984-09-05,00436370Z,aitxiber.beitia@hypernet.io,050240,ES09209580768975132020,11113.43,2022-04-25T08:10:53,Gernika,expenses,cash,-100.0,1980.55
buyer_2,Aitxiber,Beitia,1984-09-05,00436370Z,aitxiber.beitia@hypernet.io,050240,ES09209580768975132020,11113.43,2022-04-26T15:14:19,Gernika,expenses,leisure,-72.05,1908.5
buyer_2,Aitxiber,Beitia,1984-09-05,00436370Z,aitxiber.beitia@hypernet.io,050240,ES09209580768975132020,11113.43,2022-04-27T09:14:30,Gernika,expenses,food,-120.83,1787.67
buyer_2,Aitxiber,Beitia,1984-09-05,00436370Z,aitxiber.beitia@hypernet.io,050240,ES09209580768975132020,11113.43,2022-04-28T20:41:44,Gernika,expenses,food,-73.24,1714.43
buyer_2,Aitxiber,Beitia,1984-09-05,00436370Z,aitxiber.beitia@hypernet.io,050240,ES09209580768975132020,11113.43,2022-04-28T21:35:12,Gernika,expenses,education,-65.25,1649.18
buyer_2,Aitxiber,Beitia,1984-09-05,00436370Z,aitxiber.beitia@hypernet.io,050240,ES09209580768975132020,11113.43,2022-04-29T22:04:28,Gernika,expenses,clothing,-119.66,1529.52
buyer_2,Aitxiber,Beitia,1984-09-05,00436370Z,aitxiber.beitia@hypernet.io,050240,ES09209580768975132020,11113.43,2022-04-30T20:08:51,Gernika,expenses,leisure,-54.96,1474.56
buyer_2,Aitxiber,Beitia,1984-09-05,00436370Z,aitxiber.beitia@hypernet.io,050240,ES09209580768975132020,11113.43,2022-05-01T13:04:21,Gernika,incomes,salary,2007.05,3481.61
buyer_2,Aitxiber,Beitia,1984-09-05,00436370Z,aitxiber.beitia@hypernet.io,050240,ES09209580768975132020,11113.43,2022-05-01T22:29:47,Gernika,expenses,repairs,-243.56,3238.05
buyer_2,Aitxiber,Beitia,1984-09-05,00436370Z,aitxiber.beitia@hypernet.io,050240,ES09209580768975132020,11113.43,2022-05-02T16:39:58,Gernika,expenses,food,-100.3,3137.75
buyer_2,Aitxiber,Beitia,1984-09-05,00436370Z,aitxiber.beitia@hypernet.io,050240,ES09209580768975132020,11113.43,2022-05-02T13:31:29,Gernika,expenses,gifts,-369.92,2767.83
buyer_2,Aitxiber,Beitia,1984-09-05,00436370Z,aitxiber.beitia@hypernet.io,050240,ES09209580768975132020,11113.43,2022-05-03T11:03:38,Gernika,expenses,healthcare,-49.03,2718.8
buyer_2,Aitxiber,Beitia,1984-09-05,00436370Z,aitxiber.beitia@hypernet.io,050240,ES09209580768975132020,11113.43,2022-05-03T10:46:22,Gernika,expenses,cash,-100.0,2618.8
buyer_2,Aitxiber,Beitia,1984-09-05,00436370Z,aitxiber.beitia@hypernet.io,050240,ES09209580768975132020,11113.43,2022-05-03T22:32:34,Gernika,expenses,travel,-533.7,2085.1
buyer_2,Aitxiber,Beitia,1984-09-05,00436370Z,aitxiber.beitia@hypernet.io,050240,ES09209580768975132020,11113.43,2022-05-03T19:13:09,Gernika,expenses,repairs,-57.06,2028.04
buyer_2,Aitxiber,Beitia,1984-09-05,00436370Z,aitxiber.beitia@hypernet.io,050240,ES09209580768975132020,11113.43,2022-05-04T20:39:14,Gernika,expenses,food,-60.54,1967.5
buyer_2,Aitxiber,Beitia,1984-09-05,00436370Z,aitxiber.beitia@hypernet.io,050240,ES09209580768975132020,11113.43,2022-05-05T18:19:45,Gernika,expenses,mortgage,-935.82,1031.68
buyer_2,Aitxiber,Beitia,1984-09-05,00436370Z,aitxiber.beitia@hypernet.io,050240,ES09209580768975132020,11113.43,2022-05-05T13:41:08,Gernika,expenses,electricity,-36.92,994.76
buyer_2,Aitxiber,Beitia,1984-09-05,00436370Z,aitxiber.beitia@hypernet.io,050240,ES09209580768975132020,11113.43,2022-05-06T10:35:13,Gernika,expenses,healthcare,-48.6,946.16
buyer_2,Aitxiber,Beitia,1984-09-05,00436370Z,aitxiber.beitia@hypernet.io,050240,ES09209580768975132020,11113.43,2022-05-07T19:14:28,Gernika,expenses,electricity,-30.25,915.91
buyer_2,Aitxiber,Beitia,1984-09-05,00436370Z,aitxiber.beitia@hypernet.io,050240,ES09209580768975132020,11113.43,2022-05-07T12:23:32,Gernika,expenses,phone,-35.58,880.33
buyer_2,Aitxiber,Beitia,1984-09-05,00436370Z,aitxiber.beitia@hypernet.io,050240,ES09209580768975132020,11113.43,2022-05-07T17:58:53,Gernika,expenses,appliances,-85.66,794.67
buyer_2,Aitxiber,Beitia,1984-09-05,00436370Z,aitxiber.beitia@hypernet.io,050240,ES09209580768975132020,11113.43,2022-05-08T10:30:25,Gernika,expenses,electricity,-38.31,756.36
buyer_2,Aitxiber,Beitia,1984-09-05,00436370Z,aitxiber.beitia@hypernet.io,050240,ES09209580768975132020,11113.43,2022-05-08T08:24:42,Gernika,expenses,phone,-31.85,724.51
buyer_2,Aitxiber,Beitia,1984-09-05,00436370Z,aitxiber.beitia@hypernet.io,050240,ES09209580768975132020,11113.43,2022-05-10T07:35:23,Gernika,expenses,food,-114.77,609.74
buyer_2,Aitxiber,Beitia,1984-09-05,00436370Z,aitxiber.beitia@hypernet.io,050240,ES09209580768975132020,11113.43,2022-05-13T09:58:48,Gernika,expenses,food,-112.5,497.24
buyer_2,Aitxiber,Beitia,1984-09-05,00436370Z,aitxiber.beitia@hypernet.io,050240,ES09209580768975132020,11113.43,2022-05-17T17:36:50,Gernika,expenses,leisure,-38.91,458.33
buyer_2,Aitxiber,Beitia,1984-09-05,00436370Z,aitxiber.beitia@hypernet.io,050240,ES09209580768975132020,11113.43,2022-05-18T20:53:49,Gernika,expenses,education,-60.72,397.61
buyer_2,Aitxiber,Beitia,1984-09-05,00436370Z,aitxiber.beitia@hypernet.io,050240,ES09209580768975132020,11113.43,2022-05-19T13:53:55,Gernika,expenses,cash,-100.0,297.61
buyer_2,Aitxiber,Beitia,1984-09-05,00436370Z,aitxiber.beitia@hypernet.io,050240,ES09209580768975132020,11113.43,2022-05-19T02:52:25,Gernika,expenses,appliances,-380.12,-82.51
buyer_2,Aitxiber,Beitia,1984-09-05,00436370Z,aitxiber.beitia@hypernet.io,050240,ES09209580768975132020,11113.43,2022-05-20T18:55:12,Gernika,expenses,food,-63.61,-146.12
buyer_2,Aitxiber,Beitia,1984-09-05,00436370Z,aitxiber.beitia@hypernet.io,050240,ES09209580768975132020,11113.43,2022-05-20T15:49:08,Gernika,expenses,cash,-100.0,-246.12
buyer_2,Aitxiber,Beitia,1984-09-05,00436370Z,aitxiber.beitia@hypernet.io,050240,ES09209580768975132020,11113.43,2022-05-23T08:15:29,Gernika,expenses,food,-123.03,-369.15
buyer_2,Aitxiber,Beitia,1984-09-05,00436370Z,aitxiber.beitia@hypernet.io,050240,ES09209580768975132020,11113.43,2022-05-23T14:11:22,Gernika,expenses,repairs,-69.35,-438.5
buyer_2,Aitxiber,Beitia,1984-09-05,00436370Z,aitxiber.beitia@hypernet.io,050240,ES09209580768975132020,11113.43,2022-05-25T13:33:46,Gernika,expenses,cash,-100.0,-538.5
buyer_2,Aitxiber,Beitia,1984-09-05,00436370Z,aitxiber.beitia@hypernet.io,050240,ES09209580768975132020,11113.43,2022-05-26T13:15:46,Gernika,expenses,cash,-100.0,-638.5
buyer_2,Aitxiber,Beitia,1984-09-05,00436370Z,aitxiber.beitia@hypernet.io,050240,ES09209580768975132020,11113.43,2022-05-29T08:42:15,Gernika,expenses,education,-56.19,-694.69
buyer_2,Aitxiber,Beitia,1984-09-05,00436370Z,aitxiber.beitia@hypernet.io,050240,ES09209580768975132020,11113.43,2022-06-01T19:29:09,Gernika,incomes,salary,2007.05,1312.36
buyer_2,Aitxiber,Beitia,1984-09-05,00436370Z,aitxiber.beitia@hypernet.io,050240,ES09209580768975132020,11113.43,2022-06-01T19:29:09,Gernika,incomes,salary_bonus,1448.99,2761.35
buyer_2,Aitxiber,Beitia,1984-09-05,00436370Z,aitxiber.beitia@hypernet.io,050240,ES09209580768975132020,11113.43,2022-06-01T13:59:41,Gernika,expenses,taxes,-1378.06,1383.29
buyer_2,Aitxiber,Beitia,1984-09-05,00436370Z,aitxiber.beitia@hypernet.io,050240,ES09209580768975132020,11113.43,2022-06-01T17:30:41,Gernika,expenses,insurance,-529.39,853.9
buyer_2,Aitxiber,Beitia,1984-09-05,00436370Z,aitxiber.beitia@hypernet.io,050240,ES09209580768975132020,11113.43,2022-06-02T18:10:19,Gernika,expenses,healthcare,-136.08,717.82
buyer_2,Aitxiber,Beitia,1984-09-05,00436370Z,aitxiber.beitia@hypernet.io,050240,ES09209580768975132020,11113.43,2022-06-03T19:07:27,Gernika,expenses,cash,-100.0,617.82
buyer_2,Aitxiber,Beitia,1984-09-05,00436370Z,aitxiber.beitia@hypernet.io,050240,ES09209580768975132020,11113.43,2022-06-04T08:18:02,Gernika,expenses,food,-122.68,495.14
buyer_2,Aitxiber,Beitia,1984-09-05,00436370Z,aitxiber.beitia@hypernet.io,050240,ES09209580768975132020,11113.43,2022-06-05T05:32:32,Gernika,expenses,mortgage,-935.82,-440.68
buyer_2,Aitxiber,Beitia,1984-09-05,00436370Z,aitxiber.beitia@hypernet.io,050240,ES09209580768975132020,11113.43,2022-06-05T00:53:03,Gernika,expenses,electricity,-66.86,-507.54
buyer_2,Aitxiber,Beitia,1984-09-05,00436370Z,aitxiber.beitia@hypernet.io,050240,ES09209580768975132020,11113.43,2022-06-06T13:32:31,Gernika,expenses,water,-25.13,-532.67
buyer_2,Aitxiber,Beitia,1984-09-05,00436370Z,aitxiber.beitia@hypernet.io,050240,ES09209580768975132020,11113.43,2022-06-06T16:50:54,Gernika,expenses,electricity,-24.0,-556.67
buyer_2,Aitxiber,Beitia,1984-09-05,00436370Z,aitxiber.beitia@hypernet.io,050240,ES09209580768975132020,11113.43,2022-06-07T09:00:30,Gernika,expenses,electricity,-78.52,-635.19
buyer_2,Aitxiber,Beitia,1984-09-05,00436370Z,aitxiber.beitia@hypernet.io,050240,ES09209580768975132020,11113.43,2022-06-07T10:21:36,Gernika,expenses,cash,-100.0,-735.19
buyer_2,Aitxiber,Beitia,1984-09-05,00436370Z,aitxiber.beitia@hypernet.io,050240,ES09209580768975132020,11113.43,2022-06-08T17:26:38,Gernika,expenses,water,-32.03,-767.22
buyer_2,Aitxiber,Beitia,1984-09-05,00436370Z,aitxiber.beitia@hypernet.io,050240,ES09209580768975132020,11113.43,2022-06-08T12:59:51,Gernika,expenses,electricity,-60.92,-828.14
buyer_2,Aitxiber,Beitia,1984-09-05,00436370Z,aitxiber.beitia@hypernet.io,050240,ES09209580768975132020,11113.43,2022-06-08T08:43:22,Gernika,expenses,phone,-35.22,-863.36
buyer_2,Aitxiber,Beitia,1984-09-05,00436370Z,aitxiber.beitia@hypernet.io,050240,ES09209580768975132020,11113.43,2022-06-09T05:23:12,Gernika,expenses,leisure,-47.41,-910.77
buyer_2,Aitxiber,Beitia,1984-09-05,00436370Z,aitxiber.beitia@hypernet.io,050240,ES09209580768975132020,11113.43,2022-06-09T10:16:41,Gernika,expenses,cash,-100.0,-1010.77
buyer_2,Aitxiber,Beitia,1984-09-05,00436370Z,aitxiber.beitia@hypernet.io,050240,ES09209580768975132020,11113.43,2022-06-10T15:31:35,Gernika,expenses,transport,-67.61,-1078.38
buyer_2,Aitxiber,Beitia,1984-09-05,00436370Z,aitxiber.beitia@hypernet.io,050240,ES09209580768975132020,11113.43,2022-06-10T19:58:49,Gernika,expenses,leisure,-46.91,-1125.29
buyer_2,Aitxiber,Beitia,1984-09-05,00436370Z,aitxiber.beitia@hypernet.io,050240,ES09209580768975132020,11113.43,2022-06-10T14:56:17,Gernika,expenses,travel,-316.57,-1441.86
buyer_2,Aitxiber,Beitia,1984-09-05,00436370Z,aitxiber.beitia@hypernet.io,050240,ES09209580768975132020,11113.43,2022-06-11T21:05:49,Gernika,expenses,food,-85.69,-1527.55
buyer_2,Aitxiber,Beitia,1984-09-05,00436370Z,aitxiber.beitia@hypernet.io,050240,ES09209580768975132020,11113.43,2022-06-11T20:05:47,Gernika,expenses,leisure,-23.9,-1551.45
buyer_2,Aitxiber,Beitia,1984-09-05,00436370Z,aitxiber.beitia@hypernet.io,050240,ES09209580768975132020,11113.43,2022-06-11T09:55:58,Gernika,expenses,repairs,-178.73,-1730.18
buyer_2,Aitxiber,Beitia,1984-09-05,00436370Z,aitxiber.beitia@hypernet.io,050240,ES09209580768975132020,11113.43,2022-06-12T12:21:50,Gernika,expenses,food,-118.08,-1848.26
buyer_2,Aitxiber,Beitia,1984-09-05,00436370Z,aitxiber.beitia@hypernet.io,050240,ES09209580768975132020,11113.43,2022-06-12T22:41:15,Gernika,expenses,transport,-65.28,-1913.54
buyer_2,Aitxiber,Beitia,1984-09-05,00436370Z,aitxiber.beitia@hypernet.io,050240,ES09209580768975132020,11113.43,2022-06-18T22:03:44,Gernika,expenses,healthcare,-115.19,-2028.73
buyer_2,Aitxiber,Beitia,1984-09-05,00436370Z,aitxiber.beitia@hypernet.io,050240,ES09209580768975132020,11113.43,2022-06-19T16:42:16,Gernika,expenses,food,-70.16,-2098.89
buyer_2,Aitxiber,Beitia,1984-09-05,00436370Z,aitxiber.beitia@hypernet.io,050240,ES09209580768975132020,11113.43,2022-06-19T23:29:44,Gernika,expenses,leisure,-64.06,-2162.95
buyer_2,Aitxiber,Beitia,1984-09-05,00436370Z,aitxiber.beitia@hypernet.io,050240,ES09209580768975132020,11113.43,2022-06-21T15:10:07,Gernika,expenses,leisure,-67.63,-2230.58
buyer_2,Aitxiber,Beitia,1984-09-05,00436370Z,aitxiber.beitia@hypernet.io,050240,ES09209580768975132020,11113.43,2022-06-21T17:35:00,Gernika,expenses,repairs,-205.8,-2436.38
buyer_2,Aitxiber,Beitia,1984-09-05,00436370Z,aitxiber.beitia@hypernet.io,050240,ES09209580768975132020,11113.43,2022-06-22T07:04:12,Gernika,expenses,food,-122.2,-2558.58
buyer_2,Aitxiber,Beitia,1984-09-05,00436370Z,aitxiber.beitia@hypernet.io,050240,ES09209580768975132020,11113.43,2022-06-22T19:38:11,Gernika,expenses,cash,-100.0,-2658.58
buyer_2,Aitxiber,Beitia,1984-09-05,00436370Z,aitxiber.beitia@hypernet.io,050240,ES09209580768975132020,11113.43,2022-06-24T06:44:30,Gernika,expenses,cash,-100.0,-2758.58
buyer_2,Aitxiber,Beitia,1984-09-05,00436370Z,aitxiber.beitia@hypernet.io,050240,ES09209580768975132020,11113.43,2022-06-26T13:42:59,Gernika,expenses,cash,-100.0,-2858.58
buyer_2,Aitxiber,Beitia,1984-09-05,00436370Z,aitxiber.beitia@hypernet.io,050240,ES09209580768975132020,11113.43,2022-06-28T14:31:21,Gernika,expenses,food,-81.86,-2940.44
buyer_2,Aitxiber,Beitia,1984-09-05,00436370Z,aitxiber.beitia@hypernet.io,050240,ES09209580768975132020,11113.43,2022-06-29T08:21:25,Gernika,expenses,cash,-100.0,-3040.44
buyer_2,Aitxiber,Beitia,1984-09-05,00436370Z,aitxiber.beitia@hypernet.io,050240,ES09209580768975132020,11113.43,2022-06-29T17:45:38,Gernika,expenses,repairs,-102.72,-3143.16
buyer_2,Aitxiber,Beitia,1984-09-05,00436370Z,aitxiber.beitia@hypernet.io,050240,ES09209580768975132020,11113.43,2022-07-01T14:21:56,Gernika,incomes,salary,2007.05,-1136.11
buyer_2,Aitxiber,Beitia,1984-09-05,00436370Z,aitxiber.beitia@hypernet.io,050240,ES09209580768975132020,11113.43,2022-07-01T14:21:56,Gernika,incomes,extra_income,263.98,-872.13
buyer_2,Aitxiber,Beitia,1984-09-05,00436370Z,aitxiber.beitia@hypernet.io,050240,ES09209580768975132020,11113.43,2022-07-01T13:33:25,Gernika,expenses,gifts,-232.24,-1104.37
buyer_2,Aitxiber,Beitia,1984-09-05,00436370Z,aitxiber.beitia@hypernet.io,050240,ES09209580768975132020,11113.43,2022-07-02T12:37:49,Gernika,expenses,food,-87.55,-1191.92
buyer_2,Aitxiber,Beitia,1984-09-05,00436370Z,aitxiber.beitia@hypernet.io,050240,ES09209580768975132020,11113.43,2022-07-02T09:19:15,Gernika,expenses,repairs,-64.25,-1256.17
buyer_2,Aitxiber,Beitia,1984-09-05,00436370Z,aitxiber.beitia@hypernet.io,050240,ES09209580768975132020,11113.43,2022-07-03T11:25:27,Gernika,expenses,gifts,-87.44,-1343.61
buyer_2,Aitxiber,Beitia,1984-09-05,00436370Z,aitxiber.beitia@hypernet.io,050240,ES09209580768975132020,11113.43,2022-07-05T13:17:14,Gernika,expenses,mortgage,-935.82,-2279.43
buyer_2,Aitxiber,Beitia,1984-09-05,00436370Z,aitxiber.beitia@hypernet.io,050240,ES09209580768975132020,11113.43,2022-07-05T17:21:05,Gernika,expenses,internet,-42.15,-2321.58
buyer_2,Aitxiber,Beitia,1984-09-05,00436370Z,aitxiber.beitia@hypernet.io,050240,ES09209580768975132020,11113.43,2022-07-06T16:13:45,Gernika,expenses,cash,-100.0,-2421.58
buyer_2,Aitxiber,Beitia,1984-09-05,00436370Z,aitxiber.beitia@hypernet.io,050240,ES09209580768975132020,11113.43,2022-07-07T23:39:28,Gernika,expenses,gas,-94.86,-2516.44
buyer_2,Aitxiber,Beitia,1984-09-05,00436370Z,aitxiber.beitia@hypernet.io,050240,ES09209580768975132020,11113.43,2022-07-07T12:20:08,Gernika,expenses,internet,-42.15,-2558.59
buyer_2,Aitxiber,Beitia,1984-09-05,00436370Z,aitxiber.beitia@hypernet.io,050240,ES09209580768975132020,11113.43,2022-07-07T10:55:16,Gernika,expenses,cash,-100.0,-2658.59
buyer_2,Aitxiber,Beitia,1984-09-05,00436370Z,aitxiber.beitia@hypernet.io,050240,ES09209580768975132020,11113.43,2022-07-08T10:47:17,Gernika,expenses,cash,-100.0,-2758.59
buyer_2,Aitxiber,Beitia,1984-09-05,00436370Z,aitxiber.beitia@hypernet.io,050240,ES09209580768975132020,11113.43,2022-07-09T18:32:09,Gernika,expenses,repairs,-212.58,-2971.17
buyer_2,Aitxiber,Beitia,1984-09-05,00436370Z,aitxiber.beitia@hypernet.io,050240,ES09209580768975132020,11113.43,2022-07-13T02:58:46,Gernika,expenses,repairs,-78.05,-3049.22
buyer_2,Aitxiber,Beitia,1984-09-05,00436370Z,aitxiber.beitia@hypernet.io,050240,ES09209580768975132020,11113.43,2022-07-14T11:46:25,Gernika,expenses,leisure,-82.93,-3132.15
buyer_2,Aitxiber,Beitia,1984-09-05,00436370Z,aitxiber.beitia@hypernet.io,050240,ES09209580768975132020,11113.43,2022-07-17T19:45:19,Gernika,expenses,transport,-77.32,-3209.47
buyer_2,Aitxiber,Beitia,1984-09-05,00436370Z,aitxiber.beitia@hypernet.io,050240,ES09209580768975132020,11113.43,2022-07-17T18:48:46,Gernika,expenses,cash,-100.0,-3309.47
buyer_2,Aitxiber,Beitia,1984-09-05,00436370Z,aitxiber.beitia@hypernet.io,050240,ES09209580768975132020,11113.43,2022-07-20T20:09:52,Gernika,expenses,food,-64.3,-3373.77
buyer_2,Aitxiber,Beitia,1984-09-05,00436370Z,aitxiber.beitia@hypernet.io,050240,ES09209580768975132020,11113.43,2022-07-20T08:27:23,Gernika,expenses,gifts,-240.15,-3613.92
buyer_2,Aitxiber,Beitia,1984-09-05,00436370Z,aitxiber.beitia@hypernet.io,050240,ES09209580768975132020,11113.43,2022-07-21T12:43:43,Gernika,expenses,leisure,-58.09,-3672.01
buyer_2,Aitxiber,Beitia,1984-09-05,00436370Z,aitxiber.beitia@hypernet.io,050240,ES09209580768975132020,11113.43,2022-07-21T13:17:15,Gernika,expenses,gifts,-345.7,-4017.71
buyer_2,Aitxiber,Beitia,1984-09-05,00436370Z,aitxiber.beitia@hypernet.io,050240,ES09209580768975132020,11113.43,2022-07-23T16:18:18,Gernika,expenses,food,-103.51,-4121.22
buyer_2,Aitxiber,Beitia,1984-09-05,00436370Z,aitxiber.beitia@hypernet.io,050240,ES09209580768975132020,11113.43,2022-07-23T18:37:30,Gernika,expenses,cash,-100.0,-4221.22
buyer_2,Aitxiber,Beitia,1984-09-05,00436370Z,aitxiber.beitia@hypernet.io,050240,ES09209580768975132020,11113.43,2022-07-23T15:53:16,Gernika,expenses,repairs,-244.36,-4465.58
buyer_2,Aitxiber,Beitia,1984-09-05,00436370Z,aitxiber.beitia@hypernet.io,050240,ES09209580768975132020,11113.43,2022-07-25T10:54:52,Gernika,expenses,food,-84.2,-4549.78
buyer_2,Aitxiber,Beitia,1984-09-05,00436370Z,aitxiber.beitia@hypernet.io,050240,ES09209580768975132020,11113.43,2022-07-25T16:22:35,Gernika,expenses,transport,-51.3,-4601.08
buyer_2,Aitxiber,Beitia,1984-09-05,00436370Z,aitxiber.beitia@hypernet.io,050240,ES09209580768975132020,11113.43,2022-07-25T18:19:44,Gernika,expenses,cash,-100.0,-4701.08
buyer_2,Aitxiber,Beitia,1984-09-05,00436370Z,aitxiber.beitia@hypernet.io,050240,ES09209580768975132020,11113.43,2022-07-27T13:20:10,Gernika,expenses,food,-115.94,-4817.02
buyer_2,Aitxiber,Beitia,1984-09-05,00436370Z,aitxiber.beitia@hypernet.io,050240,ES09209580768975132020,11113.43,2022-07-29T11:21:10,Gernika,expenses,gifts,-419.97,-5236.99
buyer_2,Aitxiber,Beitia,1984-09-05,00436370Z,aitxiber.beitia@hypernet.io,050240,ES09209580768975132020,11113.43,2022-07-31T13:59:50,Gernika,expenses,food,-91.91,-5328.9
buyer_2,Aitxiber,Beitia,1984-09-05,00436370Z,aitxiber.beitia@hypernet.io,050240,ES09209580768975132020,11113.43,2022-08-01T14:37:26,Gernika,incomes,salary,2007.05,-3321.85
buyer_2,Aitxiber,Beitia,1984-09-05,00436370Z,aitxiber.beitia@hypernet.io,050240,ES09209580768975132020,11113.43,2022-08-03T11:47:46,Gernika,expenses,appliances,-365.95,-3687.8
buyer_2,Aitxiber,Beitia,1984-09-05,00436370Z,aitxiber.beitia@hypernet.io,050240,ES09209580768975132020,11113.43,2022-08-04T23:10:39,Gernika,expenses,food,-72.47,-3760.27
buyer_2,Aitxiber,Beitia,1984-09-05,00436370Z,aitxiber.beitia@hypernet.io,050240,ES09209580768975132020,11113.43,2022-08-05T16:26:27,Gernika,expenses,mortgage,-935.82,-4696.09
buyer_2,Aitxiber,Beitia,1984-09-05,00436370Z,aitxiber.beitia@hypernet.io,050240,ES09209580768975132020,11113.43,2022-08-05T11:30:09,Gernika,expenses,water,-30.4,-4726.49
buyer_2,Aitxiber,Beitia,1984-09-05,00436370Z,aitxiber.beitia@hypernet.io,050240,ES09209580768975132020,11113.43,2022-08-05T12:57:57,Gernika,expenses,clothing,-119.01,-4845.5
buyer_2,Aitxiber,Beitia,1984-09-05,00436370Z,aitxiber.beitia@hypernet.io,050240,ES09209580768975132020,11113.43,2022-08-06T14:32:12,Gernika,expenses,electricity,-87.63,-4933.13
buyer_2,Aitxiber,Beitia,1984-09-05,00436370Z,aitxiber.beitia@hypernet.io,050240,ES09209580768975132020,11113.43,2022-08-06T16:24:13,Gernika,expenses,gas,-53.03,-4986.16
buyer_2,Aitxiber,Beitia,1984-09-05,00436370Z,aitxiber.beitia@hypernet.io,050240,ES09209580768975132020,11113.43,2022-08-07T11:08:55,Gernika,expenses,water,-20.45,-5006.61
buyer_2,Aitxiber,Beitia,1984-09-05,00436370Z,aitxiber.beitia@hypernet.io,050240,ES09209580768975132020,11113.43,2022-08-07T05:32:33,Gernika,expenses,electricity,-36.52,-5043.13
buyer_2,Aitxiber,Beitia,1984-09-05,00436370Z,aitxiber.beitia@hypernet.io,050240,ES09209580768975132020,11113.43,2022-08-07T17:39:23,Gernika,expenses,gas,-88.6,-5131.73
buyer_2,Aitxiber,Beitia,1984-09-05,00436370Z,aitxiber.beitia@hypernet.io,050240,ES09209580768975132020,11113.43,2022-08-07T17:32:25,Gernika,expenses,repairs,-250.22,-5381.95
buyer_2,Aitxiber,Beitia,1984-09-05,00436370Z,aitxiber.beitia@hypernet.io,050240,ES09209580768975132020,11113.43,2022-08-08T07:18:23,Gernika,expenses,gas,-87.37,-5469.32
buyer_2,Aitxiber,Beitia,1984-09-05,00436370Z,aitxiber.beitia@hypernet.io,050240,ES09209580768975132020,11113.43,2022-08-09T20:52:11,Gernika,expenses,food,-113.31,-5582.63
buyer_2,Aitxiber,Beitia,1984-09-05,00436370Z,aitxiber.beitia@hypernet.io,050240,ES09209580768975132020,11113.43,2022-08-09T16:58:06,Gernika,expenses,leisure,-26.43,-5609.06
buyer_2,Aitxiber,Beitia,1984-09-05,00436370Z,aitxiber.beitia@hypernet.io,050240,ES09209580768975132020,11113.43,2022-08-10T08:03:35,Gernika,expenses,education,-78.29,-5687.35
buyer_2,Aitxiber,Beitia,1984-09-05,00436370Z,aitxiber.beitia@hypernet.io,050240,ES09209580768975132020,11113.43,2022-08-12T11:43:01,Gernika,expenses,leisure,-68.98,-5756.33
buyer_2,Aitxiber,Beitia,1984-09-05,00436370Z,aitxiber.beitia@hypernet.io,050240,ES09209580768975132020,11113.43,2022-08-13T16:45:48,Gernika,expenses,food,-113.5,-5869.83
buyer_2,Aitxiber,Beitia,1984-09-05,00436370Z,aitxiber.beitia@hypernet.io,050240,ES09209580768975132020,11113.43,2022-08-14T12:42:36,Gernika,expenses,transport,-84.65,-5954.48
buyer_2,Aitxiber,Beitia,1984-09-05,00436370Z,aitxiber.beitia@hypernet.io,050240,ES09209580768975132020,11113.43,2022-08-15T08:31:34,Gernika,expenses,leisure,-78.29,-6032.77
buyer_2,Aitxiber,Beitia,1984-09-05,00436370Z,aitxiber.beitia@hypernet.io,050240,ES09209580768975132020,11113.43,2022-08-16T17:56:17,Gernika,expenses,leisure,-43.43,-6076.2
buyer_2,Aitxiber,Beitia,1984-09-05,00436370Z,aitxiber.beitia@hypernet.io,050240,ES09209580768975132020,11113.43,2022-08-16T18:36:18,Gernika,expenses,cash,-100.0,-6176.2
buyer_2,Aitxiber,Beitia,1984-09-05,00436370Z,aitxiber.beitia@hypernet.io,050240,ES09209580768975132020,11113.43,2022-08-16T14:30:51,Gernika,expenses,appliances,-242.42,-6418.62
buyer_2,Aitxiber,Beitia,1984-09-05,00436370Z,aitxiber.beitia@hypernet.io,050240,ES09209580768975132020,11113.43,2022-08-20T10:18:23,Gernika,expenses,clothing,-47.87,-6466.49
buyer_2,Aitxiber,Beitia,1984-09-05,00436370Z,aitxiber.beitia@hypernet.io,050240,ES09209580768975132020,11113.43,2022-08-20T22:41:16,Gernika,expenses,cash,-100.0,-6566.49
buyer_2,Aitxiber,Beitia,1984-09-05,00436370Z,aitxiber.beitia@hypernet.io,050240,ES09209580768975132020,11113.43,2022-08-20T14:47:54,Gernika,expenses,repairs,-147.71,-6714.2
buyer_2,Aitxiber,Beitia,1984-09-05,00436370Z,aitxiber.beitia@hypernet.io,050240,ES09209580768975132020,11113.43,2022-08-21T23:21:17,Gernika,expenses,leisure,-78.6,-6792.8
buyer_2,Aitxiber,Beitia,1984-09-05,00436370Z,aitxiber.beitia@hypernet.io,050240,ES09209580768975132020,11113.43,2022-08-21T11:56:10,Gernika,expenses,cash,-100.0,-6892.8
buyer_2,Aitxiber,Beitia,1984-09-05,00436370Z,aitxiber.beitia@hypernet.io,050240,ES09209580768975132020,11113.43,2022-08-22T13:11:14,Gernika,expenses,transport,-68.63,-6961.43
buyer_2,Aitxiber,Beitia,1984-09-05,00436370Z,aitxiber.beitia@hypernet.io,050240,ES09209580768975132020,11113.43,2022-08-22T17:54:32,Gernika,expenses,education,-49.96,-7011.39
buyer_2,Aitxiber,Beitia,1984-09-05,00436370Z,aitxiber.beitia@hypernet.io,050240,ES09209580768975132020,11113.43,2022-08-24T09:42:32,Gernika,expenses,transport,-70.81,-7082.2
buyer_2,Aitxiber,Beitia,1984-09-05,00436370Z,aitxiber.beitia@hypernet.io,050240,ES09209580768975132020,11113.43,2022-08-24T07:04:04,Gernika,expenses,cash,-100.0,-7182.2
buyer_2,Aitxiber,Beitia,1984-09-05,00436370Z,aitxiber.beitia@hypernet.io,050240,ES09209580768975132020,11113.43,2022-08-25T18:08:43,Gernika,expenses,food,-118.21,-7300.41
buyer_2,Aitxiber,Beitia,1984-09-05,00436370Z,aitxiber.beitia@hypernet.io,050240,ES09209580768975132020,11113.43,2022-08-26T00:55:43,Gernika,expenses,cash,-100.0,-7400.41
buyer_2,Aitxiber,Beitia,1984-09-05,00436370Z,aitxiber.beitia@hypernet.io,050240,ES09209580768975132020,11113.43,2022-08-27T21:13:09,Gernika,expenses,cash,-100.0,-7500.41
buyer_2,Aitxiber,Beitia,1984-09-05,00436370Z,aitxiber.beitia@hypernet.io,050240,ES09209580768975132020,11113.43,2022-08-29T08:05:14,Gernika,expenses,transport,-44.96,-7545.37
buyer_2,Aitxiber,Beitia,1984-09-05,00436370Z,aitxiber.beitia@hypernet.io,050240,ES09209580768975132020,11113.43,2022-08-29T16:48:14,Gernika,expenses,clothing,-150.71,-7696.08
buyer_2,Aitxiber,Beitia,1984-09-05,00436370Z,aitxiber.beitia@hypernet.io,050240,ES09209580768975132020,11113.43,2022-08-30T21:26:26,Gernika,expenses,transport,-84.64,-7780.72
buyer_2,Aitxiber,Beitia,1984-09-05,00436370Z,aitxiber.beitia@hypernet.io,050240,ES09209580768975132020,11113.43,2022-08-30T12:59:36,Gernika,expenses,appliances,-114.18,-7894.9
buyer_2,Aitxiber,Beitia,1984-09-05,00436370Z,aitxiber.beitia@hypernet.io,050240,ES09209580768975132020,11113.43,2022-08-31T10:53:52,Gernika,expenses,food,-86.48,-7981.38
buyer_2,Aitxiber,Beitia,1984-09-05,00436370Z,aitxiber.beitia@hypernet.io,050240,ES09209580768975132020,11113.43,2022-09-01T20:05:13,Gernika,incomes,salary,2007.05,-5974.33
buyer_2,Aitxiber,Beitia,1984-09-05,00436370Z,aitxiber.beitia@hypernet.io,050240,ES09209580768975132020,11113.43,2022-09-01T15:56:52,Gernika,expenses,cash,-100.0,-6074.33
buyer_2,Aitxiber,Beitia,1984-09-05,00436370Z,aitxiber.beitia@hypernet.io,050240,ES09209580768975132020,11113.43,2022-09-02T13:07:54,Gernika,expenses,clothing,-79.84,-6154.17
buyer_2,Aitxiber,Beitia,1984-09-05,00436370Z,aitxiber.beitia@hypernet.io,050240,ES09209580768975132020,11113.43,2022-09-03T16:13:48,Gernika,expenses,cash,-100.0,-6254.17
buyer_2,Aitxiber,Beitia,1984-09-05,00436370Z,aitxiber.beitia@hypernet.io,050240,ES09209580768975132020,11113.43,2022-09-05T21:32:02,Gernika,expenses,mortgage,-935.82,-7189.99
buyer_2,Aitxiber,Beitia,1984-09-05,00436370Z,aitxiber.beitia@hypernet.io,050240,ES09209580768975132020,11113.43,2022-09-05T22:04:11,Gernika,expenses,internet,-42.15,-7232.14
buyer_2,Aitxiber,Beitia,1984-09-05,00436370Z,aitxiber.beitia@hypernet.io,050240,ES09209580768975132020,11113.43,2022-09-05T18:28:41,Gernika,expenses,phone,-33.9,-7266.04
buyer_2,Aitxiber,Beitia,1984-09-05,00436370Z,aitxiber.beitia@hypernet.io,050240,ES09209580768975132020,11113.43,2022-09-05T12:21:57,Gernika,expenses,leisure,-66.73,-7332.77
buyer_2,Aitxiber,Beitia,1984-09-05,00436370Z,aitxiber.beitia@hypernet.io,050240,ES09209580768975132020,11113.43,2022-09-05T20:44:52,Gernika,expenses,cash,-100.0,-7432.77
buyer_2,Aitxiber,Beitia,1984-09-05,00436370Z,aitxiber.beitia@hypernet.io,050240,ES09209580768975132020,11113.43,2022-09-07T19:55:10,Gernika,expenses,water,-34.52,-7467.29
buyer_2,Aitxiber,Beitia,1984-09-05,00436370Z,aitxiber.beitia@hypernet.io,050240,ES09209580768975132020,11113.43,2022-09-07T09:27:43,Gernika,expenses,phone,-31.58,-7498.87
buyer_2,Aitxiber,Beitia,1984-09-05,00436370Z,aitxiber.beitia@hypernet.io,050240,ES09209580768975132020,11113.43,2022-09-07T10:09:04,Gernika,expenses,food,-77.67,-7576.54
buyer_2,Aitxiber,Beitia,1984-09-05,00436370Z,aitxiber.beitia@hypernet.io,050240,ES09209580768975132020,11113.43,2022-09-07T12:12:16,Gernika,expenses,gifts,-641.77,-8218.31
buyer_2,Aitxiber,Beitia,1984-09-05,00436370Z,aitxiber.beitia@hypernet.io,050240,ES09209580768975132020,11113.43,2022-09-08T19:33:31,Gernika,expenses,electricity,-62.84,-8281.15
buyer_2,Aitxiber,Beitia,1984-09-05,00436370Z,aitxiber.beitia@hypernet.io,050240,ES09209580768975132020,11113.43,2022-09-08T20:16:59,Gernika,expenses,cash,-100.0,-8381.15
buyer_2,Aitxiber,Beitia,1984-09-05,00436370Z,aitxiber.beitia@hypernet.io,050240,ES09209580768975132020,11113.43,2022-09-10T13:34:07,Gernika,expenses,leisure,-35.83,-8416.98
buyer_2,Aitxiber,Beitia,1984-09-05,00436370Z,aitxiber.beitia@hypernet.io,050240,ES09209580768975132020,11113.43,2022-09-13T18:49:42,Gernika,expenses,transport,-86.66,-8503.64
buyer_2,Aitxiber,Beitia,1984-09-05,00436370Z,aitxiber.beitia@hypernet.io,050240,ES09209580768975132020,11113.43,2022-09-13T12:33:21,Gernika,expenses,cash,-100.0,-8603.64
buyer_2,Aitxiber,Beitia,1984-09-05,00436370Z,aitxiber.beitia@hypernet.io,050240,ES09209580768975132020,11113.43,2022-09-14T11:38:55,Gernika,expenses,transport,-66.12,-8669.76
buyer_2,Aitxiber,Beitia,1984-09-05,00436370Z,aitxiber.beitia@hypernet.io,050240,ES09209580768975132020,11113.43,2022-09-14T11:00:59,Gernika,expenses,repairs,-237.35,-8907.11
buyer_2,Aitxiber,Beitia,1984-09-05,00436370Z,aitxiber.beitia@hypernet.io,050240,ES09209580768975132020,11113.43,2022-09-15T19:50:18,Gernika,expenses,transport,-54.86,-8961.97
buyer_2,Aitxiber,Beitia,1984-09-05,00436370Z,aitxiber.beitia@hypernet.io,050240,ES09209580768975132020,11113.43,2022-09-15T02:34:33,Gernika,expenses,healthcare,-135.14,-9097.11
buyer_2,Aitxiber,Beitia,1984-09-05,00436370Z,aitxiber.beitia@hypernet.io,050240,ES09209580768975132020,11113.43,2022-09-15T16:54:45,Gernika,expenses,repairs,-78.39,-9175.5
buyer_2,Aitxiber,Beitia,1984-09-05,00436370Z,aitxiber.beitia@hypernet.io,050240,ES09209580768975132020,11113.43,2022-09-16T09:24:09,Gernika,expenses,transport,-41.77,-9217.27
buyer_2,Aitxiber,Beitia,1984-09-05,00436370Z,aitxiber.beitia@hypernet.io,050240,ES09209580768975132020,11113.43,2022-09-16T18:40:56,Gernika,expenses,leisure,-80.77,-9298.04
buyer_2,Aitxiber,Beitia,1984-09-05,00436370Z,aitxiber.beitia@hypernet.io,050240,ES09209580768975132020,11113.43,2022-09-18T14:10:44,Gernika,expenses,transport,-47.62,-9345.66
buyer_2,Aitxiber,Beitia,1984-09-05,00436370Z,aitxiber.beitia@hypernet.io,050240,ES09209580768975132020,11113.43,2022-09-19T20:34:32,Gernika,expenses,cash,-100.0,-9445.66
buyer_2,Aitxiber,Beitia,1984-09-05,00436370Z,aitxiber.beitia@hypernet.io,050240,ES09209580768975132020,11113.43,2022-09-20T14:46:46,Gernika,expenses,transport,-71.02,-9516.68
buyer_2,Aitxiber,Beitia,1984-09-05,00436370Z,aitxiber.beitia@hypernet.io,050240,ES09209580768975132020,11113.43,2022-09-21T16:03:14,Gernika,expenses,transport,-45.59,-9562.27
buyer_2,Aitxiber,Beitia,1984-09-05,00436370Z,aitxiber.beitia@hypernet.io,050240,ES09209580768975132020,11113.43,2022-09-22T13:02:34,Gernika,expenses,transport,-60.63,-9622.9
buyer_2,Aitxiber,Beitia,1984-09-05,00436370Z,aitxiber.beitia@hypernet.io,050240,ES09209580768975132020,11113.43,2022-09-22T14:58:50,Gernika,expenses,cash,-100.0,-9722.9
buyer_2,Aitxiber,Beitia,1984-09-05,00436370Z,aitxiber.beitia@hypernet.io,050240,ES09209580768975132020,11113.43,2022-09-23T09:47:45,Gernika,expenses,cash,-100.0,-9822.9
buyer_2,Aitxiber,Beitia,1984-09-05,00436370Z,aitxiber.beitia@hypernet.io,050240,ES09209580768975132020,11113.43,2022-09-24T15:24:06,Gernika,expenses,food,-86.71,-9909.61
buyer_2,Aitxiber,Beitia,1984-09-05,00436370Z,aitxiber.beitia@hypernet.io,050240,ES09209580768975132020,11113.43,2022-09-26T11:21:58,Gernika,expenses,clothing,-45.19,-9954.8
buyer_2,Aitxiber,Beitia,1984-09-05,00436370Z,aitxiber.beitia@hypernet.io,050240,ES09209580768975132020,11113.43,2022-09-27T09:15:40,Gernika,expenses,repairs,-300.63,-10255.43
buyer_2,Aitxiber,Beitia,1984-09-05,00436370Z,aitxiber.beitia@hypernet.io,050240,ES09209580768975132020,11113.43,2022-09-27T12:27:46,Gernika,expenses,gifts,-416.49,-10671.92
buyer_2,Aitxiber,Beitia,1984-09-05,00436370Z,aitxiber.beitia@hypernet.io,050240,ES09209580768975132020,11113.43,2022-09-27T17:37:51,Gernika,expenses,children,-46.90333333333308,-10718.82
buyer_2,Aitxiber,Beitia,1984-09-05,00436370Z,aitxiber.beitia@hypernet.io,050240,ES09209580768975132020,11113.43,2022-09-28T08:26:11,Gernika,expenses,clothing,-147.76,-10866.58
buyer_2,Aitxiber,Beitia,1984-09-05,00436370Z,aitxiber.beitia@hypernet.io,050240,ES09209580768975132020,11113.43,2022-10-01T19:19:50,Gernika,incomes,salary,2007.05,-8859.53
buyer_2,Aitxiber,Beitia,1984-09-05,00436370Z,aitxiber.beitia@hypernet.io,050240,ES09209580768975132020,11113.43,2022-10-01T17:42:42,Gernika,expenses,cash,-100.0,-8959.53
buyer_2,Aitxiber,Beitia,1984-09-05,00436370Z,aitxiber.beitia@hypernet.io,050240,ES09209580768975132020,11113.43,2022-10-03T13:17:16,Gernika,expenses,food,-99.44,-9058.97
buyer_2,Aitxiber,Beitia,1984-09-05,00436370Z,aitxiber.beitia@hypernet.io,050240,ES09209580768975132020,11113.43,2022-10-04T06:13:54,Gernika,expenses,repairs,-48.0,-9106.97
buyer_2,Aitxiber,Beitia,1984-09-05,00436370Z,aitxiber.beitia@hypernet.io,050240,ES09209580768975132020,11113.43,2022-10-05T14:47:39,Gernika,expenses,mortgage,-935.82,-10042.79
buyer_2,Aitxiber,Beitia,1984-09-05,00436370Z,aitxiber.beitia@hypernet.io,050240,ES09209580768975132020,11113.43,2022-10-05T20:39:05,Gernika,expenses,gas,-72.39,-10115.18
buyer_2,Aitxiber,Beitia,1984-09-05,00436370Z,aitxiber.beitia@hypernet.io,050240,ES09209580768975132020,11113.43,2022-10-05T03:56:48,Gernika,expenses,transport,-73.36,-10188.54
buyer_2,Aitxiber,Beitia,1984-09-05,00436370Z,aitxiber.beitia@hypernet.io,050240,ES09209580768975132020,11113.43,2022-10-05T12:18:34,Gernika,expenses,education,-75.15,-10263.69
buyer_2,Aitxiber,Beitia,1984-09-05,00436370Z,aitxiber.beitia@hypernet.io,050240,ES09209580768975132020,11113.43,2022-10-06T14:14:35,Gernika,expenses,internet,-42.15,-10305.84
buyer_2,Aitxiber,Beitia,1984-09-05,00436370Z,aitxiber.beitia@hypernet.io,050240,ES09209580768975132020,11113.43,2022-10-07T18:30:22,Gernika,expenses,electricity,-41.07,-10346.91
buyer_2,Aitxiber,Beitia,1984-09-05,00436370Z,aitxiber.beitia@hypernet.io,050240,ES09209580768975132020,11113.43,2022-10-07T17:08:04,Gernika,expenses,internet,-42.15,-10389.06
buyer_2,Aitxiber,Beitia,1984-09-05,00436370Z,aitxiber.beitia@hypernet.io,050240,ES09209580768975132020,11113.43,2022-10-07T19:30:39,Gernika,expenses,transport,-83.99,-10473.05
buyer_2,Aitxiber,Beitia,1984-09-05,00436370Z,aitxiber.beitia@hypernet.io,050240,ES09209580768975132020,11113.43,2022-10-07T08:49:26,Gernika,expenses,healthcare,-117.47,-10590.52
buyer_2,Aitxiber,Beitia,1984-09-05,00436370Z,aitxiber.beitia@hypernet.io,050240,ES09209580768975132020,11113.43,2022-10-08T23:05:10,Gernika,expenses,water,-43.51,-10634.03
buyer_2,Aitxiber,Beitia,1984-09-05,00436370Z,aitxiber.beitia@hypernet.io,050240,ES09209580768975132020,11113.43,2022-10-08T12:35:34,Gernika,expenses,phone,-44.4,-10678.43
buyer_2,Aitxiber,Beitia,1984-09-05,00436370Z,aitxiber.beitia@hypernet.io,050240,ES09209580768975132020,11113.43,2022-10-08T20:24:15,Gernika,expenses,education,-76.92,-10755.35
buyer_2,Aitxiber,Beitia,1984-09-05,00436370Z,aitxiber.beitia@hypernet.io,050240,ES09209580768975132020,11113.43,2022-10-11T15:47:54,Gernika,expenses,food,-104.11,-10859.46
buyer_2,Aitxiber,Beitia,1984-09-05,00436370Z,aitxiber.beitia@hypernet.io,050240,ES09209580768975132020,11113.43,2022-10-11T09:01:41,Gernika,expenses,gifts,-528.21,-11387.67
buyer_2,Aitxiber,Beitia,1984-09-05,00436370Z,aitxiber.beitia@hypernet.io,050240,ES09209580768975132020,11113.43,2022-10-12T21:49:37,Gernika,expenses,food,-124.19,-11511.86
buyer_2,Aitxiber,Beitia,1984-09-05,00436370Z,aitxiber.beitia@hypernet.io,050240,ES09209580768975132020,11113.43,2022-10-13T20:54:33,Gernika,expenses,healthcare,-139.89,-11651.75
buyer_2,Aitxiber,Beitia,1984-09-05,00436370Z,aitxiber.beitia@hypernet.io,050240,ES09209580768975132020,11113.43,2022-10-14T17:37:03,Gernika,expenses,leisure,-45.64,-11697.39
buyer_2,Aitxiber,Beitia,1984-09-05,00436370Z,aitxiber.beitia@hypernet.io,050240,ES09209580768975132020,11113.43,2022-10-14T20:19:00,Gernika,expenses,healthcare,-154.11,-11851.5
buyer_2,Aitxiber,Beitia,1984-09-05,00436370Z,aitxiber.beitia@hypernet.io,050240,ES09209580768975132020,11113.43,2022-10-15T09:29:04,Gernika,expenses,cash,-100.0,-11951.5
buyer_2,Aitxiber,Beitia,1984-09-05,00436370Z,aitxiber.beitia@hypernet.io,050240,ES09209580768975132020,11113.43,2022-10-22T21:54:52,Gernika,expenses,food,-104.47,-12055.97
buyer_2,Aitxiber,Beitia,1984-09-05,00436370Z,aitxiber.beitia@hypernet.io,050240,ES09209580768975132020,11113.43,2022-10-22T17:36:57,Gernika,expenses,healthcare,-142.65,-12198.62
buyer_2,Aitxiber,Beitia,1984-09-05,00436370Z,aitxiber.beitia@hypernet.io,050240,ES09209580768975132020,11113.43,2022-10-24T20:15:14,Gernika,expenses,cash,-100.0,-12298.62
buyer_2,Aitxiber,Beitia,1984-09-05,00436370Z,aitxiber.beitia@hypernet.io,050240,ES09209580768975132020,11113.43,2022-10-25T11:11:58,Gernika,expenses,transport,-52.3,-12350.92
buyer_2,Aitxiber,Beitia,1984-09-05,00436370Z,aitxiber.beitia@hypernet.io,050240,ES09209580768975132020,11113.43,2022-10-25T16:13:56,Gernika,expenses,cash,-100.0,-12450.92
buyer_2,Aitxiber,Beitia,1984-09-05,00436370Z,aitxiber.beitia@hypernet.io,050240,ES09209580768975132020,11113.43,2022-10-29T15:33:08,Gernika,expenses,cash,-100.0,-12550.92
buyer_2,Aitxiber,Beitia,1984-09-05,00436370Z,aitxiber.beitia@hypernet.io,050240,ES09209580768975132020,11113.43,2022-10-29T08:58:40,Gernika,expenses,repairs,-151.54,-12702.46
buyer_2,Aitxiber,Beitia,1984-09-05,00436370Z,aitxiber.beitia@hypernet.io,050240,ES09209580768975132020,11113.43,2022-11-01T15:38:22,Gernika,incomes,salary,2007.05,-10695.41
buyer_2,Aitxiber,Beitia,1984-09-05,00436370Z,aitxiber.beitia@hypernet.io,050240,ES09209580768975132020,11113.43,2022-11-01T15:38:22,Gernika,incomes,extra_income,263.98,-10431.43
buyer_2,Aitxiber,Beitia,1984-09-05,00436370Z,aitxiber.beitia@hypernet.io,050240,ES09209580768975132020,11113.43,2022-11-03T12:44:18,Gernika,expenses,food,-78.66,-10510.09
buyer_2,Aitxiber,Beitia,1984-09-05,00436370Z,aitxiber.beitia@hypernet.io,050240,ES09209580768975132020,11113.43,2022-11-03T08:13:09,Gernika,expenses,repairs,-148.09,-10658.18
buyer_2,Aitxiber,Beitia,1984-09-05,00436370Z,aitxiber.beitia@hypernet.io,050240,ES09209580768975132020,11113.43,2022-11-04T11:41:00,Gernika,expenses,food,-107.86,-10766.04
buyer_2,Aitxiber,Beitia,1984-09-05,00436370Z,aitxiber.beitia@hypernet.io,050240,ES09209580768975132020,11113.43,2022-11-04T13:32:38,Gernika,expenses,education,-55.4,-10821.44
buyer_2,Aitxiber,Beitia,1984-09-05,00436370Z,aitxiber.beitia@hypernet.io,050240,ES09209580768975132020,11113.43,2022-11-05T05:51:47,Gernika,expenses,mortgage,-935.82,-11757.26
buyer_2,Aitxiber,Beitia,1984-09-05,00436370Z,aitxiber.beitia@hypernet.io,050240,ES09209580768975132020,11113.43,2022-11-05T18:43:54,Gernika,expenses,food,-62.86,-11820.12
buyer_2,Aitxiber,Beitia,1984-09-05,00436370Z,aitxiber.beitia@hypernet.io,050240,ES09209580768975132020,11113.43,2022-11-05T14:24:31,Gernika,expenses,transport,-54.94,-11875.06
buyer_2,Aitxiber,Beitia,1984-09-05,00436370Z,aitxiber.beitia@hypernet.io,050240,ES09209580768975132020,11113.43,2022-11-05T20:53:26,Gernika,expenses,clothing,-64.15,-11939.21
buyer_2,Aitxiber,Beitia,1984-09-05,00436370Z,aitxiber.beitia@hypernet.io,050240,ES09209580768975132020,11113.43,2022-11-06T15:26:18,Gernika,expenses,internet,-42.15,-11981.36
buyer_2,Aitxiber,Beitia,1984-09-05,00436370Z,aitxiber.beitia@hypernet.io,050240,ES09209580768975132020,11113.43,2022-11-06T11:50:44,Gernika,expenses,leisure,-52.03,-12033.39
buyer_2,Aitxiber,Beitia,1984-09-05,00436370Z,aitxiber.beitia@hypernet.io,050240,ES09209580768975132020,11113.43,2022-11-06T13:03:30,Gernika,expenses,travel,-466.84,-12500.23
buyer_2,Aitxiber,Beitia,1984-09-05,00436370Z,aitxiber.beitia@hypernet.io,050240,ES09209580768975132020,11113.43,2022-11-08T12:48:51,Gernika,expenses,gas,-40.83,-12541.06
buyer_2,Aitxiber,Beitia,1984-09-05,00436370Z,aitxiber.beitia@hypernet.io,050240,ES09209580768975132020,11113.43,2022-11-08T21:52:21,Gernika,expenses,phone,-42.69,-12583.75
buyer_2,Aitxiber,Beitia,1984-09-05,00436370Z,aitxiber.beitia@hypernet.io,050240,ES09209580768975132020,11113.43,2022-11-08T08:19:17,Gernika,expenses,transport,-71.3,-12655.05
buyer_2,Aitxiber,Beitia,1984-09-05,00436370Z,aitxiber.beitia@hypernet.io,050240,ES09209580768975132020,11113.43,2022-11-08T16:25:32,Gernika,expenses,leisure,-54.55,-12709.6
buyer_2,Aitxiber,Beitia,1984-09-05,00436370Z,aitxiber.beitia@hypernet.io,050240,ES09209580768975132020,11113.43,2022-11-12T21:10:28,Gernika,expenses,cash,-100.0,-12809.6
buyer_2,Aitxiber,Beitia,1984-09-05,00436370Z,aitxiber.beitia@hypernet.io,050240,ES09209580768975132020,11113.43,2022-11-12T09:12:49,Gernika,expenses,repairs,-203.8,-13013.4
buyer_2,Aitxiber,Beitia,1984-09-05,00436370Z,aitxiber.beitia@hypernet.io,050240,ES09209580768975132020,11113.43,2022-11-13T09:09:08,Gernika,expenses,healthcare,-50.71,-13064.11
buyer_2,Aitxiber,Beitia,1984-09-05,00436370Z,aitxiber.beitia@hypernet.io,050240,ES09209580768975132020,11113.43,2022-11-16T19:21:04,Gernika,expenses,leisure,-84.22,-13148.33
buyer_2,Aitxiber,Beitia,1984-09-05,00436370Z,aitxiber.beitia@hypernet.io,050240,ES09209580768975132020,11113.43,2022-11-16T16:53:57,Gernika,expenses,education,-73.68,-13222.01
buyer_2,Aitxiber,Beitia,1984-09-05,00436370Z,aitxiber.beitia@hypernet.io,050240,ES09209580768975132020,11113.43,2022-11-16T20:53:38,Gernika,expenses,appliances,-414.4,-13636.41
buyer_2,Aitxiber,Beitia,1984-09-05,00436370Z,aitxiber.beitia@hypernet.io,050240,ES09209580768975132020,11113.43,2022-11-17T17:47:55,Gernika,expenses,transport,-49.33,-13685.74
buyer_2,Aitxiber,Beitia,1984-09-05,00436370Z,aitxiber.beitia@hypernet.io,050240,ES09209580768975132020,11113.43,2022-11-17T18:29:41,Gernika,expenses,leisure,-50.02,-13735.76
buyer_2,Aitxiber,Beitia,1984-09-05,00436370Z,aitxiber.beitia@hypernet.io,050240,ES09209580768975132020,11113.43,2022-11-17T18:36:55,Gernika,expenses,education,-47.12,-13782.88
buyer_2,Aitxiber,Beitia,1984-09-05,00436370Z,aitxiber.beitia@hypernet.io,050240,ES09209580768975132020,11113.43,2022-11-17T09:05:33,Gernika,expenses,travel,-296.1,-14078.98
buyer_2,Aitxiber,Beitia,1984-09-05,00436370Z,aitxiber.beitia@hypernet.io,050240,ES09209580768975132020,11113.43,2022-11-18T22:36:09,Gernika,expenses,food,-121.34,-14200.32
buyer_2,Aitxiber,Beitia,1984-09-05,00436370Z,aitxiber.beitia@hypernet.io,050240,ES09209580768975132020,11113.43,2022-11-19T17:57:12,Gernika,expenses,food,-86.46,-14286.78
buyer_2,Aitxiber,Beitia,1984-09-05,00436370Z,aitxiber.beitia@hypernet.io,050240,ES09209580768975132020,11113.43,2022-11-19T15:44:19,Gernika,expenses,cash,-100.0,-14386.78
buyer_2,Aitxiber,Beitia,1984-09-05,00436370Z,aitxiber.beitia@hypernet.io,050240,ES09209580768975132020,11113.43,2022-11-20T11:15:18,Gernika,expenses,food,-119.59,-14506.37
buyer_2,Aitxiber,Beitia,1984-09-05,00436370Z,aitxiber.beitia@hypernet.io,050240,ES09209580768975132020,11113.43,2022-11-20T20:37:54,Gernika,expenses,cash,-100.0,-14606.37
buyer_2,Aitxiber,Beitia,1984-09-05,00436370Z,aitxiber.beitia@hypernet.io,050240,ES09209580768975132020,11113.43,2022-11-21T20:40:53,Gernika,expenses,healthcare,-110.03,-14716.4
buyer_2,Aitxiber,Beitia,1984-09-05,00436370Z,aitxiber.beitia@hypernet.io,050240,ES09209580768975132020,11113.43,2022-11-21T17:11:28,Gernika,expenses,cash,-100.0,-14816.4
buyer_2,Aitxiber,Beitia,1984-09-05,00436370Z,aitxiber.beitia@hypernet.io,050240,ES09209580768975132020,11113.43,2022-11-22T02:22:26,Gernika,expenses,repairs,-55.63,-14872.03
buyer_2,Aitxiber,Beitia,1984-09-05,00436370Z,aitxiber.beitia@hypernet.io,050240,ES09209580768975132020,11113.43,2022-11-24T18:51:46,Gernika,expenses,transport,-50.07,-14922.1
buyer_2,Aitxiber,Beitia,1984-09-05,00436370Z,aitxiber.beitia@hypernet.io,050240,ES09209580768975132020,11113.43,2022-11-26T10:17:42,Gernika,expenses,cash,-100.0,-15022.1
buyer_2,Aitxiber,Beitia,1984-09-05,00436370Z,aitxiber.beitia@hypernet.io,050240,ES09209580768975132020,11113.43,2022-11-26T12:28:53,Gernika,expenses,repairs,-255.69,-15277.79
buyer_2,Aitxiber,Beitia,1984-09-05,00436370Z,aitxiber.beitia@hypernet.io,050240,ES09209580768975132020,11113.43,2022-11-27T14:38:17,Gernika,expenses,food,-90.79,-15368.58
buyer_2,Aitxiber,Beitia,1984-09-05,00436370Z,aitxiber.beitia@hypernet.io,050240,ES09209580768975132020,11113.43,2022-11-29T13:46:23,Gernika,expenses,food,-64.78,-15433.36
buyer_2,Aitxiber,Beitia,1984-09-05,00436370Z,aitxiber.beitia@hypernet.io,050240,ES09209580768975132020,11113.43,2022-12-01T08:27:34,Gernika,incomes,salary,2007.05,-13426.31
buyer_2,Aitxiber,Beitia,1984-09-05,00436370Z,aitxiber.beitia@hypernet.io,050240,ES09209580768975132020,11113.43,2022-12-01T08:27:34,Gernika,incomes,salary_bonus,1557.5,-11868.81
buyer_2,Aitxiber,Beitia,1984-09-05,00436370Z,aitxiber.beitia@hypernet.io,050240,ES09209580768975132020,11113.43,2022-12-01T19:27:17,Gernika,expenses,food,-76.73,-11945.54
buyer_2,Aitxiber,Beitia,1984-09-05,00436370Z,aitxiber.beitia@hypernet.io,050240,ES09209580768975132020,11113.43,2022-12-02T18:36:22,Gernika,expenses,clothing,-53.9,-11999.44
buyer_2,Aitxiber,Beitia,1984-09-05,00436370Z,aitxiber.beitia@hypernet.io,050240,ES09209580768975132020,11113.43,2022-12-03T08:27:02,Gernika,expenses,cash,-100.0,-12099.44
buyer_2,Aitxiber,Beitia,1984-09-05,00436370Z,aitxiber.beitia@hypernet.io,050240,ES09209580768975132020,11113.43,2022-12-05T08:17:35,Gernika,expenses,mortgage,-935.82,-13035.26
buyer_2,Aitxiber,Beitia,1984-09-05,00436370Z,aitxiber.beitia@hypernet.io,050240,ES09209580768975132020,11113.43,2022-12-05T20:41:47,Gernika,expenses,water,-36.73,-13071.99
buyer_2,Aitxiber,Beitia,1984-09-05,00436370Z,aitxiber.beitia@hypernet.io,050240,ES09209580768975132020,11113.43,2022-12-05T11:50:22,Gernika,expenses,electricity,-65.31,-13137.3
buyer_2,Aitxiber,Beitia,1984-09-05,00436370Z,aitxiber.beitia@hypernet.io,050240,ES09209580768975132020,11113.43,2022-12-05T17:20:03,Gernika,expenses,leisure,-72.46,-13209.76
buyer_2,Aitxiber,Beitia,1984-09-05,00436370Z,aitxiber.beitia@hypernet.io,050240,ES09209580768975132020,11113.43,2022-12-06T23:44:09,Gernika,expenses,clothing,-92.28,-13302.04
buyer_2,Aitxiber,Beitia,1984-09-05,00436370Z,aitxiber.beitia@hypernet.io,050240,ES09209580768975132020,11113.43,2022-12-09T08:57:48,Gernika,expenses,gifts,-235.41,-13537.45
buyer_2,Aitxiber,Beitia,1984-09-05,00436370Z,aitxiber.beitia@hypernet.io,050240,ES09209580768975132020,11113.43,2022-12-13T15:28:42,Gernika,expenses,cash,-100.0,-13637.45
buyer_2,Aitxiber,Beitia,1984-09-05,00436370Z,aitxiber.beitia@hypernet.io,050240,ES09209580768975132020,11113.43,2022-12-14T16:31:55,Gernika,expenses,gifts,-580.55,-14218.0
buyer_2,Aitxiber,Beitia,1984-09-05,00436370Z,aitxiber.beitia@hypernet.io,050240,ES09209580768975132020,11113.43,2022-12-16T19:56:29,Gernika,expenses,travel,-526.65,-14744.65
buyer_2,Aitxiber,Beitia,1984-09-05,00436370Z,aitxiber.beitia@hypernet.io,050240,ES09209580768975132020,11113.43,2022-12-17T19:22:24,Gernika,expenses,transport,-80.78,-14825.43
buyer_2,Aitxiber,Beitia,1984-09-05,00436370Z,aitxiber.beitia@hypernet.io,050240,ES09209580768975132020,11113.43,2022-12-17T15:20:15,Gernika,expenses,cash,-100.0,-14925.43
buyer_2,Aitxiber,Beitia,1984-09-05,00436370Z,aitxiber.beitia@hypernet.io,050240,ES09209580768975132020,11113.43,2022-12-19T15:58:01,Gernika,expenses,transport,-57.01,-14982.44
buyer_2,Aitxiber,Beitia,1984-09-05,00436370Z,aitxiber.beitia@hypernet.io,050240,ES09209580768975132020,11113.43,2022-12-19T08:15:58,Gernika,expenses,children,-707.0133333333331,-15689.45
buyer_2,Aitxiber,Beitia,1984-09-05,00436370Z,aitxiber.beitia@hypernet.io,050240,ES09209580768975132020,11113.43,2022-12-21T09:28:28,Gernika,expenses,food,-82.68,-15772.13
buyer_2,Aitxiber,Beitia,1984-09-05,00436370Z,aitxiber.beitia@hypernet.io,050240,ES09209580768975132020,11113.43,2022-12-21T13:51:03,Gernika,expenses,leisure,-72.25,-15844.38
buyer_2,Aitxiber,Beitia,1984-09-05,00436370Z,aitxiber.beitia@hypernet.io,050240,ES09209580768975132020,11113.43,2022-12-24T19:34:49,Gernika,expenses,food,-111.16,-15955.54
buyer_2,Aitxiber,Beitia,1984-09-05,00436370Z,aitxiber.beitia@hypernet.io,050240,ES09209580768975132020,11113.43,2022-12-26T17:04:53,Gernika,expenses,transport,-62.66,-16018.2
buyer_2,Aitxiber,Beitia,1984-09-05,00436370Z,aitxiber.beitia@hypernet.io,050240,ES09209580768975132020,11113.43,2022-12-27T09:00:51,Gernika,expenses,children,-280.38,-16298.58
buyer_2,Aitxiber,Beitia,1984-09-05,00436370Z,aitxiber.beitia@hypernet.io,050240,ES09209580768975132020,11113.43,2022-12-31T15:19:42,Gernika,expenses,transport,-48.25,-16346.83
buyer_2,Aitxiber,Beitia,1984-09-05,00436370Z,aitxiber.beitia@hypernet.io,050240,ES09209580768975132020,11113.43,2022-12-31T05:12:16,Gernika,expenses,cash,-100.0,-16446.83
buyer_2,Aitxiber,Beitia,1984-09-05,00436370Z,aitxiber.beitia@hypernet.io,050240,ES09209580768975132020,11113.43,2023-01-01T06:43:01,Gernika,incomes,salary,2065.05,-14381.78
buyer_2,Aitxiber,Beitia,1984-09-05,00436370Z,aitxiber.beitia@hypernet.io,050240,ES09209580768975132020,11113.43,2023-01-01T14:22:57,Gernika,expenses,food,-111.56,-14493.34
buyer_2,Aitxiber,Beitia,1984-09-05,00436370Z,aitxiber.beitia@hypernet.io,050240,ES09209580768975132020,11113.43,2023-01-02T11:32:09,Gernika,expenses,food,-81.96,-14575.3
buyer_2,Aitxiber,Beitia,1984-09-05,00436370Z,aitxiber.beitia@hypernet.io,050240,ES09209580768975132020,11113.43,2023-01-03T14:59:42,Gernika,expenses,clothing,-78.02,-14653.32
buyer_2,Aitxiber,Beitia,1984-09-05,00436370Z,aitxiber.beitia@hypernet.io,050240,ES09209580768975132020,11113.43,2023-01-04T15:34:08,Gernika,expenses,children,-183.82,-14837.14
buyer_2,Aitxiber,Beitia,1984-09-05,00436370Z,aitxiber.beitia@hypernet.io,050240,ES09209580768975132020,11113.43,2023-01-05T23:07:35,Gernika,expenses,mortgage,-1115.01,-15952.15
buyer_2,Aitxiber,Beitia,1984-09-05,00436370Z,aitxiber.beitia@hypernet.io,050240,ES09209580768975132020,11113.43,2023-01-05T08:20:23,Gernika,expenses,electricity,-37.46,-15989.61
buyer_2,Aitxiber,Beitia,1984-09-05,00436370Z,aitxiber.beitia@hypernet.io,050240,ES09209580768975132020,11113.43,2023-01-05T11:49:18,Gernika,expenses,gas,-87.14,-16076.75
buyer_2,Aitxiber,Beitia,1984-09-05,00436370Z,aitxiber.beitia@hypernet.io,050240,ES09209580768975132020,11113.43,2023-01-05T20:43:52,Gernika,expenses,internet,-43.37,-16120.12
buyer_2,Aitxiber,Beitia,1984-09-05,00436370Z,aitxiber.beitia@hypernet.io,050240,ES09209580768975132020,11113.43,2023-01-05T12:34:48,Gernika,expenses,cash,-100.0,-16220.12
buyer_2,Aitxiber,Beitia,1984-09-05,00436370Z,aitxiber.beitia@hypernet.io,050240,ES09209580768975132020,11113.43,2023-01-06T20:22:31,Gernika,expenses,food,-72.9,-16293.02
buyer_2,Aitxiber,Beitia,1984-09-05,00436370Z,aitxiber.beitia@hypernet.io,050240,ES09209580768975132020,11113.43,2023-01-06T14:33:51,Gernika,expenses,cash,-100.0,-16393.02
buyer_2,Aitxiber,Beitia,1984-09-05,00436370Z,aitxiber.beitia@hypernet.io,050240,ES09209580768975132020,11113.43,2023-01-07T18:34:14,Gernika,expenses,water,-26.42,-16419.44
buyer_2,Aitxiber,Beitia,1984-09-05,00436370Z,aitxiber.beitia@hypernet.io,050240,ES09209580768975132020,11113.43,2023-01-07T10:24:29,Gernika,expenses,electricity,-74.76,-16494.2
buyer_2,Aitxiber,Beitia,1984-09-05,00436370Z,aitxiber.beitia@hypernet.io,050240,ES09209580768975132020,11113.43,2023-01-07T09:48:30,Gernika,expenses,phone,-40.58,-16534.78
buyer_2,Aitxiber,Beitia,1984-09-05,00436370Z,aitxiber.beitia@hypernet.io,050240,ES09209580768975132020,11113.43,2023-01-07T12:23:14,Gernika,expenses,cash,-100.0,-16634.78
buyer_2,Aitxiber,Beitia,1984-09-05,00436370Z,aitxiber.beitia@hypernet.io,050240,ES09209580768975132020,11113.43,2023-01-08T23:52:06,Gernika,expenses,electricity,-55.52,-16690.3
buyer_2,Aitxiber,Beitia,1984-09-05,00436370Z,aitxiber.beitia@hypernet.io,050240,ES09209580768975132020,11113.43,2023-01-08T16:48:50,Gernika,expenses,gas,-75.06,-16765.36
buyer_2,Aitxiber,Beitia,1984-09-05,00436370Z,aitxiber.beitia@hypernet.io,050240,ES09209580768975132020,11113.43,2023-01-08T09:26:34,Gernika,expenses,phone,-31.49,-16796.85
buyer_2,Aitxiber,Beitia,1984-09-05,00436370Z,aitxiber.beitia@hypernet.io,050240,ES09209580768975132020,11113.43,2023-01-11T16:51:33,Gernika,expenses,transport,-88.53,-16885.38
buyer_2,Aitxiber,Beitia,1984-09-05,00436370Z,aitxiber.beitia@hypernet.io,050240,ES09209580768975132020,11113.43,2023-01-11T18:12:35,Gernika,expenses,cash,-100.0,-16985.38
buyer_2,Aitxiber,Beitia,1984-09-05,00436370Z,aitxiber.beitia@hypernet.io,050240,ES09209580768975132020,11113.43,2023-01-11T08:14:35,Gernika,expenses,gifts,-81.14,-17066.52
buyer_2,Aitxiber,Beitia,1984-09-05,00436370Z,aitxiber.beitia@hypernet.io,050240,ES09209580768975132020,11113.43,2023-01-12T06:02:24,Gernika,expenses,food,-96.96,-17163.48
buyer_2,Aitxiber,Beitia,1984-09-05,00436370Z,aitxiber.beitia@hypernet.io,050240,ES09209580768975132020,11113.43,2023-01-13T15:23:18,Gernika,expenses,leisure,-66.41,-17229.89
buyer_2,Aitxiber,Beitia,1984-09-05,00436370Z,aitxiber.beitia@hypernet.io,050240,ES09209580768975132020,11113.43,2023-01-14T09:00:01,Gernika,expenses,cash,-100.0,-17329.89
buyer_2,Aitxiber,Beitia,1984-09-05,00436370Z,aitxiber.beitia@hypernet.io,050240,ES09209580768975132020,11113.43,2023-01-15T12:28:26,Gernika,expenses,leisure,-19.98,-17349.87
buyer_2,Aitxiber,Beitia,1984-09-05,00436370Z,aitxiber.beitia@hypernet.io,050240,ES09209580768975132020,11113.43,2023-01-16T09:52:12,Gernika,expenses,cash,-100.0,-17449.87
buyer_2,Aitxiber,Beitia,1984-09-05,00436370Z,aitxiber.beitia@hypernet.io,050240,ES09209580768975132020,11113.43,2023-01-17T03:34:06,Gernika,expenses,repairs,-145.32,-17595.19
buyer_2,Aitxiber,Beitia,1984-09-05,00436370Z,aitxiber.beitia@hypernet.io,050240,ES09209580768975132020,11113.43,2023-01-18T23:52:27,Gernika,expenses,repairs,-51.28,-17646.47
buyer_2,Aitxiber,Beitia,1984-09-05,00436370Z,aitxiber.beitia@hypernet.io,050240,ES09209580768975132020,11113.43,2023-01-18T12:16:33,Gernika,expenses,gifts,-440.97,-18087.44
buyer_2,Aitxiber,Beitia,1984-09-05,00436370Z,aitxiber.beitia@hypernet.io,050240,ES09209580768975132020,11113.43,2023-01-20T08:16:58,Gernika,expenses,cash,-100.0,-18187.44
buyer_2,Aitxiber,Beitia,1984-09-05,00436370Z,aitxiber.beitia@hypernet.io,050240,ES09209580768975132020,11113.43,2023-01-22T15:55:01,Gernika,expenses,transport,-56.14,-18243.58
buyer_2,Aitxiber,Beitia,1984-09-05,00436370Z,aitxiber.beitia@hypernet.io,050240,ES09209580768975132020,11113.43,2023-01-25T15:21:57,Gernika,expenses,travel,-391.4,-18634.98
buyer_2,Aitxiber,Beitia,1984-09-05,00436370Z,aitxiber.beitia@hypernet.io,050240,ES09209580768975132020,11113.43,2023-01-26T13:28:51,Gernika,expenses,cash,-100.0,-18734.98
buyer_2,Aitxiber,Beitia,1984-09-05,00436370Z,aitxiber.beitia@hypernet.io,050240,ES09209580768975132020,11113.43,2023-01-26T16:07:21,Gernika,expenses,gifts,-207.31,-18942.29
buyer_2,Aitxiber,Beitia,1984-09-05,00436370Z,aitxiber.beitia@hypernet.io,050240,ES09209580768975132020,11113.43,2023-01-27T17:54:33,Gernika,expenses,leisure,-27.88,-18970.17
buyer_2,Aitxiber,Beitia,1984-09-05,00436370Z,aitxiber.beitia@hypernet.io,050240,ES09209580768975132020,11113.43,2023-01-27T12:07:25,Gernika,expenses,clothing,-66.12,-19036.29
buyer_2,Aitxiber,Beitia,1984-09-05,00436370Z,aitxiber.beitia@hypernet.io,050240,ES09209580768975132020,11113.43,2023-01-29T13:36:25,Gernika,expenses,cash,-100.0,-19136.29
buyer_2,Aitxiber,Beitia,1984-09-05,00436370Z,aitxiber.beitia@hypernet.io,050240,ES09209580768975132020,11113.43,2023-01-30T17:40:01,Gernika,expenses,cash,-100.0,-19236.29
buyer_2,Aitxiber,Beitia,1984-09-05,00436370Z,aitxiber.beitia@hypernet.io,050240,ES09209580768975132020,11113.43,2023-02-01T18:44:10,Gernika,incomes,salary,2065.05,-17171.24
buyer_2,Aitxiber,Beitia,1984-09-05,00436370Z,aitxiber.beitia@hypernet.io,050240,ES09209580768975132020,11113.43,2023-02-03T09:21:31,Gernika,expenses,children,-378.43,-17549.67
buyer_2,Aitxiber,Beitia,1984-09-05,00436370Z,aitxiber.beitia@hypernet.io,050240,ES09209580768975132020,11113.43,2023-02-04T04:00:27,Gernika,expenses,food,-117.05,-17666.72
buyer_2,Aitxiber,Beitia,1984-09-05,00436370Z,aitxiber.beitia@hypernet.io,050240,ES09209580768975132020,11113.43,2023-02-05T09:27:57,Gernika,expenses,mortgage,-1115.01,-18781.73
buyer_2,Aitxiber,Beitia,1984-09-05,00436370Z,aitxiber.beitia@hypernet.io,050240,ES09209580768975132020,11113.43,2023-02-06T10:11:30,Gernika,expenses,internet,-43.37,-18825.1
buyer_2,Aitxiber,Beitia,1984-09-05,00436370Z,aitxiber.beitia@hypernet.io,050240,ES09209580768975132020,11113.43,2023-02-07T09:33:44,Gernika,expenses,electricity,-49.46,-18874.56
buyer_2,Aitxiber,Beitia,1984-09-05,00436370Z,aitxiber.beitia@hypernet.io,050240,ES09209580768975132020,11113.43,2023-02-07T13:05:06,Gernika,expenses,gas,-84.51,-18959.07
buyer_2,Aitxiber,Beitia,1984-09-05,00436370Z,aitxiber.beitia@hypernet.io,050240,ES09209580768975132020,11113.43,2023-02-08T16:34:48,Gernika,expenses,travel,-374.03,-19333.1
buyer_2,Aitxiber,Beitia,1984-09-05,00436370Z,aitxiber.beitia@hypernet.io,050240,ES09209580768975132020,11113.43,2023-02-09T23:45:55,Gernika,expenses,gifts,-113.05,-19446.15
buyer_2,Aitxiber,Beitia,1984-09-05,00436370Z,aitxiber.beitia@hypernet.io,050240,ES09209580768975132020,11113.43,2023-02-10T18:09:37,Gernika,expenses,food,-75.74,-19521.89
buyer_2,Aitxiber,Beitia,1984-09-05,00436370Z,aitxiber.beitia@hypernet.io,050240,ES09209580768975132020,11113.43,2023-02-12T13:03:56,Gernika,expenses,clothing,-152.09,-19673.98
buyer_2,Aitxiber,Beitia,1984-09-05,00436370Z,aitxiber.beitia@hypernet.io,050240,ES09209580768975132020,11113.43,2023-02-14T05:55:19,Gernika,expenses,gifts,-441.28,-20115.26
buyer_2,Aitxiber,Beitia,1984-09-05,00436370Z,aitxiber.beitia@hypernet.io,050240,ES09209580768975132020,11113.43,2023-02-17T14:05:51,Gernika,expenses,food,-84.7,-20199.96
buyer_2,Aitxiber,Beitia,1984-09-05,00436370Z,aitxiber.beitia@hypernet.io,050240,ES09209580768975132020,11113.43,2023-02-19T16:32:33,Gernika,expenses,cash,-100.0,-20299.96
buyer_2,Aitxiber,Beitia,1984-09-05,00436370Z,aitxiber.beitia@hypernet.io,050240,ES09209580768975132020,11113.43,2023-02-21T11:53:24,Gernika,expenses,food,-64.83,-20364.79
buyer_2,Aitxiber,Beitia,1984-09-05,00436370Z,aitxiber.beitia@hypernet.io,050240,ES09209580768975132020,11113.43,2023-02-21T23:31:41,Gernika,expenses,children,-248.22,-20613.01
buyer_2,Aitxiber,Beitia,1984-09-05,00436370Z,aitxiber.beitia@hypernet.io,050240,ES09209580768975132020,11113.43,2023-02-23T16:20:56,Gernika,expenses,food,-96.21,-20709.22
buyer_2,Aitxiber,Beitia,1984-09-05,00436370Z,aitxiber.beitia@hypernet.io,050240,ES09209580768975132020,11113.43,2023-02-27T17:11:42,Gernika,expenses,repairs,-214.42,-20923.64
buyer_2,Aitxiber,Beitia,1984-09-05,00436370Z,aitxiber.beitia@hypernet.io,050240,ES09209580768975132020,11113.43,2023-02-28T20:02:32,Gernika,expenses,cash,-100.0,-21023.64
buyer_2,Aitxiber,Beitia,1984-09-05,00436370Z,aitxiber.beitia@hypernet.io,050240,ES09209580768975132020,11113.43,2023-03-01T10:52:25,Gernika,incomes,salary,2065.05,-18958.59
buyer_2,Aitxiber,Beitia,1984-09-05,00436370Z,aitxiber.beitia@hypernet.io,050240,ES09209580768975132020,11113.43,2023-03-01T10:52:25,Gernika,incomes,extra_income,263.98,-18694.61
buyer_2,Aitxiber,Beitia,1984-09-05,00436370Z,aitxiber.beitia@hypernet.io,050240,ES09209580768975132020,11113.43,2023-03-01T11:20:03,Gernika,expenses,leisure,-51.16,-18745.77
buyer_2,Aitxiber,Beitia,1984-09-05,00436370Z,aitxiber.beitia@hypernet.io,050240,ES09209580768975132020,11113.43,2023-03-01T12:23:28,Gernika,expenses,children,-515.087916666667,-19260.86
buyer_2,Aitxiber,Beitia,1984-09-05,00436370Z,aitxiber.beitia@hypernet.io,050240,ES09209580768975132020,11113.43,2023-03-03T18:44:29,Gernika,expenses,cash,-100.0,-19360.86
buyer_2,Aitxiber,Beitia,1984-09-05,00436370Z,aitxiber.beitia@hypernet.io,050240,ES09209580768975132020,11113.43,2023-03-04T19:34:03,Gernika,expenses,leisure,-59.52,-19420.38
buyer_2,Aitxiber,Beitia,1984-09-05,00436370Z,aitxiber.beitia@hypernet.io,050240,ES09209580768975132020,11113.43,2023-03-04T15:43:27,Gernika,expenses,appliances,-286.2,-19706.58
buyer_2,Aitxiber,Beitia,1984-09-05,00436370Z,aitxiber.beitia@hypernet.io,050240,ES09209580768975132020,11113.43,2023-03-05T23:55:44,Gernika,expenses,mortgage,-1115.01,-20821.59
buyer_2,Aitxiber,Beitia,1984-09-05,00436370Z,aitxiber.beitia@hypernet.io,050240,ES09209580768975132020,11113.43,2023-03-05T20:45:13,Gernika,expenses,water,-22.41,-20844.0
buyer_2,Aitxiber,Beitia,1984-09-05,00436370Z,aitxiber.beitia@hypernet.io,050240,ES09209580768975132020,11113.43,2023-03-06T10:04:42,Gernika,expenses,water,-42.78,-20886.78
buyer_2,Aitxiber,Beitia,1984-09-05,00436370Z,aitxiber.beitia@hypernet.io,050240,ES09209580768975132020,11113.43,2023-03-06T22:45:22,Gernika,expenses,cash,-100.0,-20986.78
buyer_2,Aitxiber,Beitia,1984-09-05,00436370Z,aitxiber.beitia@hypernet.io,050240,ES09209580768975132020,11113.43,2023-03-06T01:39:32,Gernika,expenses,gifts,-352.05,-21338.83
buyer_2,Aitxiber,Beitia,1984-09-05,00436370Z,aitxiber.beitia@hypernet.io,050240,ES09209580768975132020,11113.43,2023-03-07T11:14:21,Gernika,expenses,electricity,-27.38,-21366.21
buyer_2,Aitxiber,Beitia,1984-09-05,00436370Z,aitxiber.beitia@hypernet.io,050240,ES09209580768975132020,11113.43,2023-03-07T20:09:26,Gernika,expenses,transport,-88.56,-21454.77
buyer_2,Aitxiber,Beitia,1984-09-05,00436370Z,aitxiber.beitia@hypernet.io,050240,ES09209580768975132020,11113.43,2023-03-07T11:59:32,Gernika,expenses,clothing,-159.2,-21613.97
buyer_2,Aitxiber,Beitia,1984-09-05,00436370Z,aitxiber.beitia@hypernet.io,050240,ES09209580768975132020,11113.43,2023-03-10T19:47:07,Gernika,expenses,cash,-100.0,-21713.97
buyer_2,Aitxiber,Beitia,1984-09-05,00436370Z,aitxiber.beitia@hypernet.io,050240,ES09209580768975132020,11113.43,2023-03-11T13:53:31,Gernika,expenses,transport,-41.4,-21755.37
buyer_2,Aitxiber,Beitia,1984-09-05,00436370Z,aitxiber.beitia@hypernet.io,050240,ES09209580768975132020,11113.43,2023-03-12T12:45:26,Gernika,expenses,leisure,-38.13,-21793.5
buyer_2,Aitxiber,Beitia,1984-09-05,00436370Z,aitxiber.beitia@hypernet.io,050240,ES09209580768975132020,11113.43,2023-03-15T19:30:25,Gernika,expenses,leisure,-52.19,-21845.69
buyer_2,Aitxiber,Beitia,1984-09-05,00436370Z,aitxiber.beitia@hypernet.io,050240,ES09209580768975132020,11113.43,2023-03-15T20:01:53,Gernika,expenses,clothing,-139.84,-21985.53
buyer_2,Aitxiber,Beitia,1984-09-05,00436370Z,aitxiber.beitia@hypernet.io,050240,ES09209580768975132020,11113.43,2023-03-16T16:43:41,Gernika,expenses,education,-69.52,-22055.05
buyer_2,Aitxiber,Beitia,1984-09-05,00436370Z,aitxiber.beitia@hypernet.io,050240,ES09209580768975132020,11113.43,2023-03-17T12:25:20,Gernika,expenses,food,-100.66,-22155.71
buyer_2,Aitxiber,Beitia,1984-09-05,00436370Z,aitxiber.beitia@hypernet.io,050240,ES09209580768975132020,11113.43,2023-03-17T12:03:04,Gernika,expenses,clothing,-139.17,-22294.88
buyer_2,Aitxiber,Beitia,1984-09-05,00436370Z,aitxiber.beitia@hypernet.io,050240,ES09209580768975132020,11113.43,2023-03-18T19:57:11,Gernika,expenses,leisure,-64.53,-22359.41
buyer_2,Aitxiber,Beitia,1984-09-05,00436370Z,aitxiber.beitia@hypernet.io,050240,ES09209580768975132020,11113.43,2023-03-18T18:26:57,Gernika,expenses,repairs,-92.47,-22451.88
buyer_2,Aitxiber,Beitia,1984-09-05,00436370Z,aitxiber.beitia@hypernet.io,050240,ES09209580768975132020,11113.43,2023-03-19T19:00:01,Gernika,expenses,food,-63.22,-22515.1
buyer_2,Aitxiber,Beitia,1984-09-05,00436370Z,aitxiber.beitia@hypernet.io,050240,ES09209580768975132020,11113.43,2023-03-20T11:23:16,Gernika,expenses,leisure,-72.37,-22587.47
buyer_2,Aitxiber,Beitia,1984-09-05,00436370Z,aitxiber.beitia@hypernet.io,050240,ES09209580768975132020,11113.43,2023-03-20T17:24:49,Gernika,expenses,cash,-100.0,-22687.47
buyer_2,Aitxiber,Beitia,1984-09-05,00436370Z,aitxiber.beitia@hypernet.io,050240,ES09209580768975132020,11113.43,2023-03-21T18:22:27,Gernika,expenses,food,-73.78,-22761.25
buyer_2,Aitxiber,Beitia,1984-09-05,00436370Z,aitxiber.beitia@hypernet.io,050240,ES09209580768975132020,11113.43,2023-03-21T17:15:38,Gernika,expenses,repairs,-170.14,-22931.39
buyer_2,Aitxiber,Beitia,1984-09-05,00436370Z,aitxiber.beitia@hypernet.io,050240,ES09209580768975132020,11113.43,2023-03-22T14:30:21,Gernika,expenses,cash,-100.0,-23031.39
buyer_2,Aitxiber,Beitia,1984-09-05,00436370Z,aitxiber.beitia@hypernet.io,050240,ES09209580768975132020,11113.43,2023-03-23T11:22:23,Gernika,expenses,leisure,-71.25,-23102.64
buyer_2,Aitxiber,Beitia,1984-09-05,00436370Z,aitxiber.beitia@hypernet.io,050240,ES09209580768975132020,11113.43,2023-03-25T18:59:07,Gernika,expenses,cash,-100.0,-23202.64
buyer_2,Aitxiber,Beitia,1984-09-05,00436370Z,aitxiber.beitia@hypernet.io,050240,ES09209580768975132020,11113.43,2023-03-26T12:19:03,Gernika,expenses,transport,-71.96,-23274.6
buyer_2,Aitxiber,Beitia,1984-09-05,00436370Z,aitxiber.beitia@hypernet.io,050240,ES09209580768975132020,11113.43,2023-03-26T11:36:02,Gernika,expenses,cash,-100.0,-23374.6
buyer_2,Aitxiber,Beitia,1984-09-05,00436370Z,aitxiber.beitia@hypernet.io,050240,ES09209580768975132020,11113.43,2023-03-27T19:39:26,Gernika,expenses,food,-77.33,-23451.93
buyer_2,Aitxiber,Beitia,1984-09-05,00436370Z,aitxiber.beitia@hypernet.io,050240,ES09209580768975132020,11113.43,2023-03-27T11:34:46,Gernika,expenses,transport,-84.87,-23536.8
buyer_2,Aitxiber,Beitia,1984-09-05,00436370Z,aitxiber.beitia@hypernet.io,050240,ES09209580768975132020,11113.43,2023-03-27T15:57:58,Gernika,expenses,leisure,-52.88,-23589.68
buyer_2,Aitxiber,Beitia,1984-09-05,00436370Z,aitxiber.beitia@hypernet.io,050240,ES09209580768975132020,11113.43,2023-03-27T11:05:31,Gernika,expenses,cash,-100.0,-23689.68
buyer_2,Aitxiber,Beitia,1984-09-05,00436370Z,aitxiber.beitia@hypernet.io,050240,ES09209580768975132020,11113.43,2023-03-28T08:15:44,Gernika,expenses,food,-73.61,-23763.29
buyer_2,Aitxiber,Beitia,1984-09-05,00436370Z,aitxiber.beitia@hypernet.io,050240,ES09209580768975132020,11113.43,2023-03-30T17:11:56,Gernika,expenses,leisure,-50.58,-23813.87
buyer_2,Aitxiber,Beitia,1984-09-05,00436370Z,aitxiber.beitia@hypernet.io,050240,ES09209580768975132020,11113.43,2023-03-31T01:04:25,Gernika,expenses,leisure,-36.85,-23850.72
buyer_2,Aitxiber,Beitia,1984-09-05,00436370Z,aitxiber.beitia@hypernet.io,050240,ES09209580768975132020,11113.43,2023-04-01T06:40:29,Gernika,incomes,salary,2065.05,-21785.67
buyer_2,Aitxiber,Beitia,1984-09-05,00436370Z,aitxiber.beitia@hypernet.io,050240,ES09209580768975132020,11113.43,2023-04-02T08:41:35,Gernika,expenses,food,-84.41,-21870.08
buyer_2,Aitxiber,Beitia,1984-09-05,00436370Z,aitxiber.beitia@hypernet.io,050240,ES09209580768975132020,11113.43,2023-04-02T17:26:35,Gernika,expenses,gifts,-150.92,-22021.0
buyer_2,Aitxiber,Beitia,1984-09-05,00436370Z,aitxiber.beitia@hypernet.io,050240,ES09209580768975132020,11113.43,2023-04-04T10:16:37,Gernika,expenses,cash,-100.0,-22121.0
buyer_2,Aitxiber,Beitia,1984-09-05,00436370Z,aitxiber.beitia@hypernet.io,050240,ES09209580768975132020,11113.43,2023-04-05T17:44:08,Gernika,expenses,mortgage,-1115.01,-23236.01
buyer_2,Aitxiber,Beitia,1984-09-05,00436370Z,aitxiber.beitia@hypernet.io,050240,ES09209580768975132020,11113.43,2023-04-05T23:54:19,Gernika,expenses,electricity,-69.83,-23305.84
buyer_2,Aitxiber,Beitia,1984-09-05,00436370Z,aitxiber.beitia@hypernet.io,050240,ES09209580768975132020,11113.43,2023-04-05T12:20:05,Gernika,expenses,internet,-43.37,-23349.21
buyer_2,Aitxiber,Beitia,1984-09-05,00436370Z,aitxiber.beitia@hypernet.io,050240,ES09209580768975132020,11113.43,2023-04-05T18:06:44,Gernika,expenses,appliances,-199.24,-23548.45
buyer_2,Aitxiber,Beitia,1984-09-05,00436370Z,aitxiber.beitia@hypernet.io,050240,ES09209580768975132020,11113.43,2023-04-06T14:24:39,Gernika,expenses,electricity,-52.32,-23600.77
buyer_2,Aitxiber,Beitia,1984-09-05,00436370Z,aitxiber.beitia@hypernet.io,050240,ES09209580768975132020,11113.43,2023-04-06T15:21:18,Gernika,expenses,gas,-74.38,-23675.15
buyer_2,Aitxiber,Beitia,1984-09-05,00436370Z,aitxiber.beitia@hypernet.io,050240,ES09209580768975132020,11113.43,2023-04-06T19:32:04,Gernika,expenses,internet,-43.37,-23718.52
buyer_2,Aitxiber,Beitia,1984-09-05,00436370Z,aitxiber.beitia@hypernet.io,050240,ES09209580768975132020,11113.43,2023-04-06T10:49:36,Gernika,expenses,phone,-45.79,-23764.31
buyer_2,Aitxiber,Beitia,1984-09-05,00436370Z,aitxiber.beitia@hypernet.io,050240,ES09209580768975132020,11113.43,2023-04-07T19:20:42,Gernika,expenses,gas,-72.45,-23836.76
buyer_2,Aitxiber,Beitia,1984-09-05,00436370Z,aitxiber.beitia@hypernet.io,050240,ES09209580768975132020,11113.43,2023-04-07T17:05:47,Gernika,expenses,cash,-100.0,-23936.76
buyer_2,Aitxiber,Beitia,1984-09-05,00436370Z,aitxiber.beitia@hypernet.io,050240,ES09209580768975132020,11113.43,2023-04-08T10:30:09,Gernika,expenses,water,-23.02,-23959.78
buyer_2,Aitxiber,Beitia,1984-09-05,00436370Z,aitxiber.beitia@hypernet.io,050240,ES09209580768975132020,11113.43,2023-04-08T10:02:45,Gernika,expenses,phone,-33.56,-23993.34
buyer_2,Aitxiber,Beitia,1984-09-05,00436370Z,aitxiber.beitia@hypernet.io,050240,ES09209580768975132020,11113.43,2023-04-08T11:14:19,Gernika,expenses,food,-115.74,-24109.08
buyer_2,Aitxiber,Beitia,1984-09-05,00436370Z,aitxiber.beitia@hypernet.io,050240,ES09209580768975132020,11113.43,2023-04-11T16:16:09,Gernika,expenses,education,-64.99,-24174.07
buyer_2,Aitxiber,Beitia,1984-09-05,00436370Z,aitxiber.beitia@hypernet.io,050240,ES09209580768975132020,11113.43,2023-04-12T13:29:08,Gernika,expenses,leisure,-50.75,-24224.82
buyer_2,Aitxiber,Beitia,1984-09-05,00436370Z,aitxiber.beitia@hypernet.io,050240,ES09209580768975132020,11113.43,2023-04-12T09:39:17,Gernika,expenses,gifts,-451.73,-24676.55
buyer_2,Aitxiber,Beitia,1984-09-05,00436370Z,aitxiber.beitia@hypernet.io,050240,ES09209580768975132020,11113.43,2023-04-13T14:14:51,Gernika,expenses,transport,-59.85,-24736.4
buyer_2,Aitxiber,Beitia,1984-09-05,00436370Z,aitxiber.beitia@hypernet.io,050240,ES09209580768975132020,11113.43,2023-04-13T20:46:23,Gernika,expenses,repairs,-143.95,-24880.35
buyer_2,Aitxiber,Beitia,1984-09-05,00436370Z,aitxiber.beitia@hypernet.io,050240,ES09209580768975132020,11113.43,2023-04-15T12:18:11,Gernika,expenses,gifts,-108.65,-24989.0
buyer_2,Aitxiber,Beitia,1984-09-05,00436370Z,aitxiber.beitia@hypernet.io,050240,ES09209580768975132020,11113.43,2023-04-17T15:26:04,Gernika,expenses,education,-52.14,-25041.14
buyer_2,Aitxiber,Beitia,1984-09-05,00436370Z,aitxiber.beitia@hypernet.io,050240,ES09209580768975132020,11113.43,2023-04-17T15:01:22,Gernika,expenses,repairs,-299.07,-25340.21
buyer_2,Aitxiber,Beitia,1984-09-05,00436370Z,aitxiber.beitia@hypernet.io,050240,ES09209580768975132020,11113.43,2023-04-20T20:25:17,Gernika,expenses,cash,-100.0,-25440.21
buyer_2,Aitxiber,Beitia,1984-09-05,00436370Z,aitxiber.beitia@hypernet.io,050240,ES09209580768975132020,11113.43,2023-04-22T12:51:55,Gernika,expenses,education,-59.57,-25499.78
buyer_2,Aitxiber,Beitia,1984-09-05,00436370Z,aitxiber.beitia@hypernet.io,050240,ES09209580768975132020,11113.43,2023-04-22T19:28:05,Gernika,expenses,gifts,-242.1,-25741.88
buyer_2,Aitxiber,Beitia,1984-09-05,00436370Z,aitxiber.beitia@hypernet.io,050240,ES09209580768975132020,11113.43,2023-04-23T17:02:08,Gernika,expenses,gifts,-69.04,-25810.92
buyer_2,Aitxiber,Beitia,1984-09-05,00436370Z,aitxiber.beitia@hypernet.io,050240,ES09209580768975132020,11113.43,2023-04-25T17:13:32,Gernika,expenses,transport,-76.28,-25887.2
buyer_2,Aitxiber,Beitia,1984-09-05,00436370Z,aitxiber.beitia@hypernet.io,050240,ES09209580768975132020,11113.43,2023-04-25T11:04:05,Gernika,expenses,education,-52.24,-25939.44
buyer_2,Aitxiber,Beitia,1984-09-05,00436370Z,aitxiber.beitia@hypernet.io,050240,ES09209580768975132020,11113.43,2023-04-27T00:13:32,Gernika,expenses,gifts,-116.76,-26056.2
buyer_2,Aitxiber,Beitia,1984-09-05,00436370Z,aitxiber.beitia@hypernet.io,050240,ES09209580768975132020,11113.43,2023-04-28T06:23:45,Gernika,expenses,transport,-79.31,-26135.51
buyer_2,Aitxiber,Beitia,1984-09-05,00436370Z,aitxiber.beitia@hypernet.io,050240,ES09209580768975132020,11113.43,2023-04-28T19:17:49,Gernika,expenses,clothing,-82.28,-26217.79
buyer_2,Aitxiber,Beitia,1984-09-05,00436370Z,aitxiber.beitia@hypernet.io,050240,ES09209580768975132020,11113.43,2023-04-28T20:05:03,Gernika,expenses,children,-277.63,-26495.42
buyer_2,Aitxiber,Beitia,1984-09-05,00436370Z,aitxiber.beitia@hypernet.io,050240,ES09209580768975132020,11113.43,2023-04-29T08:09:51,Gernika,expenses,food,-91.33,-26586.75
buyer_2,Aitxiber,Beitia,1984-09-05,00436370Z,aitxiber.beitia@hypernet.io,050240,ES09209580768975132020,11113.43,2023-04-29T12:43:21,Gernika,expenses,leisure,-75.54,-26662.29
buyer_2,Aitxiber,Beitia,1984-09-05,00436370Z,aitxiber.beitia@hypernet.io,050240,ES09209580768975132020,11113.43,2023-04-30T13:46:10,Gernika,expenses,cash,-100.0,-26762.29
buyer_2,Aitxiber,Beitia,1984-09-05,00436370Z,aitxiber.beitia@hypernet.io,050240,ES09209580768975132020,11113.43,2023-05-01T13:57:19,Gernika,incomes,salary,2065.05,-24697.24
buyer_2,Aitxiber,Beitia,1984-09-05,00436370Z,aitxiber.beitia@hypernet.io,050240,ES09209580768975132020,11113.43,2023-05-01T11:42:11,Gernika,expenses,transport,-59.07,-24756.31
buyer_2,Aitxiber,Beitia,1984-09-05,00436370Z,aitxiber.beitia@hypernet.io,050240,ES09209580768975132020,11113.43,2023-05-01T19:14:54,Gernika,expenses,leisure,-66.92,-24823.23
buyer_2,Aitxiber,Beitia,1984-09-05,00436370Z,aitxiber.beitia@hypernet.io,050240,ES09209580768975132020,11113.43,2023-05-04T10:15:57,Gernika,expenses,clothing,-159.95,-24983.18
buyer_2,Aitxiber,Beitia,1984-09-05,00436370Z,aitxiber.beitia@hypernet.io,050240,ES09209580768975132020,11113.43,2023-05-04T08:40:07,Gernika,expenses,repairs,-179.48,-25162.66
buyer_2,Aitxiber,Beitia,1984-09-05,00436370Z,aitxiber.beitia@hypernet.io,050240,ES09209580768975132020,11113.43,2023-05-05T12:44:27,Gernika,expenses,mortgage,-1115.01,-26277.67
buyer_2,Aitxiber,Beitia,1984-09-05,00436370Z,aitxiber.beitia@hypernet.io,050240,ES09209580768975132020,11113.43,2023-05-05T14:19:20,Gernika,expenses,water,-27.43,-26305.1
buyer_2,Aitxiber,Beitia,1984-09-05,00436370Z,aitxiber.beitia@hypernet.io,050240,ES09209580768975132020,11113.43,2023-05-05T12:30:08,Gernika,expenses,electricity,-33.85,-26338.95
buyer_2,Aitxiber,Beitia,1984-09-05,00436370Z,aitxiber.beitia@hypernet.io,050240,ES09209580768975132020,11113.43,2023-05-05T12:01:19,Gernika,expenses,food,-101.92,-26440.87
buyer_2,Aitxiber,Beitia,1984-09-05,00436370Z,aitxiber.beitia@hypernet.io,050240,ES09209580768975132020,11113.43,2023-05-05T19:46:17,Gernika,expenses,transport,-72.13,-26513.0
buyer_2,Aitxiber,Beitia,1984-09-05,00436370Z,aitxiber.beitia@hypernet.io,050240,ES09209580768975132020,11113.43,2023-05-05T10:58:53,Gernika,expenses,clothing,-90.1,-26603.1
buyer_2,Aitxiber,Beitia,1984-09-05,00436370Z,aitxiber.beitia@hypernet.io,050240,ES09209580768975132020,11113.43,2023-05-06T18:35:56,Gernika,expenses,food,-91.95,-26695.05
buyer_2,Aitxiber,Beitia,1984-09-05,00436370Z,aitxiber.beitia@hypernet.io,050240,ES09209580768975132020,11113.43,2023-05-07T07:39:42,Gernika,expenses,internet,-43.37,-26738.42
buyer_2,Aitxiber,Beitia,1984-09-05,00436370Z,aitxiber.beitia@hypernet.io,050240,ES09209580768975132020,11113.43,2023-05-08T17:56:11,Gernika,expenses,internet,-43.37,-26781.79
buyer_2,Aitxiber,Beitia,1984-09-05,00436370Z,aitxiber.beitia@hypernet.io,050240,ES09209580768975132020,11113.43,2023-05-08T17:17:00,Gernika,expenses,repairs,-273.37,-27055.16
buyer_2,Aitxiber,Beitia,1984-09-05,00436370Z,aitxiber.beitia@hypernet.io,050240,ES09209580768975132020,11113.43,2023-05-10T08:22:25,Gernika,expenses,leisure,-22.24,-27077.4
buyer_2,Aitxiber,Beitia,1984-09-05,00436370Z,aitxiber.beitia@hypernet.io,050240,ES09209580768975132020,11113.43,2023-05-12T16:14:32,Gernika,expenses,cash,-100.0,-27177.4
buyer_2,Aitxiber,Beitia,1984-09-05,00436370Z,aitxiber.beitia@hypernet.io,050240,ES09209580768975132020,11113.43,2023-05-13T14:00:33,Gernika,expenses,food,-78.84,-27256.24
buyer_2,Aitxiber,Beitia,1984-09-05,00436370Z,aitxiber.beitia@hypernet.io,050240,ES09209580768975132020,11113.43,2023-05-13T18:14:37,Gernika,expenses,clothing,-83.63,-27339.87
buyer_2,Aitxiber,Beitia,1984-09-05,00436370Z,aitxiber.beitia@hypernet.io,050240,ES09209580768975132020,11113.43,2023-05-14T10:26:58,Gernika,expenses,food,-110.83,-27450.7
buyer_2,Aitxiber,Beitia,1984-09-05,00436370Z,aitxiber.beitia@hypernet.io,050240,ES09209580768975132020,11113.43,2023-05-15T15:21:20,Gernika,expenses,cash,-100.0,-27550.7
buyer_2,Aitxiber,Beitia,1984-09-05,00436370Z,aitxiber.beitia@hypernet.io,050240,ES09209580768975132020,11113.43,2023-05-15T16:46:15,Gernika,expenses,gifts,-113.69,-27664.39
buyer_2,Aitxiber,Beitia,1984-09-05,00436370Z,aitxiber.beitia@hypernet.io,050240,ES09209580768975132020,11113.43,2023-05-20T20:39:47,Gernika,expenses,cash,-100.0,-27764.39
buyer_2,Aitxiber,Beitia,1984-09-05,00436370Z,aitxiber.beitia@hypernet.io,050240,ES09209580768975132020,11113.43,2023-05-21T18:48:30,Gernika,expenses,repairs,-112.66,-27877.05
buyer_2,Aitxiber,Beitia,1984-09-05,00436370Z,aitxiber.beitia@hypernet.io,050240,ES09209580768975132020,11113.43,2023-05-22T00:02:24,Gernika,expenses,food,-61.22,-27938.27
buyer_2,Aitxiber,Beitia,1984-09-05,00436370Z,aitxiber.beitia@hypernet.io,050240,ES09209580768975132020,11113.43,2023-05-23T18:47:33,Gernika,expenses,cash,-100.0,-28038.27
buyer_2,Aitxiber,Beitia,1984-09-05,00436370Z,aitxiber.beitia@hypernet.io,050240,ES09209580768975132020,11113.43,2023-05-23T22:28:20,Gernika,expenses,gifts,-108.08,-28146.35
buyer_2,Aitxiber,Beitia,1984-09-05,00436370Z,aitxiber.beitia@hypernet.io,050240,ES09209580768975132020,11113.43,2023-05-25T14:36:38,Gernika,expenses,transport,-40.7,-28187.05
buyer_2,Aitxiber,Beitia,1984-09-05,00436370Z,aitxiber.beitia@hypernet.io,050240,ES09209580768975132020,11113.43,2023-05-25T23:29:08,Gernika,expenses,gifts,-444.37,-28631.42
buyer_2,Aitxiber,Beitia,1984-09-05,00436370Z,aitxiber.beitia@hypernet.io,050240,ES09209580768975132020,11113.43,2023-05-26T18:51:11,Gernika,expenses,cash,-100.0,-28731.42
buyer_2,Aitxiber,Beitia,1984-09-05,00436370Z,aitxiber.beitia@hypernet.io,050240,ES09209580768975132020,11113.43,2023-05-28T20:16:52,Gernika,expenses,children,-363.74,-29095.16
buyer_2,Aitxiber,Beitia,1984-09-05,00436370Z,aitxiber.beitia@hypernet.io,050240,ES09209580768975132020,11113.43,2023-05-31T14:42:11,Gernika,expenses,leisure,-27.4,-29122.56
buyer_2,Aitxiber,Beitia,1984-09-05,00436370Z,aitxiber.beitia@hypernet.io,050240,ES09209580768975132020,11113.43,2023-05-31T09:13:35,Gernika,expenses,gifts,-131.0,-29253.56
buyer_2,Aitxiber,Beitia,1984-09-05,00436370Z,aitxiber.beitia@hypernet.io,050240,ES09209580768975132020,11113.43,2023-06-01T20:04:02,Gernika,incomes,salary,2065.05,-27188.51
buyer_2,Aitxiber,Beitia,1984-09-05,00436370Z,aitxiber.beitia@hypernet.io,050240,ES09209580768975132020,11113.43,2023-06-01T20:04:02,Gernika,incomes,extra_income,263.98,-26924.53
buyer_2,Aitxiber,Beitia,1984-09-05,00436370Z,aitxiber.beitia@hypernet.io,050240,ES09209580768975132020,11113.43,2023-06-01T20:04:02,Gernika,incomes,salary_bonus,1620.46,-25304.07
buyer_2,Aitxiber,Beitia,1984-09-05,00436370Z,aitxiber.beitia@hypernet.io,050240,ES09209580768975132020,11113.43,2023-06-01T08:08:15,Gernika,expenses,taxes,-1384.78,-26688.85
buyer_2,Aitxiber,Beitia,1984-09-05,00436370Z,aitxiber.beitia@hypernet.io,050240,ES09209580768975132020,11113.43,2023-06-01T18:10:33,Gernika,expenses,insurance,-596.9,-27285.75
buyer_2,Aitxiber,Beitia,1984-09-05,00436370Z,aitxiber.beitia@hypernet.io,050240,ES09209580768975132020,11113.43,2023-06-01T04:30:58,Gernika,expenses,leisure,-79.26,-27365.01
buyer_2,Aitxiber,Beitia,1984-09-05,00436370Z,aitxiber.beitia@hypernet.io,050240,ES09209580768975132020,11113.43,2023-06-01T18:35:45,Gernika,expenses,gifts,-366.4,-27731.41
buyer_2,Aitxiber,Beitia,1984-09-05,00436370Z,aitxiber.beitia@hypernet.io,050240,ES09209580768975132020,11113.43,2023-06-02T12:44:56,Gernika,expenses,clothing,-129.18,-27860.59
buyer_2,Aitxiber,Beitia,1984-09-05,00436370Z,aitxiber.beitia@hypernet.io,050240,ES09209580768975132020,11113.43,2023-06-02T20:09:08,Gernika,expenses,cash,-100.0,-27960.59
buyer_2,Aitxiber,Beitia,1984-09-05,00436370Z,aitxiber.beitia@hypernet.io,050240,ES09209580768975132020,11113.43,2023-06-04T20:56:08,Gernika,expenses,leisure,-54.3,-28014.89
buyer_2,Aitxiber,Beitia,1984-09-05,00436370Z,aitxiber.beitia@hypernet.io,050240,ES09209580768975132020,11113.43,2023-06-04T20:23:28,Gernika,expenses,repairs,-309.34,-28324.23
buyer_2,Aitxiber,Beitia,1984-09-05,00436370Z,aitxiber.beitia@hypernet.io,050240,ES09209580768975132020,11113.43,2023-06-05T12:11:55,Gernika,expenses,mortgage,-1115.01,-29439.24
buyer_2,Aitxiber,Beitia,1984-09-05,00436370Z,aitxiber.beitia@hypernet.io,050240,ES09209580768975132020,11113.43,2023-06-05T09:14:10,Gernika,expenses,phone,-34.9,-29474.14
buyer_2,Aitxiber,Beitia,1984-09-05,00436370Z,aitxiber.beitia@hypernet.io,050240,ES09209580768975132020,11113.43,2023-06-05T18:15:22,Gernika,expenses,food,-117.22,-29591.36
buyer_2,Aitxiber,Beitia,1984-09-05,00436370Z,aitxiber.beitia@hypernet.io,050240,ES09209580768975132020,11113.43,2023-06-06T17:14:24,Gernika,expenses,electricity,-22.17,-29613.53
buyer_2,Aitxiber,Beitia,1984-09-05,00436370Z,aitxiber.beitia@hypernet.io,050240,ES09209580768975132020,11113.43,2023-06-06T10:47:56,Gernika,expenses,gas,-57.01,-29670.54
buyer_2,Aitxiber,Beitia,1984-09-05,00436370Z,aitxiber.beitia@hypernet.io,050240,ES09209580768975132020,11113.43,2023-06-06T12:07:37,Gernika,expenses,transport,-86.91,-29757.45
buyer_2,Aitxiber,Beitia,1984-09-05,00436370Z,aitxiber.beitia@hypernet.io,050240,ES09209580768975132020,11113.43,2023-06-06T16:51:16,Gernika,expenses,leisure,-64.65,-29822.1
buyer_2,Aitxiber,Beitia,1984-09-05,00436370Z,aitxiber.beitia@hypernet.io,050240,ES09209580768975132020,11113.43,2023-06-07T19:27:08,Gernika,expenses,water,-24.72,-29846.82
buyer_2,Aitxiber,Beitia,1984-09-05,00436370Z,aitxiber.beitia@hypernet.io,050240,ES09209580768975132020,11113.43,2023-06-07T20:16:32,Gernika,expenses,gas,-97.06,-29943.88
buyer_2,Aitxiber,Beitia,1984-09-05,00436370Z,aitxiber.beitia@hypernet.io,050240,ES09209580768975132020,11113.43,2023-06-08T20:51:17,Gernika,expenses,electricity,-75.74,-30019.62
buyer_2,Aitxiber,Beitia,1984-09-05,00436370Z,aitxiber.beitia@hypernet.io,050240,ES09209580768975132020,11113.43,2023-06-08T13:35:20,Gernika,expenses,phone,-41.46,-30061.08
buyer_2,Aitxiber,Beitia,1984-09-05,00436370Z,aitxiber.beitia@hypernet.io,050240,ES09209580768975132020,11113.43,2023-06-08T10:56:56,Gernika,expenses,gifts,-215.41,-30276.49
buyer_2,Aitxiber,Beitia,1984-09-05,00436370Z,aitxiber.beitia@hypernet.io,050240,ES09209580768975132020,11113.43,2023-06-11T09:50:43,Gernika,expenses,cash,-100.0,-30376.49
buyer_2,Aitxiber,Beitia,1984-09-05,00436370Z,aitxiber.beitia@hypernet.io,050240,ES09209580768975132020,11113.43,2023-06-12T09:07:55,Gernika,expenses,transport,-41.97,-30418.46
buyer_2,Aitxiber,Beitia,1984-09-05,00436370Z,aitxiber.beitia@hypernet.io,050240,ES09209580768975132020,11113.43,2023-06-12T10:42:23,Gernika,expenses,healthcare,-184.18,-30602.64
buyer_2,Aitxiber,Beitia,1984-09-05,00436370Z,aitxiber.beitia@hypernet.io,050240,ES09209580768975132020,11113.43,2023-06-14T21:46:07,Gernika,expenses,repairs,-297.41,-30900.05
buyer_2,Aitxiber,Beitia,1984-09-05,00436370Z,aitxiber.beitia@hypernet.io,050240,ES09209580768975132020,11113.43,2023-06-16T08:41:52,Gernika,expenses,clothing,-141.25,-31041.3
buyer_2,Aitxiber,Beitia,1984-09-05,00436370Z,aitxiber.beitia@hypernet.io,050240,ES09209580768975132020,11113.43,2023-06-16T19:15:42,Gernika,expenses,appliances,-321.48,-31362.78
buyer_2,Aitxiber,Beitia,1984-09-05,00436370Z,aitxiber.beitia@hypernet.io,050240,ES09209580768975132020,11113.43,2023-06-17T09:48:01,Gernika,expenses,food,-78.94,-31441.72
buyer_2,Aitxiber,Beitia,1984-09-05,00436370Z,aitxiber.beitia@hypernet.io,050240,ES09209580768975132020,11113.43,2023-06-17T20:45:45,Gernika,expenses,appliances,-275.94,-31717.66
buyer_2,Aitxiber,Beitia,1984-09-05,00436370Z,aitxiber.beitia@hypernet.io,050240,ES09209580768975132020,11113.43,2023-06-23T18:34:20,Gernika,expenses,food,-72.07,-31789.73
buyer_2,Aitxiber,Beitia,1984-09-05,00436370Z,aitxiber.beitia@hypernet.io,050240,ES09209580768975132020,11113.43,2023-06-23T12:56:50,Gernika,expenses,appliances,-417.35,-32207.08
buyer_2,Aitxiber,Beitia,1984-09-05,00436370Z,aitxiber.beitia@hypernet.io,050240,ES09209580768975132020,11113.43,2023-06-24T19:36:27,Gernika,expenses,food,-81.27,-32288.35
buyer_2,Aitxiber,Beitia,1984-09-05,00436370Z,aitxiber.beitia@hypernet.io,050240,ES09209580768975132020,11113.43,2023-06-24T11:16:32,Gernika,expenses,clothing,-142.45,-32430.8
buyer_2,Aitxiber,Beitia,1984-09-05,00436370Z,aitxiber.beitia@hypernet.io,050240,ES09209580768975132020,11113.43,2023-06-25T10:58:40,Gernika,expenses,food,-93.54,-32524.34
buyer_2,Aitxiber,Beitia,1984-09-05,00436370Z,aitxiber.beitia@hypernet.io,050240,ES09209580768975132020,11113.43,2023-06-27T09:21:38,Gernika,expenses,transport,-42.0,-32566.34
buyer_2,Aitxiber,Beitia,1984-09-05,00436370Z,aitxiber.beitia@hypernet.io,050240,ES09209580768975132020,11113.43,2023-06-27T15:33:56,Gernika,expenses,appliances,-258.62,-32824.96
buyer_2,Aitxiber,Beitia,1984-09-05,00436370Z,aitxiber.beitia@hypernet.io,050240,ES09209580768975132020,11113.43,2023-06-28T17:20:42,Gernika,expenses,food,-114.08,-32939.04
buyer_2,Aitxiber,Beitia,1984-09-05,00436370Z,aitxiber.beitia@hypernet.io,050240,ES09209580768975132020,11113.43,2023-06-28T21:42:24,Gernika,expenses,healthcare,-107.45,-33046.49
buyer_2,Aitxiber,Beitia,1984-09-05,00436370Z,aitxiber.beitia@hypernet.io,050240,ES09209580768975132020,11113.43,2023-06-29T08:41:34,Gernika,expenses,food,-81.36,-33127.85
buyer_2,Aitxiber,Beitia,1984-09-05,00436370Z,aitxiber.beitia@hypernet.io,050240,ES09209580768975132020,11113.43,2023-06-29T14:03:20,Gernika,expenses,transport,-88.0,-33215.85
buyer_2,Aitxiber,Beitia,1984-09-05,00436370Z,aitxiber.beitia@hypernet.io,050240,ES09209580768975132020,11113.43,2023-06-29T19:00:34,Gernika,expenses,cash,-100.0,-33315.85
buyer_2,Aitxiber,Beitia,1984-09-05,00436370Z,aitxiber.beitia@hypernet.io,050240,ES09209580768975132020,11113.43,2023-06-30T18:16:26,Gernika,expenses,cash,-100.0,-33415.85
buyer_2,Aitxiber,Beitia,1984-09-05,00436370Z,aitxiber.beitia@hypernet.io,050240,ES09209580768975132020,11113.43,2023-06-30T15:44:07,Gernika,expenses,appliances,-406.97,-33822.82
buyer_2,Aitxiber,Beitia,1984-09-05,00436370Z,aitxiber.beitia@hypernet.io,050240,ES09209580768975132020,11113.43,2023-07-01T15:09:07,Gernika,incomes,salary,2065.05,-31757.77
buyer_2,Aitxiber,Beitia,1984-09-05,00436370Z,aitxiber.beitia@hypernet.io,050240,ES09209580768975132020,11113.43,2023-07-03T22:18:54,Gernika,expenses,food,-121.15,-31878.92
buyer_2,Aitxiber,Beitia,1984-09-05,00436370Z,aitxiber.beitia@hypernet.io,050240,ES09209580768975132020,11113.43,2023-07-03T23:33:44,Gernika,expenses,education,-58.69,-31937.61
buyer_2,Aitxiber,Beitia,1984-09-05,00436370Z,aitxiber.beitia@hypernet.io,050240,ES09209580768975132020,11113.43,2023-07-05T16:56:34,Gernika,expenses,mortgage,-1115.01,-33052.62
buyer_2,Aitxiber,Beitia,1984-09-05,00436370Z,aitxiber.beitia@hypernet.io,050240,ES09209580768975132020,11113.43,2023-07-05T18:10:08,Gernika,expenses,gas,-58.95,-33111.57
buyer_2,Aitxiber,Beitia,1984-09-05,00436370Z,aitxiber.beitia@hypernet.io,050240,ES09209580768975132020,11113.43,2023-07-05T15:50:41,Gernika,expenses,internet,-43.37,-33154.94
buyer_2,Aitxiber,Beitia,1984-09-05,00436370Z,aitxiber.beitia@hypernet.io,050240,ES09209580768975132020,11113.43,2023-07-05T12:05:41,Gernika,expenses,food,-122.79,-33277.73
buyer_2,Aitxiber,Beitia,1984-09-05,00436370Z,aitxiber.beitia@hypernet.io,050240,ES09209580768975132020,11113.43,2023-07-05T01:30:12,Gernika,expenses,clothing,-70.46,-33348.19
buyer_2,Aitxiber,Beitia,1984-09-05,00436370Z,aitxiber.beitia@hypernet.io,050240,ES09209580768975132020,11113.43,2023-07-06T05:12:52,Gernika,expenses,water,-25.13,-33373.32
buyer_2,Aitxiber,Beitia,1984-09-05,00436370Z,aitxiber.beitia@hypernet.io,050240,ES09209580768975132020,11113.43,2023-07-07T02:06:09,Gernika,expenses,electricity,-76.76,-33450.08
buyer_2,Aitxiber,Beitia,1984-09-05,00436370Z,aitxiber.beitia@hypernet.io,050240,ES09209580768975132020,11113.43,2023-07-07T15:26:20,Gernika,expenses,gas,-51.8,-33501.88
buyer_2,Aitxiber,Beitia,1984-09-05,00436370Z,aitxiber.beitia@hypernet.io,050240,ES09209580768975132020,11113.43,2023-07-07T16:43:27,Gernika,expenses,internet,-43.37,-33545.25
buyer_2,Aitxiber,Beitia,1984-09-05,00436370Z,aitxiber.beitia@hypernet.io,050240,ES09209580768975132020,11113.43,2023-07-08T09:38:50,Gernika,expenses,electricity,-20.88,-33566.13
buyer_2,Aitxiber,Beitia,1984-09-05,00436370Z,aitxiber.beitia@hypernet.io,050240,ES09209580768975132020,11113.43,2023-07-08T18:39:16,Gernika,expenses,internet,-43.37,-33609.5
buyer_2,Aitxiber,Beitia,1984-09-05,00436370Z,aitxiber.beitia@hypernet.io,050240,ES09209580768975132020,11113.43,2023-07-09T20:53:45,Gernika,expenses,food,-110.72,-33720.22
buyer_2,Aitxiber,Beitia,1984-09-05,00436370Z,aitxiber.beitia@hypernet.io,050240,ES09209580768975132020,11113.43,2023-07-09T11:28:25,Gernika,expenses,transport,-66.03,-33786.25
buyer_2,Aitxiber,Beitia,1984-09-05,00436370Z,aitxiber.beitia@hypernet.io,050240,ES09209580768975132020,11113.43,2023-07-09T02:52:14,Gernika,expenses,leisure,-71.05,-33857.3
buyer_2,Aitxiber,Beitia,1984-09-05,00436370Z,aitxiber.beitia@hypernet.io,050240,ES09209580768975132020,11113.43,2023-07-09T12:37:44,Gernika,expenses,healthcare,-146.05,-34003.35
buyer_2,Aitxiber,Beitia,1984-09-05,00436370Z,aitxiber.beitia@hypernet.io,050240,ES09209580768975132020,11113.43,2023-07-11T14:21:26,Gernika,expenses,cash,-100.0,-34103.35
buyer_2,Aitxiber,Beitia,1984-09-05,00436370Z,aitxiber.beitia@hypernet.io,050240,ES09209580768975132020,11113.43,2023-07-12T20:09:13,Gernika,expenses,cash,-100.0,-34203.35
buyer_2,Aitxiber,Beitia,1984-09-05,00436370Z,aitxiber.beitia@hypernet.io,050240,ES09209580768975132020,11113.43,2023-07-12T11:03:16,Gernika,expenses,travel,-393.63,-34596.98
buyer_2,Aitxiber,Beitia,1984-09-05,00436370Z,aitxiber.beitia@hypernet.io,050240,ES09209580768975132020,11113.43,2023-07-14T23:14:00,Gernika,expenses,cash,-100.0,-34696.98
buyer_2,Aitxiber,Beitia,1984-09-05,00436370Z,aitxiber.beitia@hypernet.io,050240,ES09209580768975132020,11113.43,2023-07-15T17:52:56,Gernika,expenses,leisure,-77.15,-34774.13
buyer_2,Aitxiber,Beitia,1984-09-05,00436370Z,aitxiber.beitia@hypernet.io,050240,ES09209580768975132020,11113.43,2023-07-16T22:05:24,Gernika,expenses,cash,-100.0,-34874.13
buyer_2,Aitxiber,Beitia,1984-09-05,00436370Z,aitxiber.beitia@hypernet.io,050240,ES09209580768975132020,11113.43,2023-07-17T20:58:15,Gernika,expenses,leisure,-81.97,-34956.1
buyer_2,Aitxiber,Beitia,1984-09-05,00436370Z,aitxiber.beitia@hypernet.io,050240,ES09209580768975132020,11113.43,2023-07-20T21:59:05,Gernika,expenses,food,-77.51,-35033.61
buyer_2,Aitxiber,Beitia,1984-09-05,00436370Z,aitxiber.beitia@hypernet.io,050240,ES09209580768975132020,11113.43,2023-07-20T12:51:40,Gernika,expenses,gifts,-122.82,-35156.43
buyer_2,Aitxiber,Beitia,1984-09-05,00436370Z,aitxiber.beitia@hypernet.io,050240,ES09209580768975132020,11113.43,2023-07-21T12:48:37,Gernika,expenses,transport,-69.23,-35225.66
buyer_2,Aitxiber,Beitia,1984-09-05,00436370Z,aitxiber.beitia@hypernet.io,050240,ES09209580768975132020,11113.43,2023-07-22T15:44:15,Gernika,expenses,cash,-100.0,-35325.66
buyer_2,Aitxiber,Beitia,1984-09-05,00436370Z,aitxiber.beitia@hypernet.io,050240,ES09209580768975132020,11113.43,2023-07-23T14:29:36,Gernika,expenses,gifts,-175.66,-35501.32
buyer_2,Aitxiber,Beitia,1984-09-05,00436370Z,aitxiber.beitia@hypernet.io,050240,ES09209580768975132020,11113.43,2023-07-24T19:12:29,Gernika,expenses,food,-123.53,-35624.85
buyer_2,Aitxiber,Beitia,1984-09-05,00436370Z,aitxiber.beitia@hypernet.io,050240,ES09209580768975132020,11113.43,2023-07-24T18:54:37,Gernika,expenses,healthcare,-185.05,-35809.9
buyer_2,Aitxiber,Beitia,1984-09-05,00436370Z,aitxiber.beitia@hypernet.io,050240,ES09209580768975132020,11113.43,2023-07-26T08:21:26,Gernika,expenses,education,-53.11,-35863.01
buyer_2,Aitxiber,Beitia,1984-09-05,00436370Z,aitxiber.beitia@hypernet.io,050240,ES09209580768975132020,11113.43,2023-07-27T11:42:19,Gernika,expenses,leisure,-54.93,-35917.94
buyer_2,Aitxiber,Beitia,1984-09-05,00436370Z,aitxiber.beitia@hypernet.io,050240,ES09209580768975132020,11113.43,2023-07-30T11:41:10,Gernika,expenses,appliances,-259.27,-36177.21
buyer_2,Aitxiber,Beitia,1984-09-05,00436370Z,aitxiber.beitia@hypernet.io,050240,ES09209580768975132020,11113.43,2023-08-01T09:52:03,Gernika,incomes,salary,2065.05,-34112.16
buyer_2,Aitxiber,Beitia,1984-09-05,00436370Z,aitxiber.beitia@hypernet.io,050240,ES09209580768975132020,11113.43,2023-08-02T13:16:49,Gernika,expenses,healthcare,-117.63,-34229.79
buyer_2,Aitxiber,Beitia,1984-09-05,00436370Z,aitxiber.beitia@hypernet.io,050240,ES09209580768975132020,11113.43,2023-08-04T18:11:13,Gernika,expenses,cash,-100.0,-34329.79
buyer_2,Aitxiber,Beitia,1984-09-05,00436370Z,aitxiber.beitia@hypernet.io,050240,ES09209580768975132020,11113.43,2023-08-05T08:53:26,Gernika,expenses,mortgage,-1115.01,-35444.8
buyer_2,Aitxiber,Beitia,1984-09-05,00436370Z,aitxiber.beitia@hypernet.io,050240,ES09209580768975132020,11113.43,2023-08-05T07:34:17,Gernika,expenses,cash,-100.0,-35544.8
buyer_2,Aitxiber,Beitia,1984-09-05,00436370Z,aitxiber.beitia@hypernet.io,050240,ES09209580768975132020,11113.43,2023-08-06T09:05:37,Gernika,expenses,water,-29.07,-35573.87
buyer_2,Aitxiber,Beitia,1984-09-05,00436370Z,aitxiber.beitia@hypernet.io,050240,ES09209580768975132020,11113.43,2023-08-07T21:37:24,Gernika,expenses,gas,-81.9,-35655.77
buyer_2,Aitxiber,Beitia,1984-09-05,00436370Z,aitxiber.beitia@hypernet.io,050240,ES09209580768975132020,11113.43,2023-08-07T20:08:47,Gernika,expenses,phone,-31.94,-35687.71
buyer_2,Aitxiber,Beitia,1984-09-05,00436370Z,aitxiber.beitia@hypernet.io,050240,ES09209580768975132020,11113.43,2023-08-08T08:14:55,Gernika,expenses,gas,-111.97,-35799.68
buyer_2,Aitxiber,Beitia,1984-09-05,00436370Z,aitxiber.beitia@hypernet.io,050240,ES09209580768975132020,11113.43,2023-08-08T21:31:04,Gernika,expenses,phone,-31.66,-35831.34
buyer_2,Aitxiber,Beitia,1984-09-05,00436370Z,aitxiber.beitia@hypernet.io,050240,ES09209580768975132020,11113.43,2023-08-08T14:30:33,Gernika,expenses,cash,-100.0,-35931.34
buyer_2,Aitxiber,Beitia,1984-09-05,00436370Z,aitxiber.beitia@hypernet.io,050240,ES09209580768975132020,11113.43,2023-08-10T20:19:52,Gernika,expenses,leisure,-77.91,-36009.25
buyer_2,Aitxiber,Beitia,1984-09-05,00436370Z,aitxiber.beitia@hypernet.io,050240,ES09209580768975132020,11113.43,2023-08-10T18:20:29,Gernika,expenses,repairs,-324.53,-36333.78
buyer_2,Aitxiber,Beitia,1984-09-05,00436370Z,aitxiber.beitia@hypernet.io,050240,ES09209580768975132020,11113.43,2023-08-12T13:32:29,Gernika,expenses,clothing,-159.62,-36493.4
buyer_2,Aitxiber,Beitia,1984-09-05,00436370Z,aitxiber.beitia@hypernet.io,050240,ES09209580768975132020,11113.43,2023-08-12T20:13:33,Gernika,expenses,appliances,-138.71,-36632.11
buyer_2,Aitxiber,Beitia,1984-09-05,00436370Z,aitxiber.beitia@hypernet.io,050240,ES09209580768975132020,11113.43,2023-08-14T14:54:27,Gernika,expenses,transport,-85.73,-36717.84
buyer_2,Aitxiber,Beitia,1984-09-05,00436370Z,aitxiber.beitia@hypernet.io,050240,ES09209580768975132020,11113.43,2023-08-17T13:28:13,Gernika,expenses,leisure,-57.45,-36775.29
buyer_2,Aitxiber,Beitia,1984-09-05,00436370Z,aitxiber.beitia@hypernet.io,050240,ES09209580768975132020,11113.43,2023-08-17T15:21:44,Gernika,expenses,clothing,-151.43,-36926.72
buyer_2,Aitxiber,Beitia,1984-09-05,00436370Z,aitxiber.beitia@hypernet.io,050240,ES09209580768975132020,11113.43,2023-08-19T10:31:45,Gernika,expenses,cash,-100.0,-37026.72
buyer_2,Aitxiber,Beitia,1984-09-05,00436370Z,aitxiber.beitia@hypernet.io,050240,ES09209580768975132020,11113.43,2023-08-21T10:25:33,Gernika,expenses,cash,-100.0,-37126.72
buyer_2,Aitxiber,Beitia,1984-09-05,00436370Z,aitxiber.beitia@hypernet.io,050240,ES09209580768975132020,11113.43,2023-08-25T10:08:36,Gernika,expenses,repairs,-282.63,-37409.35
buyer_2,Aitxiber,Beitia,1984-09-05,00436370Z,aitxiber.beitia@hypernet.io,050240,ES09209580768975132020,11113.43,2023-08-26T15:49:29,Gernika,expenses,cash,-100.0,-37509.35
buyer_2,Aitxiber,Beitia,1984-09-05,00436370Z,aitxiber.beitia@hypernet.io,050240,ES09209580768975132020,11113.43,2023-08-27T19:17:56,Gernika,expenses,healthcare,-88.21,-37597.56
buyer_2,Aitxiber,Beitia,1984-09-05,00436370Z,aitxiber.beitia@hypernet.io,050240,ES09209580768975132020,11113.43,2023-08-27T09:56:45,Gernika,expenses,education,-44.44,-37642.0
buyer_2,Aitxiber,Beitia,1984-09-05,00436370Z,aitxiber.beitia@hypernet.io,050240,ES09209580768975132020,11113.43,2023-08-27T14:24:31,Gernika,expenses,children,-259.38,-37901.38
buyer_2,Aitxiber,Beitia,1984-09-05,00436370Z,aitxiber.beitia@hypernet.io,050240,ES09209580768975132020,11113.43,2023-08-28T12:35:44,Gernika,expenses,cash,-100.0,-38001.38
buyer_2,Aitxiber,Beitia,1984-09-05,00436370Z,aitxiber.beitia@hypernet.io,050240,ES09209580768975132020,11113.43,2023-08-28T23:39:52,Gernika,expenses,children,-466.2479166666669,-38467.63
buyer_2,Aitxiber,Beitia,1984-09-05,00436370Z,aitxiber.beitia@hypernet.io,050240,ES09209580768975132020,11113.43,2023-08-29T17:01:34,Gernika,expenses,healthcare,-121.27,-38588.9
buyer_2,Aitxiber,Beitia,1984-09-05,00436370Z,aitxiber.beitia@hypernet.io,050240,ES09209580768975132020,11113.43,2023-08-29T08:08:42,Gernika,expenses,cash,-100.0,-38688.9
buyer_2,Aitxiber,Beitia,1984-09-05,00436370Z,aitxiber.beitia@hypernet.io,050240,ES09209580768975132020,11113.43,2023-08-29T12:00:32,Gernika,expenses,gifts,-314.0,-39002.9
buyer_2,Aitxiber,Beitia,1984-09-05,00436370Z,aitxiber.beitia@hypernet.io,050240,ES09209580768975132020,11113.43,2023-08-31T08:42:13,Gernika,expenses,food,-109.25,-39112.15
buyer_2,Aitxiber,Beitia,1984-09-05,00436370Z,aitxiber.beitia@hypernet.io,050240,ES09209580768975132020,11113.43,2023-09-01T12:48:09,Gernika,incomes,salary,2065.05,-37047.1
buyer_2,Aitxiber,Beitia,1984-09-05,00436370Z,aitxiber.beitia@hypernet.io,050240,ES09209580768975132020,11113.43,2023-09-01T08:29:50,Gernika,expenses,food,-111.47,-37158.57
buyer_2,Aitxiber,Beitia,1984-09-05,00436370Z,aitxiber.beitia@hypernet.io,050240,ES09209580768975132020,11113.43,2023-09-01T08:05:33,Gernika,expenses,education,-70.45,-37229.02
buyer_2,Aitxiber,Beitia,1984-09-05,00436370Z,aitxiber.beitia@hypernet.io,050240,ES09209580768975132020,11113.43,2023-09-02T18:53:15,Gernika,expenses,transport,-63.71,-37292.73
buyer_2,Aitxiber,Beitia,1984-09-05,00436370Z,aitxiber.beitia@hypernet.io,050240,ES09209580768975132020,11113.43,2023-09-02T19:00:19,Gernika,expenses,leisure,-53.84,-37346.57
buyer_2,Aitxiber,Beitia,1984-09-05,00436370Z,aitxiber.beitia@hypernet.io,050240,ES09209580768975132020,11113.43,2023-09-02T17:48:07,Gernika,expenses,travel,-445.37,-37791.94
buyer_2,Aitxiber,Beitia,1984-09-05,00436370Z,aitxiber.beitia@hypernet.io,050240,ES09209580768975132020,11113.43,2023-09-03T19:43:47,Gernika,expenses,transport,-73.87,-37865.81
buyer_2,Aitxiber,Beitia,1984-09-05,00436370Z,aitxiber.beitia@hypernet.io,050240,ES09209580768975132020,11113.43,2023-09-03T12:00:24,Gernika,expenses,education,-57.35,-37923.16
buyer_2,Aitxiber,Beitia,1984-09-05,00436370Z,aitxiber.beitia@hypernet.io,050240,ES09209580768975132020,11113.43,2023-09-04T15:22:10,Gernika,expenses,repairs,-271.45,-38194.61
buyer_2,Aitxiber,Beitia,1984-09-05,00436370Z,aitxiber.beitia@hypernet.io,050240,ES09209580768975132020,11113.43,2023-09-05T19:11:19,Gernika,expenses,mortgage,-1115.01,-39309.62
buyer_2,Aitxiber,Beitia,1984-09-05,00436370Z,aitxiber.beitia@hypernet.io,050240,ES09209580768975132020,11113.43,2023-09-05T08:23:13,Gernika,expenses,water,-29.99,-39339.61
buyer_2,Aitxiber,Beitia,1984-09-05,00436370Z,aitxiber.beitia@hypernet.io,050240,ES09209580768975132020,11113.43,2023-09-05T19:58:37,Gernika,expenses,cash,-100.0,-39439.61
buyer_2,Aitxiber,Beitia,1984-09-05,00436370Z,aitxiber.beitia@hypernet.io,050240,ES09209580768975132020,11113.43,2023-09-06T17:04:06,Gernika,expenses,water,-45.12,-39484.73
buyer_2,Aitxiber,Beitia,1984-09-05,00436370Z,aitxiber.beitia@hypernet.io,050240,ES09209580768975132020,11113.43,2023-09-06T13:03:03,Gernika,expenses,electricity,-25.92,-39510.65
buyer_2,Aitxiber,Beitia,1984-09-05,00436370Z,aitxiber.beitia@hypernet.io,050240,ES09209580768975132020,11113.43,2023-09-06T20:00:13,Gernika,expenses,phone,-39.28,-39549.93
buyer_2,Aitxiber,Beitia,1984-09-05,00436370Z,aitxiber.beitia@hypernet.io,050240,ES09209580768975132020,11113.43,2023-09-07T09:08:26,Gernika,expenses,internet,-43.37,-39593.3
buyer_2,Aitxiber,Beitia,1984-09-05,00436370Z,aitxiber.beitia@hypernet.io,050240,ES09209580768975132020,11113.43,2023-09-07T13:48:57,Gernika,expenses,travel,-365.4,-39958.7
buyer_2,Aitxiber,Beitia,1984-09-05,00436370Z,aitxiber.beitia@hypernet.io,050240,ES09209580768975132020,11113.43,2023-09-08T12:25:56,Gernika,expenses,leisure,-81.49,-40040.19
buyer_2,Aitxiber,Beitia,1984-09-05,00436370Z,aitxiber.beitia@hypernet.io,050240,ES09209580768975132020,11113.43,2023-09-08T17:46:59,Gernika,expenses,cash,-100.0,-40140.19
buyer_2,Aitxiber,Beitia,1984-09-05,00436370Z,aitxiber.beitia@hypernet.io,050240,ES09209580768975132020,11113.43,2023-09-10T10:53:53,Gernika,expenses,cash,-100.0,-40240.19
buyer_2,Aitxiber,Beitia,1984-09-05,00436370Z,aitxiber.beitia@hypernet.io,050240,ES09209580768975132020,11113.43,2023-09-11T20:45:49,Gernika,expenses,leisure,-41.21,-40281.4
buyer_2,Aitxiber,Beitia,1984-09-05,00436370Z,aitxiber.beitia@hypernet.io,050240,ES09209580768975132020,11113.43,2023-09-11T16:08:31,Gernika,expenses,repairs,-185.7,-40467.1
buyer_2,Aitxiber,Beitia,1984-09-05,00436370Z,aitxiber.beitia@hypernet.io,050240,ES09209580768975132020,11113.43,2023-09-12T11:22:00,Gernika,expenses,food,-110.58,-40577.68
buyer_2,Aitxiber,Beitia,1984-09-05,00436370Z,aitxiber.beitia@hypernet.io,050240,ES09209580768975132020,11113.43,2023-09-12T13:35:45,Gernika,expenses,leisure,-41.93,-40619.61
buyer_2,Aitxiber,Beitia,1984-09-05,00436370Z,aitxiber.beitia@hypernet.io,050240,ES09209580768975132020,11113.43,2023-09-12T20:59:09,Gernika,expenses,repairs,-292.76,-40912.37
buyer_2,Aitxiber,Beitia,1984-09-05,00436370Z,aitxiber.beitia@hypernet.io,050240,ES09209580768975132020,11113.43,2023-09-20T11:29:17,Gernika,expenses,healthcare,-72.65,-40985.02
buyer_2,Aitxiber,Beitia,1984-09-05,00436370Z,aitxiber.beitia@hypernet.io,050240,ES09209580768975132020,11113.43,2023-09-21T20:36:26,Gernika,expenses,appliances,-218.91,-41203.93
buyer_2,Aitxiber,Beitia,1984-09-05,00436370Z,aitxiber.beitia@hypernet.io,050240,ES09209580768975132020,11113.43,2023-09-22T09:25:22,Gernika,expenses,leisure,-23.84,-41227.77
buyer_2,Aitxiber,Beitia,1984-09-05,00436370Z,aitxiber.beitia@hypernet.io,050240,ES09209580768975132020,11113.43,2023-09-22T09:06:39,Gernika,expenses,healthcare,-122.03,-41349.8
buyer_2,Aitxiber,Beitia,1984-09-05,00436370Z,aitxiber.beitia@hypernet.io,050240,ES09209580768975132020,11113.43,2023-09-23T12:04:21,Gernika,expenses,transport,-52.41,-41402.21
buyer_2,Aitxiber,Beitia,1984-09-05,00436370Z,aitxiber.beitia@hypernet.io,050240,ES09209580768975132020,11113.43,2023-09-24T09:20:32,Gernika,expenses,transport,-40.35,-41442.56
buyer_2,Aitxiber,Beitia,1984-09-05,00436370Z,aitxiber.beitia@hypernet.io,050240,ES09209580768975132020,11113.43,2023-09-24T11:25:26,Gernika,expenses,repairs,-132.99,-41575.55
buyer_2,Aitxiber,Beitia,1984-09-05,00436370Z,aitxiber.beitia@hypernet.io,050240,ES09209580768975132020,11113.43,2023-09-24T03:13:51,Gernika,expenses,gifts,-331.91,-41907.46
buyer_2,Aitxiber,Beitia,1984-09-05,00436370Z,aitxiber.beitia@hypernet.io,050240,ES09209580768975132020,11113.43,2023-09-24T09:18:34,Gernika,expenses,children,-60.997916666666924,-41968.46
buyer_2,Aitxiber,Beitia,1984-09-05,00436370Z,aitxiber.beitia@hypernet.io,050240,ES09209580768975132020,11113.43,2023-09-26T18:14:36,Gernika,expenses,appliances,-342.1,-42310.56
buyer_2,Aitxiber,Beitia,1984-09-05,00436370Z,aitxiber.beitia@hypernet.io,050240,ES09209580768975132020,11113.43,2023-09-26T12:21:09,Gernika,expenses,repairs,-141.63,-42452.19
buyer_2,Aitxiber,Beitia,1984-09-05,00436370Z,aitxiber.beitia@hypernet.io,050240,ES09209580768975132020,11113.43,2023-09-27T11:58:34,Gernika,expenses,cash,-100.0,-42552.19
buyer_2,Aitxiber,Beitia,1984-09-05,00436370Z,aitxiber.beitia@hypernet.io,050240,ES09209580768975132020,11113.43,2023-10-01T09:51:22,Gernika,incomes,salary,2065.05,-40487.14
buyer_2,Aitxiber,Beitia,1984-09-05,00436370Z,aitxiber.beitia@hypernet.io,050240,ES09209580768975132020,11113.43,2023-10-01T09:51:22,Gernika,incomes,extra_income,263.98,-40223.16
buyer_2,Aitxiber,Beitia,1984-09-05,00436370Z,aitxiber.beitia@hypernet.io,050240,ES09209580768975132020,11113.43,2023-10-01T09:50:37,Gernika,expenses,cash,-100.0,-40323.16
buyer_2,Aitxiber,Beitia,1984-09-05,00436370Z,aitxiber.beitia@hypernet.io,050240,ES09209580768975132020,11113.43,2023-10-03T15:15:55,Gernika,expenses,cash,-100.0,-40423.16
buyer_2,Aitxiber,Beitia,1984-09-05,00436370Z,aitxiber.beitia@hypernet.io,050240,ES09209580768975132020,11113.43,2023-10-04T19:22:23,Gernika,expenses,transport,-69.64,-40492.8
buyer_2,Aitxiber,Beitia,1984-09-05,00436370Z,aitxiber.beitia@hypernet.io,050240,ES09209580768975132020,11113.43,2023-10-04T17:32:27,Gernika,expenses,cash,-100.0,-40592.8
buyer_2,Aitxiber,Beitia,1984-09-05,00436370Z,aitxiber.beitia@hypernet.io,050240,ES09209580768975132020,11113.43,2023-10-05T17:03:14,Gernika,expenses,mortgage,-1115.01,-41707.81
buyer_2,Aitxiber,Beitia,1984-09-05,00436370Z,aitxiber.beitia@hypernet.io,050240,ES09209580768975132020,11113.43,2023-10-05T08:48:09,Gernika,expenses,water,-32.82,-41740.63
buyer_2,Aitxiber,Beitia,1984-09-05,00436370Z,aitxiber.beitia@hypernet.io,050240,ES09209580768975132020,11113.43,2023-10-05T21:51:37,Gernika,expenses,internet,-43.37,-41784.0
buyer_2,Aitxiber,Beitia,1984-09-05,00436370Z,aitxiber.beitia@hypernet.io,050240,ES09209580768975132020,11113.43,2023-10-05T08:27:21,Gernika,expenses,phone,-31.21,-41815.21
buyer_2,Aitxiber,Beitia,1984-09-05,00436370Z,aitxiber.beitia@hypernet.io,050240,ES09209580768975132020,11113.43,2023-10-06T17:21:08,Gernika,expenses,phone,-31.44,-41846.65
buyer_2,Aitxiber,Beitia,1984-09-05,00436370Z,aitxiber.beitia@hypernet.io,050240,ES09209580768975132020,11113.43,2023-10-06T16:42:38,Gernika,expenses,gifts,-343.61,-42190.26
buyer_2,Aitxiber,Beitia,1984-09-05,00436370Z,aitxiber.beitia@hypernet.io,050240,ES09209580768975132020,11113.43,2023-10-07T16:48:41,Gernika,expenses,electricity,-44.6,-42234.86
buyer_2,Aitxiber,Beitia,1984-09-05,00436370Z,aitxiber.beitia@hypernet.io,050240,ES09209580768975132020,11113.43,2023-10-07T20:06:18,Gernika,expenses,gas,-88.48,-42323.34
buyer_2,Aitxiber,Beitia,1984-09-05,00436370Z,aitxiber.beitia@hypernet.io,050240,ES09209580768975132020,11113.43,2023-10-08T19:19:47,Gernika,expenses,phone,-44.16,-42367.5
buyer_2,Aitxiber,Beitia,1984-09-05,00436370Z,aitxiber.beitia@hypernet.io,050240,ES09209580768975132020,11113.43,2023-10-08T19:23:31,Gernika,expenses,cash,-100.0,-42467.5
buyer_2,Aitxiber,Beitia,1984-09-05,00436370Z,aitxiber.beitia@hypernet.io,050240,ES09209580768975132020,11113.43,2023-10-11T10:45:57,Gernika,expenses,leisure,-68.02,-42535.52
buyer_2,Aitxiber,Beitia,1984-09-05,00436370Z,aitxiber.beitia@hypernet.io,050240,ES09209580768975132020,11113.43,2023-10-11T09:47:07,Gernika,expenses,cash,-100.0,-42635.52
buyer_2,Aitxiber,Beitia,1984-09-05,00436370Z,aitxiber.beitia@hypernet.io,050240,ES09209580768975132020,11113.43,2023-10-12T10:11:41,Gernika,expenses,transport,-60.38,-42695.9
buyer_2,Aitxiber,Beitia,1984-09-05,00436370Z,aitxiber.beitia@hypernet.io,050240,ES09209580768975132020,11113.43,2023-10-12T19:45:49,Gernika,expenses,repairs,-185.7,-42881.6
buyer_2,Aitxiber,Beitia,1984-09-05,00436370Z,aitxiber.beitia@hypernet.io,050240,ES09209580768975132020,11113.43,2023-10-12T17:40:32,Gernika,expenses,gifts,-156.74,-43038.34
buyer_2,Aitxiber,Beitia,1984-09-05,00436370Z,aitxiber.beitia@hypernet.io,050240,ES09209580768975132020,11113.43,2023-10-13T15:44:16,Gernika,expenses,transport,-83.66,-43122.0
buyer_2,Aitxiber,Beitia,1984-09-05,00436370Z,aitxiber.beitia@hypernet.io,050240,ES09209580768975132020,11113.43,2023-10-13T08:12:31,Gernika,expenses,cash,-100.0,-43222.0
buyer_2,Aitxiber,Beitia,1984-09-05,00436370Z,aitxiber.beitia@hypernet.io,050240,ES09209580768975132020,11113.43,2023-10-14T13:52:42,Gernika,expenses,transport,-55.83,-43277.83
buyer_2,Aitxiber,Beitia,1984-09-05,00436370Z,aitxiber.beitia@hypernet.io,050240,ES09209580768975132020,11113.43,2023-10-15T13:52:10,Gernika,expenses,appliances,-276.25,-43554.08
buyer_2,Aitxiber,Beitia,1984-09-05,00436370Z,aitxiber.beitia@hypernet.io,050240,ES09209580768975132020,11113.43,2023-10-17T11:06:04,Gernika,expenses,transport,-59.91,-43613.99
buyer_2,Aitxiber,Beitia,1984-09-05,00436370Z,aitxiber.beitia@hypernet.io,050240,ES09209580768975132020,11113.43,2023-10-18T09:39:29,Gernika,expenses,leisure,-41.68,-43655.67
buyer_2,Aitxiber,Beitia,1984-09-05,00436370Z,aitxiber.beitia@hypernet.io,050240,ES09209580768975132020,11113.43,2023-10-18T19:40:23,Gernika,expenses,gifts,-292.54,-43948.21
buyer_2,Aitxiber,Beitia,1984-09-05,00436370Z,aitxiber.beitia@hypernet.io,050240,ES09209580768975132020,11113.43,2023-10-19T10:51:46,Gernika,expenses,cash,-100.0,-44048.21
buyer_2,Aitxiber,Beitia,1984-09-05,00436370Z,aitxiber.beitia@hypernet.io,050240,ES09209580768975132020,11113.43,2023-10-20T20:39:06,Gernika,expenses,children,-366.21,-44414.42
buyer_2,Aitxiber,Beitia,1984-09-05,00436370Z,aitxiber.beitia@hypernet.io,050240,ES09209580768975132020,11113.43,2023-10-21T18:54:43,Gernika,expenses,food,-63.41,-44477.83
buyer_2,Aitxiber,Beitia,1984-09-05,00436370Z,aitxiber.beitia@hypernet.io,050240,ES09209580768975132020,11113.43,2023-10-22T10:40:39,Gernika,expenses,gifts,-70.06,-44547.89
buyer_2,Aitxiber,Beitia,1984-09-05,00436370Z,aitxiber.beitia@hypernet.io,050240,ES09209580768975132020,11113.43,2023-10-23T18:37:54,Gernika,expenses,gifts,-374.17,-44922.06
buyer_2,Aitxiber,Beitia,1984-09-05,00436370Z,aitxiber.beitia@hypernet.io,050240,ES09209580768975132020,11113.43,2023-10-25T11:27:52,Gernika,expenses,transport,-89.37,-45011.43
buyer_2,Aitxiber,Beitia,1984-09-05,00436370Z,aitxiber.beitia@hypernet.io,050240,ES09209580768975132020,11113.43,2023-10-26T14:21:07,Gernika,expenses,repairs,-140.29,-45151.72
buyer_2,Aitxiber,Beitia,1984-09-05,00436370Z,aitxiber.beitia@hypernet.io,050240,ES09209580768975132020,11113.43,2023-10-28T11:28:38,Gernika,expenses,cash,-100.0,-45251.72
buyer_2,Aitxiber,Beitia,1984-09-05,00436370Z,aitxiber.beitia@hypernet.io,050240,ES09209580768975132020,11113.43,2023-10-29T13:36:24,Gernika,expenses,food,-79.89,-45331.61
buyer_2,Aitxiber,Beitia,1984-09-05,00436370Z,aitxiber.beitia@hypernet.io,050240,ES09209580768975132020,11113.43,2023-10-30T00:15:29,Gernika,expenses,leisure,-31.68,-45363.29
buyer_2,Aitxiber,Beitia,1984-09-05,00436370Z,aitxiber.beitia@hypernet.io,050240,ES09209580768975132020,11113.43,2023-11-01T23:31:19,Gernika,incomes,salary,2065.05,-43298.24
buyer_2,Aitxiber,Beitia,1984-09-05,00436370Z,aitxiber.beitia@hypernet.io,050240,ES09209580768975132020,11113.43,2023-11-02T12:47:51,Gernika,expenses,food,-83.21,-43381.45
buyer_2,Aitxiber,Beitia,1984-09-05,00436370Z,aitxiber.beitia@hypernet.io,050240,ES09209580768975132020,11113.43,2023-11-05T14:45:07,Gernika,expenses,mortgage,-1115.01,-44496.46
buyer_2,Aitxiber,Beitia,1984-09-05,00436370Z,aitxiber.beitia@hypernet.io,050240,ES09209580768975132020,11113.43,2023-11-05T13:34:02,Gernika,expenses,cash,-100.0,-44596.46
buyer_2,Aitxiber,Beitia,1984-09-05,00436370Z,aitxiber.beitia@hypernet.io,050240,ES09209580768975132020,11113.43,2023-11-06T12:10:51,Gernika,expenses,internet,-43.37,-44639.83
buyer_2,Aitxiber,Beitia,1984-09-05,00436370Z,aitxiber.beitia@hypernet.io,050240,ES09209580768975132020,11113.43,2023-11-07T10:12:19,Gernika,expenses,cash,-100.0,-44739.83
buyer_2,Aitxiber,Beitia,1984-09-05,00436370Z,aitxiber.beitia@hypernet.io,050240,ES09209580768975132020,11113.43,2023-11-08T18:00:22,Gernika,expenses,internet,-43.37,-44783.2
buyer_2,Aitxiber,Beitia,1984-09-05,00436370Z,aitxiber.beitia@hypernet.io,050240,ES09209580768975132020,11113.43,2023-11-09T17:01:15,Gernika,expenses,food,-111.0,-44894.2
buyer_2,Aitxiber,Beitia,1984-09-05,00436370Z,aitxiber.beitia@hypernet.io,050240,ES09209580768975132020,11113.43,2023-11-13T10:58:29,Gernika,expenses,repairs,-44.88,-44939.08
buyer_2,Aitxiber,Beitia,1984-09-05,00436370Z,aitxiber.beitia@hypernet.io,050240,ES09209580768975132020,11113.43,2023-11-15T15:00:54,Gernika,expenses,food,-110.76,-45049.84
buyer_2,Aitxiber,Beitia,1984-09-05,00436370Z,aitxiber.beitia@hypernet.io,050240,ES09209580768975132020,11113.43,2023-11-17T21:48:39,Gernika,expenses,transport,-77.27,-45127.11
buyer_2,Aitxiber,Beitia,1984-09-05,00436370Z,aitxiber.beitia@hypernet.io,050240,ES09209580768975132020,11113.43,2023-11-17T13:47:07,Gernika,expenses,leisure,-35.5,-45162.61
buyer_2,Aitxiber,Beitia,1984-09-05,00436370Z,aitxiber.beitia@hypernet.io,050240,ES09209580768975132020,11113.43,2023-11-19T18:24:33,Gernika,expenses,cash,-100.0,-45262.61
buyer_2,Aitxiber,Beitia,1984-09-05,00436370Z,aitxiber.beitia@hypernet.io,050240,ES09209580768975132020,11113.43,2023-11-20T17:40:29,Gernika,expenses,food,-99.8,-45362.41
buyer_2,Aitxiber,Beitia,1984-09-05,00436370Z,aitxiber.beitia@hypernet.io,050240,ES09209580768975132020,11113.43,2023-11-25T17:39:56,Gernika,expenses,food,-117.33,-45479.74
buyer_2,Aitxiber,Beitia,1984-09-05,00436370Z,aitxiber.beitia@hypernet.io,050240,ES09209580768975132020,11113.43,2023-11-28T17:39:13,Gernika,expenses,clothing,-77.0,-45556.74
buyer_2,Aitxiber,Beitia,1984-09-05,00436370Z,aitxiber.beitia@hypernet.io,050240,ES09209580768975132020,11113.43,2023-11-28T10:29:35,Gernika,expenses,healthcare,-72.14,-45628.88
buyer_2,Aitxiber,Beitia,1984-09-05,00436370Z,aitxiber.beitia@hypernet.io,050240,ES09209580768975132020,11113.43,2023-11-29T14:06:22,Gernika,expenses,transport,-56.01,-45684.89
buyer_2,Aitxiber,Beitia,1984-09-05,00436370Z,aitxiber.beitia@hypernet.io,050240,ES09209580768975132020,11113.43,2023-11-29T16:33:00,Gernika,expenses,cash,-100.0,-45784.89
buyer_2,Aitxiber,Beitia,1984-09-05,00436370Z,aitxiber.beitia@hypernet.io,050240,ES09209580768975132020,11113.43,2023-11-29T11:08:19,Gernika,expenses,gifts,-132.71,-45917.6
buyer_2,Aitxiber,Beitia,1984-09-05,00436370Z,aitxiber.beitia@hypernet.io,050240,ES09209580768975132020,11113.43,2023-11-30T22:03:59,Gernika,expenses,transport,-79.39,-45996.99
buyer_2,Aitxiber,Beitia,1984-09-05,00436370Z,aitxiber.beitia@hypernet.io,050240,ES09209580768975132020,11113.43,2023-12-01T14:01:08,Gernika,incomes,salary,2065.05,-43931.94
buyer_2,Aitxiber,Beitia,1984-09-05,00436370Z,aitxiber.beitia@hypernet.io,050240,ES09209580768975132020,11113.43,2023-12-01T14:01:08,Gernika,incomes,salary_bonus,1575.32,-42356.62
buyer_2,Aitxiber,Beitia,1984-09-05,00436370Z,aitxiber.beitia@hypernet.io,050240,ES09209580768975132020,11113.43,2023-12-03T19:22:48,Gernika,expenses,leisure,-46.26,-42402.88
buyer_2,Aitxiber,Beitia,1984-09-05,00436370Z,aitxiber.beitia@hypernet.io,050240,ES09209580768975132020,11113.43,2023-12-04T08:50:49,Gernika,expenses,leisure,-45.86,-42448.74
buyer_2,Aitxiber,Beitia,1984-09-05,00436370Z,aitxiber.beitia@hypernet.io,050240,ES09209580768975132020,11113.43,2023-12-05T08:06:52,Gernika,expenses,mortgage,-1115.01,-43563.75
buyer_2,Aitxiber,Beitia,1984-09-05,00436370Z,aitxiber.beitia@hypernet.io,050240,ES09209580768975132020,11113.43,2023-12-05T17:02:14,Gernika,expenses,cash,-100.0,-43663.75
buyer_2,Aitxiber,Beitia,1984-09-05,00436370Z,aitxiber.beitia@hypernet.io,050240,ES09209580768975132020,11113.43,2023-12-07T13:31:57,Gernika,expenses,water,-43.67,-43707.42
buyer_2,Aitxiber,Beitia,1984-09-05,00436370Z,aitxiber.beitia@hypernet.io,050240,ES09209580768975132020,11113.43,2023-12-07T05:49:19,Gernika,expenses,internet,-43.37,-43750.79
buyer_2,Aitxiber,Beitia,1984-09-05,00436370Z,aitxiber.beitia@hypernet.io,050240,ES09209580768975132020,11113.43,2023-12-09T12:35:55,Gernika,expenses,leisure,-40.68,-43791.47
buyer_2,Aitxiber,Beitia,1984-09-05,00436370Z,aitxiber.beitia@hypernet.io,050240,ES09209580768975132020,11113.43,2023-12-14T08:10:15,Gernika,expenses,leisure,-40.21,-43831.68
buyer_2,Aitxiber,Beitia,1984-09-05,00436370Z,aitxiber.beitia@hypernet.io,050240,ES09209580768975132020,11113.43,2023-12-14T12:39:26,Gernika,expenses,cash,-100.0,-43931.68
buyer_2,Aitxiber,Beitia,1984-09-05,00436370Z,aitxiber.beitia@hypernet.io,050240,ES09209580768975132020,11113.43,2023-12-15T18:39:40,Gernika,expenses,food,-99.67,-44031.35
buyer_2,Aitxiber,Beitia,1984-09-05,00436370Z,aitxiber.beitia@hypernet.io,050240,ES09209580768975132020,11113.43,2023-12-17T14:14:34,Gernika,expenses,food,-117.7,-44149.05
buyer_2,Aitxiber,Beitia,1984-09-05,00436370Z,aitxiber.beitia@hypernet.io,050240,ES09209580768975132020,11113.43,2023-12-17T12:58:16,Gernika,expenses,gifts,-43.14,-44192.19
buyer_2,Aitxiber,Beitia,1984-09-05,00436370Z,aitxiber.beitia@hypernet.io,050240,ES09209580768975132020,11113.43,2023-12-18T05:50:55,Gernika,expenses,leisure,-62.94,-44255.13
buyer_2,Aitxiber,Beitia,1984-09-05,00436370Z,aitxiber.beitia@hypernet.io,050240,ES09209580768975132020,11113.43,2023-12-18T12:58:00,Gernika,expenses,repairs,-320.15,-44575.28
buyer_2,Aitxiber,Beitia,1984-09-05,00436370Z,aitxiber.beitia@hypernet.io,050240,ES09209580768975132020,11113.43,2023-12-19T13:31:05,Gernika,expenses,food,-61.99,-44637.27
buyer_2,Aitxiber,Beitia,1984-09-05,00436370Z,aitxiber.beitia@hypernet.io,050240,ES09209580768975132020,11113.43,2023-12-19T17:42:40,Gernika,expenses,leisure,-40.26,-44677.53
buyer_2,Aitxiber,Beitia,1984-09-05,00436370Z,aitxiber.beitia@hypernet.io,050240,ES09209580768975132020,11113.43,2023-12-20T21:09:33,Gernika,expenses,food,-74.81,-44752.34
buyer_2,Aitxiber,Beitia,1984-09-05,00436370Z,aitxiber.beitia@hypernet.io,050240,ES09209580768975132020,11113.43,2023-12-20T16:09:57,Gernika,expenses,cash,-100.0,-44852.34
buyer_2,Aitxiber,Beitia,1984-09-05,00436370Z,aitxiber.beitia@hypernet.io,050240,ES09209580768975132020,11113.43,2023-12-20T19:41:19,Gernika,expenses,travel,-327.39,-45179.73
buyer_2,Aitxiber,Beitia,1984-09-05,00436370Z,aitxiber.beitia@hypernet.io,050240,ES09209580768975132020,11113.43,2023-12-21T03:07:28,Gernika,expenses,food,-111.14,-45290.87
buyer_2,Aitxiber,Beitia,1984-09-05,00436370Z,aitxiber.beitia@hypernet.io,050240,ES09209580768975132020,11113.43,2023-12-23T12:15:56,Gernika,expenses,leisure,-79.26,-45370.13
buyer_2,Aitxiber,Beitia,1984-09-05,00436370Z,aitxiber.beitia@hypernet.io,050240,ES09209580768975132020,11113.43,2023-12-25T14:06:39,Gernika,expenses,transport,-41.61,-45411.74
buyer_2,Aitxiber,Beitia,1984-09-05,00436370Z,aitxiber.beitia@hypernet.io,050240,ES09209580768975132020,11113.43,2023-12-26T16:29:24,Gernika,expenses,travel,-457.74,-45869.48
buyer_2,Aitxiber,Beitia,1984-09-05,00436370Z,aitxiber.beitia@hypernet.io,050240,ES09209580768975132020,11113.43,2023-12-28T16:35:00,Gernika,expenses,food,-67.0,-45936.48
buyer_2,Aitxiber,Beitia,1984-09-05,00436370Z,aitxiber.beitia@hypernet.io,050240,ES09209580768975132020,11113.43,2023-12-29T14:41:51,Gernika,expenses,repairs,-158.8,-46095.28
buyer_2,Aitxiber,Beitia,1984-09-05,00436370Z,aitxiber.beitia@hypernet.io,050240,ES09209580768975132020,11113.43,2023-12-31T08:25:54,Gernika,expenses,children,-566.2479166666669,-46661.53
buyer_2,Aitxiber,Beitia,1984-09-05,00436370Z,aitxiber.beitia@hypernet.io,050240,ES09209580768975132020,11113.43,2024-01-01T12:55:18,Gernika,incomes,salary,2139.97,-44521.56
buyer_2,Aitxiber,Beitia,1984-09-05,00436370Z,aitxiber.beitia@hypernet.io,050240,ES09209580768975132020,11113.43,2024-01-01T12:55:18,Gernika,incomes,extra_income,263.98,-44257.58
buyer_2,Aitxiber,Beitia,1984-09-05,00436370Z,aitxiber.beitia@hypernet.io,050240,ES09209580768975132020,11113.43,2024-01-05T13:39:19,Gernika,expenses,mortgage,-865.42,-45123.0
buyer_2,Aitxiber,Beitia,1984-09-05,00436370Z,aitxiber.beitia@hypernet.io,050240,ES09209580768975132020,11113.43,2024-01-05T20:21:37,Gernika,expenses,children,-236.73,-45359.73
buyer_2,Aitxiber,Beitia,1984-09-05,00436370Z,aitxiber.beitia@hypernet.io,050240,ES09209580768975132020,11113.43,2024-01-06T12:31:03,Gernika,expenses,electricity,-84.93,-45444.66
buyer_2,Aitxiber,Beitia,1984-09-05,00436370Z,aitxiber.beitia@hypernet.io,050240,ES09209580768975132020,11113.43,2024-01-06T07:09:05,Gernika,expenses,gas,-72.48,-45517.14
buyer_2,Aitxiber,Beitia,1984-09-05,00436370Z,aitxiber.beitia@hypernet.io,050240,ES09209580768975132020,11113.43,2024-01-06T06:29:06,Gernika,expenses,phone,-38.28,-45555.42
buyer_2,Aitxiber,Beitia,1984-09-05,00436370Z,aitxiber.beitia@hypernet.io,050240,ES09209580768975132020,11113.43,2024-01-06T08:12:11,Gernika,expenses,cash,-100.0,-45655.42
buyer_2,Aitxiber,Beitia,1984-09-05,00436370Z,aitxiber.beitia@hypernet.io,050240,ES09209580768975132020,11113.43,2024-01-07T22:25:25,Gernika,expenses,water,-44.65,-45700.07
buyer_2,Aitxiber,Beitia,1984-09-05,00436370Z,aitxiber.beitia@hypernet.io,050240,ES09209580768975132020,11113.43,2024-01-07T08:57:28,Gernika,expenses,electricity,-50.99,-45751.06
buyer_2,Aitxiber,Beitia,1984-09-05,00436370Z,aitxiber.beitia@hypernet.io,050240,ES09209580768975132020,11113.43,2024-01-07T14:41:13,Gernika,expenses,food,-85.57,-45836.63
buyer_2,Aitxiber,Beitia,1984-09-05,00436370Z,aitxiber.beitia@hypernet.io,050240,ES09209580768975132020,11113.43,2024-01-07T10:32:06,Gernika,expenses,education,-43.65,-45880.28
buyer_2,Aitxiber,Beitia,1984-09-05,00436370Z,aitxiber.beitia@hypernet.io,050240,ES09209580768975132020,11113.43,2024-01-08T08:15:48,Gernika,expenses,water,-45.28,-45925.56
buyer_2,Aitxiber,Beitia,1984-09-05,00436370Z,aitxiber.beitia@hypernet.io,050240,ES09209580768975132020,11113.43,2024-01-08T17:08:12,Gernika,expenses,gas,-119.0,-46044.56
buyer_2,Aitxiber,Beitia,1984-09-05,00436370Z,aitxiber.beitia@hypernet.io,050240,ES09209580768975132020,11113.43,2024-01-08T11:10:37,Gernika,expenses,gifts,-689.54,-46734.1
buyer_2,Aitxiber,Beitia,1984-09-05,00436370Z,aitxiber.beitia@hypernet.io,050240,ES09209580768975132020,11113.43,2024-01-10T11:51:28,Gernika,expenses,transport,-50.9,-46785.0
buyer_2,Aitxiber,Beitia,1984-09-05,00436370Z,aitxiber.beitia@hypernet.io,050240,ES09209580768975132020,11113.43,2024-01-10T11:06:39,Gernika,expenses,leisure,-83.14,-46868.14
buyer_2,Aitxiber,Beitia,1984-09-05,00436370Z,aitxiber.beitia@hypernet.io,050240,ES09209580768975132020,11113.43,2024-01-10T16:07:24,Gernika,expenses,clothing,-144.13,-47012.27
buyer_2,Aitxiber,Beitia,1984-09-05,00436370Z,aitxiber.beitia@hypernet.io,050240,ES09209580768975132020,11113.43,2024-01-11T19:22:50,Gernika,expenses,transport,-53.58,-47065.85
buyer_2,Aitxiber,Beitia,1984-09-05,00436370Z,aitxiber.beitia@hypernet.io,050240,ES09209580768975132020,11113.43,2024-01-13T13:10:48,Gernika,expenses,cash,-100.0,-47165.85
buyer_2,Aitxiber,Beitia,1984-09-05,00436370Z,aitxiber.beitia@hypernet.io,050240,ES09209580768975132020,11113.43,2024-01-14T04:02:27,Gernika,expenses,cash,-100.0,-47265.85
buyer_2,Aitxiber,Beitia,1984-09-05,00436370Z,aitxiber.beitia@hypernet.io,050240,ES09209580768975132020,11113.43,2024-01-16T10:47:53,Gernika,expenses,leisure,-39.09,-47304.94
buyer_2,Aitxiber,Beitia,1984-09-05,00436370Z,aitxiber.beitia@hypernet.io,050240,ES09209580768975132020,11113.43,2024-01-17T11:15:05,Gernika,expenses,transport,-54.99,-47359.93
buyer_2,Aitxiber,Beitia,1984-09-05,00436370Z,aitxiber.beitia@hypernet.io,050240,ES09209580768975132020,11113.43,2024-01-21T19:27:24,Gernika,expenses,travel,-509.48,-47869.41
buyer_2,Aitxiber,Beitia,1984-09-05,00436370Z,aitxiber.beitia@hypernet.io,050240,ES09209580768975132020,11113.43,2024-01-21T15:15:39,Gernika,expenses,appliances,-192.42,-48061.83
buyer_2,Aitxiber,Beitia,1984-09-05,00436370Z,aitxiber.beitia@hypernet.io,050240,ES09209580768975132020,11113.43,2024-01-25T12:08:28,Gernika,expenses,leisure,-36.04,-48097.87
buyer_2,Aitxiber,Beitia,1984-09-05,00436370Z,aitxiber.beitia@hypernet.io,050240,ES09209580768975132020,11113.43,2024-01-25T16:49:46,Gernika,expenses,gifts,-641.39,-48739.26
buyer_2,Aitxiber,Beitia,1984-09-05,00436370Z,aitxiber.beitia@hypernet.io,050240,ES09209580768975132020,11113.43,2024-01-26T09:46:37,Gernika,expenses,gifts,-649.6,-49388.86
buyer_2,Aitxiber,Beitia,1984-09-05,00436370Z,aitxiber.beitia@hypernet.io,050240,ES09209580768975132020,11113.43,2024-01-28T16:50:16,Gernika,expenses,transport,-45.89,-49434.75
buyer_2,Aitxiber,Beitia,1984-09-05,00436370Z,aitxiber.beitia@hypernet.io,050240,ES09209580768975132020,11113.43,2024-01-28T20:30:40,Gernika,expenses,leisure,-28.33,-49463.08
buyer_2,Aitxiber,Beitia,1984-09-05,00436370Z,aitxiber.beitia@hypernet.io,050240,ES09209580768975132020,11113.43,2024-01-29T15:27:37,Gernika,expenses,food,-122.57,-49585.65
buyer_2,Aitxiber,Beitia,1984-09-05,00436370Z,aitxiber.beitia@hypernet.io,050240,ES09209580768975132020,11113.43,2024-01-30T12:21:15,Gernika,expenses,clothing,-126.54,-49712.19
buyer_2,Aitxiber,Beitia,1984-09-05,00436370Z,aitxiber.beitia@hypernet.io,050240,ES09209580768975132020,11113.43,2024-02-01T15:26:03,Gernika,incomes,salary,2139.97,-47572.22
buyer_2,Aitxiber,Beitia,1984-09-05,00436370Z,aitxiber.beitia@hypernet.io,050240,ES09209580768975132020,11113.43,2024-02-01T08:21:04,Gernika,expenses,transport,-62.5,-47634.72
buyer_2,Aitxiber,Beitia,1984-09-05,00436370Z,aitxiber.beitia@hypernet.io,050240,ES09209580768975132020,11113.43,2024-02-01T14:42:47,Gernika,expenses,education,-71.18,-47705.9
buyer_2,Aitxiber,Beitia,1984-09-05,00436370Z,aitxiber.beitia@hypernet.io,050240,ES09209580768975132020,11113.43,2024-02-02T14:28:02,Gernika,expenses,food,-94.41,-47800.31
buyer_2,Aitxiber,Beitia,1984-09-05,00436370Z,aitxiber.beitia@hypernet.io,050240,ES09209580768975132020,11113.43,2024-02-03T10:06:55,Gernika,expenses,food,-63.15,-47863.46
buyer_2,Aitxiber,Beitia,1984-09-05,00436370Z,aitxiber.beitia@hypernet.io,050240,ES09209580768975132020,11113.43,2024-02-03T08:17:04,Gernika,expenses,education,-52.45,-47915.91
buyer_2,Aitxiber,Beitia,1984-09-05,00436370Z,aitxiber.beitia@hypernet.io,050240,ES09209580768975132020,11113.43,2024-02-04T13:54:10,Gernika,expenses,leisure,-34.12,-47950.03
buyer_2,Aitxiber,Beitia,1984-09-05,00436370Z,aitxiber.beitia@hypernet.io,050240,ES09209580768975132020,11113.43,2024-02-05T09:44:10,Gernika,expenses,mortgage,-865.42,-48815.45
buyer_2,Aitxiber,Beitia,1984-09-05,00436370Z,aitxiber.beitia@hypernet.io,050240,ES09209580768975132020,11113.43,2024-02-05T13:06:51,Gernika,expenses,gas,-55.58,-48871.03
buyer_2,Aitxiber,Beitia,1984-09-05,00436370Z,aitxiber.beitia@hypernet.io,050240,ES09209580768975132020,11113.43,2024-02-05T23:16:20,Gernika,expenses,food,-105.0,-48976.03
buyer_2,Aitxiber,Beitia,1984-09-05,00436370Z,aitxiber.beitia@hypernet.io,050240,ES09209580768975132020,11113.43,2024-02-06T20:25:56,Gernika,expenses,phone,-37.7,-49013.73
buyer_2,Aitxiber,Beitia,1984-09-05,00436370Z,aitxiber.beitia@hypernet.io,050240,ES09209580768975132020,11113.43,2024-02-06T12:51:53,Gernika,expenses,food,-72.73,-49086.46
buyer_2,Aitxiber,Beitia,1984-09-05,00436370Z,aitxiber.beitia@hypernet.io,050240,ES09209580768975132020,11113.43,2024-02-08T21:32:56,Gernika,expenses,phone,-46.54,-49133.0
buyer_2,Aitxiber,Beitia,1984-09-05,00436370Z,aitxiber.beitia@hypernet.io,050240,ES09209580768975132020,11113.43,2024-02-10T20:22:23,Gernika,expenses,leisure,-54.6,-49187.6
buyer_2,Aitxiber,Beitia,1984-09-05,00436370Z,aitxiber.beitia@hypernet.io,050240,ES09209580768975132020,11113.43,2024-02-10T15:01:02,Gernika,expenses,repairs,-129.25,-49316.85
buyer_2,Aitxiber,Beitia,1984-09-05,00436370Z,aitxiber.beitia@hypernet.io,050240,ES09209580768975132020,11113.43,2024-02-11T11:46:47,Gernika,expenses,food,-61.8,-49378.65
buyer_2,Aitxiber,Beitia,1984-09-05,00436370Z,aitxiber.beitia@hypernet.io,050240,ES09209580768975132020,11113.43,2024-02-13T09:19:34,Gernika,expenses,transport,-87.46,-49466.11
buyer_2,Aitxiber,Beitia,1984-09-05,00436370Z,aitxiber.beitia@hypernet.io,050240,ES09209580768975132020,11113.43,2024-02-13T15:30:46,Gernika,expenses,repairs,-293.65,-49759.76
buyer_2,Aitxiber,Beitia,1984-09-05,00436370Z,aitxiber.beitia@hypernet.io,050240,ES09209580768975132020,11113.43,2024-02-15T10:24:07,Gernika,expenses,transport,-42.28,-49802.04
buyer_2,Aitxiber,Beitia,1984-09-05,00436370Z,aitxiber.beitia@hypernet.io,050240,ES09209580768975132020,11113.43,2024-02-15T17:39:56,Gernika,expenses,children,-645.37,-50447.41
buyer_2,Aitxiber,Beitia,1984-09-05,00436370Z,aitxiber.beitia@hypernet.io,050240,ES09209580768975132020,11113.43,2024-02-16T11:54:03,Gernika,expenses,clothing,-56.38,-50503.79
buyer_2,Aitxiber,Beitia,1984-09-05,00436370Z,aitxiber.beitia@hypernet.io,050240,ES09209580768975132020,11113.43,2024-02-17T20:11:47,Gernika,expenses,food,-119.7,-50623.49
buyer_2,Aitxiber,Beitia,1984-09-05,00436370Z,aitxiber.beitia@hypernet.io,050240,ES09209580768975132020,11113.43,2024-02-17T11:12:27,Gernika,expenses,leisure,-58.56,-50682.05
buyer_2,Aitxiber,Beitia,1984-09-05,00436370Z,aitxiber.beitia@hypernet.io,050240,ES09209580768975132020,11113.43,2024-02-18T21:39:29,Gernika,expenses,education,-58.19,-50740.24
buyer_2,Aitxiber,Beitia,1984-09-05,00436370Z,aitxiber.beitia@hypernet.io,050240,ES09209580768975132020,11113.43,2024-02-20T16:40:36,Gernika,expenses,leisure,-60.42,-50800.66
buyer_2,Aitxiber,Beitia,1984-09-05,00436370Z,aitxiber.beitia@hypernet.io,050240,ES09209580768975132020,11113.43,2024-02-20T03:05:59,Gernika,expenses,repairs,-156.75,-50957.41
buyer_2,Aitxiber,Beitia,1984-09-05,00436370Z,aitxiber.beitia@hypernet.io,050240,ES09209580768975132020,11113.43,2024-02-20T13:33:30,Gernika,expenses,gifts,-392.58,-51349.99
buyer_2,Aitxiber,Beitia,1984-09-05,00436370Z,aitxiber.beitia@hypernet.io,050240,ES09209580768975132020,11113.43,2024-02-21T02:21:04,Gernika,expenses,clothing,-66.73,-51416.72
buyer_2,Aitxiber,Beitia,1984-09-05,00436370Z,aitxiber.beitia@hypernet.io,050240,ES09209580768975132020,11113.43,2024-02-23T19:38:15,Gernika,expenses,cash,-100.0,-51516.72
buyer_2,Aitxiber,Beitia,1984-09-05,00436370Z,aitxiber.beitia@hypernet.io,050240,ES09209580768975132020,11113.43,2024-02-23T21:17:33,Gernika,expenses,gifts,-529.63,-52046.35
buyer_2,Aitxiber,Beitia,1984-09-05,00436370Z,aitxiber.beitia@hypernet.io,050240,ES09209580768975132020,11113.43,2024-02-25T15:29:59,Gernika,expenses,gifts,-481.11,-52527.46
buyer_2,Aitxiber,Beitia,1984-09-05,00436370Z,aitxiber.beitia@hypernet.io,050240,ES09209580768975132020,11113.43,2024-02-26T13:09:11,Gernika,expenses,food,-86.55,-52614.01
buyer_2,Aitxiber,Beitia,1984-09-05,00436370Z,aitxiber.beitia@hypernet.io,050240,ES09209580768975132020,11113.43,2024-02-26T17:24:30,Gernika,expenses,transport,-80.0,-52694.01
buyer_2,Aitxiber,Beitia,1984-09-05,00436370Z,aitxiber.beitia@hypernet.io,050240,ES09209580768975132020,11113.43,2024-02-27T15:09:24,Gernika,expenses,food,-105.34,-52799.35
buyer_2,Aitxiber,Beitia,1984-09-05,00436370Z,aitxiber.beitia@hypernet.io,050240,ES09209580768975132020,11113.43,2024-02-28T19:29:37,Gernika,expenses,healthcare,-55.41,-52854.76
buyer_2,Aitxiber,Beitia,1984-09-05,00436370Z,aitxiber.beitia@hypernet.io,050240,ES09209580768975132020,11113.43,2024-02-29T12:53:07,Gernika,expenses,food,-121.04,-52975.8
buyer_2,Aitxiber,Beitia,1984-09-05,00436370Z,aitxiber.beitia@hypernet.io,050240,ES09209580768975132020,11113.43,2024-03-01T17:57:44,Gernika,incomes,salary,2139.97,-50835.83
buyer_2,Aitxiber,Beitia,1984-09-05,00436370Z,aitxiber.beitia@hypernet.io,050240,ES09209580768975132020,11113.43,2024-03-01T09:34:53,Gernika,expenses,food,-90.37,-50926.2
buyer_2,Aitxiber,Beitia,1984-09-05,00436370Z,aitxiber.beitia@hypernet.io,050240,ES09209580768975132020,11113.43,2024-03-03T16:45:33,Gernika,expenses,food,-107.08,-51033.28
buyer_2,Aitxiber,Beitia,1984-09-05,00436370Z,aitxiber.beitia@hypernet.io,050240,ES09209580768975132020,11113.43,2024-03-03T13:17:12,Gernika,expenses,leisure,-37.02,-51070.3
buyer_2,Aitxiber,Beitia,1984-09-05,00436370Z,aitxiber.beitia@hypernet.io,050240,ES09209580768975132020,11113.43,2024-03-03T13:02:26,Gernika,expenses,clothing,-159.27,-51229.57
buyer_2,Aitxiber,Beitia,1984-09-05,00436370Z,aitxiber.beitia@hypernet.io,050240,ES09209580768975132020,11113.43,2024-03-03T08:08:03,Gernika,expenses,gifts,-375.94,-51605.51
buyer_2,Aitxiber,Beitia,1984-09-05,00436370Z,aitxiber.beitia@hypernet.io,050240,ES09209580768975132020,11113.43,2024-03-05T13:36:14,Gernika,expenses,mortgage,-865.42,-52470.93
buyer_2,Aitxiber,Beitia,1984-09-05,00436370Z,aitxiber.beitia@hypernet.io,050240,ES09209580768975132020,11113.43,2024-03-05T11:52:33,Gernika,expenses,water,-21.55,-52492.48
buyer_2,Aitxiber,Beitia,1984-09-05,00436370Z,aitxiber.beitia@hypernet.io,050240,ES09209580768975132020,11113.43,2024-03-05T12:14:54,Gernika,expenses,internet,-44.94,-52537.42
buyer_2,Aitxiber,Beitia,1984-09-05,00436370Z,aitxiber.beitia@hypernet.io,050240,ES09209580768975132020,11113.43,2024-03-05T14:34:05,Gernika,expenses,phone,-37.37,-52574.79
buyer_2,Aitxiber,Beitia,1984-09-05,00436370Z,aitxiber.beitia@hypernet.io,050240,ES09209580768975132020,11113.43,2024-03-05T17:53:26,Gernika,expenses,cash,-100.0,-52674.79
buyer_2,Aitxiber,Beitia,1984-09-05,00436370Z,aitxiber.beitia@hypernet.io,050240,ES09209580768975132020,11113.43,2024-03-11T21:20:26,Gernika,expenses,cash,-100.0,-52774.79
buyer_2,Aitxiber,Beitia,1984-09-05,00436370Z,aitxiber.beitia@hypernet.io,050240,ES09209580768975132020,11113.43,2024-03-11T12:16:31,Gernika,expenses,gifts,-520.01,-53294.8
buyer_2,Aitxiber,Beitia,1984-09-05,00436370Z,aitxiber.beitia@hypernet.io,050240,ES09209580768975132020,11113.43,2024-03-12T02:14:43,Gernika,expenses,cash,-100.0,-53394.8
buyer_2,Aitxiber,Beitia,1984-09-05,00436370Z,aitxiber.beitia@hypernet.io,050240,ES09209580768975132020,11113.43,2024-03-13T21:17:38,Gernika,expenses,children,-742.2,-54137.0
buyer_2,Aitxiber,Beitia,1984-09-05,00436370Z,aitxiber.beitia@hypernet.io,050240,ES09209580768975132020,11113.43,2024-03-14T06:54:18,Gernika,expenses,transport,-52.15,-54189.15
buyer_2,Aitxiber,Beitia,1984-09-05,00436370Z,aitxiber.beitia@hypernet.io,050240,ES09209580768975132020,11113.43,2024-03-16T15:55:10,Gernika,expenses,children,-753.19,-54942.34
buyer_2,Aitxiber,Beitia,1984-09-05,00436370Z,aitxiber.beitia@hypernet.io,050240,ES09209580768975132020,11113.43,2024-03-17T02:18:15,Gernika,expenses,repairs,-106.98,-55049.32
buyer_2,Aitxiber,Beitia,1984-09-05,00436370Z,aitxiber.beitia@hypernet.io,050240,ES09209580768975132020,11113.43,2024-03-18T10:56:57,Gernika,expenses,clothing,-94.6,-55143.92
buyer_2,Aitxiber,Beitia,1984-09-05,00436370Z,aitxiber.beitia@hypernet.io,050240,ES09209580768975132020,11113.43,2024-03-18T20:09:00,Gernika,expenses,gifts,-174.34,-55318.26
buyer_2,Aitxiber,Beitia,1984-09-05,00436370Z,aitxiber.beitia@hypernet.io,050240,ES09209580768975132020,11113.43,2024-03-20T08:12:55,Gernika,expenses,transport,-40.14,-55358.4
buyer_2,Aitxiber,Beitia,1984-09-05,00436370Z,aitxiber.beitia@hypernet.io,050240,ES09209580768975132020,11113.43,2024-03-21T20:37:38,Gernika,expenses,leisure,-65.46,-55423.86
buyer_2,Aitxiber,Beitia,1984-09-05,00436370Z,aitxiber.beitia@hypernet.io,050240,ES09209580768975132020,11113.43,2024-03-21T16:56:02,Gernika,expenses,cash,-100.0,-55523.86
buyer_2,Aitxiber,Beitia,1984-09-05,00436370Z,aitxiber.beitia@hypernet.io,050240,ES09209580768975132020,11113.43,2024-03-22T22:22:38,Gernika,expenses,transport,-82.17,-55606.03
buyer_2,Aitxiber,Beitia,1984-09-05,00436370Z,aitxiber.beitia@hypernet.io,050240,ES09209580768975132020,11113.43,2024-03-24T11:37:55,Gernika,expenses,repairs,-213.46,-55819.49
buyer_2,Aitxiber,Beitia,1984-09-05,00436370Z,aitxiber.beitia@hypernet.io,050240,ES09209580768975132020,11113.43,2024-03-25T18:09:49,Gernika,expenses,clothing,-110.63,-55930.12
buyer_2,Aitxiber,Beitia,1984-09-05,00436370Z,aitxiber.beitia@hypernet.io,050240,ES09209580768975132020,11113.43,2024-03-27T18:42:28,Gernika,expenses,transport,-63.42,-55993.54
buyer_2,Aitxiber,Beitia,1984-09-05,00436370Z,aitxiber.beitia@hypernet.io,050240,ES09209580768975132020,11113.43,2024-03-28T11:47:23,Gernika,expenses,food,-118.95,-56112.49
buyer_2,Aitxiber,Beitia,1984-09-05,00436370Z,aitxiber.beitia@hypernet.io,050240,ES09209580768975132020,11113.43,2024-03-28T15:26:29,Gernika,expenses,repairs,-227.71,-56340.2
buyer_2,Aitxiber,Beitia,1984-09-05,00436370Z,aitxiber.beitia@hypernet.io,050240,ES09209580768975132020,11113.43,2024-03-29T05:45:25,Gernika,expenses,education,-45.27,-56385.47
buyer_2,Aitxiber,Beitia,1984-09-05,00436370Z,aitxiber.beitia@hypernet.io,050240,ES09209580768975132020,11113.43,2024-03-30T16:44:52,Gernika,expenses,repairs,-233.05,-56618.52
buyer_2,Aitxiber,Beitia,1984-09-05,00436370Z,aitxiber.beitia@hypernet.io,050240,ES09209580768975132020,11113.43,2024-03-31T04:46:25,Gernika,expenses,leisure,-28.0,-56646.52
buyer_2,Aitxiber,Beitia,1984-09-05,00436370Z,aitxiber.beitia@hypernet.io,050240,ES09209580768975132020,11113.43,2024-04-01T20:38:20,Gernika,incomes,salary,2139.97,-54506.55
buyer_2,Aitxiber,Beitia,1984-09-05,00436370Z,aitxiber.beitia@hypernet.io,050240,ES09209580768975132020,11113.43,2024-04-01T20:38:20,Gernika,incomes,extra_income,263.98,-54242.57
buyer_2,Aitxiber,Beitia,1984-09-05,00436370Z,aitxiber.beitia@hypernet.io,050240,ES09209580768975132020,11113.43,2024-04-01T17:42:58,Gernika,expenses,leisure,-84.17,-54326.74
buyer_2,Aitxiber,Beitia,1984-09-05,00436370Z,aitxiber.beitia@hypernet.io,050240,ES09209580768975132020,11113.43,2024-04-04T09:34:34,Gernika,expenses,food,-124.95,-54451.69
buyer_2,Aitxiber,Beitia,1984-09-05,00436370Z,aitxiber.beitia@hypernet.io,050240,ES09209580768975132020,11113.43,2024-04-05T04:12:44,Gernika,expenses,mortgage,-865.42,-55317.11
buyer_2,Aitxiber,Beitia,1984-09-05,00436370Z,aitxiber.beitia@hypernet.io,050240,ES09209580768975132020,11113.43,2024-04-05T13:23:38,Gernika,expenses,electricity,-75.76,-55392.87
buyer_2,Aitxiber,Beitia,1984-09-05,00436370Z,aitxiber.beitia@hypernet.io,050240,ES09209580768975132020,11113.43,2024-04-06T16:35:58,Gernika,expenses,gas,-46.09,-55438.96
buyer_2,Aitxiber,Beitia,1984-09-05,00436370Z,aitxiber.beitia@hypernet.io,050240,ES09209580768975132020,11113.43,2024-04-06T13:07:42,Gernika,expenses,transport,-55.95,-55494.91
buyer_2,Aitxiber,Beitia,1984-09-05,00436370Z,aitxiber.beitia@hypernet.io,050240,ES09209580768975132020,11113.43,2024-04-06T05:26:56,Gernika,expenses,cash,-100.0,-55594.91
buyer_2,Aitxiber,Beitia,1984-09-05,00436370Z,aitxiber.beitia@hypernet.io,050240,ES09209580768975132020,11113.43,2024-04-06T22:00:02,Gernika,expenses,gifts,-558.83,-56153.74
buyer_2,Aitxiber,Beitia,1984-09-05,00436370Z,aitxiber.beitia@hypernet.io,050240,ES09209580768975132020,11113.43,2024-04-08T15:09:08,Gernika,expenses,gas,-103.88,-56257.62
buyer_2,Aitxiber,Beitia,1984-09-05,00436370Z,aitxiber.beitia@hypernet.io,050240,ES09209580768975132020,11113.43,2024-04-08T16:36:52,Gernika,expenses,cash,-100.0,-56357.62
buyer_2,Aitxiber,Beitia,1984-09-05,00436370Z,aitxiber.beitia@hypernet.io,050240,ES09209580768975132020,11113.43,2024-04-09T13:32:57,Gernika,expenses,clothing,-90.17,-56447.79
buyer_2,Aitxiber,Beitia,1984-09-05,00436370Z,aitxiber.beitia@hypernet.io,050240,ES09209580768975132020,11113.43,2024-04-10T20:02:01,Gernika,expenses,travel,-689.0,-57136.79
buyer_2,Aitxiber,Beitia,1984-09-05,00436370Z,aitxiber.beitia@hypernet.io,050240,ES09209580768975132020,11113.43,2024-04-10T18:35:05,Gernika,expenses,gifts,-73.29,-57210.08
buyer_2,Aitxiber,Beitia,1984-09-05,00436370Z,aitxiber.beitia@hypernet.io,050240,ES09209580768975132020,11113.43,2024-04-11T10:05:09,Gernika,expenses,leisure,-48.54,-57258.62
buyer_2,Aitxiber,Beitia,1984-09-05,00436370Z,aitxiber.beitia@hypernet.io,050240,ES09209580768975132020,11113.43,2024-04-11T10:58:15,Gernika,expenses,education,-51.63,-57310.25
buyer_2,Aitxiber,Beitia,1984-09-05,00436370Z,aitxiber.beitia@hypernet.io,050240,ES09209580768975132020,11113.43,2024-04-13T08:04:36,Gernika,expenses,repairs,-325.76,-57636.01
buyer_2,Aitxiber,Beitia,1984-09-05,00436370Z,aitxiber.beitia@hypernet.io,050240,ES09209580768975132020,11113.43,2024-04-14T09:00:57,Gernika,expenses,clothing,-117.91,-57753.92
buyer_2,Aitxiber,Beitia,1984-09-05,00436370Z,aitxiber.beitia@hypernet.io,050240,ES09209580768975132020,11113.43,2024-04-15T08:01:26,Gernika,expenses,food,-122.93,-57876.85
buyer_2,Aitxiber,Beitia,1984-09-05,00436370Z,aitxiber.beitia@hypernet.io,050240,ES09209580768975132020,11113.43,2024-04-15T09:38:33,Gernika,expenses,children,-703.56,-58580.41
buyer_2,Aitxiber,Beitia,1984-09-05,00436370Z,aitxiber.beitia@hypernet.io,050240,ES09209580768975132020,11113.43,2024-04-18T22:17:50,Gernika,expenses,education,-56.96,-58637.37
buyer_2,Aitxiber,Beitia,1984-09-05,00436370Z,aitxiber.beitia@hypernet.io,050240,ES09209580768975132020,11113.43,2024-04-19T08:35:44,Gernika,expenses,clothing,-77.67,-58715.04
buyer_2,Aitxiber,Beitia,1984-09-05,00436370Z,aitxiber.beitia@hypernet.io,050240,ES09209580768975132020,11113.43,2024-04-19T23:43:19,Gernika,expenses,cash,-100.0,-58815.04
buyer_2,Aitxiber,Beitia,1984-09-05,00436370Z,aitxiber.beitia@hypernet.io,050240,ES09209580768975132020,11113.43,2024-04-20T19:09:51,Gernika,expenses,food,-114.2,-58929.24
buyer_2,Aitxiber,Beitia,1984-09-05,00436370Z,aitxiber.beitia@hypernet.io,050240,ES09209580768975132020,11113.43,2024-04-20T14:46:19,Gernika,expenses,cash,-100.0,-59029.24
buyer_2,Aitxiber,Beitia,1984-09-05,00436370Z,aitxiber.beitia@hypernet.io,050240,ES09209580768975132020,11113.43,2024-04-21T10:32:22,Gernika,expenses,food,-63.76,-59093.0
buyer_2,Aitxiber,Beitia,1984-09-05,00436370Z,aitxiber.beitia@hypernet.io,050240,ES09209580768975132020,11113.43,2024-04-21T01:46:03,Gernika,expenses,cash,-100.0,-59193.0
buyer_2,Aitxiber,Beitia,1984-09-05,00436370Z,aitxiber.beitia@hypernet.io,050240,ES09209580768975132020,11113.43,2024-04-21T10:23:12,Gernika,expenses,repairs,-315.26,-59508.26
buyer_2,Aitxiber,Beitia,1984-09-05,00436370Z,aitxiber.beitia@hypernet.io,050240,ES09209580768975132020,11113.43,2024-04-23T21:34:03,Gernika,expenses,transport,-74.23,-59582.49
buyer_2,Aitxiber,Beitia,1984-09-05,00436370Z,aitxiber.beitia@hypernet.io,050240,ES09209580768975132020,11113.43,2024-04-23T11:12:53,Gernika,expenses,education,-42.52,-59625.01
buyer_2,Aitxiber,Beitia,1984-09-05,00436370Z,aitxiber.beitia@hypernet.io,050240,ES09209580768975132020,11113.43,2024-04-25T10:28:32,Gernika,expenses,food,-74.29,-59699.3
buyer_2,Aitxiber,Beitia,1984-09-05,00436370Z,aitxiber.beitia@hypernet.io,050240,ES09209580768975132020,11113.43,2024-04-25T14:04:53,Gernika,expenses,transport,-55.21,-59754.51
buyer_2,Aitxiber,Beitia,1984-09-05,00436370Z,aitxiber.beitia@hypernet.io,050240,ES09209580768975132020,11113.43,2024-04-25T08:51:34,Gernika,expenses,leisure,-24.25,-59778.76
buyer_2,Aitxiber,Beitia,1984-09-05,00436370Z,aitxiber.beitia@hypernet.io,050240,ES09209580768975132020,11113.43,2024-04-25T01:19:49,Gernika,expenses,education,-42.89,-59821.65
buyer_2,Aitxiber,Beitia,1984-09-05,00436370Z,aitxiber.beitia@hypernet.io,050240,ES09209580768975132020,11113.43,2024-04-26T17:54:36,Gernika,expenses,food,-68.41,-59890.06
buyer_2,Aitxiber,Beitia,1984-09-05,00436370Z,aitxiber.beitia@hypernet.io,050240,ES09209580768975132020,11113.43,2024-04-27T19:16:47,Gernika,expenses,leisure,-29.14,-59919.2
buyer_2,Aitxiber,Beitia,1984-09-05,00436370Z,aitxiber.beitia@hypernet.io,050240,ES09209580768975132020,11113.43,2024-04-28T11:06:29,Gernika,expenses,cash,-100.0,-60019.2
buyer_2,Aitxiber,Beitia,1984-09-05,00436370Z,aitxiber.beitia@hypernet.io,050240,ES09209580768975132020,11113.43,2024-04-29T14:45:41,Gernika,expenses,transport,-62.81,-60082.01
buyer_2,Aitxiber,Beitia,1984-09-05,00436370Z,aitxiber.beitia@hypernet.io,050240,ES09209580768975132020,11113.43,2024-05-01T18:12:00,Gernika,incomes,salary,2139.97,-57942.04
buyer_2,Aitxiber,Beitia,1984-09-05,00436370Z,aitxiber.beitia@hypernet.io,050240,ES09209580768975132020,11113.43,2024-05-02T16:10:23,Gernika,expenses,leisure,-45.82,-57987.86
buyer_2,Aitxiber,Beitia,1984-09-05,00436370Z,aitxiber.beitia@hypernet.io,050240,ES09209580768975132020,11113.43,2024-05-03T12:17:06,Gernika,expenses,cash,-100.0,-58087.86
buyer_2,Aitxiber,Beitia,1984-09-05,00436370Z,aitxiber.beitia@hypernet.io,050240,ES09209580768975132020,11113.43,2024-05-05T08:29:33,Gernika,expenses,mortgage,-865.42,-58953.28
buyer_2,Aitxiber,Beitia,1984-09-05,00436370Z,aitxiber.beitia@hypernet.io,050240,ES09209580768975132020,11113.43,2024-05-05T08:31:28,Gernika,expenses,electricity,-46.91,-59000.19
buyer_2,Aitxiber,Beitia,1984-09-05,00436370Z,aitxiber.beitia@hypernet.io,050240,ES09209580768975132020,11113.43,2024-05-05T13:18:29,Gernika,expenses,cash,-100.0,-59100.19
buyer_2,Aitxiber,Beitia,1984-09-05,00436370Z,aitxiber.beitia@hypernet.io,050240,ES09209580768975132020,11113.43,2024-05-06T15:04:58,Gernika,expenses,electricity,-73.38,-59173.57
buyer_2,Aitxiber,Beitia,1984-09-05,00436370Z,aitxiber.beitia@hypernet.io,050240,ES09209580768975132020,11113.43,2024-05-06T16:58:29,Gernika,expenses,leisure,-74.46,-59248.03
buyer_2,Aitxiber,Beitia,1984-09-05,00436370Z,aitxiber.beitia@hypernet.io,050240,ES09209580768975132020,11113.43,2024-05-07T15:29:13,Gernika,expenses,water,-31.22,-59279.25
buyer_2,Aitxiber,Beitia,1984-09-05,00436370Z,aitxiber.beitia@hypernet.io,050240,ES09209580768975132020,11113.43,2024-05-07T03:29:51,Gernika,expenses,gas,-84.38,-59363.63
buyer_2,Aitxiber,Beitia,1984-09-05,00436370Z,aitxiber.beitia@hypernet.io,050240,ES09209580768975132020,11113.43,2024-05-08T03:36:20,Gernika,expenses,repairs,-203.39,-59567.02
buyer_2,Aitxiber,Beitia,1984-09-05,00436370Z,aitxiber.beitia@hypernet.io,050240,ES09209580768975132020,11113.43,2024-05-09T13:49:09,Gernika,expenses,food,-113.76,-59680.78
buyer_2,Aitxiber,Beitia,1984-09-05,00436370Z,aitxiber.beitia@hypernet.io,050240,ES09209580768975132020,11113.43,2024-05-09T11:29:43,Gernika,expenses,transport,-85.09,-59765.87
buyer_2,Aitxiber,Beitia,1984-09-05,00436370Z,aitxiber.beitia@hypernet.io,050240,ES09209580768975132020,11113.43,2024-05-12T09:45:32,Gernika,expenses,food,-88.33,-59854.2
buyer_2,Aitxiber,Beitia,1984-09-05,00436370Z,aitxiber.beitia@hypernet.io,050240,ES09209580768975132020,11113.43,2024-05-13T20:09:28,Gernika,expenses,cash,-100.0,-59954.2
buyer_2,Aitxiber,Beitia,1984-09-05,00436370Z,aitxiber.beitia@hypernet.io,050240,ES09209580768975132020,11113.43,2024-05-14T19:45:06,Gernika,expenses,gifts,-117.96,-60072.16
buyer_2,Aitxiber,Beitia,1984-09-05,00436370Z,aitxiber.beitia@hypernet.io,050240,ES09209580768975132020,11113.43,2024-05-15T18:15:34,Gernika,expenses,cash,-100.0,-60172.16
buyer_2,Aitxiber,Beitia,1984-09-05,00436370Z,aitxiber.beitia@hypernet.io,050240,ES09209580768975132020,11113.43,2024-05-18T12:12:52,Gernika,expenses,transport,-74.1,-60246.26
buyer_2,Aitxiber,Beitia,1984-09-05,00436370Z,aitxiber.beitia@hypernet.io,050240,ES09209580768975132020,11113.43,2024-05-22T13:10:18,Gernika,expenses,leisure,-45.04,-60291.3
buyer_2,Aitxiber,Beitia,1984-09-05,00436370Z,aitxiber.beitia@hypernet.io,050240,ES09209580768975132020,11113.43,2024-05-24T20:54:14,Gernika,expenses,cash,-100.0,-60391.3
buyer_2,Aitxiber,Beitia,1984-09-05,00436370Z,aitxiber.beitia@hypernet.io,050240,ES09209580768975132020,11113.43,2024-05-24T09:20:14,Gernika,expenses,children,-687.44,-61078.74
buyer_2,Aitxiber,Beitia,1984-09-05,00436370Z,aitxiber.beitia@hypernet.io,050240,ES09209580768975132020,11113.43,2024-05-28T15:41:44,Gernika,expenses,transport,-59.62,-61138.36
buyer_2,Aitxiber,Beitia,1984-09-05,00436370Z,aitxiber.beitia@hypernet.io,050240,ES09209580768975132020,11113.43,2024-05-29T13:31:54,Gernika,expenses,cash,-100.0,-61238.36
buyer_2,Aitxiber,Beitia,1984-09-05,00436370Z,aitxiber.beitia@hypernet.io,050240,ES09209580768975132020,11113.43,2024-05-30T09:29:36,Gernika,expenses,food,-106.31,-61344.67
buyer_2,Aitxiber,Beitia,1984-09-05,00436370Z,aitxiber.beitia@hypernet.io,050240,ES09209580768975132020,11113.43,2024-05-30T02:47:53,Gernika,expenses,leisure,-64.01,-61408.68
buyer_2,Aitxiber,Beitia,1984-09-05,00436370Z,aitxiber.beitia@hypernet.io,050240,ES09209580768975132020,11113.43,2024-06-01T18:32:59,Gernika,incomes,salary,2139.97,-59268.71
buyer_2,Aitxiber,Beitia,1984-09-05,00436370Z,aitxiber.beitia@hypernet.io,050240,ES09209580768975132020,11113.43,2024-06-01T18:32:59,Gernika,incomes,salary_bonus,1597.75,-57670.96
buyer_2,Aitxiber,Beitia,1984-09-05,00436370Z,aitxiber.beitia@hypernet.io,050240,ES09209580768975132020,11113.43,2024-06-01T15:11:43,Gernika,expenses,repairs,-307.62,-57978.58
buyer_2,Aitxiber,Beitia,1984-09-05,00436370Z,aitxiber.beitia@hypernet.io,050240,ES09209580768975132020,11113.43,2024-06-02T11:49:37,Gernika,expenses,taxes,-1530.14,-59508.72
buyer_2,Aitxiber,Beitia,1984-09-05,00436370Z,aitxiber.beitia@hypernet.io,050240,ES09209580768975132020,11113.43,2024-06-02T13:59:36,Gernika,expenses,insurance,-454.55,-59963.27
buyer_2,Aitxiber,Beitia,1984-09-05,00436370Z,aitxiber.beitia@hypernet.io,050240,ES09209580768975132020,11113.43,2024-06-05T19:17:20,Gernika,expenses,mortgage,-865.42,-60828.69
buyer_2,Aitxiber,Beitia,1984-09-05,00436370Z,aitxiber.beitia@hypernet.io,050240,ES09209580768975132020,11113.43,2024-06-05T14:08:52,Gernika,expenses,leisure,-54.06,-60882.75
buyer_2,Aitxiber,Beitia,1984-09-05,00436370Z,aitxiber.beitia@hypernet.io,050240,ES09209580768975132020,11113.43,2024-06-06T12:13:59,Gernika,expenses,water,-42.53,-60925.28
buyer_2,Aitxiber,Beitia,1984-09-05,00436370Z,aitxiber.beitia@hypernet.io,050240,ES09209580768975132020,11113.43,2024-06-06T16:42:52,Gernika,expenses,phone,-44.25,-60969.53
buyer_2,Aitxiber,Beitia,1984-09-05,00436370Z,aitxiber.beitia@hypernet.io,050240,ES09209580768975132020,11113.43,2024-06-07T11:19:13,Gernika,expenses,phone,-40.1,-61009.63
buyer_2,Aitxiber,Beitia,1984-09-05,00436370Z,aitxiber.beitia@hypernet.io,050240,ES09209580768975132020,11113.43,2024-06-07T16:40:29,Gernika,expenses,gifts,-243.88,-61253.51
buyer_2,Aitxiber,Beitia,1984-09-05,00436370Z,aitxiber.beitia@hypernet.io,050240,ES09209580768975132020,11113.43,2024-06-08T20:52:13,Gernika,expenses,gas,-88.86,-61342.37
buyer_2,Aitxiber,Beitia,1984-09-05,00436370Z,aitxiber.beitia@hypernet.io,050240,ES09209580768975132020,11113.43,2024-06-08T13:51:53,Gernika,expenses,phone,-37.51,-61379.88
buyer_2,Aitxiber,Beitia,1984-09-05,00436370Z,aitxiber.beitia@hypernet.io,050240,ES09209580768975132020,11113.43,2024-06-08T16:12:53,Gernika,expenses,transport,-43.63,-61423.51
buyer_2,Aitxiber,Beitia,1984-09-05,00436370Z,aitxiber.beitia@hypernet.io,050240,ES09209580768975132020,11113.43,2024-06-08T15:04:41,Gernika,expenses,leisure,-42.98,-61466.49
buyer_2,Aitxiber,Beitia,1984-09-05,00436370Z,aitxiber.beitia@hypernet.io,050240,ES09209580768975132020,11113.43,2024-06-08T11:55:06,Gernika,expenses,repairs,-227.66,-61694.15
buyer_2,Aitxiber,Beitia,1984-09-05,00436370Z,aitxiber.beitia@hypernet.io,050240,ES09209580768975132020,11113.43,2024-06-10T16:29:09,Gernika,expenses,transport,-74.18,-61768.33
buyer_2,Aitxiber,Beitia,1984-09-05,00436370Z,aitxiber.beitia@hypernet.io,050240,ES09209580768975132020,11113.43,2024-06-11T15:13:33,Gernika,expenses,cash,-100.0,-61868.33
buyer_2,Aitxiber,Beitia,1984-09-05,00436370Z,aitxiber.beitia@hypernet.io,050240,ES09209580768975132020,11113.43,2024-06-11T00:22:41,Gernika,expenses,repairs,-165.43,-62033.76
buyer_2,Aitxiber,Beitia,1984-09-05,00436370Z,aitxiber.beitia@hypernet.io,050240,ES09209580768975132020,11113.43,2024-06-12T19:10:05,Gernika,expenses,cash,-100.0,-62133.76
buyer_2,Aitxiber,Beitia,1984-09-05,00436370Z,aitxiber.beitia@hypernet.io,050240,ES09209580768975132020,11113.43,2024-06-14T15:26:57,Gernika,expenses,transport,-56.66,-62190.42
buyer_2,Aitxiber,Beitia,1984-09-05,00436370Z,aitxiber.beitia@hypernet.io,050240,ES09209580768975132020,11113.43,2024-06-15T18:03:25,Gernika,expenses,food,-106.38,-62296.8
buyer_2,Aitxiber,Beitia,1984-09-05,00436370Z,aitxiber.beitia@hypernet.io,050240,ES09209580768975132020,11113.43,2024-06-15T17:32:37,Gernika,expenses,leisure,-66.08,-62362.88
buyer_2,Aitxiber,Beitia,1984-09-05,00436370Z,aitxiber.beitia@hypernet.io,050240,ES09209580768975132020,11113.43,2024-06-16T13:51:26,Gernika,expenses,transport,-83.55,-62446.43
buyer_2,Aitxiber,Beitia,1984-09-05,00436370Z,aitxiber.beitia@hypernet.io,050240,ES09209580768975132020,11113.43,2024-06-16T13:00:31,Gernika,expenses,cash,-100.0,-62546.43
buyer_2,Aitxiber,Beitia,1984-09-05,00436370Z,aitxiber.beitia@hypernet.io,050240,ES09209580768975132020,11113.43,2024-06-17T19:17:17,Gernika,expenses,food,-109.8,-62656.23
buyer_2,Aitxiber,Beitia,1984-09-05,00436370Z,aitxiber.beitia@hypernet.io,050240,ES09209580768975132020,11113.43,2024-06-18T19:48:51,Gernika,expenses,food,-68.29,-62724.52
buyer_2,Aitxiber,Beitia,1984-09-05,00436370Z,aitxiber.beitia@hypernet.io,050240,ES09209580768975132020,11113.43,2024-06-20T14:34:06,Gernika,expenses,food,-107.78,-62832.3
buyer_2,Aitxiber,Beitia,1984-09-05,00436370Z,aitxiber.beitia@hypernet.io,050240,ES09209580768975132020,11113.43,2024-06-20T11:47:37,Gernika,expenses,transport,-81.86,-62914.16
buyer_2,Aitxiber,Beitia,1984-09-05,00436370Z,aitxiber.beitia@hypernet.io,050240,ES09209580768975132020,11113.43,2024-06-21T17:25:10,Gernika,expenses,cash,-100.0,-63014.16
buyer_2,Aitxiber,Beitia,1984-09-05,00436370Z,aitxiber.beitia@hypernet.io,050240,ES09209580768975132020,11113.43,2024-06-23T10:49:33,Gernika,expenses,food,-115.39,-63129.55
buyer_2,Aitxiber,Beitia,1984-09-05,00436370Z,aitxiber.beitia@hypernet.io,050240,ES09209580768975132020,11113.43,2024-06-26T03:36:35,Gernika,expenses,appliances,-81.27,-63210.82
buyer_2,Aitxiber,Beitia,1984-09-05,00436370Z,aitxiber.beitia@hypernet.io,050240,ES09209580768975132020,11113.43,2024-06-27T20:06:29,Gernika,expenses,cash,-100.0,-63310.82
buyer_2,Aitxiber,Beitia,1984-09-05,00436370Z,aitxiber.beitia@hypernet.io,050240,ES09209580768975132020,11113.43,2024-06-28T14:04:55,Gernika,expenses,clothing,-109.5,-63420.32
buyer_2,Aitxiber,Beitia,1984-09-05,00436370Z,aitxiber.beitia@hypernet.io,050240,ES09209580768975132020,11113.43,2024-06-29T15:05:32,Gernika,expenses,transport,-45.83,-63466.15
buyer_2,Aitxiber,Beitia,1984-09-05,00436370Z,aitxiber.beitia@hypernet.io,050240,ES09209580768975132020,11113.43,2024-06-29T15:23:02,Gernika,expenses,repairs,-320.86,-63787.01
buyer_2,Aitxiber,Beitia,1984-09-05,00436370Z,aitxiber.beitia@hypernet.io,050240,ES09209580768975132020,11113.43,2024-07-01T15:50:32,Gernika,incomes,salary,2139.97,-61647.04
buyer_2,Aitxiber,Beitia,1984-09-05,00436370Z,aitxiber.beitia@hypernet.io,050240,ES09209580768975132020,11113.43,2024-07-01T15:50:32,Gernika,incomes,extra_income,263.98,-61383.06
buyer_2,Aitxiber,Beitia,1984-09-05,00436370Z,aitxiber.beitia@hypernet.io,050240,ES09209580768975132020,11113.43,2024-07-01T16:02:22,Gernika,expenses,cash,-100.0,-61483.06
buyer_2,Aitxiber,Beitia,1984-09-05,00436370Z,aitxiber.beitia@hypernet.io,050240,ES09209580768975132020,11113.43,2024-07-01T19:26:27,Gernika,expenses,gifts,-275.26,-61758.32
buyer_2,Aitxiber,Beitia,1984-09-05,00436370Z,aitxiber.beitia@hypernet.io,050240,ES09209580768975132020,11113.43,2024-07-01T05:18:01,Gernika,expenses,children,-416.78,-62175.1
buyer_2,Aitxiber,Beitia,1984-09-05,00436370Z,aitxiber.beitia@hypernet.io,050240,ES09209580768975132020,11113.43,2024-07-05T18:51:40,Gernika,expenses,mortgage,-865.42,-63040.52
buyer_2,Aitxiber,Beitia,1984-09-05,00436370Z,aitxiber.beitia@hypernet.io,050240,ES09209580768975132020,11113.43,2024-07-05T20:22:36,Gernika,expenses,water,-32.46,-63072.98
buyer_2,Aitxiber,Beitia,1984-09-05,00436370Z,aitxiber.beitia@hypernet.io,050240,ES09209580768975132020,11113.43,2024-07-05T14:02:06,Gernika,expenses,gas,-46.14,-63119.12
buyer_2,Aitxiber,Beitia,1984-09-05,00436370Z,aitxiber.beitia@hypernet.io,050240,ES09209580768975132020,11113.43,2024-07-05T10:15:38,Gernika,expenses,internet,-44.94,-63164.06
buyer_2,Aitxiber,Beitia,1984-09-05,00436370Z,aitxiber.beitia@hypernet.io,050240,ES09209580768975132020,11113.43,2024-07-06T14:05:51,Gernika,expenses,internet,-44.94,-63209.0
buyer_2,Aitxiber,Beitia,1984-09-05,00436370Z,aitxiber.beitia@hypernet.io,050240,ES09209580768975132020,11113.43,2024-07-06T12:09:07,Gernika,expenses,education,-51.72,-63260.72
buyer_2,Aitxiber,Beitia,1984-09-05,00436370Z,aitxiber.beitia@hypernet.io,050240,ES09209580768975132020,11113.43,2024-07-08T15:03:20,Gernika,expenses,phone,-44.17,-63304.89
buyer_2,Aitxiber,Beitia,1984-09-05,00436370Z,aitxiber.beitia@hypernet.io,050240,ES09209580768975132020,11113.43,2024-07-08T23:04:55,Gernika,expenses,food,-93.26,-63398.15
buyer_2,Aitxiber,Beitia,1984-09-05,00436370Z,aitxiber.beitia@hypernet.io,050240,ES09209580768975132020,11113.43,2024-07-09T19:06:43,Gernika,expenses,leisure,-20.49,-63418.64
buyer_2,Aitxiber,Beitia,1984-09-05,00436370Z,aitxiber.beitia@hypernet.io,050240,ES09209580768975132020,11113.43,2024-07-14T17:41:53,Gernika,expenses,healthcare,-156.49,-63575.13
buyer_2,Aitxiber,Beitia,1984-09-05,00436370Z,aitxiber.beitia@hypernet.io,050240,ES09209580768975132020,11113.43,2024-07-14T13:09:30,Gernika,expenses,appliances,-157.24,-63732.37
buyer_2,Aitxiber,Beitia,1984-09-05,00436370Z,aitxiber.beitia@hypernet.io,050240,ES09209580768975132020,11113.43,2024-07-18T11:22:30,Gernika,expenses,food,-89.47,-63821.84
buyer_2,Aitxiber,Beitia,1984-09-05,00436370Z,aitxiber.beitia@hypernet.io,050240,ES09209580768975132020,11113.43,2024-07-20T18:11:53,Gernika,expenses,education,-47.01,-63868.85
buyer_2,Aitxiber,Beitia,1984-09-05,00436370Z,aitxiber.beitia@hypernet.io,050240,ES09209580768975132020,11113.43,2024-07-20T10:10:46,Gernika,expenses,cash,-100.0,-63968.85
buyer_2,Aitxiber,Beitia,1984-09-05,00436370Z,aitxiber.beitia@hypernet.io,050240,ES09209580768975132020,11113.43,2024-07-22T15:45:37,Gernika,expenses,food,-101.6,-64070.45
buyer_2,Aitxiber,Beitia,1984-09-05,00436370Z,aitxiber.beitia@hypernet.io,050240,ES09209580768975132020,11113.43,2024-07-23T18:05:42,Gernika,expenses,repairs,-201.43,-64271.88
buyer_2,Aitxiber,Beitia,1984-09-05,00436370Z,aitxiber.beitia@hypernet.io,050240,ES09209580768975132020,11113.43,2024-07-24T19:09:38,Gernika,expenses,clothing,-141.83,-64413.71
buyer_2,Aitxiber,Beitia,1984-09-05,00436370Z,aitxiber.beitia@hypernet.io,050240,ES09209580768975132020,11113.43,2024-07-24T17:58:17,Gernika,expenses,travel,-475.22,-64888.93
buyer_2,Aitxiber,Beitia,1984-09-05,00436370Z,aitxiber.beitia@hypernet.io,050240,ES09209580768975132020,11113.43,2024-07-24T17:20:33,Gernika,expenses,appliances,-116.66,-65005.59
buyer_2,Aitxiber,Beitia,1984-09-05,00436370Z,aitxiber.beitia@hypernet.io,050240,ES09209580768975132020,11113.43,2024-07-25T10:21:36,Gernika,expenses,leisure,-22.09,-65027.68
buyer_2,Aitxiber,Beitia,1984-09-05,00436370Z,aitxiber.beitia@hypernet.io,050240,ES09209580768975132020,11113.43,2024-07-28T10:01:05,Gernika,expenses,cash,-100.0,-65127.68
buyer_2,Aitxiber,Beitia,1984-09-05,00436370Z,aitxiber.beitia@hypernet.io,050240,ES09209580768975132020,11113.43,2024-07-29T18:15:35,Gernika,expenses,cash,-100.0,-65227.68
buyer_2,Aitxiber,Beitia,1984-09-05,00436370Z,aitxiber.beitia@hypernet.io,050240,ES09209580768975132020,11113.43,2024-07-30T21:48:41,Gernika,expenses,clothing,-152.98,-65380.66
buyer_2,Aitxiber,Beitia,1984-09-05,00436370Z,aitxiber.beitia@hypernet.io,050240,ES09209580768975132020,11113.43,2024-07-31T14:35:55,Gernika,expenses,clothing,-143.62,-65524.28
buyer_2,Aitxiber,Beitia,1984-09-05,00436370Z,aitxiber.beitia@hypernet.io,050240,ES09209580768975132020,11113.43,2024-07-31T21:44:32,Gernika,expenses,cash,-100.0,-65624.28
buyer_2,Aitxiber,Beitia,1984-09-05,00436370Z,aitxiber.beitia@hypernet.io,050240,ES09209580768975132020,11113.43,2024-08-01T08:20:04,Gernika,incomes,salary,2139.97,-63484.31
buyer_2,Aitxiber,Beitia,1984-09-05,00436370Z,aitxiber.beitia@hypernet.io,050240,ES09209580768975132020,11113.43,2024-08-01T05:08:17,Gernika,expenses,repairs,-32.6,-63516.91
buyer_2,Aitxiber,Beitia,1984-09-05,00436370Z,aitxiber.beitia@hypernet.io,050240,ES09209580768975132020,11113.43,2024-08-02T19:01:15,Gernika,expenses,cash,-100.0,-63616.91
buyer_2,Aitxiber,Beitia,1984-09-05,00436370Z,aitxiber.beitia@hypernet.io,050240,ES09209580768975132020,11113.43,2024-08-04T09:37:02,Gernika,expenses,food,-95.11,-63712.02
buyer_2,Aitxiber,Beitia,1984-09-05,00436370Z,aitxiber.beitia@hypernet.io,050240,ES09209580768975132020,11113.43,2024-08-05T14:59:45,Gernika,expenses,mortgage,-865.42,-64577.44
buyer_2,Aitxiber,Beitia,1984-09-05,00436370Z,aitxiber.beitia@hypernet.io,050240,ES09209580768975132020,11113.43,2024-08-05T14:46:11,Gernika,expenses,electricity,-54.51,-64631.95
buyer_2,Aitxiber,Beitia,1984-09-05,00436370Z,aitxiber.beitia@hypernet.io,050240,ES09209580768975132020,11113.43,2024-08-06T20:17:03,Gernika,expenses,food,-112.67,-64744.62
buyer_2,Aitxiber,Beitia,1984-09-05,00436370Z,aitxiber.beitia@hypernet.io,050240,ES09209580768975132020,11113.43,2024-08-07T05:54:38,Gernika,expenses,electricity,-75.4,-64820.02
buyer_2,Aitxiber,Beitia,1984-09-05,00436370Z,aitxiber.beitia@hypernet.io,050240,ES09209580768975132020,11113.43,2024-08-07T17:48:07,Gernika,expenses,internet,-44.94,-64864.96
buyer_2,Aitxiber,Beitia,1984-09-05,00436370Z,aitxiber.beitia@hypernet.io,050240,ES09209580768975132020,11113.43,2024-08-07T06:46:15,Gernika,expenses,phone,-36.88,-64901.84
buyer_2,Aitxiber,Beitia,1984-09-05,00436370Z,aitxiber.beitia@hypernet.io,050240,ES09209580768975132020,11113.43,2024-08-07T19:50:20,Gernika,expenses,travel,-312.31,-65214.15
buyer_2,Aitxiber,Beitia,1984-09-05,00436370Z,aitxiber.beitia@hypernet.io,050240,ES09209580768975132020,11113.43,2024-08-08T05:53:47,Gernika,expenses,electricity,-93.21,-65307.36
buyer_2,Aitxiber,Beitia,1984-09-05,00436370Z,aitxiber.beitia@hypernet.io,050240,ES09209580768975132020,11113.43,2024-08-08T18:13:16,Gernika,expenses,gas,-35.86,-65343.22
buyer_2,Aitxiber,Beitia,1984-09-05,00436370Z,aitxiber.beitia@hypernet.io,050240,ES09209580768975132020,11113.43,2024-08-08T00:31:56,Gernika,expenses,leisure,-82.41,-65425.63
buyer_2,Aitxiber,Beitia,1984-09-05,00436370Z,aitxiber.beitia@hypernet.io,050240,ES09209580768975132020,11113.43,2024-08-09T15:13:12,Gernika,expenses,cash,-100.0,-65525.63
buyer_2,Aitxiber,Beitia,1984-09-05,00436370Z,aitxiber.beitia@hypernet.io,050240,ES09209580768975132020,11113.43,2024-08-13T16:44:11,Gernika,expenses,leisure,-51.91,-65577.54
buyer_2,Aitxiber,Beitia,1984-09-05,00436370Z,aitxiber.beitia@hypernet.io,050240,ES09209580768975132020,11113.43,2024-08-14T18:03:59,Gernika,expenses,cash,-100.0,-65677.54
buyer_2,Aitxiber,Beitia,1984-09-05,00436370Z,aitxiber.beitia@hypernet.io,050240,ES09209580768975132020,11113.43,2024-08-15T18:38:59,Gernika,expenses,transport,-69.84,-65747.38
buyer_2,Aitxiber,Beitia,1984-09-05,00436370Z,aitxiber.beitia@hypernet.io,050240,ES09209580768975132020,11113.43,2024-08-16T05:11:19,Gernika,expenses,food,-65.41,-65812.79
buyer_2,Aitxiber,Beitia,1984-09-05,00436370Z,aitxiber.beitia@hypernet.io,050240,ES09209580768975132020,11113.43,2024-08-17T20:01:22,Gernika,expenses,transport,-82.93,-65895.72
buyer_2,Aitxiber,Beitia,1984-09-05,00436370Z,aitxiber.beitia@hypernet.io,050240,ES09209580768975132020,11113.43,2024-08-18T04:55:42,Gernika,expenses,transport,-45.73,-65941.45
buyer_2,Aitxiber,Beitia,1984-09-05,00436370Z,aitxiber.beitia@hypernet.io,050240,ES09209580768975132020,11113.43,2024-08-18T20:26:59,Gernika,expenses,cash,-100.0,-66041.45
buyer_2,Aitxiber,Beitia,1984-09-05,00436370Z,aitxiber.beitia@hypernet.io,050240,ES09209580768975132020,11113.43,2024-08-22T19:33:56,Gernika,expenses,cash,-100.0,-66141.45
buyer_2,Aitxiber,Beitia,1984-09-05,00436370Z,aitxiber.beitia@hypernet.io,050240,ES09209580768975132020,11113.43,2024-08-23T08:07:19,Gernika,expenses,leisure,-72.39,-66213.84
buyer_2,Aitxiber,Beitia,1984-09-05,00436370Z,aitxiber.beitia@hypernet.io,050240,ES09209580768975132020,11113.43,2024-08-27T04:07:31,Gernika,expenses,children,-609.99,-66823.83
buyer_2,Aitxiber,Beitia,1984-09-05,00436370Z,aitxiber.beitia@hypernet.io,050240,ES09209580768975132020,11113.43,2024-08-28T17:22:26,Gernika,expenses,food,-60.15,-66883.98
buyer_2,Aitxiber,Beitia,1984-09-05,00436370Z,aitxiber.beitia@hypernet.io,050240,ES09209580768975132020,11113.43,2024-08-28T09:19:03,Gernika,expenses,repairs,-205.15,-67089.13
buyer_2,Aitxiber,Beitia,1984-09-05,00436370Z,aitxiber.beitia@hypernet.io,050240,ES09209580768975132020,11113.43,2024-08-28T11:42:35,Gernika,expenses,children,-487.76,-67576.89
buyer_2,Aitxiber,Beitia,1984-09-05,00436370Z,aitxiber.beitia@hypernet.io,050240,ES09209580768975132020,11113.43,2024-08-29T20:13:11,Gernika,expenses,transport,-51.27,-67628.16
buyer_2,Aitxiber,Beitia,1984-09-05,00436370Z,aitxiber.beitia@hypernet.io,050240,ES09209580768975132020,11113.43,2024-08-30T13:50:13,Gernika,expenses,cash,-100.0,-67728.16
buyer_2,Aitxiber,Beitia,1984-09-05,00436370Z,aitxiber.beitia@hypernet.io,050240,ES09209580768975132020,11113.43,2024-08-31T09:12:09,Gernika,expenses,education,-46.99,-67775.15
buyer_2,Aitxiber,Beitia,1984-09-05,00436370Z,aitxiber.beitia@hypernet.io,050240,ES09209580768975132020,11113.43,2024-09-01T06:38:59,Gernika,incomes,salary,2139.97,-65635.18
buyer_2,Aitxiber,Beitia,1984-09-05,00436370Z,aitxiber.beitia@hypernet.io,050240,ES09209580768975132020,11113.43,2024-09-02T09:46:07,Gernika,expenses,leisure,-56.38,-65691.56
buyer_2,Aitxiber,Beitia,1984-09-05,00436370Z,aitxiber.beitia@hypernet.io,050240,ES09209580768975132020,11113.43,2024-09-03T23:33:11,Gernika,expenses,food,-94.43,-65785.99
buyer_2,Aitxiber,Beitia,1984-09-05,00436370Z,aitxiber.beitia@hypernet.io,050240,ES09209580768975132020,11113.43,2024-09-03T18:06:14,Gernika,expenses,leisure,-29.05,-65815.04
buyer_2,Aitxiber,Beitia,1984-09-05,00436370Z,aitxiber.beitia@hypernet.io,050240,ES09209580768975132020,11113.43,2024-09-05T16:44:17,Gernika,expenses,mortgage,-865.42,-66680.46
buyer_2,Aitxiber,Beitia,1984-09-05,00436370Z,aitxiber.beitia@hypernet.io,050240,ES09209580768975132020,11113.43,2024-09-05T09:06:13,Gernika,expenses,electricity,-63.87,-66744.33
buyer_2,Aitxiber,Beitia,1984-09-05,00436370Z,aitxiber.beitia@hypernet.io,050240,ES09209580768975132020,11113.43,2024-09-05T13:38:34,Gernika,expenses,phone,-37.93,-66782.26
buyer_2,Aitxiber,Beitia,1984-09-05,00436370Z,aitxiber.beitia@hypernet.io,050240,ES09209580768975132020,11113.43,2024-09-05T14:37:55,Gernika,expenses,cash,-100.0,-66882.26
buyer_2,Aitxiber,Beitia,1984-09-05,00436370Z,aitxiber.beitia@hypernet.io,050240,ES09209580768975132020,11113.43,2024-09-06T17:46:04,Gernika,expenses,electricity,-24.39,-66906.65
buyer_2,Aitxiber,Beitia,1984-09-05,00436370Z,aitxiber.beitia@hypernet.io,050240,ES09209580768975132020,11113.43,2024-09-06T20:57:50,Gernika,expenses,cash,-100.0,-67006.65
buyer_2,Aitxiber,Beitia,1984-09-05,00436370Z,aitxiber.beitia@hypernet.io,050240,ES09209580768975132020,11113.43,2024-09-07T10:22:37,Gernika,expenses,electricity,-72.75,-67079.4
buyer_2,Aitxiber,Beitia,1984-09-05,00436370Z,aitxiber.beitia@hypernet.io,050240,ES09209580768975132020,11113.43,2024-09-07T19:34:03,Gernika,expenses,internet,-44.94,-67124.34
buyer_2,Aitxiber,Beitia,1984-09-05,00436370Z,aitxiber.beitia@hypernet.io,050240,ES09209580768975132020,11113.43,2024-09-07T09:27:08,Gernika,expenses,phone,-41.62,-67165.96
buyer_2,Aitxiber,Beitia,1984-09-05,00436370Z,aitxiber.beitia@hypernet.io,050240,ES09209580768975132020,11113.43,2024-09-07T13:09:34,Gernika,expenses,education,-65.28,-67231.24
buyer_2,Aitxiber,Beitia,1984-09-05,00436370Z,aitxiber.beitia@hypernet.io,050240,ES09209580768975132020,11113.43,2024-09-07T15:34:17,Gernika,expenses,cash,-100.0,-67331.24
buyer_2,Aitxiber,Beitia,1984-09-05,00436370Z,aitxiber.beitia@hypernet.io,050240,ES09209580768975132020,11113.43,2024-09-09T22:49:54,Gernika,expenses,transport,-71.68,-67402.92
buyer_2,Aitxiber,Beitia,1984-09-05,00436370Z,aitxiber.beitia@hypernet.io,050240,ES09209580768975132020,11113.43,2024-09-09T11:36:39,Gernika,expenses,clothing,-148.28,-67551.2
buyer_2,Aitxiber,Beitia,1984-09-05,00436370Z,aitxiber.beitia@hypernet.io,050240,ES09209580768975132020,11113.43,2024-09-12T17:09:00,Gernika,expenses,leisure,-51.02,-67602.22
buyer_2,Aitxiber,Beitia,1984-09-05,00436370Z,aitxiber.beitia@hypernet.io,050240,ES09209580768975132020,11113.43,2024-09-14T11:27:16,Gernika,expenses,food,-77.37,-67679.59
buyer_2,Aitxiber,Beitia,1984-09-05,00436370Z,aitxiber.beitia@hypernet.io,050240,ES09209580768975132020,11113.43,2024-09-15T15:21:27,Gernika,expenses,cash,-100.0,-67779.59
buyer_2,Aitxiber,Beitia,1984-09-05,00436370Z,aitxiber.beitia@hypernet.io,050240,ES09209580768975132020,11113.43,2024-09-16T11:08:23,Gernika,expenses,food,-71.28,-67850.87
buyer_2,Aitxiber,Beitia,1984-09-05,00436370Z,aitxiber.beitia@hypernet.io,050240,ES09209580768975132020,11113.43,2024-09-16T01:28:06,Gernika,expenses,healthcare,-175.77,-68026.64
buyer_2,Aitxiber,Beitia,1984-09-05,00436370Z,aitxiber.beitia@hypernet.io,050240,ES09209580768975132020,11113.43,2024-09-16T08:40:18,Gernika,expenses,gifts,-194.47,-68221.11
buyer_2,Aitxiber,Beitia,1984-09-05,00436370Z,aitxiber.beitia@hypernet.io,050240,ES09209580768975132020,11113.43,2024-09-17T14:43:08,Gernika,expenses,repairs,-185.29,-68406.4
buyer_2,Aitxiber,Beitia,1984-09-05,00436370Z,aitxiber.beitia@hypernet.io,050240,ES09209580768975132020,11113.43,2024-09-21T14:39:07,Gernika,expenses,transport,-75.09,-68481.49
buyer_2,Aitxiber,Beitia,1984-09-05,00436370Z,aitxiber.beitia@hypernet.io,050240,ES09209580768975132020,11113.43,2024-09-21T10:30:41,Gernika,expenses,cash,-100.0,-68581.49
buyer_2,Aitxiber,Beitia,1984-09-05,00436370Z,aitxiber.beitia@hypernet.io,050240,ES09209580768975132020,11113.43,2024-09-22T23:35:16,Gernika,expenses,children,-829.66,-69411.15
buyer_2,Aitxiber,Beitia,1984-09-05,00436370Z,aitxiber.beitia@hypernet.io,050240,ES09209580768975132020,11113.43,2024-09-23T15:27:15,Gernika,expenses,healthcare,-76.97,-69488.12
buyer_2,Aitxiber,Beitia,1984-09-05,00436370Z,aitxiber.beitia@hypernet.io,050240,ES09209580768975132020,11113.43,2024-09-23T08:14:19,Gernika,expenses,education,-50.95,-69539.07
buyer_2,Aitxiber,Beitia,1984-09-05,00436370Z,aitxiber.beitia@hypernet.io,050240,ES09209580768975132020,11113.43,2024-09-23T17:15:44,Gernika,expenses,cash,-100.0,-69639.07
buyer_2,Aitxiber,Beitia,1984-09-05,00436370Z,aitxiber.beitia@hypernet.io,050240,ES09209580768975132020,11113.43,2024-09-24T18:47:03,Gernika,expenses,food,-72.37,-69711.44
buyer_2,Aitxiber,Beitia,1984-09-05,00436370Z,aitxiber.beitia@hypernet.io,050240,ES09209580768975132020,11113.43,2024-09-24T19:42:53,Gernika,expenses,leisure,-42.93,-69754.37
buyer_2,Aitxiber,Beitia,1984-09-05,00436370Z,aitxiber.beitia@hypernet.io,050240,ES09209580768975132020,11113.43,2024-09-27T17:10:33,Gernika,expenses,transport,-64.21,-69818.58
buyer_2,Aitxiber,Beitia,1984-09-05,00436370Z,aitxiber.beitia@hypernet.io,050240,ES09209580768975132020,11113.43,2024-09-27T15:01:36,Gernika,expenses,cash,-100.0,-69918.58
buyer_2,Aitxiber,Beitia,1984-09-05,00436370Z,aitxiber.beitia@hypernet.io,050240,ES09209580768975132020,11113.43,2024-09-27T17:07:52,Gernika,expenses,repairs,-161.62,-70080.2
buyer_2,Aitxiber,Beitia,1984-09-05,00436370Z,aitxiber.beitia@hypernet.io,050240,ES09209580768975132020,11113.43,2024-09-28T15:39:12,Gernika,expenses,cash,-100.0,-70180.2
buyer_2,Aitxiber,Beitia,1984-09-05,00436370Z,aitxiber.beitia@hypernet.io,050240,ES09209580768975132020,11113.43,2024-09-29T08:01:58,Gernika,expenses,food,-113.68,-70293.88
buyer_2,Aitxiber,Beitia,1984-09-05,00436370Z,aitxiber.beitia@hypernet.io,050240,ES09209580768975132020,11113.43,2024-09-29T08:12:34,Gernika,expenses,healthcare,-116.65,-70410.53
buyer_2,Aitxiber,Beitia,1984-09-05,00436370Z,aitxiber.beitia@hypernet.io,050240,ES09209580768975132020,11113.43,2024-09-29T09:42:04,Gernika,expenses,travel,-350.58,-70761.11
buyer_2,Aitxiber,Beitia,1984-09-05,00436370Z,aitxiber.beitia@hypernet.io,050240,ES09209580768975132020,11113.43,2024-09-30T10:52:08,Gernika,expenses,cash,-100.0,-70861.11
buyer_2,Aitxiber,Beitia,1984-09-05,00436370Z,aitxiber.beitia@hypernet.io,050240,ES09209580768975132020,11113.43,2024-09-30T19:13:21,Gernika,expenses,repairs,-110.76,-70971.87
buyer_2,Aitxiber,Beitia,1984-09-05,00436370Z,aitxiber.beitia@hypernet.io,050240,ES09209580768975132020,11113.43,2024-10-01T15:45:30,Gernika,incomes,salary,2139.97,-68831.9
buyer_2,Aitxiber,Beitia,1984-09-05,00436370Z,aitxiber.beitia@hypernet.io,050240,ES09209580768975132020,11113.43,2024-10-01T15:45:30,Gernika,incomes,extra_income,263.98,-68567.92
buyer_2,Aitxiber,Beitia,1984-09-05,00436370Z,aitxiber.beitia@hypernet.io,050240,ES09209580768975132020,11113.43,2024-10-01T18:45:52,Gernika,expenses,leisure,-64.63,-68632.55
buyer_2,Aitxiber,Beitia,1984-09-05,00436370Z,aitxiber.beitia@hypernet.io,050240,ES09209580768975132020,11113.43,2024-10-02T15:13:58,Gernika,expenses,cash,-100.0,-68732.55
buyer_2,Aitxiber,Beitia,1984-09-05,00436370Z,aitxiber.beitia@hypernet.io,050240,ES09209580768975132020,11113.43,2024-10-02T17:06:21,Gernika,expenses,travel,-508.01,-69240.56
buyer_2,Aitxiber,Beitia,1984-09-05,00436370Z,aitxiber.beitia@hypernet.io,050240,ES09209580768975132020,11113.43,2024-10-03T01:39:41,Gernika,expenses,repairs,-286.46,-69527.02
buyer_2,Aitxiber,Beitia,1984-09-05,00436370Z,aitxiber.beitia@hypernet.io,050240,ES09209580768975132020,11113.43,2024-10-04T14:26:20,Gernika,expenses,leisure,-51.43,-69578.45
buyer_2,Aitxiber,Beitia,1984-09-05,00436370Z,aitxiber.beitia@hypernet.io,050240,ES09209580768975132020,11113.43,2024-10-05T10:45:44,Gernika,expenses,mortgage,-865.42,-70443.87
buyer_2,Aitxiber,Beitia,1984-09-05,00436370Z,aitxiber.beitia@hypernet.io,050240,ES09209580768975132020,11113.43,2024-10-05T01:58:50,Gernika,expenses,internet,-44.94,-70488.81
buyer_2,Aitxiber,Beitia,1984-09-05,00436370Z,aitxiber.beitia@hypernet.io,050240,ES09209580768975132020,11113.43,2024-10-05T10:54:07,Gernika,expenses,clothing,-95.26,-70584.07
buyer_2,Aitxiber,Beitia,1984-09-05,00436370Z,aitxiber.beitia@hypernet.io,050240,ES09209580768975132020,11113.43,2024-10-05T15:38:35,Gernika,expenses,repairs,-331.78,-70915.85
buyer_2,Aitxiber,Beitia,1984-09-05,00436370Z,aitxiber.beitia@hypernet.io,050240,ES09209580768975132020,11113.43,2024-10-06T17:26:11,Gernika,expenses,water,-38.49,-70954.34
buyer_2,Aitxiber,Beitia,1984-09-05,00436370Z,aitxiber.beitia@hypernet.io,050240,ES09209580768975132020,11113.43,2024-10-07T08:11:52,Gernika,expenses,internet,-44.94,-70999.28
buyer_2,Aitxiber,Beitia,1984-09-05,00436370Z,aitxiber.beitia@hypernet.io,050240,ES09209580768975132020,11113.43,2024-10-08T08:48:16,Gernika,expenses,water,-27.3,-71026.58
buyer_2,Aitxiber,Beitia,1984-09-05,00436370Z,aitxiber.beitia@hypernet.io,050240,ES09209580768975132020,11113.43,2024-10-09T13:39:32,Gernika,expenses,food,-66.48,-71093.06
buyer_2,Aitxiber,Beitia,1984-09-05,00436370Z,aitxiber.beitia@hypernet.io,050240,ES09209580768975132020,11113.43,2024-10-10T08:34:12,Gernika,expenses,food,-104.86,-71197.92
buyer_3,Ana,Etxebarria,1989-08-23,09407087H,ana.etxebarria@cleverbyte.tech,515685,ES71209582994069256416,7609.68,2022-01-01T23:59:09,Vitoria-Gasteiz,incomes,salary,3135.73,10745.41
buyer_3,Ana,Etxebarria,1989-08-23,09407087H,ana.etxebarria@cleverbyte.tech,515685,ES71209582994069256416,7609.68,2022-01-01T23:59:09,Vitoria-Gasteiz,incomes,salary_partner,3385.27,14130.68
buyer_3,Ana,Etxebarria,1989-08-23,09407087H,ana.etxebarria@cleverbyte.tech,515685,ES71209582994069256416,7609.68,2022-01-02T05:23:21,Vitoria-Gasteiz,expenses,transport,-64.68,14066.0
buyer_3,Ana,Etxebarria,1989-08-23,09407087H,ana.etxebarria@cleverbyte.tech,515685,ES71209582994069256416,7609.68,2022-01-03T10:13:08,Vitoria-Gasteiz,expenses,leisure,-36.17,14029.83
buyer_3,Ana,Etxebarria,1989-08-23,09407087H,ana.etxebarria@cleverbyte.tech,515685,ES71209582994069256416,7609.68,2022-01-04T03:10:38,Vitoria-Gasteiz,expenses,food,-93.4,13936.43
buyer_3,Ana,Etxebarria,1989-08-23,09407087H,ana.etxebarria@cleverbyte.tech,515685,ES71209582994069256416,7609.68,2022-01-04T19:05:44,Vitoria-Gasteiz,expenses,transport,-72.06,13864.37
buyer_3,Ana,Etxebarria,1989-08-23,09407087H,ana.etxebarria@cleverbyte.tech,515685,ES71209582994069256416,7609.68,2022-01-04T12:32:50,Vitoria-Gasteiz,expenses,cash,-100.0,13764.37
buyer_3,Ana,Etxebarria,1989-08-23,09407087H,ana.etxebarria@cleverbyte.tech,515685,ES71209582994069256416,7609.68,2022-01-05T17:14:33,Vitoria-Gasteiz,expenses,mortgage,-2407.6,11356.77
buyer_3,Ana,Etxebarria,1989-08-23,09407087H,ana.etxebarria@cleverbyte.tech,515685,ES71209582994069256416,7609.68,2022-01-05T16:59:10,Vitoria-Gasteiz,expenses,healthcare,-54.35,11302.42
buyer_3,Ana,Etxebarria,1989-08-23,09407087H,ana.etxebarria@cleverbyte.tech,515685,ES71209582994069256416,7609.68,2022-01-06T08:01:28,Vitoria-Gasteiz,expenses,water,-121.7,11180.72
buyer_3,Ana,Etxebarria,1989-08-23,09407087H,ana.etxebarria@cleverbyte.tech,515685,ES71209582994069256416,7609.68,2022-01-07T08:06:28,Vitoria-Gasteiz,expenses,electricity,-136.15,11044.57
buyer_3,Ana,Etxebarria,1989-08-23,09407087H,ana.etxebarria@cleverbyte.tech,515685,ES71209582994069256416,7609.68,2022-01-07T15:31:50,Vitoria-Gasteiz,expenses,phone,-131.39,10913.18
buyer_3,Ana,Etxebarria,1989-08-23,09407087H,ana.etxebarria@cleverbyte.tech,515685,ES71209582994069256416,7609.68,2022-01-08T13:36:16,Vitoria-Gasteiz,expenses,electricity,-167.08,10746.1
buyer_3,Ana,Etxebarria,1989-08-23,09407087H,ana.etxebarria@cleverbyte.tech,515685,ES71209582994069256416,7609.68,2022-01-08T08:43:30,Vitoria-Gasteiz,expenses,internet,-136.94,10609.16
buyer_3,Ana,Etxebarria,1989-08-23,09407087H,ana.etxebarria@cleverbyte.tech,515685,ES71209582994069256416,7609.68,2022-01-08T07:37:04,Vitoria-Gasteiz,expenses,phone,-116.55,10492.61
buyer_3,Ana,Etxebarria,1989-08-23,09407087H,ana.etxebarria@cleverbyte.tech,515685,ES71209582994069256416,7609.68,2022-01-10T07:20:52,Vitoria-Gasteiz,expenses,food,-117.63,10374.98
buyer_3,Ana,Etxebarria,1989-08-23,09407087H,ana.etxebarria@cleverbyte.tech,515685,ES71209582994069256416,7609.68,2022-01-10T12:50:27,Vitoria-Gasteiz,expenses,appliances,-340.28,10034.7
buyer_3,Ana,Etxebarria,1989-08-23,09407087H,ana.etxebarria@cleverbyte.tech,515685,ES71209582994069256416,7609.68,2022-01-11T10:34:43,Vitoria-Gasteiz,expenses,repairs,-237.99,9796.71
buyer_3,Ana,Etxebarria,1989-08-23,09407087H,ana.etxebarria@cleverbyte.tech,515685,ES71209582994069256416,7609.68,2022-01-12T12:17:50,Vitoria-Gasteiz,expenses,food,-83.19,9713.52
buyer_3,Ana,Etxebarria,1989-08-23,09407087H,ana.etxebarria@cleverbyte.tech,515685,ES71209582994069256416,7609.68,2022-01-12T08:03:28,Vitoria-Gasteiz,expenses,cash,-100.0,9613.52
buyer_3,Ana,Etxebarria,1989-08-23,09407087H,ana.etxebarria@cleverbyte.tech,515685,ES71209582994069256416,7609.68,2022-01-14T18:51:21,Vitoria-Gasteiz,expenses,leisure,-73.55,9539.97
buyer_3,Ana,Etxebarria,1989-08-23,09407087H,ana.etxebarria@cleverbyte.tech,515685,ES71209582994069256416,7609.68,2022-01-15T18:25:17,Vitoria-Gasteiz,expenses,leisure,-53.12,9486.85
buyer_3,Ana,Etxebarria,1989-08-23,09407087H,ana.etxebarria@cleverbyte.tech,515685,ES71209582994069256416,7609.68,2022-01-16T21:34:49,Vitoria-Gasteiz,expenses,food,-104.47,9382.38
buyer_3,Ana,Etxebarria,1989-08-23,09407087H,ana.etxebarria@cleverbyte.tech,515685,ES71209582994069256416,7609.68,2022-01-16T14:30:58,Vitoria-Gasteiz,expenses,clothing,-148.16,9234.22
buyer_3,Ana,Etxebarria,1989-08-23,09407087H,ana.etxebarria@cleverbyte.tech,515685,ES71209582994069256416,7609.68,2022-01-18T20:23:45,Vitoria-Gasteiz,expenses,food,-88.07,9146.15
buyer_3,Ana,Etxebarria,1989-08-23,09407087H,ana.etxebarria@cleverbyte.tech,515685,ES71209582994069256416,7609.68,2022-01-18T09:44:24,Vitoria-Gasteiz,expenses,cash,-100.0,9046.15
buyer_3,Ana,Etxebarria,1989-08-23,09407087H,ana.etxebarria@cleverbyte.tech,515685,ES71209582994069256416,7609.68,2022-01-19T15:07:31,Vitoria-Gasteiz,expenses,leisure,-59.15,8987.0
buyer_3,Ana,Etxebarria,1989-08-23,09407087H,ana.etxebarria@cleverbyte.tech,515685,ES71209582994069256416,7609.68,2022-01-20T16:59:59,Vitoria-Gasteiz,expenses,food,-82.2,8904.8
buyer_3,Ana,Etxebarria,1989-08-23,09407087H,ana.etxebarria@cleverbyte.tech,515685,ES71209582994069256416,7609.68,2022-01-20T16:05:18,Vitoria-Gasteiz,expenses,cash,-100.0,8804.8
buyer_3,Ana,Etxebarria,1989-08-23,09407087H,ana.etxebarria@cleverbyte.tech,515685,ES71209582994069256416,7609.68,2022-01-23T13:10:37,Vitoria-Gasteiz,expenses,gifts,-745.41,8059.39
buyer_3,Ana,Etxebarria,1989-08-23,09407087H,ana.etxebarria@cleverbyte.tech,515685,ES71209582994069256416,7609.68,2022-01-24T20:56:40,Vitoria-Gasteiz,expenses,cash,-100.0,7959.39
buyer_3,Ana,Etxebarria,1989-08-23,09407087H,ana.etxebarria@cleverbyte.tech,515685,ES71209582994069256416,7609.68,2022-01-27T13:01:55,Vitoria-Gasteiz,expenses,food,-66.63,7892.76
buyer_3,Ana,Etxebarria,1989-08-23,09407087H,ana.etxebarria@cleverbyte.tech,515685,ES71209582994069256416,7609.68,2022-01-27T01:27:49,Vitoria-Gasteiz,expenses,gifts,-88.37,7804.39
buyer_3,Ana,Etxebarria,1989-08-23,09407087H,ana.etxebarria@cleverbyte.tech,515685,ES71209582994069256416,7609.68,2022-02-01T09:49:27,Vitoria-Gasteiz,incomes,salary,3135.73,10940.12
buyer_3,Ana,Etxebarria,1989-08-23,09407087H,ana.etxebarria@cleverbyte.tech,515685,ES71209582994069256416,7609.68,2022-02-01T09:49:27,Vitoria-Gasteiz,incomes,salary_partner,3385.27,14325.39
buyer_3,Ana,Etxebarria,1989-08-23,09407087H,ana.etxebarria@cleverbyte.tech,515685,ES71209582994069256416,7609.68,2022-02-02T19:35:15,Vitoria-Gasteiz,expenses,clothing,-116.4,14208.99
buyer_3,Ana,Etxebarria,1989-08-23,09407087H,ana.etxebarria@cleverbyte.tech,515685,ES71209582994069256416,7609.68,2022-02-04T09:43:29,Vitoria-Gasteiz,expenses,cash,-100.0,14108.99
buyer_3,Ana,Etxebarria,1989-08-23,09407087H,ana.etxebarria@cleverbyte.tech,515685,ES71209582994069256416,7609.68,2022-02-05T16:31:15,Vitoria-Gasteiz,expenses,mortgage,-2407.6,11701.39
buyer_3,Ana,Etxebarria,1989-08-23,09407087H,ana.etxebarria@cleverbyte.tech,515685,ES71209582994069256416,7609.68,2022-02-05T17:33:39,Vitoria-Gasteiz,expenses,internet,-136.94,11564.45
buyer_3,Ana,Etxebarria,1989-08-23,09407087H,ana.etxebarria@cleverbyte.tech,515685,ES71209582994069256416,7609.68,2022-02-05T15:57:13,Vitoria-Gasteiz,expenses,food,-113.8,11450.65
buyer_3,Ana,Etxebarria,1989-08-23,09407087H,ana.etxebarria@cleverbyte.tech,515685,ES71209582994069256416,7609.68,2022-02-05T09:25:28,Vitoria-Gasteiz,expenses,leisure,-50.28,11400.37
buyer_3,Ana,Etxebarria,1989-08-23,09407087H,ana.etxebarria@cleverbyte.tech,515685,ES71209582994069256416,7609.68,2022-02-05T16:08:05,Vitoria-Gasteiz,expenses,cash,-100.0,11300.37
buyer_3,Ana,Etxebarria,1989-08-23,09407087H,ana.etxebarria@cleverbyte.tech,515685,ES71209582994069256416,7609.68,2022-02-06T23:17:46,Vitoria-Gasteiz,expenses,water,-139.96,11160.41
buyer_3,Ana,Etxebarria,1989-08-23,09407087H,ana.etxebarria@cleverbyte.tech,515685,ES71209582994069256416,7609.68,2022-02-06T12:20:26,Vitoria-Gasteiz,expenses,repairs,-205.93,10954.48
buyer_3,Ana,Etxebarria,1989-08-23,09407087H,ana.etxebarria@cleverbyte.tech,515685,ES71209582994069256416,7609.68,2022-02-07T14:08:29,Vitoria-Gasteiz,expenses,electricity,-265.43,10689.05
buyer_3,Ana,Etxebarria,1989-08-23,09407087H,ana.etxebarria@cleverbyte.tech,515685,ES71209582994069256416,7609.68,2022-02-07T09:38:33,Vitoria-Gasteiz,expenses,internet,-136.94,10552.11
buyer_3,Ana,Etxebarria,1989-08-23,09407087H,ana.etxebarria@cleverbyte.tech,515685,ES71209582994069256416,7609.68,2022-02-07T18:25:02,Vitoria-Gasteiz,expenses,phone,-113.93,10438.18
buyer_3,Ana,Etxebarria,1989-08-23,09407087H,ana.etxebarria@cleverbyte.tech,515685,ES71209582994069256416,7609.68,2022-02-07T20:44:45,Vitoria-Gasteiz,expenses,cash,-100.0,10338.18
buyer_3,Ana,Etxebarria,1989-08-23,09407087H,ana.etxebarria@cleverbyte.tech,515685,ES71209582994069256416,7609.68,2022-02-08T19:55:52,Vitoria-Gasteiz,expenses,gas,-273.57,10064.61
buyer_3,Ana,Etxebarria,1989-08-23,09407087H,ana.etxebarria@cleverbyte.tech,515685,ES71209582994069256416,7609.68,2022-02-08T00:10:51,Vitoria-Gasteiz,expenses,food,-74.16,9990.45
buyer_3,Ana,Etxebarria,1989-08-23,09407087H,ana.etxebarria@cleverbyte.tech,515685,ES71209582994069256416,7609.68,2022-02-11T20:37:40,Vitoria-Gasteiz,expenses,cash,-100.0,9890.45
buyer_3,Ana,Etxebarria,1989-08-23,09407087H,ana.etxebarria@cleverbyte.tech,515685,ES71209582994069256416,7609.68,2022-02-13T10:42:17,Vitoria-Gasteiz,expenses,repairs,-180.22,9710.23
buyer_3,Ana,Etxebarria,1989-08-23,09407087H,ana.etxebarria@cleverbyte.tech,515685,ES71209582994069256416,7609.68,2022-02-15T01:34:32,Vitoria-Gasteiz,expenses,food,-78.54,9631.69
buyer_3,Ana,Etxebarria,1989-08-23,09407087H,ana.etxebarria@cleverbyte.tech,515685,ES71209582994069256416,7609.68,2022-02-15T15:24:53,Vitoria-Gasteiz,expenses,transport,-65.91,9565.78
buyer_3,Ana,Etxebarria,1989-08-23,09407087H,ana.etxebarria@cleverbyte.tech,515685,ES71209582994069256416,7609.68,2022-02-17T17:52:57,Vitoria-Gasteiz,expenses,repairs,-94.06,9471.72
buyer_3,Ana,Etxebarria,1989-08-23,09407087H,ana.etxebarria@cleverbyte.tech,515685,ES71209582994069256416,7609.68,2022-02-18T12:26:48,Vitoria-Gasteiz,expenses,transport,-88.25,9383.47
buyer_3,Ana,Etxebarria,1989-08-23,09407087H,ana.etxebarria@cleverbyte.tech,515685,ES71209582994069256416,7609.68,2022-02-18T14:25:22,Vitoria-Gasteiz,expenses,leisure,-52.25,9331.22
buyer_3,Ana,Etxebarria,1989-08-23,09407087H,ana.etxebarria@cleverbyte.tech,515685,ES71209582994069256416,7609.68,2022-02-19T19:56:09,Vitoria-Gasteiz,expenses,leisure,-34.44,9296.78
buyer_3,Ana,Etxebarria,1989-08-23,09407087H,ana.etxebarria@cleverbyte.tech,515685,ES71209582994069256416,7609.68,2022-02-23T11:05:47,Vitoria-Gasteiz,expenses,transport,-64.57,9232.21
buyer_3,Ana,Etxebarria,1989-08-23,09407087H,ana.etxebarria@cleverbyte.tech,515685,ES71209582994069256416,7609.68,2022-02-23T19:18:06,Vitoria-Gasteiz,expenses,repairs,-148.92,9083.29
buyer_3,Ana,Etxebarria,1989-08-23,09407087H,ana.etxebarria@cleverbyte.tech,515685,ES71209582994069256416,7609.68,2022-03-01T12:32:58,Vitoria-Gasteiz,incomes,salary,3135.73,12219.02
buyer_3,Ana,Etxebarria,1989-08-23,09407087H,ana.etxebarria@cleverbyte.tech,515685,ES71209582994069256416,7609.68,2022-03-01T12:32:58,Vitoria-Gasteiz,incomes,salary_partner,3385.27,15604.29
buyer_3,Ana,Etxebarria,1989-08-23,09407087H,ana.etxebarria@cleverbyte.tech,515685,ES71209582994069256416,7609.68,2022-03-02T20:00:43,Vitoria-Gasteiz,expenses,cash,-100.0,15504.29
buyer_3,Ana,Etxebarria,1989-08-23,09407087H,ana.etxebarria@cleverbyte.tech,515685,ES71209582994069256416,7609.68,2022-03-03T11:31:45,Vitoria-Gasteiz,expenses,leisure,-32.88,15471.41
buyer_3,Ana,Etxebarria,1989-08-23,09407087H,ana.etxebarria@cleverbyte.tech,515685,ES71209582994069256416,7609.68,2022-03-04T19:52:09,Vitoria-Gasteiz,expenses,travel,-380.01,15091.4
buyer_3,Ana,Etxebarria,1989-08-23,09407087H,ana.etxebarria@cleverbyte.tech,515685,ES71209582994069256416,7609.68,2022-03-05T14:03:19,Vitoria-Gasteiz,expenses,mortgage,-2407.6,12683.8
buyer_3,Ana,Etxebarria,1989-08-23,09407087H,ana.etxebarria@cleverbyte.tech,515685,ES71209582994069256416,7609.68,2022-03-05T14:01:11,Vitoria-Gasteiz,expenses,phone,-100.38,12583.42
buyer_3,Ana,Etxebarria,1989-08-23,09407087H,ana.etxebarria@cleverbyte.tech,515685,ES71209582994069256416,7609.68,2022-03-05T07:14:26,Vitoria-Gasteiz,expenses,cash,-100.0,12483.42
buyer_3,Ana,Etxebarria,1989-08-23,09407087H,ana.etxebarria@cleverbyte.tech,515685,ES71209582994069256416,7609.68,2022-03-06T09:22:31,Vitoria-Gasteiz,expenses,electricity,-124.72,12358.7
buyer_3,Ana,Etxebarria,1989-08-23,09407087H,ana.etxebarria@cleverbyte.tech,515685,ES71209582994069256416,7609.68,2022-03-07T19:15:53,Vitoria-Gasteiz,expenses,transport,-68.74,12289.96
buyer_3,Ana,Etxebarria,1989-08-23,09407087H,ana.etxebarria@cleverbyte.tech,515685,ES71209582994069256416,7609.68,2022-03-07T14:27:56,Vitoria-Gasteiz,expenses,leisure,-42.38,12247.58
buyer_3,Ana,Etxebarria,1989-08-23,09407087H,ana.etxebarria@cleverbyte.tech,515685,ES71209582994069256416,7609.68,2022-03-08T16:15:18,Vitoria-Gasteiz,expenses,water,-75.6,12171.98
buyer_3,Ana,Etxebarria,1989-08-23,09407087H,ana.etxebarria@cleverbyte.tech,515685,ES71209582994069256416,7609.68,2022-03-08T13:44:52,Vitoria-Gasteiz,expenses,gas,-144.45,12027.53
buyer_3,Ana,Etxebarria,1989-08-23,09407087H,ana.etxebarria@cleverbyte.tech,515685,ES71209582994069256416,7609.68,2022-03-08T17:57:16,Vitoria-Gasteiz,expenses,transport,-85.81,11941.72
buyer_3,Ana,Etxebarria,1989-08-23,09407087H,ana.etxebarria@cleverbyte.tech,515685,ES71209582994069256416,7609.68,2022-03-08T14:57:15,Vitoria-Gasteiz,expenses,leisure,-59.01,11882.71
buyer_3,Ana,Etxebarria,1989-08-23,09407087H,ana.etxebarria@cleverbyte.tech,515685,ES71209582994069256416,7609.68,2022-03-08T03:34:30,Vitoria-Gasteiz,expenses,cash,-100.0,11782.71
buyer_3,Ana,Etxebarria,1989-08-23,09407087H,ana.etxebarria@cleverbyte.tech,515685,ES71209582994069256416,7609.68,2022-03-08T12:06:06,Vitoria-Gasteiz,expenses,repairs,-86.88,11695.83
buyer_3,Ana,Etxebarria,1989-08-23,09407087H,ana.etxebarria@cleverbyte.tech,515685,ES71209582994069256416,7609.68,2022-03-10T13:36:45,Vitoria-Gasteiz,expenses,leisure,-79.55,11616.28
buyer_3,Ana,Etxebarria,1989-08-23,09407087H,ana.etxebarria@cleverbyte.tech,515685,ES71209582994069256416,7609.68,2022-03-10T10:50:27,Vitoria-Gasteiz,expenses,cash,-100.0,11516.28
buyer_3,Ana,Etxebarria,1989-08-23,09407087H,ana.etxebarria@cleverbyte.tech,515685,ES71209582994069256416,7609.68,2022-03-11T18:50:22,Vitoria-Gasteiz,expenses,cash,-100.0,11416.28
buyer_3,Ana,Etxebarria,1989-08-23,09407087H,ana.etxebarria@cleverbyte.tech,515685,ES71209582994069256416,7609.68,2022-03-12T02:22:03,Vitoria-Gasteiz,expenses,clothing,-78.64,11337.64
buyer_3,Ana,Etxebarria,1989-08-23,09407087H,ana.etxebarria@cleverbyte.tech,515685,ES71209582994069256416,7609.68,2022-03-12T15:38:03,Vitoria-Gasteiz,expenses,travel,-489.55,10848.09
buyer_3,Ana,Etxebarria,1989-08-23,09407087H,ana.etxebarria@cleverbyte.tech,515685,ES71209582994069256416,7609.68,2022-03-15T22:02:02,Vitoria-Gasteiz,expenses,appliances,-77.33,10770.76
buyer_3,Ana,Etxebarria,1989-08-23,09407087H,ana.etxebarria@cleverbyte.tech,515685,ES71209582994069256416,7609.68,2022-03-15T13:14:32,Vitoria-Gasteiz,expenses,repairs,-278.6,10492.16
buyer_3,Ana,Etxebarria,1989-08-23,09407087H,ana.etxebarria@cleverbyte.tech,515685,ES71209582994069256416,7609.68,2022-03-16T12:45:35,Vitoria-Gasteiz,expenses,education,-58.23,10433.93
buyer_3,Ana,Etxebarria,1989-08-23,09407087H,ana.etxebarria@cleverbyte.tech,515685,ES71209582994069256416,7609.68,2022-03-16T11:33:15,Vitoria-Gasteiz,expenses,cash,-100.0,10333.93
buyer_3,Ana,Etxebarria,1989-08-23,09407087H,ana.etxebarria@cleverbyte.tech,515685,ES71209582994069256416,7609.68,2022-03-16T13:03:04,Vitoria-Gasteiz,expenses,repairs,-270.29,10063.64
buyer_3,Ana,Etxebarria,1989-08-23,09407087H,ana.etxebarria@cleverbyte.tech,515685,ES71209582994069256416,7609.68,2022-03-17T09:23:59,Vitoria-Gasteiz,expenses,education,-77.33,9986.31
buyer_3,Ana,Etxebarria,1989-08-23,09407087H,ana.etxebarria@cleverbyte.tech,515685,ES71209582994069256416,7609.68,2022-03-17T12:22:06,Vitoria-Gasteiz,expenses,appliances,-98.85,9887.46
buyer_3,Ana,Etxebarria,1989-08-23,09407087H,ana.etxebarria@cleverbyte.tech,515685,ES71209582994069256416,7609.68,2022-03-21T19:40:43,Vitoria-Gasteiz,expenses,cash,-100.0,9787.46
buyer_3,Ana,Etxebarria,1989-08-23,09407087H,ana.etxebarria@cleverbyte.tech,515685,ES71209582994069256416,7609.68,2022-03-22T09:28:05,Vitoria-Gasteiz,expenses,leisure,-76.66,9710.8
buyer_3,Ana,Etxebarria,1989-08-23,09407087H,ana.etxebarria@cleverbyte.tech,515685,ES71209582994069256416,7609.68,2022-03-24T17:10:31,Vitoria-Gasteiz,expenses,transport,-69.75,9641.05
buyer_3,Ana,Etxebarria,1989-08-23,09407087H,ana.etxebarria@cleverbyte.tech,515685,ES71209582994069256416,7609.68,2022-03-24T13:06:47,Vitoria-Gasteiz,expenses,cash,-100.0,9541.05
buyer_3,Ana,Etxebarria,1989-08-23,09407087H,ana.etxebarria@cleverbyte.tech,515685,ES71209582994069256416,7609.68,2022-03-25T09:06:57,Vitoria-Gasteiz,expenses,transport,-49.21,9491.84
buyer_3,Ana,Etxebarria,1989-08-23,09407087H,ana.etxebarria@cleverbyte.tech,515685,ES71209582994069256416,7609.68,2022-03-25T08:25:51,Vitoria-Gasteiz,expenses,leisure,-79.08,9412.76
buyer_3,Ana,Etxebarria,1989-08-23,09407087H,ana.etxebarria@cleverbyte.tech,515685,ES71209582994069256416,7609.68,2022-03-26T13:09:43,Vitoria-Gasteiz,expenses,leisure,-44.94,9367.82
buyer_3,Ana,Etxebarria,1989-08-23,09407087H,ana.etxebarria@cleverbyte.tech,515685,ES71209582994069256416,7609.68,2022-03-26T10:06:20,Vitoria-Gasteiz,expenses,clothing,-86.39,9281.43
buyer_3,Ana,Etxebarria,1989-08-23,09407087H,ana.etxebarria@cleverbyte.tech,515685,ES71209582994069256416,7609.68,2022-03-26T12:57:54,Vitoria-Gasteiz,expenses,travel,-628.85,8652.58
buyer_3,Ana,Etxebarria,1989-08-23,09407087H,ana.etxebarria@cleverbyte.tech,515685,ES71209582994069256416,7609.68,2022-03-27T09:48:04,Vitoria-Gasteiz,expenses,repairs,-72.71,8579.87
buyer_3,Ana,Etxebarria,1989-08-23,09407087H,ana.etxebarria@cleverbyte.tech,515685,ES71209582994069256416,7609.68,2022-03-28T19:28:59,Vitoria-Gasteiz,expenses,cash,-100.0,8479.87
buyer_3,Ana,Etxebarria,1989-08-23,09407087H,ana.etxebarria@cleverbyte.tech,515685,ES71209582994069256416,7609.68,2022-03-30T21:31:19,Vitoria-Gasteiz,expenses,food,-93.52,8386.35
buyer_3,Ana,Etxebarria,1989-08-23,09407087H,ana.etxebarria@cleverbyte.tech,515685,ES71209582994069256416,7609.68,2022-03-31T14:49:04,Vitoria-Gasteiz,expenses,repairs,-110.45,8275.9
buyer_3,Ana,Etxebarria,1989-08-23,09407087H,ana.etxebarria@cleverbyte.tech,515685,ES71209582994069256416,7609.68,2022-04-01T13:51:50,Vitoria-Gasteiz,incomes,salary,3135.73,11411.63
buyer_3,Ana,Etxebarria,1989-08-23,09407087H,ana.etxebarria@cleverbyte.tech,515685,ES71209582994069256416,7609.68,2022-04-01T13:51:50,Vitoria-Gasteiz,incomes,salary_partner,3385.27,14796.9
buyer_3,Ana,Etxebarria,1989-08-23,09407087H,ana.etxebarria@cleverbyte.tech,515685,ES71209582994069256416,7609.68,2022-04-01T13:51:50,Vitoria-Gasteiz,incomes,extra_income,372.53,15169.43
buyer_3,Ana,Etxebarria,1989-08-23,09407087H,ana.etxebarria@cleverbyte.tech,515685,ES71209582994069256416,7609.68,2022-04-01T13:25:40,Vitoria-Gasteiz,expenses,repairs,-107.77,15061.66
buyer_3,Ana,Etxebarria,1989-08-23,09407087H,ana.etxebarria@cleverbyte.tech,515685,ES71209582994069256416,7609.68,2022-04-02T15:10:24,Vitoria-Gasteiz,expenses,transport,-75.3,14986.36
buyer_3,Ana,Etxebarria,1989-08-23,09407087H,ana.etxebarria@cleverbyte.tech,515685,ES71209582994069256416,7609.68,2022-04-02T02:01:32,Vitoria-Gasteiz,expenses,leisure,-43.3,14943.06
buyer_3,Ana,Etxebarria,1989-08-23,09407087H,ana.etxebarria@cleverbyte.tech,515685,ES71209582994069256416,7609.68,2022-04-03T10:11:30,Vitoria-Gasteiz,expenses,transport,-42.44,14900.62
buyer_3,Ana,Etxebarria,1989-08-23,09407087H,ana.etxebarria@cleverbyte.tech,515685,ES71209582994069256416,7609.68,2022-04-03T20:36:05,Vitoria-Gasteiz,expenses,leisure,-34.95,14865.67
buyer_3,Ana,Etxebarria,1989-08-23,09407087H,ana.etxebarria@cleverbyte.tech,515685,ES71209582994069256416,7609.68,2022-04-04T15:59:57,Vitoria-Gasteiz,expenses,transport,-75.78,14789.89
buyer_3,Ana,Etxebarria,1989-08-23,09407087H,ana.etxebarria@cleverbyte.tech,515685,ES71209582994069256416,7609.68,2022-04-04T16:19:11,Vitoria-Gasteiz,expenses,leisure,-18.33,14771.56
buyer_3,Ana,Etxebarria,1989-08-23,09407087H,ana.etxebarria@cleverbyte.tech,515685,ES71209582994069256416,7609.68,2022-04-05T14:25:04,Vitoria-Gasteiz,expenses,mortgage,-2407.6,12363.96
buyer_3,Ana,Etxebarria,1989-08-23,09407087H,ana.etxebarria@cleverbyte.tech,515685,ES71209582994069256416,7609.68,2022-04-05T12:33:58,Vitoria-Gasteiz,expenses,internet,-136.94,12227.02
buyer_3,Ana,Etxebarria,1989-08-23,09407087H,ana.etxebarria@cleverbyte.tech,515685,ES71209582994069256416,7609.68,2022-04-06T19:13:26,Vitoria-Gasteiz,expenses,water,-145.55,12081.47
buyer_3,Ana,Etxebarria,1989-08-23,09407087H,ana.etxebarria@cleverbyte.tech,515685,ES71209582994069256416,7609.68,2022-04-07T12:43:00,Vitoria-Gasteiz,expenses,phone,-126.48,11954.99
buyer_3,Ana,Etxebarria,1989-08-23,09407087H,ana.etxebarria@cleverbyte.tech,515685,ES71209582994069256416,7609.68,2022-04-08T23:55:14,Vitoria-Gasteiz,expenses,electricity,-140.78,11814.21
buyer_3,Ana,Etxebarria,1989-08-23,09407087H,ana.etxebarria@cleverbyte.tech,515685,ES71209582994069256416,7609.68,2022-04-08T20:13:43,Vitoria-Gasteiz,expenses,gas,-169.92,11644.29
buyer_3,Ana,Etxebarria,1989-08-23,09407087H,ana.etxebarria@cleverbyte.tech,515685,ES71209582994069256416,7609.68,2022-04-08T10:47:14,Vitoria-Gasteiz,expenses,internet,-136.94,11507.35
buyer_3,Ana,Etxebarria,1989-08-23,09407087H,ana.etxebarria@cleverbyte.tech,515685,ES71209582994069256416,7609.68,2022-04-08T20:30:07,Vitoria-Gasteiz,expenses,clothing,-83.77,11423.58
buyer_3,Ana,Etxebarria,1989-08-23,09407087H,ana.etxebarria@cleverbyte.tech,515685,ES71209582994069256416,7609.68,2022-04-09T11:37:49,Vitoria-Gasteiz,expenses,food,-64.19,11359.39
buyer_3,Ana,Etxebarria,1989-08-23,09407087H,ana.etxebarria@cleverbyte.tech,515685,ES71209582994069256416,7609.68,2022-04-10T11:41:10,Vitoria-Gasteiz,expenses,food,-96.07,11263.32
buyer_3,Ana,Etxebarria,1989-08-23,09407087H,ana.etxebarria@cleverbyte.tech,515685,ES71209582994069256416,7609.68,2022-04-11T11:54:31,Vitoria-Gasteiz,expenses,repairs,-299.15,10964.17
buyer_3,Ana,Etxebarria,1989-08-23,09407087H,ana.etxebarria@cleverbyte.tech,515685,ES71209582994069256416,7609.68,2022-04-13T06:39:48,Vitoria-Gasteiz,expenses,transport,-53.33,10910.84
buyer_3,Ana,Etxebarria,1989-08-23,09407087H,ana.etxebarria@cleverbyte.tech,515685,ES71209582994069256416,7609.68,2022-04-14T15:25:22,Vitoria-Gasteiz,expenses,appliances,-161.93,10748.91
buyer_3,Ana,Etxebarria,1989-08-23,09407087H,ana.etxebarria@cleverbyte.tech,515685,ES71209582994069256416,7609.68,2022-04-16T17:30:57,Vitoria-Gasteiz,expenses,leisure,-62.2,10686.71
buyer_3,Ana,Etxebarria,1989-08-23,09407087H,ana.etxebarria@cleverbyte.tech,515685,ES71209582994069256416,7609.68,2022-04-16T14:58:55,Vitoria-Gasteiz,expenses,cash,-100.0,10586.71
buyer_3,Ana,Etxebarria,1989-08-23,09407087H,ana.etxebarria@cleverbyte.tech,515685,ES71209582994069256416,7609.68,2022-04-18T08:17:06,Vitoria-Gasteiz,expenses,food,-116.39,10470.32
buyer_3,Ana,Etxebarria,1989-08-23,09407087H,ana.etxebarria@cleverbyte.tech,515685,ES71209582994069256416,7609.68,2022-04-20T16:19:59,Vitoria-Gasteiz,expenses,leisure,-55.37,10414.95
buyer_3,Ana,Etxebarria,1989-08-23,09407087H,ana.etxebarria@cleverbyte.tech,515685,ES71209582994069256416,7609.68,2022-04-24T00:06:25,Vitoria-Gasteiz,expenses,food,-96.37,10318.58
buyer_3,Ana,Etxebarria,1989-08-23,09407087H,ana.etxebarria@cleverbyte.tech,515685,ES71209582994069256416,7609.68,2022-04-25T19:50:52,Vitoria-Gasteiz,expenses,food,-82.63,10235.95
buyer_3,Ana,Etxebarria,1989-08-23,09407087H,ana.etxebarria@cleverbyte.tech,515685,ES71209582994069256416,7609.68,2022-04-26T20:55:06,Vitoria-Gasteiz,expenses,healthcare,-85.48,10150.47
buyer_3,Ana,Etxebarria,1989-08-23,09407087H,ana.etxebarria@cleverbyte.tech,515685,ES71209582994069256416,7609.68,2022-04-30T18:37:03,Vitoria-Gasteiz,expenses,education,-70.54,10079.93
buyer_3,Ana,Etxebarria,1989-08-23,09407087H,ana.etxebarria@cleverbyte.tech,515685,ES71209582994069256416,7609.68,2022-04-30T19:29:11,Vitoria-Gasteiz,expenses,cash,-100.0,9979.93
buyer_3,Ana,Etxebarria,1989-08-23,09407087H,ana.etxebarria@cleverbyte.tech,515685,ES71209582994069256416,7609.68,2022-05-01T02:50:33,Vitoria-Gasteiz,incomes,salary,3135.73,13115.66
buyer_3,Ana,Etxebarria,1989-08-23,09407087H,ana.etxebarria@cleverbyte.tech,515685,ES71209582994069256416,7609.68,2022-05-01T02:50:33,Vitoria-Gasteiz,incomes,salary_partner,3385.27,16500.93
buyer_3,Ana,Etxebarria,1989-08-23,09407087H,ana.etxebarria@cleverbyte.tech,515685,ES71209582994069256416,7609.68,2022-05-01T12:02:53,Vitoria-Gasteiz,expenses,healthcare,-42.69,16458.24
buyer_3,Ana,Etxebarria,1989-08-23,09407087H,ana.etxebarria@cleverbyte.tech,515685,ES71209582994069256416,7609.68,2022-05-02T19:17:24,Vitoria-Gasteiz,expenses,food,-71.88,16386.36
buyer_3,Ana,Etxebarria,1989-08-23,09407087H,ana.etxebarria@cleverbyte.tech,515685,ES71209582994069256416,7609.68,2022-05-02T10:21:14,Vitoria-Gasteiz,expenses,healthcare,-48.76,16337.6
buyer_3,Ana,Etxebarria,1989-08-23,09407087H,ana.etxebarria@cleverbyte.tech,515685,ES71209582994069256416,7609.68,2022-05-03T21:38:30,Vitoria-Gasteiz,expenses,cash,-100.0,16237.6
buyer_3,Ana,Etxebarria,1989-08-23,09407087H,ana.etxebarria@cleverbyte.tech,515685,ES71209582994069256416,7609.68,2022-05-05T14:16:48,Vitoria-Gasteiz,expenses,mortgage,-2407.6,13830.0
buyer_3,Ana,Etxebarria,1989-08-23,09407087H,ana.etxebarria@cleverbyte.tech,515685,ES71209582994069256416,7609.68,2022-05-05T19:53:50,Vitoria-Gasteiz,expenses,water,-120.18,13709.82
buyer_3,Ana,Etxebarria,1989-08-23,09407087H,ana.etxebarria@cleverbyte.tech,515685,ES71209582994069256416,7609.68,2022-05-05T19:54:48,Vitoria-Gasteiz,expenses,gas,-190.14,13519.68
buyer_3,Ana,Etxebarria,1989-08-23,09407087H,ana.etxebarria@cleverbyte.tech,515685,ES71209582994069256416,7609.68,2022-05-05T10:08:44,Vitoria-Gasteiz,expenses,phone,-117.93,13401.75
buyer_3,Ana,Etxebarria,1989-08-23,09407087H,ana.etxebarria@cleverbyte.tech,515685,ES71209582994069256416,7609.68,2022-05-06T16:03:38,Vitoria-Gasteiz,expenses,internet,-136.94,13264.81
buyer_3,Ana,Etxebarria,1989-08-23,09407087H,ana.etxebarria@cleverbyte.tech,515685,ES71209582994069256416,7609.68,2022-05-06T08:37:30,Vitoria-Gasteiz,expenses,phone,-140.83,13123.98
buyer_3,Ana,Etxebarria,1989-08-23,09407087H,ana.etxebarria@cleverbyte.tech,515685,ES71209582994069256416,7609.68,2022-05-07T12:39:53,Vitoria-Gasteiz,expenses,gas,-259.0,12864.98
buyer_3,Ana,Etxebarria,1989-08-23,09407087H,ana.etxebarria@cleverbyte.tech,515685,ES71209582994069256416,7609.68,2022-05-07T08:02:04,Vitoria-Gasteiz,expenses,internet,-136.94,12728.04
buyer_3,Ana,Etxebarria,1989-08-23,09407087H,ana.etxebarria@cleverbyte.tech,515685,ES71209582994069256416,7609.68,2022-05-07T10:18:36,Vitoria-Gasteiz,expenses,phone,-108.02,12620.02
buyer_3,Ana,Etxebarria,1989-08-23,09407087H,ana.etxebarria@cleverbyte.tech,515685,ES71209582994069256416,7609.68,2022-05-08T09:04:55,Vitoria-Gasteiz,expenses,gas,-302.45,12317.57
buyer_3,Ana,Etxebarria,1989-08-23,09407087H,ana.etxebarria@cleverbyte.tech,515685,ES71209582994069256416,7609.68,2022-05-09T09:29:08,Vitoria-Gasteiz,expenses,repairs,-57.51,12260.06
buyer_3,Ana,Etxebarria,1989-08-23,09407087H,ana.etxebarria@cleverbyte.tech,515685,ES71209582994069256416,7609.68,2022-05-12T09:51:09,Vitoria-Gasteiz,expenses,transport,-77.58,12182.48
buyer_3,Ana,Etxebarria,1989-08-23,09407087H,ana.etxebarria@cleverbyte.tech,515685,ES71209582994069256416,7609.68,2022-05-12T18:03:39,Vitoria-Gasteiz,expenses,cash,-100.0,12082.48
buyer_3,Ana,Etxebarria,1989-08-23,09407087H,ana.etxebarria@cleverbyte.tech,515685,ES71209582994069256416,7609.68,2022-05-13T09:07:23,Vitoria-Gasteiz,expenses,cash,-100.0,11982.48
buyer_3,Ana,Etxebarria,1989-08-23,09407087H,ana.etxebarria@cleverbyte.tech,515685,ES71209582994069256416,7609.68,2022-05-13T17:05:58,Vitoria-Gasteiz,expenses,travel,-709.08,11273.4
buyer_3,Ana,Etxebarria,1989-08-23,09407087H,ana.etxebarria@cleverbyte.tech,515685,ES71209582994069256416,7609.68,2022-05-16T08:03:54,Vitoria-Gasteiz,expenses,cash,-100.0,11173.4
buyer_3,Ana,Etxebarria,1989-08-23,09407087H,ana.etxebarria@cleverbyte.tech,515685,ES71209582994069256416,7609.68,2022-05-18T03:40:13,Vitoria-Gasteiz,expenses,healthcare,-107.9,11065.5
buyer_3,Ana,Etxebarria,1989-08-23,09407087H,ana.etxebarria@cleverbyte.tech,515685,ES71209582994069256416,7609.68,2022-05-19T08:09:39,Vitoria-Gasteiz,expenses,transport,-54.64,11010.86
buyer_3,Ana,Etxebarria,1989-08-23,09407087H,ana.etxebarria@cleverbyte.tech,515685,ES71209582994069256416,7609.68,2022-05-21T11:43:49,Vitoria-Gasteiz,expenses,leisure,-40.44,10970.42
buyer_3,Ana,Etxebarria,1989-08-23,09407087H,ana.etxebarria@cleverbyte.tech,515685,ES71209582994069256416,7609.68,2022-05-24T12:17:31,Vitoria-Gasteiz,expenses,food,-88.23,10882.19
buyer_3,Ana,Etxebarria,1989-08-23,09407087H,ana.etxebarria@cleverbyte.tech,515685,ES71209582994069256416,7609.68,2022-05-24T14:14:03,Vitoria-Gasteiz,expenses,healthcare,-133.39,10748.8
buyer_3,Ana,Etxebarria,1989-08-23,09407087H,ana.etxebarria@cleverbyte.tech,515685,ES71209582994069256416,7609.68,2022-05-26T14:05:29,Vitoria-Gasteiz,expenses,cash,-100.0,10648.8
buyer_3,Ana,Etxebarria,1989-08-23,09407087H,ana.etxebarria@cleverbyte.tech,515685,ES71209582994069256416,7609.68,2022-05-29T22:51:10,Vitoria-Gasteiz,expenses,food,-95.37,10553.43
buyer_3,Ana,Etxebarria,1989-08-23,09407087H,ana.etxebarria@cleverbyte.tech,515685,ES71209582994069256416,7609.68,2022-05-30T17:47:47,Vitoria-Gasteiz,expenses,cash,-100.0,10453.43
buyer_3,Ana,Etxebarria,1989-08-23,09407087H,ana.etxebarria@cleverbyte.tech,515685,ES71209582994069256416,7609.68,2022-06-01T18:31:06,Vitoria-Gasteiz,incomes,salary,3135.73,13589.16
buyer_3,Ana,Etxebarria,1989-08-23,09407087H,ana.etxebarria@cleverbyte.tech,515685,ES71209582994069256416,7609.68,2022-06-01T18:31:06,Vitoria-Gasteiz,incomes,salary_partner,3385.27,16974.43
buyer_3,Ana,Etxebarria,1989-08-23,09407087H,ana.etxebarria@cleverbyte.tech,515685,ES71209582994069256416,7609.68,2022-06-01T18:31:06,Vitoria-Gasteiz,incomes,salary_bonus,2242.81,19217.24
buyer_3,Ana,Etxebarria,1989-08-23,09407087H,ana.etxebarria@cleverbyte.tech,515685,ES71209582994069256416,7609.68,2022-06-01T18:31:06,Vitoria-Gasteiz,incomes,salary_partner_bonus,2520.89,21738.13
buyer_3,Ana,Etxebarria,1989-08-23,09407087H,ana.etxebarria@cleverbyte.tech,515685,ES71209582994069256416,7609.68,2022-06-01T21:19:30,Vitoria-Gasteiz,expenses,leisure,-33.56,21704.57
buyer_3,Ana,Etxebarria,1989-08-23,09407087H,ana.etxebarria@cleverbyte.tech,515685,ES71209582994069256416,7609.68,2022-06-01T09:33:03,Vitoria-Gasteiz,expenses,repairs,-224.99,21479.58
buyer_3,Ana,Etxebarria,1989-08-23,09407087H,ana.etxebarria@cleverbyte.tech,515685,ES71209582994069256416,7609.68,2022-06-02T08:29:25,Vitoria-Gasteiz,expenses,taxes,-5365.16,16114.42
buyer_3,Ana,Etxebarria,1989-08-23,09407087H,ana.etxebarria@cleverbyte.tech,515685,ES71209582994069256416,7609.68,2022-06-02T09:47:11,Vitoria-Gasteiz,expenses,insurance,-1176.03,14938.39
buyer_3,Ana,Etxebarria,1989-08-23,09407087H,ana.etxebarria@cleverbyte.tech,515685,ES71209582994069256416,7609.68,2022-06-02T14:16:13,Vitoria-Gasteiz,expenses,leisure,-34.49,14903.9
buyer_3,Ana,Etxebarria,1989-08-23,09407087H,ana.etxebarria@cleverbyte.tech,515685,ES71209582994069256416,7609.68,2022-06-04T11:42:01,Vitoria-Gasteiz,expenses,food,-93.22,14810.68
buyer_3,Ana,Etxebarria,1989-08-23,09407087H,ana.etxebarria@cleverbyte.tech,515685,ES71209582994069256416,7609.68,2022-06-04T16:30:16,Vitoria-Gasteiz,expenses,leisure,-71.29,14739.39
buyer_3,Ana,Etxebarria,1989-08-23,09407087H,ana.etxebarria@cleverbyte.tech,515685,ES71209582994069256416,7609.68,2022-06-05T07:01:09,Vitoria-Gasteiz,expenses,mortgage,-2407.6,12331.79
buyer_3,Ana,Etxebarria,1989-08-23,09407087H,ana.etxebarria@cleverbyte.tech,515685,ES71209582994069256416,7609.68,2022-06-05T10:39:17,Vitoria-Gasteiz,expenses,gas,-310.98,12020.81
buyer_3,Ana,Etxebarria,1989-08-23,09407087H,ana.etxebarria@cleverbyte.tech,515685,ES71209582994069256416,7609.68,2022-06-05T00:56:40,Vitoria-Gasteiz,expenses,transport,-79.88,11940.93
buyer_3,Ana,Etxebarria,1989-08-23,09407087H,ana.etxebarria@cleverbyte.tech,515685,ES71209582994069256416,7609.68,2022-06-05T00:08:13,Vitoria-Gasteiz,expenses,clothing,-78.86,11862.07
buyer_3,Ana,Etxebarria,1989-08-23,09407087H,ana.etxebarria@cleverbyte.tech,515685,ES71209582994069256416,7609.68,2022-06-05T13:29:40,Vitoria-Gasteiz,expenses,cash,-100.0,11762.07
buyer_3,Ana,Etxebarria,1989-08-23,09407087H,ana.etxebarria@cleverbyte.tech,515685,ES71209582994069256416,7609.68,2022-06-06T18:24:06,Vitoria-Gasteiz,expenses,water,-142.8,11619.27
buyer_3,Ana,Etxebarria,1989-08-23,09407087H,ana.etxebarria@cleverbyte.tech,515685,ES71209582994069256416,7609.68,2022-06-06T15:11:27,Vitoria-Gasteiz,expenses,food,-115.86,11503.41
buyer_3,Ana,Etxebarria,1989-08-23,09407087H,ana.etxebarria@cleverbyte.tech,515685,ES71209582994069256416,7609.68,2022-06-06T20:44:08,Vitoria-Gasteiz,expenses,cash,-100.0,11403.41
buyer_3,Ana,Etxebarria,1989-08-23,09407087H,ana.etxebarria@cleverbyte.tech,515685,ES71209582994069256416,7609.68,2022-06-07T20:43:24,Vitoria-Gasteiz,expenses,electricity,-166.69,11236.72
buyer_3,Ana,Etxebarria,1989-08-23,09407087H,ana.etxebarria@cleverbyte.tech,515685,ES71209582994069256416,7609.68,2022-06-07T18:36:32,Vitoria-Gasteiz,expenses,gas,-232.94,11003.78
buyer_3,Ana,Etxebarria,1989-08-23,09407087H,ana.etxebarria@cleverbyte.tech,515685,ES71209582994069256416,7609.68,2022-06-07T09:57:51,Vitoria-Gasteiz,expenses,internet,-136.94,10866.84
buyer_3,Ana,Etxebarria,1989-08-23,09407087H,ana.etxebarria@cleverbyte.tech,515685,ES71209582994069256416,7609.68,2022-06-07T18:55:59,Vitoria-Gasteiz,expenses,food,-80.42,10786.42
buyer_3,Ana,Etxebarria,1989-08-23,09407087H,ana.etxebarria@cleverbyte.tech,515685,ES71209582994069256416,7609.68,2022-06-08T10:14:45,Vitoria-Gasteiz,expenses,water,-125.92,10660.5
buyer_3,Ana,Etxebarria,1989-08-23,09407087H,ana.etxebarria@cleverbyte.tech,515685,ES71209582994069256416,7609.68,2022-06-08T17:57:36,Vitoria-Gasteiz,expenses,repairs,-308.73,10351.77
buyer_3,Ana,Etxebarria,1989-08-23,09407087H,ana.etxebarria@cleverbyte.tech,515685,ES71209582994069256416,7609.68,2022-06-11T08:28:59,Vitoria-Gasteiz,expenses,healthcare,-80.5,10271.27
buyer_3,Ana,Etxebarria,1989-08-23,09407087H,ana.etxebarria@cleverbyte.tech,515685,ES71209582994069256416,7609.68,2022-06-11T13:21:40,Vitoria-Gasteiz,expenses,cash,-100.0,10171.27
buyer_3,Ana,Etxebarria,1989-08-23,09407087H,ana.etxebarria@cleverbyte.tech,515685,ES71209582994069256416,7609.68,2022-06-11T20:33:55,Vitoria-Gasteiz,expenses,travel,-787.44,9383.83
buyer_3,Ana,Etxebarria,1989-08-23,09407087H,ana.etxebarria@cleverbyte.tech,515685,ES71209582994069256416,7609.68,2022-06-12T08:53:34,Vitoria-Gasteiz,expenses,leisure,-26.72,9357.11
buyer_3,Ana,Etxebarria,1989-08-23,09407087H,ana.etxebarria@cleverbyte.tech,515685,ES71209582994069256416,7609.68,2022-06-15T09:28:52,Vitoria-Gasteiz,expenses,food,-122.51,9234.6
buyer_3,Ana,Etxebarria,1989-08-23,09407087H,ana.etxebarria@cleverbyte.tech,515685,ES71209582994069256416,7609.68,2022-06-15T19:22:59,Vitoria-Gasteiz,expenses,transport,-79.8,9154.8
buyer_3,Ana,Etxebarria,1989-08-23,09407087H,ana.etxebarria@cleverbyte.tech,515685,ES71209582994069256416,7609.68,2022-06-15T04:12:21,Vitoria-Gasteiz,expenses,cash,-100.0,9054.8
buyer_3,Ana,Etxebarria,1989-08-23,09407087H,ana.etxebarria@cleverbyte.tech,515685,ES71209582994069256416,7609.68,2022-06-17T15:47:55,Vitoria-Gasteiz,expenses,food,-82.87,8971.93
buyer_3,Ana,Etxebarria,1989-08-23,09407087H,ana.etxebarria@cleverbyte.tech,515685,ES71209582994069256416,7609.68,2022-06-17T10:20:10,Vitoria-Gasteiz,expenses,leisure,-64.08,8907.85
buyer_3,Ana,Etxebarria,1989-08-23,09407087H,ana.etxebarria@cleverbyte.tech,515685,ES71209582994069256416,7609.68,2022-06-19T23:26:27,Vitoria-Gasteiz,expenses,transport,-87.43,8820.42
buyer_3,Ana,Etxebarria,1989-08-23,09407087H,ana.etxebarria@cleverbyte.tech,515685,ES71209582994069256416,7609.68,2022-06-19T14:26:51,Vitoria-Gasteiz,expenses,cash,-100.0,8720.42
buyer_3,Ana,Etxebarria,1989-08-23,09407087H,ana.etxebarria@cleverbyte.tech,515685,ES71209582994069256416,7609.68,2022-06-20T15:55:59,Vitoria-Gasteiz,expenses,leisure,-20.85,8699.57
buyer_3,Ana,Etxebarria,1989-08-23,09407087H,ana.etxebarria@cleverbyte.tech,515685,ES71209582994069256416,7609.68,2022-06-21T08:13:17,Vitoria-Gasteiz,expenses,cash,-100.0,8599.57
buyer_3,Ana,Etxebarria,1989-08-23,09407087H,ana.etxebarria@cleverbyte.tech,515685,ES71209582994069256416,7609.68,2022-06-22T13:21:48,Vitoria-Gasteiz,expenses,food,-103.41,8496.16
buyer_3,Ana,Etxebarria,1989-08-23,09407087H,ana.etxebarria@cleverbyte.tech,515685,ES71209582994069256416,7609.68,2022-06-22T16:03:47,Vitoria-Gasteiz,expenses,education,-76.91,8419.25
buyer_3,Ana,Etxebarria,1989-08-23,09407087H,ana.etxebarria@cleverbyte.tech,515685,ES71209582994069256416,7609.68,2022-06-22T15:15:19,Vitoria-Gasteiz,expenses,repairs,-165.6,8253.65
buyer_3,Ana,Etxebarria,1989-08-23,09407087H,ana.etxebarria@cleverbyte.tech,515685,ES71209582994069256416,7609.68,2022-06-25T19:32:21,Vitoria-Gasteiz,expenses,transport,-40.73,8212.92
buyer_3,Ana,Etxebarria,1989-08-23,09407087H,ana.etxebarria@cleverbyte.tech,515685,ES71209582994069256416,7609.68,2022-06-25T13:14:16,Vitoria-Gasteiz,expenses,cash,-100.0,8112.92
buyer_3,Ana,Etxebarria,1989-08-23,09407087H,ana.etxebarria@cleverbyte.tech,515685,ES71209582994069256416,7609.68,2022-06-25T10:24:41,Vitoria-Gasteiz,expenses,gifts,-408.55,7704.37
buyer_3,Ana,Etxebarria,1989-08-23,09407087H,ana.etxebarria@cleverbyte.tech,515685,ES71209582994069256416,7609.68,2022-06-26T23:46:58,Vitoria-Gasteiz,expenses,clothing,-56.14,7648.23
buyer_3,Ana,Etxebarria,1989-08-23,09407087H,ana.etxebarria@cleverbyte.tech,515685,ES71209582994069256416,7609.68,2022-06-26T18:54:53,Vitoria-Gasteiz,expenses,gifts,-464.51,7183.72
buyer_3,Ana,Etxebarria,1989-08-23,09407087H,ana.etxebarria@cleverbyte.tech,515685,ES71209582994069256416,7609.68,2022-06-30T10:16:03,Vitoria-Gasteiz,expenses,transport,-84.45,7099.27
buyer_3,Ana,Etxebarria,1989-08-23,09407087H,ana.etxebarria@cleverbyte.tech,515685,ES71209582994069256416,7609.68,2022-07-01T04:46:36,Vitoria-Gasteiz,incomes,salary,3135.73,10235.0
buyer_3,Ana,Etxebarria,1989-08-23,09407087H,ana.etxebarria@cleverbyte.tech,515685,ES71209582994069256416,7609.68,2022-07-01T04:46:36,Vitoria-Gasteiz,incomes,salary_partner,3385.27,13620.27
buyer_3,Ana,Etxebarria,1989-08-23,09407087H,ana.etxebarria@cleverbyte.tech,515685,ES71209582994069256416,7609.68,2022-07-01T04:46:36,Vitoria-Gasteiz,incomes,extra_income,372.53,13992.8
buyer_3,Ana,Etxebarria,1989-08-23,09407087H,ana.etxebarria@cleverbyte.tech,515685,ES71209582994069256416,7609.68,2022-07-02T14:11:31,Vitoria-Gasteiz,expenses,clothing,-58.55,13934.25
buyer_3,Ana,Etxebarria,1989-08-23,09407087H,ana.etxebarria@cleverbyte.tech,515685,ES71209582994069256416,7609.68,2022-07-04T12:45:26,Vitoria-Gasteiz,expenses,food,-97.48,13836.77
buyer_3,Ana,Etxebarria,1989-08-23,09407087H,ana.etxebarria@cleverbyte.tech,515685,ES71209582994069256416,7609.68,2022-07-04T09:08:44,Vitoria-Gasteiz,expenses,appliances,-101.81,13734.96
buyer_3,Ana,Etxebarria,1989-08-23,09407087H,ana.etxebarria@cleverbyte.tech,515685,ES71209582994069256416,7609.68,2022-07-05T23:16:47,Vitoria-Gasteiz,expenses,mortgage,-2407.6,11327.36
buyer_3,Ana,Etxebarria,1989-08-23,09407087H,ana.etxebarria@cleverbyte.tech,515685,ES71209582994069256416,7609.68,2022-07-05T21:32:12,Vitoria-Gasteiz,expenses,water,-86.95,11240.41
buyer_3,Ana,Etxebarria,1989-08-23,09407087H,ana.etxebarria@cleverbyte.tech,515685,ES71209582994069256416,7609.68,2022-07-05T08:29:25,Vitoria-Gasteiz,expenses,electricity,-83.15,11157.26
buyer_3,Ana,Etxebarria,1989-08-23,09407087H,ana.etxebarria@cleverbyte.tech,515685,ES71209582994069256416,7609.68,2022-07-07T11:39:28,Vitoria-Gasteiz,expenses,electricity,-125.15,11032.11
buyer_3,Ana,Etxebarria,1989-08-23,09407087H,ana.etxebarria@cleverbyte.tech,515685,ES71209582994069256416,7609.68,2022-07-07T16:41:00,Vitoria-Gasteiz,expenses,gas,-279.28,10752.83
buyer_3,Ana,Etxebarria,1989-08-23,09407087H,ana.etxebarria@cleverbyte.tech,515685,ES71209582994069256416,7609.68,2022-07-08T08:28:36,Vitoria-Gasteiz,expenses,phone,-124.38,10628.45
buyer_3,Ana,Etxebarria,1989-08-23,09407087H,ana.etxebarria@cleverbyte.tech,515685,ES71209582994069256416,7609.68,2022-07-08T08:51:43,Vitoria-Gasteiz,expenses,transport,-52.58,10575.87
buyer_3,Ana,Etxebarria,1989-08-23,09407087H,ana.etxebarria@cleverbyte.tech,515685,ES71209582994069256416,7609.68,2022-07-14T10:25:06,Vitoria-Gasteiz,expenses,healthcare,-130.75,10445.12
buyer_3,Ana,Etxebarria,1989-08-23,09407087H,ana.etxebarria@cleverbyte.tech,515685,ES71209582994069256416,7609.68,2022-07-15T12:13:05,Vitoria-Gasteiz,expenses,cash,-100.0,10345.12
buyer_3,Ana,Etxebarria,1989-08-23,09407087H,ana.etxebarria@cleverbyte.tech,515685,ES71209582994069256416,7609.68,2022-07-16T09:31:23,Vitoria-Gasteiz,expenses,food,-120.15,10224.97
buyer_3,Ana,Etxebarria,1989-08-23,09407087H,ana.etxebarria@cleverbyte.tech,515685,ES71209582994069256416,7609.68,2022-07-16T15:38:25,Vitoria-Gasteiz,expenses,cash,-100.0,10124.97
buyer_3,Ana,Etxebarria,1989-08-23,09407087H,ana.etxebarria@cleverbyte.tech,515685,ES71209582994069256416,7609.68,2022-07-17T20:57:57,Vitoria-Gasteiz,expenses,leisure,-71.24,10053.73
buyer_3,Ana,Etxebarria,1989-08-23,09407087H,ana.etxebarria@cleverbyte.tech,515685,ES71209582994069256416,7609.68,2022-07-17T15:55:43,Vitoria-Gasteiz,expenses,cash,-100.0,9953.73
buyer_3,Ana,Etxebarria,1989-08-23,09407087H,ana.etxebarria@cleverbyte.tech,515685,ES71209582994069256416,7609.68,2022-07-18T17:03:55,Vitoria-Gasteiz,expenses,food,-111.77,9841.96
buyer_3,Ana,Etxebarria,1989-08-23,09407087H,ana.etxebarria@cleverbyte.tech,515685,ES71209582994069256416,7609.68,2022-07-18T12:35:17,Vitoria-Gasteiz,expenses,transport,-59.16,9782.8
buyer_3,Ana,Etxebarria,1989-08-23,09407087H,ana.etxebarria@cleverbyte.tech,515685,ES71209582994069256416,7609.68,2022-07-18T00:02:15,Vitoria-Gasteiz,expenses,cash,-100.0,9682.8
buyer_3,Ana,Etxebarria,1989-08-23,09407087H,ana.etxebarria@cleverbyte.tech,515685,ES71209582994069256416,7609.68,2022-07-19T09:03:53,Vitoria-Gasteiz,expenses,healthcare,-75.94,9606.86
buyer_3,Ana,Etxebarria,1989-08-23,09407087H,ana.etxebarria@cleverbyte.tech,515685,ES71209582994069256416,7609.68,2022-07-19T08:00:48,Vitoria-Gasteiz,expenses,education,-45.52,9561.34
buyer_3,Ana,Etxebarria,1989-08-23,09407087H,ana.etxebarria@cleverbyte.tech,515685,ES71209582994069256416,7609.68,2022-07-19T14:18:24,Vitoria-Gasteiz,expenses,cash,-100.0,9461.34
buyer_3,Ana,Etxebarria,1989-08-23,09407087H,ana.etxebarria@cleverbyte.tech,515685,ES71209582994069256416,7609.68,2022-07-20T16:23:49,Vitoria-Gasteiz,expenses,education,-76.07,9385.27
buyer_3,Ana,Etxebarria,1989-08-23,09407087H,ana.etxebarria@cleverbyte.tech,515685,ES71209582994069256416,7609.68,2022-07-22T16:43:54,Vitoria-Gasteiz,expenses,clothing,-75.59,9309.68
buyer_3,Ana,Etxebarria,1989-08-23,09407087H,ana.etxebarria@cleverbyte.tech,515685,ES71209582994069256416,7609.68,2022-07-24T01:09:35,Vitoria-Gasteiz,expenses,leisure,-61.01,9248.67
buyer_3,Ana,Etxebarria,1989-08-23,09407087H,ana.etxebarria@cleverbyte.tech,515685,ES71209582994069256416,7609.68,2022-07-25T13:00:19,Vitoria-Gasteiz,expenses,healthcare,-71.06,9177.61
buyer_3,Ana,Etxebarria,1989-08-23,09407087H,ana.etxebarria@cleverbyte.tech,515685,ES71209582994069256416,7609.68,2022-07-26T17:27:46,Vitoria-Gasteiz,expenses,leisure,-19.54,9158.07
buyer_3,Ana,Etxebarria,1989-08-23,09407087H,ana.etxebarria@cleverbyte.tech,515685,ES71209582994069256416,7609.68,2022-07-27T21:17:39,Vitoria-Gasteiz,expenses,food,-112.02,9046.05
buyer_3,Ana,Etxebarria,1989-08-23,09407087H,ana.etxebarria@cleverbyte.tech,515685,ES71209582994069256416,7609.68,2022-07-27T15:52:29,Vitoria-Gasteiz,expenses,transport,-67.26,8978.79
buyer_3,Ana,Etxebarria,1989-08-23,09407087H,ana.etxebarria@cleverbyte.tech,515685,ES71209582994069256416,7609.68,2022-07-27T11:37:31,Vitoria-Gasteiz,expenses,leisure,-49.95,8928.84
buyer_3,Ana,Etxebarria,1989-08-23,09407087H,ana.etxebarria@cleverbyte.tech,515685,ES71209582994069256416,7609.68,2022-07-27T17:21:00,Vitoria-Gasteiz,expenses,cash,-100.0,8828.84
buyer_3,Ana,Etxebarria,1989-08-23,09407087H,ana.etxebarria@cleverbyte.tech,515685,ES71209582994069256416,7609.68,2022-07-29T14:38:49,Vitoria-Gasteiz,expenses,food,-90.77,8738.07
buyer_3,Ana,Etxebarria,1989-08-23,09407087H,ana.etxebarria@cleverbyte.tech,515685,ES71209582994069256416,7609.68,2022-07-29T02:11:40,Vitoria-Gasteiz,expenses,gifts,-294.0,8444.07
buyer_3,Ana,Etxebarria,1989-08-23,09407087H,ana.etxebarria@cleverbyte.tech,515685,ES71209582994069256416,7609.68,2022-07-30T18:36:17,Vitoria-Gasteiz,expenses,food,-107.3,8336.77
buyer_3,Ana,Etxebarria,1989-08-23,09407087H,ana.etxebarria@cleverbyte.tech,515685,ES71209582994069256416,7609.68,2022-07-31T10:22:55,Vitoria-Gasteiz,expenses,transport,-82.95,8253.82
buyer_3,Ana,Etxebarria,1989-08-23,09407087H,ana.etxebarria@cleverbyte.tech,515685,ES71209582994069256416,7609.68,2022-08-01T20:18:55,Vitoria-Gasteiz,incomes,salary,3135.73,11389.55
buyer_3,Ana,Etxebarria,1989-08-23,09407087H,ana.etxebarria@cleverbyte.tech,515685,ES71209582994069256416,7609.68,2022-08-01T20:18:55,Vitoria-Gasteiz,incomes,salary_partner,3385.27,14774.82
buyer_3,Ana,Etxebarria,1989-08-23,09407087H,ana.etxebarria@cleverbyte.tech,515685,ES71209582994069256416,7609.68,2022-08-01T19:08:36,Vitoria-Gasteiz,expenses,food,-94.28,14680.54
buyer_3,Ana,Etxebarria,1989-08-23,09407087H,ana.etxebarria@cleverbyte.tech,515685,ES71209582994069256416,7609.68,2022-08-01T01:13:15,Vitoria-Gasteiz,expenses,leisure,-44.29,14636.25
buyer_3,Ana,Etxebarria,1989-08-23,09407087H,ana.etxebarria@cleverbyte.tech,515685,ES71209582994069256416,7609.68,2022-08-02T21:57:59,Vitoria-Gasteiz,expenses,transport,-49.78,14586.47
buyer_3,Ana,Etxebarria,1989-08-23,09407087H,ana.etxebarria@cleverbyte.tech,515685,ES71209582994069256416,7609.68,2022-08-02T18:31:50,Vitoria-Gasteiz,expenses,healthcare,-46.57,14539.9
buyer_3,Ana,Etxebarria,1989-08-23,09407087H,ana.etxebarria@cleverbyte.tech,515685,ES71209582994069256416,7609.68,2022-08-03T20:15:27,Vitoria-Gasteiz,expenses,gifts,-42.23,14497.67
buyer_3,Ana,Etxebarria,1989-08-23,09407087H,ana.etxebarria@cleverbyte.tech,515685,ES71209582994069256416,7609.68,2022-08-05T16:12:22,Vitoria-Gasteiz,expenses,mortgage,-2407.6,12090.07
buyer_3,Ana,Etxebarria,1989-08-23,09407087H,ana.etxebarria@cleverbyte.tech,515685,ES71209582994069256416,7609.68,2022-08-05T22:27:02,Vitoria-Gasteiz,expenses,internet,-136.94,11953.13
buyer_3,Ana,Etxebarria,1989-08-23,09407087H,ana.etxebarria@cleverbyte.tech,515685,ES71209582994069256416,7609.68,2022-08-05T19:28:46,Vitoria-Gasteiz,expenses,clothing,-82.09,11871.04
buyer_3,Ana,Etxebarria,1989-08-23,09407087H,ana.etxebarria@cleverbyte.tech,515685,ES71209582994069256416,7609.68,2022-08-06T04:57:24,Vitoria-Gasteiz,expenses,water,-140.82,11730.22
buyer_3,Ana,Etxebarria,1989-08-23,09407087H,ana.etxebarria@cleverbyte.tech,515685,ES71209582994069256416,7609.68,2022-08-06T08:20:18,Vitoria-Gasteiz,expenses,clothing,-155.63,11574.59
buyer_3,Ana,Etxebarria,1989-08-23,09407087H,ana.etxebarria@cleverbyte.tech,515685,ES71209582994069256416,7609.68,2022-08-07T08:06:56,Vitoria-Gasteiz,expenses,electricity,-213.58,11361.01
buyer_3,Ana,Etxebarria,1989-08-23,09407087H,ana.etxebarria@cleverbyte.tech,515685,ES71209582994069256416,7609.68,2022-08-07T01:38:18,Vitoria-Gasteiz,expenses,education,-72.94,11288.07
buyer_3,Ana,Etxebarria,1989-08-23,09407087H,ana.etxebarria@cleverbyte.tech,515685,ES71209582994069256416,7609.68,2022-08-07T00:46:32,Vitoria-Gasteiz,expenses,cash,-100.0,11188.07
buyer_3,Ana,Etxebarria,1989-08-23,09407087H,ana.etxebarria@cleverbyte.tech,515685,ES71209582994069256416,7609.68,2022-08-07T15:36:05,Vitoria-Gasteiz,expenses,repairs,-273.21,10914.86
buyer_3,Ana,Etxebarria,1989-08-23,09407087H,ana.etxebarria@cleverbyte.tech,515685,ES71209582994069256416,7609.68,2022-08-08T15:11:50,Vitoria-Gasteiz,expenses,water,-127.16,10787.7
buyer_3,Ana,Etxebarria,1989-08-23,09407087H,ana.etxebarria@cleverbyte.tech,515685,ES71209582994069256416,7609.68,2022-08-08T19:31:51,Vitoria-Gasteiz,expenses,internet,-136.94,10650.76
buyer_3,Ana,Etxebarria,1989-08-23,09407087H,ana.etxebarria@cleverbyte.tech,515685,ES71209582994069256416,7609.68,2022-08-12T18:32:05,Vitoria-Gasteiz,expenses,leisure,-21.42,10629.34
buyer_3,Ana,Etxebarria,1989-08-23,09407087H,ana.etxebarria@cleverbyte.tech,515685,ES71209582994069256416,7609.68,2022-08-12T10:56:37,Vitoria-Gasteiz,expenses,repairs,-166.84,10462.5
buyer_3,Ana,Etxebarria,1989-08-23,09407087H,ana.etxebarria@cleverbyte.tech,515685,ES71209582994069256416,7609.68,2022-08-14T17:29:36,Vitoria-Gasteiz,expenses,food,-122.48,10340.02
buyer_3,Ana,Etxebarria,1989-08-23,09407087H,ana.etxebarria@cleverbyte.tech,515685,ES71209582994069256416,7609.68,2022-08-14T13:38:05,Vitoria-Gasteiz,expenses,leisure,-55.81,10284.21
buyer_3,Ana,Etxebarria,1989-08-23,09407087H,ana.etxebarria@cleverbyte.tech,515685,ES71209582994069256416,7609.68,2022-08-14T08:29:23,Vitoria-Gasteiz,expenses,cash,-100.0,10184.21
buyer_3,Ana,Etxebarria,1989-08-23,09407087H,ana.etxebarria@cleverbyte.tech,515685,ES71209582994069256416,7609.68,2022-08-14T17:29:27,Vitoria-Gasteiz,expenses,repairs,-47.68,10136.53
buyer_3,Ana,Etxebarria,1989-08-23,09407087H,ana.etxebarria@cleverbyte.tech,515685,ES71209582994069256416,7609.68,2022-08-19T22:51:35,Vitoria-Gasteiz,expenses,food,-98.17,10038.36
buyer_3,Ana,Etxebarria,1989-08-23,09407087H,ana.etxebarria@cleverbyte.tech,515685,ES71209582994069256416,7609.68,2022-08-19T18:16:03,Vitoria-Gasteiz,expenses,transport,-42.0,9996.36
buyer_3,Ana,Etxebarria,1989-08-23,09407087H,ana.etxebarria@cleverbyte.tech,515685,ES71209582994069256416,7609.68,2022-08-20T10:19:44,Vitoria-Gasteiz,expenses,travel,-683.25,9313.11
buyer_3,Ana,Etxebarria,1989-08-23,09407087H,ana.etxebarria@cleverbyte.tech,515685,ES71209582994069256416,7609.68,2022-08-21T08:04:09,Vitoria-Gasteiz,expenses,cash,-100.0,9213.11
buyer_3,Ana,Etxebarria,1989-08-23,09407087H,ana.etxebarria@cleverbyte.tech,515685,ES71209582994069256416,7609.68,2022-08-22T14:07:16,Vitoria-Gasteiz,expenses,transport,-64.2,9148.91
buyer_3,Ana,Etxebarria,1989-08-23,09407087H,ana.etxebarria@cleverbyte.tech,515685,ES71209582994069256416,7609.68,2022-08-23T19:46:21,Vitoria-Gasteiz,expenses,repairs,-71.52,9077.39
buyer_3,Ana,Etxebarria,1989-08-23,09407087H,ana.etxebarria@cleverbyte.tech,515685,ES71209582994069256416,7609.68,2022-08-23T03:47:17,Vitoria-Gasteiz,expenses,gifts,-286.87,8790.52
buyer_3,Ana,Etxebarria,1989-08-23,09407087H,ana.etxebarria@cleverbyte.tech,515685,ES71209582994069256416,7609.68,2022-08-24T19:59:04,Vitoria-Gasteiz,expenses,leisure,-25.64,8764.88
buyer_3,Ana,Etxebarria,1989-08-23,09407087H,ana.etxebarria@cleverbyte.tech,515685,ES71209582994069256416,7609.68,2022-08-26T11:12:09,Vitoria-Gasteiz,expenses,food,-109.37,8655.51
buyer_3,Ana,Etxebarria,1989-08-23,09407087H,ana.etxebarria@cleverbyte.tech,515685,ES71209582994069256416,7609.68,2022-08-30T13:54:26,Vitoria-Gasteiz,expenses,leisure,-58.63,8596.88
buyer_3,Ana,Etxebarria,1989-08-23,09407087H,ana.etxebarria@cleverbyte.tech,515685,ES71209582994069256416,7609.68,2022-08-30T16:31:15,Vitoria-Gasteiz,expenses,clothing,-117.53,8479.35
buyer_3,Ana,Etxebarria,1989-08-23,09407087H,ana.etxebarria@cleverbyte.tech,515685,ES71209582994069256416,7609.68,2022-08-30T16:08:52,Vitoria-Gasteiz,expenses,cash,-100.0,8379.35
buyer_3,Ana,Etxebarria,1989-08-23,09407087H,ana.etxebarria@cleverbyte.tech,515685,ES71209582994069256416,7609.68,2022-09-01T17:31:12,Vitoria-Gasteiz,incomes,salary,3135.73,11515.08
buyer_3,Ana,Etxebarria,1989-08-23,09407087H,ana.etxebarria@cleverbyte.tech,515685,ES71209582994069256416,7609.68,2022-09-01T17:31:12,Vitoria-Gasteiz,incomes,salary_partner,3385.27,14900.35
buyer_3,Ana,Etxebarria,1989-08-23,09407087H,ana.etxebarria@cleverbyte.tech,515685,ES71209582994069256416,7609.68,2022-09-05T14:16:31,Vitoria-Gasteiz,expenses,mortgage,-2407.6,12492.75
buyer_3,Ana,Etxebarria,1989-08-23,09407087H,ana.etxebarria@cleverbyte.tech,515685,ES71209582994069256416,7609.68,2022-09-05T04:05:58,Vitoria-Gasteiz,expenses,water,-90.73,12402.02
buyer_3,Ana,Etxebarria,1989-08-23,09407087H,ana.etxebarria@cleverbyte.tech,515685,ES71209582994069256416,7609.68,2022-09-05T17:07:16,Vitoria-Gasteiz,expenses,phone,-127.05,12274.97
buyer_3,Ana,Etxebarria,1989-08-23,09407087H,ana.etxebarria@cleverbyte.tech,515685,ES71209582994069256416,7609.68,2022-09-06T11:23:30,Vitoria-Gasteiz,expenses,electricity,-214.94,12060.03
buyer_3,Ana,Etxebarria,1989-08-23,09407087H,ana.etxebarria@cleverbyte.tech,515685,ES71209582994069256416,7609.68,2022-09-06T10:36:06,Vitoria-Gasteiz,expenses,gas,-243.58,11816.45
buyer_3,Ana,Etxebarria,1989-08-23,09407087H,ana.etxebarria@cleverbyte.tech,515685,ES71209582994069256416,7609.68,2022-09-06T13:04:23,Vitoria-Gasteiz,expenses,cash,-100.0,11716.45
buyer_3,Ana,Etxebarria,1989-08-23,09407087H,ana.etxebarria@cleverbyte.tech,515685,ES71209582994069256416,7609.68,2022-09-06T09:51:48,Vitoria-Gasteiz,expenses,gifts,-748.62,10967.83
buyer_3,Ana,Etxebarria,1989-08-23,09407087H,ana.etxebarria@cleverbyte.tech,515685,ES71209582994069256416,7609.68,2022-09-07T21:05:59,Vitoria-Gasteiz,expenses,gas,-372.16,10595.67
buyer_3,Ana,Etxebarria,1989-08-23,09407087H,ana.etxebarria@cleverbyte.tech,515685,ES71209582994069256416,7609.68,2022-09-07T18:53:07,Vitoria-Gasteiz,expenses,internet,-136.94,10458.73
buyer_3,Ana,Etxebarria,1989-08-23,09407087H,ana.etxebarria@cleverbyte.tech,515685,ES71209582994069256416,7609.68,2022-09-07T11:25:25,Vitoria-Gasteiz,expenses,transport,-89.53,10369.2
buyer_3,Ana,Etxebarria,1989-08-23,09407087H,ana.etxebarria@cleverbyte.tech,515685,ES71209582994069256416,7609.68,2022-09-08T17:15:14,Vitoria-Gasteiz,expenses,gas,-348.95,10020.25
buyer_3,Ana,Etxebarria,1989-08-23,09407087H,ana.etxebarria@cleverbyte.tech,515685,ES71209582994069256416,7609.68,2022-09-08T12:05:52,Vitoria-Gasteiz,expenses,leisure,-55.59,9964.66
buyer_3,Ana,Etxebarria,1989-08-23,09407087H,ana.etxebarria@cleverbyte.tech,515685,ES71209582994069256416,7609.68,2022-09-09T21:42:07,Vitoria-Gasteiz,expenses,food,-88.87,9875.79
buyer_3,Ana,Etxebarria,1989-08-23,09407087H,ana.etxebarria@cleverbyte.tech,515685,ES71209582994069256416,7609.68,2022-09-09T19:15:49,Vitoria-Gasteiz,expenses,cash,-100.0,9775.79
buyer_3,Ana,Etxebarria,1989-08-23,09407087H,ana.etxebarria@cleverbyte.tech,515685,ES71209582994069256416,7609.68,2022-09-09T09:12:31,Vitoria-Gasteiz,expenses,gifts,-649.39,9126.4
buyer_3,Ana,Etxebarria,1989-08-23,09407087H,ana.etxebarria@cleverbyte.tech,515685,ES71209582994069256416,7609.68,2022-09-10T17:55:42,Vitoria-Gasteiz,expenses,food,-91.74,9034.66
buyer_3,Ana,Etxebarria,1989-08-23,09407087H,ana.etxebarria@cleverbyte.tech,515685,ES71209582994069256416,7609.68,2022-09-12T00:20:45,Vitoria-Gasteiz,expenses,education,-71.61,8963.05
buyer_3,Ana,Etxebarria,1989-08-23,09407087H,ana.etxebarria@cleverbyte.tech,515685,ES71209582994069256416,7609.68,2022-09-14T21:21:39,Vitoria-Gasteiz,expenses,food,-82.73,8880.32
buyer_3,Ana,Etxebarria,1989-08-23,09407087H,ana.etxebarria@cleverbyte.tech,515685,ES71209582994069256416,7609.68,2022-09-15T13:21:06,Vitoria-Gasteiz,expenses,food,-79.32,8801.0
buyer_3,Ana,Etxebarria,1989-08-23,09407087H,ana.etxebarria@cleverbyte.tech,515685,ES71209582994069256416,7609.68,2022-09-17T14:04:48,Vitoria-Gasteiz,expenses,appliances,-351.33,8449.67
buyer_3,Ana,Etxebarria,1989-08-23,09407087H,ana.etxebarria@cleverbyte.tech,515685,ES71209582994069256416,7609.68,2022-09-18T14:02:56,Vitoria-Gasteiz,expenses,leisure,-57.65,8392.02
buyer_3,Ana,Etxebarria,1989-08-23,09407087H,ana.etxebarria@cleverbyte.tech,515685,ES71209582994069256416,7609.68,2022-09-19T09:06:58,Vitoria-Gasteiz,expenses,leisure,-41.41,8350.61
buyer_3,Ana,Etxebarria,1989-08-23,09407087H,ana.etxebarria@cleverbyte.tech,515685,ES71209582994069256416,7609.68,2022-09-20T09:30:33,Vitoria-Gasteiz,expenses,leisure,-18.86,8331.75
buyer_3,Ana,Etxebarria,1989-08-23,09407087H,ana.etxebarria@cleverbyte.tech,515685,ES71209582994069256416,7609.68,2022-09-20T13:20:29,Vitoria-Gasteiz,expenses,cash,-100.0,8231.75
buyer_3,Ana,Etxebarria,1989-08-23,09407087H,ana.etxebarria@cleverbyte.tech,515685,ES71209582994069256416,7609.68,2022-09-22T14:01:49,Vitoria-Gasteiz,expenses,food,-115.65,8116.1
buyer_3,Ana,Etxebarria,1989-08-23,09407087H,ana.etxebarria@cleverbyte.tech,515685,ES71209582994069256416,7609.68,2022-09-23T00:03:52,Vitoria-Gasteiz,expenses,cash,-100.0,8016.1
buyer_3,Ana,Etxebarria,1989-08-23,09407087H,ana.etxebarria@cleverbyte.tech,515685,ES71209582994069256416,7609.68,2022-09-27T20:06:33,Vitoria-Gasteiz,expenses,transport,-58.29,7957.81
buyer_3,Ana,Etxebarria,1989-08-23,09407087H,ana.etxebarria@cleverbyte.tech,515685,ES71209582994069256416,7609.68,2022-09-27T15:26:54,Vitoria-Gasteiz,expenses,cash,-100.0,7857.81
buyer_3,Ana,Etxebarria,1989-08-23,09407087H,ana.etxebarria@cleverbyte.tech,515685,ES71209582994069256416,7609.68,2022-09-27T15:29:46,Vitoria-Gasteiz,expenses,repairs,-172.53,7685.28
buyer_3,Ana,Etxebarria,1989-08-23,09407087H,ana.etxebarria@cleverbyte.tech,515685,ES71209582994069256416,7609.68,2022-09-28T17:17:07,Vitoria-Gasteiz,expenses,repairs,-126.24,7559.04
buyer_3,Ana,Etxebarria,1989-08-23,09407087H,ana.etxebarria@cleverbyte.tech,515685,ES71209582994069256416,7609.68,2022-09-30T20:03:39,Vitoria-Gasteiz,expenses,leisure,-43.24,7515.8
buyer_3,Ana,Etxebarria,1989-08-23,09407087H,ana.etxebarria@cleverbyte.tech,515685,ES71209582994069256416,7609.68,2022-10-01T12:36:37,Vitoria-Gasteiz,incomes,salary,3135.73,10651.53
buyer_3,Ana,Etxebarria,1989-08-23,09407087H,ana.etxebarria@cleverbyte.tech,515685,ES71209582994069256416,7609.68,2022-10-01T12:36:37,Vitoria-Gasteiz,incomes,salary_partner,3385.27,14036.8
buyer_3,Ana,Etxebarria,1989-08-23,09407087H,ana.etxebarria@cleverbyte.tech,515685,ES71209582994069256416,7609.68,2022-10-02T23:32:00,Vitoria-Gasteiz,expenses,food,-124.02,13912.78
buyer_3,Ana,Etxebarria,1989-08-23,09407087H,ana.etxebarria@cleverbyte.tech,515685,ES71209582994069256416,7609.68,2022-10-03T21:43:36,Vitoria-Gasteiz,expenses,clothing,-54.61,13858.17
buyer_3,Ana,Etxebarria,1989-08-23,09407087H,ana.etxebarria@cleverbyte.tech,515685,ES71209582994069256416,7609.68,2022-10-04T19:25:30,Vitoria-Gasteiz,expenses,food,-97.07,13761.1
buyer_3,Ana,Etxebarria,1989-08-23,09407087H,ana.etxebarria@cleverbyte.tech,515685,ES71209582994069256416,7609.68,2022-10-05T13:09:29,Vitoria-Gasteiz,expenses,mortgage,-2407.6,11353.5
buyer_3,Ana,Etxebarria,1989-08-23,09407087H,ana.etxebarria@cleverbyte.tech,515685,ES71209582994069256416,7609.68,2022-10-05T14:40:35,Vitoria-Gasteiz,expenses,appliances,-304.65,11048.85
buyer_3,Ana,Etxebarria,1989-08-23,09407087H,ana.etxebarria@cleverbyte.tech,515685,ES71209582994069256416,7609.68,2022-10-06T09:42:22,Vitoria-Gasteiz,expenses,water,-111.31,10937.54
buyer_3,Ana,Etxebarria,1989-08-23,09407087H,ana.etxebarria@cleverbyte.tech,515685,ES71209582994069256416,7609.68,2022-10-06T13:42:49,Vitoria-Gasteiz,expenses,internet,-136.94,10800.6
buyer_3,Ana,Etxebarria,1989-08-23,09407087H,ana.etxebarria@cleverbyte.tech,515685,ES71209582994069256416,7609.68,2022-10-06T09:24:43,Vitoria-Gasteiz,expenses,phone,-145.84,10654.76
buyer_3,Ana,Etxebarria,1989-08-23,09407087H,ana.etxebarria@cleverbyte.tech,515685,ES71209582994069256416,7609.68,2022-10-07T16:53:09,Vitoria-Gasteiz,expenses,water,-116.42,10538.34
buyer_3,Ana,Etxebarria,1989-08-23,09407087H,ana.etxebarria@cleverbyte.tech,515685,ES71209582994069256416,7609.68,2022-10-07T11:02:29,Vitoria-Gasteiz,expenses,food,-84.52,10453.82
buyer_3,Ana,Etxebarria,1989-08-23,09407087H,ana.etxebarria@cleverbyte.tech,515685,ES71209582994069256416,7609.68,2022-10-08T20:21:33,Vitoria-Gasteiz,expenses,water,-94.79,10359.03
buyer_3,Ana,Etxebarria,1989-08-23,09407087H,ana.etxebarria@cleverbyte.tech,515685,ES71209582994069256416,7609.68,2022-10-10T22:51:46,Vitoria-Gasteiz,expenses,cash,-100.0,10259.03
buyer_3,Ana,Etxebarria,1989-08-23,09407087H,ana.etxebarria@cleverbyte.tech,515685,ES71209582994069256416,7609.68,2022-10-12T09:57:18,Vitoria-Gasteiz,expenses,food,-81.81,10177.22
buyer_3,Ana,Etxebarria,1989-08-23,09407087H,ana.etxebarria@cleverbyte.tech,515685,ES71209582994069256416,7609.68,2022-10-14T23:24:54,Vitoria-Gasteiz,expenses,food,-112.45,10064.77
buyer_3,Ana,Etxebarria,1989-08-23,09407087H,ana.etxebarria@cleverbyte.tech,515685,ES71209582994069256416,7609.68,2022-10-15T18:12:06,Vitoria-Gasteiz,expenses,leisure,-76.85,9987.92
buyer_3,Ana,Etxebarria,1989-08-23,09407087H,ana.etxebarria@cleverbyte.tech,515685,ES71209582994069256416,7609.68,2022-10-17T15:35:36,Vitoria-Gasteiz,expenses,transport,-48.17,9939.75
buyer_3,Ana,Etxebarria,1989-08-23,09407087H,ana.etxebarria@cleverbyte.tech,515685,ES71209582994069256416,7609.68,2022-10-17T14:06:16,Vitoria-Gasteiz,expenses,cash,-100.0,9839.75
buyer_3,Ana,Etxebarria,1989-08-23,09407087H,ana.etxebarria@cleverbyte.tech,515685,ES71209582994069256416,7609.68,2022-10-18T15:28:09,Vitoria-Gasteiz,expenses,transport,-64.88,9774.87
buyer_3,Ana,Etxebarria,1989-08-23,09407087H,ana.etxebarria@cleverbyte.tech,515685,ES71209582994069256416,7609.68,2022-10-19T19:42:20,Vitoria-Gasteiz,expenses,food,-70.77,9704.1
buyer_3,Ana,Etxebarria,1989-08-23,09407087H,ana.etxebarria@cleverbyte.tech,515685,ES71209582994069256416,7609.68,2022-10-20T17:30:08,Vitoria-Gasteiz,expenses,cash,-100.0,9604.1
buyer_3,Ana,Etxebarria,1989-08-23,09407087H,ana.etxebarria@cleverbyte.tech,515685,ES71209582994069256416,7609.68,2022-10-22T15:38:03,Vitoria-Gasteiz,expenses,food,-115.7,9488.4
buyer_3,Ana,Etxebarria,1989-08-23,09407087H,ana.etxebarria@cleverbyte.tech,515685,ES71209582994069256416,7609.68,2022-10-22T08:47:53,Vitoria-Gasteiz,expenses,appliances,-343.97,9144.43
buyer_3,Ana,Etxebarria,1989-08-23,09407087H,ana.etxebarria@cleverbyte.tech,515685,ES71209582994069256416,7609.68,2022-10-22T21:42:53,Vitoria-Gasteiz,expenses,gifts,-319.39,8825.04
buyer_3,Ana,Etxebarria,1989-08-23,09407087H,ana.etxebarria@cleverbyte.tech,515685,ES71209582994069256416,7609.68,2022-10-23T18:15:49,Vitoria-Gasteiz,expenses,food,-66.06,8758.98
buyer_3,Ana,Etxebarria,1989-08-23,09407087H,ana.etxebarria@cleverbyte.tech,515685,ES71209582994069256416,7609.68,2022-10-23T20:34:48,Vitoria-Gasteiz,expenses,transport,-46.52,8712.46
buyer_3,Ana,Etxebarria,1989-08-23,09407087H,ana.etxebarria@cleverbyte.tech,515685,ES71209582994069256416,7609.68,2022-10-23T15:34:15,Vitoria-Gasteiz,expenses,cash,-100.0,8612.46
buyer_3,Ana,Etxebarria,1989-08-23,09407087H,ana.etxebarria@cleverbyte.tech,515685,ES71209582994069256416,7609.68,2022-10-24T22:30:45,Vitoria-Gasteiz,expenses,appliances,-225.62,8386.84
buyer_3,Ana,Etxebarria,1989-08-23,09407087H,ana.etxebarria@cleverbyte.tech,515685,ES71209582994069256416,7609.68,2022-10-26T14:31:03,Vitoria-Gasteiz,expenses,transport,-53.93,8332.91
buyer_3,Ana,Etxebarria,1989-08-23,09407087H,ana.etxebarria@cleverbyte.tech,515685,ES71209582994069256416,7609.68,2022-10-28T11:15:32,Vitoria-Gasteiz,expenses,food,-113.49,8219.42
buyer_3,Ana,Etxebarria,1989-08-23,09407087H,ana.etxebarria@cleverbyte.tech,515685,ES71209582994069256416,7609.68,2022-10-30T15:07:14,Vitoria-Gasteiz,expenses,repairs,-331.47,7887.95
buyer_3,Ana,Etxebarria,1989-08-23,09407087H,ana.etxebarria@cleverbyte.tech,515685,ES71209582994069256416,7609.68,2022-10-31T00:06:58,Vitoria-Gasteiz,expenses,food,-100.67,7787.28
buyer_3,Ana,Etxebarria,1989-08-23,09407087H,ana.etxebarria@cleverbyte.tech,515685,ES71209582994069256416,7609.68,2022-10-31T10:33:22,Vitoria-Gasteiz,expenses,cash,-100.0,7687.28
buyer_3,Ana,Etxebarria,1989-08-23,09407087H,ana.etxebarria@cleverbyte.tech,515685,ES71209582994069256416,7609.68,2022-11-01T08:51:38,Vitoria-Gasteiz,incomes,salary,3135.73,10823.01
buyer_3,Ana,Etxebarria,1989-08-23,09407087H,ana.etxebarria@cleverbyte.tech,515685,ES71209582994069256416,7609.68,2022-11-01T08:51:38,Vitoria-Gasteiz,incomes,salary_partner,3385.27,14208.28
buyer_3,Ana,Etxebarria,1989-08-23,09407087H,ana.etxebarria@cleverbyte.tech,515685,ES71209582994069256416,7609.68,2022-11-01T08:51:38,Vitoria-Gasteiz,incomes,extra_income,372.53,14580.81
buyer_3,Ana,Etxebarria,1989-08-23,09407087H,ana.etxebarria@cleverbyte.tech,515685,ES71209582994069256416,7609.68,2022-11-01T12:19:57,Vitoria-Gasteiz,expenses,food,-93.52,14487.29
buyer_3,Ana,Etxebarria,1989-08-23,09407087H,ana.etxebarria@cleverbyte.tech,515685,ES71209582994069256416,7609.68,2022-11-02T11:54:56,Vitoria-Gasteiz,expenses,transport,-51.87,14435.42
buyer_3,Ana,Etxebarria,1989-08-23,09407087H,ana.etxebarria@cleverbyte.tech,515685,ES71209582994069256416,7609.68,2022-11-05T18:08:23,Vitoria-Gasteiz,expenses,mortgage,-2407.6,12027.82
buyer_3,Ana,Etxebarria,1989-08-23,09407087H,ana.etxebarria@cleverbyte.tech,515685,ES71209582994069256416,7609.68,2022-11-05T13:13:00,Vitoria-Gasteiz,expenses,electricity,-291.01,11736.81
buyer_3,Ana,Etxebarria,1989-08-23,09407087H,ana.etxebarria@cleverbyte.tech,515685,ES71209582994069256416,7609.68,2022-11-05T08:30:02,Vitoria-Gasteiz,expenses,gas,-255.63,11481.18
buyer_3,Ana,Etxebarria,1989-08-23,09407087H,ana.etxebarria@cleverbyte.tech,515685,ES71209582994069256416,7609.68,2022-11-05T15:43:52,Vitoria-Gasteiz,expenses,transport,-52.33,11428.85
buyer_3,Ana,Etxebarria,1989-08-23,09407087H,ana.etxebarria@cleverbyte.tech,515685,ES71209582994069256416,7609.68,2022-11-05T15:52:44,Vitoria-Gasteiz,expenses,leisure,-39.5,11389.35
buyer_3,Ana,Etxebarria,1989-08-23,09407087H,ana.etxebarria@cleverbyte.tech,515685,ES71209582994069256416,7609.68,2022-11-05T03:25:00,Vitoria-Gasteiz,expenses,repairs,-229.17,11160.18
buyer_3,Ana,Etxebarria,1989-08-23,09407087H,ana.etxebarria@cleverbyte.tech,515685,ES71209582994069256416,7609.68,2022-11-06T11:14:38,Vitoria-Gasteiz,expenses,appliances,-275.62,10884.56
buyer_3,Ana,Etxebarria,1989-08-23,09407087H,ana.etxebarria@cleverbyte.tech,515685,ES71209582994069256416,7609.68,2022-11-07T14:10:34,Vitoria-Gasteiz,expenses,water,-94.14,10790.42
buyer_3,Ana,Etxebarria,1989-08-23,09407087H,ana.etxebarria@cleverbyte.tech,515685,ES71209582994069256416,7609.68,2022-11-08T18:50:11,Vitoria-Gasteiz,expenses,gas,-330.56,10459.86
buyer_3,Ana,Etxebarria,1989-08-23,09407087H,ana.etxebarria@cleverbyte.tech,515685,ES71209582994069256416,7609.68,2022-11-09T10:14:50,Vitoria-Gasteiz,expenses,gifts,-597.59,9862.27
buyer_3,Ana,Etxebarria,1989-08-23,09407087H,ana.etxebarria@cleverbyte.tech,515685,ES71209582994069256416,7609.68,2022-11-10T08:33:15,Vitoria-Gasteiz,expenses,food,-117.76,9744.51
buyer_3,Ana,Etxebarria,1989-08-23,09407087H,ana.etxebarria@cleverbyte.tech,515685,ES71209582994069256416,7609.68,2022-11-11T15:48:11,Vitoria-Gasteiz,expenses,education,-60.09,9684.42
buyer_3,Ana,Etxebarria,1989-08-23,09407087H,ana.etxebarria@cleverbyte.tech,515685,ES71209582994069256416,7609.68,2022-11-12T16:39:22,Vitoria-Gasteiz,expenses,food,-80.87,9603.55
buyer_3,Ana,Etxebarria,1989-08-23,09407087H,ana.etxebarria@cleverbyte.tech,515685,ES71209582994069256416,7609.68,2022-11-13T15:35:23,Vitoria-Gasteiz,expenses,food,-95.06,9508.49
buyer_3,Ana,Etxebarria,1989-08-23,09407087H,ana.etxebarria@cleverbyte.tech,515685,ES71209582994069256416,7609.68,2022-11-13T16:30:28,Vitoria-Gasteiz,expenses,cash,-100.0,9408.49
buyer_3,Ana,Etxebarria,1989-08-23,09407087H,ana.etxebarria@cleverbyte.tech,515685,ES71209582994069256416,7609.68,2022-11-13T17:02:12,Vitoria-Gasteiz,expenses,repairs,-287.18,9121.31
buyer_3,Ana,Etxebarria,1989-08-23,09407087H,ana.etxebarria@cleverbyte.tech,515685,ES71209582994069256416,7609.68,2022-11-20T08:50:21,Vitoria-Gasteiz,expenses,cash,-100.0,9021.31
buyer_3,Ana,Etxebarria,1989-08-23,09407087H,ana.etxebarria@cleverbyte.tech,515685,ES71209582994069256416,7609.68,2022-11-25T20:15:05,Vitoria-Gasteiz,expenses,food,-73.92,8947.39
buyer_3,Ana,Etxebarria,1989-08-23,09407087H,ana.etxebarria@cleverbyte.tech,515685,ES71209582994069256416,7609.68,2022-11-25T03:56:01,Vitoria-Gasteiz,expenses,transport,-62.5,8884.89
buyer_3,Ana,Etxebarria,1989-08-23,09407087H,ana.etxebarria@cleverbyte.tech,515685,ES71209582994069256416,7609.68,2022-11-25T11:57:22,Vitoria-Gasteiz,expenses,repairs,-246.1,8638.79
buyer_3,Ana,Etxebarria,1989-08-23,09407087H,ana.etxebarria@cleverbyte.tech,515685,ES71209582994069256416,7609.68,2022-11-26T11:33:08,Vitoria-Gasteiz,expenses,leisure,-24.88,8613.91
buyer_3,Ana,Etxebarria,1989-08-23,09407087H,ana.etxebarria@cleverbyte.tech,515685,ES71209582994069256416,7609.68,2022-11-27T18:36:06,Vitoria-Gasteiz,expenses,transport,-86.89,8527.02
buyer_3,Ana,Etxebarria,1989-08-23,09407087H,ana.etxebarria@cleverbyte.tech,515685,ES71209582994069256416,7609.68,2022-11-27T08:05:26,Vitoria-Gasteiz,expenses,cash,-100.0,8427.02
buyer_3,Ana,Etxebarria,1989-08-23,09407087H,ana.etxebarria@cleverbyte.tech,515685,ES71209582994069256416,7609.68,2022-11-28T22:10:08,Vitoria-Gasteiz,expenses,transport,-55.51,8371.51
buyer_3,Ana,Etxebarria,1989-08-23,09407087H,ana.etxebarria@cleverbyte.tech,515685,ES71209582994069256416,7609.68,2022-12-01T21:21:40,Vitoria-Gasteiz,incomes,salary,3135.73,11507.24
buyer_3,Ana,Etxebarria,1989-08-23,09407087H,ana.etxebarria@cleverbyte.tech,515685,ES71209582994069256416,7609.68,2022-12-01T21:21:40,Vitoria-Gasteiz,incomes,salary_partner,3385.27,14892.51
buyer_3,Ana,Etxebarria,1989-08-23,09407087H,ana.etxebarria@cleverbyte.tech,515685,ES71209582994069256416,7609.68,2022-12-01T21:21:40,Vitoria-Gasteiz,incomes,salary_bonus,2270.76,17163.27
buyer_3,Ana,Etxebarria,1989-08-23,09407087H,ana.etxebarria@cleverbyte.tech,515685,ES71209582994069256416,7609.68,2022-12-01T21:21:40,Vitoria-Gasteiz,incomes,salary_partner_bonus,2432.05,19595.32
buyer_3,Ana,Etxebarria,1989-08-23,09407087H,ana.etxebarria@cleverbyte.tech,515685,ES71209582994069256416,7609.68,2022-12-01T16:15:58,Vitoria-Gasteiz,expenses,cash,-100.0,19495.32
buyer_3,Ana,Etxebarria,1989-08-23,09407087H,ana.etxebarria@cleverbyte.tech,515685,ES71209582994069256416,7609.68,2022-12-02T11:23:10,Vitoria-Gasteiz,expenses,transport,-63.4,19431.92
buyer_3,Ana,Etxebarria,1989-08-23,09407087H,ana.etxebarria@cleverbyte.tech,515685,ES71209582994069256416,7609.68,2022-12-02T09:38:07,Vitoria-Gasteiz,expenses,repairs,-206.81,19225.11
buyer_3,Ana,Etxebarria,1989-08-23,09407087H,ana.etxebarria@cleverbyte.tech,515685,ES71209582994069256416,7609.68,2022-12-03T09:08:59,Vitoria-Gasteiz,expenses,cash,-100.0,19125.11
buyer_3,Ana,Etxebarria,1989-08-23,09407087H,ana.etxebarria@cleverbyte.tech,515685,ES71209582994069256416,7609.68,2022-12-05T08:49:35,Vitoria-Gasteiz,expenses,mortgage,-2407.6,16717.51
buyer_3,Ana,Etxebarria,1989-08-23,09407087H,ana.etxebarria@cleverbyte.tech,515685,ES71209582994069256416,7609.68,2022-12-05T00:41:23,Vitoria-Gasteiz,expenses,water,-103.9,16613.61
buyer_3,Ana,Etxebarria,1989-08-23,09407087H,ana.etxebarria@cleverbyte.tech,515685,ES71209582994069256416,7609.68,2022-12-05T11:16:10,Vitoria-Gasteiz,expenses,electricity,-149.54,16464.07
buyer_3,Ana,Etxebarria,1989-08-23,09407087H,ana.etxebarria@cleverbyte.tech,515685,ES71209582994069256416,7609.68,2022-12-05T16:11:57,Vitoria-Gasteiz,expenses,gas,-291.06,16173.01
buyer_3,Ana,Etxebarria,1989-08-23,09407087H,ana.etxebarria@cleverbyte.tech,515685,ES71209582994069256416,7609.68,2022-12-05T21:22:20,Vitoria-Gasteiz,expenses,internet,-136.94,16036.07
buyer_3,Ana,Etxebarria,1989-08-23,09407087H,ana.etxebarria@cleverbyte.tech,515685,ES71209582994069256416,7609.68,2022-12-05T15:20:08,Vitoria-Gasteiz,expenses,cash,-100.0,15936.07
buyer_3,Ana,Etxebarria,1989-08-23,09407087H,ana.etxebarria@cleverbyte.tech,515685,ES71209582994069256416,7609.68,2022-12-06T12:51:49,Vitoria-Gasteiz,expenses,electricity,-204.68,15731.39
buyer_3,Ana,Etxebarria,1989-08-23,09407087H,ana.etxebarria@cleverbyte.tech,515685,ES71209582994069256416,7609.68,2022-12-07T09:04:03,Vitoria-Gasteiz,expenses,gas,-285.71,15445.68
buyer_3,Ana,Etxebarria,1989-08-23,09407087H,ana.etxebarria@cleverbyte.tech,515685,ES71209582994069256416,7609.68,2022-12-07T08:19:21,Vitoria-Gasteiz,expenses,phone,-112.22,15333.46
buyer_3,Ana,Etxebarria,1989-08-23,09407087H,ana.etxebarria@cleverbyte.tech,515685,ES71209582994069256416,7609.68,2022-12-08T13:31:53,Vitoria-Gasteiz,expenses,internet,-136.94,15196.52
buyer_3,Ana,Etxebarria,1989-08-23,09407087H,ana.etxebarria@cleverbyte.tech,515685,ES71209582994069256416,7609.68,2022-12-08T09:08:36,Vitoria-Gasteiz,expenses,transport,-76.84,15119.68
buyer_3,Ana,Etxebarria,1989-08-23,09407087H,ana.etxebarria@cleverbyte.tech,515685,ES71209582994069256416,7609.68,2022-12-10T20:04:27,Vitoria-Gasteiz,expenses,cash,-100.0,15019.68
buyer_3,Ana,Etxebarria,1989-08-23,09407087H,ana.etxebarria@cleverbyte.tech,515685,ES71209582994069256416,7609.68,2022-12-10T08:26:48,Vitoria-Gasteiz,expenses,appliances,-265.26,14754.42
buyer_3,Ana,Etxebarria,1989-08-23,09407087H,ana.etxebarria@cleverbyte.tech,515685,ES71209582994069256416,7609.68,2022-12-11T18:22:04,Vitoria-Gasteiz,expenses,leisure,-65.71,14688.71
buyer_3,Ana,Etxebarria,1989-08-23,09407087H,ana.etxebarria@cleverbyte.tech,515685,ES71209582994069256416,7609.68,2022-12-12T08:12:53,Vitoria-Gasteiz,expenses,leisure,-41.25,14647.46
buyer_3,Ana,Etxebarria,1989-08-23,09407087H,ana.etxebarria@cleverbyte.tech,515685,ES71209582994069256416,7609.68,2022-12-14T20:06:16,Vitoria-Gasteiz,expenses,cash,-100.0,14547.46
buyer_3,Ana,Etxebarria,1989-08-23,09407087H,ana.etxebarria@cleverbyte.tech,515685,ES71209582994069256416,7609.68,2022-12-17T20:26:23,Vitoria-Gasteiz,expenses,clothing,-45.18,14502.28
buyer_3,Ana,Etxebarria,1989-08-23,09407087H,ana.etxebarria@cleverbyte.tech,515685,ES71209582994069256416,7609.68,2022-12-17T07:33:55,Vitoria-Gasteiz,expenses,cash,-100.0,14402.28
buyer_3,Ana,Etxebarria,1989-08-23,09407087H,ana.etxebarria@cleverbyte.tech,515685,ES71209582994069256416,7609.68,2022-12-18T13:59:22,Vitoria-Gasteiz,expenses,food,-101.23,14301.05
buyer_3,Ana,Etxebarria,1989-08-23,09407087H,ana.etxebarria@cleverbyte.tech,515685,ES71209582994069256416,7609.68,2022-12-19T04:24:31,Vitoria-Gasteiz,expenses,food,-99.77,14201.28
buyer_3,Ana,Etxebarria,1989-08-23,09407087H,ana.etxebarria@cleverbyte.tech,515685,ES71209582994069256416,7609.68,2022-12-21T11:59:24,Vitoria-Gasteiz,expenses,food,-80.76,14120.52
buyer_3,Ana,Etxebarria,1989-08-23,09407087H,ana.etxebarria@cleverbyte.tech,515685,ES71209582994069256416,7609.68,2022-12-21T18:53:52,Vitoria-Gasteiz,expenses,repairs,-158.03,13962.49
buyer_3,Ana,Etxebarria,1989-08-23,09407087H,ana.etxebarria@cleverbyte.tech,515685,ES71209582994069256416,7609.68,2022-12-22T23:09:14,Vitoria-Gasteiz,expenses,food,-120.6,13841.89
buyer_3,Ana,Etxebarria,1989-08-23,09407087H,ana.etxebarria@cleverbyte.tech,515685,ES71209582994069256416,7609.68,2022-12-22T14:44:03,Vitoria-Gasteiz,expenses,leisure,-24.56,13817.33
buyer_3,Ana,Etxebarria,1989-08-23,09407087H,ana.etxebarria@cleverbyte.tech,515685,ES71209582994069256416,7609.68,2022-12-22T16:16:07,Vitoria-Gasteiz,expenses,clothing,-127.38,13689.95
buyer_3,Ana,Etxebarria,1989-08-23,09407087H,ana.etxebarria@cleverbyte.tech,515685,ES71209582994069256416,7609.68,2022-12-22T22:22:03,Vitoria-Gasteiz,expenses,cash,-100.0,13589.95
buyer_3,Ana,Etxebarria,1989-08-23,09407087H,ana.etxebarria@cleverbyte.tech,515685,ES71209582994069256416,7609.68,2022-12-25T12:50:36,Vitoria-Gasteiz,expenses,food,-76.51,13513.44
buyer_3,Ana,Etxebarria,1989-08-23,09407087H,ana.etxebarria@cleverbyte.tech,515685,ES71209582994069256416,7609.68,2022-12-25T07:42:26,Vitoria-Gasteiz,expenses,transport,-76.01,13437.43
buyer_3,Ana,Etxebarria,1989-08-23,09407087H,ana.etxebarria@cleverbyte.tech,515685,ES71209582994069256416,7609.68,2022-12-28T12:35:44,Vitoria-Gasteiz,expenses,clothing,-90.71,13346.72
buyer_3,Ana,Etxebarria,1989-08-23,09407087H,ana.etxebarria@cleverbyte.tech,515685,ES71209582994069256416,7609.68,2022-12-30T06:05:04,Vitoria-Gasteiz,expenses,repairs,-277.47,13069.25
buyer_3,Ana,Etxebarria,1989-08-23,09407087H,ana.etxebarria@cleverbyte.tech,515685,ES71209582994069256416,7609.68,2022-12-30T15:27:26,Vitoria-Gasteiz,expenses,gifts,-442.21,12627.04
buyer_3,Ana,Etxebarria,1989-08-23,09407087H,ana.etxebarria@cleverbyte.tech,515685,ES71209582994069256416,7609.68,2022-12-31T07:21:25,Vitoria-Gasteiz,expenses,food,-82.72,12544.32
buyer_3,Ana,Etxebarria,1989-08-23,09407087H,ana.etxebarria@cleverbyte.tech,515685,ES71209582994069256416,7609.68,2022-12-31T11:28:08,Vitoria-Gasteiz,expenses,transport,-66.21,12478.11
buyer_3,Ana,Etxebarria,1989-08-23,09407087H,ana.etxebarria@cleverbyte.tech,515685,ES71209582994069256416,7609.68,2023-01-01T08:26:21,Vitoria-Gasteiz,incomes,salary,3220.07,15698.18
buyer_3,Ana,Etxebarria,1989-08-23,09407087H,ana.etxebarria@cleverbyte.tech,515685,ES71209582994069256416,7609.68,2023-01-01T08:26:21,Vitoria-Gasteiz,incomes,salary_partner,3476.32,19174.5
buyer_3,Ana,Etxebarria,1989-08-23,09407087H,ana.etxebarria@cleverbyte.tech,515685,ES71209582994069256416,7609.68,2023-01-01T11:23:33,Vitoria-Gasteiz,expenses,clothing,-152.79,19021.71
buyer_3,Ana,Etxebarria,1989-08-23,09407087H,ana.etxebarria@cleverbyte.tech,515685,ES71209582994069256416,7609.68,2023-01-01T10:34:50,Vitoria-Gasteiz,expenses,gifts,-718.57,18303.14
buyer_3,Ana,Etxebarria,1989-08-23,09407087H,ana.etxebarria@cleverbyte.tech,515685,ES71209582994069256416,7609.68,2023-01-02T19:59:21,Vitoria-Gasteiz,expenses,leisure,-66.37,18236.77
buyer_3,Ana,Etxebarria,1989-08-23,09407087H,ana.etxebarria@cleverbyte.tech,515685,ES71209582994069256416,7609.68,2023-01-02T10:04:42,Vitoria-Gasteiz,expenses,education,-46.26,18190.51
buyer_3,Ana,Etxebarria,1989-08-23,09407087H,ana.etxebarria@cleverbyte.tech,515685,ES71209582994069256416,7609.68,2023-01-05T10:41:50,Vitoria-Gasteiz,expenses,mortgage,-3384.14,14806.37
buyer_3,Ana,Etxebarria,1989-08-23,09407087H,ana.etxebarria@cleverbyte.tech,515685,ES71209582994069256416,7609.68,2023-01-05T18:56:52,Vitoria-Gasteiz,expenses,water,-149.63,14656.74
buyer_3,Ana,Etxebarria,1989-08-23,09407087H,ana.etxebarria@cleverbyte.tech,515685,ES71209582994069256416,7609.68,2023-01-05T18:22:19,Vitoria-Gasteiz,expenses,food,-65.02,14591.72
buyer_3,Ana,Etxebarria,1989-08-23,09407087H,ana.etxebarria@cleverbyte.tech,515685,ES71209582994069256416,7609.68,2023-01-06T16:59:53,Vitoria-Gasteiz,expenses,water,-71.28,14520.44
buyer_3,Ana,Etxebarria,1989-08-23,09407087H,ana.etxebarria@cleverbyte.tech,515685,ES71209582994069256416,7609.68,2023-01-06T15:24:44,Vitoria-Gasteiz,expenses,electricity,-165.84,14354.6
buyer_3,Ana,Etxebarria,1989-08-23,09407087H,ana.etxebarria@cleverbyte.tech,515685,ES71209582994069256416,7609.68,2023-01-08T11:58:25,Vitoria-Gasteiz,expenses,water,-108.02,14246.58
buyer_3,Ana,Etxebarria,1989-08-23,09407087H,ana.etxebarria@cleverbyte.tech,515685,ES71209582994069256416,7609.68,2023-01-08T20:22:37,Vitoria-Gasteiz,expenses,internet,-140.62,14105.96
buyer_3,Ana,Etxebarria,1989-08-23,09407087H,ana.etxebarria@cleverbyte.tech,515685,ES71209582994069256416,7609.68,2023-01-09T17:59:06,Vitoria-Gasteiz,expenses,transport,-78.17,14027.79
buyer_3,Ana,Etxebarria,1989-08-23,09407087H,ana.etxebarria@cleverbyte.tech,515685,ES71209582994069256416,7609.68,2023-01-09T12:39:05,Vitoria-Gasteiz,expenses,car,-434.77,13593.02
buyer_3,Ana,Etxebarria,1989-08-23,09407087H,ana.etxebarria@cleverbyte.tech,515685,ES71209582994069256416,7609.68,2023-01-13T20:57:58,Vitoria-Gasteiz,expenses,cash,-100.0,13493.02
buyer_3,Ana,Etxebarria,1989-08-23,09407087H,ana.etxebarria@cleverbyte.tech,515685,ES71209582994069256416,7609.68,2023-01-14T18:39:21,Vitoria-Gasteiz,expenses,cash,-100.0,13393.02
buyer_3,Ana,Etxebarria,1989-08-23,09407087H,ana.etxebarria@cleverbyte.tech,515685,ES71209582994069256416,7609.68,2023-01-14T15:05:23,Vitoria-Gasteiz,expenses,travel,-751.4,12641.62
buyer_3,Ana,Etxebarria,1989-08-23,09407087H,ana.etxebarria@cleverbyte.tech,515685,ES71209582994069256416,7609.68,2023-01-16T15:52:06,Vitoria-Gasteiz,expenses,gifts,-257.76,12383.86
buyer_3,Ana,Etxebarria,1989-08-23,09407087H,ana.etxebarria@cleverbyte.tech,515685,ES71209582994069256416,7609.68,2023-01-17T18:54:58,Vitoria-Gasteiz,expenses,food,-103.14,12280.72
buyer_3,Ana,Etxebarria,1989-08-23,09407087H,ana.etxebarria@cleverbyte.tech,515685,ES71209582994069256416,7609.68,2023-01-17T16:07:48,Vitoria-Gasteiz,expenses,cash,-100.0,12180.72
buyer_3,Ana,Etxebarria,1989-08-23,09407087H,ana.etxebarria@cleverbyte.tech,515685,ES71209582994069256416,7609.68,2023-01-18T16:07:53,Vitoria-Gasteiz,expenses,cash,-100.0,12080.72
buyer_3,Ana,Etxebarria,1989-08-23,09407087H,ana.etxebarria@cleverbyte.tech,515685,ES71209582994069256416,7609.68,2023-01-19T16:21:25,Vitoria-Gasteiz,expenses,clothing,-53.94,12026.78
buyer_3,Ana,Etxebarria,1989-08-23,09407087H,ana.etxebarria@cleverbyte.tech,515685,ES71209582994069256416,7609.68,2023-01-21T11:36:22,Vitoria-Gasteiz,expenses,transport,-89.77,11937.01
buyer_3,Ana,Etxebarria,1989-08-23,09407087H,ana.etxebarria@cleverbyte.tech,515685,ES71209582994069256416,7609.68,2023-01-22T18:21:57,Vitoria-Gasteiz,expenses,gifts,-506.54,11430.47
buyer_3,Ana,Etxebarria,1989-08-23,09407087H,ana.etxebarria@cleverbyte.tech,515685,ES71209582994069256416,7609.68,2023-01-24T12:15:49,Vitoria-Gasteiz,expenses,transport,-60.71,11369.76
buyer_3,Ana,Etxebarria,1989-08-23,09407087H,ana.etxebarria@cleverbyte.tech,515685,ES71209582994069256416,7609.68,2023-01-24T08:28:15,Vitoria-Gasteiz,expenses,leisure,-73.05,11296.71
buyer_3,Ana,Etxebarria,1989-08-23,09407087H,ana.etxebarria@cleverbyte.tech,515685,ES71209582994069256416,7609.68,2023-01-26T10:31:50,Vitoria-Gasteiz,expenses,cash,-100.0,11196.71
buyer_3,Ana,Etxebarria,1989-08-23,09407087H,ana.etxebarria@cleverbyte.tech,515685,ES71209582994069256416,7609.68,2023-01-26T15:02:29,Vitoria-Gasteiz,expenses,travel,-415.88,10780.83
buyer_3,Ana,Etxebarria,1989-08-23,09407087H,ana.etxebarria@cleverbyte.tech,515685,ES71209582994069256416,7609.68,2023-01-28T10:38:17,Vitoria-Gasteiz,expenses,transport,-59.4,10721.43
buyer_3,Ana,Etxebarria,1989-08-23,09407087H,ana.etxebarria@cleverbyte.tech,515685,ES71209582994069256416,7609.68,2023-01-28T02:58:26,Vitoria-Gasteiz,expenses,cash,-100.0,10621.43
buyer_3,Ana,Etxebarria,1989-08-23,09407087H,ana.etxebarria@cleverbyte.tech,515685,ES71209582994069256416,7609.68,2023-01-29T09:28:04,Vitoria-Gasteiz,expenses,transport,-44.84,10576.59
buyer_3,Ana,Etxebarria,1989-08-23,09407087H,ana.etxebarria@cleverbyte.tech,515685,ES71209582994069256416,7609.68,2023-01-30T12:19:09,Vitoria-Gasteiz,expenses,leisure,-36.77,10539.82
buyer_3,Ana,Etxebarria,1989-08-23,09407087H,ana.etxebarria@cleverbyte.tech,515685,ES71209582994069256416,7609.68,2023-01-30T13:21:17,Vitoria-Gasteiz,expenses,repairs,-89.15,10450.67
buyer_3,Ana,Etxebarria,1989-08-23,09407087H,ana.etxebarria@cleverbyte.tech,515685,ES71209582994069256416,7609.68,2023-01-31T18:32:16,Vitoria-Gasteiz,expenses,repairs,-161.72,10288.95
buyer_3,Ana,Etxebarria,1989-08-23,09407087H,ana.etxebarria@cleverbyte.tech,515685,ES71209582994069256416,7609.68,2023-02-01T10:28:39,Vitoria-Gasteiz,incomes,salary,3220.07,13509.02
buyer_3,Ana,Etxebarria,1989-08-23,09407087H,ana.etxebarria@cleverbyte.tech,515685,ES71209582994069256416,7609.68,2023-02-01T10:28:39,Vitoria-Gasteiz,incomes,salary_partner,3476.32,16985.34
buyer_3,Ana,Etxebarria,1989-08-23,09407087H,ana.etxebarria@cleverbyte.tech,515685,ES71209582994069256416,7609.68,2023-02-01T10:28:39,Vitoria-Gasteiz,incomes,extra_income,372.53,17357.87
buyer_3,Ana,Etxebarria,1989-08-23,09407087H,ana.etxebarria@cleverbyte.tech,515685,ES71209582994069256416,7609.68,2023-02-01T19:39:57,Vitoria-Gasteiz,expenses,food,-102.2,17255.67
buyer_3,Ana,Etxebarria,1989-08-23,09407087H,ana.etxebarria@cleverbyte.tech,515685,ES71209582994069256416,7609.68,2023-02-03T23:10:19,Vitoria-Gasteiz,expenses,leisure,-49.75,17205.92
buyer_3,Ana,Etxebarria,1989-08-23,09407087H,ana.etxebarria@cleverbyte.tech,515685,ES71209582994069256416,7609.68,2023-02-03T19:19:51,Vitoria-Gasteiz,expenses,healthcare,-161.54,17044.38
buyer_3,Ana,Etxebarria,1989-08-23,09407087H,ana.etxebarria@cleverbyte.tech,515685,ES71209582994069256416,7609.68,2023-02-03T13:57:03,Vitoria-Gasteiz,expenses,cash,-100.0,16944.38
buyer_3,Ana,Etxebarria,1989-08-23,09407087H,ana.etxebarria@cleverbyte.tech,515685,ES71209582994069256416,7609.68,2023-02-04T22:39:50,Vitoria-Gasteiz,expenses,gifts,-346.34,16598.04
buyer_3,Ana,Etxebarria,1989-08-23,09407087H,ana.etxebarria@cleverbyte.tech,515685,ES71209582994069256416,7609.68,2023-02-05T10:48:13,Vitoria-Gasteiz,expenses,mortgage,-3384.14,13213.9
buyer_3,Ana,Etxebarria,1989-08-23,09407087H,ana.etxebarria@cleverbyte.tech,515685,ES71209582994069256416,7609.68,2023-02-05T23:07:13,Vitoria-Gasteiz,expenses,internet,-140.62,13073.28
buyer_3,Ana,Etxebarria,1989-08-23,09407087H,ana.etxebarria@cleverbyte.tech,515685,ES71209582994069256416,7609.68,2023-02-07T20:59:31,Vitoria-Gasteiz,expenses,water,-110.87,12962.41
buyer_3,Ana,Etxebarria,1989-08-23,09407087H,ana.etxebarria@cleverbyte.tech,515685,ES71209582994069256416,7609.68,2023-02-07T20:21:30,Vitoria-Gasteiz,expenses,internet,-140.62,12821.79
buyer_3,Ana,Etxebarria,1989-08-23,09407087H,ana.etxebarria@cleverbyte.tech,515685,ES71209582994069256416,7609.68,2023-02-07T09:19:57,Vitoria-Gasteiz,expenses,phone,-136.32,12685.47
buyer_3,Ana,Etxebarria,1989-08-23,09407087H,ana.etxebarria@cleverbyte.tech,515685,ES71209582994069256416,7609.68,2023-02-09T23:42:49,Vitoria-Gasteiz,expenses,food,-80.48,12604.99
buyer_3,Ana,Etxebarria,1989-08-23,09407087H,ana.etxebarria@cleverbyte.tech,515685,ES71209582994069256416,7609.68,2023-02-10T12:46:00,Vitoria-Gasteiz,expenses,food,-99.66,12505.33
buyer_3,Ana,Etxebarria,1989-08-23,09407087H,ana.etxebarria@cleverbyte.tech,515685,ES71209582994069256416,7609.68,2023-02-10T08:50:30,Vitoria-Gasteiz,expenses,transport,-87.96,12417.37
buyer_3,Ana,Etxebarria,1989-08-23,09407087H,ana.etxebarria@cleverbyte.tech,515685,ES71209582994069256416,7609.68,2023-02-11T22:04:52,Vitoria-Gasteiz,expenses,transport,-66.18,12351.19
buyer_3,Ana,Etxebarria,1989-08-23,09407087H,ana.etxebarria@cleverbyte.tech,515685,ES71209582994069256416,7609.68,2023-02-12T20:44:51,Vitoria-Gasteiz,expenses,transport,-63.93,12287.26
buyer_3,Ana,Etxebarria,1989-08-23,09407087H,ana.etxebarria@cleverbyte.tech,515685,ES71209582994069256416,7609.68,2023-02-12T17:15:10,Vitoria-Gasteiz,expenses,leisure,-30.39,12256.87
buyer_3,Ana,Etxebarria,1989-08-23,09407087H,ana.etxebarria@cleverbyte.tech,515685,ES71209582994069256416,7609.68,2023-02-13T04:49:52,Vitoria-Gasteiz,expenses,food,-81.8,12175.07
buyer_3,Ana,Etxebarria,1989-08-23,09407087H,ana.etxebarria@cleverbyte.tech,515685,ES71209582994069256416,7609.68,2023-02-13T20:57:27,Vitoria-Gasteiz,expenses,clothing,-113.88,12061.19
buyer_3,Ana,Etxebarria,1989-08-23,09407087H,ana.etxebarria@cleverbyte.tech,515685,ES71209582994069256416,7609.68,2023-02-14T11:28:55,Vitoria-Gasteiz,expenses,healthcare,-93.77,11967.42
buyer_3,Ana,Etxebarria,1989-08-23,09407087H,ana.etxebarria@cleverbyte.tech,515685,ES71209582994069256416,7609.68,2023-02-17T15:31:23,Vitoria-Gasteiz,expenses,cash,-100.0,11867.42
buyer_3,Ana,Etxebarria,1989-08-23,09407087H,ana.etxebarria@cleverbyte.tech,515685,ES71209582994069256416,7609.68,2023-02-18T18:40:37,Vitoria-Gasteiz,expenses,transport,-80.93,11786.49
buyer_3,Ana,Etxebarria,1989-08-23,09407087H,ana.etxebarria@cleverbyte.tech,515685,ES71209582994069256416,7609.68,2023-02-18T13:34:17,Vitoria-Gasteiz,expenses,appliances,-348.22,11438.27
buyer_3,Ana,Etxebarria,1989-08-23,09407087H,ana.etxebarria@cleverbyte.tech,515685,ES71209582994069256416,7609.68,2023-02-20T13:30:08,Vitoria-Gasteiz,expenses,repairs,-299.31,11138.96
buyer_3,Ana,Etxebarria,1989-08-23,09407087H,ana.etxebarria@cleverbyte.tech,515685,ES71209582994069256416,7609.68,2023-02-21T16:47:18,Vitoria-Gasteiz,expenses,repairs,-82.6,11056.36
buyer_3,Ana,Etxebarria,1989-08-23,09407087H,ana.etxebarria@cleverbyte.tech,515685,ES71209582994069256416,7609.68,2023-02-23T10:45:35,Vitoria-Gasteiz,expenses,appliances,-158.46,10897.9
buyer_3,Ana,Etxebarria,1989-08-23,09407087H,ana.etxebarria@cleverbyte.tech,515685,ES71209582994069256416,7609.68,2023-02-24T08:54:22,Vitoria-Gasteiz,expenses,food,-122.03,10775.87
buyer_3,Ana,Etxebarria,1989-08-23,09407087H,ana.etxebarria@cleverbyte.tech,515685,ES71209582994069256416,7609.68,2023-02-25T17:00:33,Vitoria-Gasteiz,expenses,appliances,-273.89,10501.98
buyer_3,Ana,Etxebarria,1989-08-23,09407087H,ana.etxebarria@cleverbyte.tech,515685,ES71209582994069256416,7609.68,2023-02-25T11:52:30,Vitoria-Gasteiz,expenses,gifts,-579.54,9922.44
buyer_3,Ana,Etxebarria,1989-08-23,09407087H,ana.etxebarria@cleverbyte.tech,515685,ES71209582994069256416,7609.68,2023-02-26T17:43:44,Vitoria-Gasteiz,expenses,leisure,-73.21,9849.23
buyer_3,Ana,Etxebarria,1989-08-23,09407087H,ana.etxebarria@cleverbyte.tech,515685,ES71209582994069256416,7609.68,2023-02-26T13:29:41,Vitoria-Gasteiz,expenses,repairs,-60.49,9788.74
buyer_3,Ana,Etxebarria,1989-08-23,09407087H,ana.etxebarria@cleverbyte.tech,515685,ES71209582994069256416,7609.68,2023-02-27T05:21:12,Vitoria-Gasteiz,expenses,clothing,-59.01,9729.73
buyer_3,Ana,Etxebarria,1989-08-23,09407087H,ana.etxebarria@cleverbyte.tech,515685,ES71209582994069256416,7609.68,2023-02-28T12:01:17,Vitoria-Gasteiz,expenses,cash,-100.0,9629.73
buyer_3,Ana,Etxebarria,1989-08-23,09407087H,ana.etxebarria@cleverbyte.tech,515685,ES71209582994069256416,7609.68,2023-03-01T12:57:06,Vitoria-Gasteiz,incomes,salary,3220.07,12849.8
buyer_3,Ana,Etxebarria,1989-08-23,09407087H,ana.etxebarria@cleverbyte.tech,515685,ES71209582994069256416,7609.68,2023-03-01T12:57:06,Vitoria-Gasteiz,incomes,salary_partner,3476.32,16326.12
buyer_3,Ana,Etxebarria,1989-08-23,09407087H,ana.etxebarria@cleverbyte.tech,515685,ES71209582994069256416,7609.68,2023-03-01T17:45:59,Vitoria-Gasteiz,expenses,leisure,-27.64,16298.48
buyer_3,Ana,Etxebarria,1989-08-23,09407087H,ana.etxebarria@cleverbyte.tech,515685,ES71209582994069256416,7609.68,2023-03-01T16:51:06,Vitoria-Gasteiz,expenses,cash,-100.0,16198.48
buyer_3,Ana,Etxebarria,1989-08-23,09407087H,ana.etxebarria@cleverbyte.tech,515685,ES71209582994069256416,7609.68,2023-03-02T17:55:06,Vitoria-Gasteiz,expenses,transport,-65.6,16132.88
buyer_3,Ana,Etxebarria,1989-08-23,09407087H,ana.etxebarria@cleverbyte.tech,515685,ES71209582994069256416,7609.68,2023-03-02T00:20:29,Vitoria-Gasteiz,expenses,education,-54.44,16078.44
buyer_3,Ana,Etxebarria,1989-08-23,09407087H,ana.etxebarria@cleverbyte.tech,515685,ES71209582994069256416,7609.68,2023-03-05T16:46:28,Vitoria-Gasteiz,expenses,mortgage,-3384.14,12694.3
buyer_3,Ana,Etxebarria,1989-08-23,09407087H,ana.etxebarria@cleverbyte.tech,515685,ES71209582994069256416,7609.68,2023-03-05T08:11:09,Vitoria-Gasteiz,expenses,water,-68.71,12625.59
buyer_3,Ana,Etxebarria,1989-08-23,09407087H,ana.etxebarria@cleverbyte.tech,515685,ES71209582994069256416,7609.68,2023-03-05T15:38:02,Vitoria-Gasteiz,expenses,electricity,-154.55,12471.04
buyer_3,Ana,Etxebarria,1989-08-23,09407087H,ana.etxebarria@cleverbyte.tech,515685,ES71209582994069256416,7609.68,2023-03-05T16:04:40,Vitoria-Gasteiz,expenses,internet,-140.62,12330.42
buyer_3,Ana,Etxebarria,1989-08-23,09407087H,ana.etxebarria@cleverbyte.tech,515685,ES71209582994069256416,7609.68,2023-03-05T10:17:46,Vitoria-Gasteiz,expenses,food,-119.66,12210.76
buyer_3,Ana,Etxebarria,1989-08-23,09407087H,ana.etxebarria@cleverbyte.tech,515685,ES71209582994069256416,7609.68,2023-03-05T20:55:00,Vitoria-Gasteiz,expenses,healthcare,-160.63,12050.13
buyer_3,Ana,Etxebarria,1989-08-23,09407087H,ana.etxebarria@cleverbyte.tech,515685,ES71209582994069256416,7609.68,2023-03-06T09:23:21,Vitoria-Gasteiz,expenses,phone,-143.99,11906.14
buyer_3,Ana,Etxebarria,1989-08-23,09407087H,ana.etxebarria@cleverbyte.tech,515685,ES71209582994069256416,7609.68,2023-03-08T12:09:40,Vitoria-Gasteiz,expenses,water,-97.54,11808.6
buyer_3,Ana,Etxebarria,1989-08-23,09407087H,ana.etxebarria@cleverbyte.tech,515685,ES71209582994069256416,7609.68,2023-03-08T08:20:41,Vitoria-Gasteiz,expenses,gas,-176.38,11632.22
buyer_3,Ana,Etxebarria,1989-08-23,09407087H,ana.etxebarria@cleverbyte.tech,515685,ES71209582994069256416,7609.68,2023-03-09T10:05:22,Vitoria-Gasteiz,expenses,clothing,-105.51,11526.71
buyer_3,Ana,Etxebarria,1989-08-23,09407087H,ana.etxebarria@cleverbyte.tech,515685,ES71209582994069256416,7609.68,2023-03-11T13:20:47,Vitoria-Gasteiz,expenses,clothing,-106.97,11419.74
buyer_3,Ana,Etxebarria,1989-08-23,09407087H,ana.etxebarria@cleverbyte.tech,515685,ES71209582994069256416,7609.68,2023-03-12T13:12:29,Vitoria-Gasteiz,expenses,leisure,-76.54,11343.2
buyer_3,Ana,Etxebarria,1989-08-23,09407087H,ana.etxebarria@cleverbyte.tech,515685,ES71209582994069256416,7609.68,2023-03-12T13:08:40,Vitoria-Gasteiz,expenses,cash,-100.0,11243.2
buyer_3,Ana,Etxebarria,1989-08-23,09407087H,ana.etxebarria@cleverbyte.tech,515685,ES71209582994069256416,7609.68,2023-03-13T14:07:35,Vitoria-Gasteiz,expenses,gifts,-667.56,10575.64
buyer_3,Ana,Etxebarria,1989-08-23,09407087H,ana.etxebarria@cleverbyte.tech,515685,ES71209582994069256416,7609.68,2023-03-14T00:40:23,Vitoria-Gasteiz,expenses,food,-74.29,10501.35
buyer_3,Ana,Etxebarria,1989-08-23,09407087H,ana.etxebarria@cleverbyte.tech,515685,ES71209582994069256416,7609.68,2023-03-14T07:21:15,Vitoria-Gasteiz,expenses,car,-368.54,10132.81
buyer_3,Ana,Etxebarria,1989-08-23,09407087H,ana.etxebarria@cleverbyte.tech,515685,ES71209582994069256416,7609.68,2023-03-15T19:49:47,Vitoria-Gasteiz,expenses,repairs,-308.93,9823.88
buyer_3,Ana,Etxebarria,1989-08-23,09407087H,ana.etxebarria@cleverbyte.tech,515685,ES71209582994069256416,7609.68,2023-03-16T09:21:09,Vitoria-Gasteiz,expenses,cash,-100.0,9723.88
buyer_3,Ana,Etxebarria,1989-08-23,09407087H,ana.etxebarria@cleverbyte.tech,515685,ES71209582994069256416,7609.68,2023-03-16T13:55:01,Vitoria-Gasteiz,expenses,appliances,-116.89,9606.99
buyer_3,Ana,Etxebarria,1989-08-23,09407087H,ana.etxebarria@cleverbyte.tech,515685,ES71209582994069256416,7609.68,2023-03-18T08:05:23,Vitoria-Gasteiz,expenses,education,-54.4,9552.59
buyer_3,Ana,Etxebarria,1989-08-23,09407087H,ana.etxebarria@cleverbyte.tech,515685,ES71209582994069256416,7609.68,2023-03-19T23:42:11,Vitoria-Gasteiz,expenses,clothing,-109.16,9443.43
buyer_3,Ana,Etxebarria,1989-08-23,09407087H,ana.etxebarria@cleverbyte.tech,515685,ES71209582994069256416,7609.68,2023-03-20T12:41:42,Vitoria-Gasteiz,expenses,repairs,-103.33,9340.1
buyer_3,Ana,Etxebarria,1989-08-23,09407087H,ana.etxebarria@cleverbyte.tech,515685,ES71209582994069256416,7609.68,2023-03-22T14:41:06,Vitoria-Gasteiz,expenses,leisure,-77.9,9262.2
buyer_3,Ana,Etxebarria,1989-08-23,09407087H,ana.etxebarria@cleverbyte.tech,515685,ES71209582994069256416,7609.68,2023-03-22T16:03:06,Vitoria-Gasteiz,expenses,education,-76.43,9185.77
buyer_3,Ana,Etxebarria,1989-08-23,09407087H,ana.etxebarria@cleverbyte.tech,515685,ES71209582994069256416,7609.68,2023-03-26T12:52:20,Vitoria-Gasteiz,expenses,travel,-512.74,8673.03
buyer_3,Ana,Etxebarria,1989-08-23,09407087H,ana.etxebarria@cleverbyte.tech,515685,ES71209582994069256416,7609.68,2023-03-27T18:54:53,Vitoria-Gasteiz,expenses,leisure,-22.88,8650.15
buyer_3,Ana,Etxebarria,1989-08-23,09407087H,ana.etxebarria@cleverbyte.tech,515685,ES71209582994069256416,7609.68,2023-03-31T16:35:50,Vitoria-Gasteiz,expenses,healthcare,-151.31,8498.84
buyer_3,Ana,Etxebarria,1989-08-23,09407087H,ana.etxebarria@cleverbyte.tech,515685,ES71209582994069256416,7609.68,2023-04-01T07:17:57,Vitoria-Gasteiz,incomes,salary,3220.07,11718.91
buyer_3,Ana,Etxebarria,1989-08-23,09407087H,ana.etxebarria@cleverbyte.tech,515685,ES71209582994069256416,7609.68,2023-04-01T07:17:57,Vitoria-Gasteiz,incomes,salary_partner,3476.32,15195.23
buyer_3,Ana,Etxebarria,1989-08-23,09407087H,ana.etxebarria@cleverbyte.tech,515685,ES71209582994069256416,7609.68,2023-04-01T18:13:06,Vitoria-Gasteiz,expenses,cash,-100.0,15095.23
buyer_3,Ana,Etxebarria,1989-08-23,09407087H,ana.etxebarria@cleverbyte.tech,515685,ES71209582994069256416,7609.68,2023-04-05T11:35:53,Vitoria-Gasteiz,expenses,mortgage,-3384.14,11711.09
buyer_3,Ana,Etxebarria,1989-08-23,09407087H,ana.etxebarria@cleverbyte.tech,515685,ES71209582994069256416,7609.68,2023-04-05T17:21:45,Vitoria-Gasteiz,expenses,electricity,-231.51,11479.58
buyer_3,Ana,Etxebarria,1989-08-23,09407087H,ana.etxebarria@cleverbyte.tech,515685,ES71209582994069256416,7609.68,2023-04-05T08:50:16,Vitoria-Gasteiz,expenses,leisure,-27.16,11452.42
buyer_3,Ana,Etxebarria,1989-08-23,09407087H,ana.etxebarria@cleverbyte.tech,515685,ES71209582994069256416,7609.68,2023-04-07T11:20:11,Vitoria-Gasteiz,expenses,phone,-145.82,11306.6
buyer_3,Ana,Etxebarria,1989-08-23,09407087H,ana.etxebarria@cleverbyte.tech,515685,ES71209582994069256416,7609.68,2023-04-08T17:15:06,Vitoria-Gasteiz,expenses,electricity,-126.77,11179.83
buyer_3,Ana,Etxebarria,1989-08-23,09407087H,ana.etxebarria@cleverbyte.tech,515685,ES71209582994069256416,7609.68,2023-04-08T06:55:36,Vitoria-Gasteiz,expenses,transport,-42.74,11137.09
buyer_3,Ana,Etxebarria,1989-08-23,09407087H,ana.etxebarria@cleverbyte.tech,515685,ES71209582994069256416,7609.68,2023-04-08T06:12:24,Vitoria-Gasteiz,expenses,leisure,-52.99,11084.1
buyer_3,Ana,Etxebarria,1989-08-23,09407087H,ana.etxebarria@cleverbyte.tech,515685,ES71209582994069256416,7609.68,2023-04-09T17:23:40,Vitoria-Gasteiz,expenses,food,-98.17,10985.93
buyer_3,Ana,Etxebarria,1989-08-23,09407087H,ana.etxebarria@cleverbyte.tech,515685,ES71209582994069256416,7609.68,2023-04-10T15:37:26,Vitoria-Gasteiz,expenses,food,-96.26,10889.67
buyer_3,Ana,Etxebarria,1989-08-23,09407087H,ana.etxebarria@cleverbyte.tech,515685,ES71209582994069256416,7609.68,2023-04-10T12:03:48,Vitoria-Gasteiz,expenses,appliances,-205.46,10684.21
buyer_3,Ana,Etxebarria,1989-08-23,09407087H,ana.etxebarria@cleverbyte.tech,515685,ES71209582994069256416,7609.68,2023-04-10T18:55:08,Vitoria-Gasteiz,expenses,repairs,-308.18,10376.03
buyer_3,Ana,Etxebarria,1989-08-23,09407087H,ana.etxebarria@cleverbyte.tech,515685,ES71209582994069256416,7609.68,2023-04-11T10:05:14,Vitoria-Gasteiz,expenses,food,-116.97,10259.06
buyer_3,Ana,Etxebarria,1989-08-23,09407087H,ana.etxebarria@cleverbyte.tech,515685,ES71209582994069256416,7609.68,2023-04-12T18:15:14,Vitoria-Gasteiz,expenses,cash,-100.0,10159.06
buyer_3,Ana,Etxebarria,1989-08-23,09407087H,ana.etxebarria@cleverbyte.tech,515685,ES71209582994069256416,7609.68,2023-04-14T21:22:32,Vitoria-Gasteiz,expenses,transport,-45.12,10113.94
buyer_3,Ana,Etxebarria,1989-08-23,09407087H,ana.etxebarria@cleverbyte.tech,515685,ES71209582994069256416,7609.68,2023-04-15T19:54:37,Vitoria-Gasteiz,expenses,food,-102.46,10011.48
buyer_3,Ana,Etxebarria,1989-08-23,09407087H,ana.etxebarria@cleverbyte.tech,515685,ES71209582994069256416,7609.68,2023-04-17T23:37:12,Vitoria-Gasteiz,expenses,clothing,-142.21,9869.27
buyer_3,Ana,Etxebarria,1989-08-23,09407087H,ana.etxebarria@cleverbyte.tech,515685,ES71209582994069256416,7609.68,2023-04-17T18:58:40,Vitoria-Gasteiz,expenses,education,-53.79,9815.48
buyer_3,Ana,Etxebarria,1989-08-23,09407087H,ana.etxebarria@cleverbyte.tech,515685,ES71209582994069256416,7609.68,2023-04-18T13:24:48,Vitoria-Gasteiz,expenses,transport,-42.7,9772.78
buyer_3,Ana,Etxebarria,1989-08-23,09407087H,ana.etxebarria@cleverbyte.tech,515685,ES71209582994069256416,7609.68,2023-04-18T19:00:33,Vitoria-Gasteiz,expenses,leisure,-66.69,9706.09
buyer_3,Ana,Etxebarria,1989-08-23,09407087H,ana.etxebarria@cleverbyte.tech,515685,ES71209582994069256416,7609.68,2023-04-18T17:58:37,Vitoria-Gasteiz,expenses,cash,-100.0,9606.09
buyer_3,Ana,Etxebarria,1989-08-23,09407087H,ana.etxebarria@cleverbyte.tech,515685,ES71209582994069256416,7609.68,2023-04-19T15:20:45,Vitoria-Gasteiz,expenses,transport,-43.18,9562.91
buyer_3,Ana,Etxebarria,1989-08-23,09407087H,ana.etxebarria@cleverbyte.tech,515685,ES71209582994069256416,7609.68,2023-04-19T18:41:41,Vitoria-Gasteiz,expenses,clothing,-141.47,9421.44
buyer_3,Ana,Etxebarria,1989-08-23,09407087H,ana.etxebarria@cleverbyte.tech,515685,ES71209582994069256416,7609.68,2023-04-21T19:43:23,Vitoria-Gasteiz,expenses,gifts,-174.37,9247.07
buyer_3,Ana,Etxebarria,1989-08-23,09407087H,ana.etxebarria@cleverbyte.tech,515685,ES71209582994069256416,7609.68,2023-04-22T07:51:46,Vitoria-Gasteiz,expenses,transport,-52.75,9194.32
buyer_3,Ana,Etxebarria,1989-08-23,09407087H,ana.etxebarria@cleverbyte.tech,515685,ES71209582994069256416,7609.68,2023-04-22T19:22:30,Vitoria-Gasteiz,expenses,repairs,-145.29,9049.03
buyer_3,Ana,Etxebarria,1989-08-23,09407087H,ana.etxebarria@cleverbyte.tech,515685,ES71209582994069256416,7609.68,2023-04-23T13:43:29,Vitoria-Gasteiz,expenses,food,-66.34,8982.69
buyer_3,Ana,Etxebarria,1989-08-23,09407087H,ana.etxebarria@cleverbyte.tech,515685,ES71209582994069256416,7609.68,2023-04-23T12:18:27,Vitoria-Gasteiz,expenses,appliances,-266.13,8716.56
buyer_3,Ana,Etxebarria,1989-08-23,09407087H,ana.etxebarria@cleverbyte.tech,515685,ES71209582994069256416,7609.68,2023-04-27T10:26:22,Vitoria-Gasteiz,expenses,leisure,-45.09,8671.47
buyer_3,Ana,Etxebarria,1989-08-23,09407087H,ana.etxebarria@cleverbyte.tech,515685,ES71209582994069256416,7609.68,2023-04-28T18:43:19,Vitoria-Gasteiz,expenses,food,-115.22,8556.25
buyer_3,Ana,Etxebarria,1989-08-23,09407087H,ana.etxebarria@cleverbyte.tech,515685,ES71209582994069256416,7609.68,2023-04-29T19:25:04,Vitoria-Gasteiz,expenses,leisure,-76.08,8480.17
buyer_3,Ana,Etxebarria,1989-08-23,09407087H,ana.etxebarria@cleverbyte.tech,515685,ES71209582994069256416,7609.68,2023-04-29T18:13:08,Vitoria-Gasteiz,expenses,cash,-100.0,8380.17
buyer_3,Ana,Etxebarria,1989-08-23,09407087H,ana.etxebarria@cleverbyte.tech,515685,ES71209582994069256416,7609.68,2023-04-30T18:17:58,Vitoria-Gasteiz,expenses,food,-61.04,8319.13
buyer_3,Ana,Etxebarria,1989-08-23,09407087H,ana.etxebarria@cleverbyte.tech,515685,ES71209582994069256416,7609.68,2023-05-01T17:57:44,Vitoria-Gasteiz,incomes,salary,3220.07,11539.2
buyer_3,Ana,Etxebarria,1989-08-23,09407087H,ana.etxebarria@cleverbyte.tech,515685,ES71209582994069256416,7609.68,2023-05-01T17:57:44,Vitoria-Gasteiz,incomes,salary_partner,3476.32,15015.52
buyer_3,Ana,Etxebarria,1989-08-23,09407087H,ana.etxebarria@cleverbyte.tech,515685,ES71209582994069256416,7609.68,2023-05-02T16:19:14,Vitoria-Gasteiz,expenses,food,-92.92,14922.6
buyer_3,Ana,Etxebarria,1989-08-23,09407087H,ana.etxebarria@cleverbyte.tech,515685,ES71209582994069256416,7609.68,2023-05-03T10:54:39,Vitoria-Gasteiz,expenses,food,-105.16,14817.44
buyer_3,Ana,Etxebarria,1989-08-23,09407087H,ana.etxebarria@cleverbyte.tech,515685,ES71209582994069256416,7609.68,2023-05-03T13:02:20,Vitoria-Gasteiz,expenses,clothing,-146.37,14671.07
buyer_3,Ana,Etxebarria,1989-08-23,09407087H,ana.etxebarria@cleverbyte.tech,515685,ES71209582994069256416,7609.68,2023-05-03T20:06:04,Vitoria-Gasteiz,expenses,education,-63.5,14607.57
buyer_3,Ana,Etxebarria,1989-08-23,09407087H,ana.etxebarria@cleverbyte.tech,515685,ES71209582994069256416,7609.68,2023-05-03T11:16:37,Vitoria-Gasteiz,expenses,repairs,-178.46,14429.11
buyer_3,Ana,Etxebarria,1989-08-23,09407087H,ana.etxebarria@cleverbyte.tech,515685,ES71209582994069256416,7609.68,2023-05-04T14:43:10,Vitoria-Gasteiz,expenses,food,-79.81,14349.3
buyer_3,Ana,Etxebarria,1989-08-23,09407087H,ana.etxebarria@cleverbyte.tech,515685,ES71209582994069256416,7609.68,2023-05-05T16:58:20,Vitoria-Gasteiz,expenses,mortgage,-3384.14,10965.16
buyer_3,Ana,Etxebarria,1989-08-23,09407087H,ana.etxebarria@cleverbyte.tech,515685,ES71209582994069256416,7609.68,2023-05-05T14:43:19,Vitoria-Gasteiz,expenses,water,-126.51,10838.65
buyer_3,Ana,Etxebarria,1989-08-23,09407087H,ana.etxebarria@cleverbyte.tech,515685,ES71209582994069256416,7609.68,2023-05-05T14:31:19,Vitoria-Gasteiz,expenses,electricity,-215.98,10622.67
buyer_3,Ana,Etxebarria,1989-08-23,09407087H,ana.etxebarria@cleverbyte.tech,515685,ES71209582994069256416,7609.68,2023-05-05T15:32:38,Vitoria-Gasteiz,expenses,gas,-136.31,10486.36
buyer_3,Ana,Etxebarria,1989-08-23,09407087H,ana.etxebarria@cleverbyte.tech,515685,ES71209582994069256416,7609.68,2023-05-06T12:55:29,Vitoria-Gasteiz,expenses,water,-99.74,10386.62
buyer_3,Ana,Etxebarria,1989-08-23,09407087H,ana.etxebarria@cleverbyte.tech,515685,ES71209582994069256416,7609.68,2023-05-06T13:54:03,Vitoria-Gasteiz,expenses,gas,-321.97,10064.65
buyer_3,Ana,Etxebarria,1989-08-23,09407087H,ana.etxebarria@cleverbyte.tech,515685,ES71209582994069256416,7609.68,2023-05-06T00:47:40,Vitoria-Gasteiz,expenses,internet,-140.62,9924.03
buyer_3,Ana,Etxebarria,1989-08-23,09407087H,ana.etxebarria@cleverbyte.tech,515685,ES71209582994069256416,7609.68,2023-05-06T14:35:55,Vitoria-Gasteiz,expenses,food,-115.07,9808.96
buyer_3,Ana,Etxebarria,1989-08-23,09407087H,ana.etxebarria@cleverbyte.tech,515685,ES71209582994069256416,7609.68,2023-05-06T11:31:27,Vitoria-Gasteiz,expenses,transport,-52.7,9756.26
buyer_3,Ana,Etxebarria,1989-08-23,09407087H,ana.etxebarria@cleverbyte.tech,515685,ES71209582994069256416,7609.68,2023-05-07T18:54:10,Vitoria-Gasteiz,expenses,clothing,-131.67,9624.59
buyer_3,Ana,Etxebarria,1989-08-23,09407087H,ana.etxebarria@cleverbyte.tech,515685,ES71209582994069256416,7609.68,2023-05-08T20:08:17,Vitoria-Gasteiz,expenses,phone,-102.55,9522.04
buyer_3,Ana,Etxebarria,1989-08-23,09407087H,ana.etxebarria@cleverbyte.tech,515685,ES71209582994069256416,7609.68,2023-05-10T10:04:54,Vitoria-Gasteiz,expenses,healthcare,-182.24,9339.8
buyer_3,Ana,Etxebarria,1989-08-23,09407087H,ana.etxebarria@cleverbyte.tech,515685,ES71209582994069256416,7609.68,2023-05-11T19:02:24,Vitoria-Gasteiz,expenses,food,-94.03,9245.77
buyer_3,Ana,Etxebarria,1989-08-23,09407087H,ana.etxebarria@cleverbyte.tech,515685,ES71209582994069256416,7609.68,2023-05-12T12:48:32,Vitoria-Gasteiz,expenses,transport,-52.07,9193.7
buyer_3,Ana,Etxebarria,1989-08-23,09407087H,ana.etxebarria@cleverbyte.tech,515685,ES71209582994069256416,7609.68,2023-05-13T11:08:40,Vitoria-Gasteiz,expenses,food,-95.59,9098.11
buyer_3,Ana,Etxebarria,1989-08-23,09407087H,ana.etxebarria@cleverbyte.tech,515685,ES71209582994069256416,7609.68,2023-05-13T07:34:24,Vitoria-Gasteiz,expenses,gifts,-479.7,8618.41
buyer_3,Ana,Etxebarria,1989-08-23,09407087H,ana.etxebarria@cleverbyte.tech,515685,ES71209582994069256416,7609.68,2023-05-14T16:03:22,Vitoria-Gasteiz,expenses,cash,-100.0,8518.41
buyer_3,Ana,Etxebarria,1989-08-23,09407087H,ana.etxebarria@cleverbyte.tech,515685,ES71209582994069256416,7609.68,2023-05-17T13:20:05,Vitoria-Gasteiz,expenses,food,-87.48,8430.93
buyer_3,Ana,Etxebarria,1989-08-23,09407087H,ana.etxebarria@cleverbyte.tech,515685,ES71209582994069256416,7609.68,2023-05-17T17:51:35,Vitoria-Gasteiz,expenses,gifts,-462.53,7968.4
buyer_3,Ana,Etxebarria,1989-08-23,09407087H,ana.etxebarria@cleverbyte.tech,515685,ES71209582994069256416,7609.68,2023-05-19T17:17:38,Vitoria-Gasteiz,expenses,cash,-100.0,7868.4
buyer_3,Ana,Etxebarria,1989-08-23,09407087H,ana.etxebarria@cleverbyte.tech,515685,ES71209582994069256416,7609.68,2023-05-21T14:48:40,Vitoria-Gasteiz,expenses,food,-70.6,7797.8
buyer_3,Ana,Etxebarria,1989-08-23,09407087H,ana.etxebarria@cleverbyte.tech,515685,ES71209582994069256416,7609.68,2023-05-21T15:19:30,Vitoria-Gasteiz,expenses,leisure,-40.39,7757.41
buyer_3,Ana,Etxebarria,1989-08-23,09407087H,ana.etxebarria@cleverbyte.tech,515685,ES71209582994069256416,7609.68,2023-05-26T10:28:05,Vitoria-Gasteiz,expenses,cash,-100.0,7657.41
buyer_3,Ana,Etxebarria,1989-08-23,09407087H,ana.etxebarria@cleverbyte.tech,515685,ES71209582994069256416,7609.68,2023-05-27T12:38:22,Vitoria-Gasteiz,expenses,leisure,-22.35,7635.06
buyer_3,Ana,Etxebarria,1989-08-23,09407087H,ana.etxebarria@cleverbyte.tech,515685,ES71209582994069256416,7609.68,2023-05-28T20:48:09,Vitoria-Gasteiz,expenses,food,-73.23,7561.83
buyer_3,Ana,Etxebarria,1989-08-23,09407087H,ana.etxebarria@cleverbyte.tech,515685,ES71209582994069256416,7609.68,2023-05-29T18:43:46,Vitoria-Gasteiz,expenses,clothing,-112.45,7449.38
buyer_3,Ana,Etxebarria,1989-08-23,09407087H,ana.etxebarria@cleverbyte.tech,515685,ES71209582994069256416,7609.68,2023-05-30T11:31:48,Vitoria-Gasteiz,expenses,gifts,-620.3,6829.08
buyer_3,Ana,Etxebarria,1989-08-23,09407087H,ana.etxebarria@cleverbyte.tech,515685,ES71209582994069256416,7609.68,2023-06-01T08:39:48,Vitoria-Gasteiz,incomes,salary,3220.07,10049.15
buyer_3,Ana,Etxebarria,1989-08-23,09407087H,ana.etxebarria@cleverbyte.tech,515685,ES71209582994069256416,7609.68,2023-06-01T08:39:48,Vitoria-Gasteiz,incomes,salary_partner,3476.32,13525.47
buyer_3,Ana,Etxebarria,1989-08-23,09407087H,ana.etxebarria@cleverbyte.tech,515685,ES71209582994069256416,7609.68,2023-06-01T08:39:48,Vitoria-Gasteiz,incomes,extra_income,372.53,13898.0
buyer_3,Ana,Etxebarria,1989-08-23,09407087H,ana.etxebarria@cleverbyte.tech,515685,ES71209582994069256416,7609.68,2023-06-01T08:39:48,Vitoria-Gasteiz,incomes,salary_bonus,2477.14,16375.14
buyer_3,Ana,Etxebarria,1989-08-23,09407087H,ana.etxebarria@cleverbyte.tech,515685,ES71209582994069256416,7609.68,2023-06-01T08:39:48,Vitoria-Gasteiz,incomes,salary_partner_bonus,2476.24,18851.38
buyer_3,Ana,Etxebarria,1989-08-23,09407087H,ana.etxebarria@cleverbyte.tech,515685,ES71209582994069256416,7609.68,2023-06-01T22:07:24,Vitoria-Gasteiz,expenses,taxes,-5788.41,13062.97
buyer_3,Ana,Etxebarria,1989-08-23,09407087H,ana.etxebarria@cleverbyte.tech,515685,ES71209582994069256416,7609.68,2023-06-01T20:16:15,Vitoria-Gasteiz,expenses,insurance,-1077.39,11985.58
buyer_3,Ana,Etxebarria,1989-08-23,09407087H,ana.etxebarria@cleverbyte.tech,515685,ES71209582994069256416,7609.68,2023-06-01T06:26:21,Vitoria-Gasteiz,expenses,food,-121.98,11863.6
buyer_3,Ana,Etxebarria,1989-08-23,09407087H,ana.etxebarria@cleverbyte.tech,515685,ES71209582994069256416,7609.68,2023-06-01T17:09:45,Vitoria-Gasteiz,expenses,transport,-58.66,11804.94
buyer_3,Ana,Etxebarria,1989-08-23,09407087H,ana.etxebarria@cleverbyte.tech,515685,ES71209582994069256416,7609.68,2023-06-05T12:36:24,Vitoria-Gasteiz,expenses,mortgage,-3384.14,8420.8
buyer_3,Ana,Etxebarria,1989-08-23,09407087H,ana.etxebarria@cleverbyte.tech,515685,ES71209582994069256416,7609.68,2023-06-05T11:54:37,Vitoria-Gasteiz,expenses,gas,-108.31,8312.49
buyer_3,Ana,Etxebarria,1989-08-23,09407087H,ana.etxebarria@cleverbyte.tech,515685,ES71209582994069256416,7609.68,2023-06-05T17:51:31,Vitoria-Gasteiz,expenses,food,-71.72,8240.77
buyer_3,Ana,Etxebarria,1989-08-23,09407087H,ana.etxebarria@cleverbyte.tech,515685,ES71209582994069256416,7609.68,2023-06-06T10:56:15,Vitoria-Gasteiz,expenses,electricity,-84.15,8156.62
buyer_3,Ana,Etxebarria,1989-08-23,09407087H,ana.etxebarria@cleverbyte.tech,515685,ES71209582994069256416,7609.68,2023-06-06T08:50:35,Vitoria-Gasteiz,expenses,cash,-100.0,8056.62
buyer_3,Ana,Etxebarria,1989-08-23,09407087H,ana.etxebarria@cleverbyte.tech,515685,ES71209582994069256416,7609.68,2023-06-07T06:08:15,Vitoria-Gasteiz,expenses,gas,-231.98,7824.64
buyer_3,Ana,Etxebarria,1989-08-23,09407087H,ana.etxebarria@cleverbyte.tech,515685,ES71209582994069256416,7609.68,2023-06-07T10:46:36,Vitoria-Gasteiz,expenses,internet,-140.62,7684.02
buyer_3,Ana,Etxebarria,1989-08-23,09407087H,ana.etxebarria@cleverbyte.tech,515685,ES71209582994069256416,7609.68,2023-06-07T11:13:27,Vitoria-Gasteiz,expenses,leisure,-34.99,7649.03
buyer_3,Ana,Etxebarria,1989-08-23,09407087H,ana.etxebarria@cleverbyte.tech,515685,ES71209582994069256416,7609.68,2023-06-08T08:13:09,Vitoria-Gasteiz,expenses,gas,-375.41,7273.62
buyer_3,Ana,Etxebarria,1989-08-23,09407087H,ana.etxebarria@cleverbyte.tech,515685,ES71209582994069256416,7609.68,2023-06-09T19:18:15,Vitoria-Gasteiz,expenses,cash,-100.0,7173.62
buyer_3,Ana,Etxebarria,1989-08-23,09407087H,ana.etxebarria@cleverbyte.tech,515685,ES71209582994069256416,7609.68,2023-06-12T11:16:24,Vitoria-Gasteiz,expenses,gifts,-108.32,7065.3
buyer_3,Ana,Etxebarria,1989-08-23,09407087H,ana.etxebarria@cleverbyte.tech,515685,ES71209582994069256416,7609.68,2023-06-14T09:21:06,Vitoria-Gasteiz,expenses,appliances,-259.98,6805.32
buyer_3,Ana,Etxebarria,1989-08-23,09407087H,ana.etxebarria@cleverbyte.tech,515685,ES71209582994069256416,7609.68,2023-06-14T14:21:23,Vitoria-Gasteiz,expenses,gifts,-508.09,6297.23
buyer_3,Ana,Etxebarria,1989-08-23,09407087H,ana.etxebarria@cleverbyte.tech,515685,ES71209582994069256416,7609.68,2023-06-16T08:11:12,Vitoria-Gasteiz,expenses,food,-104.95,6192.28
buyer_3,Ana,Etxebarria,1989-08-23,09407087H,ana.etxebarria@cleverbyte.tech,515685,ES71209582994069256416,7609.68,2023-06-16T22:06:41,Vitoria-Gasteiz,expenses,clothing,-136.26,6056.02
buyer_3,Ana,Etxebarria,1989-08-23,09407087H,ana.etxebarria@cleverbyte.tech,515685,ES71209582994069256416,7609.68,2023-06-17T16:03:12,Vitoria-Gasteiz,expenses,clothing,-101.34,5954.68
buyer_3,Ana,Etxebarria,1989-08-23,09407087H,ana.etxebarria@cleverbyte.tech,515685,ES71209582994069256416,7609.68,2023-06-20T18:51:59,Vitoria-Gasteiz,expenses,leisure,-70.92,5883.76
buyer_3,Ana,Etxebarria,1989-08-23,09407087H,ana.etxebarria@cleverbyte.tech,515685,ES71209582994069256416,7609.68,2023-06-20T20:50:12,Vitoria-Gasteiz,expenses,clothing,-158.76,5725.0
buyer_3,Ana,Etxebarria,1989-08-23,09407087H,ana.etxebarria@cleverbyte.tech,515685,ES71209582994069256416,7609.68,2023-06-22T17:15:38,Vitoria-Gasteiz,expenses,clothing,-70.96,5654.04
buyer_3,Ana,Etxebarria,1989-08-23,09407087H,ana.etxebarria@cleverbyte.tech,515685,ES71209582994069256416,7609.68,2023-06-23T14:24:59,Vitoria-Gasteiz,expenses,clothing,-95.2,5558.84
buyer_3,Ana,Etxebarria,1989-08-23,09407087H,ana.etxebarria@cleverbyte.tech,515685,ES71209582994069256416,7609.68,2023-06-24T09:13:54,Vitoria-Gasteiz,expenses,gifts,-579.65,4979.19
buyer_3,Ana,Etxebarria,1989-08-23,09407087H,ana.etxebarria@cleverbyte.tech,515685,ES71209582994069256416,7609.68,2023-06-25T20:01:50,Vitoria-Gasteiz,expenses,transport,-74.91,4904.28
buyer_3,Ana,Etxebarria,1989-08-23,09407087H,ana.etxebarria@cleverbyte.tech,515685,ES71209582994069256416,7609.68,2023-06-25T16:22:41,Vitoria-Gasteiz,expenses,travel,-787.02,4117.26
buyer_3,Ana,Etxebarria,1989-08-23,09407087H,ana.etxebarria@cleverbyte.tech,515685,ES71209582994069256416,7609.68,2023-06-26T04:28:27,Vitoria-Gasteiz,expenses,food,-65.47,4051.79
buyer_3,Ana,Etxebarria,1989-08-23,09407087H,ana.etxebarria@cleverbyte.tech,515685,ES71209582994069256416,7609.68,2023-06-27T02:51:32,Vitoria-Gasteiz,expenses,cash,-100.0,3951.79
buyer_3,Ana,Etxebarria,1989-08-23,09407087H,ana.etxebarria@cleverbyte.tech,515685,ES71209582994069256416,7609.68,2023-06-29T19:49:12,Vitoria-Gasteiz,expenses,education,-73.13,3878.66
buyer_3,Ana,Etxebarria,1989-08-23,09407087H,ana.etxebarria@cleverbyte.tech,515685,ES71209582994069256416,7609.68,2023-06-29T14:12:26,Vitoria-Gasteiz,expenses,cash,-100.0,3778.66
buyer_3,Ana,Etxebarria,1989-08-23,09407087H,ana.etxebarria@cleverbyte.tech,515685,ES71209582994069256416,7609.68,2023-07-01T17:22:55,Vitoria-Gasteiz,incomes,salary,3220.07,6998.73
buyer_3,Ana,Etxebarria,1989-08-23,09407087H,ana.etxebarria@cleverbyte.tech,515685,ES71209582994069256416,7609.68,2023-07-01T17:22:55,Vitoria-Gasteiz,incomes,salary_partner,3476.32,10475.05
buyer_3,Ana,Etxebarria,1989-08-23,09407087H,ana.etxebarria@cleverbyte.tech,515685,ES71209582994069256416,7609.68,2023-07-01T16:36:16,Vitoria-Gasteiz,expenses,cash,-100.0,10375.05
buyer_3,Ana,Etxebarria,1989-08-23,09407087H,ana.etxebarria@cleverbyte.tech,515685,ES71209582994069256416,7609.68,2023-07-01T08:45:15,Vitoria-Gasteiz,expenses,repairs,-142.13,10232.92
buyer_3,Ana,Etxebarria,1989-08-23,09407087H,ana.etxebarria@cleverbyte.tech,515685,ES71209582994069256416,7609.68,2023-07-02T17:24:44,Vitoria-Gasteiz,expenses,cash,-100.0,10132.92
buyer_3,Ana,Etxebarria,1989-08-23,09407087H,ana.etxebarria@cleverbyte.tech,515685,ES71209582994069256416,7609.68,2023-07-03T19:35:23,Vitoria-Gasteiz,expenses,leisure,-54.43,10078.49
buyer_3,Ana,Etxebarria,1989-08-23,09407087H,ana.etxebarria@cleverbyte.tech,515685,ES71209582994069256416,7609.68,2023-07-03T21:41:59,Vitoria-Gasteiz,expenses,repairs,-285.53,9792.96
buyer_3,Ana,Etxebarria,1989-08-23,09407087H,ana.etxebarria@cleverbyte.tech,515685,ES71209582994069256416,7609.68,2023-07-05T07:17:41,Vitoria-Gasteiz,expenses,mortgage,-3384.14,6408.82
buyer_3,Ana,Etxebarria,1989-08-23,09407087H,ana.etxebarria@cleverbyte.tech,515685,ES71209582994069256416,7609.68,2023-07-05T07:39:24,Vitoria-Gasteiz,expenses,phone,-135.67,6273.15
buyer_3,Ana,Etxebarria,1989-08-23,09407087H,ana.etxebarria@cleverbyte.tech,515685,ES71209582994069256416,7609.68,2023-07-05T08:37:06,Vitoria-Gasteiz,expenses,cash,-100.0,6173.15
buyer_3,Ana,Etxebarria,1989-08-23,09407087H,ana.etxebarria@cleverbyte.tech,515685,ES71209582994069256416,7609.68,2023-07-06T00:13:54,Vitoria-Gasteiz,expenses,phone,-147.62,6025.53
buyer_3,Ana,Etxebarria,1989-08-23,09407087H,ana.etxebarria@cleverbyte.tech,515685,ES71209582994069256416,7609.68,2023-07-07T11:17:03,Vitoria-Gasteiz,expenses,internet,-140.62,5884.91
buyer_3,Ana,Etxebarria,1989-08-23,09407087H,ana.etxebarria@cleverbyte.tech,515685,ES71209582994069256416,7609.68,2023-07-08T18:51:09,Vitoria-Gasteiz,expenses,gas,-236.58,5648.33
buyer_3,Ana,Etxebarria,1989-08-23,09407087H,ana.etxebarria@cleverbyte.tech,515685,ES71209582994069256416,7609.68,2023-07-08T08:55:21,Vitoria-Gasteiz,expenses,internet,-140.62,5507.71
buyer_3,Ana,Etxebarria,1989-08-23,09407087H,ana.etxebarria@cleverbyte.tech,515685,ES71209582994069256416,7609.68,2023-07-08T19:25:35,Vitoria-Gasteiz,expenses,leisure,-72.66,5435.05
buyer_3,Ana,Etxebarria,1989-08-23,09407087H,ana.etxebarria@cleverbyte.tech,515685,ES71209582994069256416,7609.68,2023-07-09T08:06:12,Vitoria-Gasteiz,expenses,food,-113.65,5321.4
buyer_3,Ana,Etxebarria,1989-08-23,09407087H,ana.etxebarria@cleverbyte.tech,515685,ES71209582994069256416,7609.68,2023-07-09T13:24:43,Vitoria-Gasteiz,expenses,repairs,-282.68,5038.72
buyer_3,Ana,Etxebarria,1989-08-23,09407087H,ana.etxebarria@cleverbyte.tech,515685,ES71209582994069256416,7609.68,2023-07-10T19:09:02,Vitoria-Gasteiz,expenses,cash,-100.0,4938.72
buyer_3,Ana,Etxebarria,1989-08-23,09407087H,ana.etxebarria@cleverbyte.tech,515685,ES71209582994069256416,7609.68,2023-07-10T11:40:42,Vitoria-Gasteiz,expenses,repairs,-281.39,4657.33
buyer_3,Ana,Etxebarria,1989-08-23,09407087H,ana.etxebarria@cleverbyte.tech,515685,ES71209582994069256416,7609.68,2023-07-12T08:53:22,Vitoria-Gasteiz,expenses,food,-77.38,4579.95
buyer_3,Ana,Etxebarria,1989-08-23,09407087H,ana.etxebarria@cleverbyte.tech,515685,ES71209582994069256416,7609.68,2023-07-13T11:00:05,Vitoria-Gasteiz,expenses,transport,-68.36,4511.59
buyer_3,Ana,Etxebarria,1989-08-23,09407087H,ana.etxebarria@cleverbyte.tech,515685,ES71209582994069256416,7609.68,2023-07-15T14:03:12,Vitoria-Gasteiz,expenses,gifts,-764.18,3747.41
buyer_3,Ana,Etxebarria,1989-08-23,09407087H,ana.etxebarria@cleverbyte.tech,515685,ES71209582994069256416,7609.68,2023-07-16T22:25:31,Vitoria-Gasteiz,expenses,car,-462.75,3284.66
buyer_3,Ana,Etxebarria,1989-08-23,09407087H,ana.etxebarria@cleverbyte.tech,515685,ES71209582994069256416,7609.68,2023-07-18T15:56:45,Vitoria-Gasteiz,expenses,cash,-100.0,3184.66
buyer_3,Ana,Etxebarria,1989-08-23,09407087H,ana.etxebarria@cleverbyte.tech,515685,ES71209582994069256416,7609.68,2023-07-19T10:37:19,Vitoria-Gasteiz,expenses,transport,-41.59,3143.07
buyer_3,Ana,Etxebarria,1989-08-23,09407087H,ana.etxebarria@cleverbyte.tech,515685,ES71209582994069256416,7609.68,2023-07-20T15:18:27,Vitoria-Gasteiz,expenses,cash,-100.0,3043.07
buyer_3,Ana,Etxebarria,1989-08-23,09407087H,ana.etxebarria@cleverbyte.tech,515685,ES71209582994069256416,7609.68,2023-07-23T20:39:53,Vitoria-Gasteiz,expenses,food,-120.75,2922.32
buyer_3,Ana,Etxebarria,1989-08-23,09407087H,ana.etxebarria@cleverbyte.tech,515685,ES71209582994069256416,7609.68,2023-07-23T12:10:55,Vitoria-Gasteiz,expenses,transport,-84.51,2837.81
buyer_3,Ana,Etxebarria,1989-08-23,09407087H,ana.etxebarria@cleverbyte.tech,515685,ES71209582994069256416,7609.68,2023-07-24T13:59:11,Vitoria-Gasteiz,expenses,cash,-100.0,2737.81
buyer_3,Ana,Etxebarria,1989-08-23,09407087H,ana.etxebarria@cleverbyte.tech,515685,ES71209582994069256416,7609.68,2023-07-28T16:33:55,Vitoria-Gasteiz,expenses,leisure,-78.19,2659.62
buyer_3,Ana,Etxebarria,1989-08-23,09407087H,ana.etxebarria@cleverbyte.tech,515685,ES71209582994069256416,7609.68,2023-07-29T14:25:48,Vitoria-Gasteiz,expenses,food,-87.99,2571.63
buyer_3,Ana,Etxebarria,1989-08-23,09407087H,ana.etxebarria@cleverbyte.tech,515685,ES71209582994069256416,7609.68,2023-07-30T21:31:37,Vitoria-Gasteiz,expenses,repairs,-255.43,2316.2
buyer_3,Ana,Etxebarria,1989-08-23,09407087H,ana.etxebarria@cleverbyte.tech,515685,ES71209582994069256416,7609.68,2023-08-01T20:03:11,Vitoria-Gasteiz,incomes,salary,3220.07,5536.27
buyer_3,Ana,Etxebarria,1989-08-23,09407087H,ana.etxebarria@cleverbyte.tech,515685,ES71209582994069256416,7609.68,2023-08-01T20:03:11,Vitoria-Gasteiz,incomes,salary_partner,3476.32,9012.59
buyer_3,Ana,Etxebarria,1989-08-23,09407087H,ana.etxebarria@cleverbyte.tech,515685,ES71209582994069256416,7609.68,2023-08-01T19:19:59,Vitoria-Gasteiz,expenses,cash,-100.0,8912.59
buyer_3,Ana,Etxebarria,1989-08-23,09407087H,ana.etxebarria@cleverbyte.tech,515685,ES71209582994069256416,7609.68,2023-08-02T15:05:23,Vitoria-Gasteiz,expenses,repairs,-320.03,8592.56
buyer_3,Ana,Etxebarria,1989-08-23,09407087H,ana.etxebarria@cleverbyte.tech,515685,ES71209582994069256416,7609.68,2023-08-05T13:51:32,Vitoria-Gasteiz,expenses,mortgage,-3384.14,5208.42
buyer_3,Ana,Etxebarria,1989-08-23,09407087H,ana.etxebarria@cleverbyte.tech,515685,ES71209582994069256416,7609.68,2023-08-05T09:47:25,Vitoria-Gasteiz,expenses,internet,-140.62,5067.8
buyer_3,Ana,Etxebarria,1989-08-23,09407087H,ana.etxebarria@cleverbyte.tech,515685,ES71209582994069256416,7609.68,2023-08-05T17:43:53,Vitoria-Gasteiz,expenses,repairs,-216.5,4851.3
buyer_3,Ana,Etxebarria,1989-08-23,09407087H,ana.etxebarria@cleverbyte.tech,515685,ES71209582994069256416,7609.68,2023-08-07T15:53:47,Vitoria-Gasteiz,expenses,water,-146.48,4704.82
buyer_3,Ana,Etxebarria,1989-08-23,09407087H,ana.etxebarria@cleverbyte.tech,515685,ES71209582994069256416,7609.68,2023-08-07T08:22:08,Vitoria-Gasteiz,expenses,electricity,-102.8,4602.02
buyer_3,Ana,Etxebarria,1989-08-23,09407087H,ana.etxebarria@cleverbyte.tech,515685,ES71209582994069256416,7609.68,2023-08-07T14:49:44,Vitoria-Gasteiz,expenses,food,-94.84,4507.18
buyer_3,Ana,Etxebarria,1989-08-23,09407087H,ana.etxebarria@cleverbyte.tech,515685,ES71209582994069256416,7609.68,2023-08-08T11:50:29,Vitoria-Gasteiz,expenses,electricity,-266.07,4241.11
buyer_3,Ana,Etxebarria,1989-08-23,09407087H,ana.etxebarria@cleverbyte.tech,515685,ES71209582994069256416,7609.68,2023-08-08T10:25:00,Vitoria-Gasteiz,expenses,phone,-143.34,4097.77
buyer_3,Ana,Etxebarria,1989-08-23,09407087H,ana.etxebarria@cleverbyte.tech,515685,ES71209582994069256416,7609.68,2023-08-08T11:20:06,Vitoria-Gasteiz,expenses,food,-91.66,4006.11
buyer_3,Ana,Etxebarria,1989-08-23,09407087H,ana.etxebarria@cleverbyte.tech,515685,ES71209582994069256416,7609.68,2023-08-08T16:22:40,Vitoria-Gasteiz,expenses,leisure,-58.21,3947.9
buyer_3,Ana,Etxebarria,1989-08-23,09407087H,ana.etxebarria@cleverbyte.tech,515685,ES71209582994069256416,7609.68,2023-08-08T08:03:49,Vitoria-Gasteiz,expenses,cash,-100.0,3847.9
buyer_3,Ana,Etxebarria,1989-08-23,09407087H,ana.etxebarria@cleverbyte.tech,515685,ES71209582994069256416,7609.68,2023-08-10T22:40:13,Vitoria-Gasteiz,expenses,healthcare,-140.25,3707.65
buyer_3,Ana,Etxebarria,1989-08-23,09407087H,ana.etxebarria@cleverbyte.tech,515685,ES71209582994069256416,7609.68,2023-08-10T10:39:06,Vitoria-Gasteiz,expenses,travel,-699.58,3008.07
buyer_3,Ana,Etxebarria,1989-08-23,09407087H,ana.etxebarria@cleverbyte.tech,515685,ES71209582994069256416,7609.68,2023-08-11T09:26:23,Vitoria-Gasteiz,expenses,leisure,-73.42,2934.65
buyer_3,Ana,Etxebarria,1989-08-23,09407087H,ana.etxebarria@cleverbyte.tech,515685,ES71209582994069256416,7609.68,2023-08-13T05:00:17,Vitoria-Gasteiz,expenses,food,-116.68,2817.97
buyer_3,Ana,Etxebarria,1989-08-23,09407087H,ana.etxebarria@cleverbyte.tech,515685,ES71209582994069256416,7609.68,2023-08-14T20:39:09,Vitoria-Gasteiz,expenses,transport,-83.73,2734.24
buyer_3,Ana,Etxebarria,1989-08-23,09407087H,ana.etxebarria@cleverbyte.tech,515685,ES71209582994069256416,7609.68,2023-08-15T21:02:44,Vitoria-Gasteiz,expenses,food,-108.48,2625.76
buyer_3,Ana,Etxebarria,1989-08-23,09407087H,ana.etxebarria@cleverbyte.tech,515685,ES71209582994069256416,7609.68,2023-08-16T20:59:41,Vitoria-Gasteiz,expenses,transport,-66.6,2559.16
buyer_3,Ana,Etxebarria,1989-08-23,09407087H,ana.etxebarria@cleverbyte.tech,515685,ES71209582994069256416,7609.68,2023-08-16T21:31:36,Vitoria-Gasteiz,expenses,appliances,-291.6,2267.56
buyer_3,Ana,Etxebarria,1989-08-23,09407087H,ana.etxebarria@cleverbyte.tech,515685,ES71209582994069256416,7609.68,2023-08-18T18:53:58,Vitoria-Gasteiz,expenses,leisure,-21.21,2246.35
buyer_3,Ana,Etxebarria,1989-08-23,09407087H,ana.etxebarria@cleverbyte.tech,515685,ES71209582994069256416,7609.68,2023-08-18T15:20:37,Vitoria-Gasteiz,expenses,cash,-100.0,2146.35
buyer_3,Ana,Etxebarria,1989-08-23,09407087H,ana.etxebarria@cleverbyte.tech,515685,ES71209582994069256416,7609.68,2023-08-19T12:30:16,Vitoria-Gasteiz,expenses,transport,-80.15,2066.2
buyer_3,Ana,Etxebarria,1989-08-23,09407087H,ana.etxebarria@cleverbyte.tech,515685,ES71209582994069256416,7609.68,2023-08-23T19:11:42,Vitoria-Gasteiz,expenses,transport,-45.4,2020.8
buyer_3,Ana,Etxebarria,1989-08-23,09407087H,ana.etxebarria@cleverbyte.tech,515685,ES71209582994069256416,7609.68,2023-08-26T19:56:09,Vitoria-Gasteiz,expenses,cash,-100.0,1920.8
buyer_3,Ana,Etxebarria,1989-08-23,09407087H,ana.etxebarria@cleverbyte.tech,515685,ES71209582994069256416,7609.68,2023-08-27T20:52:39,Vitoria-Gasteiz,expenses,transport,-46.23,1874.57
buyer_3,Ana,Etxebarria,1989-08-23,09407087H,ana.etxebarria@cleverbyte.tech,515685,ES71209582994069256416,7609.68,2023-08-28T19:36:49,Vitoria-Gasteiz,expenses,leisure,-41.47,1833.1
buyer_3,Ana,Etxebarria,1989-08-23,09407087H,ana.etxebarria@cleverbyte.tech,515685,ES71209582994069256416,7609.68,2023-08-29T21:30:33,Vitoria-Gasteiz,expenses,food,-69.73,1763.37
buyer_3,Ana,Etxebarria,1989-08-23,09407087H,ana.etxebarria@cleverbyte.tech,515685,ES71209582994069256416,7609.68,2023-08-30T08:31:43,Vitoria-Gasteiz,expenses,food,-61.47,1701.9
buyer_3,Ana,Etxebarria,1989-08-23,09407087H,ana.etxebarria@cleverbyte.tech,515685,ES71209582994069256416,7609.68,2023-08-30T12:58:42,Vitoria-Gasteiz,expenses,cash,-100.0,1601.9
buyer_3,Ana,Etxebarria,1989-08-23,09407087H,ana.etxebarria@cleverbyte.tech,515685,ES71209582994069256416,7609.68,2023-09-01T22:16:14,Vitoria-Gasteiz,incomes,salary,3220.07,4821.97
buyer_3,Ana,Etxebarria,1989-08-23,09407087H,ana.etxebarria@cleverbyte.tech,515685,ES71209582994069256416,7609.68,2023-09-01T22:16:14,Vitoria-Gasteiz,incomes,salary_partner,3476.32,8298.29
buyer_3,Ana,Etxebarria,1989-08-23,09407087H,ana.etxebarria@cleverbyte.tech,515685,ES71209582994069256416,7609.68,2023-09-01T22:16:14,Vitoria-Gasteiz,incomes,extra_income,372.53,8670.82
buyer_3,Ana,Etxebarria,1989-08-23,09407087H,ana.etxebarria@cleverbyte.tech,515685,ES71209582994069256416,7609.68,2023-09-01T13:06:30,Vitoria-Gasteiz,expenses,clothing,-121.27,8549.55
buyer_3,Ana,Etxebarria,1989-08-23,09407087H,ana.etxebarria@cleverbyte.tech,515685,ES71209582994069256416,7609.68,2023-09-02T17:03:09,Vitoria-Gasteiz,expenses,food,-111.25,8438.3
buyer_3,Ana,Etxebarria,1989-08-23,09407087H,ana.etxebarria@cleverbyte.tech,515685,ES71209582994069256416,7609.68,2023-09-02T13:26:15,Vitoria-Gasteiz,expenses,cash,-100.0,8338.3
buyer_3,Ana,Etxebarria,1989-08-23,09407087H,ana.etxebarria@cleverbyte.tech,515685,ES71209582994069256416,7609.68,2023-09-03T14:48:59,Vitoria-Gasteiz,expenses,repairs,-117.2,8221.1
buyer_3,Ana,Etxebarria,1989-08-23,09407087H,ana.etxebarria@cleverbyte.tech,515685,ES71209582994069256416,7609.68,2023-09-04T14:18:11,Vitoria-Gasteiz,expenses,cash,-100.0,8121.1
buyer_3,Ana,Etxebarria,1989-08-23,09407087H,ana.etxebarria@cleverbyte.tech,515685,ES71209582994069256416,7609.68,2023-09-05T11:30:01,Vitoria-Gasteiz,expenses,mortgage,-3384.14,4736.96
buyer_3,Ana,Etxebarria,1989-08-23,09407087H,ana.etxebarria@cleverbyte.tech,515685,ES71209582994069256416,7609.68,2023-09-05T21:24:26,Vitoria-Gasteiz,expenses,water,-119.98,4616.98
buyer_3,Ana,Etxebarria,1989-08-23,09407087H,ana.etxebarria@cleverbyte.tech,515685,ES71209582994069256416,7609.68,2023-09-05T08:36:15,Vitoria-Gasteiz,expenses,transport,-78.41,4538.57
buyer_3,Ana,Etxebarria,1989-08-23,09407087H,ana.etxebarria@cleverbyte.tech,515685,ES71209582994069256416,7609.68,2023-09-06T19:09:48,Vitoria-Gasteiz,expenses,water,-82.56,4456.01
buyer_3,Ana,Etxebarria,1989-08-23,09407087H,ana.etxebarria@cleverbyte.tech,515685,ES71209582994069256416,7609.68,2023-09-06T13:17:00,Vitoria-Gasteiz,expenses,cash,-100.0,4356.01
buyer_3,Ana,Etxebarria,1989-08-23,09407087H,ana.etxebarria@cleverbyte.tech,515685,ES71209582994069256416,7609.68,2023-09-07T21:52:29,Vitoria-Gasteiz,expenses,gas,-283.76,4072.25
buyer_3,Ana,Etxebarria,1989-08-23,09407087H,ana.etxebarria@cleverbyte.tech,515685,ES71209582994069256416,7609.68,2023-09-07T08:17:25,Vitoria-Gasteiz,expenses,education,-60.26,4011.99
buyer_3,Ana,Etxebarria,1989-08-23,09407087H,ana.etxebarria@cleverbyte.tech,515685,ES71209582994069256416,7609.68,2023-09-08T07:09:36,Vitoria-Gasteiz,expenses,phone,-104.91,3907.08
buyer_3,Ana,Etxebarria,1989-08-23,09407087H,ana.etxebarria@cleverbyte.tech,515685,ES71209582994069256416,7609.68,2023-09-08T01:59:56,Vitoria-Gasteiz,expenses,gifts,-563.17,3343.91
buyer_3,Ana,Etxebarria,1989-08-23,09407087H,ana.etxebarria@cleverbyte.tech,515685,ES71209582994069256416,7609.68,2023-09-09T15:20:24,Vitoria-Gasteiz,expenses,travel,-929.88,2414.03
buyer_3,Ana,Etxebarria,1989-08-23,09407087H,ana.etxebarria@cleverbyte.tech,515685,ES71209582994069256416,7609.68,2023-09-09T19:01:42,Vitoria-Gasteiz,expenses,repairs,-12.73,2401.3
buyer_3,Ana,Etxebarria,1989-08-23,09407087H,ana.etxebarria@cleverbyte.tech,515685,ES71209582994069256416,7609.68,2023-09-10T15:48:18,Vitoria-Gasteiz,expenses,food,-112.56,2288.74
buyer_3,Ana,Etxebarria,1989-08-23,09407087H,ana.etxebarria@cleverbyte.tech,515685,ES71209582994069256416,7609.68,2023-09-10T13:33:16,Vitoria-Gasteiz,expenses,cash,-100.0,2188.74
buyer_3,Ana,Etxebarria,1989-08-23,09407087H,ana.etxebarria@cleverbyte.tech,515685,ES71209582994069256416,7609.68,2023-09-11T20:32:41,Vitoria-Gasteiz,expenses,food,-104.99,2083.75
buyer_3,Ana,Etxebarria,1989-08-23,09407087H,ana.etxebarria@cleverbyte.tech,515685,ES71209582994069256416,7609.68,2023-09-11T16:36:32,Vitoria-Gasteiz,expenses,cash,-100.0,1983.75
buyer_3,Ana,Etxebarria,1989-08-23,09407087H,ana.etxebarria@cleverbyte.tech,515685,ES71209582994069256416,7609.68,2023-09-12T17:10:02,Vitoria-Gasteiz,expenses,appliances,-125.21,1858.54
buyer_3,Ana,Etxebarria,1989-08-23,09407087H,ana.etxebarria@cleverbyte.tech,515685,ES71209582994069256416,7609.68,2023-09-13T10:42:32,Vitoria-Gasteiz,expenses,leisure,-69.16,1789.38
buyer_3,Ana,Etxebarria,1989-08-23,09407087H,ana.etxebarria@cleverbyte.tech,515685,ES71209582994069256416,7609.68,2023-09-14T12:04:31,Vitoria-Gasteiz,expenses,cash,-100.0,1689.38
buyer_3,Ana,Etxebarria,1989-08-23,09407087H,ana.etxebarria@cleverbyte.tech,515685,ES71209582994069256416,7609.68,2023-09-15T15:51:04,Vitoria-Gasteiz,expenses,leisure,-47.61,1641.77
buyer_3,Ana,Etxebarria,1989-08-23,09407087H,ana.etxebarria@cleverbyte.tech,515685,ES71209582994069256416,7609.68,2023-09-16T08:56:51,Vitoria-Gasteiz,expenses,leisure,-20.74,1621.03
buyer_3,Ana,Etxebarria,1989-08-23,09407087H,ana.etxebarria@cleverbyte.tech,515685,ES71209582994069256416,7609.68,2023-09-17T12:44:37,Vitoria-Gasteiz,expenses,leisure,-78.0,1543.03
buyer_3,Ana,Etxebarria,1989-08-23,09407087H,ana.etxebarria@cleverbyte.tech,515685,ES71209582994069256416,7609.68,2023-09-18T17:38:17,Vitoria-Gasteiz,expenses,repairs,-201.06,1341.97
buyer_3,Ana,Etxebarria,1989-08-23,09407087H,ana.etxebarria@cleverbyte.tech,515685,ES71209582994069256416,7609.68,2023-09-19T10:48:05,Vitoria-Gasteiz,expenses,education,-67.73,1274.24
buyer_3,Ana,Etxebarria,1989-08-23,09407087H,ana.etxebarria@cleverbyte.tech,515685,ES71209582994069256416,7609.68,2023-09-19T19:44:43,Vitoria-Gasteiz,expenses,cash,-100.0,1174.24
buyer_3,Ana,Etxebarria,1989-08-23,09407087H,ana.etxebarria@cleverbyte.tech,515685,ES71209582994069256416,7609.68,2023-09-20T20:01:17,Vitoria-Gasteiz,expenses,transport,-45.1,1129.14
buyer_3,Ana,Etxebarria,1989-08-23,09407087H,ana.etxebarria@cleverbyte.tech,515685,ES71209582994069256416,7609.68,2023-09-23T19:11:15,Vitoria-Gasteiz,expenses,leisure,-19.21,1109.93
buyer_3,Ana,Etxebarria,1989-08-23,09407087H,ana.etxebarria@cleverbyte.tech,515685,ES71209582994069256416,7609.68,2023-09-24T15:18:24,Vitoria-Gasteiz,expenses,transport,-63.67,1046.26
buyer_3,Ana,Etxebarria,1989-08-23,09407087H,ana.etxebarria@cleverbyte.tech,515685,ES71209582994069256416,7609.68,2023-09-24T22:17:50,Vitoria-Gasteiz,expenses,leisure,-55.39,990.87
buyer_3,Ana,Etxebarria,1989-08-23,09407087H,ana.etxebarria@cleverbyte.tech,515685,ES71209582994069256416,7609.68,2023-09-24T16:44:28,Vitoria-Gasteiz,expenses,clothing,-76.09,914.78
buyer_3,Ana,Etxebarria,1989-08-23,09407087H,ana.etxebarria@cleverbyte.tech,515685,ES71209582994069256416,7609.68,2023-09-27T09:11:31,Vitoria-Gasteiz,expenses,cash,-100.0,814.78
buyer_3,Ana,Etxebarria,1989-08-23,09407087H,ana.etxebarria@cleverbyte.tech,515685,ES71209582994069256416,7609.68,2023-09-28T16:59:56,Vitoria-Gasteiz,expenses,food,-97.06,717.72
buyer_3,Ana,Etxebarria,1989-08-23,09407087H,ana.etxebarria@cleverbyte.tech,515685,ES71209582994069256416,7609.68,2023-09-30T20:31:17,Vitoria-Gasteiz,expenses,healthcare,-136.78,580.94
buyer_3,Ana,Etxebarria,1989-08-23,09407087H,ana.etxebarria@cleverbyte.tech,515685,ES71209582994069256416,7609.68,2023-10-01T12:26:41,Vitoria-Gasteiz,incomes,salary,3220.07,3801.01
buyer_3,Ana,Etxebarria,1989-08-23,09407087H,ana.etxebarria@cleverbyte.tech,515685,ES71209582994069256416,7609.68,2023-10-01T12:26:41,Vitoria-Gasteiz,incomes,salary_partner,3476.32,7277.33
buyer_3,Ana,Etxebarria,1989-08-23,09407087H,ana.etxebarria@cleverbyte.tech,515685,ES71209582994069256416,7609.68,2023-10-05T20:41:52,Vitoria-Gasteiz,expenses,mortgage,-3384.14,3893.19
buyer_3,Ana,Etxebarria,1989-08-23,09407087H,ana.etxebarria@cleverbyte.tech,515685,ES71209582994069256416,7609.68,2023-10-05T19:22:31,Vitoria-Gasteiz,expenses,phone,-147.2,3745.99
buyer_3,Ana,Etxebarria,1989-08-23,09407087H,ana.etxebarria@cleverbyte.tech,515685,ES71209582994069256416,7609.68,2023-10-05T15:06:13,Vitoria-Gasteiz,expenses,food,-68.64,3677.35
buyer_3,Ana,Etxebarria,1989-08-23,09407087H,ana.etxebarria@cleverbyte.tech,515685,ES71209582994069256416,7609.68,2023-10-05T18:49:30,Vitoria-Gasteiz,expenses,repairs,-268.35,3409.0
buyer_3,Ana,Etxebarria,1989-08-23,09407087H,ana.etxebarria@cleverbyte.tech,515685,ES71209582994069256416,7609.68,2023-10-06T17:32:06,Vitoria-Gasteiz,expenses,water,-91.44,3317.56
buyer_3,Ana,Etxebarria,1989-08-23,09407087H,ana.etxebarria@cleverbyte.tech,515685,ES71209582994069256416,7609.68,2023-10-06T00:49:30,Vitoria-Gasteiz,expenses,internet,-140.62,3176.94
buyer_3,Ana,Etxebarria,1989-08-23,09407087H,ana.etxebarria@cleverbyte.tech,515685,ES71209582994069256416,7609.68,2023-10-06T04:28:47,Vitoria-Gasteiz,expenses,phone,-125.66,3051.28
buyer_3,Ana,Etxebarria,1989-08-23,09407087H,ana.etxebarria@cleverbyte.tech,515685,ES71209582994069256416,7609.68,2023-10-07T17:37:23,Vitoria-Gasteiz,expenses,electricity,-259.24,2792.04
buyer_3,Ana,Etxebarria,1989-08-23,09407087H,ana.etxebarria@cleverbyte.tech,515685,ES71209582994069256416,7609.68,2023-10-07T22:10:49,Vitoria-Gasteiz,expenses,food,-72.61,2719.43
buyer_3,Ana,Etxebarria,1989-08-23,09407087H,ana.etxebarria@cleverbyte.tech,515685,ES71209582994069256416,7609.68,2023-10-07T14:00:14,Vitoria-Gasteiz,expenses,clothing,-115.38,2604.05
buyer_3,Ana,Etxebarria,1989-08-23,09407087H,ana.etxebarria@cleverbyte.tech,515685,ES71209582994069256416,7609.68,2023-10-08T14:50:38,Vitoria-Gasteiz,expenses,water,-72.41,2531.64
buyer_3,Ana,Etxebarria,1989-08-23,09407087H,ana.etxebarria@cleverbyte.tech,515685,ES71209582994069256416,7609.68,2023-10-08T11:47:29,Vitoria-Gasteiz,expenses,internet,-140.62,2391.02
buyer_3,Ana,Etxebarria,1989-08-23,09407087H,ana.etxebarria@cleverbyte.tech,515685,ES71209582994069256416,7609.68,2023-10-09T21:09:54,Vitoria-Gasteiz,expenses,cash,-100.0,2291.02
buyer_3,Ana,Etxebarria,1989-08-23,09407087H,ana.etxebarria@cleverbyte.tech,515685,ES71209582994069256416,7609.68,2023-10-12T20:41:14,Vitoria-Gasteiz,expenses,food,-73.57,2217.45
buyer_3,Ana,Etxebarria,1989-08-23,09407087H,ana.etxebarria@cleverbyte.tech,515685,ES71209582994069256416,7609.68,2023-10-13T18:29:50,Vitoria-Gasteiz,expenses,food,-98.06,2119.39
buyer_3,Ana,Etxebarria,1989-08-23,09407087H,ana.etxebarria@cleverbyte.tech,515685,ES71209582994069256416,7609.68,2023-10-14T18:39:20,Vitoria-Gasteiz,expenses,clothing,-145.73,1973.66
buyer_3,Ana,Etxebarria,1989-08-23,09407087H,ana.etxebarria@cleverbyte.tech,515685,ES71209582994069256416,7609.68,2023-10-15T18:27:20,Vitoria-Gasteiz,expenses,clothing,-127.4,1846.26
buyer_3,Ana,Etxebarria,1989-08-23,09407087H,ana.etxebarria@cleverbyte.tech,515685,ES71209582994069256416,7609.68,2023-10-16T09:46:39,Vitoria-Gasteiz,expenses,transport,-52.57,1793.69
buyer_3,Ana,Etxebarria,1989-08-23,09407087H,ana.etxebarria@cleverbyte.tech,515685,ES71209582994069256416,7609.68,2023-10-18T04:52:24,Vitoria-Gasteiz,expenses,repairs,-222.15,1571.54
buyer_3,Ana,Etxebarria,1989-08-23,09407087H,ana.etxebarria@cleverbyte.tech,515685,ES71209582994069256416,7609.68,2023-10-20T17:00:00,Vitoria-Gasteiz,expenses,cash,-100.0,1471.54
buyer_3,Ana,Etxebarria,1989-08-23,09407087H,ana.etxebarria@cleverbyte.tech,515685,ES71209582994069256416,7609.68,2023-10-22T12:33:40,Vitoria-Gasteiz,expenses,education,-42.65,1428.89
buyer_3,Ana,Etxebarria,1989-08-23,09407087H,ana.etxebarria@cleverbyte.tech,515685,ES71209582994069256416,7609.68,2023-10-23T00:58:44,Vitoria-Gasteiz,expenses,food,-80.97,1347.92
buyer_3,Ana,Etxebarria,1989-08-23,09407087H,ana.etxebarria@cleverbyte.tech,515685,ES71209582994069256416,7609.68,2023-10-23T16:43:04,Vitoria-Gasteiz,expenses,transport,-49.14,1298.78
buyer_3,Ana,Etxebarria,1989-08-23,09407087H,ana.etxebarria@cleverbyte.tech,515685,ES71209582994069256416,7609.68,2023-10-23T11:03:51,Vitoria-Gasteiz,expenses,healthcare,-139.16,1159.62
buyer_3,Ana,Etxebarria,1989-08-23,09407087H,ana.etxebarria@cleverbyte.tech,515685,ES71209582994069256416,7609.68,2023-10-24T14:10:05,Vitoria-Gasteiz,expenses,food,-112.64,1046.98
buyer_3,Ana,Etxebarria,1989-08-23,09407087H,ana.etxebarria@cleverbyte.tech,515685,ES71209582994069256416,7609.68,2023-10-25T18:19:12,Vitoria-Gasteiz,expenses,gifts,-408.47,638.51
buyer_3,Ana,Etxebarria,1989-08-23,09407087H,ana.etxebarria@cleverbyte.tech,515685,ES71209582994069256416,7609.68,2023-10-27T11:50:21,Vitoria-Gasteiz,expenses,leisure,-64.03,574.48
buyer_3,Ana,Etxebarria,1989-08-23,09407087H,ana.etxebarria@cleverbyte.tech,515685,ES71209582994069256416,7609.68,2023-10-28T09:44:06,Vitoria-Gasteiz,expenses,leisure,-33.39,541.09
buyer_3,Ana,Etxebarria,1989-08-23,09407087H,ana.etxebarria@cleverbyte.tech,515685,ES71209582994069256416,7609.68,2023-10-28T15:45:53,Vitoria-Gasteiz,expenses,cash,-100.0,441.09
buyer_3,Ana,Etxebarria,1989-08-23,09407087H,ana.etxebarria@cleverbyte.tech,515685,ES71209582994069256416,7609.68,2023-10-30T03:53:55,Vitoria-Gasteiz,expenses,leisure,-77.42,363.67
buyer_3,Ana,Etxebarria,1989-08-23,09407087H,ana.etxebarria@cleverbyte.tech,515685,ES71209582994069256416,7609.68,2023-10-30T16:42:19,Vitoria-Gasteiz,expenses,clothing,-72.45,291.22
buyer_3,Ana,Etxebarria,1989-08-23,09407087H,ana.etxebarria@cleverbyte.tech,515685,ES71209582994069256416,7609.68,2023-10-31T10:34:42,Vitoria-Gasteiz,expenses,food,-84.2,207.02
buyer_3,Ana,Etxebarria,1989-08-23,09407087H,ana.etxebarria@cleverbyte.tech,515685,ES71209582994069256416,7609.68,2023-11-01T10:10:02,Vitoria-Gasteiz,incomes,salary,3220.07,3427.09
buyer_3,Ana,Etxebarria,1989-08-23,09407087H,ana.etxebarria@cleverbyte.tech,515685,ES71209582994069256416,7609.68,2023-11-01T10:10:02,Vitoria-Gasteiz,incomes,salary_partner,3476.32,6903.41
buyer_3,Ana,Etxebarria,1989-08-23,09407087H,ana.etxebarria@cleverbyte.tech,515685,ES71209582994069256416,7609.68,2023-11-01T09:47:21,Vitoria-Gasteiz,expenses,transport,-47.49,6855.92
buyer_3,Ana,Etxebarria,1989-08-23,09407087H,ana.etxebarria@cleverbyte.tech,515685,ES71209582994069256416,7609.68,2023-11-01T11:33:26,Vitoria-Gasteiz,expenses,leisure,-55.0,6800.92
buyer_3,Ana,Etxebarria,1989-08-23,09407087H,ana.etxebarria@cleverbyte.tech,515685,ES71209582994069256416,7609.68,2023-11-02T17:01:54,Vitoria-Gasteiz,expenses,food,-84.01,6716.91
buyer_3,Ana,Etxebarria,1989-08-23,09407087H,ana.etxebarria@cleverbyte.tech,515685,ES71209582994069256416,7609.68,2023-11-02T00:53:15,Vitoria-Gasteiz,expenses,cash,-100.0,6616.91
buyer_3,Ana,Etxebarria,1989-08-23,09407087H,ana.etxebarria@cleverbyte.tech,515685,ES71209582994069256416,7609.68,2023-11-05T08:08:07,Vitoria-Gasteiz,expenses,mortgage,-3384.14,3232.77
buyer_3,Ana,Etxebarria,1989-08-23,09407087H,ana.etxebarria@cleverbyte.tech,515685,ES71209582994069256416,7609.68,2023-11-05T19:58:20,Vitoria-Gasteiz,expenses,internet,-140.62,3092.15
buyer_3,Ana,Etxebarria,1989-08-23,09407087H,ana.etxebarria@cleverbyte.tech,515685,ES71209582994069256416,7609.68,2023-11-06T14:21:21,Vitoria-Gasteiz,expenses,gas,-127.31,2964.84
buyer_3,Ana,Etxebarria,1989-08-23,09407087H,ana.etxebarria@cleverbyte.tech,515685,ES71209582994069256416,7609.68,2023-11-06T14:39:05,Vitoria-Gasteiz,expenses,transport,-74.59,2890.25
buyer_3,Ana,Etxebarria,1989-08-23,09407087H,ana.etxebarria@cleverbyte.tech,515685,ES71209582994069256416,7609.68,2023-11-07T00:35:36,Vitoria-Gasteiz,expenses,gas,-179.01,2711.24
buyer_3,Ana,Etxebarria,1989-08-23,09407087H,ana.etxebarria@cleverbyte.tech,515685,ES71209582994069256416,7609.68,2023-11-07T10:45:57,Vitoria-Gasteiz,expenses,internet,-140.62,2570.62
buyer_3,Ana,Etxebarria,1989-08-23,09407087H,ana.etxebarria@cleverbyte.tech,515685,ES71209582994069256416,7609.68,2023-11-07T08:46:24,Vitoria-Gasteiz,expenses,phone,-138.2,2432.42
buyer_3,Ana,Etxebarria,1989-08-23,09407087H,ana.etxebarria@cleverbyte.tech,515685,ES71209582994069256416,7609.68,2023-11-07T20:05:14,Vitoria-Gasteiz,expenses,leisure,-64.05,2368.37
buyer_3,Ana,Etxebarria,1989-08-23,09407087H,ana.etxebarria@cleverbyte.tech,515685,ES71209582994069256416,7609.68,2023-11-07T11:39:27,Vitoria-Gasteiz,expenses,gifts,-210.25,2158.12
buyer_3,Ana,Etxebarria,1989-08-23,09407087H,ana.etxebarria@cleverbyte.tech,515685,ES71209582994069256416,7609.68,2023-11-08T20:16:39,Vitoria-Gasteiz,expenses,water,-115.23,2042.89
buyer_3,Ana,Etxebarria,1989-08-23,09407087H,ana.etxebarria@cleverbyte.tech,515685,ES71209582994069256416,7609.68,2023-11-08T20:57:09,Vitoria-Gasteiz,expenses,electricity,-289.68,1753.21
buyer_3,Ana,Etxebarria,1989-08-23,09407087H,ana.etxebarria@cleverbyte.tech,515685,ES71209582994069256416,7609.68,2023-11-08T16:39:28,Vitoria-Gasteiz,expenses,gas,-125.3,1627.91
buyer_3,Ana,Etxebarria,1989-08-23,09407087H,ana.etxebarria@cleverbyte.tech,515685,ES71209582994069256416,7609.68,2023-11-08T07:01:13,Vitoria-Gasteiz,expenses,cash,-100.0,1527.91
buyer_3,Ana,Etxebarria,1989-08-23,09407087H,ana.etxebarria@cleverbyte.tech,515685,ES71209582994069256416,7609.68,2023-11-10T11:29:58,Vitoria-Gasteiz,expenses,leisure,-18.65,1509.26
buyer_3,Ana,Etxebarria,1989-08-23,09407087H,ana.etxebarria@cleverbyte.tech,515685,ES71209582994069256416,7609.68,2023-11-11T22:04:54,Vitoria-Gasteiz,expenses,leisure,-76.8,1432.46
buyer_3,Ana,Etxebarria,1989-08-23,09407087H,ana.etxebarria@cleverbyte.tech,515685,ES71209582994069256416,7609.68,2023-11-12T20:13:13,Vitoria-Gasteiz,expenses,leisure,-51.47,1380.99
buyer_3,Ana,Etxebarria,1989-08-23,09407087H,ana.etxebarria@cleverbyte.tech,515685,ES71209582994069256416,7609.68,2023-11-12T08:23:41,Vitoria-Gasteiz,expenses,travel,-484.88,896.11
buyer_3,Ana,Etxebarria,1989-08-23,09407087H,ana.etxebarria@cleverbyte.tech,515685,ES71209582994069256416,7609.68,2023-11-14T13:46:46,Vitoria-Gasteiz,expenses,transport,-44.97,851.14
buyer_3,Ana,Etxebarria,1989-08-23,09407087H,ana.etxebarria@cleverbyte.tech,515685,ES71209582994069256416,7609.68,2023-11-17T08:38:57,Vitoria-Gasteiz,expenses,transport,-64.58,786.56
buyer_3,Ana,Etxebarria,1989-08-23,09407087H,ana.etxebarria@cleverbyte.tech,515685,ES71209582994069256416,7609.68,2023-11-17T14:04:17,Vitoria-Gasteiz,expenses,leisure,-78.15,708.41
buyer_3,Ana,Etxebarria,1989-08-23,09407087H,ana.etxebarria@cleverbyte.tech,515685,ES71209582994069256416,7609.68,2023-11-18T10:04:30,Vitoria-Gasteiz,expenses,food,-109.23,599.18
buyer_3,Ana,Etxebarria,1989-08-23,09407087H,ana.etxebarria@cleverbyte.tech,515685,ES71209582994069256416,7609.68,2023-11-19T13:57:53,Vitoria-Gasteiz,expenses,leisure,-71.12,528.06
buyer_3,Ana,Etxebarria,1989-08-23,09407087H,ana.etxebarria@cleverbyte.tech,515685,ES71209582994069256416,7609.68,2023-11-20T13:36:00,Vitoria-Gasteiz,expenses,food,-90.14,437.92
buyer_3,Ana,Etxebarria,1989-08-23,09407087H,ana.etxebarria@cleverbyte.tech,515685,ES71209582994069256416,7609.68,2023-11-20T15:45:11,Vitoria-Gasteiz,expenses,cash,-100.0,337.92
buyer_3,Ana,Etxebarria,1989-08-23,09407087H,ana.etxebarria@cleverbyte.tech,515685,ES71209582994069256416,7609.68,2023-11-22T17:05:30,Vitoria-Gasteiz,expenses,food,-124.81,213.11
buyer_3,Ana,Etxebarria,1989-08-23,09407087H,ana.etxebarria@cleverbyte.tech,515685,ES71209582994069256416,7609.68,2023-11-22T15:57:54,Vitoria-Gasteiz,expenses,clothing,-110.34,102.77
buyer_3,Ana,Etxebarria,1989-08-23,09407087H,ana.etxebarria@cleverbyte.tech,515685,ES71209582994069256416,7609.68,2023-11-25T18:15:35,Vitoria-Gasteiz,expenses,cash,-100.0,2.77
buyer_3,Ana,Etxebarria,1989-08-23,09407087H,ana.etxebarria@cleverbyte.tech,515685,ES71209582994069256416,7609.68,2023-11-26T15:19:42,Vitoria-Gasteiz,expenses,leisure,-36.72,-33.95
buyer_3,Ana,Etxebarria,1989-08-23,09407087H,ana.etxebarria@cleverbyte.tech,515685,ES71209582994069256416,7609.68,2023-11-28T09:12:08,Vitoria-Gasteiz,expenses,food,-84.29,-118.24
buyer_3,Ana,Etxebarria,1989-08-23,09407087H,ana.etxebarria@cleverbyte.tech,515685,ES71209582994069256416,7609.68,2023-11-29T20:52:26,Vitoria-Gasteiz,expenses,food,-62.33,-180.57
buyer_3,Ana,Etxebarria,1989-08-23,09407087H,ana.etxebarria@cleverbyte.tech,515685,ES71209582994069256416,7609.68,2023-11-29T20:09:50,Vitoria-Gasteiz,expenses,leisure,-78.18,-258.75
buyer_3,Ana,Etxebarria,1989-08-23,09407087H,ana.etxebarria@cleverbyte.tech,515685,ES71209582994069256416,7609.68,2023-12-01T17:38:52,Vitoria-Gasteiz,incomes,salary,3220.07,2961.32
buyer_3,Ana,Etxebarria,1989-08-23,09407087H,ana.etxebarria@cleverbyte.tech,515685,ES71209582994069256416,7609.68,2023-12-01T17:38:52,Vitoria-Gasteiz,incomes,salary_partner,3476.32,6437.64
buyer_3,Ana,Etxebarria,1989-08-23,09407087H,ana.etxebarria@cleverbyte.tech,515685,ES71209582994069256416,7609.68,2023-12-01T17:38:52,Vitoria-Gasteiz,incomes,extra_income,372.53,6810.17
buyer_3,Ana,Etxebarria,1989-08-23,09407087H,ana.etxebarria@cleverbyte.tech,515685,ES71209582994069256416,7609.68,2023-12-01T17:38:52,Vitoria-Gasteiz,incomes,salary_bonus,2298.26,9108.43
buyer_3,Ana,Etxebarria,1989-08-23,09407087H,ana.etxebarria@cleverbyte.tech,515685,ES71209582994069256416,7609.68,2023-12-01T17:38:52,Vitoria-Gasteiz,incomes,salary_partner_bonus,2659.41,11767.84
buyer_3,Ana,Etxebarria,1989-08-23,09407087H,ana.etxebarria@cleverbyte.tech,515685,ES71209582994069256416,7609.68,2023-12-01T16:27:22,Vitoria-Gasteiz,expenses,clothing,-133.76,11634.08
buyer_3,Ana,Etxebarria,1989-08-23,09407087H,ana.etxebarria@cleverbyte.tech,515685,ES71209582994069256416,7609.68,2023-12-01T18:09:39,Vitoria-Gasteiz,expenses,education,-50.01,11584.07
buyer_3,Ana,Etxebarria,1989-08-23,09407087H,ana.etxebarria@cleverbyte.tech,515685,ES71209582994069256416,7609.68,2023-12-01T16:53:37,Vitoria-Gasteiz,expenses,travel,-617.63,10966.44
buyer_3,Ana,Etxebarria,1989-08-23,09407087H,ana.etxebarria@cleverbyte.tech,515685,ES71209582994069256416,7609.68,2023-12-02T18:36:17,Vitoria-Gasteiz,expenses,food,-120.95,10845.49
buyer_3,Ana,Etxebarria,1989-08-23,09407087H,ana.etxebarria@cleverbyte.tech,515685,ES71209582994069256416,7609.68,2023-12-02T08:23:44,Vitoria-Gasteiz,expenses,education,-70.31,10775.18
buyer_3,Ana,Etxebarria,1989-08-23,09407087H,ana.etxebarria@cleverbyte.tech,515685,ES71209582994069256416,7609.68,2023-12-02T14:36:26,Vitoria-Gasteiz,expenses,appliances,-395.09,10380.09
buyer_3,Ana,Etxebarria,1989-08-23,09407087H,ana.etxebarria@cleverbyte.tech,515685,ES71209582994069256416,7609.68,2023-12-03T17:08:23,Vitoria-Gasteiz,expenses,repairs,-156.7,10223.39
buyer_3,Ana,Etxebarria,1989-08-23,09407087H,ana.etxebarria@cleverbyte.tech,515685,ES71209582994069256416,7609.68,2023-12-04T10:56:10,Vitoria-Gasteiz,expenses,cash,-100.0,10123.39
buyer_3,Ana,Etxebarria,1989-08-23,09407087H,ana.etxebarria@cleverbyte.tech,515685,ES71209582994069256416,7609.68,2023-12-05T08:32:45,Vitoria-Gasteiz,expenses,mortgage,-3384.14,6739.25
buyer_3,Ana,Etxebarria,1989-08-23,09407087H,ana.etxebarria@cleverbyte.tech,515685,ES71209582994069256416,7609.68,2023-12-05T19:48:17,Vitoria-Gasteiz,expenses,gas,-327.35,6411.9
buyer_3,Ana,Etxebarria,1989-08-23,09407087H,ana.etxebarria@cleverbyte.tech,515685,ES71209582994069256416,7609.68,2023-12-05T20:15:50,Vitoria-Gasteiz,expenses,transport,-75.26,6336.64
buyer_3,Ana,Etxebarria,1989-08-23,09407087H,ana.etxebarria@cleverbyte.tech,515685,ES71209582994069256416,7609.68,2023-12-05T15:19:42,Vitoria-Gasteiz,expenses,leisure,-45.39,6291.25
buyer_3,Ana,Etxebarria,1989-08-23,09407087H,ana.etxebarria@cleverbyte.tech,515685,ES71209582994069256416,7609.68,2023-12-05T10:43:51,Vitoria-Gasteiz,expenses,clothing,-115.55,6175.7
buyer_3,Ana,Etxebarria,1989-08-23,09407087H,ana.etxebarria@cleverbyte.tech,515685,ES71209582994069256416,7609.68,2023-12-06T09:18:57,Vitoria-Gasteiz,expenses,phone,-130.86,6044.84
buyer_3,Ana,Etxebarria,1989-08-23,09407087H,ana.etxebarria@cleverbyte.tech,515685,ES71209582994069256416,7609.68,2023-12-07T20:34:26,Vitoria-Gasteiz,expenses,water,-145.02,5899.82
buyer_3,Ana,Etxebarria,1989-08-23,09407087H,ana.etxebarria@cleverbyte.tech,515685,ES71209582994069256416,7609.68,2023-12-07T20:44:02,Vitoria-Gasteiz,expenses,cash,-100.0,5799.82
buyer_3,Ana,Etxebarria,1989-08-23,09407087H,ana.etxebarria@cleverbyte.tech,515685,ES71209582994069256416,7609.68,2023-12-08T03:37:12,Vitoria-Gasteiz,expenses,internet,-140.62,5659.2
buyer_3,Ana,Etxebarria,1989-08-23,09407087H,ana.etxebarria@cleverbyte.tech,515685,ES71209582994069256416,7609.68,2023-12-08T22:51:35,Vitoria-Gasteiz,expenses,food,-115.89,5543.31
buyer_3,Ana,Etxebarria,1989-08-23,09407087H,ana.etxebarria@cleverbyte.tech,515685,ES71209582994069256416,7609.68,2023-12-08T15:26:02,Vitoria-Gasteiz,expenses,clothing,-67.05,5476.26
buyer_3,Ana,Etxebarria,1989-08-23,09407087H,ana.etxebarria@cleverbyte.tech,515685,ES71209582994069256416,7609.68,2023-12-08T20:22:50,Vitoria-Gasteiz,expenses,cash,-100.0,5376.26
buyer_3,Ana,Etxebarria,1989-08-23,09407087H,ana.etxebarria@cleverbyte.tech,515685,ES71209582994069256416,7609.68,2023-12-10T19:51:26,Vitoria-Gasteiz,expenses,repairs,-129.37,5246.89
buyer_3,Ana,Etxebarria,1989-08-23,09407087H,ana.etxebarria@cleverbyte.tech,515685,ES71209582994069256416,7609.68,2023-12-12T17:18:02,Vitoria-Gasteiz,expenses,leisure,-83.34,5163.55
buyer_3,Ana,Etxebarria,1989-08-23,09407087H,ana.etxebarria@cleverbyte.tech,515685,ES71209582994069256416,7609.68,2023-12-12T21:34:07,Vitoria-Gasteiz,expenses,healthcare,-128.57,5034.98
buyer_3,Ana,Etxebarria,1989-08-23,09407087H,ana.etxebarria@cleverbyte.tech,515685,ES71209582994069256416,7609.68,2023-12-12T13:48:56,Vitoria-Gasteiz,expenses,cash,-100.0,4934.98
buyer_3,Ana,Etxebarria,1989-08-23,09407087H,ana.etxebarria@cleverbyte.tech,515685,ES71209582994069256416,7609.68,2023-12-13T18:26:58,Vitoria-Gasteiz,expenses,repairs,-176.84,4758.14
buyer_3,Ana,Etxebarria,1989-08-23,09407087H,ana.etxebarria@cleverbyte.tech,515685,ES71209582994069256416,7609.68,2023-12-14T16:13:13,Vitoria-Gasteiz,expenses,travel,-706.63,4051.51
buyer_3,Ana,Etxebarria,1989-08-23,09407087H,ana.etxebarria@cleverbyte.tech,515685,ES71209582994069256416,7609.68,2023-12-15T17:07:50,Vitoria-Gasteiz,expenses,cash,-100.0,3951.51
buyer_3,Ana,Etxebarria,1989-08-23,09407087H,ana.etxebarria@cleverbyte.tech,515685,ES71209582994069256416,7609.68,2023-12-19T06:42:36,Vitoria-Gasteiz,expenses,leisure,-39.37,3912.14
buyer_3,Ana,Etxebarria,1989-08-23,09407087H,ana.etxebarria@cleverbyte.tech,515685,ES71209582994069256416,7609.68,2023-12-20T05:32:52,Vitoria-Gasteiz,expenses,transport,-53.26,3858.88
buyer_3,Ana,Etxebarria,1989-08-23,09407087H,ana.etxebarria@cleverbyte.tech,515685,ES71209582994069256416,7609.68,2023-12-21T01:17:48,Vitoria-Gasteiz,expenses,food,-117.36,3741.52
buyer_3,Ana,Etxebarria,1989-08-23,09407087H,ana.etxebarria@cleverbyte.tech,515685,ES71209582994069256416,7609.68,2023-12-21T16:33:25,Vitoria-Gasteiz,expenses,leisure,-77.33,3664.19
buyer_3,Ana,Etxebarria,1989-08-23,09407087H,ana.etxebarria@cleverbyte.tech,515685,ES71209582994069256416,7609.68,2023-12-21T14:50:10,Vitoria-Gasteiz,expenses,healthcare,-46.17,3618.02
buyer_3,Ana,Etxebarria,1989-08-23,09407087H,ana.etxebarria@cleverbyte.tech,515685,ES71209582994069256416,7609.68,2023-12-21T17:07:25,Vitoria-Gasteiz,expenses,cash,-100.0,3518.02
buyer_3,Ana,Etxebarria,1989-08-23,09407087H,ana.etxebarria@cleverbyte.tech,515685,ES71209582994069256416,7609.68,2023-12-21T21:58:44,Vitoria-Gasteiz,expenses,repairs,-204.22,3313.8
buyer_3,Ana,Etxebarria,1989-08-23,09407087H,ana.etxebarria@cleverbyte.tech,515685,ES71209582994069256416,7609.68,2023-12-22T12:56:29,Vitoria-Gasteiz,expenses,leisure,-20.9,3292.9
buyer_3,Ana,Etxebarria,1989-08-23,09407087H,ana.etxebarria@cleverbyte.tech,515685,ES71209582994069256416,7609.68,2023-12-22T19:42:59,Vitoria-Gasteiz,expenses,car,-301.26,2991.64
buyer_3,Ana,Etxebarria,1989-08-23,09407087H,ana.etxebarria@cleverbyte.tech,515685,ES71209582994069256416,7609.68,2023-12-23T13:46:11,Vitoria-Gasteiz,expenses,cash,-100.0,2891.64
buyer_3,Ana,Etxebarria,1989-08-23,09407087H,ana.etxebarria@cleverbyte.tech,515685,ES71209582994069256416,7609.68,2023-12-24T21:14:09,Vitoria-Gasteiz,expenses,food,-111.17,2780.47
buyer_3,Ana,Etxebarria,1989-08-23,09407087H,ana.etxebarria@cleverbyte.tech,515685,ES71209582994069256416,7609.68,2023-12-24T17:41:28,Vitoria-Gasteiz,expenses,appliances,-363.52,2416.95
buyer_3,Ana,Etxebarria,1989-08-23,09407087H,ana.etxebarria@cleverbyte.tech,515685,ES71209582994069256416,7609.68,2023-12-27T12:39:37,Vitoria-Gasteiz,expenses,leisure,-33.81,2383.14
buyer_3,Ana,Etxebarria,1989-08-23,09407087H,ana.etxebarria@cleverbyte.tech,515685,ES71209582994069256416,7609.68,2023-12-28T16:33:26,Vitoria-Gasteiz,expenses,food,-102.68,2280.46
buyer_3,Ana,Etxebarria,1989-08-23,09407087H,ana.etxebarria@cleverbyte.tech,515685,ES71209582994069256416,7609.68,2023-12-29T01:19:24,Vitoria-Gasteiz,expenses,cash,-100.0,2180.46
buyer_3,Ana,Etxebarria,1989-08-23,09407087H,ana.etxebarria@cleverbyte.tech,515685,ES71209582994069256416,7609.68,2023-12-31T07:39:28,Vitoria-Gasteiz,expenses,food,-98.66,2081.8
buyer_3,Ana,Etxebarria,1989-08-23,09407087H,ana.etxebarria@cleverbyte.tech,515685,ES71209582994069256416,7609.68,2023-12-31T10:40:18,Vitoria-Gasteiz,expenses,healthcare,-112.28,1969.52
buyer_3,Ana,Etxebarria,1989-08-23,09407087H,ana.etxebarria@cleverbyte.tech,515685,ES71209582994069256416,7609.68,2023-12-31T16:11:10,Vitoria-Gasteiz,expenses,cash,-100.0,1869.52
buyer_3,Ana,Etxebarria,1989-08-23,09407087H,ana.etxebarria@cleverbyte.tech,515685,ES71209582994069256416,7609.68,2024-01-01T17:39:41,Vitoria-Gasteiz,incomes,salary,3335.94,5205.46
buyer_3,Ana,Etxebarria,1989-08-23,09407087H,ana.etxebarria@cleverbyte.tech,515685,ES71209582994069256416,7609.68,2024-01-01T17:39:41,Vitoria-Gasteiz,incomes,salary_partner,3601.41,8806.87
buyer_3,Ana,Etxebarria,1989-08-23,09407087H,ana.etxebarria@cleverbyte.tech,515685,ES71209582994069256416,7609.68,2024-01-02T20:55:44,Vitoria-Gasteiz,expenses,transport,-72.06,8734.81
buyer_3,Ana,Etxebarria,1989-08-23,09407087H,ana.etxebarria@cleverbyte.tech,515685,ES71209582994069256416,7609.68,2024-01-02T16:19:27,Vitoria-Gasteiz,expenses,leisure,-36.13,8698.68
buyer_3,Ana,Etxebarria,1989-08-23,09407087H,ana.etxebarria@cleverbyte.tech,515685,ES71209582994069256416,7609.68,2024-01-02T11:25:05,Vitoria-Gasteiz,expenses,healthcare,-129.89,8568.79
buyer_3,Ana,Etxebarria,1989-08-23,09407087H,ana.etxebarria@cleverbyte.tech,515685,ES71209582994069256416,7609.68,2024-01-02T15:00:41,Vitoria-Gasteiz,expenses,cash,-100.0,8468.79
buyer_3,Ana,Etxebarria,1989-08-23,09407087H,ana.etxebarria@cleverbyte.tech,515685,ES71209582994069256416,7609.68,2024-01-04T17:10:29,Vitoria-Gasteiz,expenses,leisure,-49.45,8419.34
buyer_3,Ana,Etxebarria,1989-08-23,09407087H,ana.etxebarria@cleverbyte.tech,515685,ES71209582994069256416,7609.68,2024-01-05T20:46:45,Vitoria-Gasteiz,expenses,mortgage,-3275.41,5143.93
buyer_3,Ana,Etxebarria,1989-08-23,09407087H,ana.etxebarria@cleverbyte.tech,515685,ES71209582994069256416,7609.68,2024-01-05T15:52:58,Vitoria-Gasteiz,expenses,gas,-146.41,4997.52
buyer_3,Ana,Etxebarria,1989-08-23,09407087H,ana.etxebarria@cleverbyte.tech,515685,ES71209582994069256416,7609.68,2024-01-05T22:15:58,Vitoria-Gasteiz,expenses,repairs,-322.48,4675.04
buyer_3,Ana,Etxebarria,1989-08-23,09407087H,ana.etxebarria@cleverbyte.tech,515685,ES71209582994069256416,7609.68,2024-01-06T14:33:07,Vitoria-Gasteiz,expenses,water,-82.55,4592.49
buyer_3,Ana,Etxebarria,1989-08-23,09407087H,ana.etxebarria@cleverbyte.tech,515685,ES71209582994069256416,7609.68,2024-01-06T10:55:09,Vitoria-Gasteiz,expenses,internet,-145.68,4446.81
buyer_3,Ana,Etxebarria,1989-08-23,09407087H,ana.etxebarria@cleverbyte.tech,515685,ES71209582994069256416,7609.68,2024-01-06T13:26:10,Vitoria-Gasteiz,expenses,gifts,-682.87,3763.94
buyer_3,Ana,Etxebarria,1989-08-23,09407087H,ana.etxebarria@cleverbyte.tech,515685,ES71209582994069256416,7609.68,2024-01-07T15:55:00,Vitoria-Gasteiz,expenses,electricity,-220.55,3543.39
buyer_3,Ana,Etxebarria,1989-08-23,09407087H,ana.etxebarria@cleverbyte.tech,515685,ES71209582994069256416,7609.68,2024-01-07T13:25:53,Vitoria-Gasteiz,expenses,internet,-145.68,3397.71
buyer_3,Ana,Etxebarria,1989-08-23,09407087H,ana.etxebarria@cleverbyte.tech,515685,ES71209582994069256416,7609.68,2024-01-07T23:21:35,Vitoria-Gasteiz,expenses,phone,-110.39,3287.32
buyer_3,Ana,Etxebarria,1989-08-23,09407087H,ana.etxebarria@cleverbyte.tech,515685,ES71209582994069256416,7609.68,2024-01-09T17:23:53,Vitoria-Gasteiz,expenses,food,-83.36,3203.96
buyer_3,Ana,Etxebarria,1989-08-23,09407087H,ana.etxebarria@cleverbyte.tech,515685,ES71209582994069256416,7609.68,2024-01-09T14:09:16,Vitoria-Gasteiz,expenses,healthcare,-77.6,3126.36
buyer_3,Ana,Etxebarria,1989-08-23,09407087H,ana.etxebarria@cleverbyte.tech,515685,ES71209582994069256416,7609.68,2024-01-09T11:22:08,Vitoria-Gasteiz,expenses,cash,-100.0,3026.36
buyer_3,Ana,Etxebarria,1989-08-23,09407087H,ana.etxebarria@cleverbyte.tech,515685,ES71209582994069256416,7609.68,2024-01-10T13:44:30,Vitoria-Gasteiz,expenses,clothing,-80.67,2945.69
buyer_3,Ana,Etxebarria,1989-08-23,09407087H,ana.etxebarria@cleverbyte.tech,515685,ES71209582994069256416,7609.68,2024-01-12T21:31:45,Vitoria-Gasteiz,expenses,leisure,-26.82,2918.87
buyer_3,Ana,Etxebarria,1989-08-23,09407087H,ana.etxebarria@cleverbyte.tech,515685,ES71209582994069256416,7609.68,2024-01-15T14:08:31,Vitoria-Gasteiz,expenses,transport,-61.43,2857.44
buyer_3,Ana,Etxebarria,1989-08-23,09407087H,ana.etxebarria@cleverbyte.tech,515685,ES71209582994069256416,7609.68,2024-01-16T16:46:50,Vitoria-Gasteiz,expenses,leisure,-67.42,2790.02
buyer_3,Ana,Etxebarria,1989-08-23,09407087H,ana.etxebarria@cleverbyte.tech,515685,ES71209582994069256416,7609.68,2024-01-18T09:52:43,Vitoria-Gasteiz,expenses,healthcare,-95.49,2694.53
buyer_3,Ana,Etxebarria,1989-08-23,09407087H,ana.etxebarria@cleverbyte.tech,515685,ES71209582994069256416,7609.68,2024-01-19T17:02:14,Vitoria-Gasteiz,expenses,food,-99.7,2594.83
buyer_3,Ana,Etxebarria,1989-08-23,09407087H,ana.etxebarria@cleverbyte.tech,515685,ES71209582994069256416,7609.68,2024-01-20T15:37:07,Vitoria-Gasteiz,expenses,leisure,-20.64,2574.19
buyer_3,Ana,Etxebarria,1989-08-23,09407087H,ana.etxebarria@cleverbyte.tech,515685,ES71209582994069256416,7609.68,2024-01-21T10:29:05,Vitoria-Gasteiz,expenses,transport,-65.91,2508.28
buyer_3,Ana,Etxebarria,1989-08-23,09407087H,ana.etxebarria@cleverbyte.tech,515685,ES71209582994069256416,7609.68,2024-01-21T16:50:33,Vitoria-Gasteiz,expenses,leisure,-42.49,2465.79
buyer_3,Ana,Etxebarria,1989-08-23,09407087H,ana.etxebarria@cleverbyte.tech,515685,ES71209582994069256416,7609.68,2024-01-22T16:08:45,Vitoria-Gasteiz,expenses,leisure,-48.85,2416.94
buyer_3,Ana,Etxebarria,1989-08-23,09407087H,ana.etxebarria@cleverbyte.tech,515685,ES71209582994069256416,7609.68,2024-01-22T16:41:15,Vitoria-Gasteiz,expenses,cash,-100.0,2316.94
buyer_3,Ana,Etxebarria,1989-08-23,09407087H,ana.etxebarria@cleverbyte.tech,515685,ES71209582994069256416,7609.68,2024-01-24T13:10:38,Vitoria-Gasteiz,expenses,repairs,-269.42,2047.52
buyer_3,Ana,Etxebarria,1989-08-23,09407087H,ana.etxebarria@cleverbyte.tech,515685,ES71209582994069256416,7609.68,2024-01-25T09:32:15,Vitoria-Gasteiz,expenses,food,-75.49,1972.03
buyer_3,Ana,Etxebarria,1989-08-23,09407087H,ana.etxebarria@cleverbyte.tech,515685,ES71209582994069256416,7609.68,2024-01-25T10:07:16,Vitoria-Gasteiz,expenses,education,-58.67,1913.36
buyer_3,Ana,Etxebarria,1989-08-23,09407087H,ana.etxebarria@cleverbyte.tech,515685,ES71209582994069256416,7609.68,2024-01-31T11:28:12,Vitoria-Gasteiz,expenses,healthcare,-121.31,1792.05
buyer_3,Ana,Etxebarria,1989-08-23,09407087H,ana.etxebarria@cleverbyte.tech,515685,ES71209582994069256416,7609.68,2024-02-01T19:07:46,Vitoria-Gasteiz,incomes,salary,3335.94,5127.99
buyer_3,Ana,Etxebarria,1989-08-23,09407087H,ana.etxebarria@cleverbyte.tech,515685,ES71209582994069256416,7609.68,2024-02-01T19:07:46,Vitoria-Gasteiz,incomes,salary_partner,3601.41,8729.4
buyer_3,Ana,Etxebarria,1989-08-23,09407087H,ana.etxebarria@cleverbyte.tech,515685,ES71209582994069256416,7609.68,2024-02-01T19:19:06,Vitoria-Gasteiz,expenses,food,-120.91,8608.49
buyer_3,Ana,Etxebarria,1989-08-23,09407087H,ana.etxebarria@cleverbyte.tech,515685,ES71209582994069256416,7609.68,2024-02-01T20:26:49,Vitoria-Gasteiz,expenses,cash,-100.0,8508.49
buyer_3,Ana,Etxebarria,1989-08-23,09407087H,ana.etxebarria@cleverbyte.tech,515685,ES71209582994069256416,7609.68,2024-02-01T10:54:49,Vitoria-Gasteiz,expenses,gifts,-621.97,7886.52
buyer_3,Ana,Etxebarria,1989-08-23,09407087H,ana.etxebarria@cleverbyte.tech,515685,ES71209582994069256416,7609.68,2024-02-03T17:11:10,Vitoria-Gasteiz,expenses,food,-68.43,7818.09
buyer_3,Ana,Etxebarria,1989-08-23,09407087H,ana.etxebarria@cleverbyte.tech,515685,ES71209582994069256416,7609.68,2024-02-03T05:26:52,Vitoria-Gasteiz,expenses,transport,-40.48,7777.61
buyer_3,Ana,Etxebarria,1989-08-23,09407087H,ana.etxebarria@cleverbyte.tech,515685,ES71209582994069256416,7609.68,2024-02-03T15:47:55,Vitoria-Gasteiz,expenses,leisure,-34.92,7742.69
buyer_3,Ana,Etxebarria,1989-08-23,09407087H,ana.etxebarria@cleverbyte.tech,515685,ES71209582994069256416,7609.68,2024-02-04T17:54:14,Vitoria-Gasteiz,expenses,food,-113.27,7629.42
buyer_3,Ana,Etxebarria,1989-08-23,09407087H,ana.etxebarria@cleverbyte.tech,515685,ES71209582994069256416,7609.68,2024-02-05T18:40:34,Vitoria-Gasteiz,expenses,mortgage,-3275.41,4354.01
buyer_3,Ana,Etxebarria,1989-08-23,09407087H,ana.etxebarria@cleverbyte.tech,515685,ES71209582994069256416,7609.68,2024-02-05T19:00:56,Vitoria-Gasteiz,expenses,internet,-145.68,4208.33
buyer_3,Ana,Etxebarria,1989-08-23,09407087H,ana.etxebarria@cleverbyte.tech,515685,ES71209582994069256416,7609.68,2024-02-05T15:41:24,Vitoria-Gasteiz,expenses,food,-87.9,4120.43
buyer_3,Ana,Etxebarria,1989-08-23,09407087H,ana.etxebarria@cleverbyte.tech,515685,ES71209582994069256416,7609.68,2024-02-06T18:14:18,Vitoria-Gasteiz,expenses,water,-94.66,4025.77
buyer_3,Ana,Etxebarria,1989-08-23,09407087H,ana.etxebarria@cleverbyte.tech,515685,ES71209582994069256416,7609.68,2024-02-06T10:00:51,Vitoria-Gasteiz,expenses,electricity,-118.86,3906.91
buyer_3,Ana,Etxebarria,1989-08-23,09407087H,ana.etxebarria@cleverbyte.tech,515685,ES71209582994069256416,7609.68,2024-02-06T22:41:52,Vitoria-Gasteiz,expenses,repairs,-81.41,3825.5
buyer_3,Ana,Etxebarria,1989-08-23,09407087H,ana.etxebarria@cleverbyte.tech,515685,ES71209582994069256416,7609.68,2024-02-07T22:12:42,Vitoria-Gasteiz,expenses,gas,-115.9,3709.6
buyer_3,Ana,Etxebarria,1989-08-23,09407087H,ana.etxebarria@cleverbyte.tech,515685,ES71209582994069256416,7609.68,2024-02-07T11:55:41,Vitoria-Gasteiz,expenses,transport,-77.35,3632.25
buyer_3,Ana,Etxebarria,1989-08-23,09407087H,ana.etxebarria@cleverbyte.tech,515685,ES71209582994069256416,7609.68,2024-02-07T13:13:12,Vitoria-Gasteiz,expenses,appliances,-108.64,3523.61
buyer_3,Ana,Etxebarria,1989-08-23,09407087H,ana.etxebarria@cleverbyte.tech,515685,ES71209582994069256416,7609.68,2024-02-07T23:03:27,Vitoria-Gasteiz,expenses,repairs,-67.04,3456.57
buyer_3,Ana,Etxebarria,1989-08-23,09407087H,ana.etxebarria@cleverbyte.tech,515685,ES71209582994069256416,7609.68,2024-02-08T13:02:01,Vitoria-Gasteiz,expenses,water,-121.98,3334.59
buyer_3,Ana,Etxebarria,1989-08-23,09407087H,ana.etxebarria@cleverbyte.tech,515685,ES71209582994069256416,7609.68,2024-02-08T11:18:00,Vitoria-Gasteiz,expenses,phone,-125.66,3208.93
buyer_3,Ana,Etxebarria,1989-08-23,09407087H,ana.etxebarria@cleverbyte.tech,515685,ES71209582994069256416,7609.68,2024-02-08T08:14:08,Vitoria-Gasteiz,expenses,education,-42.09,3166.84
buyer_3,Ana,Etxebarria,1989-08-23,09407087H,ana.etxebarria@cleverbyte.tech,515685,ES71209582994069256416,7609.68,2024-02-09T21:30:28,Vitoria-Gasteiz,expenses,cash,-100.0,3066.84
buyer_3,Ana,Etxebarria,1989-08-23,09407087H,ana.etxebarria@cleverbyte.tech,515685,ES71209582994069256416,7609.68,2024-02-10T09:35:30,Vitoria-Gasteiz,expenses,education,-78.92,2987.92
buyer_3,Ana,Etxebarria,1989-08-23,09407087H,ana.etxebarria@cleverbyte.tech,515685,ES71209582994069256416,7609.68,2024-02-10T19:47:51,Vitoria-Gasteiz,expenses,gifts,-74.52,2913.4
buyer_3,Ana,Etxebarria,1989-08-23,09407087H,ana.etxebarria@cleverbyte.tech,515685,ES71209582994069256416,7609.68,2024-02-11T08:24:13,Vitoria-Gasteiz,expenses,cash,-100.0,2813.4
buyer_3,Ana,Etxebarria,1989-08-23,09407087H,ana.etxebarria@cleverbyte.tech,515685,ES71209582994069256416,7609.68,2024-02-12T16:28:10,Vitoria-Gasteiz,expenses,leisure,-65.66,2747.74
buyer_3,Ana,Etxebarria,1989-08-23,09407087H,ana.etxebarria@cleverbyte.tech,515685,ES71209582994069256416,7609.68,2024-02-15T18:26:44,Vitoria-Gasteiz,expenses,cash,-100.0,2647.74
buyer_3,Ana,Etxebarria,1989-08-23,09407087H,ana.etxebarria@cleverbyte.tech,515685,ES71209582994069256416,7609.68,2024-02-17T13:40:46,Vitoria-Gasteiz,expenses,cash,-100.0,2547.74
buyer_3,Ana,Etxebarria,1989-08-23,09407087H,ana.etxebarria@cleverbyte.tech,515685,ES71209582994069256416,7609.68,2024-02-18T09:18:32,Vitoria-Gasteiz,expenses,leisure,-67.67,2480.07
buyer_3,Ana,Etxebarria,1989-08-23,09407087H,ana.etxebarria@cleverbyte.tech,515685,ES71209582994069256416,7609.68,2024-02-19T14:12:08,Vitoria-Gasteiz,expenses,transport,-86.76,2393.31
buyer_3,Ana,Etxebarria,1989-08-23,09407087H,ana.etxebarria@cleverbyte.tech,515685,ES71209582994069256416,7609.68,2024-02-22T13:26:39,Vitoria-Gasteiz,expenses,repairs,-54.3,2339.01
buyer_3,Ana,Etxebarria,1989-08-23,09407087H,ana.etxebarria@cleverbyte.tech,515685,ES71209582994069256416,7609.68,2024-02-23T15:05:25,Vitoria-Gasteiz,expenses,leisure,-60.02,2278.99
buyer_3,Ana,Etxebarria,1989-08-23,09407087H,ana.etxebarria@cleverbyte.tech,515685,ES71209582994069256416,7609.68,2024-02-25T11:17:34,Vitoria-Gasteiz,expenses,transport,-63.51,2215.48
buyer_3,Ana,Etxebarria,1989-08-23,09407087H,ana.etxebarria@cleverbyte.tech,515685,ES71209582994069256416,7609.68,2024-02-26T02:58:21,Vitoria-Gasteiz,expenses,gifts,-572.12,1643.36
buyer_3,Ana,Etxebarria,1989-08-23,09407087H,ana.etxebarria@cleverbyte.tech,515685,ES71209582994069256416,7609.68,2024-02-27T15:29:58,Vitoria-Gasteiz,expenses,repairs,-154.12,1489.24
buyer_3,Ana,Etxebarria,1989-08-23,09407087H,ana.etxebarria@cleverbyte.tech,515685,ES71209582994069256416,7609.68,2024-02-28T19:38:14,Vitoria-Gasteiz,expenses,clothing,-140.78,1348.46
buyer_3,Ana,Etxebarria,1989-08-23,09407087H,ana.etxebarria@cleverbyte.tech,515685,ES71209582994069256416,7609.68,2024-02-28T02:42:05,Vitoria-Gasteiz,expenses,appliances,-78.31,1270.15
buyer_3,Ana,Etxebarria,1989-08-23,09407087H,ana.etxebarria@cleverbyte.tech,515685,ES71209582994069256416,7609.68,2024-02-29T21:05:11,Vitoria-Gasteiz,expenses,repairs,-74.14,1196.01
buyer_3,Ana,Etxebarria,1989-08-23,09407087H,ana.etxebarria@cleverbyte.tech,515685,ES71209582994069256416,7609.68,2024-03-01T11:03:43,Vitoria-Gasteiz,incomes,salary,3335.94,4531.95
buyer_3,Ana,Etxebarria,1989-08-23,09407087H,ana.etxebarria@cleverbyte.tech,515685,ES71209582994069256416,7609.68,2024-03-01T11:03:43,Vitoria-Gasteiz,incomes,salary_partner,3601.41,8133.36
buyer_3,Ana,Etxebarria,1989-08-23,09407087H,ana.etxebarria@cleverbyte.tech,515685,ES71209582994069256416,7609.68,2024-03-01T11:03:43,Vitoria-Gasteiz,incomes,extra_income,372.53,8505.89
buyer_3,Ana,Etxebarria,1989-08-23,09407087H,ana.etxebarria@cleverbyte.tech,515685,ES71209582994069256416,7609.68,2024-03-03T12:39:05,Vitoria-Gasteiz,expenses,leisure,-24.85,8481.04
buyer_3,Ana,Etxebarria,1989-08-23,09407087H,ana.etxebarria@cleverbyte.tech,515685,ES71209582994069256416,7609.68,2024-03-04T15:36:28,Vitoria-Gasteiz,expenses,repairs,-189.53,8291.51
buyer_3,Ana,Etxebarria,1989-08-23,09407087H,ana.etxebarria@cleverbyte.tech,515685,ES71209582994069256416,7609.68,2024-03-05T09:14:08,Vitoria-Gasteiz,expenses,mortgage,-3275.41,5016.1
buyer_3,Ana,Etxebarria,1989-08-23,09407087H,ana.etxebarria@cleverbyte.tech,515685,ES71209582994069256416,7609.68,2024-03-05T16:48:14,Vitoria-Gasteiz,expenses,water,-126.05,4890.05
buyer_3,Ana,Etxebarria,1989-08-23,09407087H,ana.etxebarria@cleverbyte.tech,515685,ES71209582994069256416,7609.68,2024-03-05T14:46:59,Vitoria-Gasteiz,expenses,gas,-276.64,4613.41
buyer_3,Ana,Etxebarria,1989-08-23,09407087H,ana.etxebarria@cleverbyte.tech,515685,ES71209582994069256416,7609.68,2024-03-05T11:19:05,Vitoria-Gasteiz,expenses,phone,-120.83,4492.58
buyer_3,Ana,Etxebarria,1989-08-23,09407087H,ana.etxebarria@cleverbyte.tech,515685,ES71209582994069256416,7609.68,2024-03-05T20:31:04,Vitoria-Gasteiz,expenses,leisure,-37.42,4455.16
buyer_3,Ana,Etxebarria,1989-08-23,09407087H,ana.etxebarria@cleverbyte.tech,515685,ES71209582994069256416,7609.68,2024-03-06T20:16:02,Vitoria-Gasteiz,expenses,electricity,-209.36,4245.8
buyer_3,Ana,Etxebarria,1989-08-23,09407087H,ana.etxebarria@cleverbyte.tech,515685,ES71209582994069256416,7609.68,2024-03-06T08:15:02,Vitoria-Gasteiz,expenses,internet,-145.68,4100.12
buyer_3,Ana,Etxebarria,1989-08-23,09407087H,ana.etxebarria@cleverbyte.tech,515685,ES71209582994069256416,7609.68,2024-03-07T11:58:20,Vitoria-Gasteiz,expenses,water,-71.7,4028.42
buyer_3,Ana,Etxebarria,1989-08-23,09407087H,ana.etxebarria@cleverbyte.tech,515685,ES71209582994069256416,7609.68,2024-03-07T08:51:47,Vitoria-Gasteiz,expenses,internet,-145.68,3882.74
buyer_3,Ana,Etxebarria,1989-08-23,09407087H,ana.etxebarria@cleverbyte.tech,515685,ES71209582994069256416,7609.68,2024-03-07T10:38:17,Vitoria-Gasteiz,expenses,food,-97.63,3785.11
buyer_3,Ana,Etxebarria,1989-08-23,09407087H,ana.etxebarria@cleverbyte.tech,515685,ES71209582994069256416,7609.68,2024-03-08T00:21:28,Vitoria-Gasteiz,expenses,gas,-302.26,3482.85
buyer_3,Ana,Etxebarria,1989-08-23,09407087H,ana.etxebarria@cleverbyte.tech,515685,ES71209582994069256416,7609.68,2024-03-08T18:32:09,Vitoria-Gasteiz,expenses,phone,-144.74,3338.11
buyer_3,Ana,Etxebarria,1989-08-23,09407087H,ana.etxebarria@cleverbyte.tech,515685,ES71209582994069256416,7609.68,2024-03-08T09:22:22,Vitoria-Gasteiz,expenses,cash,-100.0,3238.11
buyer_3,Ana,Etxebarria,1989-08-23,09407087H,ana.etxebarria@cleverbyte.tech,515685,ES71209582994069256416,7609.68,2024-03-09T16:26:01,Vitoria-Gasteiz,expenses,leisure,-42.26,3195.85
buyer_3,Ana,Etxebarria,1989-08-23,09407087H,ana.etxebarria@cleverbyte.tech,515685,ES71209582994069256416,7609.68,2024-03-12T12:46:17,Vitoria-Gasteiz,expenses,transport,-49.13,3146.72
buyer_3,Ana,Etxebarria,1989-08-23,09407087H,ana.etxebarria@cleverbyte.tech,515685,ES71209582994069256416,7609.68,2024-03-13T12:40:38,Vitoria-Gasteiz,expenses,food,-104.49,3042.23
buyer_3,Ana,Etxebarria,1989-08-23,09407087H,ana.etxebarria@cleverbyte.tech,515685,ES71209582994069256416,7609.68,2024-03-14T17:52:04,Vitoria-Gasteiz,expenses,cash,-100.0,2942.23
buyer_3,Ana,Etxebarria,1989-08-23,09407087H,ana.etxebarria@cleverbyte.tech,515685,ES71209582994069256416,7609.68,2024-03-15T15:23:20,Vitoria-Gasteiz,expenses,transport,-68.49,2873.74
buyer_3,Ana,Etxebarria,1989-08-23,09407087H,ana.etxebarria@cleverbyte.tech,515685,ES71209582994069256416,7609.68,2024-03-18T14:18:26,Vitoria-Gasteiz,expenses,leisure,-39.69,2834.05
buyer_3,Ana,Etxebarria,1989-08-23,09407087H,ana.etxebarria@cleverbyte.tech,515685,ES71209582994069256416,7609.68,2024-03-18T16:22:53,Vitoria-Gasteiz,expenses,education,-65.99,2768.06
buyer_3,Ana,Etxebarria,1989-08-23,09407087H,ana.etxebarria@cleverbyte.tech,515685,ES71209582994069256416,7609.68,2024-03-19T08:10:16,Vitoria-Gasteiz,expenses,food,-62.85,2705.21
buyer_3,Ana,Etxebarria,1989-08-23,09407087H,ana.etxebarria@cleverbyte.tech,515685,ES71209582994069256416,7609.68,2024-03-21T13:44:37,Vitoria-Gasteiz,expenses,leisure,-68.31,2636.9
buyer_3,Ana,Etxebarria,1989-08-23,09407087H,ana.etxebarria@cleverbyte.tech,515685,ES71209582994069256416,7609.68,2024-03-21T08:51:05,Vitoria-Gasteiz,expenses,clothing,-53.66,2583.24
buyer_3,Ana,Etxebarria,1989-08-23,09407087H,ana.etxebarria@cleverbyte.tech,515685,ES71209582994069256416,7609.68,2024-03-22T18:25:46,Vitoria-Gasteiz,expenses,food,-109.37,2473.87
buyer_3,Ana,Etxebarria,1989-08-23,09407087H,ana.etxebarria@cleverbyte.tech,515685,ES71209582994069256416,7609.68,2024-03-23T14:44:08,Vitoria-Gasteiz,expenses,food,-113.23,2360.64
buyer_3,Ana,Etxebarria,1989-08-23,09407087H,ana.etxebarria@cleverbyte.tech,515685,ES71209582994069256416,7609.68,2024-03-25T18:28:03,Vitoria-Gasteiz,expenses,cash,-100.0,2260.64
buyer_3,Ana,Etxebarria,1989-08-23,09407087H,ana.etxebarria@cleverbyte.tech,515685,ES71209582994069256416,7609.68,2024-03-25T17:25:52,Vitoria-Gasteiz,expenses,appliances,-221.48,2039.16
buyer_3,Ana,Etxebarria,1989-08-23,09407087H,ana.etxebarria@cleverbyte.tech,515685,ES71209582994069256416,7609.68,2024-03-26T21:22:29,Vitoria-Gasteiz,expenses,repairs,-219.8,1819.36
buyer_3,Ana,Etxebarria,1989-08-23,09407087H,ana.etxebarria@cleverbyte.tech,515685,ES71209582994069256416,7609.68,2024-03-29T16:31:37,Vitoria-Gasteiz,expenses,cash,-100.0,1719.36
buyer_3,Ana,Etxebarria,1989-08-23,09407087H,ana.etxebarria@cleverbyte.tech,515685,ES71209582994069256416,7609.68,2024-03-31T09:16:22,Vitoria-Gasteiz,expenses,food,-107.91,1611.45
buyer_3,Ana,Etxebarria,1989-08-23,09407087H,ana.etxebarria@cleverbyte.tech,515685,ES71209582994069256416,7609.68,2024-03-31T12:32:23,Vitoria-Gasteiz,expenses,clothing,-90.94,1520.51
buyer_3,Ana,Etxebarria,1989-08-23,09407087H,ana.etxebarria@cleverbyte.tech,515685,ES71209582994069256416,7609.68,2024-04-01T12:35:12,Vitoria-Gasteiz,incomes,salary,3335.94,4856.45
buyer_3,Ana,Etxebarria,1989-08-23,09407087H,ana.etxebarria@cleverbyte.tech,515685,ES71209582994069256416,7609.68,2024-04-01T12:35:12,Vitoria-Gasteiz,incomes,salary_partner,3601.41,8457.86
buyer_3,Ana,Etxebarria,1989-08-23,09407087H,ana.etxebarria@cleverbyte.tech,515685,ES71209582994069256416,7609.68,2024-04-01T09:47:37,Vitoria-Gasteiz,expenses,food,-114.24,8343.62
buyer_3,Ana,Etxebarria,1989-08-23,09407087H,ana.etxebarria@cleverbyte.tech,515685,ES71209582994069256416,7609.68,2024-04-01T13:38:09,Vitoria-Gasteiz,expenses,appliances,-330.37,8013.25
buyer_3,Ana,Etxebarria,1989-08-23,09407087H,ana.etxebarria@cleverbyte.tech,515685,ES71209582994069256416,7609.68,2024-04-02T09:03:00,Vitoria-Gasteiz,expenses,repairs,-92.66,7920.59
buyer_3,Ana,Etxebarria,1989-08-23,09407087H,ana.etxebarria@cleverbyte.tech,515685,ES71209582994069256416,7609.68,2024-04-03T13:14:10,Vitoria-Gasteiz,expenses,food,-88.25,7832.34
buyer_3,Ana,Etxebarria,1989-08-23,09407087H,ana.etxebarria@cleverbyte.tech,515685,ES71209582994069256416,7609.68,2024-04-03T14:13:42,Vitoria-Gasteiz,expenses,cash,-100.0,7732.34
buyer_3,Ana,Etxebarria,1989-08-23,09407087H,ana.etxebarria@cleverbyte.tech,515685,ES71209582994069256416,7609.68,2024-04-04T23:08:18,Vitoria-Gasteiz,expenses,cash,-100.0,7632.34
buyer_3,Ana,Etxebarria,1989-08-23,09407087H,ana.etxebarria@cleverbyte.tech,515685,ES71209582994069256416,7609.68,2024-04-05T14:43:23,Vitoria-Gasteiz,expenses,mortgage,-3275.41,4356.93
buyer_3,Ana,Etxebarria,1989-08-23,09407087H,ana.etxebarria@cleverbyte.tech,515685,ES71209582994069256416,7609.68,2024-04-05T22:06:42,Vitoria-Gasteiz,expenses,food,-100.41,4256.52
buyer_3,Ana,Etxebarria,1989-08-23,09407087H,ana.etxebarria@cleverbyte.tech,515685,ES71209582994069256416,7609.68,2024-04-06T13:27:05,Vitoria-Gasteiz,expenses,gas,-211.61,4044.91
buyer_3,Ana,Etxebarria,1989-08-23,09407087H,ana.etxebarria@cleverbyte.tech,515685,ES71209582994069256416,7609.68,2024-04-07T08:53:56,Vitoria-Gasteiz,expenses,electricity,-213.03,3831.88
buyer_3,Ana,Etxebarria,1989-08-23,09407087H,ana.etxebarria@cleverbyte.tech,515685,ES71209582994069256416,7609.68,2024-04-08T16:47:53,Vitoria-Gasteiz,expenses,electricity,-183.48,3648.4
buyer_3,Ana,Etxebarria,1989-08-23,09407087H,ana.etxebarria@cleverbyte.tech,515685,ES71209582994069256416,7609.68,2024-04-08T22:06:15,Vitoria-Gasteiz,expenses,clothing,-103.42,3544.98
buyer_3,Ana,Etxebarria,1989-08-23,09407087H,ana.etxebarria@cleverbyte.tech,515685,ES71209582994069256416,7609.68,2024-04-09T09:59:58,Vitoria-Gasteiz,expenses,food,-116.46,3428.52
buyer_3,Ana,Etxebarria,1989-08-23,09407087H,ana.etxebarria@cleverbyte.tech,515685,ES71209582994069256416,7609.68,2024-04-09T14:31:18,Vitoria-Gasteiz,expenses,leisure,-82.8,3345.72
buyer_3,Ana,Etxebarria,1989-08-23,09407087H,ana.etxebarria@cleverbyte.tech,515685,ES71209582994069256416,7609.68,2024-04-12T19:48:18,Vitoria-Gasteiz,expenses,food,-109.7,3236.02
buyer_3,Ana,Etxebarria,1989-08-23,09407087H,ana.etxebarria@cleverbyte.tech,515685,ES71209582994069256416,7609.68,2024-04-12T13:58:56,Vitoria-Gasteiz,expenses,education,-59.47,3176.55
buyer_3,Ana,Etxebarria,1989-08-23,09407087H,ana.etxebarria@cleverbyte.tech,515685,ES71209582994069256416,7609.68,2024-04-13T09:31:10,Vitoria-Gasteiz,expenses,food,-105.99,3070.56
buyer_3,Ana,Etxebarria,1989-08-23,09407087H,ana.etxebarria@cleverbyte.tech,515685,ES71209582994069256416,7609.68,2024-04-13T11:19:49,Vitoria-Gasteiz,expenses,cash,-100.0,2970.56
buyer_3,Ana,Etxebarria,1989-08-23,09407087H,ana.etxebarria@cleverbyte.tech,515685,ES71209582994069256416,7609.68,2024-04-14T10:54:35,Vitoria-Gasteiz,expenses,food,-80.6,2889.96
buyer_3,Ana,Etxebarria,1989-08-23,09407087H,ana.etxebarria@cleverbyte.tech,515685,ES71209582994069256416,7609.68,2024-04-14T04:16:08,Vitoria-Gasteiz,expenses,appliances,-249.6,2640.36
buyer_3,Ana,Etxebarria,1989-08-23,09407087H,ana.etxebarria@cleverbyte.tech,515685,ES71209582994069256416,7609.68,2024-04-16T10:28:13,Vitoria-Gasteiz,expenses,food,-103.5,2536.86
buyer_3,Ana,Etxebarria,1989-08-23,09407087H,ana.etxebarria@cleverbyte.tech,515685,ES71209582994069256416,7609.68,2024-04-17T10:44:00,Vitoria-Gasteiz,expenses,food,-88.4,2448.46
buyer_3,Ana,Etxebarria,1989-08-23,09407087H,ana.etxebarria@cleverbyte.tech,515685,ES71209582994069256416,7609.68,2024-04-20T17:39:14,Vitoria-Gasteiz,expenses,leisure,-63.35,2385.11
buyer_3,Ana,Etxebarria,1989-08-23,09407087H,ana.etxebarria@cleverbyte.tech,515685,ES71209582994069256416,7609.68,2024-04-20T19:44:33,Vitoria-Gasteiz,expenses,cash,-100.0,2285.11
buyer_3,Ana,Etxebarria,1989-08-23,09407087H,ana.etxebarria@cleverbyte.tech,515685,ES71209582994069256416,7609.68,2024-04-23T17:23:10,Vitoria-Gasteiz,expenses,food,-75.75,2209.36
buyer_3,Ana,Etxebarria,1989-08-23,09407087H,ana.etxebarria@cleverbyte.tech,515685,ES71209582994069256416,7609.68,2024-04-23T09:54:20,Vitoria-Gasteiz,expenses,leisure,-79.94,2129.42
buyer_3,Ana,Etxebarria,1989-08-23,09407087H,ana.etxebarria@cleverbyte.tech,515685,ES71209582994069256416,7609.68,2024-04-24T17:41:05,Vitoria-Gasteiz,expenses,healthcare,-127.9,2001.52
buyer_3,Ana,Etxebarria,1989-08-23,09407087H,ana.etxebarria@cleverbyte.tech,515685,ES71209582994069256416,7609.68,2024-04-25T14:42:15,Vitoria-Gasteiz,expenses,food,-88.72,1912.8
buyer_3,Ana,Etxebarria,1989-08-23,09407087H,ana.etxebarria@cleverbyte.tech,515685,ES71209582994069256416,7609.68,2024-04-25T20:12:04,Vitoria-Gasteiz,expenses,leisure,-75.08,1837.72
buyer_3,Ana,Etxebarria,1989-08-23,09407087H,ana.etxebarria@cleverbyte.tech,515685,ES71209582994069256416,7609.68,2024-04-26T23:23:43,Vitoria-Gasteiz,expenses,transport,-66.15,1771.57
buyer_3,Ana,Etxebarria,1989-08-23,09407087H,ana.etxebarria@cleverbyte.tech,515685,ES71209582994069256416,7609.68,2024-04-27T13:51:23,Vitoria-Gasteiz,expenses,cash,-100.0,1671.57
buyer_3,Ana,Etxebarria,1989-08-23,09407087H,ana.etxebarria@cleverbyte.tech,515685,ES71209582994069256416,7609.68,2024-04-29T19:14:55,Vitoria-Gasteiz,expenses,food,-64.03,1607.54
buyer_3,Ana,Etxebarria,1989-08-23,09407087H,ana.etxebarria@cleverbyte.tech,515685,ES71209582994069256416,7609.68,2024-04-29T11:48:07,Vitoria-Gasteiz,expenses,transport,-64.66,1542.88
buyer_3,Ana,Etxebarria,1989-08-23,09407087H,ana.etxebarria@cleverbyte.tech,515685,ES71209582994069256416,7609.68,2024-05-01T23:53:48,Vitoria-Gasteiz,incomes,salary,3335.94,4878.82
buyer_3,Ana,Etxebarria,1989-08-23,09407087H,ana.etxebarria@cleverbyte.tech,515685,ES71209582994069256416,7609.68,2024-05-01T23:53:48,Vitoria-Gasteiz,incomes,salary_partner,3601.41,8480.23
buyer_3,Ana,Etxebarria,1989-08-23,09407087H,ana.etxebarria@cleverbyte.tech,515685,ES71209582994069256416,7609.68,2024-05-01T14:07:25,Vitoria-Gasteiz,expenses,food,-66.56,8413.67
buyer_3,Ana,Etxebarria,1989-08-23,09407087H,ana.etxebarria@cleverbyte.tech,515685,ES71209582994069256416,7609.68,2024-05-02T01:21:17,Vitoria-Gasteiz,expenses,food,-103.16,8310.51
buyer_3,Ana,Etxebarria,1989-08-23,09407087H,ana.etxebarria@cleverbyte.tech,515685,ES71209582994069256416,7609.68,2024-05-02T10:51:36,Vitoria-Gasteiz,expenses,transport,-88.19,8222.32
buyer_3,Ana,Etxebarria,1989-08-23,09407087H,ana.etxebarria@cleverbyte.tech,515685,ES71209582994069256416,7609.68,2024-05-02T19:16:43,Vitoria-Gasteiz,expenses,cash,-100.0,8122.32
buyer_3,Ana,Etxebarria,1989-08-23,09407087H,ana.etxebarria@cleverbyte.tech,515685,ES71209582994069256416,7609.68,2024-05-04T10:17:17,Vitoria-Gasteiz,expenses,food,-96.94,8025.38
buyer_3,Ana,Etxebarria,1989-08-23,09407087H,ana.etxebarria@cleverbyte.tech,515685,ES71209582994069256416,7609.68,2024-05-04T15:12:27,Vitoria-Gasteiz,expenses,transport,-67.04,7958.34
buyer_3,Ana,Etxebarria,1989-08-23,09407087H,ana.etxebarria@cleverbyte.tech,515685,ES71209582994069256416,7609.68,2024-05-05T15:57:55,Vitoria-Gasteiz,expenses,mortgage,-3275.41,4682.93
buyer_3,Ana,Etxebarria,1989-08-23,09407087H,ana.etxebarria@cleverbyte.tech,515685,ES71209582994069256416,7609.68,2024-05-05T20:48:20,Vitoria-Gasteiz,expenses,gas,-284.58,4398.35
buyer_3,Ana,Etxebarria,1989-08-23,09407087H,ana.etxebarria@cleverbyte.tech,515685,ES71209582994069256416,7609.68,2024-05-06T18:18:12,Vitoria-Gasteiz,expenses,water,-117.36,4280.99
buyer_3,Ana,Etxebarria,1989-08-23,09407087H,ana.etxebarria@cleverbyte.tech,515685,ES71209582994069256416,7609.68,2024-05-06T20:08:08,Vitoria-Gasteiz,expenses,electricity,-255.69,4025.3
buyer_3,Ana,Etxebarria,1989-08-23,09407087H,ana.etxebarria@cleverbyte.tech,515685,ES71209582994069256416,7609.68,2024-05-06T08:43:24,Vitoria-Gasteiz,expenses,gifts,-474.88,3550.42
buyer_3,Ana,Etxebarria,1989-08-23,09407087H,ana.etxebarria@cleverbyte.tech,515685,ES71209582994069256416,7609.68,2024-05-07T13:51:38,Vitoria-Gasteiz,expenses,phone,-115.69,3434.73
buyer_3,Ana,Etxebarria,1989-08-23,09407087H,ana.etxebarria@cleverbyte.tech,515685,ES71209582994069256416,7609.68,2024-05-08T04:55:34,Vitoria-Gasteiz,expenses,leisure,-61.04,3373.69
buyer_3,Ana,Etxebarria,1989-08-23,09407087H,ana.etxebarria@cleverbyte.tech,515685,ES71209582994069256416,7609.68,2024-05-08T09:16:49,Vitoria-Gasteiz,expenses,education,-67.37,3306.32
buyer_3,Ana,Etxebarria,1989-08-23,09407087H,ana.etxebarria@cleverbyte.tech,515685,ES71209582994069256416,7609.68,2024-05-09T16:27:19,Vitoria-Gasteiz,expenses,food,-84.79,3221.53
buyer_3,Ana,Etxebarria,1989-08-23,09407087H,ana.etxebarria@cleverbyte.tech,515685,ES71209582994069256416,7609.68,2024-05-10T09:28:18,Vitoria-Gasteiz,expenses,food,-97.57,3123.96
buyer_3,Ana,Etxebarria,1989-08-23,09407087H,ana.etxebarria@cleverbyte.tech,515685,ES71209582994069256416,7609.68,2024-05-10T15:03:28,Vitoria-Gasteiz,expenses,gifts,-823.64,2300.32
buyer_3,Ana,Etxebarria,1989-08-23,09407087H,ana.etxebarria@cleverbyte.tech,515685,ES71209582994069256416,7609.68,2024-05-11T20:27:09,Vitoria-Gasteiz,expenses,food,-88.15,2212.17
buyer_3,Ana,Etxebarria,1989-08-23,09407087H,ana.etxebarria@cleverbyte.tech,515685,ES71209582994069256416,7609.68,2024-05-12T17:21:31,Vitoria-Gasteiz,expenses,leisure,-65.86,2146.31
buyer_3,Ana,Etxebarria,1989-08-23,09407087H,ana.etxebarria@cleverbyte.tech,515685,ES71209582994069256416,7609.68,2024-05-14T11:56:20,Vitoria-Gasteiz,expenses,leisure,-29.67,2116.64
buyer_3,Ana,Etxebarria,1989-08-23,09407087H,ana.etxebarria@cleverbyte.tech,515685,ES71209582994069256416,7609.68,2024-05-15T00:40:36,Vitoria-Gasteiz,expenses,gifts,-835.79,1280.85
buyer_3,Ana,Etxebarria,1989-08-23,09407087H,ana.etxebarria@cleverbyte.tech,515685,ES71209582994069256416,7609.68,2024-05-18T13:41:43,Vitoria-Gasteiz,expenses,clothing,-64.18,1216.67
buyer_3,Ana,Etxebarria,1989-08-23,09407087H,ana.etxebarria@cleverbyte.tech,515685,ES71209582994069256416,7609.68,2024-05-22T13:15:53,Vitoria-Gasteiz,expenses,transport,-86.27,1130.4
buyer_3,Ana,Etxebarria,1989-08-23,09407087H,ana.etxebarria@cleverbyte.tech,515685,ES71209582994069256416,7609.68,2024-05-23T18:32:11,Vitoria-Gasteiz,expenses,transport,-83.34,1047.06
buyer_3,Ana,Etxebarria,1989-08-23,09407087H,ana.etxebarria@cleverbyte.tech,515685,ES71209582994069256416,7609.68,2024-05-23T14:03:02,Vitoria-Gasteiz,expenses,leisure,-71.58,975.48
buyer_3,Ana,Etxebarria,1989-08-23,09407087H,ana.etxebarria@cleverbyte.tech,515685,ES71209582994069256416,7609.68,2024-05-23T19:03:11,Vitoria-Gasteiz,expenses,cash,-100.0,875.48
buyer_3,Ana,Etxebarria,1989-08-23,09407087H,ana.etxebarria@cleverbyte.tech,515685,ES71209582994069256416,7609.68,2024-05-24T02:26:29,Vitoria-Gasteiz,expenses,cash,-100.0,775.48
buyer_3,Ana,Etxebarria,1989-08-23,09407087H,ana.etxebarria@cleverbyte.tech,515685,ES71209582994069256416,7609.68,2024-05-25T15:24:52,Vitoria-Gasteiz,expenses,food,-81.0,694.48
buyer_3,Ana,Etxebarria,1989-08-23,09407087H,ana.etxebarria@cleverbyte.tech,515685,ES71209582994069256416,7609.68,2024-05-26T14:49:17,Vitoria-Gasteiz,expenses,repairs,-30.91,663.57
buyer_3,Ana,Etxebarria,1989-08-23,09407087H,ana.etxebarria@cleverbyte.tech,515685,ES71209582994069256416,7609.68,2024-05-27T10:06:47,Vitoria-Gasteiz,expenses,transport,-57.89,605.68
buyer_3,Ana,Etxebarria,1989-08-23,09407087H,ana.etxebarria@cleverbyte.tech,515685,ES71209582994069256416,7609.68,2024-05-28T08:22:26,Vitoria-Gasteiz,expenses,education,-76.81,528.87
buyer_3,Ana,Etxebarria,1989-08-23,09407087H,ana.etxebarria@cleverbyte.tech,515685,ES71209582994069256416,7609.68,2024-05-30T16:08:33,Vitoria-Gasteiz,expenses,repairs,-33.39,495.48
buyer_3,Ana,Etxebarria,1989-08-23,09407087H,ana.etxebarria@cleverbyte.tech,515685,ES71209582994069256416,7609.68,2024-05-31T06:54:26,Vitoria-Gasteiz,expenses,food,-84.39,411.09
buyer_3,Ana,Etxebarria,1989-08-23,09407087H,ana.etxebarria@cleverbyte.tech,515685,ES71209582994069256416,7609.68,2024-05-31T07:45:31,Vitoria-Gasteiz,expenses,gifts,-637.18,-226.09
buyer_3,Ana,Etxebarria,1989-08-23,09407087H,ana.etxebarria@cleverbyte.tech,515685,ES71209582994069256416,7609.68,2024-06-01T22:13:53,Vitoria-Gasteiz,incomes,salary,3335.94,3109.85
buyer_3,Ana,Etxebarria,1989-08-23,09407087H,ana.etxebarria@cleverbyte.tech,515685,ES71209582994069256416,7609.68,2024-06-01T22:13:53,Vitoria-Gasteiz,incomes,salary_partner,3601.41,6711.26
buyer_3,Ana,Etxebarria,1989-08-23,09407087H,ana.etxebarria@cleverbyte.tech,515685,ES71209582994069256416,7609.68,2024-06-01T22:13:53,Vitoria-Gasteiz,incomes,extra_income,372.53,7083.79
buyer_3,Ana,Etxebarria,1989-08-23,09407087H,ana.etxebarria@cleverbyte.tech,515685,ES71209582994069256416,7609.68,2024-06-01T22:13:53,Vitoria-Gasteiz,incomes,salary_bonus,2656.63,9740.42
buyer_3,Ana,Etxebarria,1989-08-23,09407087H,ana.etxebarria@cleverbyte.tech,515685,ES71209582994069256416,7609.68,2024-06-01T22:13:53,Vitoria-Gasteiz,incomes,salary_partner_bonus,2635.63,12376.05
buyer_3,Ana,Etxebarria,1989-08-23,09407087H,ana.etxebarria@cleverbyte.tech,515685,ES71209582994069256416,7609.68,2024-06-01T08:03:18,Vitoria-Gasteiz,expenses,cash,-100.0,12276.05
buyer_3,Ana,Etxebarria,1989-08-23,09407087H,ana.etxebarria@cleverbyte.tech,515685,ES71209582994069256416,7609.68,2024-06-02T01:17:23,Vitoria-Gasteiz,expenses,taxes,-5049.98,7226.07
buyer_3,Ana,Etxebarria,1989-08-23,09407087H,ana.etxebarria@cleverbyte.tech,515685,ES71209582994069256416,7609.68,2024-06-02T09:34:06,Vitoria-Gasteiz,expenses,insurance,-1926.98,5299.09
buyer_3,Ana,Etxebarria,1989-08-23,09407087H,ana.etxebarria@cleverbyte.tech,515685,ES71209582994069256416,7609.68,2024-06-04T12:57:13,Vitoria-Gasteiz,expenses,food,-96.46,5202.63
buyer_3,Ana,Etxebarria,1989-08-23,09407087H,ana.etxebarria@cleverbyte.tech,515685,ES71209582994069256416,7609.68,2024-06-04T12:46:04,Vitoria-Gasteiz,expenses,leisure,-19.34,5183.29
buyer_3,Ana,Etxebarria,1989-08-23,09407087H,ana.etxebarria@cleverbyte.tech,515685,ES71209582994069256416,7609.68,2024-06-04T01:39:48,Vitoria-Gasteiz,expenses,clothing,-124.33,5058.96
buyer_3,Ana,Etxebarria,1989-08-23,09407087H,ana.etxebarria@cleverbyte.tech,515685,ES71209582994069256416,7609.68,2024-06-05T10:53:44,Vitoria-Gasteiz,expenses,mortgage,-3275.41,1783.55
buyer_3,Ana,Etxebarria,1989-08-23,09407087H,ana.etxebarria@cleverbyte.tech,515685,ES71209582994069256416,7609.68,2024-06-06T17:29:52,Vitoria-Gasteiz,expenses,gas,-164.37,1619.18
buyer_3,Ana,Etxebarria,1989-08-23,09407087H,ana.etxebarria@cleverbyte.tech,515685,ES71209582994069256416,7609.68,2024-06-06T10:10:11,Vitoria-Gasteiz,expenses,leisure,-58.6,1560.58
buyer_3,Ana,Etxebarria,1989-08-23,09407087H,ana.etxebarria@cleverbyte.tech,515685,ES71209582994069256416,7609.68,2024-06-07T09:18:14,Vitoria-Gasteiz,expenses,electricity,-141.47,1419.11
buyer_3,Ana,Etxebarria,1989-08-23,09407087H,ana.etxebarria@cleverbyte.tech,515685,ES71209582994069256416,7609.68,2024-06-07T23:01:56,Vitoria-Gasteiz,expenses,transport,-42.02,1377.09
buyer_3,Ana,Etxebarria,1989-08-23,09407087H,ana.etxebarria@cleverbyte.tech,515685,ES71209582994069256416,7609.68,2024-06-09T12:39:56,Vitoria-Gasteiz,expenses,food,-121.93,1255.16
buyer_3,Ana,Etxebarria,1989-08-23,09407087H,ana.etxebarria@cleverbyte.tech,515685,ES71209582994069256416,7609.68,2024-06-12T08:57:28,Vitoria-Gasteiz,expenses,food,-68.5,1186.66
buyer_3,Ana,Etxebarria,1989-08-23,09407087H,ana.etxebarria@cleverbyte.tech,515685,ES71209582994069256416,7609.68,2024-06-13T13:21:53,Vitoria-Gasteiz,expenses,cash,-100.0,1086.66
buyer_3,Ana,Etxebarria,1989-08-23,09407087H,ana.etxebarria@cleverbyte.tech,515685,ES71209582994069256416,7609.68,2024-06-14T11:21:37,Vitoria-Gasteiz,expenses,leisure,-48.95,1037.71
buyer_3,Ana,Etxebarria,1989-08-23,09407087H,ana.etxebarria@cleverbyte.tech,515685,ES71209582994069256416,7609.68,2024-06-17T22:01:06,Vitoria-Gasteiz,expenses,clothing,-98.23,939.48
buyer_3,Ana,Etxebarria,1989-08-23,09407087H,ana.etxebarria@cleverbyte.tech,515685,ES71209582994069256416,7609.68,2024-06-17T14:24:51,Vitoria-Gasteiz,expenses,appliances,-365.12,574.36
buyer_3,Ana,Etxebarria,1989-08-23,09407087H,ana.etxebarria@cleverbyte.tech,515685,ES71209582994069256416,7609.68,2024-06-18T06:29:17,Vitoria-Gasteiz,expenses,leisure,-54.0,520.36
buyer_3,Ana,Etxebarria,1989-08-23,09407087H,ana.etxebarria@cleverbyte.tech,515685,ES71209582994069256416,7609.68,2024-06-22T12:45:12,Vitoria-Gasteiz,expenses,cash,-100.0,420.36
buyer_3,Ana,Etxebarria,1989-08-23,09407087H,ana.etxebarria@cleverbyte.tech,515685,ES71209582994069256416,7609.68,2024-06-24T14:24:44,Vitoria-Gasteiz,expenses,food,-109.64,310.72
buyer_3,Ana,Etxebarria,1989-08-23,09407087H,ana.etxebarria@cleverbyte.tech,515685,ES71209582994069256416,7609.68,2024-06-24T14:10:06,Vitoria-Gasteiz,expenses,clothing,-85.15,225.57
buyer_3,Ana,Etxebarria,1989-08-23,09407087H,ana.etxebarria@cleverbyte.tech,515685,ES71209582994069256416,7609.68,2024-06-27T19:50:41,Vitoria-Gasteiz,expenses,transport,-52.8,172.77
buyer_3,Ana,Etxebarria,1989-08-23,09407087H,ana.etxebarria@cleverbyte.tech,515685,ES71209582994069256416,7609.68,2024-06-27T12:37:40,Vitoria-Gasteiz,expenses,education,-59.21,113.56
buyer_3,Ana,Etxebarria,1989-08-23,09407087H,ana.etxebarria@cleverbyte.tech,515685,ES71209582994069256416,7609.68,2024-06-28T20:20:32,Vitoria-Gasteiz,expenses,food,-111.97,1.59
buyer_3,Ana,Etxebarria,1989-08-23,09407087H,ana.etxebarria@cleverbyte.tech,515685,ES71209582994069256416,7609.68,2024-06-29T08:50:26,Vitoria-Gasteiz,expenses,healthcare,-95.46,-93.87
buyer_3,Ana,Etxebarria,1989-08-23,09407087H,ana.etxebarria@cleverbyte.tech,515685,ES71209582994069256416,7609.68,2024-06-30T09:50:05,Vitoria-Gasteiz,expenses,food,-83.64,-177.51
buyer_3,Ana,Etxebarria,1989-08-23,09407087H,ana.etxebarria@cleverbyte.tech,515685,ES71209582994069256416,7609.68,2024-06-30T13:54:10,Vitoria-Gasteiz,expenses,education,-58.69,-236.2
buyer_3,Ana,Etxebarria,1989-08-23,09407087H,ana.etxebarria@cleverbyte.tech,515685,ES71209582994069256416,7609.68,2024-07-01T14:03:49,Vitoria-Gasteiz,incomes,salary,3335.94,3099.74
buyer_3,Ana,Etxebarria,1989-08-23,09407087H,ana.etxebarria@cleverbyte.tech,515685,ES71209582994069256416,7609.68,2024-07-01T14:03:49,Vitoria-Gasteiz,incomes,salary_partner,3601.41,6701.15
buyer_3,Ana,Etxebarria,1989-08-23,09407087H,ana.etxebarria@cleverbyte.tech,515685,ES71209582994069256416,7609.68,2024-07-01T14:48:27,Vitoria-Gasteiz,expenses,cash,-100.0,6601.15
buyer_3,Ana,Etxebarria,1989-08-23,09407087H,ana.etxebarria@cleverbyte.tech,515685,ES71209582994069256416,7609.68,2024-07-02T03:38:33,Vitoria-Gasteiz,expenses,food,-69.61,6531.54
buyer_3,Ana,Etxebarria,1989-08-23,09407087H,ana.etxebarria@cleverbyte.tech,515685,ES71209582994069256416,7609.68,2024-07-03T23:28:26,Vitoria-Gasteiz,expenses,leisure,-55.24,6476.3
buyer_3,Ana,Etxebarria,1989-08-23,09407087H,ana.etxebarria@cleverbyte.tech,515685,ES71209582994069256416,7609.68,2024-07-03T10:50:49,Vitoria-Gasteiz,expenses,gifts,-557.53,5918.77
buyer_3,Ana,Etxebarria,1989-08-23,09407087H,ana.etxebarria@cleverbyte.tech,515685,ES71209582994069256416,7609.68,2024-07-05T20:33:28,Vitoria-Gasteiz,expenses,mortgage,-3275.41,2643.36
buyer_3,Ana,Etxebarria,1989-08-23,09407087H,ana.etxebarria@cleverbyte.tech,515685,ES71209582994069256416,7609.68,2024-07-05T08:01:00,Vitoria-Gasteiz,expenses,phone,-112.44,2530.92
buyer_3,Ana,Etxebarria,1989-08-23,09407087H,ana.etxebarria@cleverbyte.tech,515685,ES71209582994069256416,7609.68,2024-07-05T08:26:24,Vitoria-Gasteiz,expenses,clothing,-59.48,2471.44
buyer_3,Ana,Etxebarria,1989-08-23,09407087H,ana.etxebarria@cleverbyte.tech,515685,ES71209582994069256416,7609.68,2024-07-05T09:58:32,Vitoria-Gasteiz,expenses,cash,-100.0,2371.44
buyer_3,Ana,Etxebarria,1989-08-23,09407087H,ana.etxebarria@cleverbyte.tech,515685,ES71209582994069256416,7609.68,2024-07-07T18:34:39,Vitoria-Gasteiz,expenses,electricity,-191.02,2180.42
buyer_3,Ana,Etxebarria,1989-08-23,09407087H,ana.etxebarria@cleverbyte.tech,515685,ES71209582994069256416,7609.68,2024-07-07T13:14:35,Vitoria-Gasteiz,expenses,transport,-81.75,2098.67
buyer_3,Ana,Etxebarria,1989-08-23,09407087H,ana.etxebarria@cleverbyte.tech,515685,ES71209582994069256416,7609.68,2024-07-08T18:01:57,Vitoria-Gasteiz,expenses,clothing,-86.05,2012.62
buyer_3,Ana,Etxebarria,1989-08-23,09407087H,ana.etxebarria@cleverbyte.tech,515685,ES71209582994069256416,7609.68,2024-07-08T21:54:18,Vitoria-Gasteiz,expenses,education,-66.87,1945.75
buyer_3,Ana,Etxebarria,1989-08-23,09407087H,ana.etxebarria@cleverbyte.tech,515685,ES71209582994069256416,7609.68,2024-07-11T23:59:48,Vitoria-Gasteiz,expenses,food,-119.67,1826.08
buyer_3,Ana,Etxebarria,1989-08-23,09407087H,ana.etxebarria@cleverbyte.tech,515685,ES71209582994069256416,7609.68,2024-07-14T10:50:29,Vitoria-Gasteiz,expenses,food,-93.07,1733.01
buyer_3,Ana,Etxebarria,1989-08-23,09407087H,ana.etxebarria@cleverbyte.tech,515685,ES71209582994069256416,7609.68,2024-07-14T15:51:11,Vitoria-Gasteiz,expenses,leisure,-31.85,1701.16
buyer_3,Ana,Etxebarria,1989-08-23,09407087H,ana.etxebarria@cleverbyte.tech,515685,ES71209582994069256416,7609.68,2024-07-14T15:56:34,Vitoria-Gasteiz,expenses,cash,-100.0,1601.16
buyer_3,Ana,Etxebarria,1989-08-23,09407087H,ana.etxebarria@cleverbyte.tech,515685,ES71209582994069256416,7609.68,2024-07-14T01:00:54,Vitoria-Gasteiz,expenses,gifts,-63.55,1537.61
buyer_3,Ana,Etxebarria,1989-08-23,09407087H,ana.etxebarria@cleverbyte.tech,515685,ES71209582994069256416,7609.68,2024-07-16T18:11:53,Vitoria-Gasteiz,expenses,food,-118.7,1418.91
buyer_3,Ana,Etxebarria,1989-08-23,09407087H,ana.etxebarria@cleverbyte.tech,515685,ES71209582994069256416,7609.68,2024-07-20T12:41:50,Vitoria-Gasteiz,expenses,food,-75.74,1343.17
buyer_3,Ana,Etxebarria,1989-08-23,09407087H,ana.etxebarria@cleverbyte.tech,515685,ES71209582994069256416,7609.68,2024-07-20T00:10:42,Vitoria-Gasteiz,expenses,leisure,-63.49,1279.68
buyer_3,Ana,Etxebarria,1989-08-23,09407087H,ana.etxebarria@cleverbyte.tech,515685,ES71209582994069256416,7609.68,2024-07-20T20:55:30,Vitoria-Gasteiz,expenses,cash,-100.0,1179.68
buyer_3,Ana,Etxebarria,1989-08-23,09407087H,ana.etxebarria@cleverbyte.tech,515685,ES71209582994069256416,7609.68,2024-07-22T08:23:53,Vitoria-Gasteiz,expenses,transport,-41.86,1137.82
buyer_3,Ana,Etxebarria,1989-08-23,09407087H,ana.etxebarria@cleverbyte.tech,515685,ES71209582994069256416,7609.68,2024-07-22T14:27:13,Vitoria-Gasteiz,expenses,leisure,-52.5,1085.32
buyer_3,Ana,Etxebarria,1989-08-23,09407087H,ana.etxebarria@cleverbyte.tech,515685,ES71209582994069256416,7609.68,2024-07-25T12:38:42,Vitoria-Gasteiz,expenses,cash,-100.0,985.32
buyer_3,Ana,Etxebarria,1989-08-23,09407087H,ana.etxebarria@cleverbyte.tech,515685,ES71209582994069256416,7609.68,2024-07-27T16:23:38,Vitoria-Gasteiz,expenses,repairs,-213.82,771.5
buyer_3,Ana,Etxebarria,1989-08-23,09407087H,ana.etxebarria@cleverbyte.tech,515685,ES71209582994069256416,7609.68,2024-07-28T17:20:08,Vitoria-Gasteiz,expenses,healthcare,-181.08,590.42
buyer_3,Ana,Etxebarria,1989-08-23,09407087H,ana.etxebarria@cleverbyte.tech,515685,ES71209582994069256416,7609.68,2024-07-29T11:40:24,Vitoria-Gasteiz,expenses,food,-63.26,527.16
buyer_3,Ana,Etxebarria,1989-08-23,09407087H,ana.etxebarria@cleverbyte.tech,515685,ES71209582994069256416,7609.68,2024-07-31T12:22:38,Vitoria-Gasteiz,expenses,cash,-100.0,427.16
buyer_3,Ana,Etxebarria,1989-08-23,09407087H,ana.etxebarria@cleverbyte.tech,515685,ES71209582994069256416,7609.68,2024-08-01T09:00:08,Vitoria-Gasteiz,incomes,salary,3335.94,3763.1
buyer_3,Ana,Etxebarria,1989-08-23,09407087H,ana.etxebarria@cleverbyte.tech,515685,ES71209582994069256416,7609.68,2024-08-01T09:00:08,Vitoria-Gasteiz,incomes,salary_partner,3601.41,7364.51
buyer_3,Ana,Etxebarria,1989-08-23,09407087H,ana.etxebarria@cleverbyte.tech,515685,ES71209582994069256416,7609.68,2024-08-01T17:03:07,Vitoria-Gasteiz,expenses,transport,-61.9,7302.61
buyer_3,Ana,Etxebarria,1989-08-23,09407087H,ana.etxebarria@cleverbyte.tech,515685,ES71209582994069256416,7609.68,2024-08-01T11:00:26,Vitoria-Gasteiz,expenses,repairs,-88.12,7214.49
buyer_3,Ana,Etxebarria,1989-08-23,09407087H,ana.etxebarria@cleverbyte.tech,515685,ES71209582994069256416,7609.68,2024-08-02T16:43:27,Vitoria-Gasteiz,expenses,cash,-100.0,7114.49
buyer_3,Ana,Etxebarria,1989-08-23,09407087H,ana.etxebarria@cleverbyte.tech,515685,ES71209582994069256416,7609.68,2024-08-04T15:44:28,Vitoria-Gasteiz,expenses,gifts,-380.59,6733.9
buyer_3,Ana,Etxebarria,1989-08-23,09407087H,ana.etxebarria@cleverbyte.tech,515685,ES71209582994069256416,7609.68,2024-08-05T21:12:36,Vitoria-Gasteiz,expenses,mortgage,-3275.41,3458.49
buyer_3,Ana,Etxebarria,1989-08-23,09407087H,ana.etxebarria@cleverbyte.tech,515685,ES71209582994069256416,7609.68,2024-08-05T10:32:36,Vitoria-Gasteiz,expenses,water,-125.58,3332.91
buyer_3,Ana,Etxebarria,1989-08-23,09407087H,ana.etxebarria@cleverbyte.tech,515685,ES71209582994069256416,7609.68,2024-08-06T19:36:18,Vitoria-Gasteiz,expenses,gas,-359.56,2973.35
buyer_3,Ana,Etxebarria,1989-08-23,09407087H,ana.etxebarria@cleverbyte.tech,515685,ES71209582994069256416,7609.68,2024-08-06T02:44:54,Vitoria-Gasteiz,expenses,education,-52.6,2920.75
buyer_3,Ana,Etxebarria,1989-08-23,09407087H,ana.etxebarria@cleverbyte.tech,515685,ES71209582994069256416,7609.68,2024-08-07T10:12:39,Vitoria-Gasteiz,expenses,electricity,-195.41,2725.34
buyer_3,Ana,Etxebarria,1989-08-23,09407087H,ana.etxebarria@cleverbyte.tech,515685,ES71209582994069256416,7609.68,2024-08-09T18:11:23,Vitoria-Gasteiz,expenses,transport,-79.41,2645.93
buyer_3,Ana,Etxebarria,1989-08-23,09407087H,ana.etxebarria@cleverbyte.tech,515685,ES71209582994069256416,7609.68,2024-08-09T19:12:19,Vitoria-Gasteiz,expenses,repairs,-201.54,2444.39
buyer_3,Ana,Etxebarria,1989-08-23,09407087H,ana.etxebarria@cleverbyte.tech,515685,ES71209582994069256416,7609.68,2024-08-10T03:04:40,Vitoria-Gasteiz,expenses,cash,-100.0,2344.39
buyer_3,Ana,Etxebarria,1989-08-23,09407087H,ana.etxebarria@cleverbyte.tech,515685,ES71209582994069256416,7609.68,2024-08-11T23:57:31,Vitoria-Gasteiz,expenses,leisure,-62.0,2282.39
buyer_3,Ana,Etxebarria,1989-08-23,09407087H,ana.etxebarria@cleverbyte.tech,515685,ES71209582994069256416,7609.68,2024-08-12T15:21:22,Vitoria-Gasteiz,expenses,cash,-100.0,2182.39
buyer_3,Ana,Etxebarria,1989-08-23,09407087H,ana.etxebarria@cleverbyte.tech,515685,ES71209582994069256416,7609.68,2024-08-13T16:51:45,Vitoria-Gasteiz,expenses,food,-94.13,2088.26
buyer_3,Ana,Etxebarria,1989-08-23,09407087H,ana.etxebarria@cleverbyte.tech,515685,ES71209582994069256416,7609.68,2024-08-14T22:49:39,Vitoria-Gasteiz,expenses,transport,-86.78,2001.48
buyer_3,Ana,Etxebarria,1989-08-23,09407087H,ana.etxebarria@cleverbyte.tech,515685,ES71209582994069256416,7609.68,2024-08-14T10:22:01,Vitoria-Gasteiz,expenses,healthcare,-140.52,1860.96
buyer_3,Ana,Etxebarria,1989-08-23,09407087H,ana.etxebarria@cleverbyte.tech,515685,ES71209582994069256416,7609.68,2024-08-15T23:21:07,Vitoria-Gasteiz,expenses,transport,-47.06,1813.9
buyer_3,Ana,Etxebarria,1989-08-23,09407087H,ana.etxebarria@cleverbyte.tech,515685,ES71209582994069256416,7609.68,2024-08-15T13:16:01,Vitoria-Gasteiz,expenses,cash,-100.0,1713.9
buyer_3,Ana,Etxebarria,1989-08-23,09407087H,ana.etxebarria@cleverbyte.tech,515685,ES71209582994069256416,7609.68,2024-08-16T15:28:25,Vitoria-Gasteiz,expenses,gifts,-665.77,1048.13
buyer_3,Ana,Etxebarria,1989-08-23,09407087H,ana.etxebarria@cleverbyte.tech,515685,ES71209582994069256416,7609.68,2024-08-18T17:50:27,Vitoria-Gasteiz,expenses,food,-73.98,974.15
buyer_3,Ana,Etxebarria,1989-08-23,09407087H,ana.etxebarria@cleverbyte.tech,515685,ES71209582994069256416,7609.68,2024-08-18T06:50:34,Vitoria-Gasteiz,expenses,cash,-100.0,874.15
buyer_3,Ana,Etxebarria,1989-08-23,09407087H,ana.etxebarria@cleverbyte.tech,515685,ES71209582994069256416,7609.68,2024-08-18T19:27:28,Vitoria-Gasteiz,expenses,travel,-336.91,537.24
buyer_3,Ana,Etxebarria,1989-08-23,09407087H,ana.etxebarria@cleverbyte.tech,515685,ES71209582994069256416,7609.68,2024-08-20T10:29:14,Vitoria-Gasteiz,expenses,cash,-100.0,437.24
buyer_3,Ana,Etxebarria,1989-08-23,09407087H,ana.etxebarria@cleverbyte.tech,515685,ES71209582994069256416,7609.68,2024-08-21T12:50:29,Vitoria-Gasteiz,expenses,leisure,-77.28,359.96
buyer_3,Ana,Etxebarria,1989-08-23,09407087H,ana.etxebarria@cleverbyte.tech,515685,ES71209582994069256416,7609.68,2024-08-24T16:53:52,Vitoria-Gasteiz,expenses,transport,-57.85,302.11
buyer_3,Ana,Etxebarria,1989-08-23,09407087H,ana.etxebarria@cleverbyte.tech,515685,ES71209582994069256416,7609.68,2024-08-24T22:48:56,Vitoria-Gasteiz,expenses,cash,-100.0,202.11
buyer_3,Ana,Etxebarria,1989-08-23,09407087H,ana.etxebarria@cleverbyte.tech,515685,ES71209582994069256416,7609.68,2024-08-25T15:16:02,Vitoria-Gasteiz,expenses,transport,-80.37,121.74
buyer_3,Ana,Etxebarria,1989-08-23,09407087H,ana.etxebarria@cleverbyte.tech,515685,ES71209582994069256416,7609.68,2024-08-25T16:58:53,Vitoria-Gasteiz,expenses,leisure,-68.42,53.32
buyer_3,Ana,Etxebarria,1989-08-23,09407087H,ana.etxebarria@cleverbyte.tech,515685,ES71209582994069256416,7609.68,2024-08-25T10:26:30,Vitoria-Gasteiz,expenses,appliances,-143.6,-90.28
buyer_3,Ana,Etxebarria,1989-08-23,09407087H,ana.etxebarria@cleverbyte.tech,515685,ES71209582994069256416,7609.68,2024-08-26T15:45:55,Vitoria-Gasteiz,expenses,food,-124.46,-214.74
buyer_3,Ana,Etxebarria,1989-08-23,09407087H,ana.etxebarria@cleverbyte.tech,515685,ES71209582994069256416,7609.68,2024-08-28T14:50:16,Vitoria-Gasteiz,expenses,food,-83.99,-298.73
buyer_3,Ana,Etxebarria,1989-08-23,09407087H,ana.etxebarria@cleverbyte.tech,515685,ES71209582994069256416,7609.68,2024-08-29T13:45:53,Vitoria-Gasteiz,expenses,education,-73.45,-372.18
buyer_3,Ana,Etxebarria,1989-08-23,09407087H,ana.etxebarria@cleverbyte.tech,515685,ES71209582994069256416,7609.68,2024-08-30T09:29:43,Vitoria-Gasteiz,expenses,transport,-88.96,-461.14
buyer_3,Ana,Etxebarria,1989-08-23,09407087H,ana.etxebarria@cleverbyte.tech,515685,ES71209582994069256416,7609.68,2024-09-01T09:27:22,Vitoria-Gasteiz,incomes,salary,3335.94,2874.8
buyer_3,Ana,Etxebarria,1989-08-23,09407087H,ana.etxebarria@cleverbyte.tech,515685,ES71209582994069256416,7609.68,2024-09-01T09:27:22,Vitoria-Gasteiz,incomes,salary_partner,3601.41,6476.21
buyer_3,Ana,Etxebarria,1989-08-23,09407087H,ana.etxebarria@cleverbyte.tech,515685,ES71209582994069256416,7609.68,2024-09-02T15:32:38,Vitoria-Gasteiz,expenses,gifts,-742.12,5734.09
buyer_3,Ana,Etxebarria,1989-08-23,09407087H,ana.etxebarria@cleverbyte.tech,515685,ES71209582994069256416,7609.68,2024-09-04T10:39:36,Vitoria-Gasteiz,expenses,food,-65.19,5668.9
buyer_3,Ana,Etxebarria,1989-08-23,09407087H,ana.etxebarria@cleverbyte.tech,515685,ES71209582994069256416,7609.68,2024-09-04T13:55:48,Vitoria-Gasteiz,expenses,transport,-65.71,5603.19
buyer_3,Ana,Etxebarria,1989-08-23,09407087H,ana.etxebarria@cleverbyte.tech,515685,ES71209582994069256416,7609.68,2024-09-05T20:28:09,Vitoria-Gasteiz,expenses,mortgage,-3275.41,2327.78
buyer_3,Ana,Etxebarria,1989-08-23,09407087H,ana.etxebarria@cleverbyte.tech,515685,ES71209582994069256416,7609.68,2024-09-05T15:59:06,Vitoria-Gasteiz,expenses,cash,-100.0,2227.78
buyer_3,Ana,Etxebarria,1989-08-23,09407087H,ana.etxebarria@cleverbyte.tech,515685,ES71209582994069256416,7609.68,2024-09-06T17:32:30,Vitoria-Gasteiz,expenses,electricity,-184.25,2043.53
buyer_3,Ana,Etxebarria,1989-08-23,09407087H,ana.etxebarria@cleverbyte.tech,515685,ES71209582994069256416,7609.68,2024-09-06T12:04:09,Vitoria-Gasteiz,expenses,gas,-184.79,1858.74
buyer_3,Ana,Etxebarria,1989-08-23,09407087H,ana.etxebarria@cleverbyte.tech,515685,ES71209582994069256416,7609.68,2024-09-06T16:45:38,Vitoria-Gasteiz,expenses,internet,-145.68,1713.06
buyer_3,Ana,Etxebarria,1989-08-23,09407087H,ana.etxebarria@cleverbyte.tech,515685,ES71209582994069256416,7609.68,2024-09-06T20:12:49,Vitoria-Gasteiz,expenses,repairs,-206.41,1506.65
buyer_3,Ana,Etxebarria,1989-08-23,09407087H,ana.etxebarria@cleverbyte.tech,515685,ES71209582994069256416,7609.68,2024-09-08T21:56:51,Vitoria-Gasteiz,expenses,leisure,-40.58,1466.07
buyer_3,Ana,Etxebarria,1989-08-23,09407087H,ana.etxebarria@cleverbyte.tech,515685,ES71209582994069256416,7609.68,2024-09-11T18:26:27,Vitoria-Gasteiz,expenses,leisure,-62.13,1403.94
buyer_3,Ana,Etxebarria,1989-08-23,09407087H,ana.etxebarria@cleverbyte.tech,515685,ES71209582994069256416,7609.68,2024-09-12T19:49:08,Vitoria-Gasteiz,expenses,transport,-46.51,1357.43
buyer_3,Ana,Etxebarria,1989-08-23,09407087H,ana.etxebarria@cleverbyte.tech,515685,ES71209582994069256416,7609.68,2024-09-12T10:14:32,Vitoria-Gasteiz,expenses,leisure,-68.49,1288.94
buyer_3,Ana,Etxebarria,1989-08-23,09407087H,ana.etxebarria@cleverbyte.tech,515685,ES71209582994069256416,7609.68,2024-09-13T18:54:42,Vitoria-Gasteiz,expenses,cash,-100.0,1188.94
buyer_3,Ana,Etxebarria,1989-08-23,09407087H,ana.etxebarria@cleverbyte.tech,515685,ES71209582994069256416,7609.68,2024-09-13T08:28:48,Vitoria-Gasteiz,expenses,appliances,-284.67,904.27
buyer_3,Ana,Etxebarria,1989-08-23,09407087H,ana.etxebarria@cleverbyte.tech,515685,ES71209582994069256416,7609.68,2024-09-14T10:02:16,Vitoria-Gasteiz,expenses,cash,-100.0,804.27
buyer_3,Ana,Etxebarria,1989-08-23,09407087H,ana.etxebarria@cleverbyte.tech,515685,ES71209582994069256416,7609.68,2024-09-16T14:15:37,Vitoria-Gasteiz,expenses,clothing,-154.47,649.8
buyer_3,Ana,Etxebarria,1989-08-23,09407087H,ana.etxebarria@cleverbyte.tech,515685,ES71209582994069256416,7609.68,2024-09-20T18:16:07,Vitoria-Gasteiz,expenses,food,-62.94,586.86
buyer_3,Ana,Etxebarria,1989-08-23,09407087H,ana.etxebarria@cleverbyte.tech,515685,ES71209582994069256416,7609.68,2024-09-20T14:00:22,Vitoria-Gasteiz,expenses,education,-43.03,543.83
buyer_3,Ana,Etxebarria,1989-08-23,09407087H,ana.etxebarria@cleverbyte.tech,515685,ES71209582994069256416,7609.68,2024-09-21T12:12:12,Vitoria-Gasteiz,expenses,repairs,-44.48,499.35
buyer_3,Ana,Etxebarria,1989-08-23,09407087H,ana.etxebarria@cleverbyte.tech,515685,ES71209582994069256416,7609.68,2024-09-21T21:29:36,Vitoria-Gasteiz,expenses,gifts,-838.4,-339.05
buyer_3,Ana,Etxebarria,1989-08-23,09407087H,ana.etxebarria@cleverbyte.tech,515685,ES71209582994069256416,7609.68,2024-09-23T11:28:36,Vitoria-Gasteiz,expenses,repairs,-193.93,-532.98
buyer_3,Ana,Etxebarria,1989-08-23,09407087H,ana.etxebarria@cleverbyte.tech,515685,ES71209582994069256416,7609.68,2024-09-24T22:23:54,Vitoria-Gasteiz,expenses,leisure,-41.28,-574.26
buyer_3,Ana,Etxebarria,1989-08-23,09407087H,ana.etxebarria@cleverbyte.tech,515685,ES71209582994069256416,7609.68,2024-09-24T21:20:10,Vitoria-Gasteiz,expenses,repairs,-57.53,-631.79
buyer_3,Ana,Etxebarria,1989-08-23,09407087H,ana.etxebarria@cleverbyte.tech,515685,ES71209582994069256416,7609.68,2024-09-28T16:19:08,Vitoria-Gasteiz,expenses,gifts,-177.12,-808.91
buyer_3,Ana,Etxebarria,1989-08-23,09407087H,ana.etxebarria@cleverbyte.tech,515685,ES71209582994069256416,7609.68,2024-09-29T18:55:47,Vitoria-Gasteiz,expenses,leisure,-29.89,-838.8
buyer_3,Ana,Etxebarria,1989-08-23,09407087H,ana.etxebarria@cleverbyte.tech,515685,ES71209582994069256416,7609.68,2024-10-01T12:26:30,Vitoria-Gasteiz,incomes,salary,3335.94,2497.14
buyer_3,Ana,Etxebarria,1989-08-23,09407087H,ana.etxebarria@cleverbyte.tech,515685,ES71209582994069256416,7609.68,2024-10-01T12:26:30,Vitoria-Gasteiz,incomes,salary_partner,3601.41,6098.55
buyer_3,Ana,Etxebarria,1989-08-23,09407087H,ana.etxebarria@cleverbyte.tech,515685,ES71209582994069256416,7609.68,2024-10-01T12:26:30,Vitoria-Gasteiz,incomes,extra_income,372.53,6471.08
buyer_3,Ana,Etxebarria,1989-08-23,09407087H,ana.etxebarria@cleverbyte.tech,515685,ES71209582994069256416,7609.68,2024-10-01T18:07:33,Vitoria-Gasteiz,expenses,cash,-100.0,6371.08
buyer_3,Ana,Etxebarria,1989-08-23,09407087H,ana.etxebarria@cleverbyte.tech,515685,ES71209582994069256416,7609.68,2024-10-02T15:15:09,Vitoria-Gasteiz,expenses,cash,-100.0,6271.08
buyer_3,Ana,Etxebarria,1989-08-23,09407087H,ana.etxebarria@cleverbyte.tech,515685,ES71209582994069256416,7609.68,2024-10-05T17:56:03,Vitoria-Gasteiz,expenses,mortgage,-3275.41,2995.67
buyer_3,Ana,Etxebarria,1989-08-23,09407087H,ana.etxebarria@cleverbyte.tech,515685,ES71209582994069256416,7609.68,2024-10-06T10:20:04,Vitoria-Gasteiz,expenses,phone,-109.09,2886.58
buyer_3,Ana,Etxebarria,1989-08-23,09407087H,ana.etxebarria@cleverbyte.tech,515685,ES71209582994069256416,7609.68,2024-10-06T20:28:30,Vitoria-Gasteiz,expenses,gifts,-570.86,2315.72
buyer_3,Ana,Etxebarria,1989-08-23,09407087H,ana.etxebarria@cleverbyte.tech,515685,ES71209582994069256416,7609.68,2024-10-08T08:01:44,Vitoria-Gasteiz,expenses,phone,-108.91,2206.81
buyer_3,Ana,Etxebarria,1989-08-23,09407087H,ana.etxebarria@cleverbyte.tech,515685,ES71209582994069256416,7609.68,2024-10-08T08:00:21,Vitoria-Gasteiz,expenses,leisure,-66.0,2140.81
buyer_3,Ana,Etxebarria,1989-08-23,09407087H,ana.etxebarria@cleverbyte.tech,515685,ES71209582994069256416,7609.68,2024-10-08T17:05:48,Vitoria-Gasteiz,expenses,cash,-100.0,2040.81
buyer_3,Ana,Etxebarria,1989-08-23,09407087H,ana.etxebarria@cleverbyte.tech,515685,ES71209582994069256416,7609.68,2024-10-10T14:24:20,Vitoria-Gasteiz,expenses,leisure,-39.35,2001.46
buyer_4,Marc,Andreu,1974-05-23,52965688T,marc.andreu@coolcloud.app,939777,ES43209578608750974410,5585.9,2022-01-01T15:53:43,Barcelona,incomes,salary,1278.93,6864.83
buyer_4,Marc,Andreu,1974-05-23,52965688T,marc.andreu@coolcloud.app,939777,ES43209578608750974410,5585.9,2022-01-01T09:38:57,Barcelona,expenses,clothing,-64.42,6800.41
buyer_4,Marc,Andreu,1974-05-23,52965688T,marc.andreu@coolcloud.app,939777,ES43209578608750974410,5585.9,2022-01-01T17:51:12,Barcelona,expenses,children,-448.9,6351.51
buyer_4,Marc,Andreu,1974-05-23,52965688T,marc.andreu@coolcloud.app,939777,ES43209578608750974410,5585.9,2022-01-02T17:18:07,Barcelona,expenses,appliances,-149.65,6201.86
buyer_4,Marc,Andreu,1974-05-23,52965688T,marc.andreu@coolcloud.app,939777,ES43209578608750974410,5585.9,2022-01-03T09:30:14,Barcelona,expenses,food,-64.75,6137.11
buyer_4,Marc,Andreu,1974-05-23,52965688T,marc.andreu@coolcloud.app,939777,ES43209578608750974410,5585.9,2022-01-05T12:16:51,Barcelona,expenses,mortgage,-477.68,5659.43
buyer_4,Marc,Andreu,1974-05-23,52965688T,marc.andreu@coolcloud.app,939777,ES43209578608750974410,5585.9,2022-01-05T10:22:39,Barcelona,expenses,leisure,-53.76,5605.67
buyer_4,Marc,Andreu,1974-05-23,52965688T,marc.andreu@coolcloud.app,939777,ES43209578608750974410,5585.9,2022-01-07T16:31:42,Barcelona,expenses,electricity,-15.48,5590.19
buyer_4,Marc,Andreu,1974-05-23,52965688T,marc.andreu@coolcloud.app,939777,ES43209578608750974410,5585.9,2022-01-07T20:19:21,Barcelona,expenses,phone,-20.5,5569.69
buyer_4,Marc,Andreu,1974-05-23,52965688T,marc.andreu@coolcloud.app,939777,ES43209578608750974410,5585.9,2022-01-08T14:53:50,Barcelona,expenses,food,-121.17,5448.52
buyer_4,Marc,Andreu,1974-05-23,52965688T,marc.andreu@coolcloud.app,939777,ES43209578608750974410,5585.9,2022-01-09T13:26:18,Barcelona,expenses,cash,-100.0,5348.52
buyer_4,Marc,Andreu,1974-05-23,52965688T,marc.andreu@coolcloud.app,939777,ES43209578608750974410,5585.9,2022-01-10T18:43:03,Barcelona,expenses,cash,-100.0,5248.52
buyer_4,Marc,Andreu,1974-05-23,52965688T,marc.andreu@coolcloud.app,939777,ES43209578608750974410,5585.9,2022-01-11T08:26:57,Barcelona,expenses,cash,-100.0,5148.52
buyer_4,Marc,Andreu,1974-05-23,52965688T,marc.andreu@coolcloud.app,939777,ES43209578608750974410,5585.9,2022-01-12T14:22:35,Barcelona,expenses,leisure,-32.06,5116.46
buyer_4,Marc,Andreu,1974-05-23,52965688T,marc.andreu@coolcloud.app,939777,ES43209578608750974410,5585.9,2022-01-13T12:58:50,Barcelona,expenses,transport,-60.61,5055.85
buyer_4,Marc,Andreu,1974-05-23,52965688T,marc.andreu@coolcloud.app,939777,ES43209578608750974410,5585.9,2022-01-13T09:52:18,Barcelona,expenses,cash,-100.0,4955.85
buyer_4,Marc,Andreu,1974-05-23,52965688T,marc.andreu@coolcloud.app,939777,ES43209578608750974410,5585.9,2022-01-13T23:26:58,Barcelona,expenses,repairs,-320.09,4635.76
buyer_4,Marc,Andreu,1974-05-23,52965688T,marc.andreu@coolcloud.app,939777,ES43209578608750974410,5585.9,2022-01-14T20:03:15,Barcelona,expenses,gifts,-448.58,4187.18
buyer_4,Marc,Andreu,1974-05-23,52965688T,marc.andreu@coolcloud.app,939777,ES43209578608750974410,5585.9,2022-01-16T14:12:32,Barcelona,expenses,food,-84.89,4102.29
buyer_4,Marc,Andreu,1974-05-23,52965688T,marc.andreu@coolcloud.app,939777,ES43209578608750974410,5585.9,2022-01-18T14:46:51,Barcelona,expenses,leisure,-71.13,4031.16
buyer_4,Marc,Andreu,1974-05-23,52965688T,marc.andreu@coolcloud.app,939777,ES43209578608750974410,5585.9,2022-01-19T16:15:30,Barcelona,expenses,education,-72.75,3958.41
buyer_4,Marc,Andreu,1974-05-23,52965688T,marc.andreu@coolcloud.app,939777,ES43209578608750974410,5585.9,2022-01-21T09:09:21,Barcelona,expenses,food,-69.41,3889.0
buyer_4,Marc,Andreu,1974-05-23,52965688T,marc.andreu@coolcloud.app,939777,ES43209578608750974410,5585.9,2022-01-21T04:12:30,Barcelona,expenses,leisure,-34.56,3854.44
buyer_4,Marc,Andreu,1974-05-23,52965688T,marc.andreu@coolcloud.app,939777,ES43209578608750974410,5585.9,2022-01-22T23:14:59,Barcelona,expenses,food,-88.39,3766.05
buyer_4,Marc,Andreu,1974-05-23,52965688T,marc.andreu@coolcloud.app,939777,ES43209578608750974410,5585.9,2022-01-22T17:28:59,Barcelona,expenses,leisure,-33.77,3732.28
buyer_4,Marc,Andreu,1974-05-23,52965688T,marc.andreu@coolcloud.app,939777,ES43209578608750974410,5585.9,2022-01-23T15:53:45,Barcelona,expenses,cash,-100.0,3632.28
buyer_4,Marc,Andreu,1974-05-23,52965688T,marc.andreu@coolcloud.app,939777,ES43209578608750974410,5585.9,2022-01-25T12:44:11,Barcelona,expenses,food,-103.68,3528.6
buyer_4,Marc,Andreu,1974-05-23,52965688T,marc.andreu@coolcloud.app,939777,ES43209578608750974410,5585.9,2022-01-25T01:27:59,Barcelona,expenses,cash,-100.0,3428.6
buyer_4,Marc,Andreu,1974-05-23,52965688T,marc.andreu@coolcloud.app,939777,ES43209578608750974410,5585.9,2022-01-28T10:36:13,Barcelona,expenses,gifts,-303.53,3125.07
buyer_4,Marc,Andreu,1974-05-23,52965688T,marc.andreu@coolcloud.app,939777,ES43209578608750974410,5585.9,2022-01-30T15:53:37,Barcelona,expenses,transport,-83.04,3042.03
buyer_4,Marc,Andreu,1974-05-23,52965688T,marc.andreu@coolcloud.app,939777,ES43209578608750974410,5585.9,2022-01-30T12:28:40,Barcelona,expenses,clothing,-129.73,2912.3
buyer_4,Marc,Andreu,1974-05-23,52965688T,marc.andreu@coolcloud.app,939777,ES43209578608750974410,5585.9,2022-02-01T15:11:07,Barcelona,incomes,salary,1278.93,4191.23
buyer_4,Marc,Andreu,1974-05-23,52965688T,marc.andreu@coolcloud.app,939777,ES43209578608750974410,5585.9,2022-02-01T16:22:40,Barcelona,expenses,gifts,-419.01,3772.22
buyer_4,Marc,Andreu,1974-05-23,52965688T,marc.andreu@coolcloud.app,939777,ES43209578608750974410,5585.9,2022-02-03T15:42:49,Barcelona,expenses,healthcare,-187.12,3585.1
buyer_4,Marc,Andreu,1974-05-23,52965688T,marc.andreu@coolcloud.app,939777,ES43209578608750974410,5585.9,2022-02-04T13:33:00,Barcelona,expenses,food,-60.33,3524.77
buyer_4,Marc,Andreu,1974-05-23,52965688T,marc.andreu@coolcloud.app,939777,ES43209578608750974410,5585.9,2022-02-05T20:04:18,Barcelona,expenses,mortgage,-477.68,3047.09
buyer_4,Marc,Andreu,1974-05-23,52965688T,marc.andreu@coolcloud.app,939777,ES43209578608750974410,5585.9,2022-02-05T18:40:15,Barcelona,expenses,gas,-53.81,2993.28
buyer_4,Marc,Andreu,1974-05-23,52965688T,marc.andreu@coolcloud.app,939777,ES43209578608750974410,5585.9,2022-02-05T20:23:40,Barcelona,expenses,phone,-26.0,2967.28
buyer_4,Marc,Andreu,1974-05-23,52965688T,marc.andreu@coolcloud.app,939777,ES43209578608750974410,5585.9,2022-02-05T00:36:25,Barcelona,expenses,food,-123.67,2843.61
buyer_4,Marc,Andreu,1974-05-23,52965688T,marc.andreu@coolcloud.app,939777,ES43209578608750974410,5585.9,2022-02-05T10:30:23,Barcelona,expenses,transport,-51.14,2792.47
buyer_4,Marc,Andreu,1974-05-23,52965688T,marc.andreu@coolcloud.app,939777,ES43209578608750974410,5585.9,2022-02-05T20:28:36,Barcelona,expenses,leisure,-51.58,2740.89
buyer_4,Marc,Andreu,1974-05-23,52965688T,marc.andreu@coolcloud.app,939777,ES43209578608750974410,5585.9,2022-02-05T20:52:56,Barcelona,expenses,clothing,-142.42,2598.47
buyer_4,Marc,Andreu,1974-05-23,52965688T,marc.andreu@coolcloud.app,939777,ES43209578608750974410,5585.9,2022-02-07T01:11:53,Barcelona,expenses,water,-12.87,2585.6
buyer_4,Marc,Andreu,1974-05-23,52965688T,marc.andreu@coolcloud.app,939777,ES43209578608750974410,5585.9,2022-02-08T16:13:38,Barcelona,expenses,electricity,-47.86,2537.74
buyer_4,Marc,Andreu,1974-05-23,52965688T,marc.andreu@coolcloud.app,939777,ES43209578608750974410,5585.9,2022-02-08T12:40:01,Barcelona,expenses,gas,-65.09,2472.65
buyer_4,Marc,Andreu,1974-05-23,52965688T,marc.andreu@coolcloud.app,939777,ES43209578608750974410,5585.9,2022-02-08T15:22:47,Barcelona,expenses,transport,-54.24,2418.41
buyer_4,Marc,Andreu,1974-05-23,52965688T,marc.andreu@coolcloud.app,939777,ES43209578608750974410,5585.9,2022-02-10T13:31:13,Barcelona,expenses,food,-74.72,2343.69
buyer_4,Marc,Andreu,1974-05-23,52965688T,marc.andreu@coolcloud.app,939777,ES43209578608750974410,5585.9,2022-02-11T18:23:51,Barcelona,expenses,leisure,-50.69,2293.0
buyer_4,Marc,Andreu,1974-05-23,52965688T,marc.andreu@coolcloud.app,939777,ES43209578608750974410,5585.9,2022-02-13T14:53:32,Barcelona,expenses,clothing,-109.81,2183.19
buyer_4,Marc,Andreu,1974-05-23,52965688T,marc.andreu@coolcloud.app,939777,ES43209578608750974410,5585.9,2022-02-13T09:02:36,Barcelona,expenses,appliances,-262.91,1920.28
buyer_4,Marc,Andreu,1974-05-23,52965688T,marc.andreu@coolcloud.app,939777,ES43209578608750974410,5585.9,2022-02-14T20:38:36,Barcelona,expenses,gifts,-388.86,1531.42
buyer_4,Marc,Andreu,1974-05-23,52965688T,marc.andreu@coolcloud.app,939777,ES43209578608750974410,5585.9,2022-02-15T01:54:26,Barcelona,expenses,leisure,-37.38,1494.04
buyer_4,Marc,Andreu,1974-05-23,52965688T,marc.andreu@coolcloud.app,939777,ES43209578608750974410,5585.9,2022-02-15T03:30:50,Barcelona,expenses,repairs,-58.71,1435.33
buyer_4,Marc,Andreu,1974-05-23,52965688T,marc.andreu@coolcloud.app,939777,ES43209578608750974410,5585.9,2022-02-17T13:58:42,Barcelona,expenses,cash,-100.0,1335.33
buyer_4,Marc,Andreu,1974-05-23,52965688T,marc.andreu@coolcloud.app,939777,ES43209578608750974410,5585.9,2022-02-18T15:50:40,Barcelona,expenses,food,-91.75,1243.58
buyer_4,Marc,Andreu,1974-05-23,52965688T,marc.andreu@coolcloud.app,939777,ES43209578608750974410,5585.9,2022-02-19T08:10:44,Barcelona,expenses,clothing,-146.99,1096.59
buyer_4,Marc,Andreu,1974-05-23,52965688T,marc.andreu@coolcloud.app,939777,ES43209578608750974410,5585.9,2022-02-19T15:02:11,Barcelona,expenses,repairs,-262.79,833.8
buyer_4,Marc,Andreu,1974-05-23,52965688T,marc.andreu@coolcloud.app,939777,ES43209578608750974410,5585.9,2022-02-20T16:24:30,Barcelona,expenses,food,-94.45,739.35
buyer_4,Marc,Andreu,1974-05-23,52965688T,marc.andreu@coolcloud.app,939777,ES43209578608750974410,5585.9,2022-02-21T13:17:49,Barcelona,expenses,education,-45.22,694.13
buyer_4,Marc,Andreu,1974-05-23,52965688T,marc.andreu@coolcloud.app,939777,ES43209578608750974410,5585.9,2022-02-22T15:06:17,Barcelona,expenses,cash,-100.0,594.13
buyer_4,Marc,Andreu,1974-05-23,52965688T,marc.andreu@coolcloud.app,939777,ES43209578608750974410,5585.9,2022-02-22T21:54:11,Barcelona,expenses,repairs,-192.1,402.03
buyer_4,Marc,Andreu,1974-05-23,52965688T,marc.andreu@coolcloud.app,939777,ES43209578608750974410,5585.9,2022-02-23T20:16:27,Barcelona,expenses,leisure,-79.92,322.11
buyer_4,Marc,Andreu,1974-05-23,52965688T,marc.andreu@coolcloud.app,939777,ES43209578608750974410,5585.9,2022-02-23T08:57:59,Barcelona,expenses,appliances,-253.8,68.31
buyer_4,Marc,Andreu,1974-05-23,52965688T,marc.andreu@coolcloud.app,939777,ES43209578608750974410,5585.9,2022-02-24T20:19:46,Barcelona,expenses,food,-118.79,-50.48
buyer_4,Marc,Andreu,1974-05-23,52965688T,marc.andreu@coolcloud.app,939777,ES43209578608750974410,5585.9,2022-02-27T14:33:41,Barcelona,expenses,food,-83.54,-134.02
buyer_4,Marc,Andreu,1974-05-23,52965688T,marc.andreu@coolcloud.app,939777,ES43209578608750974410,5585.9,2022-03-01T10:02:16,Barcelona,incomes,salary,1278.93,1144.91
buyer_4,Marc,Andreu,1974-05-23,52965688T,marc.andreu@coolcloud.app,939777,ES43209578608750974410,5585.9,2022-03-01T15:26:04,Barcelona,expenses,appliances,-257.96,886.95
buyer_4,Marc,Andreu,1974-05-23,52965688T,marc.andreu@coolcloud.app,939777,ES43209578608750974410,5585.9,2022-03-01T10:26:59,Barcelona,expenses,children,-331.07900000000024,555.87
buyer_4,Marc,Andreu,1974-05-23,52965688T,marc.andreu@coolcloud.app,939777,ES43209578608750974410,5585.9,2022-03-05T08:38:41,Barcelona,expenses,mortgage,-477.68,78.19
buyer_4,Marc,Andreu,1974-05-23,52965688T,marc.andreu@coolcloud.app,939777,ES43209578608750974410,5585.9,2022-03-05T09:29:55,Barcelona,expenses,internet,-26.86,51.33
buyer_4,Marc,Andreu,1974-05-23,52965688T,marc.andreu@coolcloud.app,939777,ES43209578608750974410,5585.9,2022-03-06T11:38:07,Barcelona,expenses,electricity,-16.35,34.98
buyer_4,Marc,Andreu,1974-05-23,52965688T,marc.andreu@coolcloud.app,939777,ES43209578608750974410,5585.9,2022-03-07T16:51:06,Barcelona,expenses,transport,-80.06,-45.08
buyer_4,Marc,Andreu,1974-05-23,52965688T,marc.andreu@coolcloud.app,939777,ES43209578608750974410,5585.9,2022-03-07T10:49:53,Barcelona,expenses,education,-62.48,-107.56
buyer_4,Marc,Andreu,1974-05-23,52965688T,marc.andreu@coolcloud.app,939777,ES43209578608750974410,5585.9,2022-03-08T17:58:26,Barcelona,expenses,water,-23.95,-131.51
buyer_4,Marc,Andreu,1974-05-23,52965688T,marc.andreu@coolcloud.app,939777,ES43209578608750974410,5585.9,2022-03-08T17:55:18,Barcelona,expenses,internet,-26.86,-158.37
buyer_4,Marc,Andreu,1974-05-23,52965688T,marc.andreu@coolcloud.app,939777,ES43209578608750974410,5585.9,2022-03-08T11:13:52,Barcelona,expenses,clothing,-137.99,-296.36
buyer_4,Marc,Andreu,1974-05-23,52965688T,marc.andreu@coolcloud.app,939777,ES43209578608750974410,5585.9,2022-03-09T12:47:55,Barcelona,expenses,food,-74.91,-371.27
buyer_4,Marc,Andreu,1974-05-23,52965688T,marc.andreu@coolcloud.app,939777,ES43209578608750974410,5585.9,2022-03-09T18:34:45,Barcelona,expenses,repairs,-159.43,-530.7
buyer_4,Marc,Andreu,1974-05-23,52965688T,marc.andreu@coolcloud.app,939777,ES43209578608750974410,5585.9,2022-03-10T19:42:06,Barcelona,expenses,cash,-100.0,-630.7
buyer_4,Marc,Andreu,1974-05-23,52965688T,marc.andreu@coolcloud.app,939777,ES43209578608750974410,5585.9,2022-03-11T18:52:53,Barcelona,expenses,appliances,-85.68,-716.38
buyer_4,Marc,Andreu,1974-05-23,52965688T,marc.andreu@coolcloud.app,939777,ES43209578608750974410,5585.9,2022-03-12T08:47:35,Barcelona,expenses,leisure,-24.97,-741.35
buyer_4,Marc,Andreu,1974-05-23,52965688T,marc.andreu@coolcloud.app,939777,ES43209578608750974410,5585.9,2022-03-12T14:42:55,Barcelona,expenses,repairs,-307.6,-1048.95
buyer_4,Marc,Andreu,1974-05-23,52965688T,marc.andreu@coolcloud.app,939777,ES43209578608750974410,5585.9,2022-03-13T15:13:02,Barcelona,expenses,food,-61.79,-1110.74
buyer_4,Marc,Andreu,1974-05-23,52965688T,marc.andreu@coolcloud.app,939777,ES43209578608750974410,5585.9,2022-03-13T17:26:34,Barcelona,expenses,transport,-76.18,-1186.92
buyer_4,Marc,Andreu,1974-05-23,52965688T,marc.andreu@coolcloud.app,939777,ES43209578608750974410,5585.9,2022-03-13T14:29:54,Barcelona,expenses,leisure,-60.58,-1247.5
buyer_4,Marc,Andreu,1974-05-23,52965688T,marc.andreu@coolcloud.app,939777,ES43209578608750974410,5585.9,2022-03-16T09:39:13,Barcelona,expenses,appliances,-223.6,-1471.1
buyer_4,Marc,Andreu,1974-05-23,52965688T,marc.andreu@coolcloud.app,939777,ES43209578608750974410,5585.9,2022-03-17T00:16:24,Barcelona,expenses,repairs,-140.53,-1611.63
buyer_4,Marc,Andreu,1974-05-23,52965688T,marc.andreu@coolcloud.app,939777,ES43209578608750974410,5585.9,2022-03-18T17:31:13,Barcelona,expenses,food,-121.6,-1733.23
buyer_4,Marc,Andreu,1974-05-23,52965688T,marc.andreu@coolcloud.app,939777,ES43209578608750974410,5585.9,2022-03-21T11:57:17,Barcelona,expenses,healthcare,-129.22,-1862.45
buyer_4,Marc,Andreu,1974-05-23,52965688T,marc.andreu@coolcloud.app,939777,ES43209578608750974410,5585.9,2022-03-23T16:55:13,Barcelona,expenses,food,-116.35,-1978.8
buyer_4,Marc,Andreu,1974-05-23,52965688T,marc.andreu@coolcloud.app,939777,ES43209578608750974410,5585.9,2022-03-25T14:17:22,Barcelona,expenses,food,-111.4,-2090.2
buyer_4,Marc,Andreu,1974-05-23,52965688T,marc.andreu@coolcloud.app,939777,ES43209578608750974410,5585.9,2022-03-25T12:52:17,Barcelona,expenses,leisure,-36.54,-2126.74
buyer_4,Marc,Andreu,1974-05-23,52965688T,marc.andreu@coolcloud.app,939777,ES43209578608750974410,5585.9,2022-03-26T16:45:27,Barcelona,expenses,food,-105.6,-2232.34
buyer_4,Marc,Andreu,1974-05-23,52965688T,marc.andreu@coolcloud.app,939777,ES43209578608750974410,5585.9,2022-03-26T08:09:02,Barcelona,expenses,cash,-100.0,-2332.34
buyer_4,Marc,Andreu,1974-05-23,52965688T,marc.andreu@coolcloud.app,939777,ES43209578608750974410,5585.9,2022-03-26T16:50:22,Barcelona,expenses,travel,-311.36,-2643.7
buyer_4,Marc,Andreu,1974-05-23,52965688T,marc.andreu@coolcloud.app,939777,ES43209578608750974410,5585.9,2022-03-27T14:21:38,Barcelona,expenses,leisure,-66.23,-2709.93
buyer_4,Marc,Andreu,1974-05-23,52965688T,marc.andreu@coolcloud.app,939777,ES43209578608750974410,5585.9,2022-03-29T13:37:49,Barcelona,expenses,food,-88.37,-2798.3
buyer_4,Marc,Andreu,1974-05-23,52965688T,marc.andreu@coolcloud.app,939777,ES43209578608750974410,5585.9,2022-03-30T09:06:31,Barcelona,expenses,healthcare,-113.62,-2911.92
buyer_4,Marc,Andreu,1974-05-23,52965688T,marc.andreu@coolcloud.app,939777,ES43209578608750974410,5585.9,2022-03-30T17:35:38,Barcelona,expenses,education,-61.23,-2973.15
buyer_4,Marc,Andreu,1974-05-23,52965688T,marc.andreu@coolcloud.app,939777,ES43209578608750974410,5585.9,2022-03-30T12:17:34,Barcelona,expenses,cash,-100.0,-3073.15
buyer_4,Marc,Andreu,1974-05-23,52965688T,marc.andreu@coolcloud.app,939777,ES43209578608750974410,5585.9,2022-03-30T21:48:22,Barcelona,expenses,repairs,-33.38,-3106.53
buyer_4,Marc,Andreu,1974-05-23,52965688T,marc.andreu@coolcloud.app,939777,ES43209578608750974410,5585.9,2022-03-31T09:34:15,Barcelona,expenses,leisure,-47.87,-3154.4
buyer_4,Marc,Andreu,1974-05-23,52965688T,marc.andreu@coolcloud.app,939777,ES43209578608750974410,5585.9,2022-04-01T09:07:05,Barcelona,incomes,salary,1278.93,-1875.47
buyer_4,Marc,Andreu,1974-05-23,52965688T,marc.andreu@coolcloud.app,939777,ES43209578608750974410,5585.9,2022-04-01T09:07:05,Barcelona,incomes,extra_income,171.57,-1703.9
buyer_4,Marc,Andreu,1974-05-23,52965688T,marc.andreu@coolcloud.app,939777,ES43209578608750974410,5585.9,2022-04-01T18:45:40,Barcelona,expenses,cash,-100.0,-1803.9
buyer_4,Marc,Andreu,1974-05-23,52965688T,marc.andreu@coolcloud.app,939777,ES43209578608750974410,5585.9,2022-04-02T15:13:47,Barcelona,expenses,leisure,-44.37,-1848.27
buyer_4,Marc,Andreu,1974-05-23,52965688T,marc.andreu@coolcloud.app,939777,ES43209578608750974410,5585.9,2022-04-03T01:24:43,Barcelona,expenses,food,-82.99,-1931.26
buyer_4,Marc,Andreu,1974-05-23,52965688T,marc.andreu@coolcloud.app,939777,ES43209578608750974410,5585.9,2022-04-04T13:07:32,Barcelona,expenses,food,-103.82,-2035.08
buyer_4,Marc,Andreu,1974-05-23,52965688T,marc.andreu@coolcloud.app,939777,ES43209578608750974410,5585.9,2022-04-04T16:17:54,Barcelona,expenses,children,-195.07,-2230.15
buyer_4,Marc,Andreu,1974-05-23,52965688T,marc.andreu@coolcloud.app,939777,ES43209578608750974410,5585.9,2022-04-05T17:41:44,Barcelona,expenses,mortgage,-477.68,-2707.83
buyer_4,Marc,Andreu,1974-05-23,52965688T,marc.andreu@coolcloud.app,939777,ES43209578608750974410,5585.9,2022-04-05T08:50:20,Barcelona,expenses,gas,-40.14,-2747.97
buyer_4,Marc,Andreu,1974-05-23,52965688T,marc.andreu@coolcloud.app,939777,ES43209578608750974410,5585.9,2022-04-06T12:46:23,Barcelona,expenses,leisure,-38.42,-2786.39
buyer_4,Marc,Andreu,1974-05-23,52965688T,marc.andreu@coolcloud.app,939777,ES43209578608750974410,5585.9,2022-04-06T16:11:42,Barcelona,expenses,cash,-100.0,-2886.39
buyer_4,Marc,Andreu,1974-05-23,52965688T,marc.andreu@coolcloud.app,939777,ES43209578608750974410,5585.9,2022-04-07T07:15:52,Barcelona,expenses,internet,-26.86,-2913.25
buyer_4,Marc,Andreu,1974-05-23,52965688T,marc.andreu@coolcloud.app,939777,ES43209578608750974410,5585.9,2022-04-07T19:53:16,Barcelona,expenses,leisure,-63.53,-2976.78
buyer_4,Marc,Andreu,1974-05-23,52965688T,marc.andreu@coolcloud.app,939777,ES43209578608750974410,5585.9,2022-04-08T20:32:25,Barcelona,expenses,water,-23.48,-3000.26
buyer_4,Marc,Andreu,1974-05-23,52965688T,marc.andreu@coolcloud.app,939777,ES43209578608750974410,5585.9,2022-04-08T06:06:10,Barcelona,expenses,repairs,-316.38,-3316.64
buyer_4,Marc,Andreu,1974-05-23,52965688T,marc.andreu@coolcloud.app,939777,ES43209578608750974410,5585.9,2022-04-08T10:14:13,Barcelona,expenses,children,-272.6590000000002,-3589.3
buyer_4,Marc,Andreu,1974-05-23,52965688T,marc.andreu@coolcloud.app,939777,ES43209578608750974410,5585.9,2022-04-09T13:11:39,Barcelona,expenses,food,-120.45,-3709.75
buyer_4,Marc,Andreu,1974-05-23,52965688T,marc.andreu@coolcloud.app,939777,ES43209578608750974410,5585.9,2022-04-10T20:36:12,Barcelona,expenses,leisure,-78.64,-3788.39
buyer_4,Marc,Andreu,1974-05-23,52965688T,marc.andreu@coolcloud.app,939777,ES43209578608750974410,5585.9,2022-04-12T15:29:35,Barcelona,expenses,food,-119.67,-3908.06
buyer_4,Marc,Andreu,1974-05-23,52965688T,marc.andreu@coolcloud.app,939777,ES43209578608750974410,5585.9,2022-04-13T16:38:16,Barcelona,expenses,leisure,-42.25,-3950.31
buyer_4,Marc,Andreu,1974-05-23,52965688T,marc.andreu@coolcloud.app,939777,ES43209578608750974410,5585.9,2022-04-13T22:00:57,Barcelona,expenses,healthcare,-152.6,-4102.91
buyer_4,Marc,Andreu,1974-05-23,52965688T,marc.andreu@coolcloud.app,939777,ES43209578608750974410,5585.9,2022-04-15T17:44:46,Barcelona,expenses,education,-71.35,-4174.26
buyer_4,Marc,Andreu,1974-05-23,52965688T,marc.andreu@coolcloud.app,939777,ES43209578608750974410,5585.9,2022-04-16T15:02:40,Barcelona,expenses,cash,-100.0,-4274.26
buyer_4,Marc,Andreu,1974-05-23,52965688T,marc.andreu@coolcloud.app,939777,ES43209578608750974410,5585.9,2022-04-17T09:32:06,Barcelona,expenses,food,-120.99,-4395.25
buyer_4,Marc,Andreu,1974-05-23,52965688T,marc.andreu@coolcloud.app,939777,ES43209578608750974410,5585.9,2022-04-24T12:10:51,Barcelona,expenses,transport,-87.23,-4482.48
buyer_4,Marc,Andreu,1974-05-23,52965688T,marc.andreu@coolcloud.app,939777,ES43209578608750974410,5585.9,2022-04-27T08:38:35,Barcelona,expenses,gifts,-275.01,-4757.49
buyer_4,Marc,Andreu,1974-05-23,52965688T,marc.andreu@coolcloud.app,939777,ES43209578608750974410,5585.9,2022-04-28T08:42:42,Barcelona,expenses,food,-113.48,-4870.97
buyer_4,Marc,Andreu,1974-05-23,52965688T,marc.andreu@coolcloud.app,939777,ES43209578608750974410,5585.9,2022-04-29T08:41:38,Barcelona,expenses,cash,-100.0,-4970.97
buyer_4,Marc,Andreu,1974-05-23,52965688T,marc.andreu@coolcloud.app,939777,ES43209578608750974410,5585.9,2022-04-29T10:12:21,Barcelona,expenses,gifts,-362.75,-5333.72
buyer_4,Marc,Andreu,1974-05-23,52965688T,marc.andreu@coolcloud.app,939777,ES43209578608750974410,5585.9,2022-04-30T03:23:11,Barcelona,expenses,food,-96.47,-5430.19
buyer_4,Marc,Andreu,1974-05-23,52965688T,marc.andreu@coolcloud.app,939777,ES43209578608750974410,5585.9,2022-05-01T18:35:27,Barcelona,incomes,salary,1278.93,-4151.26
buyer_4,Marc,Andreu,1974-05-23,52965688T,marc.andreu@coolcloud.app,939777,ES43209578608750974410,5585.9,2022-05-01T03:31:47,Barcelona,expenses,clothing,-91.14,-4242.4
buyer_4,Marc,Andreu,1974-05-23,52965688T,marc.andreu@coolcloud.app,939777,ES43209578608750974410,5585.9,2022-05-02T09:25:03,Barcelona,expenses,food,-91.57,-4333.97
buyer_4,Marc,Andreu,1974-05-23,52965688T,marc.andreu@coolcloud.app,939777,ES43209578608750974410,5585.9,2022-05-05T02:06:54,Barcelona,expenses,mortgage,-477.68,-4811.65
buyer_4,Marc,Andreu,1974-05-23,52965688T,marc.andreu@coolcloud.app,939777,ES43209578608750974410,5585.9,2022-05-06T14:17:51,Barcelona,expenses,water,-23.87,-4835.52
buyer_4,Marc,Andreu,1974-05-23,52965688T,marc.andreu@coolcloud.app,939777,ES43209578608750974410,5585.9,2022-05-06T08:26:48,Barcelona,expenses,gas,-62.72,-4898.24
buyer_4,Marc,Andreu,1974-05-23,52965688T,marc.andreu@coolcloud.app,939777,ES43209578608750974410,5585.9,2022-05-06T18:23:48,Barcelona,expenses,internet,-26.86,-4925.1
buyer_4,Marc,Andreu,1974-05-23,52965688T,marc.andreu@coolcloud.app,939777,ES43209578608750974410,5585.9,2022-05-06T09:21:17,Barcelona,expenses,food,-118.53,-5043.63
buyer_4,Marc,Andreu,1974-05-23,52965688T,marc.andreu@coolcloud.app,939777,ES43209578608750974410,5585.9,2022-05-07T15:58:43,Barcelona,expenses,water,-22.14,-5065.77
buyer_4,Marc,Andreu,1974-05-23,52965688T,marc.andreu@coolcloud.app,939777,ES43209578608750974410,5585.9,2022-05-07T12:14:44,Barcelona,expenses,gas,-30.7,-5096.47
buyer_4,Marc,Andreu,1974-05-23,52965688T,marc.andreu@coolcloud.app,939777,ES43209578608750974410,5585.9,2022-05-07T09:41:21,Barcelona,expenses,phone,-24.63,-5121.1
buyer_4,Marc,Andreu,1974-05-23,52965688T,marc.andreu@coolcloud.app,939777,ES43209578608750974410,5585.9,2022-05-07T13:13:58,Barcelona,expenses,gifts,-190.11,-5311.21
buyer_4,Marc,Andreu,1974-05-23,52965688T,marc.andreu@coolcloud.app,939777,ES43209578608750974410,5585.9,2022-05-08T11:20:26,Barcelona,expenses,cash,-100.0,-5411.21
buyer_4,Marc,Andreu,1974-05-23,52965688T,marc.andreu@coolcloud.app,939777,ES43209578608750974410,5585.9,2022-05-08T19:46:37,Barcelona,expenses,gifts,-133.04,-5544.25
buyer_4,Marc,Andreu,1974-05-23,52965688T,marc.andreu@coolcloud.app,939777,ES43209578608750974410,5585.9,2022-05-09T20:37:32,Barcelona,expenses,cash,-100.0,-5644.25
buyer_4,Marc,Andreu,1974-05-23,52965688T,marc.andreu@coolcloud.app,939777,ES43209578608750974410,5585.9,2022-05-11T14:31:50,Barcelona,expenses,leisure,-62.47,-5706.72
buyer_4,Marc,Andreu,1974-05-23,52965688T,marc.andreu@coolcloud.app,939777,ES43209578608750974410,5585.9,2022-05-12T23:50:38,Barcelona,expenses,appliances,-279.44,-5986.16
buyer_4,Marc,Andreu,1974-05-23,52965688T,marc.andreu@coolcloud.app,939777,ES43209578608750974410,5585.9,2022-05-15T16:10:46,Barcelona,expenses,food,-101.08,-6087.24
buyer_4,Marc,Andreu,1974-05-23,52965688T,marc.andreu@coolcloud.app,939777,ES43209578608750974410,5585.9,2022-05-17T18:16:56,Barcelona,expenses,transport,-86.49,-6173.73
buyer_4,Marc,Andreu,1974-05-23,52965688T,marc.andreu@coolcloud.app,939777,ES43209578608750974410,5585.9,2022-05-19T16:01:50,Barcelona,expenses,transport,-86.43,-6260.16
buyer_4,Marc,Andreu,1974-05-23,52965688T,marc.andreu@coolcloud.app,939777,ES43209578608750974410,5585.9,2022-05-19T21:30:14,Barcelona,expenses,cash,-100.0,-6360.16
buyer_4,Marc,Andreu,1974-05-23,52965688T,marc.andreu@coolcloud.app,939777,ES43209578608750974410,5585.9,2022-05-20T12:12:27,Barcelona,expenses,food,-100.64,-6460.8
buyer_4,Marc,Andreu,1974-05-23,52965688T,marc.andreu@coolcloud.app,939777,ES43209578608750974410,5585.9,2022-05-21T18:32:01,Barcelona,expenses,healthcare,-91.56,-6552.36
buyer_4,Marc,Andreu,1974-05-23,52965688T,marc.andreu@coolcloud.app,939777,ES43209578608750974410,5585.9,2022-05-21T09:54:23,Barcelona,expenses,gifts,-260.99,-6813.35
buyer_4,Marc,Andreu,1974-05-23,52965688T,marc.andreu@coolcloud.app,939777,ES43209578608750974410,5585.9,2022-05-23T09:06:32,Barcelona,expenses,leisure,-47.49,-6860.84
buyer_4,Marc,Andreu,1974-05-23,52965688T,marc.andreu@coolcloud.app,939777,ES43209578608750974410,5585.9,2022-05-23T10:13:22,Barcelona,expenses,education,-64.31,-6925.15
buyer_4,Marc,Andreu,1974-05-23,52965688T,marc.andreu@coolcloud.app,939777,ES43209578608750974410,5585.9,2022-05-25T15:07:55,Barcelona,expenses,food,-122.55,-7047.7
buyer_4,Marc,Andreu,1974-05-23,52965688T,marc.andreu@coolcloud.app,939777,ES43209578608750974410,5585.9,2022-05-25T20:00:49,Barcelona,expenses,gifts,-336.04,-7383.74
buyer_4,Marc,Andreu,1974-05-23,52965688T,marc.andreu@coolcloud.app,939777,ES43209578608750974410,5585.9,2022-05-27T17:44:20,Barcelona,expenses,transport,-57.19,-7440.93
buyer_4,Marc,Andreu,1974-05-23,52965688T,marc.andreu@coolcloud.app,939777,ES43209578608750974410,5585.9,2022-05-28T08:51:39,Barcelona,expenses,cash,-100.0,-7540.93
buyer_4,Marc,Andreu,1974-05-23,52965688T,marc.andreu@coolcloud.app,939777,ES43209578608750974410,5585.9,2022-05-31T18:12:14,Barcelona,expenses,leisure,-83.87,-7624.8
buyer_4,Marc,Andreu,1974-05-23,52965688T,marc.andreu@coolcloud.app,939777,ES43209578608750974410,5585.9,2022-05-31T16:49:45,Barcelona,expenses,repairs,-191.91,-7816.71
buyer_4,Marc,Andreu,1974-05-23,52965688T,marc.andreu@coolcloud.app,939777,ES43209578608750974410,5585.9,2022-06-01T08:56:49,Barcelona,incomes,salary,1278.93,-6537.78
buyer_4,Marc,Andreu,1974-05-23,52965688T,marc.andreu@coolcloud.app,939777,ES43209578608750974410,5585.9,2022-06-01T08:56:49,Barcelona,incomes,salary_bonus,939.55,-5598.23
buyer_4,Marc,Andreu,1974-05-23,52965688T,marc.andreu@coolcloud.app,939777,ES43209578608750974410,5585.9,2022-06-01T10:02:58,Barcelona,expenses,taxes,-782.08,-6380.31
buyer_4,Marc,Andreu,1974-05-23,52965688T,marc.andreu@coolcloud.app,939777,ES43209578608750974410,5585.9,2022-06-01T09:06:07,Barcelona,expenses,insurance,-330.9,-6711.21
buyer_4,Marc,Andreu,1974-05-23,52965688T,marc.andreu@coolcloud.app,939777,ES43209578608750974410,5585.9,2022-06-01T10:53:46,Barcelona,expenses,education,-51.06,-6762.27
buyer_4,Marc,Andreu,1974-05-23,52965688T,marc.andreu@coolcloud.app,939777,ES43209578608750974410,5585.9,2022-06-03T14:59:15,Barcelona,expenses,food,-61.73,-6824.0
buyer_4,Marc,Andreu,1974-05-23,52965688T,marc.andreu@coolcloud.app,939777,ES43209578608750974410,5585.9,2022-06-05T18:23:46,Barcelona,expenses,mortgage,-477.68,-7301.68
buyer_4,Marc,Andreu,1974-05-23,52965688T,marc.andreu@coolcloud.app,939777,ES43209578608750974410,5585.9,2022-06-05T17:49:55,Barcelona,expenses,electricity,-26.7,-7328.38
buyer_4,Marc,Andreu,1974-05-23,52965688T,marc.andreu@coolcloud.app,939777,ES43209578608750974410,5585.9,2022-06-05T02:03:20,Barcelona,expenses,phone,-23.47,-7351.85
buyer_4,Marc,Andreu,1974-05-23,52965688T,marc.andreu@coolcloud.app,939777,ES43209578608750974410,5585.9,2022-06-06T22:17:01,Barcelona,expenses,electricity,-30.37,-7382.22
buyer_4,Marc,Andreu,1974-05-23,52965688T,marc.andreu@coolcloud.app,939777,ES43209578608750974410,5585.9,2022-06-06T18:25:47,Barcelona,expenses,gas,-51.4,-7433.62
buyer_4,Marc,Andreu,1974-05-23,52965688T,marc.andreu@coolcloud.app,939777,ES43209578608750974410,5585.9,2022-06-06T08:29:27,Barcelona,expenses,phone,-21.42,-7455.04
buyer_4,Marc,Andreu,1974-05-23,52965688T,marc.andreu@coolcloud.app,939777,ES43209578608750974410,5585.9,2022-06-06T03:06:34,Barcelona,expenses,cash,-100.0,-7555.04
buyer_4,Marc,Andreu,1974-05-23,52965688T,marc.andreu@coolcloud.app,939777,ES43209578608750974410,5585.9,2022-06-07T20:06:29,Barcelona,expenses,water,-15.92,-7570.96
buyer_4,Marc,Andreu,1974-05-23,52965688T,marc.andreu@coolcloud.app,939777,ES43209578608750974410,5585.9,2022-06-07T10:53:58,Barcelona,expenses,cash,-100.0,-7670.96
buyer_4,Marc,Andreu,1974-05-23,52965688T,marc.andreu@coolcloud.app,939777,ES43209578608750974410,5585.9,2022-06-08T08:54:15,Barcelona,expenses,electricity,-56.67,-7727.63
buyer_4,Marc,Andreu,1974-05-23,52965688T,marc.andreu@coolcloud.app,939777,ES43209578608750974410,5585.9,2022-06-08T12:53:42,Barcelona,expenses,gas,-60.05,-7787.68
buyer_4,Marc,Andreu,1974-05-23,52965688T,marc.andreu@coolcloud.app,939777,ES43209578608750974410,5585.9,2022-06-08T15:26:51,Barcelona,expenses,transport,-49.26,-7836.94
buyer_4,Marc,Andreu,1974-05-23,52965688T,marc.andreu@coolcloud.app,939777,ES43209578608750974410,5585.9,2022-06-10T18:38:03,Barcelona,expenses,cash,-100.0,-7936.94
buyer_4,Marc,Andreu,1974-05-23,52965688T,marc.andreu@coolcloud.app,939777,ES43209578608750974410,5585.9,2022-06-12T20:28:06,Barcelona,expenses,transport,-41.59,-7978.53
buyer_4,Marc,Andreu,1974-05-23,52965688T,marc.andreu@coolcloud.app,939777,ES43209578608750974410,5585.9,2022-06-12T15:58:12,Barcelona,expenses,cash,-100.0,-8078.53
buyer_4,Marc,Andreu,1974-05-23,52965688T,marc.andreu@coolcloud.app,939777,ES43209578608750974410,5585.9,2022-06-13T12:21:13,Barcelona,expenses,appliances,-103.5,-8182.03
buyer_4,Marc,Andreu,1974-05-23,52965688T,marc.andreu@coolcloud.app,939777,ES43209578608750974410,5585.9,2022-06-14T08:00:36,Barcelona,expenses,children,-589.0390000000002,-8771.07
buyer_4,Marc,Andreu,1974-05-23,52965688T,marc.andreu@coolcloud.app,939777,ES43209578608750974410,5585.9,2022-06-15T12:57:00,Barcelona,expenses,leisure,-24.65,-8795.72
buyer_4,Marc,Andreu,1974-05-23,52965688T,marc.andreu@coolcloud.app,939777,ES43209578608750974410,5585.9,2022-06-16T15:27:34,Barcelona,expenses,leisure,-67.62,-8863.34
buyer_4,Marc,Andreu,1974-05-23,52965688T,marc.andreu@coolcloud.app,939777,ES43209578608750974410,5585.9,2022-06-16T16:33:15,Barcelona,expenses,healthcare,-117.44,-8980.78
buyer_4,Marc,Andreu,1974-05-23,52965688T,marc.andreu@coolcloud.app,939777,ES43209578608750974410,5585.9,2022-06-16T17:45:48,Barcelona,expenses,gifts,-234.43,-9215.21
buyer_4,Marc,Andreu,1974-05-23,52965688T,marc.andreu@coolcloud.app,939777,ES43209578608750974410,5585.9,2022-06-17T12:49:42,Barcelona,expenses,transport,-61.44,-9276.65
buyer_4,Marc,Andreu,1974-05-23,52965688T,marc.andreu@coolcloud.app,939777,ES43209578608750974410,5585.9,2022-06-17T16:50:55,Barcelona,expenses,healthcare,-152.05,-9428.7
buyer_4,Marc,Andreu,1974-05-23,52965688T,marc.andreu@coolcloud.app,939777,ES43209578608750974410,5585.9,2022-06-18T20:19:50,Barcelona,expenses,food,-77.88,-9506.58
buyer_4,Marc,Andreu,1974-05-23,52965688T,marc.andreu@coolcloud.app,939777,ES43209578608750974410,5585.9,2022-06-20T11:41:11,Barcelona,expenses,repairs,-158.99,-9665.57
buyer_4,Marc,Andreu,1974-05-23,52965688T,marc.andreu@coolcloud.app,939777,ES43209578608750974410,5585.9,2022-06-20T13:48:12,Barcelona,expenses,gifts,-256.43,-9922.0
buyer_4,Marc,Andreu,1974-05-23,52965688T,marc.andreu@coolcloud.app,939777,ES43209578608750974410,5585.9,2022-06-21T20:51:19,Barcelona,expenses,children,-589.0390000000002,-10511.04
buyer_4,Marc,Andreu,1974-05-23,52965688T,marc.andreu@coolcloud.app,939777,ES43209578608750974410,5585.9,2022-06-23T07:09:59,Barcelona,expenses,gifts,-223.52,-10734.56
buyer_4,Marc,Andreu,1974-05-23,52965688T,marc.andreu@coolcloud.app,939777,ES43209578608750974410,5585.9,2022-07-01T19:46:48,Barcelona,incomes,salary,1278.93,-9455.63
buyer_4,Marc,Andreu,1974-05-23,52965688T,marc.andreu@coolcloud.app,939777,ES43209578608750974410,5585.9,2022-07-01T19:46:48,Barcelona,incomes,extra_income,171.57,-9284.06
buyer_4,Marc,Andreu,1974-05-23,52965688T,marc.andreu@coolcloud.app,939777,ES43209578608750974410,5585.9,2022-07-02T16:04:50,Barcelona,expenses,cash,-100.0,-9384.06
buyer_4,Marc,Andreu,1974-05-23,52965688T,marc.andreu@coolcloud.app,939777,ES43209578608750974410,5585.9,2022-07-04T09:47:32,Barcelona,expenses,cash,-100.0,-9484.06
buyer_4,Marc,Andreu,1974-05-23,52965688T,marc.andreu@coolcloud.app,939777,ES43209578608750974410,5585.9,2022-07-05T20:13:37,Barcelona,expenses,mortgage,-477.68,-9961.74
buyer_4,Marc,Andreu,1974-05-23,52965688T,marc.andreu@coolcloud.app,939777,ES43209578608750974410,5585.9,2022-07-05T08:54:15,Barcelona,expenses,gas,-51.78,-10013.52
buyer_4,Marc,Andreu,1974-05-23,52965688T,marc.andreu@coolcloud.app,939777,ES43209578608750974410,5585.9,2022-07-05T12:12:44,Barcelona,expenses,internet,-26.86,-10040.38
buyer_4,Marc,Andreu,1974-05-23,52965688T,marc.andreu@coolcloud.app,939777,ES43209578608750974410,5585.9,2022-07-06T17:31:21,Barcelona,expenses,phone,-26.02,-10066.4
buyer_4,Marc,Andreu,1974-05-23,52965688T,marc.andreu@coolcloud.app,939777,ES43209578608750974410,5585.9,2022-07-06T18:38:42,Barcelona,expenses,food,-71.68,-10138.08
buyer_4,Marc,Andreu,1974-05-23,52965688T,marc.andreu@coolcloud.app,939777,ES43209578608750974410,5585.9,2022-07-06T03:04:21,Barcelona,expenses,cash,-100.0,-10238.08
buyer_4,Marc,Andreu,1974-05-23,52965688T,marc.andreu@coolcloud.app,939777,ES43209578608750974410,5585.9,2022-07-06T12:51:37,Barcelona,expenses,gifts,-159.79,-10397.87
buyer_4,Marc,Andreu,1974-05-23,52965688T,marc.andreu@coolcloud.app,939777,ES43209578608750974410,5585.9,2022-07-07T15:06:41,Barcelona,expenses,gas,-21.48,-10419.35
buyer_4,Marc,Andreu,1974-05-23,52965688T,marc.andreu@coolcloud.app,939777,ES43209578608750974410,5585.9,2022-07-07T17:06:41,Barcelona,expenses,leisure,-76.27,-10495.62
buyer_4,Marc,Andreu,1974-05-23,52965688T,marc.andreu@coolcloud.app,939777,ES43209578608750974410,5585.9,2022-07-08T20:07:51,Barcelona,expenses,gas,-59.36,-10554.98
buyer_4,Marc,Andreu,1974-05-23,52965688T,marc.andreu@coolcloud.app,939777,ES43209578608750974410,5585.9,2022-07-08T15:00:08,Barcelona,expenses,food,-82.57,-10637.55
buyer_4,Marc,Andreu,1974-05-23,52965688T,marc.andreu@coolcloud.app,939777,ES43209578608750974410,5585.9,2022-07-08T12:31:26,Barcelona,expenses,transport,-70.06,-10707.61
buyer_4,Marc,Andreu,1974-05-23,52965688T,marc.andreu@coolcloud.app,939777,ES43209578608750974410,5585.9,2022-07-08T08:29:04,Barcelona,expenses,children,-436.4090000000002,-11144.02
buyer_4,Marc,Andreu,1974-05-23,52965688T,marc.andreu@coolcloud.app,939777,ES43209578608750974410,5585.9,2022-07-09T03:55:51,Barcelona,expenses,appliances,-236.49,-11380.51
buyer_4,Marc,Andreu,1974-05-23,52965688T,marc.andreu@coolcloud.app,939777,ES43209578608750974410,5585.9,2022-07-10T13:25:47,Barcelona,expenses,leisure,-36.67,-11417.18
buyer_4,Marc,Andreu,1974-05-23,52965688T,marc.andreu@coolcloud.app,939777,ES43209578608750974410,5585.9,2022-07-11T17:46:04,Barcelona,expenses,education,-77.62,-11494.8
buyer_4,Marc,Andreu,1974-05-23,52965688T,marc.andreu@coolcloud.app,939777,ES43209578608750974410,5585.9,2022-07-11T11:26:30,Barcelona,expenses,repairs,-281.78,-11776.58
buyer_4,Marc,Andreu,1974-05-23,52965688T,marc.andreu@coolcloud.app,939777,ES43209578608750974410,5585.9,2022-07-12T13:41:01,Barcelona,expenses,leisure,-28.48,-11805.06
buyer_4,Marc,Andreu,1974-05-23,52965688T,marc.andreu@coolcloud.app,939777,ES43209578608750974410,5585.9,2022-07-13T20:49:07,Barcelona,expenses,clothing,-108.8,-11913.86
buyer_4,Marc,Andreu,1974-05-23,52965688T,marc.andreu@coolcloud.app,939777,ES43209578608750974410,5585.9,2022-07-14T11:18:25,Barcelona,expenses,gifts,-304.27,-12218.13
buyer_4,Marc,Andreu,1974-05-23,52965688T,marc.andreu@coolcloud.app,939777,ES43209578608750974410,5585.9,2022-07-15T03:15:32,Barcelona,expenses,transport,-78.95,-12297.08
buyer_4,Marc,Andreu,1974-05-23,52965688T,marc.andreu@coolcloud.app,939777,ES43209578608750974410,5585.9,2022-07-16T20:01:36,Barcelona,expenses,leisure,-40.24,-12337.32
buyer_4,Marc,Andreu,1974-05-23,52965688T,marc.andreu@coolcloud.app,939777,ES43209578608750974410,5585.9,2022-07-17T14:12:34,Barcelona,expenses,leisure,-53.02,-12390.34
buyer_4,Marc,Andreu,1974-05-23,52965688T,marc.andreu@coolcloud.app,939777,ES43209578608750974410,5585.9,2022-07-21T18:13:55,Barcelona,expenses,food,-69.39,-12459.73
buyer_4,Marc,Andreu,1974-05-23,52965688T,marc.andreu@coolcloud.app,939777,ES43209578608750974410,5585.9,2022-07-24T01:36:12,Barcelona,expenses,transport,-56.61,-12516.34
buyer_4,Marc,Andreu,1974-05-23,52965688T,marc.andreu@coolcloud.app,939777,ES43209578608750974410,5585.9,2022-07-24T15:45:47,Barcelona,expenses,cash,-100.0,-12616.34
buyer_4,Marc,Andreu,1974-05-23,52965688T,marc.andreu@coolcloud.app,939777,ES43209578608750974410,5585.9,2022-07-27T13:54:56,Barcelona,expenses,children,-589.0390000000002,-13205.38
buyer_4,Marc,Andreu,1974-05-23,52965688T,marc.andreu@coolcloud.app,939777,ES43209578608750974410,5585.9,2022-07-29T14:19:11,Barcelona,expenses,cash,-100.0,-13305.38
buyer_4,Marc,Andreu,1974-05-23,52965688T,marc.andreu@coolcloud.app,939777,ES43209578608750974410,5585.9,2022-07-31T08:06:33,Barcelona,expenses,transport,-75.5,-13380.88
buyer_4,Marc,Andreu,1974-05-23,52965688T,marc.andreu@coolcloud.app,939777,ES43209578608750974410,5585.9,2022-07-31T08:04:51,Barcelona,expenses,cash,-100.0,-13480.88
buyer_4,Marc,Andreu,1974-05-23,52965688T,marc.andreu@coolcloud.app,939777,ES43209578608750974410,5585.9,2022-08-01T07:07:33,Barcelona,incomes,salary,1278.93,-12201.95
buyer_4,Marc,Andreu,1974-05-23,52965688T,marc.andreu@coolcloud.app,939777,ES43209578608750974410,5585.9,2022-08-02T09:29:19,Barcelona,expenses,clothing,-97.01,-12298.96
buyer_4,Marc,Andreu,1974-05-23,52965688T,marc.andreu@coolcloud.app,939777,ES43209578608750974410,5585.9,2022-08-04T13:39:24,Barcelona,expenses,food,-79.31,-12378.27
buyer_4,Marc,Andreu,1974-05-23,52965688T,marc.andreu@coolcloud.app,939777,ES43209578608750974410,5585.9,2022-08-04T14:56:15,Barcelona,expenses,repairs,-92.87,-12471.14
buyer_4,Marc,Andreu,1974-05-23,52965688T,marc.andreu@coolcloud.app,939777,ES43209578608750974410,5585.9,2022-08-05T13:15:04,Barcelona,expenses,mortgage,-477.68,-12948.82
buyer_4,Marc,Andreu,1974-05-23,52965688T,marc.andreu@coolcloud.app,939777,ES43209578608750974410,5585.9,2022-08-05T11:46:16,Barcelona,expenses,gas,-27.43,-12976.25
buyer_4,Marc,Andreu,1974-05-23,52965688T,marc.andreu@coolcloud.app,939777,ES43209578608750974410,5585.9,2022-08-05T12:32:48,Barcelona,expenses,phone,-24.37,-13000.62
buyer_4,Marc,Andreu,1974-05-23,52965688T,marc.andreu@coolcloud.app,939777,ES43209578608750974410,5585.9,2022-08-05T09:33:22,Barcelona,expenses,food,-80.35,-13080.97
buyer_4,Marc,Andreu,1974-05-23,52965688T,marc.andreu@coolcloud.app,939777,ES43209578608750974410,5585.9,2022-08-05T08:19:11,Barcelona,expenses,cash,-100.0,-13180.97
buyer_4,Marc,Andreu,1974-05-23,52965688T,marc.andreu@coolcloud.app,939777,ES43209578608750974410,5585.9,2022-08-06T22:25:44,Barcelona,expenses,phone,-26.44,-13207.41
buyer_4,Marc,Andreu,1974-05-23,52965688T,marc.andreu@coolcloud.app,939777,ES43209578608750974410,5585.9,2022-08-06T17:04:26,Barcelona,expenses,cash,-100.0,-13307.41
buyer_4,Marc,Andreu,1974-05-23,52965688T,marc.andreu@coolcloud.app,939777,ES43209578608750974410,5585.9,2022-08-07T13:57:16,Barcelona,expenses,water,-24.68,-13332.09
buyer_4,Marc,Andreu,1974-05-23,52965688T,marc.andreu@coolcloud.app,939777,ES43209578608750974410,5585.9,2022-08-07T17:30:45,Barcelona,expenses,gas,-54.97,-13387.06
buyer_4,Marc,Andreu,1974-05-23,52965688T,marc.andreu@coolcloud.app,939777,ES43209578608750974410,5585.9,2022-08-07T20:39:10,Barcelona,expenses,phone,-23.83,-13410.89
buyer_4,Marc,Andreu,1974-05-23,52965688T,marc.andreu@coolcloud.app,939777,ES43209578608750974410,5585.9,2022-08-08T09:30:32,Barcelona,expenses,electricity,-37.56,-13448.45
buyer_4,Marc,Andreu,1974-05-23,52965688T,marc.andreu@coolcloud.app,939777,ES43209578608750974410,5585.9,2022-08-08T10:29:25,Barcelona,expenses,internet,-26.86,-13475.31
buyer_4,Marc,Andreu,1974-05-23,52965688T,marc.andreu@coolcloud.app,939777,ES43209578608750974410,5585.9,2022-08-08T08:34:36,Barcelona,expenses,phone,-25.07,-13500.38
buyer_4,Marc,Andreu,1974-05-23,52965688T,marc.andreu@coolcloud.app,939777,ES43209578608750974410,5585.9,2022-08-08T09:02:06,Barcelona,expenses,leisure,-81.61,-13581.99
buyer_4,Marc,Andreu,1974-05-23,52965688T,marc.andreu@coolcloud.app,939777,ES43209578608750974410,5585.9,2022-08-08T21:19:51,Barcelona,expenses,cash,-100.0,-13681.99
buyer_4,Marc,Andreu,1974-05-23,52965688T,marc.andreu@coolcloud.app,939777,ES43209578608750974410,5585.9,2022-08-11T15:55:16,Barcelona,expenses,repairs,-289.4,-13971.39
buyer_4,Marc,Andreu,1974-05-23,52965688T,marc.andreu@coolcloud.app,939777,ES43209578608750974410,5585.9,2022-08-12T08:28:27,Barcelona,expenses,cash,-100.0,-14071.39
buyer_4,Marc,Andreu,1974-05-23,52965688T,marc.andreu@coolcloud.app,939777,ES43209578608750974410,5585.9,2022-08-13T09:55:46,Barcelona,expenses,leisure,-84.45,-14155.84
buyer_4,Marc,Andreu,1974-05-23,52965688T,marc.andreu@coolcloud.app,939777,ES43209578608750974410,5585.9,2022-08-15T06:37:14,Barcelona,expenses,leisure,-39.75,-14195.59
buyer_4,Marc,Andreu,1974-05-23,52965688T,marc.andreu@coolcloud.app,939777,ES43209578608750974410,5585.9,2022-08-16T17:02:51,Barcelona,expenses,cash,-100.0,-14295.59
buyer_4,Marc,Andreu,1974-05-23,52965688T,marc.andreu@coolcloud.app,939777,ES43209578608750974410,5585.9,2022-08-17T17:52:00,Barcelona,expenses,cash,-100.0,-14395.59
buyer_4,Marc,Andreu,1974-05-23,52965688T,marc.andreu@coolcloud.app,939777,ES43209578608750974410,5585.9,2022-08-17T14:42:59,Barcelona,expenses,children,-489.0390000000002,-14884.63
buyer_4,Marc,Andreu,1974-05-23,52965688T,marc.andreu@coolcloud.app,939777,ES43209578608750974410,5585.9,2022-08-18T17:12:30,Barcelona,expenses,leisure,-76.03,-14960.66
buyer_4,Marc,Andreu,1974-05-23,52965688T,marc.andreu@coolcloud.app,939777,ES43209578608750974410,5585.9,2022-08-19T14:48:18,Barcelona,expenses,food,-118.88,-15079.54
buyer_4,Marc,Andreu,1974-05-23,52965688T,marc.andreu@coolcloud.app,939777,ES43209578608750974410,5585.9,2022-08-22T22:01:53,Barcelona,expenses,cash,-100.0,-15179.54
buyer_4,Marc,Andreu,1974-05-23,52965688T,marc.andreu@coolcloud.app,939777,ES43209578608750974410,5585.9,2022-08-22T11:45:59,Barcelona,expenses,children,-489.0390000000002,-15668.58
buyer_4,Marc,Andreu,1974-05-23,52965688T,marc.andreu@coolcloud.app,939777,ES43209578608750974410,5585.9,2022-08-23T04:57:37,Barcelona,expenses,leisure,-79.75,-15748.33
buyer_4,Marc,Andreu,1974-05-23,52965688T,marc.andreu@coolcloud.app,939777,ES43209578608750974410,5585.9,2022-08-24T13:44:09,Barcelona,expenses,food,-118.52,-15866.85
buyer_4,Marc,Andreu,1974-05-23,52965688T,marc.andreu@coolcloud.app,939777,ES43209578608750974410,5585.9,2022-08-24T12:50:35,Barcelona,expenses,cash,-100.0,-15966.85
buyer_4,Marc,Andreu,1974-05-23,52965688T,marc.andreu@coolcloud.app,939777,ES43209578608750974410,5585.9,2022-08-24T12:49:21,Barcelona,expenses,appliances,-241.67,-16208.52
buyer_4,Marc,Andreu,1974-05-23,52965688T,marc.andreu@coolcloud.app,939777,ES43209578608750974410,5585.9,2022-08-26T12:47:35,Barcelona,expenses,leisure,-31.32,-16239.84
buyer_4,Marc,Andreu,1974-05-23,52965688T,marc.andreu@coolcloud.app,939777,ES43209578608750974410,5585.9,2022-08-28T20:41:27,Barcelona,expenses,children,-589.0390000000002,-16828.88
buyer_4,Marc,Andreu,1974-05-23,52965688T,marc.andreu@coolcloud.app,939777,ES43209578608750974410,5585.9,2022-08-31T20:03:40,Barcelona,expenses,food,-114.91,-16943.79
buyer_4,Marc,Andreu,1974-05-23,52965688T,marc.andreu@coolcloud.app,939777,ES43209578608750974410,5585.9,2022-08-31T19:27:15,Barcelona,expenses,transport,-43.11,-16986.9
buyer_4,Marc,Andreu,1974-05-23,52965688T,marc.andreu@coolcloud.app,939777,ES43209578608750974410,5585.9,2022-09-01T10:07:43,Barcelona,incomes,salary,1278.93,-15707.97
buyer_4,Marc,Andreu,1974-05-23,52965688T,marc.andreu@coolcloud.app,939777,ES43209578608750974410,5585.9,2022-09-02T17:53:50,Barcelona,expenses,cash,-100.0,-15807.97
buyer_4,Marc,Andreu,1974-05-23,52965688T,marc.andreu@coolcloud.app,939777,ES43209578608750974410,5585.9,2022-09-04T14:27:47,Barcelona,expenses,transport,-40.36,-15848.33
buyer_4,Marc,Andreu,1974-05-23,52965688T,marc.andreu@coolcloud.app,939777,ES43209578608750974410,5585.9,2022-09-05T18:04:55,Barcelona,expenses,mortgage,-477.68,-16326.01
buyer_4,Marc,Andreu,1974-05-23,52965688T,marc.andreu@coolcloud.app,939777,ES43209578608750974410,5585.9,2022-09-05T08:01:07,Barcelona,expenses,water,-25.84,-16351.85
buyer_4,Marc,Andreu,1974-05-23,52965688T,marc.andreu@coolcloud.app,939777,ES43209578608750974410,5585.9,2022-09-05T04:54:17,Barcelona,expenses,internet,-26.86,-16378.71
buyer_4,Marc,Andreu,1974-05-23,52965688T,marc.andreu@coolcloud.app,939777,ES43209578608750974410,5585.9,2022-09-06T18:22:31,Barcelona,expenses,internet,-26.86,-16405.57
buyer_4,Marc,Andreu,1974-05-23,52965688T,marc.andreu@coolcloud.app,939777,ES43209578608750974410,5585.9,2022-09-06T12:03:06,Barcelona,expenses,food,-116.18,-16521.75
buyer_4,Marc,Andreu,1974-05-23,52965688T,marc.andreu@coolcloud.app,939777,ES43209578608750974410,5585.9,2022-09-06T13:11:42,Barcelona,expenses,appliances,-119.57,-16641.32
buyer_4,Marc,Andreu,1974-05-23,52965688T,marc.andreu@coolcloud.app,939777,ES43209578608750974410,5585.9,2022-09-07T20:16:50,Barcelona,expenses,gas,-60.32,-16701.64
buyer_4,Marc,Andreu,1974-05-23,52965688T,marc.andreu@coolcloud.app,939777,ES43209578608750974410,5585.9,2022-09-07T19:07:40,Barcelona,expenses,phone,-23.23,-16724.87
buyer_4,Marc,Andreu,1974-05-23,52965688T,marc.andreu@coolcloud.app,939777,ES43209578608750974410,5585.9,2022-09-07T20:33:48,Barcelona,expenses,leisure,-41.32,-16766.19
buyer_4,Marc,Andreu,1974-05-23,52965688T,marc.andreu@coolcloud.app,939777,ES43209578608750974410,5585.9,2022-09-07T15:04:36,Barcelona,expenses,healthcare,-139.74,-16905.93
buyer_4,Marc,Andreu,1974-05-23,52965688T,marc.andreu@coolcloud.app,939777,ES43209578608750974410,5585.9,2022-09-07T18:20:34,Barcelona,expenses,cash,-100.0,-17005.93
buyer_4,Marc,Andreu,1974-05-23,52965688T,marc.andreu@coolcloud.app,939777,ES43209578608750974410,5585.9,2022-09-07T18:00:06,Barcelona,expenses,repairs,-282.15,-17288.08
buyer_4,Marc,Andreu,1974-05-23,52965688T,marc.andreu@coolcloud.app,939777,ES43209578608750974410,5585.9,2022-09-08T20:21:26,Barcelona,expenses,food,-123.87,-17411.95
buyer_4,Marc,Andreu,1974-05-23,52965688T,marc.andreu@coolcloud.app,939777,ES43209578608750974410,5585.9,2022-09-08T15:46:58,Barcelona,expenses,repairs,-329.55,-17741.5
buyer_4,Marc,Andreu,1974-05-23,52965688T,marc.andreu@coolcloud.app,939777,ES43209578608750974410,5585.9,2022-09-10T22:58:00,Barcelona,expenses,transport,-79.65,-17821.15
buyer_4,Marc,Andreu,1974-05-23,52965688T,marc.andreu@coolcloud.app,939777,ES43209578608750974410,5585.9,2022-09-11T18:55:08,Barcelona,expenses,food,-112.03,-17933.18
buyer_4,Marc,Andreu,1974-05-23,52965688T,marc.andreu@coolcloud.app,939777,ES43209578608750974410,5585.9,2022-09-11T17:59:30,Barcelona,expenses,clothing,-66.06,-17999.24
buyer_4,Marc,Andreu,1974-05-23,52965688T,marc.andreu@coolcloud.app,939777,ES43209578608750974410,5585.9,2022-09-11T07:06:07,Barcelona,expenses,children,-410.9490000000002,-18410.19
buyer_4,Marc,Andreu,1974-05-23,52965688T,marc.andreu@coolcloud.app,939777,ES43209578608750974410,5585.9,2022-09-14T04:28:18,Barcelona,expenses,food,-101.99,-18512.18
buyer_4,Marc,Andreu,1974-05-23,52965688T,marc.andreu@coolcloud.app,939777,ES43209578608750974410,5585.9,2022-09-14T00:38:22,Barcelona,expenses,transport,-82.41,-18594.59
buyer_4,Marc,Andreu,1974-05-23,52965688T,marc.andreu@coolcloud.app,939777,ES43209578608750974410,5585.9,2022-09-15T11:09:48,Barcelona,expenses,cash,-100.0,-18694.59
buyer_4,Marc,Andreu,1974-05-23,52965688T,marc.andreu@coolcloud.app,939777,ES43209578608750974410,5585.9,2022-09-16T09:30:40,Barcelona,expenses,appliances,-270.57,-18965.16
buyer_4,Marc,Andreu,1974-05-23,52965688T,marc.andreu@coolcloud.app,939777,ES43209578608750974410,5585.9,2022-09-16T15:33:31,Barcelona,expenses,repairs,-192.28,-19157.44
buyer_4,Marc,Andreu,1974-05-23,52965688T,marc.andreu@coolcloud.app,939777,ES43209578608750974410,5585.9,2022-09-18T15:58:21,Barcelona,expenses,transport,-71.09,-19228.53
buyer_4,Marc,Andreu,1974-05-23,52965688T,marc.andreu@coolcloud.app,939777,ES43209578608750974410,5585.9,2022-09-18T12:47:32,Barcelona,expenses,leisure,-37.16,-19265.69
buyer_4,Marc,Andreu,1974-05-23,52965688T,marc.andreu@coolcloud.app,939777,ES43209578608750974410,5585.9,2022-09-18T22:25:33,Barcelona,expenses,clothing,-157.08,-19422.77
buyer_4,Marc,Andreu,1974-05-23,52965688T,marc.andreu@coolcloud.app,939777,ES43209578608750974410,5585.9,2022-09-19T16:23:31,Barcelona,expenses,transport,-74.37,-19497.14
buyer_4,Marc,Andreu,1974-05-23,52965688T,marc.andreu@coolcloud.app,939777,ES43209578608750974410,5585.9,2022-09-21T11:54:59,Barcelona,expenses,cash,-100.0,-19597.14
buyer_4,Marc,Andreu,1974-05-23,52965688T,marc.andreu@coolcloud.app,939777,ES43209578608750974410,5585.9,2022-09-22T18:50:33,Barcelona,expenses,transport,-67.5,-19664.64
buyer_4,Marc,Andreu,1974-05-23,52965688T,marc.andreu@coolcloud.app,939777,ES43209578608750974410,5585.9,2022-09-22T10:16:22,Barcelona,expenses,education,-62.35,-19726.99
buyer_4,Marc,Andreu,1974-05-23,52965688T,marc.andreu@coolcloud.app,939777,ES43209578608750974410,5585.9,2022-09-23T12:54:04,Barcelona,expenses,leisure,-53.8,-19780.79
buyer_4,Marc,Andreu,1974-05-23,52965688T,marc.andreu@coolcloud.app,939777,ES43209578608750974410,5585.9,2022-09-24T08:12:32,Barcelona,expenses,clothing,-98.23,-19879.02
buyer_4,Marc,Andreu,1974-05-23,52965688T,marc.andreu@coolcloud.app,939777,ES43209578608750974410,5585.9,2022-09-25T19:39:50,Barcelona,expenses,clothing,-47.74,-19926.76
buyer_4,Marc,Andreu,1974-05-23,52965688T,marc.andreu@coolcloud.app,939777,ES43209578608750974410,5585.9,2022-09-27T19:55:29,Barcelona,expenses,repairs,-278.73,-20205.49
buyer_4,Marc,Andreu,1974-05-23,52965688T,marc.andreu@coolcloud.app,939777,ES43209578608750974410,5585.9,2022-09-28T16:56:28,Barcelona,expenses,food,-90.04,-20295.53
buyer_4,Marc,Andreu,1974-05-23,52965688T,marc.andreu@coolcloud.app,939777,ES43209578608750974410,5585.9,2022-09-28T10:35:29,Barcelona,expenses,cash,-100.0,-20395.53
buyer_4,Marc,Andreu,1974-05-23,52965688T,marc.andreu@coolcloud.app,939777,ES43209578608750974410,5585.9,2022-09-29T14:00:23,Barcelona,expenses,food,-95.23,-20490.76
buyer_4,Marc,Andreu,1974-05-23,52965688T,marc.andreu@coolcloud.app,939777,ES43209578608750974410,5585.9,2022-09-29T09:14:46,Barcelona,expenses,leisure,-33.51,-20524.27
buyer_4,Marc,Andreu,1974-05-23,52965688T,marc.andreu@coolcloud.app,939777,ES43209578608750974410,5585.9,2022-09-30T10:58:40,Barcelona,expenses,leisure,-59.85,-20584.12
buyer_4,Marc,Andreu,1974-05-23,52965688T,marc.andreu@coolcloud.app,939777,ES43209578608750974410,5585.9,2022-10-01T11:06:10,Barcelona,incomes,salary,1278.93,-19305.19
buyer_4,Marc,Andreu,1974-05-23,52965688T,marc.andreu@coolcloud.app,939777,ES43209578608750974410,5585.9,2022-10-01T14:32:45,Barcelona,expenses,transport,-57.75,-19362.94
buyer_4,Marc,Andreu,1974-05-23,52965688T,marc.andreu@coolcloud.app,939777,ES43209578608750974410,5585.9,2022-10-01T13:07:41,Barcelona,expenses,clothing,-94.93,-19457.87
buyer_4,Marc,Andreu,1974-05-23,52965688T,marc.andreu@coolcloud.app,939777,ES43209578608750974410,5585.9,2022-10-03T11:38:36,Barcelona,expenses,leisure,-56.18,-19514.05
buyer_4,Marc,Andreu,1974-05-23,52965688T,marc.andreu@coolcloud.app,939777,ES43209578608750974410,5585.9,2022-10-04T18:39:36,Barcelona,expenses,education,-64.57,-19578.62
buyer_4,Marc,Andreu,1974-05-23,52965688T,marc.andreu@coolcloud.app,939777,ES43209578608750974410,5585.9,2022-10-05T15:44:58,Barcelona,expenses,mortgage,-477.68,-20056.3
buyer_4,Marc,Andreu,1974-05-23,52965688T,marc.andreu@coolcloud.app,939777,ES43209578608750974410,5585.9,2022-10-05T09:37:11,Barcelona,expenses,gas,-53.87,-20110.17
buyer_4,Marc,Andreu,1974-05-23,52965688T,marc.andreu@coolcloud.app,939777,ES43209578608750974410,5585.9,2022-10-05T04:53:38,Barcelona,expenses,food,-84.25,-20194.42
buyer_4,Marc,Andreu,1974-05-23,52965688T,marc.andreu@coolcloud.app,939777,ES43209578608750974410,5585.9,2022-10-05T11:58:01,Barcelona,expenses,education,-73.21,-20267.63
buyer_4,Marc,Andreu,1974-05-23,52965688T,marc.andreu@coolcloud.app,939777,ES43209578608750974410,5585.9,2022-10-07T11:29:51,Barcelona,expenses,water,-14.62,-20282.25
buyer_4,Marc,Andreu,1974-05-23,52965688T,marc.andreu@coolcloud.app,939777,ES43209578608750974410,5585.9,2022-10-07T00:23:38,Barcelona,expenses,gas,-71.75,-20354.0
buyer_4,Marc,Andreu,1974-05-23,52965688T,marc.andreu@coolcloud.app,939777,ES43209578608750974410,5585.9,2022-10-07T11:02:44,Barcelona,expenses,internet,-26.86,-20380.86
buyer_4,Marc,Andreu,1974-05-23,52965688T,marc.andreu@coolcloud.app,939777,ES43209578608750974410,5585.9,2022-10-07T12:44:13,Barcelona,expenses,food,-119.5,-20500.36
buyer_4,Marc,Andreu,1974-05-23,52965688T,marc.andreu@coolcloud.app,939777,ES43209578608750974410,5585.9,2022-10-07T17:44:07,Barcelona,expenses,cash,-100.0,-20600.36
buyer_4,Marc,Andreu,1974-05-23,52965688T,marc.andreu@coolcloud.app,939777,ES43209578608750974410,5585.9,2022-10-08T16:41:49,Barcelona,expenses,food,-91.49,-20691.85
buyer_4,Marc,Andreu,1974-05-23,52965688T,marc.andreu@coolcloud.app,939777,ES43209578608750974410,5585.9,2022-10-08T14:34:39,Barcelona,expenses,cash,-100.0,-20791.85
buyer_4,Marc,Andreu,1974-05-23,52965688T,marc.andreu@coolcloud.app,939777,ES43209578608750974410,5585.9,2022-10-11T15:29:28,Barcelona,expenses,education,-70.42,-20862.27
buyer_4,Marc,Andreu,1974-05-23,52965688T,marc.andreu@coolcloud.app,939777,ES43209578608750974410,5585.9,2022-10-11T13:09:11,Barcelona,expenses,cash,-100.0,-20962.27
buyer_4,Marc,Andreu,1974-05-23,52965688T,marc.andreu@coolcloud.app,939777,ES43209578608750974410,5585.9,2022-10-12T19:20:53,Barcelona,expenses,transport,-80.61,-21042.88
buyer_4,Marc,Andreu,1974-05-23,52965688T,marc.andreu@coolcloud.app,939777,ES43209578608750974410,5585.9,2022-10-12T13:23:42,Barcelona,expenses,leisure,-34.69,-21077.57
buyer_4,Marc,Andreu,1974-05-23,52965688T,marc.andreu@coolcloud.app,939777,ES43209578608750974410,5585.9,2022-10-12T05:57:14,Barcelona,expenses,cash,-100.0,-21177.57
buyer_4,Marc,Andreu,1974-05-23,52965688T,marc.andreu@coolcloud.app,939777,ES43209578608750974410,5585.9,2022-10-15T19:29:54,Barcelona,expenses,cash,-100.0,-21277.57
buyer_4,Marc,Andreu,1974-05-23,52965688T,marc.andreu@coolcloud.app,939777,ES43209578608750974410,5585.9,2022-10-15T23:11:48,Barcelona,expenses,appliances,-325.19,-21602.76
buyer_4,Marc,Andreu,1974-05-23,52965688T,marc.andreu@coolcloud.app,939777,ES43209578608750974410,5585.9,2022-10-16T13:37:03,Barcelona,expenses,gifts,-587.96,-22190.72
buyer_4,Marc,Andreu,1974-05-23,52965688T,marc.andreu@coolcloud.app,939777,ES43209578608750974410,5585.9,2022-10-17T21:04:48,Barcelona,expenses,appliances,-183.29,-22374.01
buyer_4,Marc,Andreu,1974-05-23,52965688T,marc.andreu@coolcloud.app,939777,ES43209578608750974410,5585.9,2022-10-18T12:37:01,Barcelona,expenses,transport,-78.88,-22452.89
buyer_4,Marc,Andreu,1974-05-23,52965688T,marc.andreu@coolcloud.app,939777,ES43209578608750974410,5585.9,2022-10-18T11:31:32,Barcelona,expenses,leisure,-41.93,-22494.82
buyer_4,Marc,Andreu,1974-05-23,52965688T,marc.andreu@coolcloud.app,939777,ES43209578608750974410,5585.9,2022-10-21T15:02:19,Barcelona,expenses,repairs,-130.2,-22625.02
buyer_4,Marc,Andreu,1974-05-23,52965688T,marc.andreu@coolcloud.app,939777,ES43209578608750974410,5585.9,2022-10-22T21:45:18,Barcelona,expenses,leisure,-21.39,-22646.41
buyer_4,Marc,Andreu,1974-05-23,52965688T,marc.andreu@coolcloud.app,939777,ES43209578608750974410,5585.9,2022-10-23T11:47:19,Barcelona,expenses,healthcare,-123.54,-22769.95
buyer_4,Marc,Andreu,1974-05-23,52965688T,marc.andreu@coolcloud.app,939777,ES43209578608750974410,5585.9,2022-10-23T23:53:53,Barcelona,expenses,cash,-100.0,-22869.95
buyer_4,Marc,Andreu,1974-05-23,52965688T,marc.andreu@coolcloud.app,939777,ES43209578608750974410,5585.9,2022-10-24T11:53:18,Barcelona,expenses,clothing,-74.77,-22944.72
buyer_4,Marc,Andreu,1974-05-23,52965688T,marc.andreu@coolcloud.app,939777,ES43209578608750974410,5585.9,2022-10-24T09:57:55,Barcelona,expenses,repairs,-286.92,-23231.64
buyer_4,Marc,Andreu,1974-05-23,52965688T,marc.andreu@coolcloud.app,939777,ES43209578608750974410,5585.9,2022-10-25T21:58:06,Barcelona,expenses,gifts,-462.87,-23694.51
buyer_4,Marc,Andreu,1974-05-23,52965688T,marc.andreu@coolcloud.app,939777,ES43209578608750974410,5585.9,2022-10-28T16:14:58,Barcelona,expenses,food,-98.74,-23793.25
buyer_4,Marc,Andreu,1974-05-23,52965688T,marc.andreu@coolcloud.app,939777,ES43209578608750974410,5585.9,2022-11-01T14:16:42,Barcelona,incomes,salary,1278.93,-22514.32
buyer_4,Marc,Andreu,1974-05-23,52965688T,marc.andreu@coolcloud.app,939777,ES43209578608750974410,5585.9,2022-11-01T14:16:42,Barcelona,incomes,extra_income,171.57,-22342.75
buyer_4,Marc,Andreu,1974-05-23,52965688T,marc.andreu@coolcloud.app,939777,ES43209578608750974410,5585.9,2022-11-03T03:23:40,Barcelona,expenses,leisure,-37.36,-22380.11
buyer_4,Marc,Andreu,1974-05-23,52965688T,marc.andreu@coolcloud.app,939777,ES43209578608750974410,5585.9,2022-11-03T22:45:47,Barcelona,expenses,cash,-100.0,-22480.11
buyer_4,Marc,Andreu,1974-05-23,52965688T,marc.andreu@coolcloud.app,939777,ES43209578608750974410,5585.9,2022-11-03T15:01:04,Barcelona,expenses,repairs,-70.52,-22550.63
buyer_4,Marc,Andreu,1974-05-23,52965688T,marc.andreu@coolcloud.app,939777,ES43209578608750974410,5585.9,2022-11-05T12:28:32,Barcelona,expenses,mortgage,-477.68,-23028.31
buyer_4,Marc,Andreu,1974-05-23,52965688T,marc.andreu@coolcloud.app,939777,ES43209578608750974410,5585.9,2022-11-05T16:11:59,Barcelona,expenses,electricity,-36.9,-23065.21
buyer_4,Marc,Andreu,1974-05-23,52965688T,marc.andreu@coolcloud.app,939777,ES43209578608750974410,5585.9,2022-11-05T10:36:08,Barcelona,expenses,appliances,-416.6,-23481.81
buyer_4,Marc,Andreu,1974-05-23,52965688T,marc.andreu@coolcloud.app,939777,ES43209578608750974410,5585.9,2022-11-05T17:06:28,Barcelona,expenses,gifts,-135.9,-23617.71
buyer_4,Marc,Andreu,1974-05-23,52965688T,marc.andreu@coolcloud.app,939777,ES43209578608750974410,5585.9,2022-11-06T13:39:41,Barcelona,expenses,water,-27.97,-23645.68
buyer_4,Marc,Andreu,1974-05-23,52965688T,marc.andreu@coolcloud.app,939777,ES43209578608750974410,5585.9,2022-11-06T09:23:46,Barcelona,expenses,gas,-28.89,-23674.57
buyer_4,Marc,Andreu,1974-05-23,52965688T,marc.andreu@coolcloud.app,939777,ES43209578608750974410,5585.9,2022-11-07T19:44:11,Barcelona,expenses,repairs,-286.18,-23960.75
buyer_4,Marc,Andreu,1974-05-23,52965688T,marc.andreu@coolcloud.app,939777,ES43209578608750974410,5585.9,2022-11-08T18:10:00,Barcelona,expenses,water,-27.24,-23987.99
buyer_4,Marc,Andreu,1974-05-23,52965688T,marc.andreu@coolcloud.app,939777,ES43209578608750974410,5585.9,2022-11-08T20:04:54,Barcelona,expenses,electricity,-49.79,-24037.78
buyer_4,Marc,Andreu,1974-05-23,52965688T,marc.andreu@coolcloud.app,939777,ES43209578608750974410,5585.9,2022-11-09T08:06:27,Barcelona,expenses,food,-92.61,-24130.39
buyer_4,Marc,Andreu,1974-05-23,52965688T,marc.andreu@coolcloud.app,939777,ES43209578608750974410,5585.9,2022-11-09T14:05:41,Barcelona,expenses,cash,-100.0,-24230.39
buyer_4,Marc,Andreu,1974-05-23,52965688T,marc.andreu@coolcloud.app,939777,ES43209578608750974410,5585.9,2022-11-12T23:52:29,Barcelona,expenses,healthcare,-145.87,-24376.26
buyer_4,Marc,Andreu,1974-05-23,52965688T,marc.andreu@coolcloud.app,939777,ES43209578608750974410,5585.9,2022-11-14T16:00:24,Barcelona,expenses,education,-78.53,-24454.79
buyer_4,Marc,Andreu,1974-05-23,52965688T,marc.andreu@coolcloud.app,939777,ES43209578608750974410,5585.9,2022-11-14T08:09:01,Barcelona,expenses,repairs,-92.09,-24546.88
buyer_4,Marc,Andreu,1974-05-23,52965688T,marc.andreu@coolcloud.app,939777,ES43209578608750974410,5585.9,2022-11-16T13:43:46,Barcelona,expenses,cash,-100.0,-24646.88
buyer_4,Marc,Andreu,1974-05-23,52965688T,marc.andreu@coolcloud.app,939777,ES43209578608750974410,5585.9,2022-11-17T10:16:48,Barcelona,expenses,food,-82.65,-24729.53
buyer_4,Marc,Andreu,1974-05-23,52965688T,marc.andreu@coolcloud.app,939777,ES43209578608750974410,5585.9,2022-11-19T03:02:54,Barcelona,expenses,transport,-89.6,-24819.13
buyer_4,Marc,Andreu,1974-05-23,52965688T,marc.andreu@coolcloud.app,939777,ES43209578608750974410,5585.9,2022-11-19T12:52:12,Barcelona,expenses,education,-68.07,-24887.2
buyer_4,Marc,Andreu,1974-05-23,52965688T,marc.andreu@coolcloud.app,939777,ES43209578608750974410,5585.9,2022-11-19T12:28:50,Barcelona,expenses,children,-431.36900000000026,-25318.57
buyer_4,Marc,Andreu,1974-05-23,52965688T,marc.andreu@coolcloud.app,939777,ES43209578608750974410,5585.9,2022-11-21T17:32:24,Barcelona,expenses,food,-66.34,-25384.91
buyer_4,Marc,Andreu,1974-05-23,52965688T,marc.andreu@coolcloud.app,939777,ES43209578608750974410,5585.9,2022-11-21T17:36:41,Barcelona,expenses,transport,-65.85,-25450.76
buyer_4,Marc,Andreu,1974-05-23,52965688T,marc.andreu@coolcloud.app,939777,ES43209578608750974410,5585.9,2022-11-22T11:27:43,Barcelona,expenses,cash,-100.0,-25550.76
buyer_4,Marc,Andreu,1974-05-23,52965688T,marc.andreu@coolcloud.app,939777,ES43209578608750974410,5585.9,2022-11-23T20:06:53,Barcelona,expenses,children,-213.07,-25763.83
buyer_4,Marc,Andreu,1974-05-23,52965688T,marc.andreu@coolcloud.app,939777,ES43209578608750974410,5585.9,2022-11-25T16:29:55,Barcelona,expenses,leisure,-27.24,-25791.07
buyer_4,Marc,Andreu,1974-05-23,52965688T,marc.andreu@coolcloud.app,939777,ES43209578608750974410,5585.9,2022-11-26T22:03:58,Barcelona,expenses,education,-47.84,-25838.91
buyer_4,Marc,Andreu,1974-05-23,52965688T,marc.andreu@coolcloud.app,939777,ES43209578608750974410,5585.9,2022-11-27T08:37:00,Barcelona,expenses,appliances,-284.1,-26123.01
buyer_4,Marc,Andreu,1974-05-23,52965688T,marc.andreu@coolcloud.app,939777,ES43209578608750974410,5585.9,2022-11-27T12:32:06,Barcelona,expenses,gifts,-181.97,-26304.98
buyer_4,Marc,Andreu,1974-05-23,52965688T,marc.andreu@coolcloud.app,939777,ES43209578608750974410,5585.9,2022-11-28T13:38:35,Barcelona,expenses,food,-93.05,-26398.03
buyer_4,Marc,Andreu,1974-05-23,52965688T,marc.andreu@coolcloud.app,939777,ES43209578608750974410,5585.9,2022-11-28T09:39:52,Barcelona,expenses,education,-71.9,-26469.93
buyer_4,Marc,Andreu,1974-05-23,52965688T,marc.andreu@coolcloud.app,939777,ES43209578608750974410,5585.9,2022-11-29T18:30:33,Barcelona,expenses,transport,-49.09,-26519.02
buyer_4,Marc,Andreu,1974-05-23,52965688T,marc.andreu@coolcloud.app,939777,ES43209578608750974410,5585.9,2022-12-01T13:32:59,Barcelona,incomes,salary,1278.93,-25240.09
buyer_4,Marc,Andreu,1974-05-23,52965688T,marc.andreu@coolcloud.app,939777,ES43209578608750974410,5585.9,2022-12-01T13:32:59,Barcelona,incomes,salary_bonus,912.71,-24327.38
buyer_4,Marc,Andreu,1974-05-23,52965688T,marc.andreu@coolcloud.app,939777,ES43209578608750974410,5585.9,2022-12-04T16:35:18,Barcelona,expenses,cash,-100.0,-24427.38
buyer_4,Marc,Andreu,1974-05-23,52965688T,marc.andreu@coolcloud.app,939777,ES43209578608750974410,5585.9,2022-12-05T01:18:41,Barcelona,expenses,mortgage,-477.68,-24905.06
buyer_4,Marc,Andreu,1974-05-23,52965688T,marc.andreu@coolcloud.app,939777,ES43209578608750974410,5585.9,2022-12-05T01:33:35,Barcelona,expenses,gas,-36.82,-24941.88
buyer_4,Marc,Andreu,1974-05-23,52965688T,marc.andreu@coolcloud.app,939777,ES43209578608750974410,5585.9,2022-12-05T19:48:33,Barcelona,expenses,leisure,-77.28,-25019.16
buyer_4,Marc,Andreu,1974-05-23,52965688T,marc.andreu@coolcloud.app,939777,ES43209578608750974410,5585.9,2022-12-05T13:26:56,Barcelona,expenses,education,-54.76,-25073.92
buyer_4,Marc,Andreu,1974-05-23,52965688T,marc.andreu@coolcloud.app,939777,ES43209578608750974410,5585.9,2022-12-06T08:34:50,Barcelona,expenses,repairs,-177.32,-25251.24
buyer_4,Marc,Andreu,1974-05-23,52965688T,marc.andreu@coolcloud.app,939777,ES43209578608750974410,5585.9,2022-12-07T18:27:12,Barcelona,expenses,water,-26.42,-25277.66
buyer_4,Marc,Andreu,1974-05-23,52965688T,marc.andreu@coolcloud.app,939777,ES43209578608750974410,5585.9,2022-12-07T19:09:43,Barcelona,expenses,internet,-26.86,-25304.52
buyer_4,Marc,Andreu,1974-05-23,52965688T,marc.andreu@coolcloud.app,939777,ES43209578608750974410,5585.9,2022-12-07T17:56:30,Barcelona,expenses,gifts,-240.3,-25544.82
buyer_4,Marc,Andreu,1974-05-23,52965688T,marc.andreu@coolcloud.app,939777,ES43209578608750974410,5585.9,2022-12-08T19:43:03,Barcelona,expenses,water,-28.18,-25573.0
buyer_4,Marc,Andreu,1974-05-23,52965688T,marc.andreu@coolcloud.app,939777,ES43209578608750974410,5585.9,2022-12-08T20:23:55,Barcelona,expenses,electricity,-30.95,-25603.95
buyer_4,Marc,Andreu,1974-05-23,52965688T,marc.andreu@coolcloud.app,939777,ES43209578608750974410,5585.9,2022-12-08T12:41:03,Barcelona,expenses,cash,-100.0,-25703.95
buyer_4,Marc,Andreu,1974-05-23,52965688T,marc.andreu@coolcloud.app,939777,ES43209578608750974410,5585.9,2022-12-08T04:44:19,Barcelona,expenses,repairs,-250.5,-25954.45
buyer_4,Marc,Andreu,1974-05-23,52965688T,marc.andreu@coolcloud.app,939777,ES43209578608750974410,5585.9,2022-12-13T09:22:50,Barcelona,expenses,transport,-84.27,-26038.72
buyer_4,Marc,Andreu,1974-05-23,52965688T,marc.andreu@coolcloud.app,939777,ES43209578608750974410,5585.9,2022-12-13T13:18:26,Barcelona,expenses,repairs,-327.84,-26366.56
buyer_4,Marc,Andreu,1974-05-23,52965688T,marc.andreu@coolcloud.app,939777,ES43209578608750974410,5585.9,2022-12-14T18:31:22,Barcelona,expenses,food,-98.76,-26465.32
buyer_4,Marc,Andreu,1974-05-23,52965688T,marc.andreu@coolcloud.app,939777,ES43209578608750974410,5585.9,2022-12-14T18:46:56,Barcelona,expenses,cash,-100.0,-26565.32
buyer_4,Marc,Andreu,1974-05-23,52965688T,marc.andreu@coolcloud.app,939777,ES43209578608750974410,5585.9,2022-12-16T12:04:17,Barcelona,expenses,transport,-89.38,-26654.7
buyer_4,Marc,Andreu,1974-05-23,52965688T,marc.andreu@coolcloud.app,939777,ES43209578608750974410,5585.9,2022-12-16T18:09:35,Barcelona,expenses,leisure,-24.24,-26678.94
buyer_4,Marc,Andreu,1974-05-23,52965688T,marc.andreu@coolcloud.app,939777,ES43209578608750974410,5585.9,2022-12-20T09:30:11,Barcelona,expenses,leisure,-67.8,-26746.74
buyer_4,Marc,Andreu,1974-05-23,52965688T,marc.andreu@coolcloud.app,939777,ES43209578608750974410,5585.9,2022-12-20T12:01:11,Barcelona,expenses,cash,-100.0,-26846.74
buyer_4,Marc,Andreu,1974-05-23,52965688T,marc.andreu@coolcloud.app,939777,ES43209578608750974410,5585.9,2022-12-21T15:31:51,Barcelona,expenses,transport,-84.42,-26931.16
buyer_4,Marc,Andreu,1974-05-23,52965688T,marc.andreu@coolcloud.app,939777,ES43209578608750974410,5585.9,2022-12-21T20:55:38,Barcelona,expenses,cash,-100.0,-27031.16
buyer_4,Marc,Andreu,1974-05-23,52965688T,marc.andreu@coolcloud.app,939777,ES43209578608750974410,5585.9,2022-12-22T13:16:51,Barcelona,expenses,clothing,-118.56,-27149.72
buyer_4,Marc,Andreu,1974-05-23,52965688T,marc.andreu@coolcloud.app,939777,ES43209578608750974410,5585.9,2022-12-25T17:14:40,Barcelona,expenses,food,-98.96,-27248.68
buyer_4,Marc,Andreu,1974-05-23,52965688T,marc.andreu@coolcloud.app,939777,ES43209578608750974410,5585.9,2022-12-25T12:48:42,Barcelona,expenses,children,-490.07900000000024,-27738.76
buyer_4,Marc,Andreu,1974-05-23,52965688T,marc.andreu@coolcloud.app,939777,ES43209578608750974410,5585.9,2022-12-31T01:50:52,Barcelona,expenses,cash,-100.0,-27838.76
buyer_4,Marc,Andreu,1974-05-23,52965688T,marc.andreu@coolcloud.app,939777,ES43209578608750974410,5585.9,2023-01-01T21:06:35,Barcelona,incomes,salary,1318.43,-26520.33
buyer_4,Marc,Andreu,1974-05-23,52965688T,marc.andreu@coolcloud.app,939777,ES43209578608750974410,5585.9,2023-01-01T08:59:04,Barcelona,expenses,cash,-100.0,-26620.33
buyer_4,Marc,Andreu,1974-05-23,52965688T,marc.andreu@coolcloud.app,939777,ES43209578608750974410,5585.9,2023-01-02T14:53:50,Barcelona,expenses,repairs,-102.1,-26722.43
buyer_4,Marc,Andreu,1974-05-23,52965688T,marc.andreu@coolcloud.app,939777,ES43209578608750974410,5585.9,2023-01-05T23:02:05,Barcelona,expenses,mortgage,-634.0,-27356.43
buyer_4,Marc,Andreu,1974-05-23,52965688T,marc.andreu@coolcloud.app,939777,ES43209578608750974410,5585.9,2023-01-05T12:11:02,Barcelona,expenses,electricity,-27.65,-27384.08
buyer_4,Marc,Andreu,1974-05-23,52965688T,marc.andreu@coolcloud.app,939777,ES43209578608750974410,5585.9,2023-01-05T11:07:06,Barcelona,expenses,transport,-56.25,-27440.33
buyer_4,Marc,Andreu,1974-05-23,52965688T,marc.andreu@coolcloud.app,939777,ES43209578608750974410,5585.9,2023-01-05T09:56:54,Barcelona,expenses,clothing,-78.12,-27518.45
buyer_4,Marc,Andreu,1974-05-23,52965688T,marc.andreu@coolcloud.app,939777,ES43209578608750974410,5585.9,2023-01-06T10:11:47,Barcelona,expenses,electricity,-30.67,-27549.12
buyer_4,Marc,Andreu,1974-05-23,52965688T,marc.andreu@coolcloud.app,939777,ES43209578608750974410,5585.9,2023-01-06T15:53:35,Barcelona,expenses,clothing,-95.61,-27644.73
buyer_4,Marc,Andreu,1974-05-23,52965688T,marc.andreu@coolcloud.app,939777,ES43209578608750974410,5585.9,2023-01-07T23:37:24,Barcelona,expenses,water,-21.54,-27666.27
buyer_4,Marc,Andreu,1974-05-23,52965688T,marc.andreu@coolcloud.app,939777,ES43209578608750974410,5585.9,2023-01-07T15:41:13,Barcelona,expenses,electricity,-15.28,-27681.55
buyer_4,Marc,Andreu,1974-05-23,52965688T,marc.andreu@coolcloud.app,939777,ES43209578608750974410,5585.9,2023-01-08T18:25:29,Barcelona,expenses,phone,-25.27,-27706.82
buyer_4,Marc,Andreu,1974-05-23,52965688T,marc.andreu@coolcloud.app,939777,ES43209578608750974410,5585.9,2023-01-09T03:36:04,Barcelona,expenses,food,-119.46,-27826.28
buyer_4,Marc,Andreu,1974-05-23,52965688T,marc.andreu@coolcloud.app,939777,ES43209578608750974410,5585.9,2023-01-11T12:48:54,Barcelona,expenses,appliances,-389.19,-28215.47
buyer_4,Marc,Andreu,1974-05-23,52965688T,marc.andreu@coolcloud.app,939777,ES43209578608750974410,5585.9,2023-01-13T14:43:52,Barcelona,expenses,cash,-100.0,-28315.47
buyer_4,Marc,Andreu,1974-05-23,52965688T,marc.andreu@coolcloud.app,939777,ES43209578608750974410,5585.9,2023-01-13T23:47:56,Barcelona,expenses,repairs,-127.51,-28442.98
buyer_4,Marc,Andreu,1974-05-23,52965688T,marc.andreu@coolcloud.app,939777,ES43209578608750974410,5585.9,2023-01-14T16:43:36,Barcelona,expenses,food,-104.25,-28547.23
buyer_4,Marc,Andreu,1974-05-23,52965688T,marc.andreu@coolcloud.app,939777,ES43209578608750974410,5585.9,2023-01-15T09:16:04,Barcelona,expenses,repairs,-300.56,-28847.79
buyer_4,Marc,Andreu,1974-05-23,52965688T,marc.andreu@coolcloud.app,939777,ES43209578608750974410,5585.9,2023-01-17T09:00:05,Barcelona,expenses,cash,-100.0,-28947.79
buyer_4,Marc,Andreu,1974-05-23,52965688T,marc.andreu@coolcloud.app,939777,ES43209578608750974410,5585.9,2023-01-18T20:54:01,Barcelona,expenses,food,-69.47,-29017.26
buyer_4,Marc,Andreu,1974-05-23,52965688T,marc.andreu@coolcloud.app,939777,ES43209578608750974410,5585.9,2023-01-18T15:09:20,Barcelona,expenses,education,-45.91,-29063.17
buyer_4,Marc,Andreu,1974-05-23,52965688T,marc.andreu@coolcloud.app,939777,ES43209578608750974410,5585.9,2023-01-19T08:13:49,Barcelona,expenses,clothing,-149.8,-29212.97
buyer_4,Marc,Andreu,1974-05-23,52965688T,marc.andreu@coolcloud.app,939777,ES43209578608750974410,5585.9,2023-01-19T19:36:26,Barcelona,expenses,education,-45.09,-29258.06
buyer_4,Marc,Andreu,1974-05-23,52965688T,marc.andreu@coolcloud.app,939777,ES43209578608750974410,5585.9,2023-01-20T08:13:14,Barcelona,expenses,healthcare,-82.55,-29340.61
buyer_4,Marc,Andreu,1974-05-23,52965688T,marc.andreu@coolcloud.app,939777,ES43209578608750974410,5585.9,2023-01-21T11:20:32,Barcelona,expenses,clothing,-120.17,-29460.78
buyer_4,Marc,Andreu,1974-05-23,52965688T,marc.andreu@coolcloud.app,939777,ES43209578608750974410,5585.9,2023-01-22T10:46:47,Barcelona,expenses,leisure,-22.76,-29483.54
buyer_4,Marc,Andreu,1974-05-23,52965688T,marc.andreu@coolcloud.app,939777,ES43209578608750974410,5585.9,2023-01-22T14:42:18,Barcelona,expenses,clothing,-128.9,-29612.44
buyer_4,Marc,Andreu,1974-05-23,52965688T,marc.andreu@coolcloud.app,939777,ES43209578608750974410,5585.9,2023-01-23T20:54:56,Barcelona,expenses,food,-75.03,-29687.47
buyer_4,Marc,Andreu,1974-05-23,52965688T,marc.andreu@coolcloud.app,939777,ES43209578608750974410,5585.9,2023-01-23T16:59:13,Barcelona,expenses,leisure,-68.14,-29755.61
buyer_4,Marc,Andreu,1974-05-23,52965688T,marc.andreu@coolcloud.app,939777,ES43209578608750974410,5585.9,2023-01-25T09:44:53,Barcelona,expenses,transport,-67.29,-29822.9
buyer_4,Marc,Andreu,1974-05-23,52965688T,marc.andreu@coolcloud.app,939777,ES43209578608750974410,5585.9,2023-01-25T10:02:49,Barcelona,expenses,children,-408.35549999999984,-30231.26
buyer_4,Marc,Andreu,1974-05-23,52965688T,marc.andreu@coolcloud.app,939777,ES43209578608750974410,5585.9,2023-01-26T09:47:30,Barcelona,expenses,transport,-53.43,-30284.69
buyer_4,Marc,Andreu,1974-05-23,52965688T,marc.andreu@coolcloud.app,939777,ES43209578608750974410,5585.9,2023-01-26T19:20:23,Barcelona,expenses,leisure,-21.51,-30306.2
buyer_4,Marc,Andreu,1974-05-23,52965688T,marc.andreu@coolcloud.app,939777,ES43209578608750974410,5585.9,2023-01-30T08:49:39,Barcelona,expenses,leisure,-42.04,-30348.24
buyer_4,Marc,Andreu,1974-05-23,52965688T,marc.andreu@coolcloud.app,939777,ES43209578608750974410,5585.9,2023-01-30T22:25:59,Barcelona,expenses,appliances,-92.91,-30441.15
buyer_4,Marc,Andreu,1974-05-23,52965688T,marc.andreu@coolcloud.app,939777,ES43209578608750974410,5585.9,2023-01-31T04:40:06,Barcelona,expenses,food,-63.69,-30504.84
buyer_4,Marc,Andreu,1974-05-23,52965688T,marc.andreu@coolcloud.app,939777,ES43209578608750974410,5585.9,2023-02-01T17:25:11,Barcelona,incomes,salary,1318.43,-29186.41
buyer_4,Marc,Andreu,1974-05-23,52965688T,marc.andreu@coolcloud.app,939777,ES43209578608750974410,5585.9,2023-02-01T17:25:11,Barcelona,incomes,extra_income,171.57,-29014.84
buyer_4,Marc,Andreu,1974-05-23,52965688T,marc.andreu@coolcloud.app,939777,ES43209578608750974410,5585.9,2023-02-01T03:21:52,Barcelona,expenses,cash,-100.0,-29114.84
buyer_4,Marc,Andreu,1974-05-23,52965688T,marc.andreu@coolcloud.app,939777,ES43209578608750974410,5585.9,2023-02-03T05:41:01,Barcelona,expenses,gifts,-37.29,-29152.13
buyer_4,Marc,Andreu,1974-05-23,52965688T,marc.andreu@coolcloud.app,939777,ES43209578608750974410,5585.9,2023-02-04T12:17:12,Barcelona,expenses,cash,-100.0,-29252.13
buyer_4,Marc,Andreu,1974-05-23,52965688T,marc.andreu@coolcloud.app,939777,ES43209578608750974410,5585.9,2023-02-05T18:23:01,Barcelona,expenses,mortgage,-634.0,-29886.13
buyer_4,Marc,Andreu,1974-05-23,52965688T,marc.andreu@coolcloud.app,939777,ES43209578608750974410,5585.9,2023-02-05T10:19:42,Barcelona,expenses,electricity,-19.19,-29905.32
buyer_4,Marc,Andreu,1974-05-23,52965688T,marc.andreu@coolcloud.app,939777,ES43209578608750974410,5585.9,2023-02-05T17:49:53,Barcelona,expenses,phone,-20.04,-29925.36
buyer_4,Marc,Andreu,1974-05-23,52965688T,marc.andreu@coolcloud.app,939777,ES43209578608750974410,5585.9,2023-02-06T12:25:22,Barcelona,expenses,gas,-46.23,-29971.59
buyer_4,Marc,Andreu,1974-05-23,52965688T,marc.andreu@coolcloud.app,939777,ES43209578608750974410,5585.9,2023-02-06T17:47:21,Barcelona,expenses,transport,-69.68,-30041.27
buyer_4,Marc,Andreu,1974-05-23,52965688T,marc.andreu@coolcloud.app,939777,ES43209578608750974410,5585.9,2023-02-07T10:59:01,Barcelona,expenses,water,-27.04,-30068.31
buyer_4,Marc,Andreu,1974-05-23,52965688T,marc.andreu@coolcloud.app,939777,ES43209578608750974410,5585.9,2023-02-07T19:28:15,Barcelona,expenses,food,-104.97,-30173.28
buyer_4,Marc,Andreu,1974-05-23,52965688T,marc.andreu@coolcloud.app,939777,ES43209578608750974410,5585.9,2023-02-09T20:12:47,Barcelona,expenses,food,-66.54,-30239.82
buyer_4,Marc,Andreu,1974-05-23,52965688T,marc.andreu@coolcloud.app,939777,ES43209578608750974410,5585.9,2023-02-10T15:27:09,Barcelona,expenses,transport,-53.98,-30293.8
buyer_4,Marc,Andreu,1974-05-23,52965688T,marc.andreu@coolcloud.app,939777,ES43209578608750974410,5585.9,2023-02-10T10:58:38,Barcelona,expenses,appliances,-131.46,-30425.26
buyer_4,Marc,Andreu,1974-05-23,52965688T,marc.andreu@coolcloud.app,939777,ES43209578608750974410,5585.9,2023-02-11T01:01:42,Barcelona,expenses,leisure,-20.08,-30445.34
buyer_4,Marc,Andreu,1974-05-23,52965688T,marc.andreu@coolcloud.app,939777,ES43209578608750974410,5585.9,2023-02-12T08:28:48,Barcelona,expenses,food,-120.55,-30565.89
buyer_4,Marc,Andreu,1974-05-23,52965688T,marc.andreu@coolcloud.app,939777,ES43209578608750974410,5585.9,2023-02-13T11:30:58,Barcelona,expenses,clothing,-134.05,-30699.94
buyer_4,Marc,Andreu,1974-05-23,52965688T,marc.andreu@coolcloud.app,939777,ES43209578608750974410,5585.9,2023-02-14T08:29:33,Barcelona,expenses,cash,-100.0,-30799.94
buyer_4,Marc,Andreu,1974-05-23,52965688T,marc.andreu@coolcloud.app,939777,ES43209578608750974410,5585.9,2023-02-14T22:21:24,Barcelona,expenses,gifts,-369.87,-31169.81
buyer_4,Marc,Andreu,1974-05-23,52965688T,marc.andreu@coolcloud.app,939777,ES43209578608750974410,5585.9,2023-02-16T19:35:05,Barcelona,expenses,repairs,-91.74,-31261.55
buyer_4,Marc,Andreu,1974-05-23,52965688T,marc.andreu@coolcloud.app,939777,ES43209578608750974410,5585.9,2023-02-18T17:05:34,Barcelona,expenses,clothing,-56.84,-31318.39
buyer_4,Marc,Andreu,1974-05-23,52965688T,marc.andreu@coolcloud.app,939777,ES43209578608750974410,5585.9,2023-02-20T04:13:24,Barcelona,expenses,food,-86.03,-31404.42
buyer_4,Marc,Andreu,1974-05-23,52965688T,marc.andreu@coolcloud.app,939777,ES43209578608750974410,5585.9,2023-02-20T16:02:54,Barcelona,expenses,cash,-100.0,-31504.42
buyer_4,Marc,Andreu,1974-05-23,52965688T,marc.andreu@coolcloud.app,939777,ES43209578608750974410,5585.9,2023-02-21T12:04:08,Barcelona,expenses,food,-92.1,-31596.52
buyer_4,Marc,Andreu,1974-05-23,52965688T,marc.andreu@coolcloud.app,939777,ES43209578608750974410,5585.9,2023-02-22T08:20:30,Barcelona,expenses,repairs,-296.76,-31893.28
buyer_4,Marc,Andreu,1974-05-23,52965688T,marc.andreu@coolcloud.app,939777,ES43209578608750974410,5585.9,2023-02-26T00:32:38,Barcelona,expenses,repairs,-322.83,-32216.11
buyer_4,Marc,Andreu,1974-05-23,52965688T,marc.andreu@coolcloud.app,939777,ES43209578608750974410,5585.9,2023-02-27T13:15:24,Barcelona,expenses,children,-208.22,-32424.33
buyer_4,Marc,Andreu,1974-05-23,52965688T,marc.andreu@coolcloud.app,939777,ES43209578608750974410,5585.9,2023-02-28T19:45:54,Barcelona,expenses,transport,-52.72,-32477.05
buyer_4,Marc,Andreu,1974-05-23,52965688T,marc.andreu@coolcloud.app,939777,ES43209578608750974410,5585.9,2023-03-01T13:46:29,Barcelona,incomes,salary,1318.43,-31158.62
buyer_4,Marc,Andreu,1974-05-23,52965688T,marc.andreu@coolcloud.app,939777,ES43209578608750974410,5585.9,2023-03-02T16:26:10,Barcelona,expenses,repairs,-216.49,-31375.11
buyer_4,Marc,Andreu,1974-05-23,52965688T,marc.andreu@coolcloud.app,939777,ES43209578608750974410,5585.9,2023-03-04T13:19:12,Barcelona,expenses,transport,-53.04,-31428.15
buyer_4,Marc,Andreu,1974-05-23,52965688T,marc.andreu@coolcloud.app,939777,ES43209578608750974410,5585.9,2023-03-04T21:29:34,Barcelona,expenses,travel,-375.11,-31803.26
buyer_4,Marc,Andreu,1974-05-23,52965688T,marc.andreu@coolcloud.app,939777,ES43209578608750974410,5585.9,2023-03-05T07:45:18,Barcelona,expenses,mortgage,-634.0,-32437.26
buyer_4,Marc,Andreu,1974-05-23,52965688T,marc.andreu@coolcloud.app,939777,ES43209578608750974410,5585.9,2023-03-05T15:20:54,Barcelona,expenses,water,-14.41,-32451.67
buyer_4,Marc,Andreu,1974-05-23,52965688T,marc.andreu@coolcloud.app,939777,ES43209578608750974410,5585.9,2023-03-05T12:53:59,Barcelona,expenses,food,-123.85,-32575.52
buyer_4,Marc,Andreu,1974-05-23,52965688T,marc.andreu@coolcloud.app,939777,ES43209578608750974410,5585.9,2023-03-05T12:19:13,Barcelona,expenses,transport,-79.47,-32654.99
buyer_4,Marc,Andreu,1974-05-23,52965688T,marc.andreu@coolcloud.app,939777,ES43209578608750974410,5585.9,2023-03-06T08:03:43,Barcelona,expenses,phone,-23.48,-32678.47
buyer_4,Marc,Andreu,1974-05-23,52965688T,marc.andreu@coolcloud.app,939777,ES43209578608750974410,5585.9,2023-03-06T18:48:20,Barcelona,expenses,transport,-80.43,-32758.9
buyer_4,Marc,Andreu,1974-05-23,52965688T,marc.andreu@coolcloud.app,939777,ES43209578608750974410,5585.9,2023-03-06T08:57:59,Barcelona,expenses,leisure,-31.6,-32790.5
buyer_4,Marc,Andreu,1974-05-23,52965688T,marc.andreu@coolcloud.app,939777,ES43209578608750974410,5585.9,2023-03-07T17:11:20,Barcelona,expenses,water,-19.49,-32809.99
buyer_4,Marc,Andreu,1974-05-23,52965688T,marc.andreu@coolcloud.app,939777,ES43209578608750974410,5585.9,2023-03-07T15:22:53,Barcelona,expenses,electricity,-51.04,-32861.03
buyer_4,Marc,Andreu,1974-05-23,52965688T,marc.andreu@coolcloud.app,939777,ES43209578608750974410,5585.9,2023-03-08T15:22:17,Barcelona,expenses,water,-17.4,-32878.43
buyer_4,Marc,Andreu,1974-05-23,52965688T,marc.andreu@coolcloud.app,939777,ES43209578608750974410,5585.9,2023-03-08T19:04:42,Barcelona,expenses,electricity,-46.56,-32924.99
buyer_4,Marc,Andreu,1974-05-23,52965688T,marc.andreu@coolcloud.app,939777,ES43209578608750974410,5585.9,2023-03-08T19:18:35,Barcelona,expenses,internet,-27.69,-32952.68
buyer_4,Marc,Andreu,1974-05-23,52965688T,marc.andreu@coolcloud.app,939777,ES43209578608750974410,5585.9,2023-03-08T12:43:36,Barcelona,expenses,clothing,-76.49,-33029.17
buyer_4,Marc,Andreu,1974-05-23,52965688T,marc.andreu@coolcloud.app,939777,ES43209578608750974410,5585.9,2023-03-08T14:09:07,Barcelona,expenses,repairs,-272.06,-33301.23
buyer_4,Marc,Andreu,1974-05-23,52965688T,marc.andreu@coolcloud.app,939777,ES43209578608750974410,5585.9,2023-03-09T15:15:26,Barcelona,expenses,appliances,-220.88,-33522.11
buyer_4,Marc,Andreu,1974-05-23,52965688T,marc.andreu@coolcloud.app,939777,ES43209578608750974410,5585.9,2023-03-10T10:23:35,Barcelona,expenses,cash,-100.0,-33622.11
buyer_4,Marc,Andreu,1974-05-23,52965688T,marc.andreu@coolcloud.app,939777,ES43209578608750974410,5585.9,2023-03-12T11:53:28,Barcelona,expenses,food,-64.97,-33687.08
buyer_4,Marc,Andreu,1974-05-23,52965688T,marc.andreu@coolcloud.app,939777,ES43209578608750974410,5585.9,2023-03-14T06:32:31,Barcelona,expenses,food,-87.73,-33774.81
buyer_4,Marc,Andreu,1974-05-23,52965688T,marc.andreu@coolcloud.app,939777,ES43209578608750974410,5585.9,2023-03-14T21:07:33,Barcelona,expenses,cash,-100.0,-33874.81
buyer_4,Marc,Andreu,1974-05-23,52965688T,marc.andreu@coolcloud.app,939777,ES43209578608750974410,5585.9,2023-03-17T19:44:54,Barcelona,expenses,transport,-81.93,-33956.74
buyer_4,Marc,Andreu,1974-05-23,52965688T,marc.andreu@coolcloud.app,939777,ES43209578608750974410,5585.9,2023-03-17T14:15:55,Barcelona,expenses,cash,-100.0,-34056.74
buyer_4,Marc,Andreu,1974-05-23,52965688T,marc.andreu@coolcloud.app,939777,ES43209578608750974410,5585.9,2023-03-18T17:27:55,Barcelona,expenses,food,-120.97,-34177.71
buyer_4,Marc,Andreu,1974-05-23,52965688T,marc.andreu@coolcloud.app,939777,ES43209578608750974410,5585.9,2023-03-21T09:30:10,Barcelona,expenses,food,-93.63,-34271.34
buyer_4,Marc,Andreu,1974-05-23,52965688T,marc.andreu@coolcloud.app,939777,ES43209578608750974410,5585.9,2023-03-22T09:34:20,Barcelona,expenses,cash,-100.0,-34371.34
buyer_4,Marc,Andreu,1974-05-23,52965688T,marc.andreu@coolcloud.app,939777,ES43209578608750974410,5585.9,2023-03-22T16:32:54,Barcelona,expenses,children,-353.42,-34724.76
buyer_4,Marc,Andreu,1974-05-23,52965688T,marc.andreu@coolcloud.app,939777,ES43209578608750974410,5585.9,2023-03-24T20:50:21,Barcelona,expenses,food,-98.16,-34822.92
buyer_4,Marc,Andreu,1974-05-23,52965688T,marc.andreu@coolcloud.app,939777,ES43209578608750974410,5585.9,2023-03-24T16:28:50,Barcelona,expenses,cash,-100.0,-34922.92
buyer_4,Marc,Andreu,1974-05-23,52965688T,marc.andreu@coolcloud.app,939777,ES43209578608750974410,5585.9,2023-03-25T16:13:24,Barcelona,expenses,leisure,-21.59,-34944.51
buyer_4,Marc,Andreu,1974-05-23,52965688T,marc.andreu@coolcloud.app,939777,ES43209578608750974410,5585.9,2023-03-27T08:33:23,Barcelona,expenses,food,-63.27,-35007.78
buyer_4,Marc,Andreu,1974-05-23,52965688T,marc.andreu@coolcloud.app,939777,ES43209578608750974410,5585.9,2023-03-27T12:00:31,Barcelona,expenses,leisure,-36.42,-35044.2
buyer_4,Marc,Andreu,1974-05-23,52965688T,marc.andreu@coolcloud.app,939777,ES43209578608750974410,5585.9,2023-03-28T00:56:21,Barcelona,expenses,clothing,-130.33,-35174.53
buyer_4,Marc,Andreu,1974-05-23,52965688T,marc.andreu@coolcloud.app,939777,ES43209578608750974410,5585.9,2023-03-28T10:43:21,Barcelona,expenses,cash,-100.0,-35274.53
buyer_4,Marc,Andreu,1974-05-23,52965688T,marc.andreu@coolcloud.app,939777,ES43209578608750974410,5585.9,2023-03-28T10:20:06,Barcelona,expenses,appliances,-221.76,-35496.29
buyer_4,Marc,Andreu,1974-05-23,52965688T,marc.andreu@coolcloud.app,939777,ES43209578608750974410,5585.9,2023-03-29T08:02:41,Barcelona,expenses,food,-66.67,-35562.96
buyer_4,Marc,Andreu,1974-05-23,52965688T,marc.andreu@coolcloud.app,939777,ES43209578608750974410,5585.9,2023-03-29T11:33:08,Barcelona,expenses,repairs,-296.26,-35859.22
buyer_4,Marc,Andreu,1974-05-23,52965688T,marc.andreu@coolcloud.app,939777,ES43209578608750974410,5585.9,2023-03-30T11:51:18,Barcelona,expenses,leisure,-55.17,-35914.39
buyer_4,Marc,Andreu,1974-05-23,52965688T,marc.andreu@coolcloud.app,939777,ES43209578608750974410,5585.9,2023-03-30T18:57:24,Barcelona,expenses,appliances,-417.94,-36332.33
buyer_4,Marc,Andreu,1974-05-23,52965688T,marc.andreu@coolcloud.app,939777,ES43209578608750974410,5585.9,2023-03-31T09:28:46,Barcelona,expenses,food,-74.81,-36407.14
buyer_4,Marc,Andreu,1974-05-23,52965688T,marc.andreu@coolcloud.app,939777,ES43209578608750974410,5585.9,2023-04-01T09:32:26,Barcelona,incomes,salary,1318.43,-35088.71
buyer_4,Marc,Andreu,1974-05-23,52965688T,marc.andreu@coolcloud.app,939777,ES43209578608750974410,5585.9,2023-04-01T11:35:27,Barcelona,expenses,food,-95.63,-35184.34
buyer_4,Marc,Andreu,1974-05-23,52965688T,marc.andreu@coolcloud.app,939777,ES43209578608750974410,5585.9,2023-04-04T18:33:23,Barcelona,expenses,food,-104.29,-35288.63
buyer_4,Marc,Andreu,1974-05-23,52965688T,marc.andreu@coolcloud.app,939777,ES43209578608750974410,5585.9,2023-04-05T15:38:34,Barcelona,expenses,mortgage,-634.0,-35922.63
buyer_4,Marc,Andreu,1974-05-23,52965688T,marc.andreu@coolcloud.app,939777,ES43209578608750974410,5585.9,2023-04-05T10:17:17,Barcelona,expenses,gas,-63.57,-35986.2
buyer_4,Marc,Andreu,1974-05-23,52965688T,marc.andreu@coolcloud.app,939777,ES43209578608750974410,5585.9,2023-04-05T15:41:55,Barcelona,expenses,internet,-27.69,-36013.89
buyer_4,Marc,Andreu,1974-05-23,52965688T,marc.andreu@coolcloud.app,939777,ES43209578608750974410,5585.9,2023-04-05T22:12:15,Barcelona,expenses,phone,-20.33,-36034.22
buyer_4,Marc,Andreu,1974-05-23,52965688T,marc.andreu@coolcloud.app,939777,ES43209578608750974410,5585.9,2023-04-05T14:04:06,Barcelona,expenses,cash,-100.0,-36134.22
buyer_4,Marc,Andreu,1974-05-23,52965688T,marc.andreu@coolcloud.app,939777,ES43209578608750974410,5585.9,2023-04-06T17:44:03,Barcelona,expenses,electricity,-59.27,-36193.49
buyer_4,Marc,Andreu,1974-05-23,52965688T,marc.andreu@coolcloud.app,939777,ES43209578608750974410,5585.9,2023-04-06T19:03:05,Barcelona,expenses,cash,-100.0,-36293.49
buyer_4,Marc,Andreu,1974-05-23,52965688T,marc.andreu@coolcloud.app,939777,ES43209578608750974410,5585.9,2023-04-07T12:17:01,Barcelona,expenses,water,-15.86,-36309.35
buyer_4,Marc,Andreu,1974-05-23,52965688T,marc.andreu@coolcloud.app,939777,ES43209578608750974410,5585.9,2023-04-07T12:38:42,Barcelona,expenses,phone,-27.38,-36336.73
buyer_4,Marc,Andreu,1974-05-23,52965688T,marc.andreu@coolcloud.app,939777,ES43209578608750974410,5585.9,2023-04-07T08:01:42,Barcelona,expenses,cash,-100.0,-36436.73
buyer_4,Marc,Andreu,1974-05-23,52965688T,marc.andreu@coolcloud.app,939777,ES43209578608750974410,5585.9,2023-04-07T10:40:14,Barcelona,expenses,gifts,-133.18,-36569.91
buyer_4,Marc,Andreu,1974-05-23,52965688T,marc.andreu@coolcloud.app,939777,ES43209578608750974410,5585.9,2023-04-08T08:27:24,Barcelona,expenses,internet,-27.69,-36597.6
buyer_4,Marc,Andreu,1974-05-23,52965688T,marc.andreu@coolcloud.app,939777,ES43209578608750974410,5585.9,2023-04-08T17:38:44,Barcelona,expenses,transport,-54.73,-36652.33
buyer_4,Marc,Andreu,1974-05-23,52965688T,marc.andreu@coolcloud.app,939777,ES43209578608750974410,5585.9,2023-04-10T11:11:06,Barcelona,expenses,transport,-61.86,-36714.19
buyer_4,Marc,Andreu,1974-05-23,52965688T,marc.andreu@coolcloud.app,939777,ES43209578608750974410,5585.9,2023-04-12T16:05:56,Barcelona,expenses,food,-124.93,-36839.12
buyer_4,Marc,Andreu,1974-05-23,52965688T,marc.andreu@coolcloud.app,939777,ES43209578608750974410,5585.9,2023-04-13T16:34:49,Barcelona,expenses,cash,-100.0,-36939.12
buyer_4,Marc,Andreu,1974-05-23,52965688T,marc.andreu@coolcloud.app,939777,ES43209578608750974410,5585.9,2023-04-14T08:51:36,Barcelona,expenses,leisure,-80.46,-37019.58
buyer_4,Marc,Andreu,1974-05-23,52965688T,marc.andreu@coolcloud.app,939777,ES43209578608750974410,5585.9,2023-04-15T00:35:32,Barcelona,expenses,food,-103.61,-37123.19
buyer_4,Marc,Andreu,1974-05-23,52965688T,marc.andreu@coolcloud.app,939777,ES43209578608750974410,5585.9,2023-04-15T14:05:59,Barcelona,expenses,cash,-100.0,-37223.19
buyer_4,Marc,Andreu,1974-05-23,52965688T,marc.andreu@coolcloud.app,939777,ES43209578608750974410,5585.9,2023-04-17T08:35:27,Barcelona,expenses,cash,-100.0,-37323.19
buyer_4,Marc,Andreu,1974-05-23,52965688T,marc.andreu@coolcloud.app,939777,ES43209578608750974410,5585.9,2023-04-18T14:04:13,Barcelona,expenses,food,-74.08,-37397.27
buyer_4,Marc,Andreu,1974-05-23,52965688T,marc.andreu@coolcloud.app,939777,ES43209578608750974410,5585.9,2023-04-18T08:47:21,Barcelona,expenses,cash,-100.0,-37497.27
buyer_4,Marc,Andreu,1974-05-23,52965688T,marc.andreu@coolcloud.app,939777,ES43209578608750974410,5585.9,2023-04-19T16:36:19,Barcelona,expenses,transport,-49.36,-37546.63
buyer_4,Marc,Andreu,1974-05-23,52965688T,marc.andreu@coolcloud.app,939777,ES43209578608750974410,5585.9,2023-04-21T08:43:19,Barcelona,expenses,leisure,-41.95,-37588.58
buyer_4,Marc,Andreu,1974-05-23,52965688T,marc.andreu@coolcloud.app,939777,ES43209578608750974410,5585.9,2023-04-21T16:48:46,Barcelona,expenses,appliances,-412.42,-38001.0
buyer_4,Marc,Andreu,1974-05-23,52965688T,marc.andreu@coolcloud.app,939777,ES43209578608750974410,5585.9,2023-04-22T09:27:56,Barcelona,expenses,clothing,-111.15,-38112.15
buyer_4,Marc,Andreu,1974-05-23,52965688T,marc.andreu@coolcloud.app,939777,ES43209578608750974410,5585.9,2023-04-22T17:05:00,Barcelona,expenses,education,-59.62,-38171.77
buyer_4,Marc,Andreu,1974-05-23,52965688T,marc.andreu@coolcloud.app,939777,ES43209578608750974410,5585.9,2023-04-24T09:40:48,Barcelona,expenses,leisure,-45.78,-38217.55
buyer_4,Marc,Andreu,1974-05-23,52965688T,marc.andreu@coolcloud.app,939777,ES43209578608750974410,5585.9,2023-04-24T10:06:43,Barcelona,expenses,travel,-421.34,-38638.89
buyer_4,Marc,Andreu,1974-05-23,52965688T,marc.andreu@coolcloud.app,939777,ES43209578608750974410,5585.9,2023-04-25T19:55:47,Barcelona,expenses,food,-120.24,-38759.13
buyer_4,Marc,Andreu,1974-05-23,52965688T,marc.andreu@coolcloud.app,939777,ES43209578608750974410,5585.9,2023-04-27T02:08:15,Barcelona,expenses,food,-60.22,-38819.35
buyer_4,Marc,Andreu,1974-05-23,52965688T,marc.andreu@coolcloud.app,939777,ES43209578608750974410,5585.9,2023-04-28T10:13:51,Barcelona,expenses,leisure,-32.75,-38852.1
buyer_4,Marc,Andreu,1974-05-23,52965688T,marc.andreu@coolcloud.app,939777,ES43209578608750974410,5585.9,2023-04-29T09:47:53,Barcelona,expenses,transport,-73.0,-38925.1
buyer_4,Marc,Andreu,1974-05-23,52965688T,marc.andreu@coolcloud.app,939777,ES43209578608750974410,5585.9,2023-04-30T23:48:00,Barcelona,expenses,food,-104.48,-39029.58
buyer_4,Marc,Andreu,1974-05-23,52965688T,marc.andreu@coolcloud.app,939777,ES43209578608750974410,5585.9,2023-05-01T09:37:56,Barcelona,incomes,salary,1318.43,-37711.15
buyer_4,Marc,Andreu,1974-05-23,52965688T,marc.andreu@coolcloud.app,939777,ES43209578608750974410,5585.9,2023-05-02T18:11:07,Barcelona,expenses,food,-65.17,-37776.32
buyer_4,Marc,Andreu,1974-05-23,52965688T,marc.andreu@coolcloud.app,939777,ES43209578608750974410,5585.9,2023-05-03T14:57:50,Barcelona,expenses,healthcare,-81.4,-37857.72
buyer_4,Marc,Andreu,1974-05-23,52965688T,marc.andreu@coolcloud.app,939777,ES43209578608750974410,5585.9,2023-05-03T18:38:52,Barcelona,expenses,repairs,-201.64,-38059.36
buyer_4,Marc,Andreu,1974-05-23,52965688T,marc.andreu@coolcloud.app,939777,ES43209578608750974410,5585.9,2023-05-05T08:28:50,Barcelona,expenses,mortgage,-634.0,-38693.36
buyer_4,Marc,Andreu,1974-05-23,52965688T,marc.andreu@coolcloud.app,939777,ES43209578608750974410,5585.9,2023-05-05T11:16:01,Barcelona,expenses,phone,-26.95,-38720.31
buyer_4,Marc,Andreu,1974-05-23,52965688T,marc.andreu@coolcloud.app,939777,ES43209578608750974410,5585.9,2023-05-05T15:53:51,Barcelona,expenses,repairs,-262.8,-38983.11
buyer_4,Marc,Andreu,1974-05-23,52965688T,marc.andreu@coolcloud.app,939777,ES43209578608750974410,5585.9,2023-05-06T10:50:18,Barcelona,expenses,food,-69.06,-39052.17
buyer_4,Marc,Andreu,1974-05-23,52965688T,marc.andreu@coolcloud.app,939777,ES43209578608750974410,5585.9,2023-05-07T10:35:03,Barcelona,expenses,phone,-22.42,-39074.59
buyer_4,Marc,Andreu,1974-05-23,52965688T,marc.andreu@coolcloud.app,939777,ES43209578608750974410,5585.9,2023-05-08T18:57:56,Barcelona,expenses,internet,-27.69,-39102.28
buyer_4,Marc,Andreu,1974-05-23,52965688T,marc.andreu@coolcloud.app,939777,ES43209578608750974410,5585.9,2023-05-08T18:34:07,Barcelona,expenses,leisure,-24.59,-39126.87
buyer_4,Marc,Andreu,1974-05-23,52965688T,marc.andreu@coolcloud.app,939777,ES43209578608750974410,5585.9,2023-05-08T15:56:05,Barcelona,expenses,cash,-100.0,-39226.87
buyer_4,Marc,Andreu,1974-05-23,52965688T,marc.andreu@coolcloud.app,939777,ES43209578608750974410,5585.9,2023-05-10T23:05:27,Barcelona,expenses,food,-75.52,-39302.39
buyer_4,Marc,Andreu,1974-05-23,52965688T,marc.andreu@coolcloud.app,939777,ES43209578608750974410,5585.9,2023-05-11T08:57:28,Barcelona,expenses,education,-43.81,-39346.2
buyer_4,Marc,Andreu,1974-05-23,52965688T,marc.andreu@coolcloud.app,939777,ES43209578608750974410,5585.9,2023-05-15T14:37:06,Barcelona,expenses,food,-82.09,-39428.29
buyer_4,Marc,Andreu,1974-05-23,52965688T,marc.andreu@coolcloud.app,939777,ES43209578608750974410,5585.9,2023-05-16T23:49:24,Barcelona,expenses,food,-76.21,-39504.5
buyer_4,Marc,Andreu,1974-05-23,52965688T,marc.andreu@coolcloud.app,939777,ES43209578608750974410,5585.9,2023-05-17T09:48:03,Barcelona,expenses,cash,-100.0,-39604.5
buyer_4,Marc,Andreu,1974-05-23,52965688T,marc.andreu@coolcloud.app,939777,ES43209578608750974410,5585.9,2023-05-18T20:50:41,Barcelona,expenses,leisure,-37.13,-39641.63
buyer_4,Marc,Andreu,1974-05-23,52965688T,marc.andreu@coolcloud.app,939777,ES43209578608750974410,5585.9,2023-05-18T13:52:28,Barcelona,expenses,cash,-100.0,-39741.63
buyer_4,Marc,Andreu,1974-05-23,52965688T,marc.andreu@coolcloud.app,939777,ES43209578608750974410,5585.9,2023-05-19T09:43:41,Barcelona,expenses,leisure,-30.2,-39771.83
buyer_4,Marc,Andreu,1974-05-23,52965688T,marc.andreu@coolcloud.app,939777,ES43209578608750974410,5585.9,2023-05-20T11:26:47,Barcelona,expenses,healthcare,-47.71,-39819.54
buyer_4,Marc,Andreu,1974-05-23,52965688T,marc.andreu@coolcloud.app,939777,ES43209578608750974410,5585.9,2023-05-20T13:26:54,Barcelona,expenses,cash,-100.0,-39919.54
buyer_4,Marc,Andreu,1974-05-23,52965688T,marc.andreu@coolcloud.app,939777,ES43209578608750974410,5585.9,2023-05-21T18:46:43,Barcelona,expenses,transport,-42.81,-39962.35
buyer_4,Marc,Andreu,1974-05-23,52965688T,marc.andreu@coolcloud.app,939777,ES43209578608750974410,5585.9,2023-05-21T11:31:20,Barcelona,expenses,cash,-100.0,-40062.35
buyer_4,Marc,Andreu,1974-05-23,52965688T,marc.andreu@coolcloud.app,939777,ES43209578608750974410,5585.9,2023-05-23T16:40:14,Barcelona,expenses,cash,-100.0,-40162.35
buyer_4,Marc,Andreu,1974-05-23,52965688T,marc.andreu@coolcloud.app,939777,ES43209578608750974410,5585.9,2023-05-25T08:26:40,Barcelona,expenses,transport,-43.41,-40205.76
buyer_4,Marc,Andreu,1974-05-23,52965688T,marc.andreu@coolcloud.app,939777,ES43209578608750974410,5585.9,2023-05-25T11:03:40,Barcelona,expenses,cash,-100.0,-40305.76
buyer_4,Marc,Andreu,1974-05-23,52965688T,marc.andreu@coolcloud.app,939777,ES43209578608750974410,5585.9,2023-05-28T15:58:33,Barcelona,expenses,food,-77.68,-40383.44
buyer_4,Marc,Andreu,1974-05-23,52965688T,marc.andreu@coolcloud.app,939777,ES43209578608750974410,5585.9,2023-05-28T20:46:29,Barcelona,expenses,cash,-100.0,-40483.44
buyer_4,Marc,Andreu,1974-05-23,52965688T,marc.andreu@coolcloud.app,939777,ES43209578608750974410,5585.9,2023-05-28T17:48:37,Barcelona,expenses,gifts,-108.57,-40592.01
buyer_4,Marc,Andreu,1974-05-23,52965688T,marc.andreu@coolcloud.app,939777,ES43209578608750974410,5585.9,2023-05-30T20:42:31,Barcelona,expenses,food,-102.04,-40694.05
buyer_4,Marc,Andreu,1974-05-23,52965688T,marc.andreu@coolcloud.app,939777,ES43209578608750974410,5585.9,2023-05-30T12:52:49,Barcelona,expenses,leisure,-67.77,-40761.82
buyer_4,Marc,Andreu,1974-05-23,52965688T,marc.andreu@coolcloud.app,939777,ES43209578608750974410,5585.9,2023-05-31T02:47:11,Barcelona,expenses,gifts,-437.35,-41199.17
buyer_4,Marc,Andreu,1974-05-23,52965688T,marc.andreu@coolcloud.app,939777,ES43209578608750974410,5585.9,2023-06-01T19:38:39,Barcelona,incomes,salary,1318.43,-39880.74
buyer_4,Marc,Andreu,1974-05-23,52965688T,marc.andreu@coolcloud.app,939777,ES43209578608750974410,5585.9,2023-06-01T19:38:39,Barcelona,incomes,extra_income,171.57,-39709.17
buyer_4,Marc,Andreu,1974-05-23,52965688T,marc.andreu@coolcloud.app,939777,ES43209578608750974410,5585.9,2023-06-01T19:38:39,Barcelona,incomes,salary_bonus,986.91,-38722.26
buyer_4,Marc,Andreu,1974-05-23,52965688T,marc.andreu@coolcloud.app,939777,ES43209578608750974410,5585.9,2023-06-01T18:16:28,Barcelona,expenses,taxes,-905.03,-39627.29
buyer_4,Marc,Andreu,1974-05-23,52965688T,marc.andreu@coolcloud.app,939777,ES43209578608750974410,5585.9,2023-06-01T12:45:23,Barcelona,expenses,insurance,-376.59,-40003.88
buyer_4,Marc,Andreu,1974-05-23,52965688T,marc.andreu@coolcloud.app,939777,ES43209578608750974410,5585.9,2023-06-01T16:40:52,Barcelona,expenses,cash,-100.0,-40103.88
buyer_4,Marc,Andreu,1974-05-23,52965688T,marc.andreu@coolcloud.app,939777,ES43209578608750974410,5585.9,2023-06-04T23:14:07,Barcelona,expenses,transport,-86.31,-40190.19
buyer_4,Marc,Andreu,1974-05-23,52965688T,marc.andreu@coolcloud.app,939777,ES43209578608750974410,5585.9,2023-06-04T13:39:37,Barcelona,expenses,leisure,-27.62,-40217.81
buyer_4,Marc,Andreu,1974-05-23,52965688T,marc.andreu@coolcloud.app,939777,ES43209578608750974410,5585.9,2023-06-04T16:10:58,Barcelona,expenses,cash,-100.0,-40317.81
buyer_4,Marc,Andreu,1974-05-23,52965688T,marc.andreu@coolcloud.app,939777,ES43209578608750974410,5585.9,2023-06-04T20:01:25,Barcelona,expenses,gifts,-104.15,-40421.96
buyer_4,Marc,Andreu,1974-05-23,52965688T,marc.andreu@coolcloud.app,939777,ES43209578608750974410,5585.9,2023-06-05T09:31:37,Barcelona,expenses,mortgage,-634.0,-41055.96
buyer_4,Marc,Andreu,1974-05-23,52965688T,marc.andreu@coolcloud.app,939777,ES43209578608750974410,5585.9,2023-06-05T09:04:10,Barcelona,expenses,transport,-60.7,-41116.66
buyer_4,Marc,Andreu,1974-05-23,52965688T,marc.andreu@coolcloud.app,939777,ES43209578608750974410,5585.9,2023-06-05T15:22:42,Barcelona,expenses,cash,-100.0,-41216.66
buyer_4,Marc,Andreu,1974-05-23,52965688T,marc.andreu@coolcloud.app,939777,ES43209578608750974410,5585.9,2023-06-06T11:06:38,Barcelona,expenses,water,-18.16,-41234.82
buyer_4,Marc,Andreu,1974-05-23,52965688T,marc.andreu@coolcloud.app,939777,ES43209578608750974410,5585.9,2023-06-06T18:44:28,Barcelona,expenses,internet,-27.69,-41262.51
buyer_4,Marc,Andreu,1974-05-23,52965688T,marc.andreu@coolcloud.app,939777,ES43209578608750974410,5585.9,2023-06-06T17:03:07,Barcelona,expenses,phone,-20.64,-41283.15
buyer_4,Marc,Andreu,1974-05-23,52965688T,marc.andreu@coolcloud.app,939777,ES43209578608750974410,5585.9,2023-06-06T14:40:41,Barcelona,expenses,food,-67.8,-41350.95
buyer_4,Marc,Andreu,1974-05-23,52965688T,marc.andreu@coolcloud.app,939777,ES43209578608750974410,5585.9,2023-06-07T13:37:56,Barcelona,expenses,water,-16.84,-41367.79
buyer_4,Marc,Andreu,1974-05-23,52965688T,marc.andreu@coolcloud.app,939777,ES43209578608750974410,5585.9,2023-06-07T05:07:52,Barcelona,expenses,electricity,-44.71,-41412.5
buyer_4,Marc,Andreu,1974-05-23,52965688T,marc.andreu@coolcloud.app,939777,ES43209578608750974410,5585.9,2023-06-07T20:13:52,Barcelona,expenses,internet,-27.69,-41440.19
buyer_4,Marc,Andreu,1974-05-23,52965688T,marc.andreu@coolcloud.app,939777,ES43209578608750974410,5585.9,2023-06-08T12:14:19,Barcelona,expenses,gas,-44.1,-41484.29
buyer_4,Marc,Andreu,1974-05-23,52965688T,marc.andreu@coolcloud.app,939777,ES43209578608750974410,5585.9,2023-06-08T12:09:41,Barcelona,expenses,internet,-27.69,-41511.98
buyer_4,Marc,Andreu,1974-05-23,52965688T,marc.andreu@coolcloud.app,939777,ES43209578608750974410,5585.9,2023-06-08T09:43:47,Barcelona,expenses,phone,-21.43,-41533.41
buyer_4,Marc,Andreu,1974-05-23,52965688T,marc.andreu@coolcloud.app,939777,ES43209578608750974410,5585.9,2023-06-09T09:49:50,Barcelona,expenses,cash,-100.0,-41633.41
buyer_4,Marc,Andreu,1974-05-23,52965688T,marc.andreu@coolcloud.app,939777,ES43209578608750974410,5585.9,2023-06-12T08:37:53,Barcelona,expenses,cash,-100.0,-41733.41
buyer_4,Marc,Andreu,1974-05-23,52965688T,marc.andreu@coolcloud.app,939777,ES43209578608750974410,5585.9,2023-06-12T16:07:40,Barcelona,expenses,repairs,-198.63,-41932.04
buyer_4,Marc,Andreu,1974-05-23,52965688T,marc.andreu@coolcloud.app,939777,ES43209578608750974410,5585.9,2023-06-13T17:39:28,Barcelona,expenses,cash,-100.0,-42032.04
buyer_4,Marc,Andreu,1974-05-23,52965688T,marc.andreu@coolcloud.app,939777,ES43209578608750974410,5585.9,2023-06-14T11:11:41,Barcelona,expenses,transport,-67.08,-42099.12
buyer_4,Marc,Andreu,1974-05-23,52965688T,marc.andreu@coolcloud.app,939777,ES43209578608750974410,5585.9,2023-06-14T16:45:22,Barcelona,expenses,cash,-100.0,-42199.12
buyer_4,Marc,Andreu,1974-05-23,52965688T,marc.andreu@coolcloud.app,939777,ES43209578608750974410,5585.9,2023-06-15T19:04:24,Barcelona,expenses,education,-74.84,-42273.96
buyer_4,Marc,Andreu,1974-05-23,52965688T,marc.andreu@coolcloud.app,939777,ES43209578608750974410,5585.9,2023-06-16T09:07:59,Barcelona,expenses,food,-87.28,-42361.24
buyer_4,Marc,Andreu,1974-05-23,52965688T,marc.andreu@coolcloud.app,939777,ES43209578608750974410,5585.9,2023-06-16T13:07:05,Barcelona,expenses,cash,-100.0,-42461.24
buyer_4,Marc,Andreu,1974-05-23,52965688T,marc.andreu@coolcloud.app,939777,ES43209578608750974410,5585.9,2023-06-17T17:37:22,Barcelona,expenses,leisure,-33.79,-42495.03
buyer_4,Marc,Andreu,1974-05-23,52965688T,marc.andreu@coolcloud.app,939777,ES43209578608750974410,5585.9,2023-06-18T15:41:13,Barcelona,expenses,education,-65.04,-42560.07
buyer_4,Marc,Andreu,1974-05-23,52965688T,marc.andreu@coolcloud.app,939777,ES43209578608750974410,5585.9,2023-06-18T16:25:57,Barcelona,expenses,gifts,-136.0,-42696.07
buyer_4,Marc,Andreu,1974-05-23,52965688T,marc.andreu@coolcloud.app,939777,ES43209578608750974410,5585.9,2023-06-20T11:20:59,Barcelona,expenses,cash,-100.0,-42796.07
buyer_4,Marc,Andreu,1974-05-23,52965688T,marc.andreu@coolcloud.app,939777,ES43209578608750974410,5585.9,2023-06-21T08:58:40,Barcelona,expenses,food,-93.21,-42889.28
buyer_4,Marc,Andreu,1974-05-23,52965688T,marc.andreu@coolcloud.app,939777,ES43209578608750974410,5585.9,2023-06-24T08:50:59,Barcelona,expenses,leisure,-82.09,-42971.37
buyer_4,Marc,Andreu,1974-05-23,52965688T,marc.andreu@coolcloud.app,939777,ES43209578608750974410,5585.9,2023-06-27T15:26:27,Barcelona,expenses,gifts,-70.84,-43042.21
buyer_4,Marc,Andreu,1974-05-23,52965688T,marc.andreu@coolcloud.app,939777,ES43209578608750974410,5585.9,2023-06-30T17:52:47,Barcelona,expenses,transport,-82.19,-43124.4
buyer_4,Marc,Andreu,1974-05-23,52965688T,marc.andreu@coolcloud.app,939777,ES43209578608750974410,5585.9,2023-06-30T12:36:05,Barcelona,expenses,leisure,-57.39,-43181.79
buyer_4,Marc,Andreu,1974-05-23,52965688T,marc.andreu@coolcloud.app,939777,ES43209578608750974410,5585.9,2023-07-01T22:30:25,Barcelona,incomes,salary,1318.43,-41863.36
buyer_4,Marc,Andreu,1974-05-23,52965688T,marc.andreu@coolcloud.app,939777,ES43209578608750974410,5585.9,2023-07-02T18:18:21,Barcelona,expenses,leisure,-83.07,-41946.43
buyer_4,Marc,Andreu,1974-05-23,52965688T,marc.andreu@coolcloud.app,939777,ES43209578608750974410,5585.9,2023-07-02T10:43:32,Barcelona,expenses,healthcare,-53.52,-41999.95
buyer_4,Marc,Andreu,1974-05-23,52965688T,marc.andreu@coolcloud.app,939777,ES43209578608750974410,5585.9,2023-07-02T14:21:29,Barcelona,expenses,cash,-100.0,-42099.95
buyer_4,Marc,Andreu,1974-05-23,52965688T,marc.andreu@coolcloud.app,939777,ES43209578608750974410,5585.9,2023-07-03T13:03:53,Barcelona,expenses,repairs,-80.25,-42180.2
buyer_4,Marc,Andreu,1974-05-23,52965688T,marc.andreu@coolcloud.app,939777,ES43209578608750974410,5585.9,2023-07-04T18:13:21,Barcelona,expenses,food,-67.76,-42247.96
buyer_4,Marc,Andreu,1974-05-23,52965688T,marc.andreu@coolcloud.app,939777,ES43209578608750974410,5585.9,2023-07-05T09:59:59,Barcelona,expenses,mortgage,-634.0,-42881.96
buyer_4,Marc,Andreu,1974-05-23,52965688T,marc.andreu@coolcloud.app,939777,ES43209578608750974410,5585.9,2023-07-05T15:06:53,Barcelona,expenses,internet,-27.69,-42909.65
buyer_4,Marc,Andreu,1974-05-23,52965688T,marc.andreu@coolcloud.app,939777,ES43209578608750974410,5585.9,2023-07-05T18:04:22,Barcelona,expenses,cash,-100.0,-43009.65
buyer_4,Marc,Andreu,1974-05-23,52965688T,marc.andreu@coolcloud.app,939777,ES43209578608750974410,5585.9,2023-07-06T06:43:41,Barcelona,expenses,gas,-41.48,-43051.13
buyer_4,Marc,Andreu,1974-05-23,52965688T,marc.andreu@coolcloud.app,939777,ES43209578608750974410,5585.9,2023-07-06T10:46:19,Barcelona,expenses,internet,-27.69,-43078.82
buyer_4,Marc,Andreu,1974-05-23,52965688T,marc.andreu@coolcloud.app,939777,ES43209578608750974410,5585.9,2023-07-06T08:05:19,Barcelona,expenses,phone,-26.36,-43105.18
buyer_4,Marc,Andreu,1974-05-23,52965688T,marc.andreu@coolcloud.app,939777,ES43209578608750974410,5585.9,2023-07-06T10:25:36,Barcelona,expenses,clothing,-101.99,-43207.17
buyer_4,Marc,Andreu,1974-05-23,52965688T,marc.andreu@coolcloud.app,939777,ES43209578608750974410,5585.9,2023-07-07T05:14:33,Barcelona,expenses,water,-21.35,-43228.52
buyer_4,Marc,Andreu,1974-05-23,52965688T,marc.andreu@coolcloud.app,939777,ES43209578608750974410,5585.9,2023-07-08T05:11:43,Barcelona,expenses,phone,-22.57,-43251.09
buyer_4,Marc,Andreu,1974-05-23,52965688T,marc.andreu@coolcloud.app,939777,ES43209578608750974410,5585.9,2023-07-08T18:50:26,Barcelona,expenses,transport,-67.61,-43318.7
buyer_4,Marc,Andreu,1974-05-23,52965688T,marc.andreu@coolcloud.app,939777,ES43209578608750974410,5585.9,2023-07-10T11:40:31,Barcelona,expenses,food,-83.08,-43401.78
buyer_4,Marc,Andreu,1974-05-23,52965688T,marc.andreu@coolcloud.app,939777,ES43209578608750974410,5585.9,2023-07-10T09:05:34,Barcelona,expenses,appliances,-174.15,-43575.93
buyer_4,Marc,Andreu,1974-05-23,52965688T,marc.andreu@coolcloud.app,939777,ES43209578608750974410,5585.9,2023-07-13T13:29:46,Barcelona,expenses,appliances,-303.4,-43879.33
buyer_4,Marc,Andreu,1974-05-23,52965688T,marc.andreu@coolcloud.app,939777,ES43209578608750974410,5585.9,2023-07-14T15:51:18,Barcelona,expenses,gifts,-116.63,-43995.96
buyer_4,Marc,Andreu,1974-05-23,52965688T,marc.andreu@coolcloud.app,939777,ES43209578608750974410,5585.9,2023-07-17T15:21:57,Barcelona,expenses,transport,-89.98,-44085.94
buyer_4,Marc,Andreu,1974-05-23,52965688T,marc.andreu@coolcloud.app,939777,ES43209578608750974410,5585.9,2023-07-18T00:25:38,Barcelona,expenses,travel,-395.67,-44481.61
buyer_4,Marc,Andreu,1974-05-23,52965688T,marc.andreu@coolcloud.app,939777,ES43209578608750974410,5585.9,2023-07-18T20:14:12,Barcelona,expenses,children,-79.97549999999984,-44561.59
buyer_4,Marc,Andreu,1974-05-23,52965688T,marc.andreu@coolcloud.app,939777,ES43209578608750974410,5585.9,2023-07-20T15:27:34,Barcelona,expenses,transport,-44.6,-44606.19
buyer_4,Marc,Andreu,1974-05-23,52965688T,marc.andreu@coolcloud.app,939777,ES43209578608750974410,5585.9,2023-07-20T09:19:17,Barcelona,expenses,gifts,-312.87,-44919.06
buyer_4,Marc,Andreu,1974-05-23,52965688T,marc.andreu@coolcloud.app,939777,ES43209578608750974410,5585.9,2023-07-21T08:49:32,Barcelona,expenses,repairs,-134.89,-45053.95
buyer_4,Marc,Andreu,1974-05-23,52965688T,marc.andreu@coolcloud.app,939777,ES43209578608750974410,5585.9,2023-07-22T17:01:37,Barcelona,expenses,education,-66.06,-45120.01
buyer_4,Marc,Andreu,1974-05-23,52965688T,marc.andreu@coolcloud.app,939777,ES43209578608750974410,5585.9,2023-07-22T18:54:17,Barcelona,expenses,children,-409.58549999999985,-45529.6
buyer_4,Marc,Andreu,1974-05-23,52965688T,marc.andreu@coolcloud.app,939777,ES43209578608750974410,5585.9,2023-07-23T12:11:55,Barcelona,expenses,food,-64.72,-45594.32
buyer_4,Marc,Andreu,1974-05-23,52965688T,marc.andreu@coolcloud.app,939777,ES43209578608750974410,5585.9,2023-07-25T01:54:12,Barcelona,expenses,repairs,-141.82,-45736.14
buyer_4,Marc,Andreu,1974-05-23,52965688T,marc.andreu@coolcloud.app,939777,ES43209578608750974410,5585.9,2023-07-27T08:15:38,Barcelona,expenses,leisure,-50.47,-45786.61
buyer_4,Marc,Andreu,1974-05-23,52965688T,marc.andreu@coolcloud.app,939777,ES43209578608750974410,5585.9,2023-07-27T05:44:21,Barcelona,expenses,repairs,-309.41,-46096.02
buyer_4,Marc,Andreu,1974-05-23,52965688T,marc.andreu@coolcloud.app,939777,ES43209578608750974410,5585.9,2023-07-29T00:34:37,Barcelona,expenses,travel,-399.37,-46495.39
buyer_4,Marc,Andreu,1974-05-23,52965688T,marc.andreu@coolcloud.app,939777,ES43209578608750974410,5585.9,2023-07-31T10:58:56,Barcelona,expenses,food,-69.82,-46565.21
buyer_4,Marc,Andreu,1974-05-23,52965688T,marc.andreu@coolcloud.app,939777,ES43209578608750974410,5585.9,2023-07-31T14:38:30,Barcelona,expenses,gifts,-342.3,-46907.51
buyer_4,Marc,Andreu,1974-05-23,52965688T,marc.andreu@coolcloud.app,939777,ES43209578608750974410,5585.9,2023-08-01T20:39:48,Barcelona,incomes,salary,1318.43,-45589.08
buyer_4,Marc,Andreu,1974-05-23,52965688T,marc.andreu@coolcloud.app,939777,ES43209578608750974410,5585.9,2023-08-03T17:18:03,Barcelona,expenses,cash,-100.0,-45689.08
buyer_4,Marc,Andreu,1974-05-23,52965688T,marc.andreu@coolcloud.app,939777,ES43209578608750974410,5585.9,2023-08-03T19:48:57,Barcelona,expenses,repairs,-327.65,-46016.73
buyer_4,Marc,Andreu,1974-05-23,52965688T,marc.andreu@coolcloud.app,939777,ES43209578608750974410,5585.9,2023-08-05T03:34:49,Barcelona,expenses,mortgage,-634.0,-46650.73
buyer_4,Marc,Andreu,1974-05-23,52965688T,marc.andreu@coolcloud.app,939777,ES43209578608750974410,5585.9,2023-08-05T08:02:04,Barcelona,expenses,water,-23.91,-46674.64
buyer_4,Marc,Andreu,1974-05-23,52965688T,marc.andreu@coolcloud.app,939777,ES43209578608750974410,5585.9,2023-08-05T00:46:20,Barcelona,expenses,electricity,-14.74,-46689.38
buyer_4,Marc,Andreu,1974-05-23,52965688T,marc.andreu@coolcloud.app,939777,ES43209578608750974410,5585.9,2023-08-05T15:18:12,Barcelona,expenses,leisure,-19.97,-46709.35
buyer_4,Marc,Andreu,1974-05-23,52965688T,marc.andreu@coolcloud.app,939777,ES43209578608750974410,5585.9,2023-08-06T20:50:28,Barcelona,expenses,children,-180.29,-46889.64
buyer_4,Marc,Andreu,1974-05-23,52965688T,marc.andreu@coolcloud.app,939777,ES43209578608750974410,5585.9,2023-08-07T08:53:10,Barcelona,expenses,electricity,-29.51,-46919.15
buyer_4,Marc,Andreu,1974-05-23,52965688T,marc.andreu@coolcloud.app,939777,ES43209578608750974410,5585.9,2023-08-07T10:35:06,Barcelona,expenses,phone,-28.0,-46947.15
buyer_4,Marc,Andreu,1974-05-23,52965688T,marc.andreu@coolcloud.app,939777,ES43209578608750974410,5585.9,2023-08-07T19:43:48,Barcelona,expenses,transport,-70.6,-47017.75
buyer_4,Marc,Andreu,1974-05-23,52965688T,marc.andreu@coolcloud.app,939777,ES43209578608750974410,5585.9,2023-08-07T13:45:44,Barcelona,expenses,leisure,-76.61,-47094.36
buyer_4,Marc,Andreu,1974-05-23,52965688T,marc.andreu@coolcloud.app,939777,ES43209578608750974410,5585.9,2023-08-08T06:09:03,Barcelona,expenses,water,-16.93,-47111.29
buyer_4,Marc,Andreu,1974-05-23,52965688T,marc.andreu@coolcloud.app,939777,ES43209578608750974410,5585.9,2023-08-08T10:42:36,Barcelona,expenses,gas,-58.87,-47170.16
buyer_4,Marc,Andreu,1974-05-23,52965688T,marc.andreu@coolcloud.app,939777,ES43209578608750974410,5585.9,2023-08-08T20:03:34,Barcelona,expenses,internet,-27.69,-47197.85
buyer_4,Marc,Andreu,1974-05-23,52965688T,marc.andreu@coolcloud.app,939777,ES43209578608750974410,5585.9,2023-08-09T10:47:58,Barcelona,expenses,food,-85.39,-47283.24
buyer_4,Marc,Andreu,1974-05-23,52965688T,marc.andreu@coolcloud.app,939777,ES43209578608750974410,5585.9,2023-08-10T22:20:07,Barcelona,expenses,cash,-100.0,-47383.24
buyer_4,Marc,Andreu,1974-05-23,52965688T,marc.andreu@coolcloud.app,939777,ES43209578608750974410,5585.9,2023-08-10T09:17:35,Barcelona,expenses,gifts,-275.06,-47658.3
buyer_4,Marc,Andreu,1974-05-23,52965688T,marc.andreu@coolcloud.app,939777,ES43209578608750974410,5585.9,2023-08-11T12:54:29,Barcelona,expenses,healthcare,-106.98,-47765.28
buyer_4,Marc,Andreu,1974-05-23,52965688T,marc.andreu@coolcloud.app,939777,ES43209578608750974410,5585.9,2023-08-12T08:51:07,Barcelona,expenses,education,-67.48,-47832.76
buyer_4,Marc,Andreu,1974-05-23,52965688T,marc.andreu@coolcloud.app,939777,ES43209578608750974410,5585.9,2023-08-14T17:31:53,Barcelona,expenses,food,-110.12,-47942.88
buyer_4,Marc,Andreu,1974-05-23,52965688T,marc.andreu@coolcloud.app,939777,ES43209578608750974410,5585.9,2023-08-17T15:25:05,Barcelona,expenses,food,-90.27,-48033.15
buyer_4,Marc,Andreu,1974-05-23,52965688T,marc.andreu@coolcloud.app,939777,ES43209578608750974410,5585.9,2023-08-17T17:52:46,Barcelona,expenses,clothing,-124.58,-48157.73
buyer_4,Marc,Andreu,1974-05-23,52965688T,marc.andreu@coolcloud.app,939777,ES43209578608750974410,5585.9,2023-08-19T00:25:21,Barcelona,expenses,food,-112.15,-48269.88
buyer_4,Marc,Andreu,1974-05-23,52965688T,marc.andreu@coolcloud.app,939777,ES43209578608750974410,5585.9,2023-08-20T13:13:47,Barcelona,expenses,education,-77.03,-48346.91
buyer_4,Marc,Andreu,1974-05-23,52965688T,marc.andreu@coolcloud.app,939777,ES43209578608750974410,5585.9,2023-08-21T22:29:02,Barcelona,expenses,clothing,-146.05,-48492.96
buyer_4,Marc,Andreu,1974-05-23,52965688T,marc.andreu@coolcloud.app,939777,ES43209578608750974410,5585.9,2023-08-22T14:51:31,Barcelona,expenses,food,-78.92,-48571.88
buyer_4,Marc,Andreu,1974-05-23,52965688T,marc.andreu@coolcloud.app,939777,ES43209578608750974410,5585.9,2023-08-24T16:39:05,Barcelona,expenses,transport,-86.14,-48658.02
buyer_4,Marc,Andreu,1974-05-23,52965688T,marc.andreu@coolcloud.app,939777,ES43209578608750974410,5585.9,2023-08-25T14:48:45,Barcelona,expenses,leisure,-59.4,-48717.42
buyer_4,Marc,Andreu,1974-05-23,52965688T,marc.andreu@coolcloud.app,939777,ES43209578608750974410,5585.9,2023-08-26T16:27:58,Barcelona,expenses,transport,-47.77,-48765.19
buyer_4,Marc,Andreu,1974-05-23,52965688T,marc.andreu@coolcloud.app,939777,ES43209578608750974410,5585.9,2023-08-26T18:34:29,Barcelona,expenses,healthcare,-173.72,-48938.91
buyer_4,Marc,Andreu,1974-05-23,52965688T,marc.andreu@coolcloud.app,939777,ES43209578608750974410,5585.9,2023-08-27T08:24:37,Barcelona,expenses,cash,-100.0,-49038.91
buyer_4,Marc,Andreu,1974-05-23,52965688T,marc.andreu@coolcloud.app,939777,ES43209578608750974410,5585.9,2023-08-28T05:42:20,Barcelona,expenses,food,-106.24,-49145.15
buyer_4,Marc,Andreu,1974-05-23,52965688T,marc.andreu@coolcloud.app,939777,ES43209578608750974410,5585.9,2023-08-30T11:14:50,Barcelona,expenses,education,-45.71,-49190.86
buyer_4,Marc,Andreu,1974-05-23,52965688T,marc.andreu@coolcloud.app,939777,ES43209578608750974410,5585.9,2023-08-30T17:51:27,Barcelona,expenses,travel,-390.34,-49581.2
buyer_4,Marc,Andreu,1974-05-23,52965688T,marc.andreu@coolcloud.app,939777,ES43209578608750974410,5585.9,2023-09-01T19:36:25,Barcelona,incomes,salary,1318.43,-48262.77
buyer_4,Marc,Andreu,1974-05-23,52965688T,marc.andreu@coolcloud.app,939777,ES43209578608750974410,5585.9,2023-09-02T02:56:08,Barcelona,expenses,cash,-100.0,-48362.77
buyer_4,Marc,Andreu,1974-05-23,52965688T,marc.andreu@coolcloud.app,939777,ES43209578608750974410,5585.9,2023-09-03T01:01:18,Barcelona,expenses,food,-121.0,-48483.77
buyer_4,Marc,Andreu,1974-05-23,52965688T,marc.andreu@coolcloud.app,939777,ES43209578608750974410,5585.9,2023-09-04T19:52:19,Barcelona,expenses,cash,-100.0,-48583.77
buyer_4,Marc,Andreu,1974-05-23,52965688T,marc.andreu@coolcloud.app,939777,ES43209578608750974410,5585.9,2023-09-05T16:29:32,Barcelona,expenses,mortgage,-634.0,-49217.77
buyer_4,Marc,Andreu,1974-05-23,52965688T,marc.andreu@coolcloud.app,939777,ES43209578608750974410,5585.9,2023-09-05T01:30:29,Barcelona,expenses,phone,-21.79,-49239.56
buyer_4,Marc,Andreu,1974-05-23,52965688T,marc.andreu@coolcloud.app,939777,ES43209578608750974410,5585.9,2023-09-05T23:09:59,Barcelona,expenses,transport,-87.63,-49327.19
buyer_4,Marc,Andreu,1974-05-23,52965688T,marc.andreu@coolcloud.app,939777,ES43209578608750974410,5585.9,2023-09-05T09:06:18,Barcelona,expenses,leisure,-30.01,-49357.2
buyer_4,Marc,Andreu,1974-05-23,52965688T,marc.andreu@coolcloud.app,939777,ES43209578608750974410,5585.9,2023-09-06T11:02:40,Barcelona,expenses,gas,-28.48,-49385.68
buyer_4,Marc,Andreu,1974-05-23,52965688T,marc.andreu@coolcloud.app,939777,ES43209578608750974410,5585.9,2023-09-06T11:24:56,Barcelona,expenses,internet,-27.69,-49413.37
buyer_4,Marc,Andreu,1974-05-23,52965688T,marc.andreu@coolcloud.app,939777,ES43209578608750974410,5585.9,2023-09-07T10:30:55,Barcelona,expenses,leisure,-53.48,-49466.85
buyer_4,Marc,Andreu,1974-05-23,52965688T,marc.andreu@coolcloud.app,939777,ES43209578608750974410,5585.9,2023-09-07T20:26:36,Barcelona,expenses,repairs,-40.82,-49507.67
buyer_4,Marc,Andreu,1974-05-23,52965688T,marc.andreu@coolcloud.app,939777,ES43209578608750974410,5585.9,2023-09-08T12:22:38,Barcelona,expenses,water,-18.58,-49526.25
buyer_4,Marc,Andreu,1974-05-23,52965688T,marc.andreu@coolcloud.app,939777,ES43209578608750974410,5585.9,2023-09-09T10:27:33,Barcelona,expenses,food,-65.38,-49591.63
buyer_4,Marc,Andreu,1974-05-23,52965688T,marc.andreu@coolcloud.app,939777,ES43209578608750974410,5585.9,2023-09-10T16:23:23,Barcelona,expenses,cash,-100.0,-49691.63
buyer_4,Marc,Andreu,1974-05-23,52965688T,marc.andreu@coolcloud.app,939777,ES43209578608750974410,5585.9,2023-09-12T16:18:34,Barcelona,expenses,education,-66.55,-49758.18
buyer_4,Marc,Andreu,1974-05-23,52965688T,marc.andreu@coolcloud.app,939777,ES43209578608750974410,5585.9,2023-09-12T10:23:32,Barcelona,expenses,cash,-100.0,-49858.18
buyer_4,Marc,Andreu,1974-05-23,52965688T,marc.andreu@coolcloud.app,939777,ES43209578608750974410,5585.9,2023-09-13T13:57:36,Barcelona,expenses,food,-84.75,-49942.93
buyer_4,Marc,Andreu,1974-05-23,52965688T,marc.andreu@coolcloud.app,939777,ES43209578608750974410,5585.9,2023-09-14T09:35:29,Barcelona,expenses,appliances,-133.3,-50076.23
buyer_4,Marc,Andreu,1974-05-23,52965688T,marc.andreu@coolcloud.app,939777,ES43209578608750974410,5585.9,2023-09-16T16:06:10,Barcelona,expenses,transport,-48.52,-50124.75
buyer_4,Marc,Andreu,1974-05-23,52965688T,marc.andreu@coolcloud.app,939777,ES43209578608750974410,5585.9,2023-09-17T09:36:00,Barcelona,expenses,clothing,-53.28,-50178.03
buyer_4,Marc,Andreu,1974-05-23,52965688T,marc.andreu@coolcloud.app,939777,ES43209578608750974410,5585.9,2023-09-17T19:48:24,Barcelona,expenses,cash,-100.0,-50278.03
buyer_4,Marc,Andreu,1974-05-23,52965688T,marc.andreu@coolcloud.app,939777,ES43209578608750974410,5585.9,2023-09-19T17:42:16,Barcelona,expenses,cash,-100.0,-50378.03
buyer_4,Marc,Andreu,1974-05-23,52965688T,marc.andreu@coolcloud.app,939777,ES43209578608750974410,5585.9,2023-09-20T15:42:58,Barcelona,expenses,food,-97.14,-50475.17
buyer_4,Marc,Andreu,1974-05-23,52965688T,marc.andreu@coolcloud.app,939777,ES43209578608750974410,5585.9,2023-09-20T08:09:00,Barcelona,expenses,clothing,-55.28,-50530.45
buyer_4,Marc,Andreu,1974-05-23,52965688T,marc.andreu@coolcloud.app,939777,ES43209578608750974410,5585.9,2023-09-20T12:09:41,Barcelona,expenses,cash,-100.0,-50630.45
buyer_4,Marc,Andreu,1974-05-23,52965688T,marc.andreu@coolcloud.app,939777,ES43209578608750974410,5585.9,2023-09-21T08:37:30,Barcelona,expenses,food,-111.84,-50742.29
buyer_4,Marc,Andreu,1974-05-23,52965688T,marc.andreu@coolcloud.app,939777,ES43209578608750974410,5585.9,2023-09-22T09:44:57,Barcelona,expenses,leisure,-38.32,-50780.61
buyer_4,Marc,Andreu,1974-05-23,52965688T,marc.andreu@coolcloud.app,939777,ES43209578608750974410,5585.9,2023-09-23T23:20:09,Barcelona,expenses,travel,-298.61,-51079.22
buyer_4,Marc,Andreu,1974-05-23,52965688T,marc.andreu@coolcloud.app,939777,ES43209578608750974410,5585.9,2023-09-24T09:08:03,Barcelona,expenses,food,-123.07,-51202.29
buyer_4,Marc,Andreu,1974-05-23,52965688T,marc.andreu@coolcloud.app,939777,ES43209578608750974410,5585.9,2023-09-24T13:24:42,Barcelona,expenses,healthcare,-112.97,-51315.26
buyer_4,Marc,Andreu,1974-05-23,52965688T,marc.andreu@coolcloud.app,939777,ES43209578608750974410,5585.9,2023-09-25T22:25:01,Barcelona,expenses,clothing,-133.59,-51448.85
buyer_4,Marc,Andreu,1974-05-23,52965688T,marc.andreu@coolcloud.app,939777,ES43209578608750974410,5585.9,2023-09-27T08:57:49,Barcelona,expenses,cash,-100.0,-51548.85
buyer_4,Marc,Andreu,1974-05-23,52965688T,marc.andreu@coolcloud.app,939777,ES43209578608750974410,5585.9,2023-09-27T15:27:45,Barcelona,expenses,travel,-323.04,-51871.89
buyer_4,Marc,Andreu,1974-05-23,52965688T,marc.andreu@coolcloud.app,939777,ES43209578608750974410,5585.9,2023-09-29T16:39:53,Barcelona,expenses,transport,-64.6,-51936.49
buyer_4,Marc,Andreu,1974-05-23,52965688T,marc.andreu@coolcloud.app,939777,ES43209578608750974410,5585.9,2023-09-30T16:40:51,Barcelona,expenses,food,-101.0,-52037.49
buyer_4,Marc,Andreu,1974-05-23,52965688T,marc.andreu@coolcloud.app,939777,ES43209578608750974410,5585.9,2023-10-01T20:13:41,Barcelona,incomes,salary,1318.43,-50719.06
buyer_4,Marc,Andreu,1974-05-23,52965688T,marc.andreu@coolcloud.app,939777,ES43209578608750974410,5585.9,2023-10-01T20:13:41,Barcelona,incomes,extra_income,171.57,-50547.49
buyer_4,Marc,Andreu,1974-05-23,52965688T,marc.andreu@coolcloud.app,939777,ES43209578608750974410,5585.9,2023-10-01T11:49:24,Barcelona,expenses,gifts,-399.4,-50946.89
buyer_4,Marc,Andreu,1974-05-23,52965688T,marc.andreu@coolcloud.app,939777,ES43209578608750974410,5585.9,2023-10-03T18:50:18,Barcelona,expenses,transport,-78.69,-51025.58
buyer_4,Marc,Andreu,1974-05-23,52965688T,marc.andreu@coolcloud.app,939777,ES43209578608750974410,5585.9,2023-10-05T12:50:56,Barcelona,expenses,mortgage,-634.0,-51659.58
buyer_4,Marc,Andreu,1974-05-23,52965688T,marc.andreu@coolcloud.app,939777,ES43209578608750974410,5585.9,2023-10-05T20:40:27,Barcelona,expenses,internet,-27.69,-51687.27
buyer_4,Marc,Andreu,1974-05-23,52965688T,marc.andreu@coolcloud.app,939777,ES43209578608750974410,5585.9,2023-10-05T14:25:52,Barcelona,expenses,leisure,-72.72,-51759.99
buyer_4,Marc,Andreu,1974-05-23,52965688T,marc.andreu@coolcloud.app,939777,ES43209578608750974410,5585.9,2023-10-06T08:13:50,Barcelona,expenses,water,-19.42,-51779.41
buyer_4,Marc,Andreu,1974-05-23,52965688T,marc.andreu@coolcloud.app,939777,ES43209578608750974410,5585.9,2023-10-06T22:19:54,Barcelona,expenses,electricity,-18.17,-51797.58
buyer_4,Marc,Andreu,1974-05-23,52965688T,marc.andreu@coolcloud.app,939777,ES43209578608750974410,5585.9,2023-10-06T05:09:14,Barcelona,expenses,gas,-25.7,-51823.28
buyer_4,Marc,Andreu,1974-05-23,52965688T,marc.andreu@coolcloud.app,939777,ES43209578608750974410,5585.9,2023-10-06T18:45:29,Barcelona,expenses,healthcare,-55.88,-51879.16
buyer_4,Marc,Andreu,1974-05-23,52965688T,marc.andreu@coolcloud.app,939777,ES43209578608750974410,5585.9,2023-10-08T12:22:29,Barcelona,expenses,transport,-62.34,-51941.5
buyer_4,Marc,Andreu,1974-05-23,52965688T,marc.andreu@coolcloud.app,939777,ES43209578608750974410,5585.9,2023-10-09T20:22:48,Barcelona,expenses,leisure,-63.04,-52004.54
buyer_4,Marc,Andreu,1974-05-23,52965688T,marc.andreu@coolcloud.app,939777,ES43209578608750974410,5585.9,2023-10-09T17:34:01,Barcelona,expenses,healthcare,-99.66,-52104.2
buyer_4,Marc,Andreu,1974-05-23,52965688T,marc.andreu@coolcloud.app,939777,ES43209578608750974410,5585.9,2023-10-10T23:03:57,Barcelona,expenses,food,-89.96,-52194.16
buyer_4,Marc,Andreu,1974-05-23,52965688T,marc.andreu@coolcloud.app,939777,ES43209578608750974410,5585.9,2023-10-10T12:15:30,Barcelona,expenses,clothing,-128.23,-52322.39
buyer_4,Marc,Andreu,1974-05-23,52965688T,marc.andreu@coolcloud.app,939777,ES43209578608750974410,5585.9,2023-10-11T21:41:21,Barcelona,expenses,food,-99.51,-52421.9
buyer_4,Marc,Andreu,1974-05-23,52965688T,marc.andreu@coolcloud.app,939777,ES43209578608750974410,5585.9,2023-10-14T14:00:08,Barcelona,expenses,food,-68.47,-52490.37
buyer_4,Marc,Andreu,1974-05-23,52965688T,marc.andreu@coolcloud.app,939777,ES43209578608750974410,5585.9,2023-10-14T09:18:25,Barcelona,expenses,cash,-100.0,-52590.37
buyer_4,Marc,Andreu,1974-05-23,52965688T,marc.andreu@coolcloud.app,939777,ES43209578608750974410,5585.9,2023-10-18T08:29:40,Barcelona,expenses,transport,-43.58,-52633.95
buyer_4,Marc,Andreu,1974-05-23,52965688T,marc.andreu@coolcloud.app,939777,ES43209578608750974410,5585.9,2023-10-18T17:31:28,Barcelona,expenses,cash,-100.0,-52733.95
buyer_4,Marc,Andreu,1974-05-23,52965688T,marc.andreu@coolcloud.app,939777,ES43209578608750974410,5585.9,2023-10-20T18:26:37,Barcelona,expenses,leisure,-52.62,-52786.57
buyer_4,Marc,Andreu,1974-05-23,52965688T,marc.andreu@coolcloud.app,939777,ES43209578608750974410,5585.9,2023-10-20T21:31:59,Barcelona,expenses,gifts,-305.38,-53091.95
buyer_4,Marc,Andreu,1974-05-23,52965688T,marc.andreu@coolcloud.app,939777,ES43209578608750974410,5585.9,2023-10-21T11:09:50,Barcelona,expenses,food,-97.19,-53189.14
buyer_4,Marc,Andreu,1974-05-23,52965688T,marc.andreu@coolcloud.app,939777,ES43209578608750974410,5585.9,2023-10-21T09:16:56,Barcelona,expenses,appliances,-287.23,-53476.37
buyer_4,Marc,Andreu,1974-05-23,52965688T,marc.andreu@coolcloud.app,939777,ES43209578608750974410,5585.9,2023-10-22T14:53:08,Barcelona,expenses,repairs,-123.52,-53599.89
buyer_4,Marc,Andreu,1974-05-23,52965688T,marc.andreu@coolcloud.app,939777,ES43209578608750974410,5585.9,2023-10-23T09:23:08,Barcelona,expenses,transport,-45.41,-53645.3
buyer_4,Marc,Andreu,1974-05-23,52965688T,marc.andreu@coolcloud.app,939777,ES43209578608750974410,5585.9,2023-10-23T19:47:27,Barcelona,expenses,appliances,-180.4,-53825.7
buyer_4,Marc,Andreu,1974-05-23,52965688T,marc.andreu@coolcloud.app,939777,ES43209578608750974410,5585.9,2023-10-29T17:13:37,Barcelona,expenses,gifts,-154.56,-53980.26
buyer_4,Marc,Andreu,1974-05-23,52965688T,marc.andreu@coolcloud.app,939777,ES43209578608750974410,5585.9,2023-10-31T09:03:24,Barcelona,expenses,cash,-100.0,-54080.26
buyer_4,Marc,Andreu,1974-05-23,52965688T,marc.andreu@coolcloud.app,939777,ES43209578608750974410,5585.9,2023-11-01T08:13:12,Barcelona,incomes,salary,1318.43,-52761.83
buyer_4,Marc,Andreu,1974-05-23,52965688T,marc.andreu@coolcloud.app,939777,ES43209578608750974410,5585.9,2023-11-01T11:47:26,Barcelona,expenses,food,-112.94,-52874.77
buyer_4,Marc,Andreu,1974-05-23,52965688T,marc.andreu@coolcloud.app,939777,ES43209578608750974410,5585.9,2023-11-02T21:03:51,Barcelona,expenses,healthcare,-61.13,-52935.9
buyer_4,Marc,Andreu,1974-05-23,52965688T,marc.andreu@coolcloud.app,939777,ES43209578608750974410,5585.9,2023-11-04T16:26:53,Barcelona,expenses,food,-72.98,-53008.88
buyer_4,Marc,Andreu,1974-05-23,52965688T,marc.andreu@coolcloud.app,939777,ES43209578608750974410,5585.9,2023-11-05T12:11:24,Barcelona,expenses,mortgage,-634.0,-53642.88
buyer_4,Marc,Andreu,1974-05-23,52965688T,marc.andreu@coolcloud.app,939777,ES43209578608750974410,5585.9,2023-11-05T19:27:03,Barcelona,expenses,electricity,-29.94,-53672.82
buyer_4,Marc,Andreu,1974-05-23,52965688T,marc.andreu@coolcloud.app,939777,ES43209578608750974410,5585.9,2023-11-05T15:07:48,Barcelona,expenses,gas,-63.13,-53735.95
buyer_4,Marc,Andreu,1974-05-23,52965688T,marc.andreu@coolcloud.app,939777,ES43209578608750974410,5585.9,2023-11-05T08:40:32,Barcelona,expenses,phone,-27.35,-53763.3
buyer_4,Marc,Andreu,1974-05-23,52965688T,marc.andreu@coolcloud.app,939777,ES43209578608750974410,5585.9,2023-11-06T19:54:46,Barcelona,expenses,phone,-26.53,-53789.83
buyer_4,Marc,Andreu,1974-05-23,52965688T,marc.andreu@coolcloud.app,939777,ES43209578608750974410,5585.9,2023-11-06T16:56:21,Barcelona,expenses,clothing,-118.09,-53907.92
buyer_4,Marc,Andreu,1974-05-23,52965688T,marc.andreu@coolcloud.app,939777,ES43209578608750974410,5585.9,2023-11-07T12:22:33,Barcelona,expenses,internet,-27.69,-53935.61
buyer_4,Marc,Andreu,1974-05-23,52965688T,marc.andreu@coolcloud.app,939777,ES43209578608750974410,5585.9,2023-11-07T19:29:47,Barcelona,expenses,leisure,-38.21,-53973.82
buyer_4,Marc,Andreu,1974-05-23,52965688T,marc.andreu@coolcloud.app,939777,ES43209578608750974410,5585.9,2023-11-08T15:09:20,Barcelona,expenses,education,-65.11,-54038.93
buyer_4,Marc,Andreu,1974-05-23,52965688T,marc.andreu@coolcloud.app,939777,ES43209578608750974410,5585.9,2023-11-08T17:43:21,Barcelona,expenses,cash,-100.0,-54138.93
buyer_4,Marc,Andreu,1974-05-23,52965688T,marc.andreu@coolcloud.app,939777,ES43209578608750974410,5585.9,2023-11-10T11:01:05,Barcelona,expenses,clothing,-71.57,-54210.5
buyer_4,Marc,Andreu,1974-05-23,52965688T,marc.andreu@coolcloud.app,939777,ES43209578608750974410,5585.9,2023-11-10T13:45:57,Barcelona,expenses,cash,-100.0,-54310.5
buyer_4,Marc,Andreu,1974-05-23,52965688T,marc.andreu@coolcloud.app,939777,ES43209578608750974410,5585.9,2023-11-12T15:58:52,Barcelona,expenses,food,-71.83,-54382.33
buyer_4,Marc,Andreu,1974-05-23,52965688T,marc.andreu@coolcloud.app,939777,ES43209578608750974410,5585.9,2023-11-14T07:51:54,Barcelona,expenses,food,-61.48,-54443.81
buyer_4,Marc,Andreu,1974-05-23,52965688T,marc.andreu@coolcloud.app,939777,ES43209578608750974410,5585.9,2023-11-17T10:46:33,Barcelona,expenses,leisure,-41.48,-54485.29
buyer_4,Marc,Andreu,1974-05-23,52965688T,marc.andreu@coolcloud.app,939777,ES43209578608750974410,5585.9,2023-11-18T17:34:33,Barcelona,expenses,food,-73.73,-54559.02
buyer_4,Marc,Andreu,1974-05-23,52965688T,marc.andreu@coolcloud.app,939777,ES43209578608750974410,5585.9,2023-11-18T17:24:34,Barcelona,expenses,cash,-100.0,-54659.02
buyer_4,Marc,Andreu,1974-05-23,52965688T,marc.andreu@coolcloud.app,939777,ES43209578608750974410,5585.9,2023-11-19T17:34:50,Barcelona,expenses,food,-72.93,-54731.95
buyer_4,Marc,Andreu,1974-05-23,52965688T,marc.andreu@coolcloud.app,939777,ES43209578608750974410,5585.9,2023-11-19T10:15:10,Barcelona,expenses,cash,-100.0,-54831.95
buyer_4,Marc,Andreu,1974-05-23,52965688T,marc.andreu@coolcloud.app,939777,ES43209578608750974410,5585.9,2023-11-21T09:08:00,Barcelona,expenses,repairs,-218.67,-55050.62
buyer_4,Marc,Andreu,1974-05-23,52965688T,marc.andreu@coolcloud.app,939777,ES43209578608750974410,5585.9,2023-11-22T18:33:56,Barcelona,expenses,transport,-42.8,-55093.42
buyer_4,Marc,Andreu,1974-05-23,52965688T,marc.andreu@coolcloud.app,939777,ES43209578608750974410,5585.9,2023-11-25T12:14:12,Barcelona,expenses,transport,-49.38,-55142.8
buyer_4,Marc,Andreu,1974-05-23,52965688T,marc.andreu@coolcloud.app,939777,ES43209578608750974410,5585.9,2023-11-25T09:22:38,Barcelona,expenses,gifts,-156.64,-55299.44
buyer_4,Marc,Andreu,1974-05-23,52965688T,marc.andreu@coolcloud.app,939777,ES43209578608750974410,5585.9,2023-11-26T08:57:35,Barcelona,expenses,food,-65.49,-55364.93
buyer_4,Marc,Andreu,1974-05-23,52965688T,marc.andreu@coolcloud.app,939777,ES43209578608750974410,5585.9,2023-11-26T15:01:48,Barcelona,expenses,leisure,-83.74,-55448.67
buyer_4,Marc,Andreu,1974-05-23,52965688T,marc.andreu@coolcloud.app,939777,ES43209578608750974410,5585.9,2023-11-26T14:13:18,Barcelona,expenses,cash,-100.0,-55548.67
buyer_4,Marc,Andreu,1974-05-23,52965688T,marc.andreu@coolcloud.app,939777,ES43209578608750974410,5585.9,2023-11-28T17:21:44,Barcelona,expenses,appliances,-152.58,-55701.25
buyer_4,Marc,Andreu,1974-05-23,52965688T,marc.andreu@coolcloud.app,939777,ES43209578608750974410,5585.9,2023-11-29T05:28:33,Barcelona,expenses,children,-475.64549999999986,-56176.9
buyer_4,Marc,Andreu,1974-05-23,52965688T,marc.andreu@coolcloud.app,939777,ES43209578608750974410,5585.9,2023-12-01T21:03:54,Barcelona,incomes,salary,1318.43,-54858.47
buyer_4,Marc,Andreu,1974-05-23,52965688T,marc.andreu@coolcloud.app,939777,ES43209578608750974410,5585.9,2023-12-01T21:03:54,Barcelona,incomes,salary_bonus,957.11,-53901.36
buyer_4,Marc,Andreu,1974-05-23,52965688T,marc.andreu@coolcloud.app,939777,ES43209578608750974410,5585.9,2023-12-01T14:28:55,Barcelona,expenses,food,-92.55,-53993.91
buyer_4,Marc,Andreu,1974-05-23,52965688T,marc.andreu@coolcloud.app,939777,ES43209578608750974410,5585.9,2023-12-01T13:51:03,Barcelona,expenses,gifts,-315.87,-54309.78
buyer_4,Marc,Andreu,1974-05-23,52965688T,marc.andreu@coolcloud.app,939777,ES43209578608750974410,5585.9,2023-12-02T08:16:57,Barcelona,expenses,leisure,-63.77,-54373.55
buyer_4,Marc,Andreu,1974-05-23,52965688T,marc.andreu@coolcloud.app,939777,ES43209578608750974410,5585.9,2023-12-02T14:08:30,Barcelona,expenses,healthcare,-179.02,-54552.57
buyer_4,Marc,Andreu,1974-05-23,52965688T,marc.andreu@coolcloud.app,939777,ES43209578608750974410,5585.9,2023-12-03T19:47:32,Barcelona,expenses,leisure,-46.76,-54599.33
buyer_4,Marc,Andreu,1974-05-23,52965688T,marc.andreu@coolcloud.app,939777,ES43209578608750974410,5585.9,2023-12-03T01:33:54,Barcelona,expenses,children,-428.88549999999987,-55028.22
buyer_4,Marc,Andreu,1974-05-23,52965688T,marc.andreu@coolcloud.app,939777,ES43209578608750974410,5585.9,2023-12-04T11:47:53,Barcelona,expenses,leisure,-45.88,-55074.1
buyer_4,Marc,Andreu,1974-05-23,52965688T,marc.andreu@coolcloud.app,939777,ES43209578608750974410,5585.9,2023-12-04T19:18:01,Barcelona,expenses,cash,-100.0,-55174.1
buyer_4,Marc,Andreu,1974-05-23,52965688T,marc.andreu@coolcloud.app,939777,ES43209578608750974410,5585.9,2023-12-05T18:45:39,Barcelona,expenses,mortgage,-634.0,-55808.1
buyer_4,Marc,Andreu,1974-05-23,52965688T,marc.andreu@coolcloud.app,939777,ES43209578608750974410,5585.9,2023-12-05T12:24:36,Barcelona,expenses,water,-19.52,-55827.62
buyer_4,Marc,Andreu,1974-05-23,52965688T,marc.andreu@coolcloud.app,939777,ES43209578608750974410,5585.9,2023-12-05T08:48:33,Barcelona,expenses,gas,-26.26,-55853.88
buyer_4,Marc,Andreu,1974-05-23,52965688T,marc.andreu@coolcloud.app,939777,ES43209578608750974410,5585.9,2023-12-05T12:53:37,Barcelona,expenses,phone,-23.35,-55877.23
buyer_4,Marc,Andreu,1974-05-23,52965688T,marc.andreu@coolcloud.app,939777,ES43209578608750974410,5585.9,2023-12-05T08:49:02,Barcelona,expenses,food,-89.26,-55966.49
buyer_4,Marc,Andreu,1974-05-23,52965688T,marc.andreu@coolcloud.app,939777,ES43209578608750974410,5585.9,2023-12-06T17:37:57,Barcelona,expenses,water,-16.82,-55983.31
buyer_4,Marc,Andreu,1974-05-23,52965688T,marc.andreu@coolcloud.app,939777,ES43209578608750974410,5585.9,2023-12-06T08:21:50,Barcelona,expenses,gas,-53.68,-56036.99
buyer_4,Marc,Andreu,1974-05-23,52965688T,marc.andreu@coolcloud.app,939777,ES43209578608750974410,5585.9,2023-12-06T12:51:16,Barcelona,expenses,internet,-27.69,-56064.68
buyer_4,Marc,Andreu,1974-05-23,52965688T,marc.andreu@coolcloud.app,939777,ES43209578608750974410,5585.9,2023-12-06T20:15:13,Barcelona,expenses,repairs,-311.65,-56376.33
buyer_4,Marc,Andreu,1974-05-23,52965688T,marc.andreu@coolcloud.app,939777,ES43209578608750974410,5585.9,2023-12-07T08:13:10,Barcelona,expenses,phone,-19.88,-56396.21
buyer_4,Marc,Andreu,1974-05-23,52965688T,marc.andreu@coolcloud.app,939777,ES43209578608750974410,5585.9,2023-12-08T11:36:05,Barcelona,expenses,gas,-57.49,-56453.7
buyer_4,Marc,Andreu,1974-05-23,52965688T,marc.andreu@coolcloud.app,939777,ES43209578608750974410,5585.9,2023-12-08T22:05:08,Barcelona,expenses,transport,-78.46,-56532.16
buyer_4,Marc,Andreu,1974-05-23,52965688T,marc.andreu@coolcloud.app,939777,ES43209578608750974410,5585.9,2023-12-08T12:51:05,Barcelona,expenses,cash,-100.0,-56632.16
buyer_4,Marc,Andreu,1974-05-23,52965688T,marc.andreu@coolcloud.app,939777,ES43209578608750974410,5585.9,2023-12-08T17:38:18,Barcelona,expenses,repairs,-72.0,-56704.16
buyer_4,Marc,Andreu,1974-05-23,52965688T,marc.andreu@coolcloud.app,939777,ES43209578608750974410,5585.9,2023-12-08T04:15:16,Barcelona,expenses,children,-225.18549999999988,-56929.35
buyer_4,Marc,Andreu,1974-05-23,52965688T,marc.andreu@coolcloud.app,939777,ES43209578608750974410,5585.9,2023-12-09T15:04:35,Barcelona,expenses,food,-106.9,-57036.25
buyer_4,Marc,Andreu,1974-05-23,52965688T,marc.andreu@coolcloud.app,939777,ES43209578608750974410,5585.9,2023-12-09T14:54:09,Barcelona,expenses,leisure,-74.23,-57110.48
buyer_4,Marc,Andreu,1974-05-23,52965688T,marc.andreu@coolcloud.app,939777,ES43209578608750974410,5585.9,2023-12-09T10:00:15,Barcelona,expenses,appliances,-275.48,-57385.96
buyer_4,Marc,Andreu,1974-05-23,52965688T,marc.andreu@coolcloud.app,939777,ES43209578608750974410,5585.9,2023-12-10T14:36:40,Barcelona,expenses,food,-61.12,-57447.08
buyer_4,Marc,Andreu,1974-05-23,52965688T,marc.andreu@coolcloud.app,939777,ES43209578608750974410,5585.9,2023-12-11T10:18:17,Barcelona,expenses,leisure,-81.83,-57528.91
buyer_4,Marc,Andreu,1974-05-23,52965688T,marc.andreu@coolcloud.app,939777,ES43209578608750974410,5585.9,2023-12-12T20:04:04,Barcelona,expenses,education,-75.18,-57604.09
buyer_4,Marc,Andreu,1974-05-23,52965688T,marc.andreu@coolcloud.app,939777,ES43209578608750974410,5585.9,2023-12-14T05:52:30,Barcelona,expenses,gifts,-412.7,-58016.79
buyer_4,Marc,Andreu,1974-05-23,52965688T,marc.andreu@coolcloud.app,939777,ES43209578608750974410,5585.9,2023-12-15T13:25:41,Barcelona,expenses,cash,-100.0,-58116.79
buyer_4,Marc,Andreu,1974-05-23,52965688T,marc.andreu@coolcloud.app,939777,ES43209578608750974410,5585.9,2023-12-16T13:01:03,Barcelona,expenses,food,-103.36,-58220.15
buyer_4,Marc,Andreu,1974-05-23,52965688T,marc.andreu@coolcloud.app,939777,ES43209578608750974410,5585.9,2023-12-17T16:01:04,Barcelona,expenses,gifts,-197.05,-58417.2
buyer_4,Marc,Andreu,1974-05-23,52965688T,marc.andreu@coolcloud.app,939777,ES43209578608750974410,5585.9,2023-12-18T16:10:54,Barcelona,expenses,repairs,-197.15,-58614.35
buyer_4,Marc,Andreu,1974-05-23,52965688T,marc.andreu@coolcloud.app,939777,ES43209578608750974410,5585.9,2023-12-19T19:57:45,Barcelona,expenses,cash,-100.0,-58714.35
buyer_4,Marc,Andreu,1974-05-23,52965688T,marc.andreu@coolcloud.app,939777,ES43209578608750974410,5585.9,2023-12-21T15:52:30,Barcelona,expenses,gifts,-256.98,-58971.33
buyer_4,Marc,Andreu,1974-05-23,52965688T,marc.andreu@coolcloud.app,939777,ES43209578608750974410,5585.9,2023-12-24T10:25:32,Barcelona,expenses,gifts,-324.71,-59296.04
buyer_4,Marc,Andreu,1974-05-23,52965688T,marc.andreu@coolcloud.app,939777,ES43209578608750974410,5585.9,2023-12-28T05:08:34,Barcelona,expenses,cash,-100.0,-59396.04
buyer_4,Marc,Andreu,1974-05-23,52965688T,marc.andreu@coolcloud.app,939777,ES43209578608750974410,5585.9,2023-12-29T20:45:02,Barcelona,expenses,clothing,-106.34,-59502.38
buyer_4,Marc,Andreu,1974-05-23,52965688T,marc.andreu@coolcloud.app,939777,ES43209578608750974410,5585.9,2023-12-31T13:21:00,Barcelona,expenses,clothing,-77.45,-59579.83
buyer_4,Marc,Andreu,1974-05-23,52965688T,marc.andreu@coolcloud.app,939777,ES43209578608750974410,5585.9,2023-12-31T20:51:01,Barcelona,expenses,repairs,-197.79,-59777.62
buyer_4,Marc,Andreu,1974-05-23,52965688T,marc.andreu@coolcloud.app,939777,ES43209578608750974410,5585.9,2024-01-01T18:37:32,Barcelona,incomes,salary,1354.33,-58423.29
buyer_4,Marc,Andreu,1974-05-23,52965688T,marc.andreu@coolcloud.app,939777,ES43209578608750974410,5585.9,2024-01-01T00:13:15,Barcelona,expenses,cash,-100.0,-58523.29
buyer_4,Marc,Andreu,1974-05-23,52965688T,marc.andreu@coolcloud.app,939777,ES43209578608750974410,5585.9,2024-01-02T19:47:05,Barcelona,expenses,cash,-100.0,-58623.29
buyer_4,Marc,Andreu,1974-05-23,52965688T,marc.andreu@coolcloud.app,939777,ES43209578608750974410,5585.9,2024-01-03T18:26:50,Barcelona,expenses,education,-57.75,-58681.04
buyer_4,Marc,Andreu,1974-05-23,52965688T,marc.andreu@coolcloud.app,939777,ES43209578608750974410,5585.9,2024-01-05T17:56:18,Barcelona,expenses,mortgage,-508.37,-59189.41
buyer_4,Marc,Andreu,1974-05-23,52965688T,marc.andreu@coolcloud.app,939777,ES43209578608750974410,5585.9,2024-01-05T16:34:27,Barcelona,expenses,gas,-72.03,-59261.44
buyer_4,Marc,Andreu,1974-05-23,52965688T,marc.andreu@coolcloud.app,939777,ES43209578608750974410,5585.9,2024-01-06T18:35:43,Barcelona,expenses,electricity,-31.53,-59292.97
buyer_4,Marc,Andreu,1974-05-23,52965688T,marc.andreu@coolcloud.app,939777,ES43209578608750974410,5585.9,2024-01-06T12:37:29,Barcelona,expenses,internet,-28.44,-59321.41
buyer_4,Marc,Andreu,1974-05-23,52965688T,marc.andreu@coolcloud.app,939777,ES43209578608750974410,5585.9,2024-01-06T20:27:12,Barcelona,expenses,phone,-25.72,-59347.13
buyer_4,Marc,Andreu,1974-05-23,52965688T,marc.andreu@coolcloud.app,939777,ES43209578608750974410,5585.9,2024-01-06T12:03:51,Barcelona,expenses,food,-95.86,-59442.99
buyer_4,Marc,Andreu,1974-05-23,52965688T,marc.andreu@coolcloud.app,939777,ES43209578608750974410,5585.9,2024-01-06T20:23:06,Barcelona,expenses,repairs,-229.12,-59672.11
buyer_4,Marc,Andreu,1974-05-23,52965688T,marc.andreu@coolcloud.app,939777,ES43209578608750974410,5585.9,2024-01-07T10:50:50,Barcelona,expenses,water,-15.73,-59687.84
buyer_4,Marc,Andreu,1974-05-23,52965688T,marc.andreu@coolcloud.app,939777,ES43209578608750974410,5585.9,2024-01-08T21:46:22,Barcelona,expenses,water,-15.34,-59703.18
buyer_4,Marc,Andreu,1974-05-23,52965688T,marc.andreu@coolcloud.app,939777,ES43209578608750974410,5585.9,2024-01-08T19:59:11,Barcelona,expenses,electricity,-43.65,-59746.83
buyer_4,Marc,Andreu,1974-05-23,52965688T,marc.andreu@coolcloud.app,939777,ES43209578608750974410,5585.9,2024-01-09T15:48:06,Barcelona,expenses,repairs,-149.46,-59896.29
buyer_4,Marc,Andreu,1974-05-23,52965688T,marc.andreu@coolcloud.app,939777,ES43209578608750974410,5585.9,2024-01-10T20:59:45,Barcelona,expenses,leisure,-25.81,-59922.1
buyer_4,Marc,Andreu,1974-05-23,52965688T,marc.andreu@coolcloud.app,939777,ES43209578608750974410,5585.9,2024-01-11T20:10:51,Barcelona,expenses,food,-113.58,-60035.68
buyer_4,Marc,Andreu,1974-05-23,52965688T,marc.andreu@coolcloud.app,939777,ES43209578608750974410,5585.9,2024-01-11T16:53:55,Barcelona,expenses,leisure,-40.31,-60075.99
buyer_4,Marc,Andreu,1974-05-23,52965688T,marc.andreu@coolcloud.app,939777,ES43209578608750974410,5585.9,2024-01-12T23:45:21,Barcelona,expenses,gifts,-382.09,-60458.08
buyer_4,Marc,Andreu,1974-05-23,52965688T,marc.andreu@coolcloud.app,939777,ES43209578608750974410,5585.9,2024-01-16T15:08:18,Barcelona,expenses,cash,-100.0,-60558.08
buyer_4,Marc,Andreu,1974-05-23,52965688T,marc.andreu@coolcloud.app,939777,ES43209578608750974410,5585.9,2024-01-18T17:23:27,Barcelona,expenses,transport,-59.49,-60617.57
buyer_4,Marc,Andreu,1974-05-23,52965688T,marc.andreu@coolcloud.app,939777,ES43209578608750974410,5585.9,2024-01-18T13:48:21,Barcelona,expenses,healthcare,-138.57,-60756.14
buyer_4,Marc,Andreu,1974-05-23,52965688T,marc.andreu@coolcloud.app,939777,ES43209578608750974410,5585.9,2024-01-19T20:16:54,Barcelona,expenses,cash,-100.0,-60856.14
buyer_4,Marc,Andreu,1974-05-23,52965688T,marc.andreu@coolcloud.app,939777,ES43209578608750974410,5585.9,2024-01-22T19:37:03,Barcelona,expenses,clothing,-61.5,-60917.64
buyer_4,Marc,Andreu,1974-05-23,52965688T,marc.andreu@coolcloud.app,939777,ES43209578608750974410,5585.9,2024-01-23T17:34:44,Barcelona,expenses,repairs,-101.58,-61019.22
buyer_4,Marc,Andreu,1974-05-23,52965688T,marc.andreu@coolcloud.app,939777,ES43209578608750974410,5585.9,2024-01-27T13:17:08,Barcelona,expenses,leisure,-59.2,-61078.42
buyer_4,Marc,Andreu,1974-05-23,52965688T,marc.andreu@coolcloud.app,939777,ES43209578608750974410,5585.9,2024-01-27T11:24:22,Barcelona,expenses,cash,-100.0,-61178.42
buyer_4,Marc,Andreu,1974-05-23,52965688T,marc.andreu@coolcloud.app,939777,ES43209578608750974410,5585.9,2024-01-29T17:53:22,Barcelona,expenses,cash,-100.0,-61278.42
buyer_4,Marc,Andreu,1974-05-23,52965688T,marc.andreu@coolcloud.app,939777,ES43209578608750974410,5585.9,2024-01-31T17:37:43,Barcelona,expenses,children,-640.2009166666667,-61918.62
buyer_4,Marc,Andreu,1974-05-23,52965688T,marc.andreu@coolcloud.app,939777,ES43209578608750974410,5585.9,2024-02-01T20:49:37,Barcelona,incomes,salary,1354.33,-60564.29
buyer_4,Marc,Andreu,1974-05-23,52965688T,marc.andreu@coolcloud.app,939777,ES43209578608750974410,5585.9,2024-02-01T20:49:37,Barcelona,incomes,extra_income,171.57,-60392.72
buyer_4,Marc,Andreu,1974-05-23,52965688T,marc.andreu@coolcloud.app,939777,ES43209578608750974410,5585.9,2024-02-03T15:23:11,Barcelona,expenses,clothing,-121.57,-60514.29
buyer_4,Marc,Andreu,1974-05-23,52965688T,marc.andreu@coolcloud.app,939777,ES43209578608750974410,5585.9,2024-02-03T15:50:26,Barcelona,expenses,cash,-100.0,-60614.29
buyer_4,Marc,Andreu,1974-05-23,52965688T,marc.andreu@coolcloud.app,939777,ES43209578608750974410,5585.9,2024-02-04T20:51:49,Barcelona,expenses,food,-78.92,-60693.21
buyer_4,Marc,Andreu,1974-05-23,52965688T,marc.andreu@coolcloud.app,939777,ES43209578608750974410,5585.9,2024-02-05T17:54:39,Barcelona,expenses,mortgage,-508.37,-61201.58
buyer_4,Marc,Andreu,1974-05-23,52965688T,marc.andreu@coolcloud.app,939777,ES43209578608750974410,5585.9,2024-02-05T02:41:26,Barcelona,expenses,children,-383.57,-61585.15
buyer_4,Marc,Andreu,1974-05-23,52965688T,marc.andreu@coolcloud.app,939777,ES43209578608750974410,5585.9,2024-02-06T08:02:57,Barcelona,expenses,education,-43.57,-61628.72
buyer_4,Marc,Andreu,1974-05-23,52965688T,marc.andreu@coolcloud.app,939777,ES43209578608750974410,5585.9,2024-02-06T08:29:49,Barcelona,expenses,children,-596.6309166666666,-62225.35
buyer_4,Marc,Andreu,1974-05-23,52965688T,marc.andreu@coolcloud.app,939777,ES43209578608750974410,5585.9,2024-02-07T18:06:55,Barcelona,expenses,internet,-28.44,-62253.79
buyer_4,Marc,Andreu,1974-05-23,52965688T,marc.andreu@coolcloud.app,939777,ES43209578608750974410,5585.9,2024-02-07T16:25:56,Barcelona,expenses,transport,-69.76,-62323.55
buyer_4,Marc,Andreu,1974-05-23,52965688T,marc.andreu@coolcloud.app,939777,ES43209578608750974410,5585.9,2024-02-07T10:16:37,Barcelona,expenses,education,-47.54,-62371.09
buyer_4,Marc,Andreu,1974-05-23,52965688T,marc.andreu@coolcloud.app,939777,ES43209578608750974410,5585.9,2024-02-07T20:50:57,Barcelona,expenses,cash,-100.0,-62471.09
buyer_4,Marc,Andreu,1974-05-23,52965688T,marc.andreu@coolcloud.app,939777,ES43209578608750974410,5585.9,2024-02-08T14:53:29,Barcelona,expenses,food,-119.07,-62590.16
buyer_4,Marc,Andreu,1974-05-23,52965688T,marc.andreu@coolcloud.app,939777,ES43209578608750974410,5585.9,2024-02-10T13:40:20,Barcelona,expenses,transport,-49.83,-62639.99
buyer_4,Marc,Andreu,1974-05-23,52965688T,marc.andreu@coolcloud.app,939777,ES43209578608750974410,5585.9,2024-02-15T15:21:07,Barcelona,expenses,transport,-45.8,-62685.79
buyer_4,Marc,Andreu,1974-05-23,52965688T,marc.andreu@coolcloud.app,939777,ES43209578608750974410,5585.9,2024-02-15T20:16:12,Barcelona,expenses,car,-236.71,-62922.5
buyer_4,Marc,Andreu,1974-05-23,52965688T,marc.andreu@coolcloud.app,939777,ES43209578608750974410,5585.9,2024-02-16T10:03:19,Barcelona,expenses,cash,-100.0,-63022.5
buyer_4,Marc,Andreu,1974-05-23,52965688T,marc.andreu@coolcloud.app,939777,ES43209578608750974410,5585.9,2024-02-17T12:10:51,Barcelona,expenses,appliances,-280.62,-63303.12
buyer_4,Marc,Andreu,1974-05-23,52965688T,marc.andreu@coolcloud.app,939777,ES43209578608750974410,5585.9,2024-02-18T17:55:07,Barcelona,expenses,gifts,-70.52,-63373.64
buyer_4,Marc,Andreu,1974-05-23,52965688T,marc.andreu@coolcloud.app,939777,ES43209578608750974410,5585.9,2024-02-22T10:51:48,Barcelona,expenses,education,-63.77,-63437.41
buyer_4,Marc,Andreu,1974-05-23,52965688T,marc.andreu@coolcloud.app,939777,ES43209578608750974410,5585.9,2024-02-25T09:10:08,Barcelona,expenses,leisure,-19.65,-63457.06
buyer_4,Marc,Andreu,1974-05-23,52965688T,marc.andreu@coolcloud.app,939777,ES43209578608750974410,5585.9,2024-02-25T18:41:58,Barcelona,expenses,cash,-100.0,-63557.06
buyer_4,Marc,Andreu,1974-05-23,52965688T,marc.andreu@coolcloud.app,939777,ES43209578608750974410,5585.9,2024-02-26T21:33:16,Barcelona,expenses,leisure,-28.91,-63585.97
buyer_4,Marc,Andreu,1974-05-23,52965688T,marc.andreu@coolcloud.app,939777,ES43209578608750974410,5585.9,2024-02-28T10:49:03,Barcelona,expenses,food,-113.76,-63699.73
buyer_4,Marc,Andreu,1974-05-23,52965688T,marc.andreu@coolcloud.app,939777,ES43209578608750974410,5585.9,2024-02-28T23:03:49,Barcelona,expenses,gifts,-284.4,-63984.13
buyer_4,Marc,Andreu,1974-05-23,52965688T,marc.andreu@coolcloud.app,939777,ES43209578608750974410,5585.9,2024-03-01T11:59:12,Barcelona,incomes,salary,1354.33,-62629.8
buyer_4,Marc,Andreu,1974-05-23,52965688T,marc.andreu@coolcloud.app,939777,ES43209578608750974410,5585.9,2024-03-01T15:32:13,Barcelona,expenses,education,-54.63,-62684.43
buyer_4,Marc,Andreu,1974-05-23,52965688T,marc.andreu@coolcloud.app,939777,ES43209578608750974410,5585.9,2024-03-03T18:06:02,Barcelona,expenses,transport,-61.64,-62746.07
buyer_4,Marc,Andreu,1974-05-23,52965688T,marc.andreu@coolcloud.app,939777,ES43209578608750974410,5585.9,2024-03-03T15:53:30,Barcelona,expenses,leisure,-62.33,-62808.4
buyer_4,Marc,Andreu,1974-05-23,52965688T,marc.andreu@coolcloud.app,939777,ES43209578608750974410,5585.9,2024-03-04T14:26:18,Barcelona,expenses,food,-113.42,-62921.82
buyer_4,Marc,Andreu,1974-05-23,52965688T,marc.andreu@coolcloud.app,939777,ES43209578608750974410,5585.9,2024-03-05T20:32:23,Barcelona,expenses,mortgage,-508.37,-63430.19
buyer_4,Marc,Andreu,1974-05-23,52965688T,marc.andreu@coolcloud.app,939777,ES43209578608750974410,5585.9,2024-03-05T15:59:01,Barcelona,expenses,internet,-28.44,-63458.63
buyer_4,Marc,Andreu,1974-05-23,52965688T,marc.andreu@coolcloud.app,939777,ES43209578608750974410,5585.9,2024-03-05T15:05:27,Barcelona,expenses,food,-107.26,-63565.89
buyer_4,Marc,Andreu,1974-05-23,52965688T,marc.andreu@coolcloud.app,939777,ES43209578608750974410,5585.9,2024-03-06T10:45:16,Barcelona,expenses,internet,-28.44,-63594.33
buyer_4,Marc,Andreu,1974-05-23,52965688T,marc.andreu@coolcloud.app,939777,ES43209578608750974410,5585.9,2024-03-07T12:35:08,Barcelona,expenses,electricity,-31.22,-63625.55
buyer_4,Marc,Andreu,1974-05-23,52965688T,marc.andreu@coolcloud.app,939777,ES43209578608750974410,5585.9,2024-03-07T18:19:10,Barcelona,expenses,internet,-28.44,-63653.99
buyer_4,Marc,Andreu,1974-05-23,52965688T,marc.andreu@coolcloud.app,939777,ES43209578608750974410,5585.9,2024-03-07T11:24:34,Barcelona,expenses,phone,-20.83,-63674.82
buyer_4,Marc,Andreu,1974-05-23,52965688T,marc.andreu@coolcloud.app,939777,ES43209578608750974410,5585.9,2024-03-07T21:30:46,Barcelona,expenses,clothing,-122.45,-63797.27
buyer_4,Marc,Andreu,1974-05-23,52965688T,marc.andreu@coolcloud.app,939777,ES43209578608750974410,5585.9,2024-03-07T09:18:02,Barcelona,expenses,repairs,-139.6,-63936.87
buyer_4,Marc,Andreu,1974-05-23,52965688T,marc.andreu@coolcloud.app,939777,ES43209578608750974410,5585.9,2024-03-08T04:09:19,Barcelona,expenses,gas,-66.79,-64003.66
buyer_4,Marc,Andreu,1974-05-23,52965688T,marc.andreu@coolcloud.app,939777,ES43209578608750974410,5585.9,2024-03-08T16:56:53,Barcelona,expenses,leisure,-80.69,-64084.35
buyer_4,Marc,Andreu,1974-05-23,52965688T,marc.andreu@coolcloud.app,939777,ES43209578608750974410,5585.9,2024-03-08T10:32:17,Barcelona,expenses,children,-559.5109166666666,-64643.86
buyer_4,Marc,Andreu,1974-05-23,52965688T,marc.andreu@coolcloud.app,939777,ES43209578608750974410,5585.9,2024-03-09T15:03:01,Barcelona,expenses,cash,-100.0,-64743.86
buyer_4,Marc,Andreu,1974-05-23,52965688T,marc.andreu@coolcloud.app,939777,ES43209578608750974410,5585.9,2024-03-11T21:21:36,Barcelona,expenses,leisure,-49.28,-64793.14
buyer_4,Marc,Andreu,1974-05-23,52965688T,marc.andreu@coolcloud.app,939777,ES43209578608750974410,5585.9,2024-03-12T13:04:50,Barcelona,expenses,leisure,-69.61,-64862.75
buyer_4,Marc,Andreu,1974-05-23,52965688T,marc.andreu@coolcloud.app,939777,ES43209578608750974410,5585.9,2024-03-12T15:49:11,Barcelona,expenses,appliances,-264.04,-65126.79
buyer_4,Marc,Andreu,1974-05-23,52965688T,marc.andreu@coolcloud.app,939777,ES43209578608750974410,5585.9,2024-03-12T17:00:14,Barcelona,expenses,repairs,-30.53,-65157.32
buyer_4,Marc,Andreu,1974-05-23,52965688T,marc.andreu@coolcloud.app,939777,ES43209578608750974410,5585.9,2024-03-13T11:05:53,Barcelona,expenses,leisure,-34.74,-65192.06
buyer_4,Marc,Andreu,1974-05-23,52965688T,marc.andreu@coolcloud.app,939777,ES43209578608750974410,5585.9,2024-03-15T16:10:10,Barcelona,expenses,travel,-325.89,-65517.95
buyer_4,Marc,Andreu,1974-05-23,52965688T,marc.andreu@coolcloud.app,939777,ES43209578608750974410,5585.9,2024-03-16T19:08:15,Barcelona,expenses,leisure,-54.56,-65572.51
buyer_4,Marc,Andreu,1974-05-23,52965688T,marc.andreu@coolcloud.app,939777,ES43209578608750974410,5585.9,2024-03-18T16:25:28,Barcelona,expenses,food,-116.84,-65689.35
buyer_4,Marc,Andreu,1974-05-23,52965688T,marc.andreu@coolcloud.app,939777,ES43209578608750974410,5585.9,2024-03-18T09:44:17,Barcelona,expenses,gifts,-185.42,-65874.77
buyer_4,Marc,Andreu,1974-05-23,52965688T,marc.andreu@coolcloud.app,939777,ES43209578608750974410,5585.9,2024-03-19T08:14:57,Barcelona,expenses,education,-76.03,-65950.8
buyer_4,Marc,Andreu,1974-05-23,52965688T,marc.andreu@coolcloud.app,939777,ES43209578608750974410,5585.9,2024-03-20T20:16:03,Barcelona,expenses,food,-69.39,-66020.19
buyer_4,Marc,Andreu,1974-05-23,52965688T,marc.andreu@coolcloud.app,939777,ES43209578608750974410,5585.9,2024-03-21T16:44:02,Barcelona,expenses,leisure,-49.28,-66069.47
buyer_4,Marc,Andreu,1974-05-23,52965688T,marc.andreu@coolcloud.app,939777,ES43209578608750974410,5585.9,2024-03-21T13:43:03,Barcelona,expenses,cash,-100.0,-66169.47
buyer_4,Marc,Andreu,1974-05-23,52965688T,marc.andreu@coolcloud.app,939777,ES43209578608750974410,5585.9,2024-03-22T11:43:39,Barcelona,expenses,education,-56.31,-66225.78
buyer_4,Marc,Andreu,1974-05-23,52965688T,marc.andreu@coolcloud.app,939777,ES43209578608750974410,5585.9,2024-03-22T21:18:38,Barcelona,expenses,cash,-100.0,-66325.78
buyer_4,Marc,Andreu,1974-05-23,52965688T,marc.andreu@coolcloud.app,939777,ES43209578608750974410,5585.9,2024-03-24T04:49:19,Barcelona,expenses,food,-109.58,-66435.36
buyer_4,Marc,Andreu,1974-05-23,52965688T,marc.andreu@coolcloud.app,939777,ES43209578608750974410,5585.9,2024-03-24T16:46:00,Barcelona,expenses,education,-75.35,-66510.71
buyer_4,Marc,Andreu,1974-05-23,52965688T,marc.andreu@coolcloud.app,939777,ES43209578608750974410,5585.9,2024-03-25T19:25:55,Barcelona,expenses,cash,-100.0,-66610.71
buyer_4,Marc,Andreu,1974-05-23,52965688T,marc.andreu@coolcloud.app,939777,ES43209578608750974410,5585.9,2024-03-26T14:26:59,Barcelona,expenses,education,-43.6,-66654.31
buyer_4,Marc,Andreu,1974-05-23,52965688T,marc.andreu@coolcloud.app,939777,ES43209578608750974410,5585.9,2024-03-26T19:32:47,Barcelona,expenses,repairs,-188.37,-66842.68
buyer_4,Marc,Andreu,1974-05-23,52965688T,marc.andreu@coolcloud.app,939777,ES43209578608750974410,5585.9,2024-03-27T18:45:42,Barcelona,expenses,travel,-335.82,-67178.5
buyer_4,Marc,Andreu,1974-05-23,52965688T,marc.andreu@coolcloud.app,939777,ES43209578608750974410,5585.9,2024-03-28T21:30:43,Barcelona,expenses,education,-65.42,-67243.92
buyer_4,Marc,Andreu,1974-05-23,52965688T,marc.andreu@coolcloud.app,939777,ES43209578608750974410,5585.9,2024-03-28T17:49:30,Barcelona,expenses,gifts,-180.47,-67424.39
buyer_4,Marc,Andreu,1974-05-23,52965688T,marc.andreu@coolcloud.app,939777,ES43209578608750974410,5585.9,2024-03-29T19:15:48,Barcelona,expenses,food,-114.79,-67539.18
buyer_4,Marc,Andreu,1974-05-23,52965688T,marc.andreu@coolcloud.app,939777,ES43209578608750974410,5585.9,2024-03-31T14:09:38,Barcelona,expenses,transport,-43.23,-67582.41
buyer_4,Marc,Andreu,1974-05-23,52965688T,marc.andreu@coolcloud.app,939777,ES43209578608750974410,5585.9,2024-03-31T07:15:27,Barcelona,expenses,gifts,-424.33,-68006.74
buyer_4,Marc,Andreu,1974-05-23,52965688T,marc.andreu@coolcloud.app,939777,ES43209578608750974410,5585.9,2024-04-01T09:01:04,Barcelona,incomes,salary,1354.33,-66652.41
buyer_4,Marc,Andreu,1974-05-23,52965688T,marc.andreu@coolcloud.app,939777,ES43209578608750974410,5585.9,2024-04-02T14:51:37,Barcelona,expenses,cash,-100.0,-66752.41
buyer_4,Marc,Andreu,1974-05-23,52965688T,marc.andreu@coolcloud.app,939777,ES43209578608750974410,5585.9,2024-04-04T18:50:05,Barcelona,expenses,cash,-100.0,-66852.41
buyer_4,Marc,Andreu,1974-05-23,52965688T,marc.andreu@coolcloud.app,939777,ES43209578608750974410,5585.9,2024-04-05T15:24:00,Barcelona,expenses,mortgage,-508.37,-67360.78
buyer_4,Marc,Andreu,1974-05-23,52965688T,marc.andreu@coolcloud.app,939777,ES43209578608750974410,5585.9,2024-04-05T15:47:47,Barcelona,expenses,water,-29.6,-67390.38
buyer_4,Marc,Andreu,1974-05-23,52965688T,marc.andreu@coolcloud.app,939777,ES43209578608750974410,5585.9,2024-04-05T13:44:18,Barcelona,expenses,leisure,-22.99,-67413.37
buyer_4,Marc,Andreu,1974-05-23,52965688T,marc.andreu@coolcloud.app,939777,ES43209578608750974410,5585.9,2024-04-06T11:23:37,Barcelona,expenses,internet,-28.44,-67441.81
buyer_4,Marc,Andreu,1974-05-23,52965688T,marc.andreu@coolcloud.app,939777,ES43209578608750974410,5585.9,2024-04-06T20:19:04,Barcelona,expenses,healthcare,-59.6,-67501.41
buyer_4,Marc,Andreu,1974-05-23,52965688T,marc.andreu@coolcloud.app,939777,ES43209578608750974410,5585.9,2024-04-06T10:01:00,Barcelona,expenses,gifts,-126.16,-67627.57
buyer_4,Marc,Andreu,1974-05-23,52965688T,marc.andreu@coolcloud.app,939777,ES43209578608750974410,5585.9,2024-04-07T14:04:54,Barcelona,expenses,phone,-23.69,-67651.26
buyer_4,Marc,Andreu,1974-05-23,52965688T,marc.andreu@coolcloud.app,939777,ES43209578608750974410,5585.9,2024-04-08T16:58:06,Barcelona,expenses,gas,-37.12,-67688.38
buyer_4,Marc,Andreu,1974-05-23,52965688T,marc.andreu@coolcloud.app,939777,ES43209578608750974410,5585.9,2024-04-08T17:51:06,Barcelona,expenses,internet,-28.44,-67716.82
buyer_4,Marc,Andreu,1974-05-23,52965688T,marc.andreu@coolcloud.app,939777,ES43209578608750974410,5585.9,2024-04-10T20:03:57,Barcelona,expenses,repairs,-30.2,-67747.02
buyer_4,Marc,Andreu,1974-05-23,52965688T,marc.andreu@coolcloud.app,939777,ES43209578608750974410,5585.9,2024-04-11T13:02:54,Barcelona,expenses,transport,-48.07,-67795.09
buyer_4,Marc,Andreu,1974-05-23,52965688T,marc.andreu@coolcloud.app,939777,ES43209578608750974410,5585.9,2024-04-11T17:42:50,Barcelona,expenses,leisure,-20.7,-67815.79
buyer_4,Marc,Andreu,1974-05-23,52965688T,marc.andreu@coolcloud.app,939777,ES43209578608750974410,5585.9,2024-04-11T09:09:55,Barcelona,expenses,cash,-100.0,-67915.79
buyer_4,Marc,Andreu,1974-05-23,52965688T,marc.andreu@coolcloud.app,939777,ES43209578608750974410,5585.9,2024-04-12T17:21:50,Barcelona,expenses,food,-63.58,-67979.37
buyer_4,Marc,Andreu,1974-05-23,52965688T,marc.andreu@coolcloud.app,939777,ES43209578608750974410,5585.9,2024-04-14T00:07:30,Barcelona,expenses,cash,-100.0,-68079.37
buyer_4,Marc,Andreu,1974-05-23,52965688T,marc.andreu@coolcloud.app,939777,ES43209578608750974410,5585.9,2024-04-15T14:16:19,Barcelona,expenses,transport,-56.08,-68135.45
buyer_4,Marc,Andreu,1974-05-23,52965688T,marc.andreu@coolcloud.app,939777,ES43209578608750974410,5585.9,2024-04-17T11:32:57,Barcelona,expenses,cash,-100.0,-68235.45
buyer_4,Marc,Andreu,1974-05-23,52965688T,marc.andreu@coolcloud.app,939777,ES43209578608750974410,5585.9,2024-04-18T14:03:00,Barcelona,expenses,leisure,-79.71,-68315.16
buyer_4,Marc,Andreu,1974-05-23,52965688T,marc.andreu@coolcloud.app,939777,ES43209578608750974410,5585.9,2024-04-19T19:03:03,Barcelona,expenses,cash,-100.0,-68415.16
buyer_4,Marc,Andreu,1974-05-23,52965688T,marc.andreu@coolcloud.app,939777,ES43209578608750974410,5585.9,2024-04-21T22:48:19,Barcelona,expenses,education,-46.68,-68461.84
buyer_4,Marc,Andreu,1974-05-23,52965688T,marc.andreu@coolcloud.app,939777,ES43209578608750974410,5585.9,2024-04-23T19:34:51,Barcelona,expenses,cash,-100.0,-68561.84
buyer_4,Marc,Andreu,1974-05-23,52965688T,marc.andreu@coolcloud.app,939777,ES43209578608750974410,5585.9,2024-04-25T09:16:28,Barcelona,expenses,healthcare,-137.62,-68699.46
buyer_4,Marc,Andreu,1974-05-23,52965688T,marc.andreu@coolcloud.app,939777,ES43209578608750974410,5585.9,2024-05-01T08:54:59,Barcelona,incomes,salary,1354.33,-67345.13
buyer_4,Marc,Andreu,1974-05-23,52965688T,marc.andreu@coolcloud.app,939777,ES43209578608750974410,5585.9,2024-05-01T08:54:59,Barcelona,incomes,extra_income,171.57,-67173.56
buyer_4,Marc,Andreu,1974-05-23,52965688T,marc.andreu@coolcloud.app,939777,ES43209578608750974410,5585.9,2024-05-01T11:22:34,Barcelona,expenses,food,-73.88,-67247.44
buyer_4,Marc,Andreu,1974-05-23,52965688T,marc.andreu@coolcloud.app,939777,ES43209578608750974410,5585.9,2024-05-01T20:17:19,Barcelona,expenses,clothing,-158.42,-67405.86
buyer_4,Marc,Andreu,1974-05-23,52965688T,marc.andreu@coolcloud.app,939777,ES43209578608750974410,5585.9,2024-05-01T20:41:18,Barcelona,expenses,cash,-100.0,-67505.86
buyer_4,Marc,Andreu,1974-05-23,52965688T,marc.andreu@coolcloud.app,939777,ES43209578608750974410,5585.9,2024-05-04T22:55:01,Barcelona,expenses,food,-65.09,-67570.95
buyer_4,Marc,Andreu,1974-05-23,52965688T,marc.andreu@coolcloud.app,939777,ES43209578608750974410,5585.9,2024-05-05T19:39:11,Barcelona,expenses,mortgage,-508.37,-68079.32
buyer_4,Marc,Andreu,1974-05-23,52965688T,marc.andreu@coolcloud.app,939777,ES43209578608750974410,5585.9,2024-05-05T17:16:29,Barcelona,expenses,electricity,-32.19,-68111.51
buyer_4,Marc,Andreu,1974-05-23,52965688T,marc.andreu@coolcloud.app,939777,ES43209578608750974410,5585.9,2024-05-05T13:43:39,Barcelona,expenses,gas,-53.88,-68165.39
buyer_4,Marc,Andreu,1974-05-23,52965688T,marc.andreu@coolcloud.app,939777,ES43209578608750974410,5585.9,2024-05-05T04:12:33,Barcelona,expenses,gifts,-47.79,-68213.18
buyer_4,Marc,Andreu,1974-05-23,52965688T,marc.andreu@coolcloud.app,939777,ES43209578608750974410,5585.9,2024-05-06T12:08:25,Barcelona,expenses,water,-18.8,-68231.98
buyer_4,Marc,Andreu,1974-05-23,52965688T,marc.andreu@coolcloud.app,939777,ES43209578608750974410,5585.9,2024-05-06T12:06:53,Barcelona,expenses,gas,-26.01,-68257.99
buyer_4,Marc,Andreu,1974-05-23,52965688T,marc.andreu@coolcloud.app,939777,ES43209578608750974410,5585.9,2024-05-06T12:38:13,Barcelona,expenses,internet,-28.44,-68286.43
buyer_4,Marc,Andreu,1974-05-23,52965688T,marc.andreu@coolcloud.app,939777,ES43209578608750974410,5585.9,2024-05-06T09:45:09,Barcelona,expenses,leisure,-55.21,-68341.64
buyer_4,Marc,Andreu,1974-05-23,52965688T,marc.andreu@coolcloud.app,939777,ES43209578608750974410,5585.9,2024-05-07T12:30:04,Barcelona,expenses,water,-21.32,-68362.96
buyer_4,Marc,Andreu,1974-05-23,52965688T,marc.andreu@coolcloud.app,939777,ES43209578608750974410,5585.9,2024-05-07T11:11:05,Barcelona,expenses,gas,-45.14,-68408.1
buyer_4,Marc,Andreu,1974-05-23,52965688T,marc.andreu@coolcloud.app,939777,ES43209578608750974410,5585.9,2024-05-07T16:31:50,Barcelona,expenses,internet,-28.44,-68436.54
buyer_4,Marc,Andreu,1974-05-23,52965688T,marc.andreu@coolcloud.app,939777,ES43209578608750974410,5585.9,2024-05-08T08:48:52,Barcelona,expenses,gas,-56.92,-68493.46
buyer_4,Marc,Andreu,1974-05-23,52965688T,marc.andreu@coolcloud.app,939777,ES43209578608750974410,5585.9,2024-05-08T13:07:52,Barcelona,expenses,cash,-100.0,-68593.46
buyer_4,Marc,Andreu,1974-05-23,52965688T,marc.andreu@coolcloud.app,939777,ES43209578608750974410,5585.9,2024-05-11T10:35:09,Barcelona,expenses,food,-83.06,-68676.52
buyer_4,Marc,Andreu,1974-05-23,52965688T,marc.andreu@coolcloud.app,939777,ES43209578608750974410,5585.9,2024-05-11T13:44:39,Barcelona,expenses,transport,-62.71,-68739.23
buyer_4,Marc,Andreu,1974-05-23,52965688T,marc.andreu@coolcloud.app,939777,ES43209578608750974410,5585.9,2024-05-12T10:50:52,Barcelona,expenses,leisure,-39.64,-68778.87
buyer_4,Marc,Andreu,1974-05-23,52965688T,marc.andreu@coolcloud.app,939777,ES43209578608750974410,5585.9,2024-05-12T14:21:28,Barcelona,expenses,cash,-100.0,-68878.87
buyer_4,Marc,Andreu,1974-05-23,52965688T,marc.andreu@coolcloud.app,939777,ES43209578608750974410,5585.9,2024-05-14T19:00:36,Barcelona,expenses,leisure,-47.39,-68926.26
buyer_4,Marc,Andreu,1974-05-23,52965688T,marc.andreu@coolcloud.app,939777,ES43209578608750974410,5585.9,2024-05-14T14:02:42,Barcelona,expenses,cash,-100.0,-69026.26
buyer_4,Marc,Andreu,1974-05-23,52965688T,marc.andreu@coolcloud.app,939777,ES43209578608750974410,5585.9,2024-05-15T16:51:25,Barcelona,expenses,leisure,-25.15,-69051.41
buyer_4,Marc,Andreu,1974-05-23,52965688T,marc.andreu@coolcloud.app,939777,ES43209578608750974410,5585.9,2024-05-15T11:50:34,Barcelona,expenses,cash,-100.0,-69151.41
buyer_4,Marc,Andreu,1974-05-23,52965688T,marc.andreu@coolcloud.app,939777,ES43209578608750974410,5585.9,2024-05-15T09:12:13,Barcelona,expenses,gifts,-66.15,-69217.56
buyer_4,Marc,Andreu,1974-05-23,52965688T,marc.andreu@coolcloud.app,939777,ES43209578608750974410,5585.9,2024-05-16T20:01:45,Barcelona,expenses,food,-85.4,-69302.96
buyer_4,Marc,Andreu,1974-05-23,52965688T,marc.andreu@coolcloud.app,939777,ES43209578608750974410,5585.9,2024-05-16T09:04:29,Barcelona,expenses,leisure,-84.58,-69387.54
buyer_4,Marc,Andreu,1974-05-23,52965688T,marc.andreu@coolcloud.app,939777,ES43209578608750974410,5585.9,2024-05-16T18:21:26,Barcelona,expenses,cash,-100.0,-69487.54
buyer_4,Marc,Andreu,1974-05-23,52965688T,marc.andreu@coolcloud.app,939777,ES43209578608750974410,5585.9,2024-05-18T20:08:40,Barcelona,expenses,healthcare,-81.12,-69568.66
buyer_4,Marc,Andreu,1974-05-23,52965688T,marc.andreu@coolcloud.app,939777,ES43209578608750974410,5585.9,2024-05-19T11:54:39,Barcelona,expenses,food,-64.49,-69633.15
buyer_4,Marc,Andreu,1974-05-23,52965688T,marc.andreu@coolcloud.app,939777,ES43209578608750974410,5585.9,2024-05-19T10:20:20,Barcelona,expenses,leisure,-35.95,-69669.1
buyer_4,Marc,Andreu,1974-05-23,52965688T,marc.andreu@coolcloud.app,939777,ES43209578608750974410,5585.9,2024-05-19T09:19:41,Barcelona,expenses,children,-539.7609166666666,-70208.86
buyer_4,Marc,Andreu,1974-05-23,52965688T,marc.andreu@coolcloud.app,939777,ES43209578608750974410,5585.9,2024-05-20T17:17:25,Barcelona,expenses,cash,-100.0,-70308.86
buyer_4,Marc,Andreu,1974-05-23,52965688T,marc.andreu@coolcloud.app,939777,ES43209578608750974410,5585.9,2024-05-21T09:50:12,Barcelona,expenses,cash,-100.0,-70408.86
buyer_4,Marc,Andreu,1974-05-23,52965688T,marc.andreu@coolcloud.app,939777,ES43209578608750974410,5585.9,2024-05-23T15:10:33,Barcelona,expenses,transport,-70.13,-70478.99
buyer_4,Marc,Andreu,1974-05-23,52965688T,marc.andreu@coolcloud.app,939777,ES43209578608750974410,5585.9,2024-05-24T09:10:59,Barcelona,expenses,cash,-100.0,-70578.99
buyer_4,Marc,Andreu,1974-05-23,52965688T,marc.andreu@coolcloud.app,939777,ES43209578608750974410,5585.9,2024-05-25T14:00:33,Barcelona,expenses,transport,-53.85,-70632.84
buyer_4,Marc,Andreu,1974-05-23,52965688T,marc.andreu@coolcloud.app,939777,ES43209578608750974410,5585.9,2024-05-25T03:40:35,Barcelona,expenses,appliances,-316.33,-70949.17
buyer_4,Marc,Andreu,1974-05-23,52965688T,marc.andreu@coolcloud.app,939777,ES43209578608750974410,5585.9,2024-05-27T11:14:40,Barcelona,expenses,transport,-79.98,-71029.15
buyer_4,Marc,Andreu,1974-05-23,52965688T,marc.andreu@coolcloud.app,939777,ES43209578608750974410,5585.9,2024-05-27T19:42:08,Barcelona,expenses,repairs,-295.64,-71324.79
buyer_4,Marc,Andreu,1974-05-23,52965688T,marc.andreu@coolcloud.app,939777,ES43209578608750974410,5585.9,2024-05-29T19:34:52,Barcelona,expenses,food,-109.37,-71434.16
buyer_4,Marc,Andreu,1974-05-23,52965688T,marc.andreu@coolcloud.app,939777,ES43209578608750974410,5585.9,2024-05-29T15:09:11,Barcelona,expenses,transport,-60.12,-71494.28
buyer_4,Marc,Andreu,1974-05-23,52965688T,marc.andreu@coolcloud.app,939777,ES43209578608750974410,5585.9,2024-05-30T09:01:28,Barcelona,expenses,appliances,-220.39,-71714.67
buyer_4,Marc,Andreu,1974-05-23,52965688T,marc.andreu@coolcloud.app,939777,ES43209578608750974410,5585.9,2024-05-30T23:39:15,Barcelona,expenses,repairs,-107.38,-71822.05
buyer_4,Marc,Andreu,1974-05-23,52965688T,marc.andreu@coolcloud.app,939777,ES43209578608750974410,5585.9,2024-05-31T19:19:10,Barcelona,expenses,repairs,-198.49,-72020.54
buyer_4,Marc,Andreu,1974-05-23,52965688T,marc.andreu@coolcloud.app,939777,ES43209578608750974410,5585.9,2024-06-01T11:12:15,Barcelona,incomes,salary,1354.33,-70666.21
buyer_4,Marc,Andreu,1974-05-23,52965688T,marc.andreu@coolcloud.app,939777,ES43209578608750974410,5585.9,2024-06-01T11:12:15,Barcelona,incomes,salary_bonus,966.69,-69699.52
buyer_4,Marc,Andreu,1974-05-23,52965688T,marc.andreu@coolcloud.app,939777,ES43209578608750974410,5585.9,2024-06-01T11:59:42,Barcelona,expenses,children,-359.23,-70058.75
buyer_4,Marc,Andreu,1974-05-23,52965688T,marc.andreu@coolcloud.app,939777,ES43209578608750974410,5585.9,2024-06-03T12:12:57,Barcelona,expenses,food,-117.93,-70176.68
buyer_4,Marc,Andreu,1974-05-23,52965688T,marc.andreu@coolcloud.app,939777,ES43209578608750974410,5585.9,2024-06-03T16:02:45,Barcelona,expenses,clothing,-114.11,-70290.79
buyer_4,Marc,Andreu,1974-05-23,52965688T,marc.andreu@coolcloud.app,939777,ES43209578608750974410,5585.9,2024-06-04T19:00:11,Barcelona,expenses,cash,-100.0,-70390.79
buyer_4,Marc,Andreu,1974-05-23,52965688T,marc.andreu@coolcloud.app,939777,ES43209578608750974410,5585.9,2024-06-05T19:37:12,Barcelona,expenses,mortgage,-508.37,-70899.16
buyer_4,Marc,Andreu,1974-05-23,52965688T,marc.andreu@coolcloud.app,939777,ES43209578608750974410,5585.9,2024-06-05T23:16:57,Barcelona,expenses,taxes,-957.51,-71856.67
buyer_4,Marc,Andreu,1974-05-23,52965688T,marc.andreu@coolcloud.app,939777,ES43209578608750974410,5585.9,2024-06-05T14:58:05,Barcelona,expenses,insurance,-336.27,-72192.94
buyer_4,Marc,Andreu,1974-05-23,52965688T,marc.andreu@coolcloud.app,939777,ES43209578608750974410,5585.9,2024-06-05T20:01:41,Barcelona,expenses,electricity,-22.16,-72215.1
buyer_4,Marc,Andreu,1974-05-23,52965688T,marc.andreu@coolcloud.app,939777,ES43209578608750974410,5585.9,2024-06-05T11:55:45,Barcelona,expenses,internet,-28.44,-72243.54
buyer_4,Marc,Andreu,1974-05-23,52965688T,marc.andreu@coolcloud.app,939777,ES43209578608750974410,5585.9,2024-06-05T19:41:06,Barcelona,expenses,leisure,-27.51,-72271.05
buyer_4,Marc,Andreu,1974-05-23,52965688T,marc.andreu@coolcloud.app,939777,ES43209578608750974410,5585.9,2024-06-06T09:58:34,Barcelona,expenses,electricity,-33.37,-72304.42
buyer_4,Marc,Andreu,1974-05-23,52965688T,marc.andreu@coolcloud.app,939777,ES43209578608750974410,5585.9,2024-06-06T20:00:21,Barcelona,expenses,food,-92.65,-72397.07
buyer_4,Marc,Andreu,1974-05-23,52965688T,marc.andreu@coolcloud.app,939777,ES43209578608750974410,5585.9,2024-06-07T13:00:23,Barcelona,expenses,electricity,-41.0,-72438.07
buyer_4,Marc,Andreu,1974-05-23,52965688T,marc.andreu@coolcloud.app,939777,ES43209578608750974410,5585.9,2024-06-07T20:13:38,Barcelona,expenses,gas,-71.73,-72509.8
buyer_4,Marc,Andreu,1974-05-23,52965688T,marc.andreu@coolcloud.app,939777,ES43209578608750974410,5585.9,2024-06-07T17:40:45,Barcelona,expenses,internet,-28.44,-72538.24
buyer_4,Marc,Andreu,1974-05-23,52965688T,marc.andreu@coolcloud.app,939777,ES43209578608750974410,5585.9,2024-06-07T18:27:12,Barcelona,expenses,phone,-29.07,-72567.31
buyer_4,Marc,Andreu,1974-05-23,52965688T,marc.andreu@coolcloud.app,939777,ES43209578608750974410,5585.9,2024-06-07T13:32:50,Barcelona,expenses,cash,-100.0,-72667.31
buyer_4,Marc,Andreu,1974-05-23,52965688T,marc.andreu@coolcloud.app,939777,ES43209578608750974410,5585.9,2024-06-08T12:10:36,Barcelona,expenses,water,-19.92,-72687.23
buyer_4,Marc,Andreu,1974-05-23,52965688T,marc.andreu@coolcloud.app,939777,ES43209578608750974410,5585.9,2024-06-08T12:01:37,Barcelona,expenses,internet,-28.44,-72715.67
buyer_4,Marc,Andreu,1974-05-23,52965688T,marc.andreu@coolcloud.app,939777,ES43209578608750974410,5585.9,2024-06-09T09:07:24,Barcelona,expenses,transport,-74.39,-72790.06
buyer_4,Marc,Andreu,1974-05-23,52965688T,marc.andreu@coolcloud.app,939777,ES43209578608750974410,5585.9,2024-06-15T23:58:17,Barcelona,expenses,gifts,-445.2,-73235.26
buyer_4,Marc,Andreu,1974-05-23,52965688T,marc.andreu@coolcloud.app,939777,ES43209578608750974410,5585.9,2024-06-15T16:33:53,Barcelona,expenses,car,-153.93,-73389.19
buyer_4,Marc,Andreu,1974-05-23,52965688T,marc.andreu@coolcloud.app,939777,ES43209578608750974410,5585.9,2024-06-16T13:35:25,Barcelona,expenses,cash,-100.0,-73489.19
buyer_4,Marc,Andreu,1974-05-23,52965688T,marc.andreu@coolcloud.app,939777,ES43209578608750974410,5585.9,2024-06-16T15:51:05,Barcelona,expenses,repairs,-104.95,-73594.14
buyer_4,Marc,Andreu,1974-05-23,52965688T,marc.andreu@coolcloud.app,939777,ES43209578608750974410,5585.9,2024-06-22T14:05:21,Barcelona,expenses,leisure,-65.23,-73659.37
buyer_4,Marc,Andreu,1974-05-23,52965688T,marc.andreu@coolcloud.app,939777,ES43209578608750974410,5585.9,2024-06-24T09:50:43,Barcelona,expenses,leisure,-57.16,-73716.53
buyer_4,Marc,Andreu,1974-05-23,52965688T,marc.andreu@coolcloud.app,939777,ES43209578608750974410,5585.9,2024-06-26T08:02:37,Barcelona,expenses,cash,-100.0,-73816.53
buyer_4,Marc,Andreu,1974-05-23,52965688T,marc.andreu@coolcloud.app,939777,ES43209578608750974410,5585.9,2024-06-27T12:04:37,Barcelona,expenses,transport,-52.77,-73869.3
buyer_4,Marc,Andreu,1974-05-23,52965688T,marc.andreu@coolcloud.app,939777,ES43209578608750974410,5585.9,2024-06-27T08:41:18,Barcelona,expenses,cash,-100.0,-73969.3
buyer_4,Marc,Andreu,1974-05-23,52965688T,marc.andreu@coolcloud.app,939777,ES43209578608750974410,5585.9,2024-06-28T12:45:38,Barcelona,expenses,food,-69.11,-74038.41
buyer_4,Marc,Andreu,1974-05-23,52965688T,marc.andreu@coolcloud.app,939777,ES43209578608750974410,5585.9,2024-06-28T13:12:27,Barcelona,expenses,gifts,-28.6,-74067.01
buyer_4,Marc,Andreu,1974-05-23,52965688T,marc.andreu@coolcloud.app,939777,ES43209578608750974410,5585.9,2024-07-01T08:52:07,Barcelona,incomes,salary,1354.33,-72712.68
buyer_4,Marc,Andreu,1974-05-23,52965688T,marc.andreu@coolcloud.app,939777,ES43209578608750974410,5585.9,2024-07-01T18:49:32,Barcelona,expenses,transport,-89.48,-72802.16
buyer_4,Marc,Andreu,1974-05-23,52965688T,marc.andreu@coolcloud.app,939777,ES43209578608750974410,5585.9,2024-07-01T05:57:26,Barcelona,expenses,leisure,-55.51,-72857.67
buyer_4,Marc,Andreu,1974-05-23,52965688T,marc.andreu@coolcloud.app,939777,ES43209578608750974410,5585.9,2024-07-03T13:44:08,Barcelona,expenses,cash,-100.0,-72957.67
buyer_4,Marc,Andreu,1974-05-23,52965688T,marc.andreu@coolcloud.app,939777,ES43209578608750974410,5585.9,2024-07-03T11:53:16,Barcelona,expenses,repairs,-162.75,-73120.42
buyer_4,Marc,Andreu,1974-05-23,52965688T,marc.andreu@coolcloud.app,939777,ES43209578608750974410,5585.9,2024-07-04T16:10:39,Barcelona,expenses,healthcare,-109.62,-73230.04
buyer_4,Marc,Andreu,1974-05-23,52965688T,marc.andreu@coolcloud.app,939777,ES43209578608750974410,5585.9,2024-07-05T09:03:09,Barcelona,expenses,mortgage,-508.37,-73738.41
buyer_4,Marc,Andreu,1974-05-23,52965688T,marc.andreu@coolcloud.app,939777,ES43209578608750974410,5585.9,2024-07-05T18:49:08,Barcelona,expenses,food,-114.4,-73852.81
buyer_4,Marc,Andreu,1974-05-23,52965688T,marc.andreu@coolcloud.app,939777,ES43209578608750974410,5585.9,2024-07-05T12:56:13,Barcelona,expenses,clothing,-63.94,-73916.75
buyer_4,Marc,Andreu,1974-05-23,52965688T,marc.andreu@coolcloud.app,939777,ES43209578608750974410,5585.9,2024-07-06T21:40:46,Barcelona,expenses,water,-14.57,-73931.32
buyer_4,Marc,Andreu,1974-05-23,52965688T,marc.andreu@coolcloud.app,939777,ES43209578608750974410,5585.9,2024-07-06T08:41:52,Barcelona,expenses,electricity,-53.55,-73984.87
buyer_4,Marc,Andreu,1974-05-23,52965688T,marc.andreu@coolcloud.app,939777,ES43209578608750974410,5585.9,2024-07-06T17:43:17,Barcelona,expenses,gas,-52.95,-74037.82
buyer_4,Marc,Andreu,1974-05-23,52965688T,marc.andreu@coolcloud.app,939777,ES43209578608750974410,5585.9,2024-07-06T08:00:33,Barcelona,expenses,internet,-28.44,-74066.26
buyer_4,Marc,Andreu,1974-05-23,52965688T,marc.andreu@coolcloud.app,939777,ES43209578608750974410,5585.9,2024-07-06T14:03:48,Barcelona,expenses,phone,-22.43,-74088.69
buyer_4,Marc,Andreu,1974-05-23,52965688T,marc.andreu@coolcloud.app,939777,ES43209578608750974410,5585.9,2024-07-07T10:12:00,Barcelona,expenses,electricity,-32.52,-74121.21
buyer_4,Marc,Andreu,1974-05-23,52965688T,marc.andreu@coolcloud.app,939777,ES43209578608750974410,5585.9,2024-07-07T16:55:42,Barcelona,expenses,food,-90.16,-74211.37
buyer_4,Marc,Andreu,1974-05-23,52965688T,marc.andreu@coolcloud.app,939777,ES43209578608750974410,5585.9,2024-07-07T11:29:58,Barcelona,expenses,transport,-76.32,-74287.69
buyer_4,Marc,Andreu,1974-05-23,52965688T,marc.andreu@coolcloud.app,939777,ES43209578608750974410,5585.9,2024-07-07T10:22:18,Barcelona,expenses,cash,-100.0,-74387.69
buyer_4,Marc,Andreu,1974-05-23,52965688T,marc.andreu@coolcloud.app,939777,ES43209578608750974410,5585.9,2024-07-07T15:55:52,Barcelona,expenses,travel,-323.55,-74711.24
buyer_4,Marc,Andreu,1974-05-23,52965688T,marc.andreu@coolcloud.app,939777,ES43209578608750974410,5585.9,2024-07-07T16:11:03,Barcelona,expenses,gifts,-45.19,-74756.43
buyer_4,Marc,Andreu,1974-05-23,52965688T,marc.andreu@coolcloud.app,939777,ES43209578608750974410,5585.9,2024-07-08T13:55:22,Barcelona,expenses,electricity,-59.6,-74816.03
buyer_4,Marc,Andreu,1974-05-23,52965688T,marc.andreu@coolcloud.app,939777,ES43209578608750974410,5585.9,2024-07-08T13:22:17,Barcelona,expenses,internet,-28.44,-74844.47
buyer_4,Marc,Andreu,1974-05-23,52965688T,marc.andreu@coolcloud.app,939777,ES43209578608750974410,5585.9,2024-07-08T16:59:03,Barcelona,expenses,transport,-41.42,-74885.89
buyer_4,Marc,Andreu,1974-05-23,52965688T,marc.andreu@coolcloud.app,939777,ES43209578608750974410,5585.9,2024-07-11T10:12:18,Barcelona,expenses,leisure,-39.65,-74925.54
buyer_4,Marc,Andreu,1974-05-23,52965688T,marc.andreu@coolcloud.app,939777,ES43209578608750974410,5585.9,2024-07-12T08:50:42,Barcelona,expenses,food,-64.49,-74990.03
buyer_4,Marc,Andreu,1974-05-23,52965688T,marc.andreu@coolcloud.app,939777,ES43209578608750974410,5585.9,2024-07-12T19:34:09,Barcelona,expenses,leisure,-54.06,-75044.09
buyer_4,Marc,Andreu,1974-05-23,52965688T,marc.andreu@coolcloud.app,939777,ES43209578608750974410,5585.9,2024-07-12T16:15:44,Barcelona,expenses,cash,-100.0,-75144.09
buyer_4,Marc,Andreu,1974-05-23,52965688T,marc.andreu@coolcloud.app,939777,ES43209578608750974410,5585.9,2024-07-16T19:09:35,Barcelona,expenses,healthcare,-173.37,-75317.46
buyer_4,Marc,Andreu,1974-05-23,52965688T,marc.andreu@coolcloud.app,939777,ES43209578608750974410,5585.9,2024-07-16T10:17:22,Barcelona,expenses,gifts,-187.53,-75504.99
buyer_4,Marc,Andreu,1974-05-23,52965688T,marc.andreu@coolcloud.app,939777,ES43209578608750974410,5585.9,2024-07-17T18:53:57,Barcelona,expenses,leisure,-38.35,-75543.34
buyer_4,Marc,Andreu,1974-05-23,52965688T,marc.andreu@coolcloud.app,939777,ES43209578608750974410,5585.9,2024-07-17T17:26:03,Barcelona,expenses,children,-568.66,-76112.0
buyer_4,Marc,Andreu,1974-05-23,52965688T,marc.andreu@coolcloud.app,939777,ES43209578608750974410,5585.9,2024-07-19T20:39:57,Barcelona,expenses,transport,-56.9,-76168.9
buyer_4,Marc,Andreu,1974-05-23,52965688T,marc.andreu@coolcloud.app,939777,ES43209578608750974410,5585.9,2024-07-22T18:03:45,Barcelona,expenses,leisure,-70.53,-76239.43
buyer_4,Marc,Andreu,1974-05-23,52965688T,marc.andreu@coolcloud.app,939777,ES43209578608750974410,5585.9,2024-07-23T15:20:52,Barcelona,expenses,cash,-100.0,-76339.43
buyer_4,Marc,Andreu,1974-05-23,52965688T,marc.andreu@coolcloud.app,939777,ES43209578608750974410,5585.9,2024-07-23T17:40:30,Barcelona,expenses,appliances,-191.4,-76530.83
buyer_4,Marc,Andreu,1974-05-23,52965688T,marc.andreu@coolcloud.app,939777,ES43209578608750974410,5585.9,2024-07-25T15:32:00,Barcelona,expenses,food,-111.9,-76642.73
buyer_4,Marc,Andreu,1974-05-23,52965688T,marc.andreu@coolcloud.app,939777,ES43209578608750974410,5585.9,2024-07-26T18:43:23,Barcelona,expenses,gifts,-164.96,-76807.69
buyer_4,Marc,Andreu,1974-05-23,52965688T,marc.andreu@coolcloud.app,939777,ES43209578608750974410,5585.9,2024-07-28T05:04:54,Barcelona,expenses,cash,-100.0,-76907.69
buyer_4,Marc,Andreu,1974-05-23,52965688T,marc.andreu@coolcloud.app,939777,ES43209578608750974410,5585.9,2024-07-29T16:44:08,Barcelona,expenses,food,-124.57,-77032.26
buyer_4,Marc,Andreu,1974-05-23,52965688T,marc.andreu@coolcloud.app,939777,ES43209578608750974410,5585.9,2024-07-30T10:07:19,Barcelona,expenses,repairs,-70.75,-77103.01
buyer_4,Marc,Andreu,1974-05-23,52965688T,marc.andreu@coolcloud.app,939777,ES43209578608750974410,5585.9,2024-07-31T08:12:15,Barcelona,expenses,food,-64.37,-77167.38
buyer_4,Marc,Andreu,1974-05-23,52965688T,marc.andreu@coolcloud.app,939777,ES43209578608750974410,5585.9,2024-07-31T10:51:11,Barcelona,expenses,cash,-100.0,-77267.38
buyer_4,Marc,Andreu,1974-05-23,52965688T,marc.andreu@coolcloud.app,939777,ES43209578608750974410,5585.9,2024-07-31T09:45:11,Barcelona,expenses,appliances,-260.12,-77527.5
buyer_4,Marc,Andreu,1974-05-23,52965688T,marc.andreu@coolcloud.app,939777,ES43209578608750974410,5585.9,2024-08-01T18:12:22,Barcelona,incomes,salary,1354.33,-76173.17
buyer_4,Marc,Andreu,1974-05-23,52965688T,marc.andreu@coolcloud.app,939777,ES43209578608750974410,5585.9,2024-08-01T16:40:55,Barcelona,expenses,food,-99.23,-76272.4
buyer_4,Marc,Andreu,1974-05-23,52965688T,marc.andreu@coolcloud.app,939777,ES43209578608750974410,5585.9,2024-08-04T13:26:08,Barcelona,expenses,repairs,-115.95,-76388.35
buyer_4,Marc,Andreu,1974-05-23,52965688T,marc.andreu@coolcloud.app,939777,ES43209578608750974410,5585.9,2024-08-05T01:06:46,Barcelona,expenses,mortgage,-508.37,-76896.72
buyer_4,Marc,Andreu,1974-05-23,52965688T,marc.andreu@coolcloud.app,939777,ES43209578608750974410,5585.9,2024-08-05T17:05:30,Barcelona,expenses,water,-17.33,-76914.05
buyer_4,Marc,Andreu,1974-05-23,52965688T,marc.andreu@coolcloud.app,939777,ES43209578608750974410,5585.9,2024-08-05T18:00:19,Barcelona,expenses,internet,-28.44,-76942.49
buyer_4,Marc,Andreu,1974-05-23,52965688T,marc.andreu@coolcloud.app,939777,ES43209578608750974410,5585.9,2024-08-05T08:09:15,Barcelona,expenses,food,-94.04,-77036.53
buyer_4,Marc,Andreu,1974-05-23,52965688T,marc.andreu@coolcloud.app,939777,ES43209578608750974410,5585.9,2024-08-05T08:20:57,Barcelona,expenses,leisure,-48.29,-77084.82
buyer_4,Marc,Andreu,1974-05-23,52965688T,marc.andreu@coolcloud.app,939777,ES43209578608750974410,5585.9,2024-08-06T14:04:53,Barcelona,expenses,internet,-28.44,-77113.26
buyer_4,Marc,Andreu,1974-05-23,52965688T,marc.andreu@coolcloud.app,939777,ES43209578608750974410,5585.9,2024-08-07T08:04:52,Barcelona,expenses,gas,-55.04,-77168.3
buyer_4,Marc,Andreu,1974-05-23,52965688T,marc.andreu@coolcloud.app,939777,ES43209578608750974410,5585.9,2024-08-07T19:28:07,Barcelona,expenses,cash,-100.0,-77268.3
buyer_4,Marc,Andreu,1974-05-23,52965688T,marc.andreu@coolcloud.app,939777,ES43209578608750974410,5585.9,2024-08-08T11:33:47,Barcelona,expenses,appliances,-322.99,-77591.29
buyer_4,Marc,Andreu,1974-05-23,52965688T,marc.andreu@coolcloud.app,939777,ES43209578608750974410,5585.9,2024-08-09T10:17:24,Barcelona,expenses,food,-93.99,-77685.28
buyer_4,Marc,Andreu,1974-05-23,52965688T,marc.andreu@coolcloud.app,939777,ES43209578608750974410,5585.9,2024-08-09T20:50:29,Barcelona,expenses,education,-50.82,-77736.1
buyer_4,Marc,Andreu,1974-05-23,52965688T,marc.andreu@coolcloud.app,939777,ES43209578608750974410,5585.9,2024-08-12T19:12:38,Barcelona,expenses,leisure,-42.18,-77778.28
buyer_4,Marc,Andreu,1974-05-23,52965688T,marc.andreu@coolcloud.app,939777,ES43209578608750974410,5585.9,2024-08-13T02:52:56,Barcelona,expenses,transport,-84.59,-77862.87
buyer_4,Marc,Andreu,1974-05-23,52965688T,marc.andreu@coolcloud.app,939777,ES43209578608750974410,5585.9,2024-08-13T14:37:16,Barcelona,expenses,clothing,-89.01,-77951.88
buyer_4,Marc,Andreu,1974-05-23,52965688T,marc.andreu@coolcloud.app,939777,ES43209578608750974410,5585.9,2024-08-14T10:05:31,Barcelona,expenses,appliances,-121.29,-78073.17
buyer_4,Marc,Andreu,1974-05-23,52965688T,marc.andreu@coolcloud.app,939777,ES43209578608750974410,5585.9,2024-08-16T16:53:37,Barcelona,expenses,transport,-40.41,-78113.58
buyer_4,Marc,Andreu,1974-05-23,52965688T,marc.andreu@coolcloud.app,939777,ES43209578608750974410,5585.9,2024-08-19T14:32:12,Barcelona,expenses,cash,-100.0,-78213.58
buyer_4,Marc,Andreu,1974-05-23,52965688T,marc.andreu@coolcloud.app,939777,ES43209578608750974410,5585.9,2024-08-20T23:40:28,Barcelona,expenses,food,-70.15,-78283.73
buyer_4,Marc,Andreu,1974-05-23,52965688T,marc.andreu@coolcloud.app,939777,ES43209578608750974410,5585.9,2024-08-23T10:12:23,Barcelona,expenses,leisure,-44.36,-78328.09
buyer_4,Marc,Andreu,1974-05-23,52965688T,marc.andreu@coolcloud.app,939777,ES43209578608750974410,5585.9,2024-08-23T08:46:07,Barcelona,expenses,gifts,-554.53,-78882.62
buyer_4,Marc,Andreu,1974-05-23,52965688T,marc.andreu@coolcloud.app,939777,ES43209578608750974410,5585.9,2024-08-24T15:37:01,Barcelona,expenses,food,-89.84,-78972.46
buyer_4,Marc,Andreu,1974-05-23,52965688T,marc.andreu@coolcloud.app,939777,ES43209578608750974410,5585.9,2024-08-25T09:12:34,Barcelona,expenses,food,-108.87,-79081.33
buyer_4,Marc,Andreu,1974-05-23,52965688T,marc.andreu@coolcloud.app,939777,ES43209578608750974410,5585.9,2024-08-25T00:07:08,Barcelona,expenses,cash,-100.0,-79181.33
buyer_4,Marc,Andreu,1974-05-23,52965688T,marc.andreu@coolcloud.app,939777,ES43209578608750974410,5585.9,2024-08-25T16:39:52,Barcelona,expenses,repairs,-331.13,-79512.46
buyer_4,Marc,Andreu,1974-05-23,52965688T,marc.andreu@coolcloud.app,939777,ES43209578608750974410,5585.9,2024-08-26T21:27:26,Barcelona,expenses,cash,-100.0,-79612.46
buyer_4,Marc,Andreu,1974-05-23,52965688T,marc.andreu@coolcloud.app,939777,ES43209578608750974410,5585.9,2024-08-28T18:09:57,Barcelona,expenses,leisure,-47.59,-79660.05
buyer_4,Marc,Andreu,1974-05-23,52965688T,marc.andreu@coolcloud.app,939777,ES43209578608750974410,5585.9,2024-08-29T13:37:38,Barcelona,expenses,transport,-67.8,-79727.85
buyer_4,Marc,Andreu,1974-05-23,52965688T,marc.andreu@coolcloud.app,939777,ES43209578608750974410,5585.9,2024-08-29T14:51:24,Barcelona,expenses,repairs,-68.95,-79796.8
buyer_4,Marc,Andreu,1974-05-23,52965688T,marc.andreu@coolcloud.app,939777,ES43209578608750974410,5585.9,2024-08-31T09:01:39,Barcelona,expenses,gifts,-343.9,-80140.7
buyer_4,Marc,Andreu,1974-05-23,52965688T,marc.andreu@coolcloud.app,939777,ES43209578608750974410,5585.9,2024-09-01T14:21:31,Barcelona,incomes,salary,1354.33,-78786.37
buyer_4,Marc,Andreu,1974-05-23,52965688T,marc.andreu@coolcloud.app,939777,ES43209578608750974410,5585.9,2024-09-01T14:21:31,Barcelona,incomes,extra_income,171.57,-78614.8
buyer_4,Marc,Andreu,1974-05-23,52965688T,marc.andreu@coolcloud.app,939777,ES43209578608750974410,5585.9,2024-09-02T13:39:20,Barcelona,expenses,food,-101.75,-78716.55
buyer_4,Marc,Andreu,1974-05-23,52965688T,marc.andreu@coolcloud.app,939777,ES43209578608750974410,5585.9,2024-09-02T10:56:37,Barcelona,expenses,children,-405.55,-79122.1
buyer_4,Marc,Andreu,1974-05-23,52965688T,marc.andreu@coolcloud.app,939777,ES43209578608750974410,5585.9,2024-09-05T11:37:42,Barcelona,expenses,mortgage,-508.37,-79630.47
buyer_4,Marc,Andreu,1974-05-23,52965688T,marc.andreu@coolcloud.app,939777,ES43209578608750974410,5585.9,2024-09-05T09:09:02,Barcelona,expenses,water,-28.81,-79659.28
buyer_4,Marc,Andreu,1974-05-23,52965688T,marc.andreu@coolcloud.app,939777,ES43209578608750974410,5585.9,2024-09-05T20:48:51,Barcelona,expenses,electricity,-43.68,-79702.96
buyer_4,Marc,Andreu,1974-05-23,52965688T,marc.andreu@coolcloud.app,939777,ES43209578608750974410,5585.9,2024-09-06T11:56:44,Barcelona,expenses,water,-27.99,-79730.95
buyer_4,Marc,Andreu,1974-05-23,52965688T,marc.andreu@coolcloud.app,939777,ES43209578608750974410,5585.9,2024-09-06T19:58:11,Barcelona,expenses,cash,-100.0,-79830.95
buyer_4,Marc,Andreu,1974-05-23,52965688T,marc.andreu@coolcloud.app,939777,ES43209578608750974410,5585.9,2024-09-06T04:16:07,Barcelona,expenses,children,-275.57,-80106.52
buyer_4,Marc,Andreu,1974-05-23,52965688T,marc.andreu@coolcloud.app,939777,ES43209578608750974410,5585.9,2024-09-07T14:46:02,Barcelona,expenses,phone,-24.5,-80131.02
buyer_4,Marc,Andreu,1974-05-23,52965688T,marc.andreu@coolcloud.app,939777,ES43209578608750974410,5585.9,2024-09-07T08:33:17,Barcelona,expenses,education,-78.06,-80209.08
buyer_4,Marc,Andreu,1974-05-23,52965688T,marc.andreu@coolcloud.app,939777,ES43209578608750974410,5585.9,2024-09-09T02:20:23,Barcelona,expenses,food,-88.62,-80297.7
buyer_4,Marc,Andreu,1974-05-23,52965688T,marc.andreu@coolcloud.app,939777,ES43209578608750974410,5585.9,2024-09-10T12:27:18,Barcelona,expenses,food,-76.16,-80373.86
buyer_4,Marc,Andreu,1974-05-23,52965688T,marc.andreu@coolcloud.app,939777,ES43209578608750974410,5585.9,2024-09-10T09:28:14,Barcelona,expenses,gifts,-254.69,-80628.55
buyer_4,Marc,Andreu,1974-05-23,52965688T,marc.andreu@coolcloud.app,939777,ES43209578608750974410,5585.9,2024-09-11T18:13:35,Barcelona,expenses,food,-65.81,-80694.36
buyer_4,Marc,Andreu,1974-05-23,52965688T,marc.andreu@coolcloud.app,939777,ES43209578608750974410,5585.9,2024-09-13T08:18:18,Barcelona,expenses,leisure,-37.53,-80731.89
buyer_4,Marc,Andreu,1974-05-23,52965688T,marc.andreu@coolcloud.app,939777,ES43209578608750974410,5585.9,2024-09-14T20:45:05,Barcelona,expenses,appliances,-352.46,-81084.35
buyer_4,Marc,Andreu,1974-05-23,52965688T,marc.andreu@coolcloud.app,939777,ES43209578608750974410,5585.9,2024-09-15T20:05:56,Barcelona,expenses,transport,-80.95,-81165.3
buyer_4,Marc,Andreu,1974-05-23,52965688T,marc.andreu@coolcloud.app,939777,ES43209578608750974410,5585.9,2024-09-15T16:22:06,Barcelona,expenses,leisure,-75.65,-81240.95
buyer_4,Marc,Andreu,1974-05-23,52965688T,marc.andreu@coolcloud.app,939777,ES43209578608750974410,5585.9,2024-09-16T11:57:33,Barcelona,expenses,healthcare,-59.27,-81300.22
buyer_4,Marc,Andreu,1974-05-23,52965688T,marc.andreu@coolcloud.app,939777,ES43209578608750974410,5585.9,2024-09-16T01:37:50,Barcelona,expenses,children,-249.65,-81549.87
buyer_4,Marc,Andreu,1974-05-23,52965688T,marc.andreu@coolcloud.app,939777,ES43209578608750974410,5585.9,2024-09-17T16:56:21,Barcelona,expenses,repairs,-243.19,-81793.06
buyer_4,Marc,Andreu,1974-05-23,52965688T,marc.andreu@coolcloud.app,939777,ES43209578608750974410,5585.9,2024-09-18T23:48:49,Barcelona,expenses,food,-103.81,-81896.87
buyer_4,Marc,Andreu,1974-05-23,52965688T,marc.andreu@coolcloud.app,939777,ES43209578608750974410,5585.9,2024-09-18T18:45:45,Barcelona,expenses,transport,-67.78,-81964.65
buyer_4,Marc,Andreu,1974-05-23,52965688T,marc.andreu@coolcloud.app,939777,ES43209578608750974410,5585.9,2024-09-18T17:00:18,Barcelona,expenses,clothing,-49.35,-82014.0
buyer_4,Marc,Andreu,1974-05-23,52965688T,marc.andreu@coolcloud.app,939777,ES43209578608750974410,5585.9,2024-09-18T08:38:45,Barcelona,expenses,cash,-100.0,-82114.0
buyer_4,Marc,Andreu,1974-05-23,52965688T,marc.andreu@coolcloud.app,939777,ES43209578608750974410,5585.9,2024-09-19T17:29:49,Barcelona,expenses,transport,-61.06,-82175.06
buyer_4,Marc,Andreu,1974-05-23,52965688T,marc.andreu@coolcloud.app,939777,ES43209578608750974410,5585.9,2024-09-19T14:25:58,Barcelona,expenses,education,-47.65,-82222.71
buyer_4,Marc,Andreu,1974-05-23,52965688T,marc.andreu@coolcloud.app,939777,ES43209578608750974410,5585.9,2024-09-19T14:22:50,Barcelona,expenses,gifts,-397.1,-82619.81
buyer_4,Marc,Andreu,1974-05-23,52965688T,marc.andreu@coolcloud.app,939777,ES43209578608750974410,5585.9,2024-09-20T13:53:47,Barcelona,expenses,cash,-100.0,-82719.81
buyer_4,Marc,Andreu,1974-05-23,52965688T,marc.andreu@coolcloud.app,939777,ES43209578608750974410,5585.9,2024-09-21T11:13:06,Barcelona,expenses,food,-95.88,-82815.69
buyer_4,Marc,Andreu,1974-05-23,52965688T,marc.andreu@coolcloud.app,939777,ES43209578608750974410,5585.9,2024-09-21T20:50:52,Barcelona,expenses,leisure,-83.58,-82899.27
buyer_4,Marc,Andreu,1974-05-23,52965688T,marc.andreu@coolcloud.app,939777,ES43209578608750974410,5585.9,2024-09-22T20:56:39,Barcelona,expenses,transport,-55.07,-82954.34
buyer_4,Marc,Andreu,1974-05-23,52965688T,marc.andreu@coolcloud.app,939777,ES43209578608750974410,5585.9,2024-09-22T11:31:07,Barcelona,expenses,cash,-100.0,-83054.34
buyer_4,Marc,Andreu,1974-05-23,52965688T,marc.andreu@coolcloud.app,939777,ES43209578608750974410,5585.9,2024-09-24T08:17:01,Barcelona,expenses,gifts,-414.08,-83468.42
buyer_4,Marc,Andreu,1974-05-23,52965688T,marc.andreu@coolcloud.app,939777,ES43209578608750974410,5585.9,2024-09-26T01:30:21,Barcelona,expenses,food,-123.05,-83591.47
buyer_4,Marc,Andreu,1974-05-23,52965688T,marc.andreu@coolcloud.app,939777,ES43209578608750974410,5585.9,2024-09-27T14:55:12,Barcelona,expenses,food,-85.53,-83677.0
buyer_4,Marc,Andreu,1974-05-23,52965688T,marc.andreu@coolcloud.app,939777,ES43209578608750974410,5585.9,2024-09-28T11:07:04,Barcelona,expenses,food,-67.78,-83744.78
buyer_4,Marc,Andreu,1974-05-23,52965688T,marc.andreu@coolcloud.app,939777,ES43209578608750974410,5585.9,2024-09-28T12:11:22,Barcelona,expenses,transport,-49.11,-83793.89
buyer_4,Marc,Andreu,1974-05-23,52965688T,marc.andreu@coolcloud.app,939777,ES43209578608750974410,5585.9,2024-10-01T14:11:44,Barcelona,incomes,salary,1354.33,-82439.56
buyer_4,Marc,Andreu,1974-05-23,52965688T,marc.andreu@coolcloud.app,939777,ES43209578608750974410,5585.9,2024-10-01T07:19:29,Barcelona,expenses,cash,-100.0,-82539.56
buyer_4,Marc,Andreu,1974-05-23,52965688T,marc.andreu@coolcloud.app,939777,ES43209578608750974410,5585.9,2024-10-01T20:41:14,Barcelona,expenses,children,-540.2009166666667,-83079.76
buyer_4,Marc,Andreu,1974-05-23,52965688T,marc.andreu@coolcloud.app,939777,ES43209578608750974410,5585.9,2024-10-02T12:44:54,Barcelona,expenses,food,-75.86,-83155.62
buyer_4,Marc,Andreu,1974-05-23,52965688T,marc.andreu@coolcloud.app,939777,ES43209578608750974410,5585.9,2024-10-02T13:32:04,Barcelona,expenses,leisure,-51.91,-83207.53
buyer_4,Marc,Andreu,1974-05-23,52965688T,marc.andreu@coolcloud.app,939777,ES43209578608750974410,5585.9,2024-10-02T09:49:35,Barcelona,expenses,healthcare,-112.47,-83320.0
buyer_4,Marc,Andreu,1974-05-23,52965688T,marc.andreu@coolcloud.app,939777,ES43209578608750974410,5585.9,2024-10-05T18:28:22,Barcelona,expenses,mortgage,-508.37,-83828.37
buyer_4,Marc,Andreu,1974-05-23,52965688T,marc.andreu@coolcloud.app,939777,ES43209578608750974410,5585.9,2024-10-06T10:31:34,Barcelona,expenses,gas,-77.16,-83905.53
buyer_4,Marc,Andreu,1974-05-23,52965688T,marc.andreu@coolcloud.app,939777,ES43209578608750974410,5585.9,2024-10-06T19:19:21,Barcelona,expenses,internet,-28.44,-83933.97
buyer_4,Marc,Andreu,1974-05-23,52965688T,marc.andreu@coolcloud.app,939777,ES43209578608750974410,5585.9,2024-10-07T22:01:01,Barcelona,expenses,electricity,-41.36,-83975.33
buyer_4,Marc,Andreu,1974-05-23,52965688T,marc.andreu@coolcloud.app,939777,ES43209578608750974410,5585.9,2024-10-07T09:20:14,Barcelona,expenses,internet,-28.44,-84003.77
buyer_4,Marc,Andreu,1974-05-23,52965688T,marc.andreu@coolcloud.app,939777,ES43209578608750974410,5585.9,2024-10-07T08:16:27,Barcelona,expenses,healthcare,-79.13,-84082.9
buyer_4,Marc,Andreu,1974-05-23,52965688T,marc.andreu@coolcloud.app,939777,ES43209578608750974410,5585.9,2024-10-08T18:03:01,Barcelona,expenses,electricity,-48.38,-84131.28
buyer_4,Marc,Andreu,1974-05-23,52965688T,marc.andreu@coolcloud.app,939777,ES43209578608750974410,5585.9,2024-10-08T09:57:26,Barcelona,expenses,phone,-25.43,-84156.71
buyer_4,Marc,Andreu,1974-05-23,52965688T,marc.andreu@coolcloud.app,939777,ES43209578608750974410,5585.9,2024-10-08T18:54:41,Barcelona,expenses,clothing,-156.97,-84313.68
buyer_4,Marc,Andreu,1974-05-23,52965688T,marc.andreu@coolcloud.app,939777,ES43209578608750974410,5585.9,2024-10-09T17:55:20,Barcelona,expenses,clothing,-138.85,-84452.53
buyer_5,Sara,Urkiaga,1994-03-12,95203027R,sara.urkiaga@megabyte.net,951608,ES89209541595236157007,1585.44,2022-01-01T17:40:06,Plentzia,incomes,salary,2177.55,3762.99
buyer_5,Sara,Urkiaga,1994-03-12,95203027R,sara.urkiaga@megabyte.net,951608,ES89209541595236157007,1585.44,2022-01-01T17:40:06,Plentzia,incomes,salary_partner,2164.93,5927.92
buyer_5,Sara,Urkiaga,1994-03-12,95203027R,sara.urkiaga@megabyte.net,951608,ES89209541595236157007,1585.44,2022-01-03T14:55:27,Plentzia,expenses,clothing,-103.4,5824.52
buyer_5,Sara,Urkiaga,1994-03-12,95203027R,sara.urkiaga@megabyte.net,951608,ES89209541595236157007,1585.44,2022-01-05T08:51:43,Plentzia,expenses,mortgage,-2095.25,3729.27
buyer_5,Sara,Urkiaga,1994-03-12,95203027R,sara.urkiaga@megabyte.net,951608,ES89209541595236157007,1585.44,2022-01-05T08:00:05,Plentzia,expenses,gas,-169.65,3559.62
buyer_5,Sara,Urkiaga,1994-03-12,95203027R,sara.urkiaga@megabyte.net,951608,ES89209541595236157007,1585.44,2022-01-06T10:57:29,Plentzia,expenses,water,-56.39,3503.23
buyer_5,Sara,Urkiaga,1994-03-12,95203027R,sara.urkiaga@megabyte.net,951608,ES89209541595236157007,1585.44,2022-01-06T10:42:31,Plentzia,expenses,electricity,-94.36,3408.87
buyer_5,Sara,Urkiaga,1994-03-12,95203027R,sara.urkiaga@megabyte.net,951608,ES89209541595236157007,1585.44,2022-01-07T18:35:18,Plentzia,expenses,gas,-181.12,3227.75
buyer_5,Sara,Urkiaga,1994-03-12,95203027R,sara.urkiaga@megabyte.net,951608,ES89209541595236157007,1585.44,2022-01-07T11:43:36,Plentzia,expenses,internet,-91.19,3136.56
buyer_5,Sara,Urkiaga,1994-03-12,95203027R,sara.urkiaga@megabyte.net,951608,ES89209541595236157007,1585.44,2022-01-08T20:34:19,Plentzia,expenses,gas,-160.28,2976.28
buyer_5,Sara,Urkiaga,1994-03-12,95203027R,sara.urkiaga@megabyte.net,951608,ES89209541595236157007,1585.44,2022-01-08T10:50:30,Plentzia,expenses,leisure,-49.14,2927.14
buyer_5,Sara,Urkiaga,1994-03-12,95203027R,sara.urkiaga@megabyte.net,951608,ES89209541595236157007,1585.44,2022-01-08T06:49:47,Plentzia,expenses,travel,-547.65,2379.49
buyer_5,Sara,Urkiaga,1994-03-12,95203027R,sara.urkiaga@megabyte.net,951608,ES89209541595236157007,1585.44,2022-01-09T03:23:07,Plentzia,expenses,leisure,-44.53,2334.96
buyer_5,Sara,Urkiaga,1994-03-12,95203027R,sara.urkiaga@megabyte.net,951608,ES89209541595236157007,1585.44,2022-01-09T08:00:52,Plentzia,expenses,cash,-100.0,2234.96
buyer_5,Sara,Urkiaga,1994-03-12,95203027R,sara.urkiaga@megabyte.net,951608,ES89209541595236157007,1585.44,2022-01-10T08:48:41,Plentzia,expenses,leisure,-37.22,2197.74
buyer_5,Sara,Urkiaga,1994-03-12,95203027R,sara.urkiaga@megabyte.net,951608,ES89209541595236157007,1585.44,2022-01-10T16:43:17,Plentzia,expenses,repairs,-106.83,2090.91
buyer_5,Sara,Urkiaga,1994-03-12,95203027R,sara.urkiaga@megabyte.net,951608,ES89209541595236157007,1585.44,2022-01-11T08:38:42,Plentzia,expenses,repairs,-128.43,1962.48
buyer_5,Sara,Urkiaga,1994-03-12,95203027R,sara.urkiaga@megabyte.net,951608,ES89209541595236157007,1585.44,2022-01-12T15:53:23,Plentzia,expenses,transport,-74.49,1887.99
buyer_5,Sara,Urkiaga,1994-03-12,95203027R,sara.urkiaga@megabyte.net,951608,ES89209541595236157007,1585.44,2022-01-13T18:06:19,Plentzia,expenses,healthcare,-144.53,1743.46
buyer_5,Sara,Urkiaga,1994-03-12,95203027R,sara.urkiaga@megabyte.net,951608,ES89209541595236157007,1585.44,2022-01-14T11:21:17,Plentzia,expenses,food,-69.01,1674.45
buyer_5,Sara,Urkiaga,1994-03-12,95203027R,sara.urkiaga@megabyte.net,951608,ES89209541595236157007,1585.44,2022-01-15T18:31:51,Plentzia,expenses,leisure,-83.77,1590.68
buyer_5,Sara,Urkiaga,1994-03-12,95203027R,sara.urkiaga@megabyte.net,951608,ES89209541595236157007,1585.44,2022-01-16T09:35:36,Plentzia,expenses,repairs,-202.15,1388.53
buyer_5,Sara,Urkiaga,1994-03-12,95203027R,sara.urkiaga@megabyte.net,951608,ES89209541595236157007,1585.44,2022-01-19T16:13:07,Plentzia,expenses,repairs,-124.83,1263.7
buyer_5,Sara,Urkiaga,1994-03-12,95203027R,sara.urkiaga@megabyte.net,951608,ES89209541595236157007,1585.44,2022-01-22T05:02:46,Plentzia,expenses,gifts,-573.27,690.43
buyer_5,Sara,Urkiaga,1994-03-12,95203027R,sara.urkiaga@megabyte.net,951608,ES89209541595236157007,1585.44,2022-01-23T09:29:35,Plentzia,expenses,cash,-100.0,590.43
buyer_5,Sara,Urkiaga,1994-03-12,95203027R,sara.urkiaga@megabyte.net,951608,ES89209541595236157007,1585.44,2022-01-25T20:18:44,Plentzia,expenses,food,-60.08,530.35
buyer_5,Sara,Urkiaga,1994-03-12,95203027R,sara.urkiaga@megabyte.net,951608,ES89209541595236157007,1585.44,2022-01-26T14:45:48,Plentzia,expenses,cash,-100.0,430.35
buyer_5,Sara,Urkiaga,1994-03-12,95203027R,sara.urkiaga@megabyte.net,951608,ES89209541595236157007,1585.44,2022-01-26T00:27:30,Plentzia,expenses,gifts,-39.57,390.78
buyer_5,Sara,Urkiaga,1994-03-12,95203027R,sara.urkiaga@megabyte.net,951608,ES89209541595236157007,1585.44,2022-01-27T14:09:18,Plentzia,expenses,clothing,-121.25,269.53
buyer_5,Sara,Urkiaga,1994-03-12,95203027R,sara.urkiaga@megabyte.net,951608,ES89209541595236157007,1585.44,2022-01-27T15:40:39,Plentzia,expenses,cash,-100.0,169.53
buyer_5,Sara,Urkiaga,1994-03-12,95203027R,sara.urkiaga@megabyte.net,951608,ES89209541595236157007,1585.44,2022-01-29T10:35:41,Plentzia,expenses,food,-103.57,65.96
buyer_5,Sara,Urkiaga,1994-03-12,95203027R,sara.urkiaga@megabyte.net,951608,ES89209541595236157007,1585.44,2022-01-29T12:09:05,Plentzia,expenses,cash,-100.0,-34.04
buyer_5,Sara,Urkiaga,1994-03-12,95203027R,sara.urkiaga@megabyte.net,951608,ES89209541595236157007,1585.44,2022-01-30T23:58:03,Plentzia,expenses,cash,-100.0,-134.04
buyer_5,Sara,Urkiaga,1994-03-12,95203027R,sara.urkiaga@megabyte.net,951608,ES89209541595236157007,1585.44,2022-02-01T22:42:37,Plentzia,incomes,salary,2177.55,2043.51
buyer_5,Sara,Urkiaga,1994-03-12,95203027R,sara.urkiaga@megabyte.net,951608,ES89209541595236157007,1585.44,2022-02-01T22:42:37,Plentzia,incomes,salary_partner,2164.93,4208.44
buyer_5,Sara,Urkiaga,1994-03-12,95203027R,sara.urkiaga@megabyte.net,951608,ES89209541595236157007,1585.44,2022-02-01T21:22:04,Plentzia,expenses,healthcare,-48.25,4160.19
buyer_5,Sara,Urkiaga,1994-03-12,95203027R,sara.urkiaga@megabyte.net,951608,ES89209541595236157007,1585.44,2022-02-01T08:55:42,Plentzia,expenses,cash,-100.0,4060.19
buyer_5,Sara,Urkiaga,1994-03-12,95203027R,sara.urkiaga@megabyte.net,951608,ES89209541595236157007,1585.44,2022-02-02T09:47:59,Plentzia,expenses,cash,-100.0,3960.19
buyer_5,Sara,Urkiaga,1994-03-12,95203027R,sara.urkiaga@megabyte.net,951608,ES89209541595236157007,1585.44,2022-02-03T17:43:43,Plentzia,expenses,food,-72.6,3887.59
buyer_5,Sara,Urkiaga,1994-03-12,95203027R,sara.urkiaga@megabyte.net,951608,ES89209541595236157007,1585.44,2022-02-03T10:05:30,Plentzia,expenses,clothing,-73.88,3813.71
buyer_5,Sara,Urkiaga,1994-03-12,95203027R,sara.urkiaga@megabyte.net,951608,ES89209541595236157007,1585.44,2022-02-03T13:00:44,Plentzia,expenses,cash,-100.0,3713.71
buyer_5,Sara,Urkiaga,1994-03-12,95203027R,sara.urkiaga@megabyte.net,951608,ES89209541595236157007,1585.44,2022-02-05T13:36:43,Plentzia,expenses,mortgage,-2095.25,1618.46
buyer_5,Sara,Urkiaga,1994-03-12,95203027R,sara.urkiaga@megabyte.net,951608,ES89209541595236157007,1585.44,2022-02-05T09:39:25,Plentzia,expenses,water,-59.03,1559.43
buyer_5,Sara,Urkiaga,1994-03-12,95203027R,sara.urkiaga@megabyte.net,951608,ES89209541595236157007,1585.44,2022-02-05T17:19:49,Plentzia,expenses,gas,-206.74,1352.69
buyer_5,Sara,Urkiaga,1994-03-12,95203027R,sara.urkiaga@megabyte.net,951608,ES89209541595236157007,1585.44,2022-02-05T20:49:45,Plentzia,expenses,leisure,-56.64,1296.05
buyer_5,Sara,Urkiaga,1994-03-12,95203027R,sara.urkiaga@megabyte.net,951608,ES89209541595236157007,1585.44,2022-02-06T08:47:35,Plentzia,expenses,water,-65.09,1230.96
buyer_5,Sara,Urkiaga,1994-03-12,95203027R,sara.urkiaga@megabyte.net,951608,ES89209541595236157007,1585.44,2022-02-06T10:00:45,Plentzia,expenses,internet,-91.19,1139.77
buyer_5,Sara,Urkiaga,1994-03-12,95203027R,sara.urkiaga@megabyte.net,951608,ES89209541595236157007,1585.44,2022-02-07T19:02:51,Plentzia,expenses,electricity,-104.44,1035.33
buyer_5,Sara,Urkiaga,1994-03-12,95203027R,sara.urkiaga@megabyte.net,951608,ES89209541595236157007,1585.44,2022-02-07T08:23:04,Plentzia,expenses,internet,-91.19,944.14
buyer_5,Sara,Urkiaga,1994-03-12,95203027R,sara.urkiaga@megabyte.net,951608,ES89209541595236157007,1585.44,2022-02-08T12:11:55,Plentzia,expenses,water,-73.11,871.03
buyer_5,Sara,Urkiaga,1994-03-12,95203027R,sara.urkiaga@megabyte.net,951608,ES89209541595236157007,1585.44,2022-02-08T20:03:36,Plentzia,expenses,phone,-79.06,791.97
buyer_5,Sara,Urkiaga,1994-03-12,95203027R,sara.urkiaga@megabyte.net,951608,ES89209541595236157007,1585.44,2022-02-11T10:24:16,Plentzia,expenses,leisure,-41.06,750.91
buyer_5,Sara,Urkiaga,1994-03-12,95203027R,sara.urkiaga@megabyte.net,951608,ES89209541595236157007,1585.44,2022-02-13T11:23:00,Plentzia,expenses,education,-51.59,699.32
buyer_5,Sara,Urkiaga,1994-03-12,95203027R,sara.urkiaga@megabyte.net,951608,ES89209541595236157007,1585.44,2022-02-14T04:41:38,Plentzia,expenses,leisure,-39.55,659.77
buyer_5,Sara,Urkiaga,1994-03-12,95203027R,sara.urkiaga@megabyte.net,951608,ES89209541595236157007,1585.44,2022-02-15T22:02:33,Plentzia,expenses,leisure,-34.78,624.99
buyer_5,Sara,Urkiaga,1994-03-12,95203027R,sara.urkiaga@megabyte.net,951608,ES89209541595236157007,1585.44,2022-02-17T12:00:54,Plentzia,expenses,leisure,-77.09,547.9
buyer_5,Sara,Urkiaga,1994-03-12,95203027R,sara.urkiaga@megabyte.net,951608,ES89209541595236157007,1585.44,2022-02-17T09:01:43,Plentzia,expenses,cash,-100.0,447.9
buyer_5,Sara,Urkiaga,1994-03-12,95203027R,sara.urkiaga@megabyte.net,951608,ES89209541595236157007,1585.44,2022-02-17T19:44:57,Plentzia,expenses,appliances,-208.1,239.8
buyer_5,Sara,Urkiaga,1994-03-12,95203027R,sara.urkiaga@megabyte.net,951608,ES89209541595236157007,1585.44,2022-02-18T13:35:20,Plentzia,expenses,gifts,-448.69,-208.89
buyer_5,Sara,Urkiaga,1994-03-12,95203027R,sara.urkiaga@megabyte.net,951608,ES89209541595236157007,1585.44,2022-02-19T11:53:15,Plentzia,expenses,food,-106.08,-314.97
buyer_5,Sara,Urkiaga,1994-03-12,95203027R,sara.urkiaga@megabyte.net,951608,ES89209541595236157007,1585.44,2022-02-19T04:45:37,Plentzia,expenses,education,-51.07,-366.04
buyer_5,Sara,Urkiaga,1994-03-12,95203027R,sara.urkiaga@megabyte.net,951608,ES89209541595236157007,1585.44,2022-02-20T05:51:23,Plentzia,expenses,food,-92.38,-458.42
buyer_5,Sara,Urkiaga,1994-03-12,95203027R,sara.urkiaga@megabyte.net,951608,ES89209541595236157007,1585.44,2022-02-20T13:43:50,Plentzia,expenses,transport,-73.48,-531.9
buyer_5,Sara,Urkiaga,1994-03-12,95203027R,sara.urkiaga@megabyte.net,951608,ES89209541595236157007,1585.44,2022-02-22T11:29:44,Plentzia,expenses,leisure,-84.66,-616.56
buyer_5,Sara,Urkiaga,1994-03-12,95203027R,sara.urkiaga@megabyte.net,951608,ES89209541595236157007,1585.44,2022-02-24T11:05:46,Plentzia,expenses,food,-86.69,-703.25
buyer_5,Sara,Urkiaga,1994-03-12,95203027R,sara.urkiaga@megabyte.net,951608,ES89209541595236157007,1585.44,2022-02-27T17:53:03,Plentzia,expenses,transport,-60.07,-763.32
buyer_5,Sara,Urkiaga,1994-03-12,95203027R,sara.urkiaga@megabyte.net,951608,ES89209541595236157007,1585.44,2022-03-01T12:00:46,Plentzia,incomes,salary,2177.55,1414.23
buyer_5,Sara,Urkiaga,1994-03-12,95203027R,sara.urkiaga@megabyte.net,951608,ES89209541595236157007,1585.44,2022-03-01T12:00:46,Plentzia,incomes,salary_partner,2164.93,3579.16
buyer_5,Sara,Urkiaga,1994-03-12,95203027R,sara.urkiaga@megabyte.net,951608,ES89209541595236157007,1585.44,2022-03-01T12:00:46,Plentzia,incomes,extra_income,224.91,3804.07
buyer_5,Sara,Urkiaga,1994-03-12,95203027R,sara.urkiaga@megabyte.net,951608,ES89209541595236157007,1585.44,2022-03-01T18:32:07,Plentzia,expenses,food,-95.15,3708.92
buyer_5,Sara,Urkiaga,1994-03-12,95203027R,sara.urkiaga@megabyte.net,951608,ES89209541595236157007,1585.44,2022-03-01T15:53:52,Plentzia,expenses,cash,-100.0,3608.92
buyer_5,Sara,Urkiaga,1994-03-12,95203027R,sara.urkiaga@megabyte.net,951608,ES89209541595236157007,1585.44,2022-03-03T15:32:03,Plentzia,expenses,clothing,-91.04,3517.88
buyer_5,Sara,Urkiaga,1994-03-12,95203027R,sara.urkiaga@megabyte.net,951608,ES89209541595236157007,1585.44,2022-03-04T12:01:14,Plentzia,expenses,food,-79.89,3437.99
buyer_5,Sara,Urkiaga,1994-03-12,95203027R,sara.urkiaga@megabyte.net,951608,ES89209541595236157007,1585.44,2022-03-04T09:46:58,Plentzia,expenses,cash,-100.0,3337.99
buyer_5,Sara,Urkiaga,1994-03-12,95203027R,sara.urkiaga@megabyte.net,951608,ES89209541595236157007,1585.44,2022-03-05T20:02:14,Plentzia,expenses,mortgage,-2095.25,1242.74
buyer_5,Sara,Urkiaga,1994-03-12,95203027R,sara.urkiaga@megabyte.net,951608,ES89209541595236157007,1585.44,2022-03-05T17:14:57,Plentzia,expenses,water,-82.99,1159.75
buyer_5,Sara,Urkiaga,1994-03-12,95203027R,sara.urkiaga@megabyte.net,951608,ES89209541595236157007,1585.44,2022-03-05T14:32:29,Plentzia,expenses,food,-88.24,1071.51
buyer_5,Sara,Urkiaga,1994-03-12,95203027R,sara.urkiaga@megabyte.net,951608,ES89209541595236157007,1585.44,2022-03-05T20:11:08,Plentzia,expenses,clothing,-69.76,1001.75
buyer_5,Sara,Urkiaga,1994-03-12,95203027R,sara.urkiaga@megabyte.net,951608,ES89209541595236157007,1585.44,2022-03-05T14:46:01,Plentzia,expenses,cash,-100.0,901.75
buyer_5,Sara,Urkiaga,1994-03-12,95203027R,sara.urkiaga@megabyte.net,951608,ES89209541595236157007,1585.44,2022-03-06T09:44:38,Plentzia,expenses,gas,-65.19,836.56
buyer_5,Sara,Urkiaga,1994-03-12,95203027R,sara.urkiaga@megabyte.net,951608,ES89209541595236157007,1585.44,2022-03-06T13:36:59,Plentzia,expenses,food,-105.17,731.39
buyer_5,Sara,Urkiaga,1994-03-12,95203027R,sara.urkiaga@megabyte.net,951608,ES89209541595236157007,1585.44,2022-03-06T18:19:20,Plentzia,expenses,education,-71.07,660.32
buyer_5,Sara,Urkiaga,1994-03-12,95203027R,sara.urkiaga@megabyte.net,951608,ES89209541595236157007,1585.44,2022-03-07T12:57:37,Plentzia,expenses,electricity,-102.35,557.97
buyer_5,Sara,Urkiaga,1994-03-12,95203027R,sara.urkiaga@megabyte.net,951608,ES89209541595236157007,1585.44,2022-03-07T18:44:34,Plentzia,expenses,phone,-67.26,490.71
buyer_5,Sara,Urkiaga,1994-03-12,95203027R,sara.urkiaga@megabyte.net,951608,ES89209541595236157007,1585.44,2022-03-08T12:57:16,Plentzia,expenses,food,-68.48,422.23
buyer_5,Sara,Urkiaga,1994-03-12,95203027R,sara.urkiaga@megabyte.net,951608,ES89209541595236157007,1585.44,2022-03-11T17:45:05,Plentzia,expenses,cash,-100.0,322.23
buyer_5,Sara,Urkiaga,1994-03-12,95203027R,sara.urkiaga@megabyte.net,951608,ES89209541595236157007,1585.44,2022-03-13T19:58:31,Plentzia,expenses,food,-82.21,240.02
buyer_5,Sara,Urkiaga,1994-03-12,95203027R,sara.urkiaga@megabyte.net,951608,ES89209541595236157007,1585.44,2022-03-13T13:53:04,Plentzia,expenses,leisure,-51.88,188.14
buyer_5,Sara,Urkiaga,1994-03-12,95203027R,sara.urkiaga@megabyte.net,951608,ES89209541595236157007,1585.44,2022-03-14T20:24:10,Plentzia,expenses,food,-96.04,92.1
buyer_5,Sara,Urkiaga,1994-03-12,95203027R,sara.urkiaga@megabyte.net,951608,ES89209541595236157007,1585.44,2022-03-14T15:11:05,Plentzia,expenses,cash,-100.0,-7.9
buyer_5,Sara,Urkiaga,1994-03-12,95203027R,sara.urkiaga@megabyte.net,951608,ES89209541595236157007,1585.44,2022-03-15T15:48:17,Plentzia,expenses,education,-58.29,-66.19
buyer_5,Sara,Urkiaga,1994-03-12,95203027R,sara.urkiaga@megabyte.net,951608,ES89209541595236157007,1585.44,2022-03-17T09:00:53,Plentzia,expenses,cash,-100.0,-166.19
buyer_5,Sara,Urkiaga,1994-03-12,95203027R,sara.urkiaga@megabyte.net,951608,ES89209541595236157007,1585.44,2022-03-20T10:18:16,Plentzia,expenses,transport,-59.64,-225.83
buyer_5,Sara,Urkiaga,1994-03-12,95203027R,sara.urkiaga@megabyte.net,951608,ES89209541595236157007,1585.44,2022-03-20T14:20:11,Plentzia,expenses,leisure,-21.96,-247.79
buyer_5,Sara,Urkiaga,1994-03-12,95203027R,sara.urkiaga@megabyte.net,951608,ES89209541595236157007,1585.44,2022-03-20T18:07:36,Plentzia,expenses,repairs,-139.99,-387.78
buyer_5,Sara,Urkiaga,1994-03-12,95203027R,sara.urkiaga@megabyte.net,951608,ES89209541595236157007,1585.44,2022-03-21T17:28:28,Plentzia,expenses,travel,-587.06,-974.84
buyer_5,Sara,Urkiaga,1994-03-12,95203027R,sara.urkiaga@megabyte.net,951608,ES89209541595236157007,1585.44,2022-03-21T16:47:11,Plentzia,expenses,gifts,-51.32,-1026.16
buyer_5,Sara,Urkiaga,1994-03-12,95203027R,sara.urkiaga@megabyte.net,951608,ES89209541595236157007,1585.44,2022-03-22T10:31:16,Plentzia,expenses,transport,-42.8,-1068.96
buyer_5,Sara,Urkiaga,1994-03-12,95203027R,sara.urkiaga@megabyte.net,951608,ES89209541595236157007,1585.44,2022-03-22T19:51:01,Plentzia,expenses,cash,-100.0,-1168.96
buyer_5,Sara,Urkiaga,1994-03-12,95203027R,sara.urkiaga@megabyte.net,951608,ES89209541595236157007,1585.44,2022-03-25T19:50:18,Plentzia,expenses,clothing,-144.31,-1313.27
buyer_5,Sara,Urkiaga,1994-03-12,95203027R,sara.urkiaga@megabyte.net,951608,ES89209541595236157007,1585.44,2022-03-25T15:25:36,Plentzia,expenses,appliances,-295.55,-1608.82
buyer_5,Sara,Urkiaga,1994-03-12,95203027R,sara.urkiaga@megabyte.net,951608,ES89209541595236157007,1585.44,2022-03-25T22:39:09,Plentzia,expenses,gifts,-173.59,-1782.41
buyer_5,Sara,Urkiaga,1994-03-12,95203027R,sara.urkiaga@megabyte.net,951608,ES89209541595236157007,1585.44,2022-03-26T12:39:40,Plentzia,expenses,leisure,-54.36,-1836.77
buyer_5,Sara,Urkiaga,1994-03-12,95203027R,sara.urkiaga@megabyte.net,951608,ES89209541595236157007,1585.44,2022-03-26T15:39:43,Plentzia,expenses,cash,-100.0,-1936.77
buyer_5,Sara,Urkiaga,1994-03-12,95203027R,sara.urkiaga@megabyte.net,951608,ES89209541595236157007,1585.44,2022-03-27T16:23:31,Plentzia,expenses,healthcare,-152.85,-2089.62
buyer_5,Sara,Urkiaga,1994-03-12,95203027R,sara.urkiaga@megabyte.net,951608,ES89209541595236157007,1585.44,2022-03-27T20:43:27,Plentzia,expenses,cash,-100.0,-2189.62
buyer_5,Sara,Urkiaga,1994-03-12,95203027R,sara.urkiaga@megabyte.net,951608,ES89209541595236157007,1585.44,2022-03-27T18:29:37,Plentzia,expenses,gifts,-248.08,-2437.7
buyer_5,Sara,Urkiaga,1994-03-12,95203027R,sara.urkiaga@megabyte.net,951608,ES89209541595236157007,1585.44,2022-03-29T19:12:20,Plentzia,expenses,gifts,-343.25,-2780.95
buyer_5,Sara,Urkiaga,1994-03-12,95203027R,sara.urkiaga@megabyte.net,951608,ES89209541595236157007,1585.44,2022-03-31T19:19:52,Plentzia,expenses,cash,-100.0,-2880.95
buyer_5,Sara,Urkiaga,1994-03-12,95203027R,sara.urkiaga@megabyte.net,951608,ES89209541595236157007,1585.44,2022-03-31T17:07:24,Plentzia,expenses,gifts,-408.88,-3289.83
buyer_5,Sara,Urkiaga,1994-03-12,95203027R,sara.urkiaga@megabyte.net,951608,ES89209541595236157007,1585.44,2022-04-01T08:03:05,Plentzia,incomes,salary,2177.55,-1112.28
buyer_5,Sara,Urkiaga,1994-03-12,95203027R,sara.urkiaga@megabyte.net,951608,ES89209541595236157007,1585.44,2022-04-01T08:03:05,Plentzia,incomes,salary_partner,2164.93,1052.65
buyer_5,Sara,Urkiaga,1994-03-12,95203027R,sara.urkiaga@megabyte.net,951608,ES89209541595236157007,1585.44,2022-04-02T20:08:06,Plentzia,expenses,clothing,-94.09,958.56
buyer_5,Sara,Urkiaga,1994-03-12,95203027R,sara.urkiaga@megabyte.net,951608,ES89209541595236157007,1585.44,2022-04-02T20:37:11,Plentzia,expenses,cash,-100.0,858.56
buyer_5,Sara,Urkiaga,1994-03-12,95203027R,sara.urkiaga@megabyte.net,951608,ES89209541595236157007,1585.44,2022-04-04T10:33:44,Plentzia,expenses,education,-51.22,807.34
buyer_5,Sara,Urkiaga,1994-03-12,95203027R,sara.urkiaga@megabyte.net,951608,ES89209541595236157007,1585.44,2022-04-05T07:04:51,Plentzia,expenses,mortgage,-2095.25,-1287.91
buyer_5,Sara,Urkiaga,1994-03-12,95203027R,sara.urkiaga@megabyte.net,951608,ES89209541595236157007,1585.44,2022-04-06T19:56:18,Plentzia,expenses,water,-94.82,-1382.73
buyer_5,Sara,Urkiaga,1994-03-12,95203027R,sara.urkiaga@megabyte.net,951608,ES89209541595236157007,1585.44,2022-04-06T18:22:53,Plentzia,expenses,phone,-71.98,-1454.71
buyer_5,Sara,Urkiaga,1994-03-12,95203027R,sara.urkiaga@megabyte.net,951608,ES89209541595236157007,1585.44,2022-04-06T12:08:21,Plentzia,expenses,transport,-49.54,-1504.25
buyer_5,Sara,Urkiaga,1994-03-12,95203027R,sara.urkiaga@megabyte.net,951608,ES89209541595236157007,1585.44,2022-04-07T10:28:22,Plentzia,expenses,water,-79.26,-1583.51
buyer_5,Sara,Urkiaga,1994-03-12,95203027R,sara.urkiaga@megabyte.net,951608,ES89209541595236157007,1585.44,2022-04-07T12:24:25,Plentzia,expenses,cash,-100.0,-1683.51
buyer_5,Sara,Urkiaga,1994-03-12,95203027R,sara.urkiaga@megabyte.net,951608,ES89209541595236157007,1585.44,2022-04-08T22:25:46,Plentzia,expenses,internet,-91.19,-1774.7
buyer_5,Sara,Urkiaga,1994-03-12,95203027R,sara.urkiaga@megabyte.net,951608,ES89209541595236157007,1585.44,2022-04-08T15:40:39,Plentzia,expenses,transport,-63.54,-1838.24
buyer_5,Sara,Urkiaga,1994-03-12,95203027R,sara.urkiaga@megabyte.net,951608,ES89209541595236157007,1585.44,2022-04-09T10:20:08,Plentzia,expenses,healthcare,-58.09,-1896.33
buyer_5,Sara,Urkiaga,1994-03-12,95203027R,sara.urkiaga@megabyte.net,951608,ES89209541595236157007,1585.44,2022-04-10T18:04:30,Plentzia,expenses,food,-91.35,-1987.68
buyer_5,Sara,Urkiaga,1994-03-12,95203027R,sara.urkiaga@megabyte.net,951608,ES89209541595236157007,1585.44,2022-04-10T08:04:07,Plentzia,expenses,clothing,-90.57,-2078.25
buyer_5,Sara,Urkiaga,1994-03-12,95203027R,sara.urkiaga@megabyte.net,951608,ES89209541595236157007,1585.44,2022-04-10T10:55:57,Plentzia,expenses,cash,-100.0,-2178.25
buyer_5,Sara,Urkiaga,1994-03-12,95203027R,sara.urkiaga@megabyte.net,951608,ES89209541595236157007,1585.44,2022-04-14T18:23:52,Plentzia,expenses,healthcare,-56.86,-2235.11
buyer_5,Sara,Urkiaga,1994-03-12,95203027R,sara.urkiaga@megabyte.net,951608,ES89209541595236157007,1585.44,2022-04-15T17:30:42,Plentzia,expenses,leisure,-79.5,-2314.61
buyer_5,Sara,Urkiaga,1994-03-12,95203027R,sara.urkiaga@megabyte.net,951608,ES89209541595236157007,1585.44,2022-04-17T15:43:14,Plentzia,expenses,food,-89.54,-2404.15
buyer_5,Sara,Urkiaga,1994-03-12,95203027R,sara.urkiaga@megabyte.net,951608,ES89209541595236157007,1585.44,2022-04-20T12:49:06,Plentzia,expenses,cash,-100.0,-2504.15
buyer_5,Sara,Urkiaga,1994-03-12,95203027R,sara.urkiaga@megabyte.net,951608,ES89209541595236157007,1585.44,2022-04-21T11:00:38,Plentzia,expenses,transport,-41.82,-2545.97
buyer_5,Sara,Urkiaga,1994-03-12,95203027R,sara.urkiaga@megabyte.net,951608,ES89209541595236157007,1585.44,2022-04-22T19:58:25,Plentzia,expenses,food,-103.81,-2649.78
buyer_5,Sara,Urkiaga,1994-03-12,95203027R,sara.urkiaga@megabyte.net,951608,ES89209541595236157007,1585.44,2022-04-23T16:45:47,Plentzia,expenses,clothing,-81.63,-2731.41
buyer_5,Sara,Urkiaga,1994-03-12,95203027R,sara.urkiaga@megabyte.net,951608,ES89209541595236157007,1585.44,2022-04-24T19:57:13,Plentzia,expenses,education,-50.55,-2781.96
buyer_5,Sara,Urkiaga,1994-03-12,95203027R,sara.urkiaga@megabyte.net,951608,ES89209541595236157007,1585.44,2022-04-25T08:32:07,Plentzia,expenses,education,-72.02,-2853.98
buyer_5,Sara,Urkiaga,1994-03-12,95203027R,sara.urkiaga@megabyte.net,951608,ES89209541595236157007,1585.44,2022-04-26T18:52:58,Plentzia,expenses,leisure,-56.57,-2910.55
buyer_5,Sara,Urkiaga,1994-03-12,95203027R,sara.urkiaga@megabyte.net,951608,ES89209541595236157007,1585.44,2022-04-27T01:19:27,Plentzia,expenses,cash,-100.0,-3010.55
buyer_5,Sara,Urkiaga,1994-03-12,95203027R,sara.urkiaga@megabyte.net,951608,ES89209541595236157007,1585.44,2022-04-28T14:04:33,Plentzia,expenses,transport,-82.41,-3092.96
buyer_5,Sara,Urkiaga,1994-03-12,95203027R,sara.urkiaga@megabyte.net,951608,ES89209541595236157007,1585.44,2022-04-29T15:50:50,Plentzia,expenses,repairs,-36.44,-3129.4
buyer_5,Sara,Urkiaga,1994-03-12,95203027R,sara.urkiaga@megabyte.net,951608,ES89209541595236157007,1585.44,2022-05-01T23:22:06,Plentzia,incomes,salary,2177.55,-951.85
buyer_5,Sara,Urkiaga,1994-03-12,95203027R,sara.urkiaga@megabyte.net,951608,ES89209541595236157007,1585.44,2022-05-01T23:22:06,Plentzia,incomes,salary_partner,2164.93,1213.08
buyer_5,Sara,Urkiaga,1994-03-12,95203027R,sara.urkiaga@megabyte.net,951608,ES89209541595236157007,1585.44,2022-05-01T03:32:44,Plentzia,expenses,food,-91.18,1121.9
buyer_5,Sara,Urkiaga,1994-03-12,95203027R,sara.urkiaga@megabyte.net,951608,ES89209541595236157007,1585.44,2022-05-02T10:15:27,Plentzia,expenses,cash,-100.0,1021.9
buyer_5,Sara,Urkiaga,1994-03-12,95203027R,sara.urkiaga@megabyte.net,951608,ES89209541595236157007,1585.44,2022-05-04T11:38:48,Plentzia,expenses,repairs,-259.71,762.19
buyer_5,Sara,Urkiaga,1994-03-12,95203027R,sara.urkiaga@megabyte.net,951608,ES89209541595236157007,1585.44,2022-05-05T17:54:58,Plentzia,expenses,mortgage,-2095.25,-1333.06
buyer_5,Sara,Urkiaga,1994-03-12,95203027R,sara.urkiaga@megabyte.net,951608,ES89209541595236157007,1585.44,2022-05-05T21:03:48,Plentzia,expenses,gas,-170.45,-1503.51
buyer_5,Sara,Urkiaga,1994-03-12,95203027R,sara.urkiaga@megabyte.net,951608,ES89209541595236157007,1585.44,2022-05-05T20:16:40,Plentzia,expenses,leisure,-82.3,-1585.81
buyer_5,Sara,Urkiaga,1994-03-12,95203027R,sara.urkiaga@megabyte.net,951608,ES89209541595236157007,1585.44,2022-05-06T23:50:50,Plentzia,expenses,electricity,-94.79,-1680.6
buyer_5,Sara,Urkiaga,1994-03-12,95203027R,sara.urkiaga@megabyte.net,951608,ES89209541595236157007,1585.44,2022-05-06T17:13:44,Plentzia,expenses,food,-94.98,-1775.58
buyer_5,Sara,Urkiaga,1994-03-12,95203027R,sara.urkiaga@megabyte.net,951608,ES89209541595236157007,1585.44,2022-05-07T09:05:59,Plentzia,expenses,electricity,-94.42,-1870.0
buyer_5,Sara,Urkiaga,1994-03-12,95203027R,sara.urkiaga@megabyte.net,951608,ES89209541595236157007,1585.44,2022-05-07T09:12:49,Plentzia,expenses,gas,-71.5,-1941.5
buyer_5,Sara,Urkiaga,1994-03-12,95203027R,sara.urkiaga@megabyte.net,951608,ES89209541595236157007,1585.44,2022-05-08T17:40:32,Plentzia,expenses,electricity,-188.34,-2129.84
buyer_5,Sara,Urkiaga,1994-03-12,95203027R,sara.urkiaga@megabyte.net,951608,ES89209541595236157007,1585.44,2022-05-08T20:23:52,Plentzia,expenses,transport,-79.71,-2209.55
buyer_5,Sara,Urkiaga,1994-03-12,95203027R,sara.urkiaga@megabyte.net,951608,ES89209541595236157007,1585.44,2022-05-09T08:34:42,Plentzia,expenses,education,-44.08,-2253.63
buyer_5,Sara,Urkiaga,1994-03-12,95203027R,sara.urkiaga@megabyte.net,951608,ES89209541595236157007,1585.44,2022-05-09T11:34:45,Plentzia,expenses,repairs,-166.34,-2419.97
buyer_5,Sara,Urkiaga,1994-03-12,95203027R,sara.urkiaga@megabyte.net,951608,ES89209541595236157007,1585.44,2022-05-10T13:53:04,Plentzia,expenses,transport,-42.58,-2462.55
buyer_5,Sara,Urkiaga,1994-03-12,95203027R,sara.urkiaga@megabyte.net,951608,ES89209541595236157007,1585.44,2022-05-11T15:29:41,Plentzia,expenses,food,-105.84,-2568.39
buyer_5,Sara,Urkiaga,1994-03-12,95203027R,sara.urkiaga@megabyte.net,951608,ES89209541595236157007,1585.44,2022-05-11T15:36:02,Plentzia,expenses,gifts,-301.83,-2870.22
buyer_5,Sara,Urkiaga,1994-03-12,95203027R,sara.urkiaga@megabyte.net,951608,ES89209541595236157007,1585.44,2022-05-17T09:10:54,Plentzia,expenses,gifts,-141.22,-3011.44
buyer_5,Sara,Urkiaga,1994-03-12,95203027R,sara.urkiaga@megabyte.net,951608,ES89209541595236157007,1585.44,2022-05-19T21:17:26,Plentzia,expenses,repairs,-156.73,-3168.17
buyer_5,Sara,Urkiaga,1994-03-12,95203027R,sara.urkiaga@megabyte.net,951608,ES89209541595236157007,1585.44,2022-05-20T08:53:25,Plentzia,expenses,food,-120.55,-3288.72
buyer_5,Sara,Urkiaga,1994-03-12,95203027R,sara.urkiaga@megabyte.net,951608,ES89209541595236157007,1585.44,2022-05-21T20:50:29,Plentzia,expenses,food,-117.89,-3406.61
buyer_5,Sara,Urkiaga,1994-03-12,95203027R,sara.urkiaga@megabyte.net,951608,ES89209541595236157007,1585.44,2022-05-21T14:04:43,Plentzia,expenses,transport,-40.3,-3446.91
buyer_5,Sara,Urkiaga,1994-03-12,95203027R,sara.urkiaga@megabyte.net,951608,ES89209541595236157007,1585.44,2022-05-22T12:48:58,Plentzia,expenses,education,-51.95,-3498.86
buyer_5,Sara,Urkiaga,1994-03-12,95203027R,sara.urkiaga@megabyte.net,951608,ES89209541595236157007,1585.44,2022-05-23T16:08:40,Plentzia,expenses,food,-80.61,-3579.47
buyer_5,Sara,Urkiaga,1994-03-12,95203027R,sara.urkiaga@megabyte.net,951608,ES89209541595236157007,1585.44,2022-05-23T19:49:24,Plentzia,expenses,clothing,-99.99,-3679.46
buyer_5,Sara,Urkiaga,1994-03-12,95203027R,sara.urkiaga@megabyte.net,951608,ES89209541595236157007,1585.44,2022-05-23T23:00:13,Plentzia,expenses,repairs,-204.15,-3883.61
buyer_5,Sara,Urkiaga,1994-03-12,95203027R,sara.urkiaga@megabyte.net,951608,ES89209541595236157007,1585.44,2022-05-24T12:35:24,Plentzia,expenses,gifts,-300.48,-4184.09
buyer_5,Sara,Urkiaga,1994-03-12,95203027R,sara.urkiaga@megabyte.net,951608,ES89209541595236157007,1585.44,2022-05-25T10:54:28,Plentzia,expenses,cash,-100.0,-4284.09
buyer_5,Sara,Urkiaga,1994-03-12,95203027R,sara.urkiaga@megabyte.net,951608,ES89209541595236157007,1585.44,2022-05-25T08:00:36,Plentzia,expenses,appliances,-296.3,-4580.39
buyer_5,Sara,Urkiaga,1994-03-12,95203027R,sara.urkiaga@megabyte.net,951608,ES89209541595236157007,1585.44,2022-05-26T08:14:16,Plentzia,expenses,leisure,-47.75,-4628.14
buyer_5,Sara,Urkiaga,1994-03-12,95203027R,sara.urkiaga@megabyte.net,951608,ES89209541595236157007,1585.44,2022-05-28T03:48:05,Plentzia,expenses,appliances,-338.84,-4966.98
buyer_5,Sara,Urkiaga,1994-03-12,95203027R,sara.urkiaga@megabyte.net,951608,ES89209541595236157007,1585.44,2022-06-01T15:21:05,Plentzia,incomes,salary,2177.55,-2789.43
buyer_5,Sara,Urkiaga,1994-03-12,95203027R,sara.urkiaga@megabyte.net,951608,ES89209541595236157007,1585.44,2022-06-01T15:21:05,Plentzia,incomes,salary_partner,2164.93,-624.5
buyer_5,Sara,Urkiaga,1994-03-12,95203027R,sara.urkiaga@megabyte.net,951608,ES89209541595236157007,1585.44,2022-06-01T15:21:05,Plentzia,incomes,extra_income,224.91,-399.59
buyer_5,Sara,Urkiaga,1994-03-12,95203027R,sara.urkiaga@megabyte.net,951608,ES89209541595236157007,1585.44,2022-06-01T15:21:05,Plentzia,incomes,salary_bonus,1734.44,1334.85
buyer_5,Sara,Urkiaga,1994-03-12,95203027R,sara.urkiaga@megabyte.net,951608,ES89209541595236157007,1585.44,2022-06-01T15:21:05,Plentzia,incomes,salary_partner_bonus,1578.48,2913.33
buyer_5,Sara,Urkiaga,1994-03-12,95203027R,sara.urkiaga@megabyte.net,951608,ES89209541595236157007,1585.44,2022-06-01T20:13:27,Plentzia,expenses,taxes,-3092.8,-179.47
buyer_5,Sara,Urkiaga,1994-03-12,95203027R,sara.urkiaga@megabyte.net,951608,ES89209541595236157007,1585.44,2022-06-01T19:59:43,Plentzia,expenses,insurance,-943.56,-1123.03
buyer_5,Sara,Urkiaga,1994-03-12,95203027R,sara.urkiaga@megabyte.net,951608,ES89209541595236157007,1585.44,2022-06-02T20:27:59,Plentzia,expenses,food,-75.5,-1198.53
buyer_5,Sara,Urkiaga,1994-03-12,95203027R,sara.urkiaga@megabyte.net,951608,ES89209541595236157007,1585.44,2022-06-02T16:18:56,Plentzia,expenses,transport,-54.17,-1252.7
buyer_5,Sara,Urkiaga,1994-03-12,95203027R,sara.urkiaga@megabyte.net,951608,ES89209541595236157007,1585.44,2022-06-02T05:31:37,Plentzia,expenses,leisure,-38.34,-1291.04
buyer_5,Sara,Urkiaga,1994-03-12,95203027R,sara.urkiaga@megabyte.net,951608,ES89209541595236157007,1585.44,2022-06-02T15:51:13,Plentzia,expenses,education,-54.44,-1345.48
buyer_5,Sara,Urkiaga,1994-03-12,95203027R,sara.urkiaga@megabyte.net,951608,ES89209541595236157007,1585.44,2022-06-02T14:20:01,Plentzia,expenses,repairs,-89.39,-1434.87
buyer_5,Sara,Urkiaga,1994-03-12,95203027R,sara.urkiaga@megabyte.net,951608,ES89209541595236157007,1585.44,2022-06-03T11:35:32,Plentzia,expenses,education,-72.9,-1507.77
buyer_5,Sara,Urkiaga,1994-03-12,95203027R,sara.urkiaga@megabyte.net,951608,ES89209541595236157007,1585.44,2022-06-03T12:42:29,Plentzia,expenses,cash,-100.0,-1607.77
buyer_5,Sara,Urkiaga,1994-03-12,95203027R,sara.urkiaga@megabyte.net,951608,ES89209541595236157007,1585.44,2022-06-04T11:43:57,Plentzia,expenses,education,-66.3,-1674.07
buyer_5,Sara,Urkiaga,1994-03-12,95203027R,sara.urkiaga@megabyte.net,951608,ES89209541595236157007,1585.44,2022-06-05T16:35:32,Plentzia,expenses,mortgage,-2095.25,-3769.32
buyer_5,Sara,Urkiaga,1994-03-12,95203027R,sara.urkiaga@megabyte.net,951608,ES89209541595236157007,1585.44,2022-06-05T12:36:07,Plentzia,expenses,leisure,-84.11,-3853.43
buyer_5,Sara,Urkiaga,1994-03-12,95203027R,sara.urkiaga@megabyte.net,951608,ES89209541595236157007,1585.44,2022-06-06T20:31:40,Plentzia,expenses,water,-84.31,-3937.74
buyer_5,Sara,Urkiaga,1994-03-12,95203027R,sara.urkiaga@megabyte.net,951608,ES89209541595236157007,1585.44,2022-06-06T13:57:58,Plentzia,expenses,internet,-91.19,-4028.93
buyer_5,Sara,Urkiaga,1994-03-12,95203027R,sara.urkiaga@megabyte.net,951608,ES89209541595236157007,1585.44,2022-06-07T14:59:05,Plentzia,expenses,water,-74.24,-4103.17
buyer_5,Sara,Urkiaga,1994-03-12,95203027R,sara.urkiaga@megabyte.net,951608,ES89209541595236157007,1585.44,2022-06-08T13:12:51,Plentzia,expenses,water,-76.67,-4179.84
buyer_5,Sara,Urkiaga,1994-03-12,95203027R,sara.urkiaga@megabyte.net,951608,ES89209541595236157007,1585.44,2022-06-08T20:56:50,Plentzia,expenses,electricity,-175.8,-4355.64
buyer_5,Sara,Urkiaga,1994-03-12,95203027R,sara.urkiaga@megabyte.net,951608,ES89209541595236157007,1585.44,2022-06-08T01:33:18,Plentzia,expenses,gas,-188.42,-4544.06
buyer_5,Sara,Urkiaga,1994-03-12,95203027R,sara.urkiaga@megabyte.net,951608,ES89209541595236157007,1585.44,2022-06-08T16:01:22,Plentzia,expenses,internet,-91.19,-4635.25
buyer_5,Sara,Urkiaga,1994-03-12,95203027R,sara.urkiaga@megabyte.net,951608,ES89209541595236157007,1585.44,2022-06-08T18:52:51,Plentzia,expenses,cash,-100.0,-4735.25
buyer_5,Sara,Urkiaga,1994-03-12,95203027R,sara.urkiaga@megabyte.net,951608,ES89209541595236157007,1585.44,2022-06-09T11:57:24,Plentzia,expenses,gifts,-527.86,-5263.11
buyer_5,Sara,Urkiaga,1994-03-12,95203027R,sara.urkiaga@megabyte.net,951608,ES89209541595236157007,1585.44,2022-06-10T15:59:25,Plentzia,expenses,repairs,-44.48,-5307.59
buyer_5,Sara,Urkiaga,1994-03-12,95203027R,sara.urkiaga@megabyte.net,951608,ES89209541595236157007,1585.44,2022-06-14T19:48:25,Plentzia,expenses,leisure,-24.76,-5332.35
buyer_5,Sara,Urkiaga,1994-03-12,95203027R,sara.urkiaga@megabyte.net,951608,ES89209541595236157007,1585.44,2022-06-14T11:39:26,Plentzia,expenses,gifts,-84.32,-5416.67
buyer_5,Sara,Urkiaga,1994-03-12,95203027R,sara.urkiaga@megabyte.net,951608,ES89209541595236157007,1585.44,2022-06-18T17:22:56,Plentzia,expenses,cash,-100.0,-5516.67
buyer_5,Sara,Urkiaga,1994-03-12,95203027R,sara.urkiaga@megabyte.net,951608,ES89209541595236157007,1585.44,2022-06-19T13:40:17,Plentzia,expenses,leisure,-71.78,-5588.45
buyer_5,Sara,Urkiaga,1994-03-12,95203027R,sara.urkiaga@megabyte.net,951608,ES89209541595236157007,1585.44,2022-06-22T13:29:39,Plentzia,expenses,cash,-100.0,-5688.45
buyer_5,Sara,Urkiaga,1994-03-12,95203027R,sara.urkiaga@megabyte.net,951608,ES89209541595236157007,1585.44,2022-06-22T11:48:46,Plentzia,expenses,appliances,-407.73,-6096.18
buyer_5,Sara,Urkiaga,1994-03-12,95203027R,sara.urkiaga@megabyte.net,951608,ES89209541595236157007,1585.44,2022-06-24T09:06:27,Plentzia,expenses,food,-67.06,-6163.24
buyer_5,Sara,Urkiaga,1994-03-12,95203027R,sara.urkiaga@megabyte.net,951608,ES89209541595236157007,1585.44,2022-06-24T18:57:45,Plentzia,expenses,leisure,-49.59,-6212.83
buyer_5,Sara,Urkiaga,1994-03-12,95203027R,sara.urkiaga@megabyte.net,951608,ES89209541595236157007,1585.44,2022-06-27T08:05:31,Plentzia,expenses,cash,-100.0,-6312.83
buyer_5,Sara,Urkiaga,1994-03-12,95203027R,sara.urkiaga@megabyte.net,951608,ES89209541595236157007,1585.44,2022-06-27T13:03:21,Plentzia,expenses,gifts,-471.69,-6784.52
buyer_5,Sara,Urkiaga,1994-03-12,95203027R,sara.urkiaga@megabyte.net,951608,ES89209541595236157007,1585.44,2022-06-28T13:56:17,Plentzia,expenses,food,-117.01,-6901.53
buyer_5,Sara,Urkiaga,1994-03-12,95203027R,sara.urkiaga@megabyte.net,951608,ES89209541595236157007,1585.44,2022-06-30T16:39:41,Plentzia,expenses,transport,-48.5,-6950.03
buyer_5,Sara,Urkiaga,1994-03-12,95203027R,sara.urkiaga@megabyte.net,951608,ES89209541595236157007,1585.44,2022-07-01T20:00:38,Plentzia,incomes,salary,2177.55,-4772.48
buyer_5,Sara,Urkiaga,1994-03-12,95203027R,sara.urkiaga@megabyte.net,951608,ES89209541595236157007,1585.44,2022-07-01T20:00:38,Plentzia,incomes,salary_partner,2164.93,-2607.55
buyer_5,Sara,Urkiaga,1994-03-12,95203027R,sara.urkiaga@megabyte.net,951608,ES89209541595236157007,1585.44,2022-07-03T12:41:41,Plentzia,expenses,food,-105.64,-2713.19
buyer_5,Sara,Urkiaga,1994-03-12,95203027R,sara.urkiaga@megabyte.net,951608,ES89209541595236157007,1585.44,2022-07-03T22:52:54,Plentzia,expenses,education,-45.38,-2758.57
buyer_5,Sara,Urkiaga,1994-03-12,95203027R,sara.urkiaga@megabyte.net,951608,ES89209541595236157007,1585.44,2022-07-05T02:56:57,Plentzia,expenses,mortgage,-2095.25,-4853.82
buyer_5,Sara,Urkiaga,1994-03-12,95203027R,sara.urkiaga@megabyte.net,951608,ES89209541595236157007,1585.44,2022-07-06T19:41:43,Plentzia,expenses,water,-54.94,-4908.76
buyer_5,Sara,Urkiaga,1994-03-12,95203027R,sara.urkiaga@megabyte.net,951608,ES89209541595236157007,1585.44,2022-07-06T03:45:35,Plentzia,expenses,electricity,-57.71,-4966.47
buyer_5,Sara,Urkiaga,1994-03-12,95203027R,sara.urkiaga@megabyte.net,951608,ES89209541595236157007,1585.44,2022-07-06T09:38:07,Plentzia,expenses,clothing,-62.41,-5028.88
buyer_5,Sara,Urkiaga,1994-03-12,95203027R,sara.urkiaga@megabyte.net,951608,ES89209541595236157007,1585.44,2022-07-07T20:35:48,Plentzia,expenses,water,-91.8,-5120.68
buyer_5,Sara,Urkiaga,1994-03-12,95203027R,sara.urkiaga@megabyte.net,951608,ES89209541595236157007,1585.44,2022-07-07T13:59:21,Plentzia,expenses,electricity,-180.7,-5301.38
buyer_5,Sara,Urkiaga,1994-03-12,95203027R,sara.urkiaga@megabyte.net,951608,ES89209541595236157007,1585.44,2022-07-07T13:04:49,Plentzia,expenses,gas,-229.82,-5531.2
buyer_5,Sara,Urkiaga,1994-03-12,95203027R,sara.urkiaga@megabyte.net,951608,ES89209541595236157007,1585.44,2022-07-07T08:08:14,Plentzia,expenses,gifts,-308.93,-5840.13
buyer_5,Sara,Urkiaga,1994-03-12,95203027R,sara.urkiaga@megabyte.net,951608,ES89209541595236157007,1585.44,2022-07-08T22:34:17,Plentzia,expenses,water,-66.71,-5906.84
buyer_5,Sara,Urkiaga,1994-03-12,95203027R,sara.urkiaga@megabyte.net,951608,ES89209541595236157007,1585.44,2022-07-09T13:38:51,Plentzia,expenses,leisure,-76.55,-5983.39
buyer_5,Sara,Urkiaga,1994-03-12,95203027R,sara.urkiaga@megabyte.net,951608,ES89209541595236157007,1585.44,2022-07-09T23:50:26,Plentzia,expenses,travel,-645.0,-6628.39
buyer_5,Sara,Urkiaga,1994-03-12,95203027R,sara.urkiaga@megabyte.net,951608,ES89209541595236157007,1585.44,2022-07-12T12:51:23,Plentzia,expenses,clothing,-80.06,-6708.45
buyer_5,Sara,Urkiaga,1994-03-12,95203027R,sara.urkiaga@megabyte.net,951608,ES89209541595236157007,1585.44,2022-07-14T16:11:42,Plentzia,expenses,food,-71.46,-6779.91
buyer_5,Sara,Urkiaga,1994-03-12,95203027R,sara.urkiaga@megabyte.net,951608,ES89209541595236157007,1585.44,2022-07-15T09:28:11,Plentzia,expenses,cash,-100.0,-6879.91
buyer_5,Sara,Urkiaga,1994-03-12,95203027R,sara.urkiaga@megabyte.net,951608,ES89209541595236157007,1585.44,2022-07-16T16:20:32,Plentzia,expenses,repairs,-162.04,-7041.95
buyer_5,Sara,Urkiaga,1994-03-12,95203027R,sara.urkiaga@megabyte.net,951608,ES89209541595236157007,1585.44,2022-07-19T19:49:36,Plentzia,expenses,food,-108.74,-7150.69
buyer_5,Sara,Urkiaga,1994-03-12,95203027R,sara.urkiaga@megabyte.net,951608,ES89209541595236157007,1585.44,2022-07-19T16:46:23,Plentzia,expenses,clothing,-54.87,-7205.56
buyer_5,Sara,Urkiaga,1994-03-12,95203027R,sara.urkiaga@megabyte.net,951608,ES89209541595236157007,1585.44,2022-07-19T12:55:54,Plentzia,expenses,cash,-100.0,-7305.56
buyer_5,Sara,Urkiaga,1994-03-12,95203027R,sara.urkiaga@megabyte.net,951608,ES89209541595236157007,1585.44,2022-07-20T19:58:17,Plentzia,expenses,leisure,-80.32,-7385.88
buyer_5,Sara,Urkiaga,1994-03-12,95203027R,sara.urkiaga@megabyte.net,951608,ES89209541595236157007,1585.44,2022-07-20T17:03:00,Plentzia,expenses,cash,-100.0,-7485.88
buyer_5,Sara,Urkiaga,1994-03-12,95203027R,sara.urkiaga@megabyte.net,951608,ES89209541595236157007,1585.44,2022-07-21T09:28:28,Plentzia,expenses,food,-81.22,-7567.1
buyer_5,Sara,Urkiaga,1994-03-12,95203027R,sara.urkiaga@megabyte.net,951608,ES89209541595236157007,1585.44,2022-07-25T15:27:05,Plentzia,expenses,cash,-100.0,-7667.1
buyer_5,Sara,Urkiaga,1994-03-12,95203027R,sara.urkiaga@megabyte.net,951608,ES89209541595236157007,1585.44,2022-07-26T17:45:21,Plentzia,expenses,clothing,-69.17,-7736.27
buyer_5,Sara,Urkiaga,1994-03-12,95203027R,sara.urkiaga@megabyte.net,951608,ES89209541595236157007,1585.44,2022-07-28T10:38:47,Plentzia,expenses,gifts,-678.34,-8414.61
buyer_5,Sara,Urkiaga,1994-03-12,95203027R,sara.urkiaga@megabyte.net,951608,ES89209541595236157007,1585.44,2022-07-29T11:24:23,Plentzia,expenses,education,-42.58,-8457.19
buyer_5,Sara,Urkiaga,1994-03-12,95203027R,sara.urkiaga@megabyte.net,951608,ES89209541595236157007,1585.44,2022-07-30T18:27:09,Plentzia,expenses,cash,-100.0,-8557.19
buyer_5,Sara,Urkiaga,1994-03-12,95203027R,sara.urkiaga@megabyte.net,951608,ES89209541595236157007,1585.44,2022-07-31T18:24:21,Plentzia,expenses,transport,-48.47,-8605.66
buyer_5,Sara,Urkiaga,1994-03-12,95203027R,sara.urkiaga@megabyte.net,951608,ES89209541595236157007,1585.44,2022-07-31T14:07:05,Plentzia,expenses,leisure,-53.92,-8659.58
buyer_5,Sara,Urkiaga,1994-03-12,95203027R,sara.urkiaga@megabyte.net,951608,ES89209541595236157007,1585.44,2022-08-01T00:59:33,Plentzia,incomes,salary,2177.55,-6482.03
buyer_5,Sara,Urkiaga,1994-03-12,95203027R,sara.urkiaga@megabyte.net,951608,ES89209541595236157007,1585.44,2022-08-01T00:59:33,Plentzia,incomes,salary_partner,2164.93,-4317.1
buyer_5,Sara,Urkiaga,1994-03-12,95203027R,sara.urkiaga@megabyte.net,951608,ES89209541595236157007,1585.44,2022-08-02T16:11:06,Plentzia,expenses,clothing,-86.95,-4404.05
buyer_5,Sara,Urkiaga,1994-03-12,95203027R,sara.urkiaga@megabyte.net,951608,ES89209541595236157007,1585.44,2022-08-05T21:23:48,Plentzia,expenses,mortgage,-2095.25,-6499.3
buyer_5,Sara,Urkiaga,1994-03-12,95203027R,sara.urkiaga@megabyte.net,951608,ES89209541595236157007,1585.44,2022-08-05T09:00:16,Plentzia,expenses,electricity,-75.83,-6575.13
buyer_5,Sara,Urkiaga,1994-03-12,95203027R,sara.urkiaga@megabyte.net,951608,ES89209541595236157007,1585.44,2022-08-05T19:26:25,Plentzia,expenses,gas,-242.05,-6817.18
buyer_5,Sara,Urkiaga,1994-03-12,95203027R,sara.urkiaga@megabyte.net,951608,ES89209541595236157007,1585.44,2022-08-05T12:10:50,Plentzia,expenses,food,-120.55,-6937.73
buyer_5,Sara,Urkiaga,1994-03-12,95203027R,sara.urkiaga@megabyte.net,951608,ES89209541595236157007,1585.44,2022-08-06T19:39:41,Plentzia,expenses,electricity,-135.41,-7073.14
buyer_5,Sara,Urkiaga,1994-03-12,95203027R,sara.urkiaga@megabyte.net,951608,ES89209541595236157007,1585.44,2022-08-06T11:54:04,Plentzia,expenses,gas,-168.01,-7241.15
buyer_5,Sara,Urkiaga,1994-03-12,95203027R,sara.urkiaga@megabyte.net,951608,ES89209541595236157007,1585.44,2022-08-06T13:21:24,Plentzia,expenses,cash,-100.0,-7341.15
buyer_5,Sara,Urkiaga,1994-03-12,95203027R,sara.urkiaga@megabyte.net,951608,ES89209541595236157007,1585.44,2022-08-07T08:47:29,Plentzia,expenses,water,-57.52,-7398.67
buyer_5,Sara,Urkiaga,1994-03-12,95203027R,sara.urkiaga@megabyte.net,951608,ES89209541595236157007,1585.44,2022-08-07T14:48:08,Plentzia,expenses,internet,-91.19,-7489.86
buyer_5,Sara,Urkiaga,1994-03-12,95203027R,sara.urkiaga@megabyte.net,951608,ES89209541595236157007,1585.44,2022-08-07T19:49:47,Plentzia,expenses,food,-61.06,-7550.92
buyer_5,Sara,Urkiaga,1994-03-12,95203027R,sara.urkiaga@megabyte.net,951608,ES89209541595236157007,1585.44,2022-08-07T22:31:58,Plentzia,expenses,leisure,-40.77,-7591.69
buyer_5,Sara,Urkiaga,1994-03-12,95203027R,sara.urkiaga@megabyte.net,951608,ES89209541595236157007,1585.44,2022-08-07T17:24:03,Plentzia,expenses,gifts,-141.59,-7733.28
buyer_5,Sara,Urkiaga,1994-03-12,95203027R,sara.urkiaga@megabyte.net,951608,ES89209541595236157007,1585.44,2022-08-08T09:14:25,Plentzia,expenses,electricity,-92.86,-7826.14
buyer_5,Sara,Urkiaga,1994-03-12,95203027R,sara.urkiaga@megabyte.net,951608,ES89209541595236157007,1585.44,2022-08-08T07:20:00,Plentzia,expenses,gas,-158.19,-7984.33
buyer_5,Sara,Urkiaga,1994-03-12,95203027R,sara.urkiaga@megabyte.net,951608,ES89209541595236157007,1585.44,2022-08-08T21:59:54,Plentzia,expenses,internet,-91.19,-8075.52
buyer_5,Sara,Urkiaga,1994-03-12,95203027R,sara.urkiaga@megabyte.net,951608,ES89209541595236157007,1585.44,2022-08-08T18:03:17,Plentzia,expenses,education,-54.76,-8130.28
buyer_5,Sara,Urkiaga,1994-03-12,95203027R,sara.urkiaga@megabyte.net,951608,ES89209541595236157007,1585.44,2022-08-08T08:07:59,Plentzia,expenses,gifts,-425.72,-8556.0
buyer_5,Sara,Urkiaga,1994-03-12,95203027R,sara.urkiaga@megabyte.net,951608,ES89209541595236157007,1585.44,2022-08-09T18:59:25,Plentzia,expenses,leisure,-34.1,-8590.1
buyer_5,Sara,Urkiaga,1994-03-12,95203027R,sara.urkiaga@megabyte.net,951608,ES89209541595236157007,1585.44,2022-08-09T13:43:31,Plentzia,expenses,appliances,-295.33,-8885.43
buyer_5,Sara,Urkiaga,1994-03-12,95203027R,sara.urkiaga@megabyte.net,951608,ES89209541595236157007,1585.44,2022-08-10T15:49:29,Plentzia,expenses,food,-103.49,-8988.92
buyer_5,Sara,Urkiaga,1994-03-12,95203027R,sara.urkiaga@megabyte.net,951608,ES89209541595236157007,1585.44,2022-08-10T20:31:12,Plentzia,expenses,repairs,-152.5,-9141.42
buyer_5,Sara,Urkiaga,1994-03-12,95203027R,sara.urkiaga@megabyte.net,951608,ES89209541595236157007,1585.44,2022-08-12T15:05:31,Plentzia,expenses,clothing,-56.53,-9197.95
buyer_5,Sara,Urkiaga,1994-03-12,95203027R,sara.urkiaga@megabyte.net,951608,ES89209541595236157007,1585.44,2022-08-13T19:59:24,Plentzia,expenses,food,-91.96,-9289.91
buyer_5,Sara,Urkiaga,1994-03-12,95203027R,sara.urkiaga@megabyte.net,951608,ES89209541595236157007,1585.44,2022-08-17T08:29:51,Plentzia,expenses,cash,-100.0,-9389.91
buyer_5,Sara,Urkiaga,1994-03-12,95203027R,sara.urkiaga@megabyte.net,951608,ES89209541595236157007,1585.44,2022-08-19T13:04:29,Plentzia,expenses,leisure,-41.44,-9431.35
buyer_5,Sara,Urkiaga,1994-03-12,95203027R,sara.urkiaga@megabyte.net,951608,ES89209541595236157007,1585.44,2022-08-19T00:17:47,Plentzia,expenses,cash,-100.0,-9531.35
buyer_5,Sara,Urkiaga,1994-03-12,95203027R,sara.urkiaga@megabyte.net,951608,ES89209541595236157007,1585.44,2022-08-20T14:58:17,Plentzia,expenses,leisure,-53.1,-9584.45
buyer_5,Sara,Urkiaga,1994-03-12,95203027R,sara.urkiaga@megabyte.net,951608,ES89209541595236157007,1585.44,2022-08-21T08:03:15,Plentzia,expenses,food,-64.63,-9649.08
buyer_5,Sara,Urkiaga,1994-03-12,95203027R,sara.urkiaga@megabyte.net,951608,ES89209541595236157007,1585.44,2022-08-22T17:22:33,Plentzia,expenses,leisure,-36.68,-9685.76
buyer_5,Sara,Urkiaga,1994-03-12,95203027R,sara.urkiaga@megabyte.net,951608,ES89209541595236157007,1585.44,2022-08-23T18:07:15,Plentzia,expenses,cash,-100.0,-9785.76
buyer_5,Sara,Urkiaga,1994-03-12,95203027R,sara.urkiaga@megabyte.net,951608,ES89209541595236157007,1585.44,2022-08-24T15:09:25,Plentzia,expenses,cash,-100.0,-9885.76
buyer_5,Sara,Urkiaga,1994-03-12,95203027R,sara.urkiaga@megabyte.net,951608,ES89209541595236157007,1585.44,2022-08-26T10:44:59,Plentzia,expenses,transport,-71.34,-9957.1
buyer_5,Sara,Urkiaga,1994-03-12,95203027R,sara.urkiaga@megabyte.net,951608,ES89209541595236157007,1585.44,2022-08-29T16:55:45,Plentzia,expenses,clothing,-55.81,-10012.91
buyer_5,Sara,Urkiaga,1994-03-12,95203027R,sara.urkiaga@megabyte.net,951608,ES89209541595236157007,1585.44,2022-08-31T11:08:35,Plentzia,expenses,cash,-100.0,-10112.91
buyer_5,Sara,Urkiaga,1994-03-12,95203027R,sara.urkiaga@megabyte.net,951608,ES89209541595236157007,1585.44,2022-09-01T21:24:20,Plentzia,incomes,salary,2177.55,-7935.36
buyer_5,Sara,Urkiaga,1994-03-12,95203027R,sara.urkiaga@megabyte.net,951608,ES89209541595236157007,1585.44,2022-09-01T21:24:20,Plentzia,incomes,salary_partner,2164.93,-5770.43
buyer_5,Sara,Urkiaga,1994-03-12,95203027R,sara.urkiaga@megabyte.net,951608,ES89209541595236157007,1585.44,2022-09-01T21:24:20,Plentzia,incomes,extra_income,224.91,-5545.52
buyer_5,Sara,Urkiaga,1994-03-12,95203027R,sara.urkiaga@megabyte.net,951608,ES89209541595236157007,1585.44,2022-09-01T08:42:01,Plentzia,expenses,food,-106.43,-5651.95
buyer_5,Sara,Urkiaga,1994-03-12,95203027R,sara.urkiaga@megabyte.net,951608,ES89209541595236157007,1585.44,2022-09-01T03:52:46,Plentzia,expenses,education,-62.04,-5713.99
buyer_5,Sara,Urkiaga,1994-03-12,95203027R,sara.urkiaga@megabyte.net,951608,ES89209541595236157007,1585.44,2022-09-04T13:59:03,Plentzia,expenses,cash,-100.0,-5813.99
buyer_5,Sara,Urkiaga,1994-03-12,95203027R,sara.urkiaga@megabyte.net,951608,ES89209541595236157007,1585.44,2022-09-04T13:36:05,Plentzia,expenses,gifts,-379.11,-6193.1
buyer_5,Sara,Urkiaga,1994-03-12,95203027R,sara.urkiaga@megabyte.net,951608,ES89209541595236157007,1585.44,2022-09-05T20:13:20,Plentzia,expenses,mortgage,-2095.25,-8288.35
buyer_5,Sara,Urkiaga,1994-03-12,95203027R,sara.urkiaga@megabyte.net,951608,ES89209541595236157007,1585.44,2022-09-05T13:42:27,Plentzia,expenses,electricity,-190.04,-8478.39
buyer_5,Sara,Urkiaga,1994-03-12,95203027R,sara.urkiaga@megabyte.net,951608,ES89209541595236157007,1585.44,2022-09-05T16:39:27,Plentzia,expenses,phone,-72.03,-8550.42
buyer_5,Sara,Urkiaga,1994-03-12,95203027R,sara.urkiaga@megabyte.net,951608,ES89209541595236157007,1585.44,2022-09-05T20:27:04,Plentzia,expenses,food,-118.12,-8668.54
buyer_5,Sara,Urkiaga,1994-03-12,95203027R,sara.urkiaga@megabyte.net,951608,ES89209541595236157007,1585.44,2022-09-05T14:14:47,Plentzia,expenses,cash,-100.0,-8768.54
buyer_5,Sara,Urkiaga,1994-03-12,95203027R,sara.urkiaga@megabyte.net,951608,ES89209541595236157007,1585.44,2022-09-06T13:21:44,Plentzia,expenses,transport,-59.36,-8827.9
buyer_5,Sara,Urkiaga,1994-03-12,95203027R,sara.urkiaga@megabyte.net,951608,ES89209541595236157007,1585.44,2022-09-07T06:58:48,Plentzia,expenses,electricity,-87.51,-8915.41
buyer_5,Sara,Urkiaga,1994-03-12,95203027R,sara.urkiaga@megabyte.net,951608,ES89209541595236157007,1585.44,2022-09-07T09:56:01,Plentzia,expenses,transport,-59.15,-8974.56
buyer_5,Sara,Urkiaga,1994-03-12,95203027R,sara.urkiaga@megabyte.net,951608,ES89209541595236157007,1585.44,2022-09-08T15:28:46,Plentzia,expenses,electricity,-160.15,-9134.71
buyer_5,Sara,Urkiaga,1994-03-12,95203027R,sara.urkiaga@megabyte.net,951608,ES89209541595236157007,1585.44,2022-09-08T09:07:53,Plentzia,expenses,phone,-92.21,-9226.92
buyer_5,Sara,Urkiaga,1994-03-12,95203027R,sara.urkiaga@megabyte.net,951608,ES89209541595236157007,1585.44,2022-09-08T16:50:09,Plentzia,expenses,repairs,-320.27,-9547.19
buyer_5,Sara,Urkiaga,1994-03-12,95203027R,sara.urkiaga@megabyte.net,951608,ES89209541595236157007,1585.44,2022-09-09T15:28:25,Plentzia,expenses,repairs,-255.81,-9803.0
buyer_5,Sara,Urkiaga,1994-03-12,95203027R,sara.urkiaga@megabyte.net,951608,ES89209541595236157007,1585.44,2022-09-10T20:20:17,Plentzia,expenses,appliances,-275.78,-10078.78
buyer_5,Sara,Urkiaga,1994-03-12,95203027R,sara.urkiaga@megabyte.net,951608,ES89209541595236157007,1585.44,2022-09-12T09:23:31,Plentzia,expenses,gifts,-299.06,-10377.84
buyer_5,Sara,Urkiaga,1994-03-12,95203027R,sara.urkiaga@megabyte.net,951608,ES89209541595236157007,1585.44,2022-09-13T16:11:14,Plentzia,expenses,leisure,-49.85,-10427.69
buyer_5,Sara,Urkiaga,1994-03-12,95203027R,sara.urkiaga@megabyte.net,951608,ES89209541595236157007,1585.44,2022-09-15T10:46:30,Plentzia,expenses,food,-79.5,-10507.19
buyer_5,Sara,Urkiaga,1994-03-12,95203027R,sara.urkiaga@megabyte.net,951608,ES89209541595236157007,1585.44,2022-09-15T11:50:18,Plentzia,expenses,clothing,-66.67,-10573.86
buyer_5,Sara,Urkiaga,1994-03-12,95203027R,sara.urkiaga@megabyte.net,951608,ES89209541595236157007,1585.44,2022-09-15T15:55:00,Plentzia,expenses,gifts,-356.32,-10930.18
buyer_5,Sara,Urkiaga,1994-03-12,95203027R,sara.urkiaga@megabyte.net,951608,ES89209541595236157007,1585.44,2022-09-16T20:09:06,Plentzia,expenses,food,-111.44,-11041.62
buyer_5,Sara,Urkiaga,1994-03-12,95203027R,sara.urkiaga@megabyte.net,951608,ES89209541595236157007,1585.44,2022-09-16T13:01:07,Plentzia,expenses,transport,-75.5,-11117.12
buyer_5,Sara,Urkiaga,1994-03-12,95203027R,sara.urkiaga@megabyte.net,951608,ES89209541595236157007,1585.44,2022-09-16T08:29:13,Plentzia,expenses,cash,-100.0,-11217.12
buyer_5,Sara,Urkiaga,1994-03-12,95203027R,sara.urkiaga@megabyte.net,951608,ES89209541595236157007,1585.44,2022-09-17T22:57:12,Plentzia,expenses,transport,-83.17,-11300.29
buyer_5,Sara,Urkiaga,1994-03-12,95203027R,sara.urkiaga@megabyte.net,951608,ES89209541595236157007,1585.44,2022-09-19T21:03:16,Plentzia,expenses,cash,-100.0,-11400.29
buyer_5,Sara,Urkiaga,1994-03-12,95203027R,sara.urkiaga@megabyte.net,951608,ES89209541595236157007,1585.44,2022-09-21T14:48:17,Plentzia,expenses,cash,-100.0,-11500.29
buyer_5,Sara,Urkiaga,1994-03-12,95203027R,sara.urkiaga@megabyte.net,951608,ES89209541595236157007,1585.44,2022-09-22T16:12:10,Plentzia,expenses,cash,-100.0,-11600.29
buyer_5,Sara,Urkiaga,1994-03-12,95203027R,sara.urkiaga@megabyte.net,951608,ES89209541595236157007,1585.44,2022-09-26T17:18:34,Plentzia,expenses,cash,-100.0,-11700.29
buyer_5,Sara,Urkiaga,1994-03-12,95203027R,sara.urkiaga@megabyte.net,951608,ES89209541595236157007,1585.44,2022-09-27T17:07:05,Plentzia,expenses,gifts,-381.65,-12081.94
buyer_5,Sara,Urkiaga,1994-03-12,95203027R,sara.urkiaga@megabyte.net,951608,ES89209541595236157007,1585.44,2022-09-28T09:55:58,Plentzia,expenses,leisure,-34.14,-12116.08
buyer_5,Sara,Urkiaga,1994-03-12,95203027R,sara.urkiaga@megabyte.net,951608,ES89209541595236157007,1585.44,2022-09-28T16:03:51,Plentzia,expenses,cash,-100.0,-12216.08
buyer_5,Sara,Urkiaga,1994-03-12,95203027R,sara.urkiaga@megabyte.net,951608,ES89209541595236157007,1585.44,2022-09-30T12:03:02,Plentzia,expenses,food,-61.39,-12277.47
buyer_5,Sara,Urkiaga,1994-03-12,95203027R,sara.urkiaga@megabyte.net,951608,ES89209541595236157007,1585.44,2022-09-30T11:14:41,Plentzia,expenses,transport,-46.78,-12324.25
buyer_5,Sara,Urkiaga,1994-03-12,95203027R,sara.urkiaga@megabyte.net,951608,ES89209541595236157007,1585.44,2022-09-30T10:20:49,Plentzia,expenses,leisure,-76.19,-12400.44
buyer_5,Sara,Urkiaga,1994-03-12,95203027R,sara.urkiaga@megabyte.net,951608,ES89209541595236157007,1585.44,2022-10-01T08:42:13,Plentzia,incomes,salary,2177.55,-10222.89
buyer_5,Sara,Urkiaga,1994-03-12,95203027R,sara.urkiaga@megabyte.net,951608,ES89209541595236157007,1585.44,2022-10-01T08:42:13,Plentzia,incomes,salary_partner,2164.93,-8057.96
buyer_5,Sara,Urkiaga,1994-03-12,95203027R,sara.urkiaga@megabyte.net,951608,ES89209541595236157007,1585.44,2022-10-04T10:30:36,Plentzia,expenses,leisure,-55.63,-8113.59
buyer_5,Sara,Urkiaga,1994-03-12,95203027R,sara.urkiaga@megabyte.net,951608,ES89209541595236157007,1585.44,2022-10-05T18:08:45,Plentzia,expenses,mortgage,-2095.25,-10208.84
buyer_5,Sara,Urkiaga,1994-03-12,95203027R,sara.urkiaga@megabyte.net,951608,ES89209541595236157007,1585.44,2022-10-05T18:39:56,Plentzia,expenses,gas,-195.98,-10404.82
buyer_5,Sara,Urkiaga,1994-03-12,95203027R,sara.urkiaga@megabyte.net,951608,ES89209541595236157007,1585.44,2022-10-05T13:41:41,Plentzia,expenses,food,-73.08,-10477.9
buyer_5,Sara,Urkiaga,1994-03-12,95203027R,sara.urkiaga@megabyte.net,951608,ES89209541595236157007,1585.44,2022-10-05T16:41:36,Plentzia,expenses,appliances,-126.52,-10604.42
buyer_5,Sara,Urkiaga,1994-03-12,95203027R,sara.urkiaga@megabyte.net,951608,ES89209541595236157007,1585.44,2022-10-06T18:14:44,Plentzia,expenses,water,-70.35,-10674.77
buyer_5,Sara,Urkiaga,1994-03-12,95203027R,sara.urkiaga@megabyte.net,951608,ES89209541595236157007,1585.44,2022-10-06T04:21:05,Plentzia,expenses,electricity,-126.55,-10801.32
buyer_5,Sara,Urkiaga,1994-03-12,95203027R,sara.urkiaga@megabyte.net,951608,ES89209541595236157007,1585.44,2022-10-07T20:19:37,Plentzia,expenses,water,-93.07,-10894.39
buyer_5,Sara,Urkiaga,1994-03-12,95203027R,sara.urkiaga@megabyte.net,951608,ES89209541595236157007,1585.44,2022-10-08T06:19:03,Plentzia,expenses,internet,-91.19,-10985.58
buyer_5,Sara,Urkiaga,1994-03-12,95203027R,sara.urkiaga@megabyte.net,951608,ES89209541595236157007,1585.44,2022-10-08T18:20:31,Plentzia,expenses,phone,-66.09,-11051.67
buyer_5,Sara,Urkiaga,1994-03-12,95203027R,sara.urkiaga@megabyte.net,951608,ES89209541595236157007,1585.44,2022-10-09T16:50:36,Plentzia,expenses,leisure,-77.28,-11128.95
buyer_5,Sara,Urkiaga,1994-03-12,95203027R,sara.urkiaga@megabyte.net,951608,ES89209541595236157007,1585.44,2022-10-10T05:59:27,Plentzia,expenses,transport,-67.73,-11196.68
buyer_5,Sara,Urkiaga,1994-03-12,95203027R,sara.urkiaga@megabyte.net,951608,ES89209541595236157007,1585.44,2022-10-14T09:01:32,Plentzia,expenses,repairs,-278.29,-11474.97
buyer_5,Sara,Urkiaga,1994-03-12,95203027R,sara.urkiaga@megabyte.net,951608,ES89209541595236157007,1585.44,2022-10-15T15:40:00,Plentzia,expenses,leisure,-43.74,-11518.71
buyer_5,Sara,Urkiaga,1994-03-12,95203027R,sara.urkiaga@megabyte.net,951608,ES89209541595236157007,1585.44,2022-10-15T10:30:02,Plentzia,expenses,cash,-100.0,-11618.71
buyer_5,Sara,Urkiaga,1994-03-12,95203027R,sara.urkiaga@megabyte.net,951608,ES89209541595236157007,1585.44,2022-10-16T02:41:51,Plentzia,expenses,cash,-100.0,-11718.71
buyer_5,Sara,Urkiaga,1994-03-12,95203027R,sara.urkiaga@megabyte.net,951608,ES89209541595236157007,1585.44,2022-10-17T18:25:49,Plentzia,expenses,food,-108.27,-11826.98
buyer_5,Sara,Urkiaga,1994-03-12,95203027R,sara.urkiaga@megabyte.net,951608,ES89209541595236157007,1585.44,2022-10-18T21:19:11,Plentzia,expenses,food,-100.85,-11927.83
buyer_5,Sara,Urkiaga,1994-03-12,95203027R,sara.urkiaga@megabyte.net,951608,ES89209541595236157007,1585.44,2022-10-18T12:58:14,Plentzia,expenses,gifts,-73.47,-12001.3
buyer_5,Sara,Urkiaga,1994-03-12,95203027R,sara.urkiaga@megabyte.net,951608,ES89209541595236157007,1585.44,2022-10-19T13:50:49,Plentzia,expenses,transport,-82.77,-12084.07
buyer_5,Sara,Urkiaga,1994-03-12,95203027R,sara.urkiaga@megabyte.net,951608,ES89209541595236157007,1585.44,2022-10-20T10:45:16,Plentzia,expenses,food,-66.72,-12150.79
buyer_5,Sara,Urkiaga,1994-03-12,95203027R,sara.urkiaga@megabyte.net,951608,ES89209541595236157007,1585.44,2022-10-20T10:09:31,Plentzia,expenses,gifts,-247.15,-12397.94
buyer_5,Sara,Urkiaga,1994-03-12,95203027R,sara.urkiaga@megabyte.net,951608,ES89209541595236157007,1585.44,2022-10-21T16:35:04,Plentzia,expenses,appliances,-314.49,-12712.43
buyer_5,Sara,Urkiaga,1994-03-12,95203027R,sara.urkiaga@megabyte.net,951608,ES89209541595236157007,1585.44,2022-10-23T02:29:54,Plentzia,expenses,food,-62.83,-12775.26
buyer_5,Sara,Urkiaga,1994-03-12,95203027R,sara.urkiaga@megabyte.net,951608,ES89209541595236157007,1585.44,2022-10-24T19:33:38,Plentzia,expenses,leisure,-60.07,-12835.33
buyer_5,Sara,Urkiaga,1994-03-12,95203027R,sara.urkiaga@megabyte.net,951608,ES89209541595236157007,1585.44,2022-10-24T08:56:36,Plentzia,expenses,appliances,-277.11,-13112.44
buyer_5,Sara,Urkiaga,1994-03-12,95203027R,sara.urkiaga@megabyte.net,951608,ES89209541595236157007,1585.44,2022-10-25T15:24:07,Plentzia,expenses,cash,-100.0,-13212.44
buyer_5,Sara,Urkiaga,1994-03-12,95203027R,sara.urkiaga@megabyte.net,951608,ES89209541595236157007,1585.44,2022-10-26T17:02:13,Plentzia,expenses,gifts,-165.62,-13378.06
buyer_5,Sara,Urkiaga,1994-03-12,95203027R,sara.urkiaga@megabyte.net,951608,ES89209541595236157007,1585.44,2022-10-27T13:38:01,Plentzia,expenses,food,-119.06,-13497.12
buyer_5,Sara,Urkiaga,1994-03-12,95203027R,sara.urkiaga@megabyte.net,951608,ES89209541595236157007,1585.44,2022-10-27T15:49:26,Plentzia,expenses,transport,-69.94,-13567.06
buyer_5,Sara,Urkiaga,1994-03-12,95203027R,sara.urkiaga@megabyte.net,951608,ES89209541595236157007,1585.44,2022-10-30T10:16:42,Plentzia,expenses,food,-88.36,-13655.42
buyer_5,Sara,Urkiaga,1994-03-12,95203027R,sara.urkiaga@megabyte.net,951608,ES89209541595236157007,1585.44,2022-10-30T17:48:38,Plentzia,expenses,cash,-100.0,-13755.42
buyer_5,Sara,Urkiaga,1994-03-12,95203027R,sara.urkiaga@megabyte.net,951608,ES89209541595236157007,1585.44,2022-10-31T20:19:34,Plentzia,expenses,cash,-100.0,-13855.42
buyer_5,Sara,Urkiaga,1994-03-12,95203027R,sara.urkiaga@megabyte.net,951608,ES89209541595236157007,1585.44,2022-11-01T20:50:21,Plentzia,incomes,salary,2177.55,-11677.87
buyer_5,Sara,Urkiaga,1994-03-12,95203027R,sara.urkiaga@megabyte.net,951608,ES89209541595236157007,1585.44,2022-11-01T20:50:21,Plentzia,incomes,salary_partner,2164.93,-9512.94
buyer_5,Sara,Urkiaga,1994-03-12,95203027R,sara.urkiaga@megabyte.net,951608,ES89209541595236157007,1585.44,2022-11-02T11:34:09,Plentzia,expenses,transport,-74.12,-9587.06
buyer_5,Sara,Urkiaga,1994-03-12,95203027R,sara.urkiaga@megabyte.net,951608,ES89209541595236157007,1585.44,2022-11-03T09:14:35,Plentzia,expenses,cash,-100.0,-9687.06
buyer_5,Sara,Urkiaga,1994-03-12,95203027R,sara.urkiaga@megabyte.net,951608,ES89209541595236157007,1585.44,2022-11-03T16:52:26,Plentzia,expenses,gifts,-278.41,-9965.47
buyer_5,Sara,Urkiaga,1994-03-12,95203027R,sara.urkiaga@megabyte.net,951608,ES89209541595236157007,1585.44,2022-11-04T16:29:19,Plentzia,expenses,food,-100.06,-10065.53
buyer_5,Sara,Urkiaga,1994-03-12,95203027R,sara.urkiaga@megabyte.net,951608,ES89209541595236157007,1585.44,2022-11-04T16:06:22,Plentzia,expenses,clothing,-89.58,-10155.11
buyer_5,Sara,Urkiaga,1994-03-12,95203027R,sara.urkiaga@megabyte.net,951608,ES89209541595236157007,1585.44,2022-11-05T21:30:25,Plentzia,expenses,mortgage,-2095.25,-12250.36
buyer_5,Sara,Urkiaga,1994-03-12,95203027R,sara.urkiaga@megabyte.net,951608,ES89209541595236157007,1585.44,2022-11-05T12:22:30,Plentzia,expenses,gas,-148.52,-12398.88
buyer_5,Sara,Urkiaga,1994-03-12,95203027R,sara.urkiaga@megabyte.net,951608,ES89209541595236157007,1585.44,2022-11-05T18:23:27,Plentzia,expenses,food,-84.95,-12483.83
buyer_5,Sara,Urkiaga,1994-03-12,95203027R,sara.urkiaga@megabyte.net,951608,ES89209541595236157007,1585.44,2022-11-06T10:38:17,Plentzia,expenses,internet,-91.19,-12575.02
buyer_5,Sara,Urkiaga,1994-03-12,95203027R,sara.urkiaga@megabyte.net,951608,ES89209541595236157007,1585.44,2022-11-07T02:05:14,Plentzia,expenses,water,-86.21,-12661.23
buyer_5,Sara,Urkiaga,1994-03-12,95203027R,sara.urkiaga@megabyte.net,951608,ES89209541595236157007,1585.44,2022-11-07T14:26:55,Plentzia,expenses,gas,-153.84,-12815.07
buyer_5,Sara,Urkiaga,1994-03-12,95203027R,sara.urkiaga@megabyte.net,951608,ES89209541595236157007,1585.44,2022-11-07T11:08:28,Plentzia,expenses,transport,-44.92,-12859.99
buyer_5,Sara,Urkiaga,1994-03-12,95203027R,sara.urkiaga@megabyte.net,951608,ES89209541595236157007,1585.44,2022-11-08T14:28:11,Plentzia,expenses,internet,-91.19,-12951.18
buyer_5,Sara,Urkiaga,1994-03-12,95203027R,sara.urkiaga@megabyte.net,951608,ES89209541595236157007,1585.44,2022-11-12T23:09:05,Plentzia,expenses,leisure,-54.53,-13005.71
buyer_5,Sara,Urkiaga,1994-03-12,95203027R,sara.urkiaga@megabyte.net,951608,ES89209541595236157007,1585.44,2022-11-12T09:53:21,Plentzia,expenses,gifts,-650.77,-13656.48
buyer_5,Sara,Urkiaga,1994-03-12,95203027R,sara.urkiaga@megabyte.net,951608,ES89209541595236157007,1585.44,2022-11-13T23:32:00,Plentzia,expenses,food,-97.19,-13753.67
buyer_5,Sara,Urkiaga,1994-03-12,95203027R,sara.urkiaga@megabyte.net,951608,ES89209541595236157007,1585.44,2022-11-13T20:47:27,Plentzia,expenses,transport,-53.79,-13807.46
buyer_5,Sara,Urkiaga,1994-03-12,95203027R,sara.urkiaga@megabyte.net,951608,ES89209541595236157007,1585.44,2022-11-14T23:12:57,Plentzia,expenses,food,-98.48,-13905.94
buyer_5,Sara,Urkiaga,1994-03-12,95203027R,sara.urkiaga@megabyte.net,951608,ES89209541595236157007,1585.44,2022-11-14T11:17:14,Plentzia,expenses,transport,-88.27,-13994.21
buyer_5,Sara,Urkiaga,1994-03-12,95203027R,sara.urkiaga@megabyte.net,951608,ES89209541595236157007,1585.44,2022-11-14T11:49:14,Plentzia,expenses,clothing,-79.41,-14073.62
buyer_5,Sara,Urkiaga,1994-03-12,95203027R,sara.urkiaga@megabyte.net,951608,ES89209541595236157007,1585.44,2022-11-16T16:53:03,Plentzia,expenses,leisure,-79.77,-14153.39
buyer_5,Sara,Urkiaga,1994-03-12,95203027R,sara.urkiaga@megabyte.net,951608,ES89209541595236157007,1585.44,2022-11-16T13:00:40,Plentzia,expenses,clothing,-48.94,-14202.33
buyer_5,Sara,Urkiaga,1994-03-12,95203027R,sara.urkiaga@megabyte.net,951608,ES89209541595236157007,1585.44,2022-11-18T23:15:01,Plentzia,expenses,food,-62.22,-14264.55
buyer_5,Sara,Urkiaga,1994-03-12,95203027R,sara.urkiaga@megabyte.net,951608,ES89209541595236157007,1585.44,2022-11-19T23:04:05,Plentzia,expenses,cash,-100.0,-14364.55
buyer_5,Sara,Urkiaga,1994-03-12,95203027R,sara.urkiaga@megabyte.net,951608,ES89209541595236157007,1585.44,2022-11-21T09:52:00,Plentzia,expenses,cash,-100.0,-14464.55
buyer_5,Sara,Urkiaga,1994-03-12,95203027R,sara.urkiaga@megabyte.net,951608,ES89209541595236157007,1585.44,2022-11-22T23:20:52,Plentzia,expenses,clothing,-147.06,-14611.61
buyer_5,Sara,Urkiaga,1994-03-12,95203027R,sara.urkiaga@megabyte.net,951608,ES89209541595236157007,1585.44,2022-11-22T20:59:52,Plentzia,expenses,cash,-100.0,-14711.61
buyer_5,Sara,Urkiaga,1994-03-12,95203027R,sara.urkiaga@megabyte.net,951608,ES89209541595236157007,1585.44,2022-11-23T19:13:33,Plentzia,expenses,leisure,-63.73,-14775.34
buyer_5,Sara,Urkiaga,1994-03-12,95203027R,sara.urkiaga@megabyte.net,951608,ES89209541595236157007,1585.44,2022-11-25T16:20:34,Plentzia,expenses,leisure,-71.04,-14846.38
buyer_5,Sara,Urkiaga,1994-03-12,95203027R,sara.urkiaga@megabyte.net,951608,ES89209541595236157007,1585.44,2022-11-25T20:43:54,Plentzia,expenses,repairs,-38.85,-14885.23
buyer_5,Sara,Urkiaga,1994-03-12,95203027R,sara.urkiaga@megabyte.net,951608,ES89209541595236157007,1585.44,2022-11-26T11:31:16,Plentzia,expenses,food,-91.56,-14976.79
buyer_5,Sara,Urkiaga,1994-03-12,95203027R,sara.urkiaga@megabyte.net,951608,ES89209541595236157007,1585.44,2022-11-28T15:01:35,Plentzia,expenses,clothing,-159.37,-15136.16
buyer_5,Sara,Urkiaga,1994-03-12,95203027R,sara.urkiaga@megabyte.net,951608,ES89209541595236157007,1585.44,2022-11-29T17:06:32,Plentzia,expenses,education,-58.56,-15194.72
buyer_5,Sara,Urkiaga,1994-03-12,95203027R,sara.urkiaga@megabyte.net,951608,ES89209541595236157007,1585.44,2022-11-29T17:09:13,Plentzia,expenses,repairs,-203.38,-15398.1
buyer_5,Sara,Urkiaga,1994-03-12,95203027R,sara.urkiaga@megabyte.net,951608,ES89209541595236157007,1585.44,2022-12-01T01:01:51,Plentzia,incomes,salary,2177.55,-13220.55
buyer_5,Sara,Urkiaga,1994-03-12,95203027R,sara.urkiaga@megabyte.net,951608,ES89209541595236157007,1585.44,2022-12-01T01:01:51,Plentzia,incomes,salary_partner,2164.93,-11055.62
buyer_5,Sara,Urkiaga,1994-03-12,95203027R,sara.urkiaga@megabyte.net,951608,ES89209541595236157007,1585.44,2022-12-01T01:01:51,Plentzia,incomes,salary_bonus,1569.21,-9486.41
buyer_5,Sara,Urkiaga,1994-03-12,95203027R,sara.urkiaga@megabyte.net,951608,ES89209541595236157007,1585.44,2022-12-01T01:01:51,Plentzia,incomes,salary_partner_bonus,1698.22,-7788.19
buyer_5,Sara,Urkiaga,1994-03-12,95203027R,sara.urkiaga@megabyte.net,951608,ES89209541595236157007,1585.44,2022-12-02T16:31:45,Plentzia,expenses,cash,-100.0,-7888.19
buyer_5,Sara,Urkiaga,1994-03-12,95203027R,sara.urkiaga@megabyte.net,951608,ES89209541595236157007,1585.44,2022-12-02T16:23:22,Plentzia,expenses,repairs,-36.64,-7924.83
buyer_5,Sara,Urkiaga,1994-03-12,95203027R,sara.urkiaga@megabyte.net,951608,ES89209541595236157007,1585.44,2022-12-03T18:47:56,Plentzia,expenses,transport,-80.53,-8005.36
buyer_5,Sara,Urkiaga,1994-03-12,95203027R,sara.urkiaga@megabyte.net,951608,ES89209541595236157007,1585.44,2022-12-03T19:59:59,Plentzia,expenses,leisure,-76.53,-8081.89
buyer_5,Sara,Urkiaga,1994-03-12,95203027R,sara.urkiaga@megabyte.net,951608,ES89209541595236157007,1585.44,2022-12-03T12:43:25,Plentzia,expenses,clothing,-112.3,-8194.19
buyer_5,Sara,Urkiaga,1994-03-12,95203027R,sara.urkiaga@megabyte.net,951608,ES89209541595236157007,1585.44,2022-12-03T12:32:23,Plentzia,expenses,education,-60.22,-8254.41
buyer_5,Sara,Urkiaga,1994-03-12,95203027R,sara.urkiaga@megabyte.net,951608,ES89209541595236157007,1585.44,2022-12-05T16:45:14,Plentzia,expenses,mortgage,-2095.25,-10349.66
buyer_5,Sara,Urkiaga,1994-03-12,95203027R,sara.urkiaga@megabyte.net,951608,ES89209541595236157007,1585.44,2022-12-05T10:16:05,Plentzia,expenses,phone,-96.93,-10446.59
buyer_5,Sara,Urkiaga,1994-03-12,95203027R,sara.urkiaga@megabyte.net,951608,ES89209541595236157007,1585.44,2022-12-05T12:20:59,Plentzia,expenses,cash,-100.0,-10546.59
buyer_5,Sara,Urkiaga,1994-03-12,95203027R,sara.urkiaga@megabyte.net,951608,ES89209541595236157007,1585.44,2022-12-06T11:06:24,Plentzia,expenses,education,-64.25,-10610.84
buyer_5,Sara,Urkiaga,1994-03-12,95203027R,sara.urkiaga@megabyte.net,951608,ES89209541595236157007,1585.44,2022-12-07T19:54:31,Plentzia,expenses,water,-50.29,-10661.13
buyer_5,Sara,Urkiaga,1994-03-12,95203027R,sara.urkiaga@megabyte.net,951608,ES89209541595236157007,1585.44,2022-12-08T09:11:17,Plentzia,expenses,cash,-100.0,-10761.13
buyer_5,Sara,Urkiaga,1994-03-12,95203027R,sara.urkiaga@megabyte.net,951608,ES89209541595236157007,1585.44,2022-12-10T07:22:33,Plentzia,expenses,leisure,-73.63,-10834.76
buyer_5,Sara,Urkiaga,1994-03-12,95203027R,sara.urkiaga@megabyte.net,951608,ES89209541595236157007,1585.44,2022-12-12T10:32:21,Plentzia,expenses,appliances,-198.0,-11032.76
buyer_5,Sara,Urkiaga,1994-03-12,95203027R,sara.urkiaga@megabyte.net,951608,ES89209541595236157007,1585.44,2022-12-14T18:29:31,Plentzia,expenses,leisure,-84.44,-11117.2
buyer_5,Sara,Urkiaga,1994-03-12,95203027R,sara.urkiaga@megabyte.net,951608,ES89209541595236157007,1585.44,2022-12-15T02:51:59,Plentzia,expenses,food,-111.93,-11229.13
buyer_5,Sara,Urkiaga,1994-03-12,95203027R,sara.urkiaga@megabyte.net,951608,ES89209541595236157007,1585.44,2022-12-16T09:42:23,Plentzia,expenses,repairs,-42.28,-11271.41
buyer_5,Sara,Urkiaga,1994-03-12,95203027R,sara.urkiaga@megabyte.net,951608,ES89209541595236157007,1585.44,2022-12-17T11:25:54,Plentzia,expenses,education,-49.27,-11320.68
buyer_5,Sara,Urkiaga,1994-03-12,95203027R,sara.urkiaga@megabyte.net,951608,ES89209541595236157007,1585.44,2022-12-18T10:14:34,Plentzia,expenses,repairs,-203.95,-11524.63
buyer_5,Sara,Urkiaga,1994-03-12,95203027R,sara.urkiaga@megabyte.net,951608,ES89209541595236157007,1585.44,2022-12-21T08:31:57,Plentzia,expenses,travel,-432.72,-11957.35
buyer_5,Sara,Urkiaga,1994-03-12,95203027R,sara.urkiaga@megabyte.net,951608,ES89209541595236157007,1585.44,2022-12-23T18:16:28,Plentzia,expenses,food,-73.17,-12030.52
buyer_5,Sara,Urkiaga,1994-03-12,95203027R,sara.urkiaga@megabyte.net,951608,ES89209541595236157007,1585.44,2022-12-23T17:00:32,Plentzia,expenses,travel,-487.92,-12518.44
buyer_5,Sara,Urkiaga,1994-03-12,95203027R,sara.urkiaga@megabyte.net,951608,ES89209541595236157007,1585.44,2022-12-24T10:45:33,Plentzia,expenses,food,-61.93,-12580.37
buyer_5,Sara,Urkiaga,1994-03-12,95203027R,sara.urkiaga@megabyte.net,951608,ES89209541595236157007,1585.44,2022-12-24T14:33:52,Plentzia,expenses,transport,-59.37,-12639.74
buyer_5,Sara,Urkiaga,1994-03-12,95203027R,sara.urkiaga@megabyte.net,951608,ES89209541595236157007,1585.44,2022-12-24T19:24:28,Plentzia,expenses,education,-51.76,-12691.5
buyer_5,Sara,Urkiaga,1994-03-12,95203027R,sara.urkiaga@megabyte.net,951608,ES89209541595236157007,1585.44,2022-12-26T12:57:21,Plentzia,expenses,food,-84.76,-12776.26
buyer_5,Sara,Urkiaga,1994-03-12,95203027R,sara.urkiaga@megabyte.net,951608,ES89209541595236157007,1585.44,2022-12-27T15:01:10,Plentzia,expenses,food,-72.15,-12848.41
buyer_5,Sara,Urkiaga,1994-03-12,95203027R,sara.urkiaga@megabyte.net,951608,ES89209541595236157007,1585.44,2022-12-27T12:29:01,Plentzia,expenses,transport,-43.24,-12891.65
buyer_5,Sara,Urkiaga,1994-03-12,95203027R,sara.urkiaga@megabyte.net,951608,ES89209541595236157007,1585.44,2022-12-28T07:05:53,Plentzia,expenses,cash,-100.0,-12991.65
buyer_5,Sara,Urkiaga,1994-03-12,95203027R,sara.urkiaga@megabyte.net,951608,ES89209541595236157007,1585.44,2022-12-30T14:26:17,Plentzia,expenses,healthcare,-104.78,-13096.43
buyer_5,Sara,Urkiaga,1994-03-12,95203027R,sara.urkiaga@megabyte.net,951608,ES89209541595236157007,1585.44,2022-12-30T14:27:51,Plentzia,expenses,repairs,-107.26,-13203.69
buyer_5,Sara,Urkiaga,1994-03-12,95203027R,sara.urkiaga@megabyte.net,951608,ES89209541595236157007,1585.44,2022-12-30T14:30:51,Plentzia,expenses,gifts,-208.58,-13412.27
buyer_5,Sara,Urkiaga,1994-03-12,95203027R,sara.urkiaga@megabyte.net,951608,ES89209541595236157007,1585.44,2023-01-01T20:03:16,Plentzia,incomes,salary,2239.22,-11173.05
buyer_5,Sara,Urkiaga,1994-03-12,95203027R,sara.urkiaga@megabyte.net,951608,ES89209541595236157007,1585.44,2023-01-01T20:03:16,Plentzia,incomes,salary_partner,2226.24,-8946.81
buyer_5,Sara,Urkiaga,1994-03-12,95203027R,sara.urkiaga@megabyte.net,951608,ES89209541595236157007,1585.44,2023-01-01T20:03:16,Plentzia,incomes,extra_income,224.91,-8721.9
buyer_5,Sara,Urkiaga,1994-03-12,95203027R,sara.urkiaga@megabyte.net,951608,ES89209541595236157007,1585.44,2023-01-01T12:11:17,Plentzia,expenses,leisure,-35.47,-8757.37
buyer_5,Sara,Urkiaga,1994-03-12,95203027R,sara.urkiaga@megabyte.net,951608,ES89209541595236157007,1585.44,2023-01-01T14:43:34,Plentzia,expenses,cash,-100.0,-8857.37
buyer_5,Sara,Urkiaga,1994-03-12,95203027R,sara.urkiaga@megabyte.net,951608,ES89209541595236157007,1585.44,2023-01-02T08:30:20,Plentzia,expenses,transport,-47.15,-8904.52
buyer_5,Sara,Urkiaga,1994-03-12,95203027R,sara.urkiaga@megabyte.net,951608,ES89209541595236157007,1585.44,2023-01-02T20:47:56,Plentzia,expenses,clothing,-129.26,-9033.78
buyer_5,Sara,Urkiaga,1994-03-12,95203027R,sara.urkiaga@megabyte.net,951608,ES89209541595236157007,1585.44,2023-01-02T14:59:13,Plentzia,expenses,gifts,-72.25,-9106.03
buyer_5,Sara,Urkiaga,1994-03-12,95203027R,sara.urkiaga@megabyte.net,951608,ES89209541595236157007,1585.44,2023-01-05T15:29:26,Plentzia,expenses,mortgage,-1701.23,-10807.26
buyer_5,Sara,Urkiaga,1994-03-12,95203027R,sara.urkiaga@megabyte.net,951608,ES89209541595236157007,1585.44,2023-01-06T20:20:58,Plentzia,expenses,electricity,-65.85,-10873.11
buyer_5,Sara,Urkiaga,1994-03-12,95203027R,sara.urkiaga@megabyte.net,951608,ES89209541595236157007,1585.44,2023-01-06T20:52:41,Plentzia,expenses,phone,-97.25,-10970.36
buyer_5,Sara,Urkiaga,1994-03-12,95203027R,sara.urkiaga@megabyte.net,951608,ES89209541595236157007,1585.44,2023-01-06T12:36:39,Plentzia,expenses,transport,-64.98,-11035.34
buyer_5,Sara,Urkiaga,1994-03-12,95203027R,sara.urkiaga@megabyte.net,951608,ES89209541595236157007,1585.44,2023-01-06T17:37:27,Plentzia,expenses,gifts,-148.7,-11184.04
buyer_5,Sara,Urkiaga,1994-03-12,95203027R,sara.urkiaga@megabyte.net,951608,ES89209541595236157007,1585.44,2023-01-07T15:46:43,Plentzia,expenses,electricity,-92.8,-11276.84
buyer_5,Sara,Urkiaga,1994-03-12,95203027R,sara.urkiaga@megabyte.net,951608,ES89209541595236157007,1585.44,2023-01-07T23:55:30,Plentzia,expenses,gas,-74.92,-11351.76
buyer_5,Sara,Urkiaga,1994-03-12,95203027R,sara.urkiaga@megabyte.net,951608,ES89209541595236157007,1585.44,2023-01-07T17:43:58,Plentzia,expenses,clothing,-65.39,-11417.15
buyer_5,Sara,Urkiaga,1994-03-12,95203027R,sara.urkiaga@megabyte.net,951608,ES89209541595236157007,1585.44,2023-01-09T08:13:10,Plentzia,expenses,food,-94.61,-11511.76
buyer_5,Sara,Urkiaga,1994-03-12,95203027R,sara.urkiaga@megabyte.net,951608,ES89209541595236157007,1585.44,2023-01-09T18:31:23,Plentzia,expenses,transport,-56.4,-11568.16
buyer_5,Sara,Urkiaga,1994-03-12,95203027R,sara.urkiaga@megabyte.net,951608,ES89209541595236157007,1585.44,2023-01-09T12:42:31,Plentzia,expenses,clothing,-81.75,-11649.91
buyer_5,Sara,Urkiaga,1994-03-12,95203027R,sara.urkiaga@megabyte.net,951608,ES89209541595236157007,1585.44,2023-01-09T16:18:30,Plentzia,expenses,appliances,-291.66,-11941.57
buyer_5,Sara,Urkiaga,1994-03-12,95203027R,sara.urkiaga@megabyte.net,951608,ES89209541595236157007,1585.44,2023-01-10T08:27:13,Plentzia,expenses,gifts,-285.57,-12227.14
buyer_5,Sara,Urkiaga,1994-03-12,95203027R,sara.urkiaga@megabyte.net,951608,ES89209541595236157007,1585.44,2023-01-12T00:49:51,Plentzia,expenses,food,-120.78,-12347.92
buyer_5,Sara,Urkiaga,1994-03-12,95203027R,sara.urkiaga@megabyte.net,951608,ES89209541595236157007,1585.44,2023-01-13T16:45:59,Plentzia,expenses,transport,-46.86,-12394.78
buyer_5,Sara,Urkiaga,1994-03-12,95203027R,sara.urkiaga@megabyte.net,951608,ES89209541595236157007,1585.44,2023-01-15T12:17:51,Plentzia,expenses,repairs,-74.95,-12469.73
buyer_5,Sara,Urkiaga,1994-03-12,95203027R,sara.urkiaga@megabyte.net,951608,ES89209541595236157007,1585.44,2023-01-18T12:59:07,Plentzia,expenses,leisure,-73.25,-12542.98
buyer_5,Sara,Urkiaga,1994-03-12,95203027R,sara.urkiaga@megabyte.net,951608,ES89209541595236157007,1585.44,2023-01-19T14:03:03,Plentzia,expenses,cash,-100.0,-12642.98
buyer_5,Sara,Urkiaga,1994-03-12,95203027R,sara.urkiaga@megabyte.net,951608,ES89209541595236157007,1585.44,2023-01-20T23:05:40,Plentzia,expenses,food,-113.18,-12756.16
buyer_5,Sara,Urkiaga,1994-03-12,95203027R,sara.urkiaga@megabyte.net,951608,ES89209541595236157007,1585.44,2023-01-20T18:54:31,Plentzia,expenses,transport,-50.43,-12806.59
buyer_5,Sara,Urkiaga,1994-03-12,95203027R,sara.urkiaga@megabyte.net,951608,ES89209541595236157007,1585.44,2023-01-20T00:05:46,Plentzia,expenses,leisure,-67.27,-12873.86
buyer_5,Sara,Urkiaga,1994-03-12,95203027R,sara.urkiaga@megabyte.net,951608,ES89209541595236157007,1585.44,2023-01-21T16:46:40,Plentzia,expenses,education,-75.39,-12949.25
buyer_5,Sara,Urkiaga,1994-03-12,95203027R,sara.urkiaga@megabyte.net,951608,ES89209541595236157007,1585.44,2023-01-24T21:31:48,Plentzia,expenses,food,-71.57,-13020.82
buyer_5,Sara,Urkiaga,1994-03-12,95203027R,sara.urkiaga@megabyte.net,951608,ES89209541595236157007,1585.44,2023-01-24T10:25:31,Plentzia,expenses,repairs,-129.14,-13149.96
buyer_5,Sara,Urkiaga,1994-03-12,95203027R,sara.urkiaga@megabyte.net,951608,ES89209541595236157007,1585.44,2023-01-25T19:54:15,Plentzia,expenses,cash,-100.0,-13249.96
buyer_5,Sara,Urkiaga,1994-03-12,95203027R,sara.urkiaga@megabyte.net,951608,ES89209541595236157007,1585.44,2023-01-27T13:48:35,Plentzia,expenses,food,-86.77,-13336.73
buyer_5,Sara,Urkiaga,1994-03-12,95203027R,sara.urkiaga@megabyte.net,951608,ES89209541595236157007,1585.44,2023-01-28T04:29:51,Plentzia,expenses,repairs,-177.08,-13513.81
buyer_5,Sara,Urkiaga,1994-03-12,95203027R,sara.urkiaga@megabyte.net,951608,ES89209541595236157007,1585.44,2023-01-29T20:17:24,Plentzia,expenses,leisure,-25.94,-13539.75
buyer_5,Sara,Urkiaga,1994-03-12,95203027R,sara.urkiaga@megabyte.net,951608,ES89209541595236157007,1585.44,2023-01-29T17:29:19,Plentzia,expenses,appliances,-82.17,-13621.92
buyer_5,Sara,Urkiaga,1994-03-12,95203027R,sara.urkiaga@megabyte.net,951608,ES89209541595236157007,1585.44,2023-01-29T11:09:57,Plentzia,expenses,repairs,-165.02,-13786.94
buyer_5,Sara,Urkiaga,1994-03-12,95203027R,sara.urkiaga@megabyte.net,951608,ES89209541595236157007,1585.44,2023-01-30T14:10:43,Plentzia,expenses,leisure,-42.39,-13829.33
buyer_5,Sara,Urkiaga,1994-03-12,95203027R,sara.urkiaga@megabyte.net,951608,ES89209541595236157007,1585.44,2023-01-30T11:11:16,Plentzia,expenses,gifts,-796.0,-14625.33
buyer_5,Sara,Urkiaga,1994-03-12,95203027R,sara.urkiaga@megabyte.net,951608,ES89209541595236157007,1585.44,2023-01-31T03:36:51,Plentzia,expenses,food,-80.99,-14706.32
buyer_5,Sara,Urkiaga,1994-03-12,95203027R,sara.urkiaga@megabyte.net,951608,ES89209541595236157007,1585.44,2023-01-31T19:10:12,Plentzia,expenses,cash,-100.0,-14806.32
buyer_5,Sara,Urkiaga,1994-03-12,95203027R,sara.urkiaga@megabyte.net,951608,ES89209541595236157007,1585.44,2023-02-01T13:27:21,Plentzia,incomes,salary,2239.22,-12567.1
buyer_5,Sara,Urkiaga,1994-03-12,95203027R,sara.urkiaga@megabyte.net,951608,ES89209541595236157007,1585.44,2023-02-01T13:27:21,Plentzia,incomes,salary_partner,2226.24,-10340.86
buyer_5,Sara,Urkiaga,1994-03-12,95203027R,sara.urkiaga@megabyte.net,951608,ES89209541595236157007,1585.44,2023-02-02T19:24:36,Plentzia,expenses,transport,-68.05,-10408.91
buyer_5,Sara,Urkiaga,1994-03-12,95203027R,sara.urkiaga@megabyte.net,951608,ES89209541595236157007,1585.44,2023-02-03T12:31:03,Plentzia,expenses,clothing,-156.13,-10565.04
buyer_5,Sara,Urkiaga,1994-03-12,95203027R,sara.urkiaga@megabyte.net,951608,ES89209541595236157007,1585.44,2023-02-04T10:51:23,Plentzia,expenses,gifts,-688.38,-11253.42
buyer_5,Sara,Urkiaga,1994-03-12,95203027R,sara.urkiaga@megabyte.net,951608,ES89209541595236157007,1585.44,2023-02-05T08:03:38,Plentzia,expenses,mortgage,-1701.23,-12954.65
buyer_5,Sara,Urkiaga,1994-03-12,95203027R,sara.urkiaga@megabyte.net,951608,ES89209541595236157007,1585.44,2023-02-05T16:22:27,Plentzia,expenses,water,-61.13,-13015.78
buyer_5,Sara,Urkiaga,1994-03-12,95203027R,sara.urkiaga@megabyte.net,951608,ES89209541595236157007,1585.44,2023-02-05T11:30:17,Plentzia,expenses,phone,-92.0,-13107.78
buyer_5,Sara,Urkiaga,1994-03-12,95203027R,sara.urkiaga@megabyte.net,951608,ES89209541595236157007,1585.44,2023-02-06T08:39:04,Plentzia,expenses,gas,-147.01,-13254.79
buyer_5,Sara,Urkiaga,1994-03-12,95203027R,sara.urkiaga@megabyte.net,951608,ES89209541595236157007,1585.44,2023-02-07T17:12:21,Plentzia,expenses,water,-100.28,-13355.07
buyer_5,Sara,Urkiaga,1994-03-12,95203027R,sara.urkiaga@megabyte.net,951608,ES89209541595236157007,1585.44,2023-02-07T18:25:13,Plentzia,expenses,electricity,-72.25,-13427.32
buyer_5,Sara,Urkiaga,1994-03-12,95203027R,sara.urkiaga@megabyte.net,951608,ES89209541595236157007,1585.44,2023-02-07T02:11:59,Plentzia,expenses,internet,-93.77,-13521.09
buyer_5,Sara,Urkiaga,1994-03-12,95203027R,sara.urkiaga@megabyte.net,951608,ES89209541595236157007,1585.44,2023-02-07T09:49:48,Plentzia,expenses,phone,-95.84,-13616.93
buyer_5,Sara,Urkiaga,1994-03-12,95203027R,sara.urkiaga@megabyte.net,951608,ES89209541595236157007,1585.44,2023-02-07T16:46:56,Plentzia,expenses,food,-81.62,-13698.55
buyer_5,Sara,Urkiaga,1994-03-12,95203027R,sara.urkiaga@megabyte.net,951608,ES89209541595236157007,1585.44,2023-02-08T20:15:27,Plentzia,expenses,water,-87.56,-13786.11
buyer_5,Sara,Urkiaga,1994-03-12,95203027R,sara.urkiaga@megabyte.net,951608,ES89209541595236157007,1585.44,2023-02-08T16:29:29,Plentzia,expenses,electricity,-116.17,-13902.28
buyer_5,Sara,Urkiaga,1994-03-12,95203027R,sara.urkiaga@megabyte.net,951608,ES89209541595236157007,1585.44,2023-02-08T18:48:10,Plentzia,expenses,cash,-100.0,-14002.28
buyer_5,Sara,Urkiaga,1994-03-12,95203027R,sara.urkiaga@megabyte.net,951608,ES89209541595236157007,1585.44,2023-02-09T12:55:46,Plentzia,expenses,clothing,-134.56,-14136.84
buyer_5,Sara,Urkiaga,1994-03-12,95203027R,sara.urkiaga@megabyte.net,951608,ES89209541595236157007,1585.44,2023-02-09T14:41:07,Plentzia,expenses,cash,-100.0,-14236.84
buyer_5,Sara,Urkiaga,1994-03-12,95203027R,sara.urkiaga@megabyte.net,951608,ES89209541595236157007,1585.44,2023-02-09T08:22:24,Plentzia,expenses,travel,-287.65,-14524.49
buyer_5,Sara,Urkiaga,1994-03-12,95203027R,sara.urkiaga@megabyte.net,951608,ES89209541595236157007,1585.44,2023-02-10T23:18:38,Plentzia,expenses,food,-123.33,-14647.82
buyer_5,Sara,Urkiaga,1994-03-12,95203027R,sara.urkiaga@megabyte.net,951608,ES89209541595236157007,1585.44,2023-02-11T12:22:22,Plentzia,expenses,transport,-69.13,-14716.95
buyer_5,Sara,Urkiaga,1994-03-12,95203027R,sara.urkiaga@megabyte.net,951608,ES89209541595236157007,1585.44,2023-02-11T11:07:45,Plentzia,expenses,appliances,-274.16,-14991.11
buyer_5,Sara,Urkiaga,1994-03-12,95203027R,sara.urkiaga@megabyte.net,951608,ES89209541595236157007,1585.44,2023-02-13T20:43:02,Plentzia,expenses,repairs,-53.26,-15044.37
buyer_5,Sara,Urkiaga,1994-03-12,95203027R,sara.urkiaga@megabyte.net,951608,ES89209541595236157007,1585.44,2023-02-14T23:11:11,Plentzia,expenses,transport,-62.26,-15106.63
buyer_5,Sara,Urkiaga,1994-03-12,95203027R,sara.urkiaga@megabyte.net,951608,ES89209541595236157007,1585.44,2023-02-15T18:35:35,Plentzia,expenses,cash,-100.0,-15206.63
buyer_5,Sara,Urkiaga,1994-03-12,95203027R,sara.urkiaga@megabyte.net,951608,ES89209541595236157007,1585.44,2023-02-15T16:16:26,Plentzia,expenses,appliances,-412.28,-15618.91
buyer_5,Sara,Urkiaga,1994-03-12,95203027R,sara.urkiaga@megabyte.net,951608,ES89209541595236157007,1585.44,2023-02-16T08:18:50,Plentzia,expenses,leisure,-66.94,-15685.85
buyer_5,Sara,Urkiaga,1994-03-12,95203027R,sara.urkiaga@megabyte.net,951608,ES89209541595236157007,1585.44,2023-02-17T14:58:50,Plentzia,expenses,cash,-100.0,-15785.85
buyer_5,Sara,Urkiaga,1994-03-12,95203027R,sara.urkiaga@megabyte.net,951608,ES89209541595236157007,1585.44,2023-02-19T12:16:27,Plentzia,expenses,food,-76.12,-15861.97
buyer_5,Sara,Urkiaga,1994-03-12,95203027R,sara.urkiaga@megabyte.net,951608,ES89209541595236157007,1585.44,2023-02-19T08:15:00,Plentzia,expenses,cash,-100.0,-15961.97
buyer_5,Sara,Urkiaga,1994-03-12,95203027R,sara.urkiaga@megabyte.net,951608,ES89209541595236157007,1585.44,2023-02-20T18:06:28,Plentzia,expenses,clothing,-116.7,-16078.67
buyer_5,Sara,Urkiaga,1994-03-12,95203027R,sara.urkiaga@megabyte.net,951608,ES89209541595236157007,1585.44,2023-02-22T10:52:41,Plentzia,expenses,transport,-77.09,-16155.76
buyer_5,Sara,Urkiaga,1994-03-12,95203027R,sara.urkiaga@megabyte.net,951608,ES89209541595236157007,1585.44,2023-02-27T20:54:02,Plentzia,expenses,cash,-100.0,-16255.76
buyer_5,Sara,Urkiaga,1994-03-12,95203027R,sara.urkiaga@megabyte.net,951608,ES89209541595236157007,1585.44,2023-02-28T18:51:50,Plentzia,expenses,education,-49.66,-16305.42
buyer_5,Sara,Urkiaga,1994-03-12,95203027R,sara.urkiaga@megabyte.net,951608,ES89209541595236157007,1585.44,2023-03-01T10:52:01,Plentzia,incomes,salary,2239.22,-14066.2
buyer_5,Sara,Urkiaga,1994-03-12,95203027R,sara.urkiaga@megabyte.net,951608,ES89209541595236157007,1585.44,2023-03-01T10:52:01,Plentzia,incomes,salary_partner,2226.24,-11839.96
buyer_5,Sara,Urkiaga,1994-03-12,95203027R,sara.urkiaga@megabyte.net,951608,ES89209541595236157007,1585.44,2023-03-01T09:54:07,Plentzia,expenses,food,-75.78,-11915.74
buyer_5,Sara,Urkiaga,1994-03-12,95203027R,sara.urkiaga@megabyte.net,951608,ES89209541595236157007,1585.44,2023-03-02T23:08:54,Plentzia,expenses,healthcare,-170.33,-12086.07
buyer_5,Sara,Urkiaga,1994-03-12,95203027R,sara.urkiaga@megabyte.net,951608,ES89209541595236157007,1585.44,2023-03-02T23:25:25,Plentzia,expenses,gifts,-654.14,-12740.21
buyer_5,Sara,Urkiaga,1994-03-12,95203027R,sara.urkiaga@megabyte.net,951608,ES89209541595236157007,1585.44,2023-03-03T15:09:49,Plentzia,expenses,transport,-88.55,-12828.76
buyer_5,Sara,Urkiaga,1994-03-12,95203027R,sara.urkiaga@megabyte.net,951608,ES89209541595236157007,1585.44,2023-03-03T16:30:21,Plentzia,expenses,appliances,-396.28,-13225.04
buyer_5,Sara,Urkiaga,1994-03-12,95203027R,sara.urkiaga@megabyte.net,951608,ES89209541595236157007,1585.44,2023-03-03T10:45:17,Plentzia,expenses,repairs,-90.21,-13315.25
buyer_5,Sara,Urkiaga,1994-03-12,95203027R,sara.urkiaga@megabyte.net,951608,ES89209541595236157007,1585.44,2023-03-04T12:38:41,Plentzia,expenses,transport,-67.78,-13383.03
buyer_5,Sara,Urkiaga,1994-03-12,95203027R,sara.urkiaga@megabyte.net,951608,ES89209541595236157007,1585.44,2023-03-05T12:11:03,Plentzia,expenses,mortgage,-1701.23,-15084.26
buyer_5,Sara,Urkiaga,1994-03-12,95203027R,sara.urkiaga@megabyte.net,951608,ES89209541595236157007,1585.44,2023-03-06T17:51:05,Plentzia,expenses,gas,-129.31,-15213.57
buyer_5,Sara,Urkiaga,1994-03-12,95203027R,sara.urkiaga@megabyte.net,951608,ES89209541595236157007,1585.44,2023-03-07T18:23:03,Plentzia,expenses,internet,-93.77,-15307.34
buyer_5,Sara,Urkiaga,1994-03-12,95203027R,sara.urkiaga@megabyte.net,951608,ES89209541595236157007,1585.44,2023-03-07T09:56:27,Plentzia,expenses,phone,-71.37,-15378.71
buyer_5,Sara,Urkiaga,1994-03-12,95203027R,sara.urkiaga@megabyte.net,951608,ES89209541595236157007,1585.44,2023-03-07T11:28:16,Plentzia,expenses,food,-81.09,-15459.8
buyer_5,Sara,Urkiaga,1994-03-12,95203027R,sara.urkiaga@megabyte.net,951608,ES89209541595236157007,1585.44,2023-03-07T20:01:28,Plentzia,expenses,leisure,-58.2,-15518.0
buyer_5,Sara,Urkiaga,1994-03-12,95203027R,sara.urkiaga@megabyte.net,951608,ES89209541595236157007,1585.44,2023-03-08T17:53:57,Plentzia,expenses,repairs,-37.27,-15555.27
buyer_5,Sara,Urkiaga,1994-03-12,95203027R,sara.urkiaga@megabyte.net,951608,ES89209541595236157007,1585.44,2023-03-09T19:40:58,Plentzia,expenses,appliances,-244.02,-15799.29
buyer_5,Sara,Urkiaga,1994-03-12,95203027R,sara.urkiaga@megabyte.net,951608,ES89209541595236157007,1585.44,2023-03-11T08:08:22,Plentzia,expenses,cash,-100.0,-15899.29
buyer_5,Sara,Urkiaga,1994-03-12,95203027R,sara.urkiaga@megabyte.net,951608,ES89209541595236157007,1585.44,2023-03-13T11:25:21,Plentzia,expenses,repairs,-278.25,-16177.54
buyer_5,Sara,Urkiaga,1994-03-12,95203027R,sara.urkiaga@megabyte.net,951608,ES89209541595236157007,1585.44,2023-03-14T11:31:33,Plentzia,expenses,leisure,-23.81,-16201.35
buyer_5,Sara,Urkiaga,1994-03-12,95203027R,sara.urkiaga@megabyte.net,951608,ES89209541595236157007,1585.44,2023-03-14T23:58:26,Plentzia,expenses,clothing,-53.28,-16254.63
buyer_5,Sara,Urkiaga,1994-03-12,95203027R,sara.urkiaga@megabyte.net,951608,ES89209541595236157007,1585.44,2023-03-16T15:20:12,Plentzia,expenses,transport,-75.54,-16330.17
buyer_5,Sara,Urkiaga,1994-03-12,95203027R,sara.urkiaga@megabyte.net,951608,ES89209541595236157007,1585.44,2023-03-16T09:27:18,Plentzia,expenses,cash,-100.0,-16430.17
buyer_5,Sara,Urkiaga,1994-03-12,95203027R,sara.urkiaga@megabyte.net,951608,ES89209541595236157007,1585.44,2023-03-21T19:16:15,Plentzia,expenses,cash,-100.0,-16530.17
buyer_5,Sara,Urkiaga,1994-03-12,95203027R,sara.urkiaga@megabyte.net,951608,ES89209541595236157007,1585.44,2023-03-22T18:20:32,Plentzia,expenses,cash,-100.0,-16630.17
buyer_5,Sara,Urkiaga,1994-03-12,95203027R,sara.urkiaga@megabyte.net,951608,ES89209541595236157007,1585.44,2023-03-23T10:48:05,Plentzia,expenses,transport,-57.62,-16687.79
buyer_5,Sara,Urkiaga,1994-03-12,95203027R,sara.urkiaga@megabyte.net,951608,ES89209541595236157007,1585.44,2023-03-23T05:07:20,Plentzia,expenses,gifts,-795.76,-17483.55
buyer_5,Sara,Urkiaga,1994-03-12,95203027R,sara.urkiaga@megabyte.net,951608,ES89209541595236157007,1585.44,2023-03-24T19:23:07,Plentzia,expenses,appliances,-181.0,-17664.55
buyer_5,Sara,Urkiaga,1994-03-12,95203027R,sara.urkiaga@megabyte.net,951608,ES89209541595236157007,1585.44,2023-03-28T11:34:09,Plentzia,expenses,transport,-83.53,-17748.08
buyer_5,Sara,Urkiaga,1994-03-12,95203027R,sara.urkiaga@megabyte.net,951608,ES89209541595236157007,1585.44,2023-03-28T19:04:54,Plentzia,expenses,repairs,-115.06,-17863.14
buyer_5,Sara,Urkiaga,1994-03-12,95203027R,sara.urkiaga@megabyte.net,951608,ES89209541595236157007,1585.44,2023-03-28T08:02:28,Plentzia,expenses,gifts,-457.72,-18320.86
buyer_5,Sara,Urkiaga,1994-03-12,95203027R,sara.urkiaga@megabyte.net,951608,ES89209541595236157007,1585.44,2023-03-29T11:04:02,Plentzia,expenses,leisure,-39.81,-18360.67
buyer_5,Sara,Urkiaga,1994-03-12,95203027R,sara.urkiaga@megabyte.net,951608,ES89209541595236157007,1585.44,2023-03-29T15:35:38,Plentzia,expenses,gifts,-392.22,-18752.89
buyer_5,Sara,Urkiaga,1994-03-12,95203027R,sara.urkiaga@megabyte.net,951608,ES89209541595236157007,1585.44,2023-03-31T17:54:16,Plentzia,expenses,food,-105.98,-18858.87
buyer_5,Sara,Urkiaga,1994-03-12,95203027R,sara.urkiaga@megabyte.net,951608,ES89209541595236157007,1585.44,2023-04-01T19:32:57,Plentzia,incomes,salary,2239.22,-16619.65
buyer_5,Sara,Urkiaga,1994-03-12,95203027R,sara.urkiaga@megabyte.net,951608,ES89209541595236157007,1585.44,2023-04-01T19:32:57,Plentzia,incomes,salary_partner,2226.24,-14393.41
buyer_5,Sara,Urkiaga,1994-03-12,95203027R,sara.urkiaga@megabyte.net,951608,ES89209541595236157007,1585.44,2023-04-01T19:32:57,Plentzia,incomes,extra_income,224.91,-14168.5
buyer_5,Sara,Urkiaga,1994-03-12,95203027R,sara.urkiaga@megabyte.net,951608,ES89209541595236157007,1585.44,2023-04-01T09:04:59,Plentzia,expenses,healthcare,-180.92,-14349.42
buyer_5,Sara,Urkiaga,1994-03-12,95203027R,sara.urkiaga@megabyte.net,951608,ES89209541595236157007,1585.44,2023-04-02T18:11:46,Plentzia,expenses,food,-92.32,-14441.74
buyer_5,Sara,Urkiaga,1994-03-12,95203027R,sara.urkiaga@megabyte.net,951608,ES89209541595236157007,1585.44,2023-04-05T20:26:51,Plentzia,expenses,mortgage,-1701.23,-16142.97
buyer_5,Sara,Urkiaga,1994-03-12,95203027R,sara.urkiaga@megabyte.net,951608,ES89209541595236157007,1585.44,2023-04-06T14:04:11,Plentzia,expenses,electricity,-92.97,-16235.94
buyer_5,Sara,Urkiaga,1994-03-12,95203027R,sara.urkiaga@megabyte.net,951608,ES89209541595236157007,1585.44,2023-04-06T11:25:48,Plentzia,expenses,gas,-92.18,-16328.12
buyer_5,Sara,Urkiaga,1994-03-12,95203027R,sara.urkiaga@megabyte.net,951608,ES89209541595236157007,1585.44,2023-04-06T19:20:24,Plentzia,expenses,internet,-93.77,-16421.89
buyer_5,Sara,Urkiaga,1994-03-12,95203027R,sara.urkiaga@megabyte.net,951608,ES89209541595236157007,1585.44,2023-04-07T11:28:31,Plentzia,expenses,phone,-88.9,-16510.79
buyer_5,Sara,Urkiaga,1994-03-12,95203027R,sara.urkiaga@megabyte.net,951608,ES89209541595236157007,1585.44,2023-04-07T04:59:39,Plentzia,expenses,clothing,-100.69,-16611.48
buyer_5,Sara,Urkiaga,1994-03-12,95203027R,sara.urkiaga@megabyte.net,951608,ES89209541595236157007,1585.44,2023-04-08T05:34:13,Plentzia,expenses,phone,-99.97,-16711.45
buyer_5,Sara,Urkiaga,1994-03-12,95203027R,sara.urkiaga@megabyte.net,951608,ES89209541595236157007,1585.44,2023-04-08T08:47:43,Plentzia,expenses,cash,-100.0,-16811.45
buyer_5,Sara,Urkiaga,1994-03-12,95203027R,sara.urkiaga@megabyte.net,951608,ES89209541595236157007,1585.44,2023-04-09T12:28:24,Plentzia,expenses,repairs,-224.72,-17036.17
buyer_5,Sara,Urkiaga,1994-03-12,95203027R,sara.urkiaga@megabyte.net,951608,ES89209541595236157007,1585.44,2023-04-10T10:36:58,Plentzia,expenses,food,-75.82,-17111.99
buyer_5,Sara,Urkiaga,1994-03-12,95203027R,sara.urkiaga@megabyte.net,951608,ES89209541595236157007,1585.44,2023-04-10T18:54:43,Plentzia,expenses,clothing,-133.46,-17245.45
buyer_5,Sara,Urkiaga,1994-03-12,95203027R,sara.urkiaga@megabyte.net,951608,ES89209541595236157007,1585.44,2023-04-15T11:39:02,Plentzia,expenses,education,-61.0,-17306.45
buyer_5,Sara,Urkiaga,1994-03-12,95203027R,sara.urkiaga@megabyte.net,951608,ES89209541595236157007,1585.44,2023-04-16T04:23:32,Plentzia,expenses,food,-123.51,-17429.96
buyer_5,Sara,Urkiaga,1994-03-12,95203027R,sara.urkiaga@megabyte.net,951608,ES89209541595236157007,1585.44,2023-04-17T16:37:00,Plentzia,expenses,cash,-100.0,-17529.96
buyer_5,Sara,Urkiaga,1994-03-12,95203027R,sara.urkiaga@megabyte.net,951608,ES89209541595236157007,1585.44,2023-04-19T08:39:05,Plentzia,expenses,cash,-100.0,-17629.96
buyer_5,Sara,Urkiaga,1994-03-12,95203027R,sara.urkiaga@megabyte.net,951608,ES89209541595236157007,1585.44,2023-04-19T08:00:49,Plentzia,expenses,gifts,-26.08,-17656.04
buyer_5,Sara,Urkiaga,1994-03-12,95203027R,sara.urkiaga@megabyte.net,951608,ES89209541595236157007,1585.44,2023-04-22T11:15:33,Plentzia,expenses,repairs,-28.52,-17684.56
buyer_5,Sara,Urkiaga,1994-03-12,95203027R,sara.urkiaga@megabyte.net,951608,ES89209541595236157007,1585.44,2023-04-24T16:58:40,Plentzia,expenses,food,-94.22,-17778.78
buyer_5,Sara,Urkiaga,1994-03-12,95203027R,sara.urkiaga@megabyte.net,951608,ES89209541595236157007,1585.44,2023-04-24T10:41:10,Plentzia,expenses,repairs,-270.91,-18049.69
buyer_5,Sara,Urkiaga,1994-03-12,95203027R,sara.urkiaga@megabyte.net,951608,ES89209541595236157007,1585.44,2023-04-25T18:45:45,Plentzia,expenses,cash,-100.0,-18149.69
buyer_5,Sara,Urkiaga,1994-03-12,95203027R,sara.urkiaga@megabyte.net,951608,ES89209541595236157007,1585.44,2023-04-27T18:16:53,Plentzia,expenses,gifts,-540.34,-18690.03
buyer_5,Sara,Urkiaga,1994-03-12,95203027R,sara.urkiaga@megabyte.net,951608,ES89209541595236157007,1585.44,2023-04-28T08:44:58,Plentzia,expenses,food,-72.34,-18762.37
buyer_5,Sara,Urkiaga,1994-03-12,95203027R,sara.urkiaga@megabyte.net,951608,ES89209541595236157007,1585.44,2023-04-28T11:28:48,Plentzia,expenses,cash,-100.0,-18862.37
buyer_5,Sara,Urkiaga,1994-03-12,95203027R,sara.urkiaga@megabyte.net,951608,ES89209541595236157007,1585.44,2023-04-30T14:22:53,Plentzia,expenses,food,-99.15,-18961.52
buyer_5,Sara,Urkiaga,1994-03-12,95203027R,sara.urkiaga@megabyte.net,951608,ES89209541595236157007,1585.44,2023-05-01T07:59:54,Plentzia,incomes,salary,2239.22,-16722.3
buyer_5,Sara,Urkiaga,1994-03-12,95203027R,sara.urkiaga@megabyte.net,951608,ES89209541595236157007,1585.44,2023-05-01T07:59:54,Plentzia,incomes,salary_partner,2226.24,-14496.06
buyer_5,Sara,Urkiaga,1994-03-12,95203027R,sara.urkiaga@megabyte.net,951608,ES89209541595236157007,1585.44,2023-05-01T20:34:04,Plentzia,expenses,education,-78.56,-14574.62
buyer_5,Sara,Urkiaga,1994-03-12,95203027R,sara.urkiaga@megabyte.net,951608,ES89209541595236157007,1585.44,2023-05-02T13:37:01,Plentzia,expenses,clothing,-83.51,-14658.13
buyer_5,Sara,Urkiaga,1994-03-12,95203027R,sara.urkiaga@megabyte.net,951608,ES89209541595236157007,1585.44,2023-05-02T11:31:06,Plentzia,expenses,cash,-100.0,-14758.13
buyer_5,Sara,Urkiaga,1994-03-12,95203027R,sara.urkiaga@megabyte.net,951608,ES89209541595236157007,1585.44,2023-05-04T11:11:30,Plentzia,expenses,leisure,-33.47,-14791.6
buyer_5,Sara,Urkiaga,1994-03-12,95203027R,sara.urkiaga@megabyte.net,951608,ES89209541595236157007,1585.44,2023-05-05T19:31:27,Plentzia,expenses,mortgage,-1701.23,-16492.83
buyer_5,Sara,Urkiaga,1994-03-12,95203027R,sara.urkiaga@megabyte.net,951608,ES89209541595236157007,1585.44,2023-05-05T09:47:50,Plentzia,expenses,gifts,-818.41,-17311.24
buyer_5,Sara,Urkiaga,1994-03-12,95203027R,sara.urkiaga@megabyte.net,951608,ES89209541595236157007,1585.44,2023-05-06T12:51:56,Plentzia,expenses,water,-76.13,-17387.37
buyer_5,Sara,Urkiaga,1994-03-12,95203027R,sara.urkiaga@megabyte.net,951608,ES89209541595236157007,1585.44,2023-05-06T11:26:26,Plentzia,expenses,gas,-80.75,-17468.12
buyer_5,Sara,Urkiaga,1994-03-12,95203027R,sara.urkiaga@megabyte.net,951608,ES89209541595236157007,1585.44,2023-05-06T10:40:28,Plentzia,expenses,repairs,-28.68,-17496.8
buyer_5,Sara,Urkiaga,1994-03-12,95203027R,sara.urkiaga@megabyte.net,951608,ES89209541595236157007,1585.44,2023-05-07T19:25:38,Plentzia,expenses,gas,-167.9,-17664.7
buyer_5,Sara,Urkiaga,1994-03-12,95203027R,sara.urkiaga@megabyte.net,951608,ES89209541595236157007,1585.44,2023-05-07T13:06:51,Plentzia,expenses,phone,-97.69,-17762.39
buyer_5,Sara,Urkiaga,1994-03-12,95203027R,sara.urkiaga@megabyte.net,951608,ES89209541595236157007,1585.44,2023-05-08T09:09:46,Plentzia,expenses,leisure,-48.6,-17810.99
buyer_5,Sara,Urkiaga,1994-03-12,95203027R,sara.urkiaga@megabyte.net,951608,ES89209541595236157007,1585.44,2023-05-09T21:09:46,Plentzia,expenses,transport,-55.0,-17865.99
buyer_5,Sara,Urkiaga,1994-03-12,95203027R,sara.urkiaga@megabyte.net,951608,ES89209541595236157007,1585.44,2023-05-09T09:35:40,Plentzia,expenses,leisure,-31.07,-17897.06
buyer_5,Sara,Urkiaga,1994-03-12,95203027R,sara.urkiaga@megabyte.net,951608,ES89209541595236157007,1585.44,2023-05-10T09:08:38,Plentzia,expenses,cash,-100.0,-17997.06
buyer_5,Sara,Urkiaga,1994-03-12,95203027R,sara.urkiaga@megabyte.net,951608,ES89209541595236157007,1585.44,2023-05-11T13:59:42,Plentzia,expenses,transport,-71.34,-18068.4
buyer_5,Sara,Urkiaga,1994-03-12,95203027R,sara.urkiaga@megabyte.net,951608,ES89209541595236157007,1585.44,2023-05-14T08:36:06,Plentzia,expenses,food,-121.02,-18189.42
buyer_5,Sara,Urkiaga,1994-03-12,95203027R,sara.urkiaga@megabyte.net,951608,ES89209541595236157007,1585.44,2023-05-14T05:33:30,Plentzia,expenses,education,-70.46,-18259.88
buyer_5,Sara,Urkiaga,1994-03-12,95203027R,sara.urkiaga@megabyte.net,951608,ES89209541595236157007,1585.44,2023-05-14T17:54:12,Plentzia,expenses,cash,-100.0,-18359.88
buyer_5,Sara,Urkiaga,1994-03-12,95203027R,sara.urkiaga@megabyte.net,951608,ES89209541595236157007,1585.44,2023-05-15T01:39:12,Plentzia,expenses,transport,-72.05,-18431.93
buyer_5,Sara,Urkiaga,1994-03-12,95203027R,sara.urkiaga@megabyte.net,951608,ES89209541595236157007,1585.44,2023-05-15T19:59:04,Plentzia,expenses,education,-57.1,-18489.03
buyer_5,Sara,Urkiaga,1994-03-12,95203027R,sara.urkiaga@megabyte.net,951608,ES89209541595236157007,1585.44,2023-05-15T16:58:29,Plentzia,expenses,cash,-100.0,-18589.03
buyer_5,Sara,Urkiaga,1994-03-12,95203027R,sara.urkiaga@megabyte.net,951608,ES89209541595236157007,1585.44,2023-05-17T12:25:15,Plentzia,expenses,clothing,-144.51,-18733.54
buyer_5,Sara,Urkiaga,1994-03-12,95203027R,sara.urkiaga@megabyte.net,951608,ES89209541595236157007,1585.44,2023-05-18T16:59:29,Plentzia,expenses,leisure,-40.56,-18774.1
buyer_5,Sara,Urkiaga,1994-03-12,95203027R,sara.urkiaga@megabyte.net,951608,ES89209541595236157007,1585.44,2023-05-23T14:02:12,Plentzia,expenses,clothing,-61.06,-18835.16
buyer_5,Sara,Urkiaga,1994-03-12,95203027R,sara.urkiaga@megabyte.net,951608,ES89209541595236157007,1585.44,2023-05-23T07:29:31,Plentzia,expenses,cash,-100.0,-18935.16
buyer_5,Sara,Urkiaga,1994-03-12,95203027R,sara.urkiaga@megabyte.net,951608,ES89209541595236157007,1585.44,2023-05-24T13:49:03,Plentzia,expenses,food,-114.52,-19049.68
buyer_5,Sara,Urkiaga,1994-03-12,95203027R,sara.urkiaga@megabyte.net,951608,ES89209541595236157007,1585.44,2023-05-24T18:29:15,Plentzia,expenses,repairs,-99.53,-19149.21
buyer_5,Sara,Urkiaga,1994-03-12,95203027R,sara.urkiaga@megabyte.net,951608,ES89209541595236157007,1585.44,2023-05-26T17:06:46,Plentzia,expenses,repairs,-130.97,-19280.18
buyer_5,Sara,Urkiaga,1994-03-12,95203027R,sara.urkiaga@megabyte.net,951608,ES89209541595236157007,1585.44,2023-05-29T03:56:34,Plentzia,expenses,repairs,-265.44,-19545.62
buyer_5,Sara,Urkiaga,1994-03-12,95203027R,sara.urkiaga@megabyte.net,951608,ES89209541595236157007,1585.44,2023-05-30T20:53:41,Plentzia,expenses,leisure,-74.53,-19620.15
buyer_5,Sara,Urkiaga,1994-03-12,95203027R,sara.urkiaga@megabyte.net,951608,ES89209541595236157007,1585.44,2023-06-01T12:20:37,Plentzia,incomes,salary,2239.22,-17380.93
buyer_5,Sara,Urkiaga,1994-03-12,95203027R,sara.urkiaga@megabyte.net,951608,ES89209541595236157007,1585.44,2023-06-01T12:20:37,Plentzia,incomes,salary_partner,2226.24,-15154.69
buyer_5,Sara,Urkiaga,1994-03-12,95203027R,sara.urkiaga@megabyte.net,951608,ES89209541595236157007,1585.44,2023-06-01T12:20:37,Plentzia,incomes,salary_bonus,1786.05,-13368.64
buyer_5,Sara,Urkiaga,1994-03-12,95203027R,sara.urkiaga@megabyte.net,951608,ES89209541595236157007,1585.44,2023-06-01T12:20:37,Plentzia,incomes,salary_partner_bonus,1684.87,-11683.77
buyer_5,Sara,Urkiaga,1994-03-12,95203027R,sara.urkiaga@megabyte.net,951608,ES89209541595236157007,1585.44,2023-06-01T22:11:03,Plentzia,expenses,leisure,-84.12,-11767.89
buyer_5,Sara,Urkiaga,1994-03-12,95203027R,sara.urkiaga@megabyte.net,951608,ES89209541595236157007,1585.44,2023-06-02T15:40:20,Plentzia,expenses,education,-43.94,-11811.83
buyer_5,Sara,Urkiaga,1994-03-12,95203027R,sara.urkiaga@megabyte.net,951608,ES89209541595236157007,1585.44,2023-06-02T20:38:06,Plentzia,expenses,appliances,-285.76,-12097.59
buyer_5,Sara,Urkiaga,1994-03-12,95203027R,sara.urkiaga@megabyte.net,951608,ES89209541595236157007,1585.44,2023-06-03T09:45:14,Plentzia,expenses,taxes,-2791.8,-14889.39
buyer_5,Sara,Urkiaga,1994-03-12,95203027R,sara.urkiaga@megabyte.net,951608,ES89209541595236157007,1585.44,2023-06-03T03:26:30,Plentzia,expenses,insurance,-869.06,-15758.45
buyer_5,Sara,Urkiaga,1994-03-12,95203027R,sara.urkiaga@megabyte.net,951608,ES89209541595236157007,1585.44,2023-06-03T05:26:35,Plentzia,expenses,food,-106.45,-15864.9
buyer_5,Sara,Urkiaga,1994-03-12,95203027R,sara.urkiaga@megabyte.net,951608,ES89209541595236157007,1585.44,2023-06-03T17:22:48,Plentzia,expenses,cash,-100.0,-15964.9
buyer_5,Sara,Urkiaga,1994-03-12,95203027R,sara.urkiaga@megabyte.net,951608,ES89209541595236157007,1585.44,2023-06-04T14:28:12,Plentzia,expenses,transport,-55.24,-16020.14
buyer_5,Sara,Urkiaga,1994-03-12,95203027R,sara.urkiaga@megabyte.net,951608,ES89209541595236157007,1585.44,2023-06-05T10:48:49,Plentzia,expenses,mortgage,-1701.23,-17721.37
buyer_5,Sara,Urkiaga,1994-03-12,95203027R,sara.urkiaga@megabyte.net,951608,ES89209541595236157007,1585.44,2023-06-05T10:08:37,Plentzia,expenses,internet,-93.77,-17815.14
buyer_5,Sara,Urkiaga,1994-03-12,95203027R,sara.urkiaga@megabyte.net,951608,ES89209541595236157007,1585.44,2023-06-05T10:01:38,Plentzia,expenses,phone,-81.79,-17896.93
buyer_5,Sara,Urkiaga,1994-03-12,95203027R,sara.urkiaga@megabyte.net,951608,ES89209541595236157007,1585.44,2023-06-06T09:04:13,Plentzia,expenses,cash,-100.0,-17996.93
buyer_5,Sara,Urkiaga,1994-03-12,95203027R,sara.urkiaga@megabyte.net,951608,ES89209541595236157007,1585.44,2023-06-07T16:12:04,Plentzia,expenses,water,-47.63,-18044.56
buyer_5,Sara,Urkiaga,1994-03-12,95203027R,sara.urkiaga@megabyte.net,951608,ES89209541595236157007,1585.44,2023-06-07T15:07:26,Plentzia,expenses,food,-65.67,-18110.23
buyer_5,Sara,Urkiaga,1994-03-12,95203027R,sara.urkiaga@megabyte.net,951608,ES89209541595236157007,1585.44,2023-06-08T14:20:03,Plentzia,expenses,water,-70.56,-18180.79
buyer_5,Sara,Urkiaga,1994-03-12,95203027R,sara.urkiaga@megabyte.net,951608,ES89209541595236157007,1585.44,2023-06-08T16:56:22,Plentzia,expenses,gas,-145.18,-18325.97
buyer_5,Sara,Urkiaga,1994-03-12,95203027R,sara.urkiaga@megabyte.net,951608,ES89209541595236157007,1585.44,2023-06-08T20:27:27,Plentzia,expenses,transport,-77.61,-18403.58
buyer_5,Sara,Urkiaga,1994-03-12,95203027R,sara.urkiaga@megabyte.net,951608,ES89209541595236157007,1585.44,2023-06-10T13:36:55,Plentzia,expenses,leisure,-78.49,-18482.07
buyer_5,Sara,Urkiaga,1994-03-12,95203027R,sara.urkiaga@megabyte.net,951608,ES89209541595236157007,1585.44,2023-06-11T08:51:43,Plentzia,expenses,transport,-46.76,-18528.83
buyer_5,Sara,Urkiaga,1994-03-12,95203027R,sara.urkiaga@megabyte.net,951608,ES89209541595236157007,1585.44,2023-06-13T08:23:49,Plentzia,expenses,leisure,-54.07,-18582.9
buyer_5,Sara,Urkiaga,1994-03-12,95203027R,sara.urkiaga@megabyte.net,951608,ES89209541595236157007,1585.44,2023-06-14T14:07:52,Plentzia,expenses,cash,-100.0,-18682.9
buyer_5,Sara,Urkiaga,1994-03-12,95203027R,sara.urkiaga@megabyte.net,951608,ES89209541595236157007,1585.44,2023-06-16T20:00:30,Plentzia,expenses,gifts,-222.24,-18905.14
buyer_5,Sara,Urkiaga,1994-03-12,95203027R,sara.urkiaga@megabyte.net,951608,ES89209541595236157007,1585.44,2023-06-23T15:36:58,Plentzia,expenses,transport,-60.61,-18965.75
buyer_5,Sara,Urkiaga,1994-03-12,95203027R,sara.urkiaga@megabyte.net,951608,ES89209541595236157007,1585.44,2023-06-24T11:19:07,Plentzia,expenses,food,-79.66,-19045.41
buyer_5,Sara,Urkiaga,1994-03-12,95203027R,sara.urkiaga@megabyte.net,951608,ES89209541595236157007,1585.44,2023-06-25T21:57:06,Plentzia,expenses,cash,-100.0,-19145.41
buyer_5,Sara,Urkiaga,1994-03-12,95203027R,sara.urkiaga@megabyte.net,951608,ES89209541595236157007,1585.44,2023-06-26T18:03:45,Plentzia,expenses,transport,-61.36,-19206.77
buyer_5,Sara,Urkiaga,1994-03-12,95203027R,sara.urkiaga@megabyte.net,951608,ES89209541595236157007,1585.44,2023-06-27T17:10:33,Plentzia,expenses,leisure,-82.17,-19288.94
buyer_5,Sara,Urkiaga,1994-03-12,95203027R,sara.urkiaga@megabyte.net,951608,ES89209541595236157007,1585.44,2023-06-27T10:20:08,Plentzia,expenses,cash,-100.0,-19388.94
buyer_5,Sara,Urkiaga,1994-03-12,95203027R,sara.urkiaga@megabyte.net,951608,ES89209541595236157007,1585.44,2023-06-28T12:29:34,Plentzia,expenses,transport,-68.63,-19457.57
buyer_5,Sara,Urkiaga,1994-03-12,95203027R,sara.urkiaga@megabyte.net,951608,ES89209541595236157007,1585.44,2023-06-28T12:17:05,Plentzia,expenses,leisure,-45.08,-19502.65
buyer_5,Sara,Urkiaga,1994-03-12,95203027R,sara.urkiaga@megabyte.net,951608,ES89209541595236157007,1585.44,2023-06-29T19:58:07,Plentzia,expenses,food,-84.68,-19587.33
buyer_5,Sara,Urkiaga,1994-03-12,95203027R,sara.urkiaga@megabyte.net,951608,ES89209541595236157007,1585.44,2023-06-30T20:21:06,Plentzia,expenses,food,-87.73,-19675.06
buyer_5,Sara,Urkiaga,1994-03-12,95203027R,sara.urkiaga@megabyte.net,951608,ES89209541595236157007,1585.44,2023-06-30T09:50:48,Plentzia,expenses,appliances,-286.21,-19961.27
buyer_5,Sara,Urkiaga,1994-03-12,95203027R,sara.urkiaga@megabyte.net,951608,ES89209541595236157007,1585.44,2023-07-01T19:02:05,Plentzia,incomes,salary,2239.22,-17722.05
buyer_5,Sara,Urkiaga,1994-03-12,95203027R,sara.urkiaga@megabyte.net,951608,ES89209541595236157007,1585.44,2023-07-01T19:02:05,Plentzia,incomes,salary_partner,2226.24,-15495.81
buyer_5,Sara,Urkiaga,1994-03-12,95203027R,sara.urkiaga@megabyte.net,951608,ES89209541595236157007,1585.44,2023-07-01T20:38:52,Plentzia,expenses,education,-69.5,-15565.31
buyer_5,Sara,Urkiaga,1994-03-12,95203027R,sara.urkiaga@megabyte.net,951608,ES89209541595236157007,1585.44,2023-07-04T16:33:26,Plentzia,expenses,leisure,-28.02,-15593.33
buyer_5,Sara,Urkiaga,1994-03-12,95203027R,sara.urkiaga@megabyte.net,951608,ES89209541595236157007,1585.44,2023-07-05T08:22:18,Plentzia,expenses,mortgage,-1701.23,-17294.56
buyer_5,Sara,Urkiaga,1994-03-12,95203027R,sara.urkiaga@megabyte.net,951608,ES89209541595236157007,1585.44,2023-07-07T16:48:47,Plentzia,expenses,phone,-77.62,-17372.18
buyer_5,Sara,Urkiaga,1994-03-12,95203027R,sara.urkiaga@megabyte.net,951608,ES89209541595236157007,1585.44,2023-07-07T12:39:31,Plentzia,expenses,leisure,-70.38,-17442.56
buyer_5,Sara,Urkiaga,1994-03-12,95203027R,sara.urkiaga@megabyte.net,951608,ES89209541595236157007,1585.44,2023-07-10T19:40:25,Plentzia,expenses,food,-104.8,-17547.36
buyer_5,Sara,Urkiaga,1994-03-12,95203027R,sara.urkiaga@megabyte.net,951608,ES89209541595236157007,1585.44,2023-07-10T11:18:34,Plentzia,expenses,cash,-100.0,-17647.36
buyer_5,Sara,Urkiaga,1994-03-12,95203027R,sara.urkiaga@megabyte.net,951608,ES89209541595236157007,1585.44,2023-07-11T14:42:01,Plentzia,expenses,cash,-100.0,-17747.36
buyer_5,Sara,Urkiaga,1994-03-12,95203027R,sara.urkiaga@megabyte.net,951608,ES89209541595236157007,1585.44,2023-07-12T19:04:22,Plentzia,expenses,repairs,-128.49,-17875.85
buyer_5,Sara,Urkiaga,1994-03-12,95203027R,sara.urkiaga@megabyte.net,951608,ES89209541595236157007,1585.44,2023-07-14T11:33:08,Plentzia,expenses,education,-61.25,-17937.1
buyer_5,Sara,Urkiaga,1994-03-12,95203027R,sara.urkiaga@megabyte.net,951608,ES89209541595236157007,1585.44,2023-07-14T08:34:36,Plentzia,expenses,cash,-100.0,-18037.1
buyer_5,Sara,Urkiaga,1994-03-12,95203027R,sara.urkiaga@megabyte.net,951608,ES89209541595236157007,1585.44,2023-07-16T23:10:21,Plentzia,expenses,clothing,-67.08,-18104.18
buyer_5,Sara,Urkiaga,1994-03-12,95203027R,sara.urkiaga@megabyte.net,951608,ES89209541595236157007,1585.44,2023-07-17T12:25:40,Plentzia,expenses,food,-97.51,-18201.69
buyer_5,Sara,Urkiaga,1994-03-12,95203027R,sara.urkiaga@megabyte.net,951608,ES89209541595236157007,1585.44,2023-07-20T20:30:08,Plentzia,expenses,transport,-84.67,-18286.36
buyer_5,Sara,Urkiaga,1994-03-12,95203027R,sara.urkiaga@megabyte.net,951608,ES89209541595236157007,1585.44,2023-07-21T17:15:26,Plentzia,expenses,transport,-53.92,-18340.28
buyer_5,Sara,Urkiaga,1994-03-12,95203027R,sara.urkiaga@megabyte.net,951608,ES89209541595236157007,1585.44,2023-07-22T11:47:21,Plentzia,expenses,food,-93.67,-18433.95
buyer_5,Sara,Urkiaga,1994-03-12,95203027R,sara.urkiaga@megabyte.net,951608,ES89209541595236157007,1585.44,2023-07-22T16:12:31,Plentzia,expenses,transport,-41.65,-18475.6
buyer_5,Sara,Urkiaga,1994-03-12,95203027R,sara.urkiaga@megabyte.net,951608,ES89209541595236157007,1585.44,2023-07-23T18:52:44,Plentzia,expenses,food,-69.93,-18545.53
buyer_5,Sara,Urkiaga,1994-03-12,95203027R,sara.urkiaga@megabyte.net,951608,ES89209541595236157007,1585.44,2023-07-23T09:40:59,Plentzia,expenses,transport,-42.94,-18588.47
buyer_5,Sara,Urkiaga,1994-03-12,95203027R,sara.urkiaga@megabyte.net,951608,ES89209541595236157007,1585.44,2023-07-25T10:45:46,Plentzia,expenses,gifts,-179.72,-18768.19
buyer_5,Sara,Urkiaga,1994-03-12,95203027R,sara.urkiaga@megabyte.net,951608,ES89209541595236157007,1585.44,2023-07-27T14:53:49,Plentzia,expenses,leisure,-67.72,-18835.91
buyer_5,Sara,Urkiaga,1994-03-12,95203027R,sara.urkiaga@megabyte.net,951608,ES89209541595236157007,1585.44,2023-07-28T13:50:44,Plentzia,expenses,gifts,-112.86,-18948.77
buyer_5,Sara,Urkiaga,1994-03-12,95203027R,sara.urkiaga@megabyte.net,951608,ES89209541595236157007,1585.44,2023-07-29T17:18:11,Plentzia,expenses,healthcare,-157.0,-19105.77
buyer_5,Sara,Urkiaga,1994-03-12,95203027R,sara.urkiaga@megabyte.net,951608,ES89209541595236157007,1585.44,2023-07-29T13:07:09,Plentzia,expenses,gifts,-623.12,-19728.89
buyer_5,Sara,Urkiaga,1994-03-12,95203027R,sara.urkiaga@megabyte.net,951608,ES89209541595236157007,1585.44,2023-08-01T15:48:40,Plentzia,incomes,salary,2239.22,-17489.67
buyer_5,Sara,Urkiaga,1994-03-12,95203027R,sara.urkiaga@megabyte.net,951608,ES89209541595236157007,1585.44,2023-08-01T15:48:40,Plentzia,incomes,salary_partner,2226.24,-15263.43
buyer_5,Sara,Urkiaga,1994-03-12,95203027R,sara.urkiaga@megabyte.net,951608,ES89209541595236157007,1585.44,2023-08-01T15:48:40,Plentzia,incomes,extra_income,224.91,-15038.52
buyer_5,Sara,Urkiaga,1994-03-12,95203027R,sara.urkiaga@megabyte.net,951608,ES89209541595236157007,1585.44,2023-08-01T19:16:24,Plentzia,expenses,transport,-64.95,-15103.47
buyer_5,Sara,Urkiaga,1994-03-12,95203027R,sara.urkiaga@megabyte.net,951608,ES89209541595236157007,1585.44,2023-08-01T10:03:16,Plentzia,expenses,gifts,-562.52,-15665.99
buyer_5,Sara,Urkiaga,1994-03-12,95203027R,sara.urkiaga@megabyte.net,951608,ES89209541595236157007,1585.44,2023-08-03T10:25:08,Plentzia,expenses,cash,-100.0,-15765.99
buyer_5,Sara,Urkiaga,1994-03-12,95203027R,sara.urkiaga@megabyte.net,951608,ES89209541595236157007,1585.44,2023-08-04T08:49:25,Plentzia,expenses,healthcare,-69.42,-15835.41
buyer_5,Sara,Urkiaga,1994-03-12,95203027R,sara.urkiaga@megabyte.net,951608,ES89209541595236157007,1585.44,2023-08-05T08:41:38,Plentzia,expenses,mortgage,-1701.23,-17536.64
buyer_5,Sara,Urkiaga,1994-03-12,95203027R,sara.urkiaga@megabyte.net,951608,ES89209541595236157007,1585.44,2023-08-05T22:01:38,Plentzia,expenses,gas,-81.92,-17618.56
buyer_5,Sara,Urkiaga,1994-03-12,95203027R,sara.urkiaga@megabyte.net,951608,ES89209541595236157007,1585.44,2023-08-05T15:49:02,Plentzia,expenses,internet,-93.77,-17712.33
buyer_5,Sara,Urkiaga,1994-03-12,95203027R,sara.urkiaga@megabyte.net,951608,ES89209541595236157007,1585.44,2023-08-07T15:16:34,Plentzia,expenses,repairs,-254.23,-17966.56
buyer_5,Sara,Urkiaga,1994-03-12,95203027R,sara.urkiaga@megabyte.net,951608,ES89209541595236157007,1585.44,2023-08-08T19:58:10,Plentzia,expenses,food,-88.14,-18054.7
buyer_5,Sara,Urkiaga,1994-03-12,95203027R,sara.urkiaga@megabyte.net,951608,ES89209541595236157007,1585.44,2023-08-10T10:38:15,Plentzia,expenses,food,-68.73,-18123.43
buyer_5,Sara,Urkiaga,1994-03-12,95203027R,sara.urkiaga@megabyte.net,951608,ES89209541595236157007,1585.44,2023-08-11T08:51:09,Plentzia,expenses,education,-42.07,-18165.5
buyer_5,Sara,Urkiaga,1994-03-12,95203027R,sara.urkiaga@megabyte.net,951608,ES89209541595236157007,1585.44,2023-08-12T18:42:55,Plentzia,expenses,food,-90.93,-18256.43
buyer_5,Sara,Urkiaga,1994-03-12,95203027R,sara.urkiaga@megabyte.net,951608,ES89209541595236157007,1585.44,2023-08-15T18:13:19,Plentzia,expenses,transport,-54.59,-18311.02
buyer_5,Sara,Urkiaga,1994-03-12,95203027R,sara.urkiaga@megabyte.net,951608,ES89209541595236157007,1585.44,2023-08-15T19:10:10,Plentzia,expenses,cash,-100.0,-18411.02
buyer_5,Sara,Urkiaga,1994-03-12,95203027R,sara.urkiaga@megabyte.net,951608,ES89209541595236157007,1585.44,2023-08-16T09:58:24,Plentzia,expenses,food,-116.65,-18527.67
buyer_5,Sara,Urkiaga,1994-03-12,95203027R,sara.urkiaga@megabyte.net,951608,ES89209541595236157007,1585.44,2023-08-18T18:31:01,Plentzia,expenses,cash,-100.0,-18627.67
buyer_5,Sara,Urkiaga,1994-03-12,95203027R,sara.urkiaga@megabyte.net,951608,ES89209541595236157007,1585.44,2023-08-20T11:39:25,Plentzia,expenses,food,-84.01,-18711.68
buyer_5,Sara,Urkiaga,1994-03-12,95203027R,sara.urkiaga@megabyte.net,951608,ES89209541595236157007,1585.44,2023-08-21T16:04:30,Plentzia,expenses,food,-119.53,-18831.21
buyer_5,Sara,Urkiaga,1994-03-12,95203027R,sara.urkiaga@megabyte.net,951608,ES89209541595236157007,1585.44,2023-08-23T17:42:22,Plentzia,expenses,transport,-53.05,-18884.26
buyer_5,Sara,Urkiaga,1994-03-12,95203027R,sara.urkiaga@megabyte.net,951608,ES89209541595236157007,1585.44,2023-08-26T05:00:22,Plentzia,expenses,clothing,-90.03,-18974.29
buyer_5,Sara,Urkiaga,1994-03-12,95203027R,sara.urkiaga@megabyte.net,951608,ES89209541595236157007,1585.44,2023-08-29T10:17:08,Plentzia,expenses,clothing,-95.86,-19070.15
buyer_5,Sara,Urkiaga,1994-03-12,95203027R,sara.urkiaga@megabyte.net,951608,ES89209541595236157007,1585.44,2023-08-29T14:59:19,Plentzia,expenses,cash,-100.0,-19170.15
buyer_5,Sara,Urkiaga,1994-03-12,95203027R,sara.urkiaga@megabyte.net,951608,ES89209541595236157007,1585.44,2023-08-30T18:06:09,Plentzia,expenses,food,-103.26,-19273.41
buyer_5,Sara,Urkiaga,1994-03-12,95203027R,sara.urkiaga@megabyte.net,951608,ES89209541595236157007,1585.44,2023-08-30T01:19:52,Plentzia,expenses,leisure,-74.47,-19347.88
buyer_5,Sara,Urkiaga,1994-03-12,95203027R,sara.urkiaga@megabyte.net,951608,ES89209541595236157007,1585.44,2023-08-30T13:37:12,Plentzia,expenses,gifts,-823.51,-20171.39
buyer_5,Sara,Urkiaga,1994-03-12,95203027R,sara.urkiaga@megabyte.net,951608,ES89209541595236157007,1585.44,2023-08-31T14:05:18,Plentzia,expenses,transport,-72.96,-20244.35
buyer_5,Sara,Urkiaga,1994-03-12,95203027R,sara.urkiaga@megabyte.net,951608,ES89209541595236157007,1585.44,2023-08-31T11:29:57,Plentzia,expenses,appliances,-396.92,-20641.27
buyer_5,Sara,Urkiaga,1994-03-12,95203027R,sara.urkiaga@megabyte.net,951608,ES89209541595236157007,1585.44,2023-09-01T05:55:13,Plentzia,incomes,salary,2239.22,-18402.05
buyer_5,Sara,Urkiaga,1994-03-12,95203027R,sara.urkiaga@megabyte.net,951608,ES89209541595236157007,1585.44,2023-09-01T05:55:13,Plentzia,incomes,salary_partner,2226.24,-16175.81
buyer_5,Sara,Urkiaga,1994-03-12,95203027R,sara.urkiaga@megabyte.net,951608,ES89209541595236157007,1585.44,2023-09-01T14:00:40,Plentzia,expenses,cash,-100.0,-16275.81
buyer_5,Sara,Urkiaga,1994-03-12,95203027R,sara.urkiaga@megabyte.net,951608,ES89209541595236157007,1585.44,2023-09-02T16:00:58,Plentzia,expenses,cash,-100.0,-16375.81
buyer_5,Sara,Urkiaga,1994-03-12,95203027R,sara.urkiaga@megabyte.net,951608,ES89209541595236157007,1585.44,2023-09-03T20:14:05,Plentzia,expenses,appliances,-288.64,-16664.45
buyer_5,Sara,Urkiaga,1994-03-12,95203027R,sara.urkiaga@megabyte.net,951608,ES89209541595236157007,1585.44,2023-09-05T10:39:36,Plentzia,expenses,mortgage,-1701.23,-18365.68
buyer_5,Sara,Urkiaga,1994-03-12,95203027R,sara.urkiaga@megabyte.net,951608,ES89209541595236157007,1585.44,2023-09-05T10:54:25,Plentzia,expenses,electricity,-115.32,-18481.0
buyer_5,Sara,Urkiaga,1994-03-12,95203027R,sara.urkiaga@megabyte.net,951608,ES89209541595236157007,1585.44,2023-09-05T11:31:50,Plentzia,expenses,gas,-209.48,-18690.48
buyer_5,Sara,Urkiaga,1994-03-12,95203027R,sara.urkiaga@megabyte.net,951608,ES89209541595236157007,1585.44,2023-09-06T19:31:35,Plentzia,expenses,healthcare,-148.57,-18839.05
buyer_5,Sara,Urkiaga,1994-03-12,95203027R,sara.urkiaga@megabyte.net,951608,ES89209541595236157007,1585.44,2023-09-06T22:43:03,Plentzia,expenses,gifts,-682.14,-19521.19
buyer_5,Sara,Urkiaga,1994-03-12,95203027R,sara.urkiaga@megabyte.net,951608,ES89209541595236157007,1585.44,2023-09-10T09:52:38,Plentzia,expenses,cash,-100.0,-19621.19
buyer_5,Sara,Urkiaga,1994-03-12,95203027R,sara.urkiaga@megabyte.net,951608,ES89209541595236157007,1585.44,2023-09-11T16:36:12,Plentzia,expenses,food,-116.02,-19737.21
buyer_5,Sara,Urkiaga,1994-03-12,95203027R,sara.urkiaga@megabyte.net,951608,ES89209541595236157007,1585.44,2023-09-14T14:53:11,Plentzia,expenses,leisure,-69.76,-19806.97
buyer_5,Sara,Urkiaga,1994-03-12,95203027R,sara.urkiaga@megabyte.net,951608,ES89209541595236157007,1585.44,2023-09-14T12:54:16,Plentzia,expenses,repairs,-153.34,-19960.31
buyer_5,Sara,Urkiaga,1994-03-12,95203027R,sara.urkiaga@megabyte.net,951608,ES89209541595236157007,1585.44,2023-09-15T21:59:02,Plentzia,expenses,leisure,-59.26,-20019.57
buyer_5,Sara,Urkiaga,1994-03-12,95203027R,sara.urkiaga@megabyte.net,951608,ES89209541595236157007,1585.44,2023-09-16T10:07:04,Plentzia,expenses,cash,-100.0,-20119.57
buyer_5,Sara,Urkiaga,1994-03-12,95203027R,sara.urkiaga@megabyte.net,951608,ES89209541595236157007,1585.44,2023-09-17T20:42:21,Plentzia,expenses,transport,-87.82,-20207.39
buyer_5,Sara,Urkiaga,1994-03-12,95203027R,sara.urkiaga@megabyte.net,951608,ES89209541595236157007,1585.44,2023-09-22T16:04:35,Plentzia,expenses,education,-54.17,-20261.56
buyer_5,Sara,Urkiaga,1994-03-12,95203027R,sara.urkiaga@megabyte.net,951608,ES89209541595236157007,1585.44,2023-09-23T08:01:11,Plentzia,expenses,leisure,-66.79,-20328.35
buyer_5,Sara,Urkiaga,1994-03-12,95203027R,sara.urkiaga@megabyte.net,951608,ES89209541595236157007,1585.44,2023-09-24T00:11:50,Plentzia,expenses,leisure,-48.56,-20376.91
buyer_5,Sara,Urkiaga,1994-03-12,95203027R,sara.urkiaga@megabyte.net,951608,ES89209541595236157007,1585.44,2023-09-24T15:05:35,Plentzia,expenses,cash,-100.0,-20476.91
buyer_5,Sara,Urkiaga,1994-03-12,95203027R,sara.urkiaga@megabyte.net,951608,ES89209541595236157007,1585.44,2023-09-24T08:33:28,Plentzia,expenses,repairs,-135.51,-20612.42
buyer_5,Sara,Urkiaga,1994-03-12,95203027R,sara.urkiaga@megabyte.net,951608,ES89209541595236157007,1585.44,2023-09-26T11:22:39,Plentzia,expenses,leisure,-73.08,-20685.5
buyer_5,Sara,Urkiaga,1994-03-12,95203027R,sara.urkiaga@megabyte.net,951608,ES89209541595236157007,1585.44,2023-09-26T20:49:43,Plentzia,expenses,appliances,-160.22,-20845.72
buyer_5,Sara,Urkiaga,1994-03-12,95203027R,sara.urkiaga@megabyte.net,951608,ES89209541595236157007,1585.44,2023-09-27T13:17:22,Plentzia,expenses,clothing,-118.27,-20963.99
buyer_5,Sara,Urkiaga,1994-03-12,95203027R,sara.urkiaga@megabyte.net,951608,ES89209541595236157007,1585.44,2023-09-27T18:50:18,Plentzia,expenses,repairs,-243.69,-21207.68
buyer_5,Sara,Urkiaga,1994-03-12,95203027R,sara.urkiaga@megabyte.net,951608,ES89209541595236157007,1585.44,2023-09-28T13:18:16,Plentzia,expenses,leisure,-18.44,-21226.12
buyer_5,Sara,Urkiaga,1994-03-12,95203027R,sara.urkiaga@megabyte.net,951608,ES89209541595236157007,1585.44,2023-09-29T20:52:21,Plentzia,expenses,food,-100.86,-21326.98
buyer_5,Sara,Urkiaga,1994-03-12,95203027R,sara.urkiaga@megabyte.net,951608,ES89209541595236157007,1585.44,2023-10-01T08:39:13,Plentzia,incomes,salary,2239.22,-19087.76
buyer_5,Sara,Urkiaga,1994-03-12,95203027R,sara.urkiaga@megabyte.net,951608,ES89209541595236157007,1585.44,2023-10-01T08:39:13,Plentzia,incomes,salary_partner,2226.24,-16861.52
buyer_5,Sara,Urkiaga,1994-03-12,95203027R,sara.urkiaga@megabyte.net,951608,ES89209541595236157007,1585.44,2023-10-01T13:06:00,Plentzia,expenses,food,-121.2,-16982.72
buyer_5,Sara,Urkiaga,1994-03-12,95203027R,sara.urkiaga@megabyte.net,951608,ES89209541595236157007,1585.44,2023-10-02T18:59:57,Plentzia,expenses,healthcare,-133.92,-17116.64
buyer_5,Sara,Urkiaga,1994-03-12,95203027R,sara.urkiaga@megabyte.net,951608,ES89209541595236157007,1585.44,2023-10-03T22:10:48,Plentzia,expenses,leisure,-74.99,-17191.63
buyer_5,Sara,Urkiaga,1994-03-12,95203027R,sara.urkiaga@megabyte.net,951608,ES89209541595236157007,1585.44,2023-10-04T12:10:45,Plentzia,expenses,food,-63.54,-17255.17
buyer_5,Sara,Urkiaga,1994-03-12,95203027R,sara.urkiaga@megabyte.net,951608,ES89209541595236157007,1585.44,2023-10-05T17:18:12,Plentzia,expenses,mortgage,-1701.23,-18956.4
buyer_5,Sara,Urkiaga,1994-03-12,95203027R,sara.urkiaga@megabyte.net,951608,ES89209541595236157007,1585.44,2023-10-05T03:38:42,Plentzia,expenses,water,-98.73,-19055.13
buyer_5,Sara,Urkiaga,1994-03-12,95203027R,sara.urkiaga@megabyte.net,951608,ES89209541595236157007,1585.44,2023-10-06T05:38:05,Plentzia,expenses,food,-106.63,-19161.76
buyer_5,Sara,Urkiaga,1994-03-12,95203027R,sara.urkiaga@megabyte.net,951608,ES89209541595236157007,1585.44,2023-10-07T16:56:18,Plentzia,expenses,internet,-93.77,-19255.53
buyer_5,Sara,Urkiaga,1994-03-12,95203027R,sara.urkiaga@megabyte.net,951608,ES89209541595236157007,1585.44,2023-10-07T13:31:56,Plentzia,expenses,food,-99.67,-19355.2
buyer_5,Sara,Urkiaga,1994-03-12,95203027R,sara.urkiaga@megabyte.net,951608,ES89209541595236157007,1585.44,2023-10-08T02:08:37,Plentzia,expenses,water,-72.37,-19427.57
buyer_5,Sara,Urkiaga,1994-03-12,95203027R,sara.urkiaga@megabyte.net,951608,ES89209541595236157007,1585.44,2023-10-08T15:16:27,Plentzia,expenses,gas,-164.83,-19592.4
buyer_5,Sara,Urkiaga,1994-03-12,95203027R,sara.urkiaga@megabyte.net,951608,ES89209541595236157007,1585.44,2023-10-08T11:25:39,Plentzia,expenses,food,-112.46,-19704.86
buyer_5,Sara,Urkiaga,1994-03-12,95203027R,sara.urkiaga@megabyte.net,951608,ES89209541595236157007,1585.44,2023-10-09T12:49:05,Plentzia,expenses,food,-69.55,-19774.41
buyer_5,Sara,Urkiaga,1994-03-12,95203027R,sara.urkiaga@megabyte.net,951608,ES89209541595236157007,1585.44,2023-10-12T17:26:03,Plentzia,expenses,leisure,-52.58,-19826.99
buyer_5,Sara,Urkiaga,1994-03-12,95203027R,sara.urkiaga@megabyte.net,951608,ES89209541595236157007,1585.44,2023-10-13T13:48:55,Plentzia,expenses,leisure,-66.5,-19893.49
buyer_5,Sara,Urkiaga,1994-03-12,95203027R,sara.urkiaga@megabyte.net,951608,ES89209541595236157007,1585.44,2023-10-13T23:19:53,Plentzia,expenses,cash,-100.0,-19993.49
buyer_5,Sara,Urkiaga,1994-03-12,95203027R,sara.urkiaga@megabyte.net,951608,ES89209541595236157007,1585.44,2023-10-14T09:13:59,Plentzia,expenses,transport,-56.26,-20049.75
buyer_5,Sara,Urkiaga,1994-03-12,95203027R,sara.urkiaga@megabyte.net,951608,ES89209541595236157007,1585.44,2023-10-15T17:32:51,Plentzia,expenses,clothing,-122.81,-20172.56
buyer_5,Sara,Urkiaga,1994-03-12,95203027R,sara.urkiaga@megabyte.net,951608,ES89209541595236157007,1585.44,2023-10-15T09:29:43,Plentzia,expenses,cash,-100.0,-20272.56
buyer_5,Sara,Urkiaga,1994-03-12,95203027R,sara.urkiaga@megabyte.net,951608,ES89209541595236157007,1585.44,2023-10-18T15:29:11,Plentzia,expenses,transport,-87.04,-20359.6
buyer_5,Sara,Urkiaga,1994-03-12,95203027R,sara.urkiaga@megabyte.net,951608,ES89209541595236157007,1585.44,2023-10-21T17:25:56,Plentzia,expenses,cash,-100.0,-20459.6
buyer_5,Sara,Urkiaga,1994-03-12,95203027R,sara.urkiaga@megabyte.net,951608,ES89209541595236157007,1585.44,2023-10-22T20:28:16,Plentzia,expenses,cash,-100.0,-20559.6
buyer_5,Sara,Urkiaga,1994-03-12,95203027R,sara.urkiaga@megabyte.net,951608,ES89209541595236157007,1585.44,2023-10-22T15:28:25,Plentzia,expenses,repairs,-248.18,-20807.78
buyer_5,Sara,Urkiaga,1994-03-12,95203027R,sara.urkiaga@megabyte.net,951608,ES89209541595236157007,1585.44,2023-10-24T17:54:34,Plentzia,expenses,food,-89.1,-20896.88
buyer_5,Sara,Urkiaga,1994-03-12,95203027R,sara.urkiaga@megabyte.net,951608,ES89209541595236157007,1585.44,2023-10-24T10:16:05,Plentzia,expenses,healthcare,-70.15,-20967.03
buyer_5,Sara,Urkiaga,1994-03-12,95203027R,sara.urkiaga@megabyte.net,951608,ES89209541595236157007,1585.44,2023-10-25T09:10:32,Plentzia,expenses,food,-73.87,-21040.9
buyer_5,Sara,Urkiaga,1994-03-12,95203027R,sara.urkiaga@megabyte.net,951608,ES89209541595236157007,1585.44,2023-10-25T10:13:13,Plentzia,expenses,transport,-81.72,-21122.62
buyer_5,Sara,Urkiaga,1994-03-12,95203027R,sara.urkiaga@megabyte.net,951608,ES89209541595236157007,1585.44,2023-10-29T10:49:16,Plentzia,expenses,food,-71.95,-21194.57
buyer_5,Sara,Urkiaga,1994-03-12,95203027R,sara.urkiaga@megabyte.net,951608,ES89209541595236157007,1585.44,2023-10-31T17:04:03,Plentzia,expenses,cash,-100.0,-21294.57
buyer_5,Sara,Urkiaga,1994-03-12,95203027R,sara.urkiaga@megabyte.net,951608,ES89209541595236157007,1585.44,2023-10-31T16:08:38,Plentzia,expenses,repairs,-66.71,-21361.28
buyer_5,Sara,Urkiaga,1994-03-12,95203027R,sara.urkiaga@megabyte.net,951608,ES89209541595236157007,1585.44,2023-11-01T14:05:13,Plentzia,incomes,salary,2239.22,-19122.06
buyer_5,Sara,Urkiaga,1994-03-12,95203027R,sara.urkiaga@megabyte.net,951608,ES89209541595236157007,1585.44,2023-11-01T14:05:13,Plentzia,incomes,salary_partner,2226.24,-16895.82
buyer_5,Sara,Urkiaga,1994-03-12,95203027R,sara.urkiaga@megabyte.net,951608,ES89209541595236157007,1585.44,2023-11-01T14:05:13,Plentzia,incomes,extra_income,224.91,-16670.91
buyer_5,Sara,Urkiaga,1994-03-12,95203027R,sara.urkiaga@megabyte.net,951608,ES89209541595236157007,1585.44,2023-11-01T06:45:20,Plentzia,expenses,cash,-100.0,-16770.91
buyer_5,Sara,Urkiaga,1994-03-12,95203027R,sara.urkiaga@megabyte.net,951608,ES89209541595236157007,1585.44,2023-11-02T22:57:06,Plentzia,expenses,transport,-56.49,-16827.4
buyer_5,Sara,Urkiaga,1994-03-12,95203027R,sara.urkiaga@megabyte.net,951608,ES89209541595236157007,1585.44,2023-11-02T19:07:28,Plentzia,expenses,gifts,-101.83,-16929.23
buyer_5,Sara,Urkiaga,1994-03-12,95203027R,sara.urkiaga@megabyte.net,951608,ES89209541595236157007,1585.44,2023-11-03T09:44:42,Plentzia,expenses,education,-62.92,-16992.15
buyer_5,Sara,Urkiaga,1994-03-12,95203027R,sara.urkiaga@megabyte.net,951608,ES89209541595236157007,1585.44,2023-11-03T16:53:41,Plentzia,expenses,repairs,-79.83,-17071.98
buyer_5,Sara,Urkiaga,1994-03-12,95203027R,sara.urkiaga@megabyte.net,951608,ES89209541595236157007,1585.44,2023-11-05T11:53:41,Plentzia,expenses,mortgage,-1701.23,-18773.21
buyer_5,Sara,Urkiaga,1994-03-12,95203027R,sara.urkiaga@megabyte.net,951608,ES89209541595236157007,1585.44,2023-11-05T16:38:29,Plentzia,expenses,education,-66.73,-18839.94
buyer_5,Sara,Urkiaga,1994-03-12,95203027R,sara.urkiaga@megabyte.net,951608,ES89209541595236157007,1585.44,2023-11-06T18:59:37,Plentzia,expenses,internet,-93.77,-18933.71
buyer_5,Sara,Urkiaga,1994-03-12,95203027R,sara.urkiaga@megabyte.net,951608,ES89209541595236157007,1585.44,2023-11-06T04:54:10,Plentzia,expenses,leisure,-60.23,-18993.94
buyer_5,Sara,Urkiaga,1994-03-12,95203027R,sara.urkiaga@megabyte.net,951608,ES89209541595236157007,1585.44,2023-11-07T16:41:48,Plentzia,expenses,repairs,-166.62,-19160.56
buyer_5,Sara,Urkiaga,1994-03-12,95203027R,sara.urkiaga@megabyte.net,951608,ES89209541595236157007,1585.44,2023-11-08T17:55:56,Plentzia,expenses,gas,-225.0,-19385.56
buyer_5,Sara,Urkiaga,1994-03-12,95203027R,sara.urkiaga@megabyte.net,951608,ES89209541595236157007,1585.44,2023-11-08T08:53:19,Plentzia,expenses,phone,-90.08,-19475.64
buyer_5,Sara,Urkiaga,1994-03-12,95203027R,sara.urkiaga@megabyte.net,951608,ES89209541595236157007,1585.44,2023-11-09T05:24:47,Plentzia,expenses,food,-118.43,-19594.07
buyer_5,Sara,Urkiaga,1994-03-12,95203027R,sara.urkiaga@megabyte.net,951608,ES89209541595236157007,1585.44,2023-11-09T17:36:35,Plentzia,expenses,cash,-100.0,-19694.07
buyer_5,Sara,Urkiaga,1994-03-12,95203027R,sara.urkiaga@megabyte.net,951608,ES89209541595236157007,1585.44,2023-11-10T16:50:44,Plentzia,expenses,food,-100.09,-19794.16
buyer_5,Sara,Urkiaga,1994-03-12,95203027R,sara.urkiaga@megabyte.net,951608,ES89209541595236157007,1585.44,2023-11-10T12:34:36,Plentzia,expenses,clothing,-84.01,-19878.17
buyer_5,Sara,Urkiaga,1994-03-12,95203027R,sara.urkiaga@megabyte.net,951608,ES89209541595236157007,1585.44,2023-11-12T15:35:27,Plentzia,expenses,leisure,-36.59,-19914.76
buyer_5,Sara,Urkiaga,1994-03-12,95203027R,sara.urkiaga@megabyte.net,951608,ES89209541595236157007,1585.44,2023-11-12T20:24:08,Plentzia,expenses,education,-57.19,-19971.95
buyer_5,Sara,Urkiaga,1994-03-12,95203027R,sara.urkiaga@megabyte.net,951608,ES89209541595236157007,1585.44,2023-11-12T18:10:26,Plentzia,expenses,appliances,-155.78,-20127.73
buyer_5,Sara,Urkiaga,1994-03-12,95203027R,sara.urkiaga@megabyte.net,951608,ES89209541595236157007,1585.44,2023-11-12T10:55:19,Plentzia,expenses,repairs,-197.23,-20324.96
buyer_5,Sara,Urkiaga,1994-03-12,95203027R,sara.urkiaga@megabyte.net,951608,ES89209541595236157007,1585.44,2023-11-16T15:14:42,Plentzia,expenses,transport,-48.24,-20373.2
buyer_5,Sara,Urkiaga,1994-03-12,95203027R,sara.urkiaga@megabyte.net,951608,ES89209541595236157007,1585.44,2023-11-17T19:55:54,Plentzia,expenses,food,-89.33,-20462.53
buyer_5,Sara,Urkiaga,1994-03-12,95203027R,sara.urkiaga@megabyte.net,951608,ES89209541595236157007,1585.44,2023-11-18T08:03:31,Plentzia,expenses,clothing,-92.58,-20555.11
buyer_5,Sara,Urkiaga,1994-03-12,95203027R,sara.urkiaga@megabyte.net,951608,ES89209541595236157007,1585.44,2023-11-19T11:19:31,Plentzia,expenses,education,-48.54,-20603.65
buyer_5,Sara,Urkiaga,1994-03-12,95203027R,sara.urkiaga@megabyte.net,951608,ES89209541595236157007,1585.44,2023-11-19T09:44:41,Plentzia,expenses,repairs,-118.22,-20721.87
buyer_5,Sara,Urkiaga,1994-03-12,95203027R,sara.urkiaga@megabyte.net,951608,ES89209541595236157007,1585.44,2023-11-20T10:11:37,Plentzia,expenses,transport,-46.03,-20767.9
buyer_5,Sara,Urkiaga,1994-03-12,95203027R,sara.urkiaga@megabyte.net,951608,ES89209541595236157007,1585.44,2023-11-20T19:22:33,Plentzia,expenses,leisure,-56.47,-20824.37
buyer_5,Sara,Urkiaga,1994-03-12,95203027R,sara.urkiaga@megabyte.net,951608,ES89209541595236157007,1585.44,2023-11-20T16:29:01,Plentzia,expenses,cash,-100.0,-20924.37
buyer_5,Sara,Urkiaga,1994-03-12,95203027R,sara.urkiaga@megabyte.net,951608,ES89209541595236157007,1585.44,2023-11-21T18:08:37,Plentzia,expenses,cash,-100.0,-21024.37
buyer_5,Sara,Urkiaga,1994-03-12,95203027R,sara.urkiaga@megabyte.net,951608,ES89209541595236157007,1585.44,2023-11-23T12:18:26,Plentzia,expenses,cash,-100.0,-21124.37
buyer_5,Sara,Urkiaga,1994-03-12,95203027R,sara.urkiaga@megabyte.net,951608,ES89209541595236157007,1585.44,2023-11-23T18:28:32,Plentzia,expenses,repairs,-203.9,-21328.27
buyer_5,Sara,Urkiaga,1994-03-12,95203027R,sara.urkiaga@megabyte.net,951608,ES89209541595236157007,1585.44,2023-11-24T17:08:31,Plentzia,expenses,leisure,-26.86,-21355.13
buyer_5,Sara,Urkiaga,1994-03-12,95203027R,sara.urkiaga@megabyte.net,951608,ES89209541595236157007,1585.44,2023-11-25T05:58:18,Plentzia,expenses,transport,-82.68,-21437.81
buyer_5,Sara,Urkiaga,1994-03-12,95203027R,sara.urkiaga@megabyte.net,951608,ES89209541595236157007,1585.44,2023-11-25T16:50:17,Plentzia,expenses,clothing,-87.99,-21525.8
buyer_5,Sara,Urkiaga,1994-03-12,95203027R,sara.urkiaga@megabyte.net,951608,ES89209541595236157007,1585.44,2023-11-26T08:54:44,Plentzia,expenses,cash,-100.0,-21625.8
buyer_5,Sara,Urkiaga,1994-03-12,95203027R,sara.urkiaga@megabyte.net,951608,ES89209541595236157007,1585.44,2023-11-27T10:39:02,Plentzia,expenses,food,-86.99,-21712.79
buyer_5,Sara,Urkiaga,1994-03-12,95203027R,sara.urkiaga@megabyte.net,951608,ES89209541595236157007,1585.44,2023-11-27T15:05:35,Plentzia,expenses,leisure,-23.19,-21735.98
buyer_5,Sara,Urkiaga,1994-03-12,95203027R,sara.urkiaga@megabyte.net,951608,ES89209541595236157007,1585.44,2023-11-27T16:45:42,Plentzia,expenses,repairs,-73.75,-21809.73
buyer_5,Sara,Urkiaga,1994-03-12,95203027R,sara.urkiaga@megabyte.net,951608,ES89209541595236157007,1585.44,2023-11-29T15:36:13,Plentzia,expenses,transport,-51.63,-21861.36
buyer_5,Sara,Urkiaga,1994-03-12,95203027R,sara.urkiaga@megabyte.net,951608,ES89209541595236157007,1585.44,2023-11-29T17:47:20,Plentzia,expenses,cash,-100.0,-21961.36
buyer_5,Sara,Urkiaga,1994-03-12,95203027R,sara.urkiaga@megabyte.net,951608,ES89209541595236157007,1585.44,2023-11-30T20:25:55,Plentzia,expenses,leisure,-25.33,-21986.69
buyer_5,Sara,Urkiaga,1994-03-12,95203027R,sara.urkiaga@megabyte.net,951608,ES89209541595236157007,1585.44,2023-12-01T20:46:56,Plentzia,incomes,salary,2239.22,-19747.47
buyer_5,Sara,Urkiaga,1994-03-12,95203027R,sara.urkiaga@megabyte.net,951608,ES89209541595236157007,1585.44,2023-12-01T20:46:56,Plentzia,incomes,salary_partner,2226.24,-17521.23
buyer_5,Sara,Urkiaga,1994-03-12,95203027R,sara.urkiaga@megabyte.net,951608,ES89209541595236157007,1585.44,2023-12-01T20:46:56,Plentzia,incomes,salary_bonus,1752.06,-15769.17
buyer_5,Sara,Urkiaga,1994-03-12,95203027R,sara.urkiaga@megabyte.net,951608,ES89209541595236157007,1585.44,2023-12-01T20:46:56,Plentzia,incomes,salary_partner_bonus,1724.85,-14044.32
buyer_5,Sara,Urkiaga,1994-03-12,95203027R,sara.urkiaga@megabyte.net,951608,ES89209541595236157007,1585.44,2023-12-02T12:47:18,Plentzia,expenses,transport,-60.03,-14104.35
buyer_5,Sara,Urkiaga,1994-03-12,95203027R,sara.urkiaga@megabyte.net,951608,ES89209541595236157007,1585.44,2023-12-03T23:09:11,Plentzia,expenses,healthcare,-139.29,-14243.64
buyer_5,Sara,Urkiaga,1994-03-12,95203027R,sara.urkiaga@megabyte.net,951608,ES89209541595236157007,1585.44,2023-12-05T20:51:03,Plentzia,expenses,mortgage,-1701.23,-15944.87
buyer_5,Sara,Urkiaga,1994-03-12,95203027R,sara.urkiaga@megabyte.net,951608,ES89209541595236157007,1585.44,2023-12-05T14:17:39,Plentzia,expenses,water,-61.22,-16006.09
buyer_5,Sara,Urkiaga,1994-03-12,95203027R,sara.urkiaga@megabyte.net,951608,ES89209541595236157007,1585.44,2023-12-05T11:15:03,Plentzia,expenses,phone,-87.86,-16093.95
buyer_5,Sara,Urkiaga,1994-03-12,95203027R,sara.urkiaga@megabyte.net,951608,ES89209541595236157007,1585.44,2023-12-05T23:03:35,Plentzia,expenses,transport,-47.75,-16141.7
buyer_5,Sara,Urkiaga,1994-03-12,95203027R,sara.urkiaga@megabyte.net,951608,ES89209541595236157007,1585.44,2023-12-06T16:15:26,Plentzia,expenses,water,-63.67,-16205.37
buyer_5,Sara,Urkiaga,1994-03-12,95203027R,sara.urkiaga@megabyte.net,951608,ES89209541595236157007,1585.44,2023-12-06T10:21:23,Plentzia,expenses,electricity,-100.29,-16305.66
buyer_5,Sara,Urkiaga,1994-03-12,95203027R,sara.urkiaga@megabyte.net,951608,ES89209541595236157007,1585.44,2023-12-06T06:35:27,Plentzia,expenses,internet,-93.77,-16399.43
buyer_5,Sara,Urkiaga,1994-03-12,95203027R,sara.urkiaga@megabyte.net,951608,ES89209541595236157007,1585.44,2023-12-07T15:43:04,Plentzia,expenses,electricity,-183.24,-16582.67
buyer_5,Sara,Urkiaga,1994-03-12,95203027R,sara.urkiaga@megabyte.net,951608,ES89209541595236157007,1585.44,2023-12-07T19:32:10,Plentzia,expenses,gas,-228.56,-16811.23
buyer_5,Sara,Urkiaga,1994-03-12,95203027R,sara.urkiaga@megabyte.net,951608,ES89209541595236157007,1585.44,2023-12-07T10:07:32,Plentzia,expenses,clothing,-63.37,-16874.6
buyer_5,Sara,Urkiaga,1994-03-12,95203027R,sara.urkiaga@megabyte.net,951608,ES89209541595236157007,1585.44,2023-12-08T15:33:43,Plentzia,expenses,electricity,-198.34,-17072.94
buyer_5,Sara,Urkiaga,1994-03-12,95203027R,sara.urkiaga@megabyte.net,951608,ES89209541595236157007,1585.44,2023-12-08T08:31:07,Plentzia,expenses,gas,-99.31,-17172.25
buyer_5,Sara,Urkiaga,1994-03-12,95203027R,sara.urkiaga@megabyte.net,951608,ES89209541595236157007,1585.44,2023-12-08T23:22:01,Plentzia,expenses,transport,-45.25,-17217.5
buyer_5,Sara,Urkiaga,1994-03-12,95203027R,sara.urkiaga@megabyte.net,951608,ES89209541595236157007,1585.44,2023-12-12T09:55:39,Plentzia,expenses,cash,-100.0,-17317.5
buyer_5,Sara,Urkiaga,1994-03-12,95203027R,sara.urkiaga@megabyte.net,951608,ES89209541595236157007,1585.44,2023-12-12T09:47:06,Plentzia,expenses,repairs,-308.08,-17625.58
buyer_5,Sara,Urkiaga,1994-03-12,95203027R,sara.urkiaga@megabyte.net,951608,ES89209541595236157007,1585.44,2023-12-12T09:26:33,Plentzia,expenses,gifts,-573.41,-18198.99
buyer_5,Sara,Urkiaga,1994-03-12,95203027R,sara.urkiaga@megabyte.net,951608,ES89209541595236157007,1585.44,2023-12-13T04:11:43,Plentzia,expenses,food,-70.93,-18269.92
buyer_5,Sara,Urkiaga,1994-03-12,95203027R,sara.urkiaga@megabyte.net,951608,ES89209541595236157007,1585.44,2023-12-14T11:41:49,Plentzia,expenses,healthcare,-146.15,-18416.07
buyer_5,Sara,Urkiaga,1994-03-12,95203027R,sara.urkiaga@megabyte.net,951608,ES89209541595236157007,1585.44,2023-12-14T01:21:10,Plentzia,expenses,repairs,-291.75,-18707.82
buyer_5,Sara,Urkiaga,1994-03-12,95203027R,sara.urkiaga@megabyte.net,951608,ES89209541595236157007,1585.44,2023-12-15T21:59:31,Plentzia,expenses,cash,-100.0,-18807.82
buyer_5,Sara,Urkiaga,1994-03-12,95203027R,sara.urkiaga@megabyte.net,951608,ES89209541595236157007,1585.44,2023-12-17T12:03:35,Plentzia,expenses,clothing,-137.43,-18945.25
buyer_5,Sara,Urkiaga,1994-03-12,95203027R,sara.urkiaga@megabyte.net,951608,ES89209541595236157007,1585.44,2023-12-18T19:06:37,Plentzia,expenses,cash,-100.0,-19045.25
buyer_5,Sara,Urkiaga,1994-03-12,95203027R,sara.urkiaga@megabyte.net,951608,ES89209541595236157007,1585.44,2023-12-18T08:08:44,Plentzia,expenses,repairs,-250.97,-19296.22
buyer_5,Sara,Urkiaga,1994-03-12,95203027R,sara.urkiaga@megabyte.net,951608,ES89209541595236157007,1585.44,2023-12-19T20:18:34,Plentzia,expenses,education,-78.44,-19374.66
buyer_5,Sara,Urkiaga,1994-03-12,95203027R,sara.urkiaga@megabyte.net,951608,ES89209541595236157007,1585.44,2023-12-26T01:11:19,Plentzia,expenses,transport,-47.73,-19422.39
buyer_5,Sara,Urkiaga,1994-03-12,95203027R,sara.urkiaga@megabyte.net,951608,ES89209541595236157007,1585.44,2023-12-27T09:40:43,Plentzia,expenses,food,-104.77,-19527.16
buyer_5,Sara,Urkiaga,1994-03-12,95203027R,sara.urkiaga@megabyte.net,951608,ES89209541595236157007,1585.44,2023-12-28T14:33:50,Plentzia,expenses,repairs,-320.38,-19847.54
buyer_5,Sara,Urkiaga,1994-03-12,95203027R,sara.urkiaga@megabyte.net,951608,ES89209541595236157007,1585.44,2023-12-29T23:31:26,Plentzia,expenses,clothing,-91.25,-19938.79
buyer_5,Sara,Urkiaga,1994-03-12,95203027R,sara.urkiaga@megabyte.net,951608,ES89209541595236157007,1585.44,2023-12-30T17:11:32,Plentzia,expenses,transport,-60.4,-19999.19
buyer_5,Sara,Urkiaga,1994-03-12,95203027R,sara.urkiaga@megabyte.net,951608,ES89209541595236157007,1585.44,2023-12-30T09:58:02,Plentzia,expenses,cash,-100.0,-20099.19
buyer_5,Sara,Urkiaga,1994-03-12,95203027R,sara.urkiaga@megabyte.net,951608,ES89209541595236157007,1585.44,2023-12-31T13:45:52,Plentzia,expenses,transport,-84.12,-20183.31
buyer_5,Sara,Urkiaga,1994-03-12,95203027R,sara.urkiaga@megabyte.net,951608,ES89209541595236157007,1585.44,2024-01-01T20:16:13,Plentzia,incomes,salary,2291.03,-17892.28
buyer_5,Sara,Urkiaga,1994-03-12,95203027R,sara.urkiaga@megabyte.net,951608,ES89209541595236157007,1585.44,2024-01-01T20:16:13,Plentzia,incomes,salary_partner,2277.75,-15614.53
buyer_5,Sara,Urkiaga,1994-03-12,95203027R,sara.urkiaga@megabyte.net,951608,ES89209541595236157007,1585.44,2024-01-01T19:56:55,Plentzia,expenses,leisure,-18.75,-15633.28
buyer_5,Sara,Urkiaga,1994-03-12,95203027R,sara.urkiaga@megabyte.net,951608,ES89209541595236157007,1585.44,2024-01-03T09:14:09,Plentzia,expenses,leisure,-40.13,-15673.41
buyer_5,Sara,Urkiaga,1994-03-12,95203027R,sara.urkiaga@megabyte.net,951608,ES89209541595236157007,1585.44,2024-01-03T14:53:12,Plentzia,expenses,cash,-100.0,-15773.41
buyer_5,Sara,Urkiaga,1994-03-12,95203027R,sara.urkiaga@megabyte.net,951608,ES89209541595236157007,1585.44,2024-01-03T09:44:24,Plentzia,expenses,appliances,-80.92,-15854.33
buyer_5,Sara,Urkiaga,1994-03-12,95203027R,sara.urkiaga@megabyte.net,951608,ES89209541595236157007,1585.44,2024-01-04T12:47:51,Plentzia,expenses,food,-111.99,-15966.32
buyer_5,Sara,Urkiaga,1994-03-12,95203027R,sara.urkiaga@megabyte.net,951608,ES89209541595236157007,1585.44,2024-01-05T17:12:08,Plentzia,expenses,mortgage,-1722.86,-17689.18
buyer_5,Sara,Urkiaga,1994-03-12,95203027R,sara.urkiaga@megabyte.net,951608,ES89209541595236157007,1585.44,2024-01-05T18:59:06,Plentzia,expenses,gas,-80.24,-17769.42
buyer_5,Sara,Urkiaga,1994-03-12,95203027R,sara.urkiaga@megabyte.net,951608,ES89209541595236157007,1585.44,2024-01-05T16:50:13,Plentzia,expenses,repairs,-137.6,-17907.02
buyer_5,Sara,Urkiaga,1994-03-12,95203027R,sara.urkiaga@megabyte.net,951608,ES89209541595236157007,1585.44,2024-01-06T11:20:23,Plentzia,expenses,internet,-95.94,-18002.96
buyer_5,Sara,Urkiaga,1994-03-12,95203027R,sara.urkiaga@megabyte.net,951608,ES89209541595236157007,1585.44,2024-01-06T18:24:12,Plentzia,expenses,appliances,-195.88,-18198.84
buyer_5,Sara,Urkiaga,1994-03-12,95203027R,sara.urkiaga@megabyte.net,951608,ES89209541595236157007,1585.44,2024-01-07T11:11:12,Plentzia,expenses,gas,-173.21,-18372.05
buyer_5,Sara,Urkiaga,1994-03-12,95203027R,sara.urkiaga@megabyte.net,951608,ES89209541595236157007,1585.44,2024-01-12T16:30:52,Plentzia,expenses,leisure,-54.96,-18427.01
buyer_5,Sara,Urkiaga,1994-03-12,95203027R,sara.urkiaga@megabyte.net,951608,ES89209541595236157007,1585.44,2024-01-13T19:16:13,Plentzia,expenses,cash,-100.0,-18527.01
buyer_5,Sara,Urkiaga,1994-03-12,95203027R,sara.urkiaga@megabyte.net,951608,ES89209541595236157007,1585.44,2024-01-14T16:03:41,Plentzia,expenses,cash,-100.0,-18627.01
buyer_5,Sara,Urkiaga,1994-03-12,95203027R,sara.urkiaga@megabyte.net,951608,ES89209541595236157007,1585.44,2024-01-16T17:17:27,Plentzia,expenses,food,-116.12,-18743.13
buyer_5,Sara,Urkiaga,1994-03-12,95203027R,sara.urkiaga@megabyte.net,951608,ES89209541595236157007,1585.44,2024-01-17T22:56:43,Plentzia,expenses,transport,-85.75,-18828.88
buyer_5,Sara,Urkiaga,1994-03-12,95203027R,sara.urkiaga@megabyte.net,951608,ES89209541595236157007,1585.44,2024-01-19T09:07:24,Plentzia,expenses,cash,-100.0,-18928.88
buyer_5,Sara,Urkiaga,1994-03-12,95203027R,sara.urkiaga@megabyte.net,951608,ES89209541595236157007,1585.44,2024-01-21T11:38:50,Plentzia,expenses,healthcare,-111.91,-19040.79
buyer_5,Sara,Urkiaga,1994-03-12,95203027R,sara.urkiaga@megabyte.net,951608,ES89209541595236157007,1585.44,2024-01-24T17:09:59,Plentzia,expenses,cash,-100.0,-19140.79
buyer_5,Sara,Urkiaga,1994-03-12,95203027R,sara.urkiaga@megabyte.net,951608,ES89209541595236157007,1585.44,2024-01-26T09:53:17,Plentzia,expenses,clothing,-152.68,-19293.47
buyer_5,Sara,Urkiaga,1994-03-12,95203027R,sara.urkiaga@megabyte.net,951608,ES89209541595236157007,1585.44,2024-01-27T17:38:26,Plentzia,expenses,gifts,-214.8,-19508.27
buyer_5,Sara,Urkiaga,1994-03-12,95203027R,sara.urkiaga@megabyte.net,951608,ES89209541595236157007,1585.44,2024-02-01T12:46:14,Plentzia,incomes,salary,2291.03,-17217.24
buyer_5,Sara,Urkiaga,1994-03-12,95203027R,sara.urkiaga@megabyte.net,951608,ES89209541595236157007,1585.44,2024-02-01T12:46:14,Plentzia,incomes,salary_partner,2277.75,-14939.49
buyer_5,Sara,Urkiaga,1994-03-12,95203027R,sara.urkiaga@megabyte.net,951608,ES89209541595236157007,1585.44,2024-02-01T12:46:14,Plentzia,incomes,extra_income,224.91,-14714.58
buyer_5,Sara,Urkiaga,1994-03-12,95203027R,sara.urkiaga@megabyte.net,951608,ES89209541595236157007,1585.44,2024-02-02T08:24:00,Plentzia,expenses,food,-84.25,-14798.83
buyer_5,Sara,Urkiaga,1994-03-12,95203027R,sara.urkiaga@megabyte.net,951608,ES89209541595236157007,1585.44,2024-02-04T19:06:16,Plentzia,expenses,food,-124.35,-14923.18
buyer_5,Sara,Urkiaga,1994-03-12,95203027R,sara.urkiaga@megabyte.net,951608,ES89209541595236157007,1585.44,2024-02-04T12:08:24,Plentzia,expenses,leisure,-23.65,-14946.83
buyer_5,Sara,Urkiaga,1994-03-12,95203027R,sara.urkiaga@megabyte.net,951608,ES89209541595236157007,1585.44,2024-02-05T12:24:16,Plentzia,expenses,mortgage,-1722.86,-16669.69
buyer_5,Sara,Urkiaga,1994-03-12,95203027R,sara.urkiaga@megabyte.net,951608,ES89209541595236157007,1585.44,2024-02-05T13:51:22,Plentzia,expenses,leisure,-28.96,-16698.65
buyer_5,Sara,Urkiaga,1994-03-12,95203027R,sara.urkiaga@megabyte.net,951608,ES89209541595236157007,1585.44,2024-02-06T15:13:50,Plentzia,expenses,water,-63.14,-16761.79
buyer_5,Sara,Urkiaga,1994-03-12,95203027R,sara.urkiaga@megabyte.net,951608,ES89209541595236157007,1585.44,2024-02-06T01:07:52,Plentzia,expenses,gifts,-202.61,-16964.4
buyer_5,Sara,Urkiaga,1994-03-12,95203027R,sara.urkiaga@megabyte.net,951608,ES89209541595236157007,1585.44,2024-02-07T08:38:11,Plentzia,expenses,electricity,-120.2,-17084.6
buyer_5,Sara,Urkiaga,1994-03-12,95203027R,sara.urkiaga@megabyte.net,951608,ES89209541595236157007,1585.44,2024-02-08T13:16:02,Plentzia,expenses,repairs,-39.15,-17123.75
buyer_5,Sara,Urkiaga,1994-03-12,95203027R,sara.urkiaga@megabyte.net,951608,ES89209541595236157007,1585.44,2024-02-09T23:41:35,Plentzia,expenses,food,-114.18,-17237.93
buyer_5,Sara,Urkiaga,1994-03-12,95203027R,sara.urkiaga@megabyte.net,951608,ES89209541595236157007,1585.44,2024-02-09T08:24:14,Plentzia,expenses,leisure,-31.49,-17269.42
buyer_5,Sara,Urkiaga,1994-03-12,95203027R,sara.urkiaga@megabyte.net,951608,ES89209541595236157007,1585.44,2024-02-10T10:28:13,Plentzia,expenses,food,-110.63,-17380.05
buyer_5,Sara,Urkiaga,1994-03-12,95203027R,sara.urkiaga@megabyte.net,951608,ES89209541595236157007,1585.44,2024-02-11T12:12:04,Plentzia,expenses,education,-59.9,-17439.95
buyer_5,Sara,Urkiaga,1994-03-12,95203027R,sara.urkiaga@megabyte.net,951608,ES89209541595236157007,1585.44,2024-02-12T20:42:24,Plentzia,expenses,appliances,-168.26,-17608.21
buyer_5,Sara,Urkiaga,1994-03-12,95203027R,sara.urkiaga@megabyte.net,951608,ES89209541595236157007,1585.44,2024-02-14T21:14:18,Plentzia,expenses,clothing,-140.21,-17748.42
buyer_5,Sara,Urkiaga,1994-03-12,95203027R,sara.urkiaga@megabyte.net,951608,ES89209541595236157007,1585.44,2024-02-14T16:27:26,Plentzia,expenses,cash,-100.0,-17848.42
buyer_5,Sara,Urkiaga,1994-03-12,95203027R,sara.urkiaga@megabyte.net,951608,ES89209541595236157007,1585.44,2024-02-14T18:42:33,Plentzia,expenses,repairs,-130.81,-17979.23
buyer_5,Sara,Urkiaga,1994-03-12,95203027R,sara.urkiaga@megabyte.net,951608,ES89209541595236157007,1585.44,2024-02-15T14:53:55,Plentzia,expenses,transport,-61.26,-18040.49
buyer_5,Sara,Urkiaga,1994-03-12,95203027R,sara.urkiaga@megabyte.net,951608,ES89209541595236157007,1585.44,2024-02-16T11:17:01,Plentzia,expenses,food,-73.53,-18114.02
buyer_5,Sara,Urkiaga,1994-03-12,95203027R,sara.urkiaga@megabyte.net,951608,ES89209541595236157007,1585.44,2024-02-16T13:55:24,Plentzia,expenses,clothing,-45.65,-18159.67
buyer_5,Sara,Urkiaga,1994-03-12,95203027R,sara.urkiaga@megabyte.net,951608,ES89209541595236157007,1585.44,2024-02-17T12:27:33,Plentzia,expenses,food,-114.16,-18273.83
buyer_5,Sara,Urkiaga,1994-03-12,95203027R,sara.urkiaga@megabyte.net,951608,ES89209541595236157007,1585.44,2024-02-17T09:13:45,Plentzia,expenses,clothing,-89.81,-18363.64
buyer_5,Sara,Urkiaga,1994-03-12,95203027R,sara.urkiaga@megabyte.net,951608,ES89209541595236157007,1585.44,2024-02-18T21:17:56,Plentzia,expenses,cash,-100.0,-18463.64
buyer_5,Sara,Urkiaga,1994-03-12,95203027R,sara.urkiaga@megabyte.net,951608,ES89209541595236157007,1585.44,2024-02-20T05:03:06,Plentzia,expenses,transport,-81.26,-18544.9
buyer_5,Sara,Urkiaga,1994-03-12,95203027R,sara.urkiaga@megabyte.net,951608,ES89209541595236157007,1585.44,2024-02-22T06:59:02,Plentzia,expenses,leisure,-21.59,-18566.49
buyer_5,Sara,Urkiaga,1994-03-12,95203027R,sara.urkiaga@megabyte.net,951608,ES89209541595236157007,1585.44,2024-02-22T15:50:32,Plentzia,expenses,cash,-100.0,-18666.49
buyer_5,Sara,Urkiaga,1994-03-12,95203027R,sara.urkiaga@megabyte.net,951608,ES89209541595236157007,1585.44,2024-02-23T22:31:01,Plentzia,expenses,cash,-100.0,-18766.49
buyer_5,Sara,Urkiaga,1994-03-12,95203027R,sara.urkiaga@megabyte.net,951608,ES89209541595236157007,1585.44,2024-02-25T20:10:10,Plentzia,expenses,transport,-83.71,-18850.2
buyer_5,Sara,Urkiaga,1994-03-12,95203027R,sara.urkiaga@megabyte.net,951608,ES89209541595236157007,1585.44,2024-03-01T17:31:59,Plentzia,incomes,salary,2291.03,-16559.17
buyer_5,Sara,Urkiaga,1994-03-12,95203027R,sara.urkiaga@megabyte.net,951608,ES89209541595236157007,1585.44,2024-03-01T17:31:59,Plentzia,incomes,salary_partner,2277.75,-14281.42
buyer_5,Sara,Urkiaga,1994-03-12,95203027R,sara.urkiaga@megabyte.net,951608,ES89209541595236157007,1585.44,2024-03-01T02:08:18,Plentzia,expenses,leisure,-51.62,-14333.04
buyer_5,Sara,Urkiaga,1994-03-12,95203027R,sara.urkiaga@megabyte.net,951608,ES89209541595236157007,1585.44,2024-03-04T02:54:54,Plentzia,expenses,education,-48.77,-14381.81
buyer_5,Sara,Urkiaga,1994-03-12,95203027R,sara.urkiaga@megabyte.net,951608,ES89209541595236157007,1585.44,2024-03-05T14:20:46,Plentzia,expenses,mortgage,-1722.86,-16104.67
buyer_5,Sara,Urkiaga,1994-03-12,95203027R,sara.urkiaga@megabyte.net,951608,ES89209541595236157007,1585.44,2024-03-05T19:39:37,Plentzia,expenses,electricity,-201.82,-16306.49
buyer_5,Sara,Urkiaga,1994-03-12,95203027R,sara.urkiaga@megabyte.net,951608,ES89209541595236157007,1585.44,2024-03-05T18:03:20,Plentzia,expenses,phone,-80.58,-16387.07
buyer_5,Sara,Urkiaga,1994-03-12,95203027R,sara.urkiaga@megabyte.net,951608,ES89209541595236157007,1585.44,2024-03-05T18:34:27,Plentzia,expenses,food,-105.4,-16492.47
buyer_5,Sara,Urkiaga,1994-03-12,95203027R,sara.urkiaga@megabyte.net,951608,ES89209541595236157007,1585.44,2024-03-05T10:53:43,Plentzia,expenses,leisure,-40.7,-16533.17
buyer_5,Sara,Urkiaga,1994-03-12,95203027R,sara.urkiaga@megabyte.net,951608,ES89209541595236157007,1585.44,2024-03-05T13:02:21,Plentzia,expenses,cash,-100.0,-16633.17
buyer_5,Sara,Urkiaga,1994-03-12,95203027R,sara.urkiaga@megabyte.net,951608,ES89209541595236157007,1585.44,2024-03-06T08:55:04,Plentzia,expenses,gas,-172.06,-16805.23
buyer_5,Sara,Urkiaga,1994-03-12,95203027R,sara.urkiaga@megabyte.net,951608,ES89209541595236157007,1585.44,2024-03-07T20:16:15,Plentzia,expenses,internet,-95.94,-16901.17
buyer_5,Sara,Urkiaga,1994-03-12,95203027R,sara.urkiaga@megabyte.net,951608,ES89209541595236157007,1585.44,2024-03-07T10:40:58,Plentzia,expenses,food,-106.42,-17007.59
buyer_5,Sara,Urkiaga,1994-03-12,95203027R,sara.urkiaga@megabyte.net,951608,ES89209541595236157007,1585.44,2024-03-07T04:46:48,Plentzia,expenses,transport,-87.8,-17095.39
buyer_5,Sara,Urkiaga,1994-03-12,95203027R,sara.urkiaga@megabyte.net,951608,ES89209541595236157007,1585.44,2024-03-07T15:31:41,Plentzia,expenses,cash,-100.0,-17195.39
buyer_5,Sara,Urkiaga,1994-03-12,95203027R,sara.urkiaga@megabyte.net,951608,ES89209541595236157007,1585.44,2024-03-08T23:23:27,Plentzia,expenses,water,-95.51,-17290.9
buyer_5,Sara,Urkiaga,1994-03-12,95203027R,sara.urkiaga@megabyte.net,951608,ES89209541595236157007,1585.44,2024-03-08T09:38:14,Plentzia,expenses,phone,-77.99,-17368.89
buyer_5,Sara,Urkiaga,1994-03-12,95203027R,sara.urkiaga@megabyte.net,951608,ES89209541595236157007,1585.44,2024-03-08T17:01:24,Plentzia,expenses,transport,-56.22,-17425.11
buyer_5,Sara,Urkiaga,1994-03-12,95203027R,sara.urkiaga@megabyte.net,951608,ES89209541595236157007,1585.44,2024-03-09T15:14:31,Plentzia,expenses,food,-106.53,-17531.64
buyer_5,Sara,Urkiaga,1994-03-12,95203027R,sara.urkiaga@megabyte.net,951608,ES89209541595236157007,1585.44,2024-03-09T01:21:08,Plentzia,expenses,leisure,-83.96,-17615.6
buyer_5,Sara,Urkiaga,1994-03-12,95203027R,sara.urkiaga@megabyte.net,951608,ES89209541595236157007,1585.44,2024-03-10T12:24:33,Plentzia,expenses,leisure,-41.75,-17657.35
buyer_5,Sara,Urkiaga,1994-03-12,95203027R,sara.urkiaga@megabyte.net,951608,ES89209541595236157007,1585.44,2024-03-10T22:21:02,Plentzia,expenses,cash,-100.0,-17757.35
buyer_5,Sara,Urkiaga,1994-03-12,95203027R,sara.urkiaga@megabyte.net,951608,ES89209541595236157007,1585.44,2024-03-11T08:15:16,Plentzia,expenses,cash,-100.0,-17857.35
buyer_5,Sara,Urkiaga,1994-03-12,95203027R,sara.urkiaga@megabyte.net,951608,ES89209541595236157007,1585.44,2024-03-11T20:53:31,Plentzia,expenses,gifts,-321.02,-18178.37
buyer_5,Sara,Urkiaga,1994-03-12,95203027R,sara.urkiaga@megabyte.net,951608,ES89209541595236157007,1585.44,2024-03-14T14:39:12,Plentzia,expenses,cash,-100.0,-18278.37
buyer_5,Sara,Urkiaga,1994-03-12,95203027R,sara.urkiaga@megabyte.net,951608,ES89209541595236157007,1585.44,2024-03-15T10:22:45,Plentzia,expenses,transport,-58.71,-18337.08
buyer_5,Sara,Urkiaga,1994-03-12,95203027R,sara.urkiaga@megabyte.net,951608,ES89209541595236157007,1585.44,2024-03-15T17:20:43,Plentzia,expenses,cash,-100.0,-18437.08
buyer_5,Sara,Urkiaga,1994-03-12,95203027R,sara.urkiaga@megabyte.net,951608,ES89209541595236157007,1585.44,2024-03-18T13:59:59,Plentzia,expenses,cash,-100.0,-18537.08
buyer_5,Sara,Urkiaga,1994-03-12,95203027R,sara.urkiaga@megabyte.net,951608,ES89209541595236157007,1585.44,2024-03-19T15:20:23,Plentzia,expenses,clothing,-69.94,-18607.02
buyer_5,Sara,Urkiaga,1994-03-12,95203027R,sara.urkiaga@megabyte.net,951608,ES89209541595236157007,1585.44,2024-03-19T07:23:59,Plentzia,expenses,repairs,-294.39,-18901.41
buyer_5,Sara,Urkiaga,1994-03-12,95203027R,sara.urkiaga@megabyte.net,951608,ES89209541595236157007,1585.44,2024-03-20T18:57:37,Plentzia,expenses,repairs,-59.95,-18961.36
buyer_5,Sara,Urkiaga,1994-03-12,95203027R,sara.urkiaga@megabyte.net,951608,ES89209541595236157007,1585.44,2024-03-21T20:08:07,Plentzia,expenses,cash,-100.0,-19061.36
buyer_5,Sara,Urkiaga,1994-03-12,95203027R,sara.urkiaga@megabyte.net,951608,ES89209541595236157007,1585.44,2024-03-23T07:47:19,Plentzia,expenses,food,-71.48,-19132.84
buyer_5,Sara,Urkiaga,1994-03-12,95203027R,sara.urkiaga@megabyte.net,951608,ES89209541595236157007,1585.44,2024-03-25T18:14:01,Plentzia,expenses,transport,-78.58,-19211.42
buyer_5,Sara,Urkiaga,1994-03-12,95203027R,sara.urkiaga@megabyte.net,951608,ES89209541595236157007,1585.44,2024-03-26T12:21:14,Plentzia,expenses,cash,-100.0,-19311.42
buyer_5,Sara,Urkiaga,1994-03-12,95203027R,sara.urkiaga@megabyte.net,951608,ES89209541595236157007,1585.44,2024-03-27T20:28:57,Plentzia,expenses,food,-62.97,-19374.39
buyer_5,Sara,Urkiaga,1994-03-12,95203027R,sara.urkiaga@megabyte.net,951608,ES89209541595236157007,1585.44,2024-03-27T11:09:28,Plentzia,expenses,transport,-84.25,-19458.64
buyer_5,Sara,Urkiaga,1994-03-12,95203027R,sara.urkiaga@megabyte.net,951608,ES89209541595236157007,1585.44,2024-03-30T17:15:12,Plentzia,expenses,transport,-79.01,-19537.65
buyer_5,Sara,Urkiaga,1994-03-12,95203027R,sara.urkiaga@megabyte.net,951608,ES89209541595236157007,1585.44,2024-03-30T21:36:15,Plentzia,expenses,leisure,-20.1,-19557.75
buyer_5,Sara,Urkiaga,1994-03-12,95203027R,sara.urkiaga@megabyte.net,951608,ES89209541595236157007,1585.44,2024-04-01T12:32:43,Plentzia,incomes,salary,2291.03,-17266.72
buyer_5,Sara,Urkiaga,1994-03-12,95203027R,sara.urkiaga@megabyte.net,951608,ES89209541595236157007,1585.44,2024-04-01T12:32:43,Plentzia,incomes,salary_partner,2277.75,-14988.97
buyer_5,Sara,Urkiaga,1994-03-12,95203027R,sara.urkiaga@megabyte.net,951608,ES89209541595236157007,1585.44,2024-04-03T12:04:33,Plentzia,expenses,repairs,-153.63,-15142.6
buyer_5,Sara,Urkiaga,1994-03-12,95203027R,sara.urkiaga@megabyte.net,951608,ES89209541595236157007,1585.44,2024-04-05T10:37:29,Plentzia,expenses,mortgage,-1722.86,-16865.46
buyer_5,Sara,Urkiaga,1994-03-12,95203027R,sara.urkiaga@megabyte.net,951608,ES89209541595236157007,1585.44,2024-04-05T14:53:00,Plentzia,expenses,electricity,-158.34,-17023.8
buyer_5,Sara,Urkiaga,1994-03-12,95203027R,sara.urkiaga@megabyte.net,951608,ES89209541595236157007,1585.44,2024-04-06T18:36:23,Plentzia,expenses,water,-57.27,-17081.07
buyer_5,Sara,Urkiaga,1994-03-12,95203027R,sara.urkiaga@megabyte.net,951608,ES89209541595236157007,1585.44,2024-04-06T19:41:41,Plentzia,expenses,electricity,-161.14,-17242.21
buyer_5,Sara,Urkiaga,1994-03-12,95203027R,sara.urkiaga@megabyte.net,951608,ES89209541595236157007,1585.44,2024-04-06T16:04:08,Plentzia,expenses,cash,-100.0,-17342.21
buyer_5,Sara,Urkiaga,1994-03-12,95203027R,sara.urkiaga@megabyte.net,951608,ES89209541595236157007,1585.44,2024-04-07T11:42:41,Plentzia,expenses,water,-97.46,-17439.67
buyer_5,Sara,Urkiaga,1994-03-12,95203027R,sara.urkiaga@megabyte.net,951608,ES89209541595236157007,1585.44,2024-04-07T20:01:27,Plentzia,expenses,internet,-95.94,-17535.61
buyer_5,Sara,Urkiaga,1994-03-12,95203027R,sara.urkiaga@megabyte.net,951608,ES89209541595236157007,1585.44,2024-04-07T13:54:39,Plentzia,expenses,repairs,-27.61,-17563.22
buyer_5,Sara,Urkiaga,1994-03-12,95203027R,sara.urkiaga@megabyte.net,951608,ES89209541595236157007,1585.44,2024-04-08T01:39:49,Plentzia,expenses,water,-80.85,-17644.07
buyer_5,Sara,Urkiaga,1994-03-12,95203027R,sara.urkiaga@megabyte.net,951608,ES89209541595236157007,1585.44,2024-04-09T06:22:16,Plentzia,expenses,transport,-72.0,-17716.07
buyer_5,Sara,Urkiaga,1994-03-12,95203027R,sara.urkiaga@megabyte.net,951608,ES89209541595236157007,1585.44,2024-04-12T23:53:04,Plentzia,expenses,education,-67.82,-17783.89
buyer_5,Sara,Urkiaga,1994-03-12,95203027R,sara.urkiaga@megabyte.net,951608,ES89209541595236157007,1585.44,2024-04-14T13:47:34,Plentzia,expenses,food,-71.56,-17855.45
buyer_5,Sara,Urkiaga,1994-03-12,95203027R,sara.urkiaga@megabyte.net,951608,ES89209541595236157007,1585.44,2024-04-15T18:57:19,Plentzia,expenses,leisure,-75.2,-17930.65
buyer_5,Sara,Urkiaga,1994-03-12,95203027R,sara.urkiaga@megabyte.net,951608,ES89209541595236157007,1585.44,2024-04-16T11:15:56,Plentzia,expenses,food,-70.03,-18000.68
buyer_5,Sara,Urkiaga,1994-03-12,95203027R,sara.urkiaga@megabyte.net,951608,ES89209541595236157007,1585.44,2024-04-16T01:23:02,Plentzia,expenses,repairs,-111.41,-18112.09
buyer_5,Sara,Urkiaga,1994-03-12,95203027R,sara.urkiaga@megabyte.net,951608,ES89209541595236157007,1585.44,2024-04-17T12:08:40,Plentzia,expenses,leisure,-71.47,-18183.56
buyer_5,Sara,Urkiaga,1994-03-12,95203027R,sara.urkiaga@megabyte.net,951608,ES89209541595236157007,1585.44,2024-04-19T10:22:17,Plentzia,expenses,cash,-100.0,-18283.56
buyer_5,Sara,Urkiaga,1994-03-12,95203027R,sara.urkiaga@megabyte.net,951608,ES89209541595236157007,1585.44,2024-04-20T09:37:13,Plentzia,expenses,food,-119.85,-18403.41
buyer_5,Sara,Urkiaga,1994-03-12,95203027R,sara.urkiaga@megabyte.net,951608,ES89209541595236157007,1585.44,2024-04-21T10:47:25,Plentzia,expenses,leisure,-84.82,-18488.23
buyer_5,Sara,Urkiaga,1994-03-12,95203027R,sara.urkiaga@megabyte.net,951608,ES89209541595236157007,1585.44,2024-04-21T17:37:02,Plentzia,expenses,clothing,-143.96,-18632.19
buyer_5,Sara,Urkiaga,1994-03-12,95203027R,sara.urkiaga@megabyte.net,951608,ES89209541595236157007,1585.44,2024-04-24T08:51:47,Plentzia,expenses,food,-73.62,-18705.81
buyer_5,Sara,Urkiaga,1994-03-12,95203027R,sara.urkiaga@megabyte.net,951608,ES89209541595236157007,1585.44,2024-04-25T09:53:52,Plentzia,expenses,clothing,-51.44,-18757.25
buyer_5,Sara,Urkiaga,1994-03-12,95203027R,sara.urkiaga@megabyte.net,951608,ES89209541595236157007,1585.44,2024-04-26T20:53:37,Plentzia,expenses,food,-96.38,-18853.63
buyer_5,Sara,Urkiaga,1994-03-12,95203027R,sara.urkiaga@megabyte.net,951608,ES89209541595236157007,1585.44,2024-04-26T20:01:15,Plentzia,expenses,education,-62.62,-18916.25
buyer_5,Sara,Urkiaga,1994-03-12,95203027R,sara.urkiaga@megabyte.net,951608,ES89209541595236157007,1585.44,2024-04-27T17:59:49,Plentzia,expenses,gifts,-425.12,-19341.37
buyer_5,Sara,Urkiaga,1994-03-12,95203027R,sara.urkiaga@megabyte.net,951608,ES89209541595236157007,1585.44,2024-04-28T08:43:27,Plentzia,expenses,leisure,-72.49,-19413.86
buyer_5,Sara,Urkiaga,1994-03-12,95203027R,sara.urkiaga@megabyte.net,951608,ES89209541595236157007,1585.44,2024-04-30T14:05:47,Plentzia,expenses,gifts,-594.49,-20008.35
buyer_5,Sara,Urkiaga,1994-03-12,95203027R,sara.urkiaga@megabyte.net,951608,ES89209541595236157007,1585.44,2024-05-01T12:29:31,Plentzia,incomes,salary,2291.03,-17717.32
buyer_5,Sara,Urkiaga,1994-03-12,95203027R,sara.urkiaga@megabyte.net,951608,ES89209541595236157007,1585.44,2024-05-01T12:29:31,Plentzia,incomes,salary_partner,2277.75,-15439.57
buyer_5,Sara,Urkiaga,1994-03-12,95203027R,sara.urkiaga@megabyte.net,951608,ES89209541595236157007,1585.44,2024-05-01T12:29:31,Plentzia,incomes,extra_income,224.91,-15214.66
buyer_5,Sara,Urkiaga,1994-03-12,95203027R,sara.urkiaga@megabyte.net,951608,ES89209541595236157007,1585.44,2024-05-01T17:05:59,Plentzia,expenses,cash,-100.0,-15314.66
buyer_5,Sara,Urkiaga,1994-03-12,95203027R,sara.urkiaga@megabyte.net,951608,ES89209541595236157007,1585.44,2024-05-04T13:34:28,Plentzia,expenses,food,-82.31,-15396.97
buyer_5,Sara,Urkiaga,1994-03-12,95203027R,sara.urkiaga@megabyte.net,951608,ES89209541595236157007,1585.44,2024-05-05T11:51:22,Plentzia,expenses,mortgage,-1722.86,-17119.83
buyer_5,Sara,Urkiaga,1994-03-12,95203027R,sara.urkiaga@megabyte.net,951608,ES89209541595236157007,1585.44,2024-05-05T15:04:40,Plentzia,expenses,internet,-95.94,-17215.77
buyer_5,Sara,Urkiaga,1994-03-12,95203027R,sara.urkiaga@megabyte.net,951608,ES89209541595236157007,1585.44,2024-05-06T01:23:18,Plentzia,expenses,water,-83.92,-17299.69
buyer_5,Sara,Urkiaga,1994-03-12,95203027R,sara.urkiaga@megabyte.net,951608,ES89209541595236157007,1585.44,2024-05-06T10:15:55,Plentzia,expenses,education,-47.05,-17346.74
buyer_5,Sara,Urkiaga,1994-03-12,95203027R,sara.urkiaga@megabyte.net,951608,ES89209541595236157007,1585.44,2024-05-07T15:56:18,Plentzia,expenses,electricity,-83.59,-17430.33
buyer_5,Sara,Urkiaga,1994-03-12,95203027R,sara.urkiaga@megabyte.net,951608,ES89209541595236157007,1585.44,2024-05-07T14:42:21,Plentzia,expenses,internet,-95.94,-17526.27
buyer_5,Sara,Urkiaga,1994-03-12,95203027R,sara.urkiaga@megabyte.net,951608,ES89209541595236157007,1585.44,2024-05-07T09:29:38,Plentzia,expenses,phone,-89.3,-17615.57
buyer_5,Sara,Urkiaga,1994-03-12,95203027R,sara.urkiaga@megabyte.net,951608,ES89209541595236157007,1585.44,2024-05-07T10:12:12,Plentzia,expenses,appliances,-109.74,-17725.31
buyer_5,Sara,Urkiaga,1994-03-12,95203027R,sara.urkiaga@megabyte.net,951608,ES89209541595236157007,1585.44,2024-05-08T15:44:56,Plentzia,expenses,water,-79.76,-17805.07
buyer_5,Sara,Urkiaga,1994-03-12,95203027R,sara.urkiaga@megabyte.net,951608,ES89209541595236157007,1585.44,2024-05-08T14:22:15,Plentzia,expenses,internet,-95.94,-17901.01
buyer_5,Sara,Urkiaga,1994-03-12,95203027R,sara.urkiaga@megabyte.net,951608,ES89209541595236157007,1585.44,2024-05-08T12:20:21,Plentzia,expenses,transport,-73.6,-17974.61
buyer_5,Sara,Urkiaga,1994-03-12,95203027R,sara.urkiaga@megabyte.net,951608,ES89209541595236157007,1585.44,2024-05-08T13:38:20,Plentzia,expenses,appliances,-418.31,-18392.92
buyer_5,Sara,Urkiaga,1994-03-12,95203027R,sara.urkiaga@megabyte.net,951608,ES89209541595236157007,1585.44,2024-05-09T22:57:04,Plentzia,expenses,leisure,-55.78,-18448.7
buyer_5,Sara,Urkiaga,1994-03-12,95203027R,sara.urkiaga@megabyte.net,951608,ES89209541595236157007,1585.44,2024-05-10T12:10:19,Plentzia,expenses,healthcare,-178.04,-18626.74
buyer_5,Sara,Urkiaga,1994-03-12,95203027R,sara.urkiaga@megabyte.net,951608,ES89209541595236157007,1585.44,2024-05-10T15:44:42,Plentzia,expenses,repairs,-41.58,-18668.32
buyer_5,Sara,Urkiaga,1994-03-12,95203027R,sara.urkiaga@megabyte.net,951608,ES89209541595236157007,1585.44,2024-05-10T15:23:58,Plentzia,expenses,gifts,-342.31,-19010.63
buyer_5,Sara,Urkiaga,1994-03-12,95203027R,sara.urkiaga@megabyte.net,951608,ES89209541595236157007,1585.44,2024-05-11T18:33:23,Plentzia,expenses,cash,-100.0,-19110.63
buyer_5,Sara,Urkiaga,1994-03-12,95203027R,sara.urkiaga@megabyte.net,951608,ES89209541595236157007,1585.44,2024-05-12T16:23:38,Plentzia,expenses,leisure,-32.54,-19143.17
buyer_5,Sara,Urkiaga,1994-03-12,95203027R,sara.urkiaga@megabyte.net,951608,ES89209541595236157007,1585.44,2024-05-12T20:28:03,Plentzia,expenses,cash,-100.0,-19243.17
buyer_5,Sara,Urkiaga,1994-03-12,95203027R,sara.urkiaga@megabyte.net,951608,ES89209541595236157007,1585.44,2024-05-13T10:06:09,Plentzia,expenses,food,-83.33,-19326.5
buyer_5,Sara,Urkiaga,1994-03-12,95203027R,sara.urkiaga@megabyte.net,951608,ES89209541595236157007,1585.44,2024-05-14T11:55:04,Plentzia,expenses,transport,-76.23,-19402.73
buyer_5,Sara,Urkiaga,1994-03-12,95203027R,sara.urkiaga@megabyte.net,951608,ES89209541595236157007,1585.44,2024-05-14T10:56:31,Plentzia,expenses,clothing,-62.42,-19465.15
buyer_5,Sara,Urkiaga,1994-03-12,95203027R,sara.urkiaga@megabyte.net,951608,ES89209541595236157007,1585.44,2024-05-15T16:53:27,Plentzia,expenses,food,-111.18,-19576.33
buyer_5,Sara,Urkiaga,1994-03-12,95203027R,sara.urkiaga@megabyte.net,951608,ES89209541595236157007,1585.44,2024-05-16T14:45:41,Plentzia,expenses,food,-65.02,-19641.35
buyer_5,Sara,Urkiaga,1994-03-12,95203027R,sara.urkiaga@megabyte.net,951608,ES89209541595236157007,1585.44,2024-05-18T14:24:14,Plentzia,expenses,gifts,-55.93,-19697.28
buyer_5,Sara,Urkiaga,1994-03-12,95203027R,sara.urkiaga@megabyte.net,951608,ES89209541595236157007,1585.44,2024-05-19T11:58:56,Plentzia,expenses,healthcare,-121.32,-19818.6
buyer_5,Sara,Urkiaga,1994-03-12,95203027R,sara.urkiaga@megabyte.net,951608,ES89209541595236157007,1585.44,2024-05-19T20:10:44,Plentzia,expenses,cash,-100.0,-19918.6
buyer_5,Sara,Urkiaga,1994-03-12,95203027R,sara.urkiaga@megabyte.net,951608,ES89209541595236157007,1585.44,2024-05-20T08:54:02,Plentzia,expenses,healthcare,-117.74,-20036.34
buyer_5,Sara,Urkiaga,1994-03-12,95203027R,sara.urkiaga@megabyte.net,951608,ES89209541595236157007,1585.44,2024-05-21T17:08:44,Plentzia,expenses,food,-116.52,-20152.86
buyer_5,Sara,Urkiaga,1994-03-12,95203027R,sara.urkiaga@megabyte.net,951608,ES89209541595236157007,1585.44,2024-05-21T20:36:45,Plentzia,expenses,transport,-48.39,-20201.25
buyer_5,Sara,Urkiaga,1994-03-12,95203027R,sara.urkiaga@megabyte.net,951608,ES89209541595236157007,1585.44,2024-05-22T04:58:27,Plentzia,expenses,repairs,-194.51,-20395.76
buyer_5,Sara,Urkiaga,1994-03-12,95203027R,sara.urkiaga@megabyte.net,951608,ES89209541595236157007,1585.44,2024-05-23T12:09:43,Plentzia,expenses,clothing,-66.15,-20461.91
buyer_5,Sara,Urkiaga,1994-03-12,95203027R,sara.urkiaga@megabyte.net,951608,ES89209541595236157007,1585.44,2024-05-27T19:52:08,Plentzia,expenses,food,-68.48,-20530.39
buyer_5,Sara,Urkiaga,1994-03-12,95203027R,sara.urkiaga@megabyte.net,951608,ES89209541595236157007,1585.44,2024-05-29T20:24:27,Plentzia,expenses,leisure,-31.65,-20562.04
buyer_5,Sara,Urkiaga,1994-03-12,95203027R,sara.urkiaga@megabyte.net,951608,ES89209541595236157007,1585.44,2024-05-29T13:32:16,Plentzia,expenses,cash,-100.0,-20662.04
buyer_5,Sara,Urkiaga,1994-03-12,95203027R,sara.urkiaga@megabyte.net,951608,ES89209541595236157007,1585.44,2024-05-30T18:19:19,Plentzia,expenses,food,-67.76,-20729.8
buyer_5,Sara,Urkiaga,1994-03-12,95203027R,sara.urkiaga@megabyte.net,951608,ES89209541595236157007,1585.44,2024-05-31T04:41:38,Plentzia,expenses,repairs,-174.95,-20904.75
buyer_5,Sara,Urkiaga,1994-03-12,95203027R,sara.urkiaga@megabyte.net,951608,ES89209541595236157007,1585.44,2024-06-01T18:42:49,Plentzia,incomes,salary,2291.03,-18613.72
buyer_5,Sara,Urkiaga,1994-03-12,95203027R,sara.urkiaga@megabyte.net,951608,ES89209541595236157007,1585.44,2024-06-01T18:42:49,Plentzia,incomes,salary_partner,2277.75,-16335.97
buyer_5,Sara,Urkiaga,1994-03-12,95203027R,sara.urkiaga@megabyte.net,951608,ES89209541595236157007,1585.44,2024-06-01T18:42:49,Plentzia,incomes,salary_bonus,1811.91,-14524.06
buyer_5,Sara,Urkiaga,1994-03-12,95203027R,sara.urkiaga@megabyte.net,951608,ES89209541595236157007,1585.44,2024-06-01T18:42:49,Plentzia,incomes,salary_partner_bonus,1694.73,-12829.33
buyer_5,Sara,Urkiaga,1994-03-12,95203027R,sara.urkiaga@megabyte.net,951608,ES89209541595236157007,1585.44,2024-06-01T13:21:11,Plentzia,expenses,taxes,-3943.17,-16772.5
buyer_5,Sara,Urkiaga,1994-03-12,95203027R,sara.urkiaga@megabyte.net,951608,ES89209541595236157007,1585.44,2024-06-01T09:37:24,Plentzia,expenses,insurance,-695.07,-17467.57
buyer_5,Sara,Urkiaga,1994-03-12,95203027R,sara.urkiaga@megabyte.net,951608,ES89209541595236157007,1585.44,2024-06-02T17:04:08,Plentzia,expenses,transport,-85.85,-17553.42
buyer_5,Sara,Urkiaga,1994-03-12,95203027R,sara.urkiaga@megabyte.net,951608,ES89209541595236157007,1585.44,2024-06-03T10:37:12,Plentzia,expenses,gifts,-133.85,-17687.27
buyer_5,Sara,Urkiaga,1994-03-12,95203027R,sara.urkiaga@megabyte.net,951608,ES89209541595236157007,1585.44,2024-06-04T20:29:21,Plentzia,expenses,food,-118.88,-17806.15
buyer_5,Sara,Urkiaga,1994-03-12,95203027R,sara.urkiaga@megabyte.net,951608,ES89209541595236157007,1585.44,2024-06-05T11:38:42,Plentzia,expenses,mortgage,-1722.86,-19529.01
buyer_5,Sara,Urkiaga,1994-03-12,95203027R,sara.urkiaga@megabyte.net,951608,ES89209541595236157007,1585.44,2024-06-05T15:53:50,Plentzia,expenses,internet,-95.94,-19624.95
buyer_5,Sara,Urkiaga,1994-03-12,95203027R,sara.urkiaga@megabyte.net,951608,ES89209541595236157007,1585.44,2024-06-05T03:11:52,Plentzia,expenses,cash,-100.0,-19724.95
buyer_5,Sara,Urkiaga,1994-03-12,95203027R,sara.urkiaga@megabyte.net,951608,ES89209541595236157007,1585.44,2024-06-06T09:30:05,Plentzia,expenses,gas,-235.16,-19960.11
buyer_5,Sara,Urkiaga,1994-03-12,95203027R,sara.urkiaga@megabyte.net,951608,ES89209541595236157007,1585.44,2024-06-07T01:38:22,Plentzia,expenses,water,-46.84,-20006.95
buyer_5,Sara,Urkiaga,1994-03-12,95203027R,sara.urkiaga@megabyte.net,951608,ES89209541595236157007,1585.44,2024-06-07T14:38:12,Plentzia,expenses,electricity,-184.94,-20191.89
buyer_5,Sara,Urkiaga,1994-03-12,95203027R,sara.urkiaga@megabyte.net,951608,ES89209541595236157007,1585.44,2024-06-08T20:24:36,Plentzia,expenses,water,-60.96,-20252.85
buyer_5,Sara,Urkiaga,1994-03-12,95203027R,sara.urkiaga@megabyte.net,951608,ES89209541595236157007,1585.44,2024-06-08T05:32:54,Plentzia,expenses,electricity,-49.69,-20302.54
buyer_5,Sara,Urkiaga,1994-03-12,95203027R,sara.urkiaga@megabyte.net,951608,ES89209541595236157007,1585.44,2024-06-08T19:39:10,Plentzia,expenses,leisure,-55.48,-20358.02
buyer_5,Sara,Urkiaga,1994-03-12,95203027R,sara.urkiaga@megabyte.net,951608,ES89209541595236157007,1585.44,2024-06-08T09:54:32,Plentzia,expenses,cash,-100.0,-20458.02
buyer_5,Sara,Urkiaga,1994-03-12,95203027R,sara.urkiaga@megabyte.net,951608,ES89209541595236157007,1585.44,2024-06-10T07:26:10,Plentzia,expenses,cash,-100.0,-20558.02
buyer_5,Sara,Urkiaga,1994-03-12,95203027R,sara.urkiaga@megabyte.net,951608,ES89209541595236157007,1585.44,2024-06-11T08:47:59,Plentzia,expenses,food,-68.4,-20626.42
buyer_5,Sara,Urkiaga,1994-03-12,95203027R,sara.urkiaga@megabyte.net,951608,ES89209541595236157007,1585.44,2024-06-12T18:51:33,Plentzia,expenses,leisure,-77.15,-20703.57
buyer_5,Sara,Urkiaga,1994-03-12,95203027R,sara.urkiaga@megabyte.net,951608,ES89209541595236157007,1585.44,2024-06-13T17:03:00,Plentzia,expenses,clothing,-104.21,-20807.78
buyer_5,Sara,Urkiaga,1994-03-12,95203027R,sara.urkiaga@megabyte.net,951608,ES89209541595236157007,1585.44,2024-06-14T18:12:50,Plentzia,expenses,food,-86.34,-20894.12
buyer_5,Sara,Urkiaga,1994-03-12,95203027R,sara.urkiaga@megabyte.net,951608,ES89209541595236157007,1585.44,2024-06-14T19:57:43,Plentzia,expenses,transport,-60.21,-20954.33
buyer_5,Sara,Urkiaga,1994-03-12,95203027R,sara.urkiaga@megabyte.net,951608,ES89209541595236157007,1585.44,2024-06-14T21:59:09,Plentzia,expenses,healthcare,-60.12,-21014.45
buyer_5,Sara,Urkiaga,1994-03-12,95203027R,sara.urkiaga@megabyte.net,951608,ES89209541595236157007,1585.44,2024-06-16T13:08:28,Plentzia,expenses,food,-79.69,-21094.14
buyer_5,Sara,Urkiaga,1994-03-12,95203027R,sara.urkiaga@megabyte.net,951608,ES89209541595236157007,1585.44,2024-06-16T16:34:10,Plentzia,expenses,transport,-44.18,-21138.32
buyer_5,Sara,Urkiaga,1994-03-12,95203027R,sara.urkiaga@megabyte.net,951608,ES89209541595236157007,1585.44,2024-06-16T00:36:11,Plentzia,expenses,leisure,-47.12,-21185.44
buyer_5,Sara,Urkiaga,1994-03-12,95203027R,sara.urkiaga@megabyte.net,951608,ES89209541595236157007,1585.44,2024-06-19T17:51:17,Plentzia,expenses,repairs,-286.14,-21471.58
buyer_5,Sara,Urkiaga,1994-03-12,95203027R,sara.urkiaga@megabyte.net,951608,ES89209541595236157007,1585.44,2024-06-20T11:31:16,Plentzia,expenses,transport,-49.9,-21521.48
buyer_5,Sara,Urkiaga,1994-03-12,95203027R,sara.urkiaga@megabyte.net,951608,ES89209541595236157007,1585.44,2024-06-21T22:52:02,Plentzia,expenses,food,-70.84,-21592.32
buyer_5,Sara,Urkiaga,1994-03-12,95203027R,sara.urkiaga@megabyte.net,951608,ES89209541595236157007,1585.44,2024-06-22T18:55:52,Plentzia,expenses,food,-111.89,-21704.21
buyer_5,Sara,Urkiaga,1994-03-12,95203027R,sara.urkiaga@megabyte.net,951608,ES89209541595236157007,1585.44,2024-06-23T08:21:44,Plentzia,expenses,leisure,-37.45,-21741.66
buyer_5,Sara,Urkiaga,1994-03-12,95203027R,sara.urkiaga@megabyte.net,951608,ES89209541595236157007,1585.44,2024-06-26T23:41:42,Plentzia,expenses,leisure,-54.04,-21795.7
buyer_5,Sara,Urkiaga,1994-03-12,95203027R,sara.urkiaga@megabyte.net,951608,ES89209541595236157007,1585.44,2024-06-27T14:53:53,Plentzia,expenses,cash,-100.0,-21895.7
buyer_5,Sara,Urkiaga,1994-03-12,95203027R,sara.urkiaga@megabyte.net,951608,ES89209541595236157007,1585.44,2024-06-27T11:27:19,Plentzia,expenses,gifts,-161.9,-22057.6
buyer_5,Sara,Urkiaga,1994-03-12,95203027R,sara.urkiaga@megabyte.net,951608,ES89209541595236157007,1585.44,2024-06-29T13:51:46,Plentzia,expenses,food,-71.78,-22129.38
buyer_5,Sara,Urkiaga,1994-03-12,95203027R,sara.urkiaga@megabyte.net,951608,ES89209541595236157007,1585.44,2024-06-29T17:47:54,Plentzia,expenses,repairs,-45.6,-22174.98
buyer_5,Sara,Urkiaga,1994-03-12,95203027R,sara.urkiaga@megabyte.net,951608,ES89209541595236157007,1585.44,2024-06-30T20:38:04,Plentzia,expenses,cash,-100.0,-22274.98
buyer_5,Sara,Urkiaga,1994-03-12,95203027R,sara.urkiaga@megabyte.net,951608,ES89209541595236157007,1585.44,2024-07-01T13:16:15,Plentzia,incomes,salary,2291.03,-19983.95
buyer_5,Sara,Urkiaga,1994-03-12,95203027R,sara.urkiaga@megabyte.net,951608,ES89209541595236157007,1585.44,2024-07-01T13:16:15,Plentzia,incomes,salary_partner,2277.75,-17706.2
buyer_5,Sara,Urkiaga,1994-03-12,95203027R,sara.urkiaga@megabyte.net,951608,ES89209541595236157007,1585.44,2024-07-01T17:20:12,Plentzia,expenses,food,-68.18,-17774.38
buyer_5,Sara,Urkiaga,1994-03-12,95203027R,sara.urkiaga@megabyte.net,951608,ES89209541595236157007,1585.44,2024-07-03T04:28:03,Plentzia,expenses,food,-103.1,-17877.48
buyer_5,Sara,Urkiaga,1994-03-12,95203027R,sara.urkiaga@megabyte.net,951608,ES89209541595236157007,1585.44,2024-07-04T12:54:35,Plentzia,expenses,food,-116.91,-17994.39
buyer_5,Sara,Urkiaga,1994-03-12,95203027R,sara.urkiaga@megabyte.net,951608,ES89209541595236157007,1585.44,2024-07-04T11:50:13,Plentzia,expenses,transport,-65.79,-18060.18
buyer_5,Sara,Urkiaga,1994-03-12,95203027R,sara.urkiaga@megabyte.net,951608,ES89209541595236157007,1585.44,2024-07-04T17:54:57,Plentzia,expenses,gifts,-502.47,-18562.65
buyer_5,Sara,Urkiaga,1994-03-12,95203027R,sara.urkiaga@megabyte.net,951608,ES89209541595236157007,1585.44,2024-07-05T10:31:26,Plentzia,expenses,mortgage,-1722.86,-20285.51
buyer_5,Sara,Urkiaga,1994-03-12,95203027R,sara.urkiaga@megabyte.net,951608,ES89209541595236157007,1585.44,2024-07-06T08:46:44,Plentzia,expenses,food,-67.33,-20352.84
buyer_5,Sara,Urkiaga,1994-03-12,95203027R,sara.urkiaga@megabyte.net,951608,ES89209541595236157007,1585.44,2024-07-07T12:18:12,Plentzia,expenses,gas,-249.09,-20601.93
buyer_5,Sara,Urkiaga,1994-03-12,95203027R,sara.urkiaga@megabyte.net,951608,ES89209541595236157007,1585.44,2024-07-08T13:05:52,Plentzia,expenses,internet,-95.94,-20697.87
buyer_5,Sara,Urkiaga,1994-03-12,95203027R,sara.urkiaga@megabyte.net,951608,ES89209541595236157007,1585.44,2024-07-08T09:27:00,Plentzia,expenses,phone,-75.5,-20773.37
buyer_5,Sara,Urkiaga,1994-03-12,95203027R,sara.urkiaga@megabyte.net,951608,ES89209541595236157007,1585.44,2024-07-08T09:44:54,Plentzia,expenses,cash,-100.0,-20873.37
buyer_5,Sara,Urkiaga,1994-03-12,95203027R,sara.urkiaga@megabyte.net,951608,ES89209541595236157007,1585.44,2024-07-09T11:29:19,Plentzia,expenses,transport,-80.37,-20953.74
buyer_5,Sara,Urkiaga,1994-03-12,95203027R,sara.urkiaga@megabyte.net,951608,ES89209541595236157007,1585.44,2024-07-09T10:33:09,Plentzia,expenses,leisure,-66.18,-21019.92
buyer_5,Sara,Urkiaga,1994-03-12,95203027R,sara.urkiaga@megabyte.net,951608,ES89209541595236157007,1585.44,2024-07-10T16:19:18,Plentzia,expenses,cash,-100.0,-21119.92
buyer_5,Sara,Urkiaga,1994-03-12,95203027R,sara.urkiaga@megabyte.net,951608,ES89209541595236157007,1585.44,2024-07-11T08:44:47,Plentzia,expenses,food,-106.42,-21226.34
buyer_5,Sara,Urkiaga,1994-03-12,95203027R,sara.urkiaga@megabyte.net,951608,ES89209541595236157007,1585.44,2024-07-11T08:06:47,Plentzia,expenses,travel,-421.08,-21647.42
buyer_5,Sara,Urkiaga,1994-03-12,95203027R,sara.urkiaga@megabyte.net,951608,ES89209541595236157007,1585.44,2024-07-12T11:00:50,Plentzia,expenses,cash,-100.0,-21747.42
buyer_5,Sara,Urkiaga,1994-03-12,95203027R,sara.urkiaga@megabyte.net,951608,ES89209541595236157007,1585.44,2024-07-13T01:20:08,Plentzia,expenses,transport,-84.9,-21832.32
buyer_5,Sara,Urkiaga,1994-03-12,95203027R,sara.urkiaga@megabyte.net,951608,ES89209541595236157007,1585.44,2024-07-13T11:32:11,Plentzia,expenses,cash,-100.0,-21932.32
buyer_5,Sara,Urkiaga,1994-03-12,95203027R,sara.urkiaga@megabyte.net,951608,ES89209541595236157007,1585.44,2024-07-16T14:41:04,Plentzia,expenses,appliances,-115.7,-22048.02
buyer_5,Sara,Urkiaga,1994-03-12,95203027R,sara.urkiaga@megabyte.net,951608,ES89209541595236157007,1585.44,2024-07-17T23:47:55,Plentzia,expenses,cash,-100.0,-22148.02
buyer_5,Sara,Urkiaga,1994-03-12,95203027R,sara.urkiaga@megabyte.net,951608,ES89209541595236157007,1585.44,2024-07-17T05:36:48,Plentzia,expenses,appliances,-403.81,-22551.83
buyer_5,Sara,Urkiaga,1994-03-12,95203027R,sara.urkiaga@megabyte.net,951608,ES89209541595236157007,1585.44,2024-07-18T01:33:41,Plentzia,expenses,leisure,-45.25,-22597.08
buyer_5,Sara,Urkiaga,1994-03-12,95203027R,sara.urkiaga@megabyte.net,951608,ES89209541595236157007,1585.44,2024-07-19T15:30:21,Plentzia,expenses,leisure,-22.19,-22619.27
buyer_5,Sara,Urkiaga,1994-03-12,95203027R,sara.urkiaga@megabyte.net,951608,ES89209541595236157007,1585.44,2024-07-20T19:44:58,Plentzia,expenses,food,-95.73,-22715.0
buyer_5,Sara,Urkiaga,1994-03-12,95203027R,sara.urkiaga@megabyte.net,951608,ES89209541595236157007,1585.44,2024-07-22T15:51:38,Plentzia,expenses,clothing,-67.89,-22782.89
buyer_5,Sara,Urkiaga,1994-03-12,95203027R,sara.urkiaga@megabyte.net,951608,ES89209541595236157007,1585.44,2024-07-24T18:16:24,Plentzia,expenses,food,-117.76,-22900.65
buyer_5,Sara,Urkiaga,1994-03-12,95203027R,sara.urkiaga@megabyte.net,951608,ES89209541595236157007,1585.44,2024-07-27T06:57:04,Plentzia,expenses,leisure,-27.94,-22928.59
buyer_5,Sara,Urkiaga,1994-03-12,95203027R,sara.urkiaga@megabyte.net,951608,ES89209541595236157007,1585.44,2024-07-28T10:15:23,Plentzia,expenses,cash,-100.0,-23028.59
buyer_5,Sara,Urkiaga,1994-03-12,95203027R,sara.urkiaga@megabyte.net,951608,ES89209541595236157007,1585.44,2024-07-30T16:13:00,Plentzia,expenses,leisure,-77.2,-23105.79
buyer_5,Sara,Urkiaga,1994-03-12,95203027R,sara.urkiaga@megabyte.net,951608,ES89209541595236157007,1585.44,2024-07-30T13:09:19,Plentzia,expenses,repairs,-168.68,-23274.47
buyer_5,Sara,Urkiaga,1994-03-12,95203027R,sara.urkiaga@megabyte.net,951608,ES89209541595236157007,1585.44,2024-07-31T11:31:09,Plentzia,expenses,transport,-66.95,-23341.42
buyer_5,Sara,Urkiaga,1994-03-12,95203027R,sara.urkiaga@megabyte.net,951608,ES89209541595236157007,1585.44,2024-07-31T15:57:37,Plentzia,expenses,clothing,-107.54,-23448.96
buyer_5,Sara,Urkiaga,1994-03-12,95203027R,sara.urkiaga@megabyte.net,951608,ES89209541595236157007,1585.44,2024-08-01T20:50:07,Plentzia,incomes,salary,2291.03,-21157.93
buyer_5,Sara,Urkiaga,1994-03-12,95203027R,sara.urkiaga@megabyte.net,951608,ES89209541595236157007,1585.44,2024-08-01T20:50:07,Plentzia,incomes,salary_partner,2277.75,-18880.18
buyer_5,Sara,Urkiaga,1994-03-12,95203027R,sara.urkiaga@megabyte.net,951608,ES89209541595236157007,1585.44,2024-08-01T20:50:07,Plentzia,incomes,extra_income,224.91,-18655.27
buyer_5,Sara,Urkiaga,1994-03-12,95203027R,sara.urkiaga@megabyte.net,951608,ES89209541595236157007,1585.44,2024-08-01T22:12:07,Plentzia,expenses,clothing,-57.33,-18712.6
buyer_5,Sara,Urkiaga,1994-03-12,95203027R,sara.urkiaga@megabyte.net,951608,ES89209541595236157007,1585.44,2024-08-02T02:13:15,Plentzia,expenses,healthcare,-111.34,-18823.94
buyer_5,Sara,Urkiaga,1994-03-12,95203027R,sara.urkiaga@megabyte.net,951608,ES89209541595236157007,1585.44,2024-08-03T09:11:09,Plentzia,expenses,leisure,-21.4,-18845.34
buyer_5,Sara,Urkiaga,1994-03-12,95203027R,sara.urkiaga@megabyte.net,951608,ES89209541595236157007,1585.44,2024-08-03T15:53:29,Plentzia,expenses,cash,-100.0,-18945.34
buyer_5,Sara,Urkiaga,1994-03-12,95203027R,sara.urkiaga@megabyte.net,951608,ES89209541595236157007,1585.44,2024-08-04T11:30:07,Plentzia,expenses,food,-116.24,-19061.58
buyer_5,Sara,Urkiaga,1994-03-12,95203027R,sara.urkiaga@megabyte.net,951608,ES89209541595236157007,1585.44,2024-08-04T21:41:42,Plentzia,expenses,leisure,-76.92,-19138.5
buyer_5,Sara,Urkiaga,1994-03-12,95203027R,sara.urkiaga@megabyte.net,951608,ES89209541595236157007,1585.44,2024-08-04T13:12:56,Plentzia,expenses,cash,-100.0,-19238.5
buyer_5,Sara,Urkiaga,1994-03-12,95203027R,sara.urkiaga@megabyte.net,951608,ES89209541595236157007,1585.44,2024-08-04T14:19:00,Plentzia,expenses,appliances,-407.07,-19645.57
buyer_5,Sara,Urkiaga,1994-03-12,95203027R,sara.urkiaga@megabyte.net,951608,ES89209541595236157007,1585.44,2024-08-05T13:27:47,Plentzia,expenses,mortgage,-1722.86,-21368.43
buyer_5,Sara,Urkiaga,1994-03-12,95203027R,sara.urkiaga@megabyte.net,951608,ES89209541595236157007,1585.44,2024-08-05T20:23:56,Plentzia,expenses,water,-74.3,-21442.73
buyer_5,Sara,Urkiaga,1994-03-12,95203027R,sara.urkiaga@megabyte.net,951608,ES89209541595236157007,1585.44,2024-08-06T11:18:55,Plentzia,expenses,electricity,-103.31,-21546.04
buyer_5,Sara,Urkiaga,1994-03-12,95203027R,sara.urkiaga@megabyte.net,951608,ES89209541595236157007,1585.44,2024-08-06T15:39:10,Plentzia,expenses,phone,-71.37,-21617.41
buyer_5,Sara,Urkiaga,1994-03-12,95203027R,sara.urkiaga@megabyte.net,951608,ES89209541595236157007,1585.44,2024-08-07T01:17:43,Plentzia,expenses,internet,-95.94,-21713.35
buyer_5,Sara,Urkiaga,1994-03-12,95203027R,sara.urkiaga@megabyte.net,951608,ES89209541595236157007,1585.44,2024-08-08T18:06:25,Plentzia,expenses,water,-53.29,-21766.64
buyer_5,Sara,Urkiaga,1994-03-12,95203027R,sara.urkiaga@megabyte.net,951608,ES89209541595236157007,1585.44,2024-08-08T13:08:51,Plentzia,expenses,gas,-157.62,-21924.26
buyer_5,Sara,Urkiaga,1994-03-12,95203027R,sara.urkiaga@megabyte.net,951608,ES89209541595236157007,1585.44,2024-08-08T18:05:25,Plentzia,expenses,food,-101.36,-22025.62
buyer_5,Sara,Urkiaga,1994-03-12,95203027R,sara.urkiaga@megabyte.net,951608,ES89209541595236157007,1585.44,2024-08-08T09:09:04,Plentzia,expenses,cash,-100.0,-22125.62
buyer_5,Sara,Urkiaga,1994-03-12,95203027R,sara.urkiaga@megabyte.net,951608,ES89209541595236157007,1585.44,2024-08-09T08:55:26,Plentzia,expenses,food,-88.33,-22213.95
buyer_5,Sara,Urkiaga,1994-03-12,95203027R,sara.urkiaga@megabyte.net,951608,ES89209541595236157007,1585.44,2024-08-12T18:45:03,Plentzia,expenses,food,-74.94,-22288.89
buyer_5,Sara,Urkiaga,1994-03-12,95203027R,sara.urkiaga@megabyte.net,951608,ES89209541595236157007,1585.44,2024-08-15T00:43:38,Plentzia,expenses,transport,-48.52,-22337.41
buyer_5,Sara,Urkiaga,1994-03-12,95203027R,sara.urkiaga@megabyte.net,951608,ES89209541595236157007,1585.44,2024-08-18T19:08:21,Plentzia,expenses,gifts,-287.68,-22625.09
buyer_5,Sara,Urkiaga,1994-03-12,95203027R,sara.urkiaga@megabyte.net,951608,ES89209541595236157007,1585.44,2024-08-19T06:16:14,Plentzia,expenses,leisure,-73.78,-22698.87
buyer_5,Sara,Urkiaga,1994-03-12,95203027R,sara.urkiaga@megabyte.net,951608,ES89209541595236157007,1585.44,2024-08-22T12:26:51,Plentzia,expenses,transport,-69.42,-22768.29
buyer_5,Sara,Urkiaga,1994-03-12,95203027R,sara.urkiaga@megabyte.net,951608,ES89209541595236157007,1585.44,2024-08-22T12:32:10,Plentzia,expenses,healthcare,-39.02,-22807.31
buyer_5,Sara,Urkiaga,1994-03-12,95203027R,sara.urkiaga@megabyte.net,951608,ES89209541595236157007,1585.44,2024-08-27T11:44:09,Plentzia,expenses,transport,-64.96,-22872.27
buyer_5,Sara,Urkiaga,1994-03-12,95203027R,sara.urkiaga@megabyte.net,951608,ES89209541595236157007,1585.44,2024-08-28T23:41:29,Plentzia,expenses,food,-120.69,-22992.96
buyer_5,Sara,Urkiaga,1994-03-12,95203027R,sara.urkiaga@megabyte.net,951608,ES89209541595236157007,1585.44,2024-08-30T11:33:22,Plentzia,expenses,leisure,-34.36,-23027.32
buyer_5,Sara,Urkiaga,1994-03-12,95203027R,sara.urkiaga@megabyte.net,951608,ES89209541595236157007,1585.44,2024-09-01T20:37:35,Plentzia,incomes,salary,2291.03,-20736.29
buyer_5,Sara,Urkiaga,1994-03-12,95203027R,sara.urkiaga@megabyte.net,951608,ES89209541595236157007,1585.44,2024-09-01T20:37:35,Plentzia,incomes,salary_partner,2277.75,-18458.54
buyer_5,Sara,Urkiaga,1994-03-12,95203027R,sara.urkiaga@megabyte.net,951608,ES89209541595236157007,1585.44,2024-09-01T14:54:09,Plentzia,expenses,leisure,-77.36,-18535.9
buyer_5,Sara,Urkiaga,1994-03-12,95203027R,sara.urkiaga@megabyte.net,951608,ES89209541595236157007,1585.44,2024-09-01T05:53:50,Plentzia,expenses,cash,-100.0,-18635.9
buyer_5,Sara,Urkiaga,1994-03-12,95203027R,sara.urkiaga@megabyte.net,951608,ES89209541595236157007,1585.44,2024-09-05T20:17:04,Plentzia,expenses,mortgage,-1722.86,-20358.76
buyer_5,Sara,Urkiaga,1994-03-12,95203027R,sara.urkiaga@megabyte.net,951608,ES89209541595236157007,1585.44,2024-09-05T23:42:07,Plentzia,expenses,gas,-222.91,-20581.67
buyer_5,Sara,Urkiaga,1994-03-12,95203027R,sara.urkiaga@megabyte.net,951608,ES89209541595236157007,1585.44,2024-09-05T01:56:16,Plentzia,expenses,food,-94.55,-20676.22
buyer_5,Sara,Urkiaga,1994-03-12,95203027R,sara.urkiaga@megabyte.net,951608,ES89209541595236157007,1585.44,2024-09-07T11:36:27,Plentzia,expenses,gas,-144.47,-20820.69
buyer_5,Sara,Urkiaga,1994-03-12,95203027R,sara.urkiaga@megabyte.net,951608,ES89209541595236157007,1585.44,2024-09-07T06:49:18,Plentzia,expenses,clothing,-70.14,-20890.83
buyer_5,Sara,Urkiaga,1994-03-12,95203027R,sara.urkiaga@megabyte.net,951608,ES89209541595236157007,1585.44,2024-09-08T13:53:20,Plentzia,expenses,cash,-100.0,-20990.83
buyer_5,Sara,Urkiaga,1994-03-12,95203027R,sara.urkiaga@megabyte.net,951608,ES89209541595236157007,1585.44,2024-09-10T22:52:44,Plentzia,expenses,cash,-100.0,-21090.83
buyer_5,Sara,Urkiaga,1994-03-12,95203027R,sara.urkiaga@megabyte.net,951608,ES89209541595236157007,1585.44,2024-09-11T14:59:06,Plentzia,expenses,food,-117.24,-21208.07
buyer_5,Sara,Urkiaga,1994-03-12,95203027R,sara.urkiaga@megabyte.net,951608,ES89209541595236157007,1585.44,2024-09-11T10:20:03,Plentzia,expenses,transport,-71.96,-21280.03
buyer_5,Sara,Urkiaga,1994-03-12,95203027R,sara.urkiaga@megabyte.net,951608,ES89209541595236157007,1585.44,2024-09-13T10:20:59,Plentzia,expenses,food,-123.1,-21403.13
buyer_5,Sara,Urkiaga,1994-03-12,95203027R,sara.urkiaga@megabyte.net,951608,ES89209541595236157007,1585.44,2024-09-13T14:37:59,Plentzia,expenses,cash,-100.0,-21503.13
buyer_5,Sara,Urkiaga,1994-03-12,95203027R,sara.urkiaga@megabyte.net,951608,ES89209541595236157007,1585.44,2024-09-14T06:35:46,Plentzia,expenses,leisure,-57.2,-21560.33
buyer_5,Sara,Urkiaga,1994-03-12,95203027R,sara.urkiaga@megabyte.net,951608,ES89209541595236157007,1585.44,2024-09-15T20:55:57,Plentzia,expenses,clothing,-78.25,-21638.58
buyer_5,Sara,Urkiaga,1994-03-12,95203027R,sara.urkiaga@megabyte.net,951608,ES89209541595236157007,1585.44,2024-09-16T16:09:05,Plentzia,expenses,clothing,-153.44,-21792.02
buyer_5,Sara,Urkiaga,1994-03-12,95203027R,sara.urkiaga@megabyte.net,951608,ES89209541595236157007,1585.44,2024-09-18T04:35:07,Plentzia,expenses,cash,-100.0,-21892.02
buyer_5,Sara,Urkiaga,1994-03-12,95203027R,sara.urkiaga@megabyte.net,951608,ES89209541595236157007,1585.44,2024-09-21T07:09:24,Plentzia,expenses,leisure,-30.87,-21922.89
buyer_5,Sara,Urkiaga,1994-03-12,95203027R,sara.urkiaga@megabyte.net,951608,ES89209541595236157007,1585.44,2024-09-22T18:18:22,Plentzia,expenses,food,-94.22,-22017.11
buyer_5,Sara,Urkiaga,1994-03-12,95203027R,sara.urkiaga@megabyte.net,951608,ES89209541595236157007,1585.44,2024-09-23T17:30:38,Plentzia,expenses,gifts,-403.53,-22420.64
buyer_5,Sara,Urkiaga,1994-03-12,95203027R,sara.urkiaga@megabyte.net,951608,ES89209541595236157007,1585.44,2024-09-26T11:03:37,Plentzia,expenses,food,-116.07,-22536.71
buyer_5,Sara,Urkiaga,1994-03-12,95203027R,sara.urkiaga@megabyte.net,951608,ES89209541595236157007,1585.44,2024-09-27T19:34:19,Plentzia,expenses,food,-61.49,-22598.2
buyer_5,Sara,Urkiaga,1994-03-12,95203027R,sara.urkiaga@megabyte.net,951608,ES89209541595236157007,1585.44,2024-09-28T13:37:42,Plentzia,expenses,cash,-100.0,-22698.2
buyer_5,Sara,Urkiaga,1994-03-12,95203027R,sara.urkiaga@megabyte.net,951608,ES89209541595236157007,1585.44,2024-09-29T14:25:55,Plentzia,expenses,cash,-100.0,-22798.2
buyer_5,Sara,Urkiaga,1994-03-12,95203027R,sara.urkiaga@megabyte.net,951608,ES89209541595236157007,1585.44,2024-10-01T03:53:39,Plentzia,incomes,salary,2291.03,-20507.17
buyer_5,Sara,Urkiaga,1994-03-12,95203027R,sara.urkiaga@megabyte.net,951608,ES89209541595236157007,1585.44,2024-10-01T03:53:39,Plentzia,incomes,salary_partner,2277.75,-18229.42
buyer_5,Sara,Urkiaga,1994-03-12,95203027R,sara.urkiaga@megabyte.net,951608,ES89209541595236157007,1585.44,2024-10-01T22:17:42,Plentzia,expenses,cash,-100.0,-18329.42
buyer_5,Sara,Urkiaga,1994-03-12,95203027R,sara.urkiaga@megabyte.net,951608,ES89209541595236157007,1585.44,2024-10-01T17:53:24,Plentzia,expenses,gifts,-691.06,-19020.48
buyer_5,Sara,Urkiaga,1994-03-12,95203027R,sara.urkiaga@megabyte.net,951608,ES89209541595236157007,1585.44,2024-10-02T18:27:28,Plentzia,expenses,leisure,-32.54,-19053.02
buyer_5,Sara,Urkiaga,1994-03-12,95203027R,sara.urkiaga@megabyte.net,951608,ES89209541595236157007,1585.44,2024-10-05T16:48:05,Plentzia,expenses,mortgage,-1722.86,-20775.88
buyer_5,Sara,Urkiaga,1994-03-12,95203027R,sara.urkiaga@megabyte.net,951608,ES89209541595236157007,1585.44,2024-10-05T15:54:40,Plentzia,expenses,electricity,-125.49,-20901.37
buyer_5,Sara,Urkiaga,1994-03-12,95203027R,sara.urkiaga@megabyte.net,951608,ES89209541595236157007,1585.44,2024-10-07T19:05:13,Plentzia,expenses,internet,-95.94,-20997.31
buyer_5,Sara,Urkiaga,1994-03-12,95203027R,sara.urkiaga@megabyte.net,951608,ES89209541595236157007,1585.44,2024-10-07T20:36:18,Plentzia,expenses,cash,-100.0,-21097.31
buyer_5,Sara,Urkiaga,1994-03-12,95203027R,sara.urkiaga@megabyte.net,951608,ES89209541595236157007,1585.44,2024-10-08T18:00:39,Plentzia,expenses,phone,-79.95,-21177.26
buyer_5,Sara,Urkiaga,1994-03-12,95203027R,sara.urkiaga@megabyte.net,951608,ES89209541595236157007,1585.44,2024-10-08T16:27:10,Plentzia,expenses,food,-120.05,-21297.31
buyer_6,Manuel,Díez,1979-02-14,43668965S,manuel.díez@extremetech.io,146712,ES97209541159222930896,1625.21,2022-01-01T13:24:57,Valladolid,incomes,salary,2976.14,4601.35
buyer_6,Manuel,Díez,1979-02-14,43668965S,manuel.díez@extremetech.io,146712,ES97209541159222930896,1625.21,2022-01-03T14:37:39,Valladolid,expenses,cash,-100.0,4501.35
buyer_6,Manuel,Díez,1979-02-14,43668965S,manuel.díez@extremetech.io,146712,ES97209541159222930896,1625.21,2022-01-04T16:00:03,Valladolid,expenses,leisure,-70.41,4430.94
buyer_6,Manuel,Díez,1979-02-14,43668965S,manuel.díez@extremetech.io,146712,ES97209541159222930896,1625.21,2022-01-05T13:00:49,Valladolid,expenses,mortgage,-1147.51,3283.43
buyer_6,Manuel,Díez,1979-02-14,43668965S,manuel.díez@extremetech.io,146712,ES97209541159222930896,1625.21,2022-01-05T17:49:09,Valladolid,expenses,water,-37.33,3246.1
buyer_6,Manuel,Díez,1979-02-14,43668965S,manuel.díez@extremetech.io,146712,ES97209541159222930896,1625.21,2022-01-05T20:48:23,Valladolid,expenses,electricity,-85.49,3160.61
buyer_6,Manuel,Díez,1979-02-14,43668965S,manuel.díez@extremetech.io,146712,ES97209541159222930896,1625.21,2022-01-05T08:26:32,Valladolid,expenses,phone,-51.22,3109.39
buyer_6,Manuel,Díez,1979-02-14,43668965S,manuel.díez@extremetech.io,146712,ES97209541159222930896,1625.21,2022-01-06T20:19:00,Valladolid,expenses,water,-61.78,3047.61
buyer_6,Manuel,Díez,1979-02-14,43668965S,manuel.díez@extremetech.io,146712,ES97209541159222930896,1625.21,2022-01-06T15:04:45,Valladolid,expenses,transport,-86.03,2961.58
buyer_6,Manuel,Díez,1979-02-14,43668965S,manuel.díez@extremetech.io,146712,ES97209541159222930896,1625.21,2022-01-07T17:34:33,Valladolid,expenses,water,-42.02,2919.56
buyer_6,Manuel,Díez,1979-02-14,43668965S,manuel.díez@extremetech.io,146712,ES97209541159222930896,1625.21,2022-01-07T12:03:15,Valladolid,expenses,leisure,-57.45,2862.11
buyer_6,Manuel,Díez,1979-02-14,43668965S,manuel.díez@extremetech.io,146712,ES97209541159222930896,1625.21,2022-01-07T14:42:18,Valladolid,expenses,travel,-422.21,2439.9
buyer_6,Manuel,Díez,1979-02-14,43668965S,manuel.díez@extremetech.io,146712,ES97209541159222930896,1625.21,2022-01-08T20:00:57,Valladolid,expenses,internet,-62.5,2377.4
buyer_6,Manuel,Díez,1979-02-14,43668965S,manuel.díez@extremetech.io,146712,ES97209541159222930896,1625.21,2022-01-08T02:26:19,Valladolid,expenses,gifts,-314.14,2063.26
buyer_6,Manuel,Díez,1979-02-14,43668965S,manuel.díez@extremetech.io,146712,ES97209541159222930896,1625.21,2022-01-09T12:57:26,Valladolid,expenses,transport,-77.37,1985.89
buyer_6,Manuel,Díez,1979-02-14,43668965S,manuel.díez@extremetech.io,146712,ES97209541159222930896,1625.21,2022-01-09T08:33:43,Valladolid,expenses,healthcare,-41.88,1944.01
buyer_6,Manuel,Díez,1979-02-14,43668965S,manuel.díez@extremetech.io,146712,ES97209541159222930896,1625.21,2022-01-09T09:10:43,Valladolid,expenses,cash,-100.0,1844.01
buyer_6,Manuel,Díez,1979-02-14,43668965S,manuel.díez@extremetech.io,146712,ES97209541159222930896,1625.21,2022-01-10T10:48:06,Valladolid,expenses,leisure,-56.1,1787.91
buyer_6,Manuel,Díez,1979-02-14,43668965S,manuel.díez@extremetech.io,146712,ES97209541159222930896,1625.21,2022-01-11T21:18:04,Valladolid,expenses,food,-86.52,1701.39
buyer_6,Manuel,Díez,1979-02-14,43668965S,manuel.díez@extremetech.io,146712,ES97209541159222930896,1625.21,2022-01-13T18:46:38,Valladolid,expenses,gifts,-769.66,931.73
buyer_6,Manuel,Díez,1979-02-14,43668965S,manuel.díez@extremetech.io,146712,ES97209541159222930896,1625.21,2022-01-14T16:36:22,Valladolid,expenses,food,-104.81,826.92
buyer_6,Manuel,Díez,1979-02-14,43668965S,manuel.díez@extremetech.io,146712,ES97209541159222930896,1625.21,2022-01-14T14:17:39,Valladolid,expenses,repairs,-242.04,584.88
buyer_6,Manuel,Díez,1979-02-14,43668965S,manuel.díez@extremetech.io,146712,ES97209541159222930896,1625.21,2022-01-16T20:06:11,Valladolid,expenses,gifts,-307.53,277.35
buyer_6,Manuel,Díez,1979-02-14,43668965S,manuel.díez@extremetech.io,146712,ES97209541159222930896,1625.21,2022-01-17T12:16:47,Valladolid,expenses,leisure,-31.01,246.34
buyer_6,Manuel,Díez,1979-02-14,43668965S,manuel.díez@extremetech.io,146712,ES97209541159222930896,1625.21,2022-01-19T14:28:37,Valladolid,expenses,transport,-62.29,184.05
buyer_6,Manuel,Díez,1979-02-14,43668965S,manuel.díez@extremetech.io,146712,ES97209541159222930896,1625.21,2022-01-19T15:00:10,Valladolid,expenses,cash,-100.0,84.05
buyer_6,Manuel,Díez,1979-02-14,43668965S,manuel.díez@extremetech.io,146712,ES97209541159222930896,1625.21,2022-01-20T19:53:42,Valladolid,expenses,appliances,-178.95,-94.9
buyer_6,Manuel,Díez,1979-02-14,43668965S,manuel.díez@extremetech.io,146712,ES97209541159222930896,1625.21,2022-01-20T13:00:50,Valladolid,expenses,gifts,-74.15,-169.05
buyer_6,Manuel,Díez,1979-02-14,43668965S,manuel.díez@extremetech.io,146712,ES97209541159222930896,1625.21,2022-01-21T17:29:01,Valladolid,expenses,gifts,-150.58,-319.63
buyer_6,Manuel,Díez,1979-02-14,43668965S,manuel.díez@extremetech.io,146712,ES97209541159222930896,1625.21,2022-01-24T11:58:01,Valladolid,expenses,transport,-62.16,-381.79
buyer_6,Manuel,Díez,1979-02-14,43668965S,manuel.díez@extremetech.io,146712,ES97209541159222930896,1625.21,2022-01-25T10:42:46,Valladolid,expenses,food,-103.07,-484.86
buyer_6,Manuel,Díez,1979-02-14,43668965S,manuel.díez@extremetech.io,146712,ES97209541159222930896,1625.21,2022-01-25T20:46:23,Valladolid,expenses,gifts,-361.73,-846.59
buyer_6,Manuel,Díez,1979-02-14,43668965S,manuel.díez@extremetech.io,146712,ES97209541159222930896,1625.21,2022-01-28T09:52:46,Valladolid,expenses,healthcare,-56.89,-903.48
buyer_6,Manuel,Díez,1979-02-14,43668965S,manuel.díez@extremetech.io,146712,ES97209541159222930896,1625.21,2022-01-28T23:09:42,Valladolid,expenses,cash,-100.0,-1003.48
buyer_6,Manuel,Díez,1979-02-14,43668965S,manuel.díez@extremetech.io,146712,ES97209541159222930896,1625.21,2022-01-30T20:30:47,Valladolid,expenses,food,-108.43,-1111.91
buyer_6,Manuel,Díez,1979-02-14,43668965S,manuel.díez@extremetech.io,146712,ES97209541159222930896,1625.21,2022-01-31T13:55:27,Valladolid,expenses,leisure,-48.62,-1160.53
buyer_6,Manuel,Díez,1979-02-14,43668965S,manuel.díez@extremetech.io,146712,ES97209541159222930896,1625.21,2022-02-01T11:03:35,Valladolid,incomes,salary,2976.14,1815.61
buyer_6,Manuel,Díez,1979-02-14,43668965S,manuel.díez@extremetech.io,146712,ES97209541159222930896,1625.21,2022-02-02T23:41:14,Valladolid,expenses,food,-66.81,1748.8
buyer_6,Manuel,Díez,1979-02-14,43668965S,manuel.díez@extremetech.io,146712,ES97209541159222930896,1625.21,2022-02-04T19:29:55,Valladolid,expenses,leisure,-33.48,1715.32
buyer_6,Manuel,Díez,1979-02-14,43668965S,manuel.díez@extremetech.io,146712,ES97209541159222930896,1625.21,2022-02-04T18:31:48,Valladolid,expenses,cash,-100.0,1615.32
buyer_6,Manuel,Díez,1979-02-14,43668965S,manuel.díez@extremetech.io,146712,ES97209541159222930896,1625.21,2022-02-05T18:12:53,Valladolid,expenses,mortgage,-1147.51,467.81
buyer_6,Manuel,Díez,1979-02-14,43668965S,manuel.díez@extremetech.io,146712,ES97209541159222930896,1625.21,2022-02-05T01:13:13,Valladolid,expenses,water,-33.92,433.89
buyer_6,Manuel,Díez,1979-02-14,43668965S,manuel.díez@extremetech.io,146712,ES97209541159222930896,1625.21,2022-02-05T12:11:05,Valladolid,expenses,internet,-62.5,371.39
buyer_6,Manuel,Díez,1979-02-14,43668965S,manuel.díez@extremetech.io,146712,ES97209541159222930896,1625.21,2022-02-06T21:40:16,Valladolid,expenses,electricity,-54.91,316.48
buyer_6,Manuel,Díez,1979-02-14,43668965S,manuel.díez@extremetech.io,146712,ES97209541159222930896,1625.21,2022-02-06T13:04:33,Valladolid,expenses,gas,-80.4,236.08
buyer_6,Manuel,Díez,1979-02-14,43668965S,manuel.díez@extremetech.io,146712,ES97209541159222930896,1625.21,2022-02-07T10:02:39,Valladolid,expenses,water,-63.82,172.26
buyer_6,Manuel,Díez,1979-02-14,43668965S,manuel.díez@extremetech.io,146712,ES97209541159222930896,1625.21,2022-02-07T14:12:17,Valladolid,expenses,phone,-62.83,109.43
buyer_6,Manuel,Díez,1979-02-14,43668965S,manuel.díez@extremetech.io,146712,ES97209541159222930896,1625.21,2022-02-08T00:52:47,Valladolid,expenses,water,-61.03,48.4
buyer_6,Manuel,Díez,1979-02-14,43668965S,manuel.díez@extremetech.io,146712,ES97209541159222930896,1625.21,2022-02-08T13:08:32,Valladolid,expenses,food,-84.56,-36.16
buyer_6,Manuel,Díez,1979-02-14,43668965S,manuel.díez@extremetech.io,146712,ES97209541159222930896,1625.21,2022-02-08T15:26:09,Valladolid,expenses,transport,-69.23,-105.39
buyer_6,Manuel,Díez,1979-02-14,43668965S,manuel.díez@extremetech.io,146712,ES97209541159222930896,1625.21,2022-02-08T13:14:34,Valladolid,expenses,leisure,-73.17,-178.56
buyer_6,Manuel,Díez,1979-02-14,43668965S,manuel.díez@extremetech.io,146712,ES97209541159222930896,1625.21,2022-02-08T16:37:55,Valladolid,expenses,education,-68.82,-247.38
buyer_6,Manuel,Díez,1979-02-14,43668965S,manuel.díez@extremetech.io,146712,ES97209541159222930896,1625.21,2022-02-09T15:05:45,Valladolid,expenses,transport,-67.23,-314.61
buyer_6,Manuel,Díez,1979-02-14,43668965S,manuel.díez@extremetech.io,146712,ES97209541159222930896,1625.21,2022-02-10T08:09:37,Valladolid,expenses,leisure,-78.55,-393.16
buyer_6,Manuel,Díez,1979-02-14,43668965S,manuel.díez@extremetech.io,146712,ES97209541159222930896,1625.21,2022-02-10T12:43:31,Valladolid,expenses,repairs,-205.4,-598.56
buyer_6,Manuel,Díez,1979-02-14,43668965S,manuel.díez@extremetech.io,146712,ES97209541159222930896,1625.21,2022-02-12T16:39:07,Valladolid,expenses,leisure,-68.16,-666.72
buyer_6,Manuel,Díez,1979-02-14,43668965S,manuel.díez@extremetech.io,146712,ES97209541159222930896,1625.21,2022-02-13T20:51:34,Valladolid,expenses,cash,-100.0,-766.72
buyer_6,Manuel,Díez,1979-02-14,43668965S,manuel.díez@extremetech.io,146712,ES97209541159222930896,1625.21,2022-02-15T09:27:13,Valladolid,expenses,food,-97.62,-864.34
buyer_6,Manuel,Díez,1979-02-14,43668965S,manuel.díez@extremetech.io,146712,ES97209541159222930896,1625.21,2022-02-15T13:47:54,Valladolid,expenses,healthcare,-156.96,-1021.3
buyer_6,Manuel,Díez,1979-02-14,43668965S,manuel.díez@extremetech.io,146712,ES97209541159222930896,1625.21,2022-02-15T20:11:29,Valladolid,expenses,cash,-100.0,-1121.3
buyer_6,Manuel,Díez,1979-02-14,43668965S,manuel.díez@extremetech.io,146712,ES97209541159222930896,1625.21,2022-02-16T10:04:46,Valladolid,expenses,healthcare,-161.34,-1282.64
buyer_6,Manuel,Díez,1979-02-14,43668965S,manuel.díez@extremetech.io,146712,ES97209541159222930896,1625.21,2022-02-17T16:57:42,Valladolid,expenses,food,-98.26,-1380.9
buyer_6,Manuel,Díez,1979-02-14,43668965S,manuel.díez@extremetech.io,146712,ES97209541159222930896,1625.21,2022-02-18T22:55:39,Valladolid,expenses,transport,-54.12,-1435.02
buyer_6,Manuel,Díez,1979-02-14,43668965S,manuel.díez@extremetech.io,146712,ES97209541159222930896,1625.21,2022-02-18T19:57:08,Valladolid,expenses,gifts,-42.22,-1477.24
buyer_6,Manuel,Díez,1979-02-14,43668965S,manuel.díez@extremetech.io,146712,ES97209541159222930896,1625.21,2022-02-19T08:11:09,Valladolid,expenses,clothing,-92.76,-1570.0
buyer_6,Manuel,Díez,1979-02-14,43668965S,manuel.díez@extremetech.io,146712,ES97209541159222930896,1625.21,2022-02-24T13:30:43,Valladolid,expenses,food,-98.45,-1668.45
buyer_6,Manuel,Díez,1979-02-14,43668965S,manuel.díez@extremetech.io,146712,ES97209541159222930896,1625.21,2022-02-24T02:04:15,Valladolid,expenses,clothing,-85.35,-1753.8
buyer_6,Manuel,Díez,1979-02-14,43668965S,manuel.díez@extremetech.io,146712,ES97209541159222930896,1625.21,2022-02-27T08:37:49,Valladolid,expenses,leisure,-38.81,-1792.61
buyer_6,Manuel,Díez,1979-02-14,43668965S,manuel.díez@extremetech.io,146712,ES97209541159222930896,1625.21,2022-03-01T19:47:16,Valladolid,incomes,salary,2976.14,1183.53
buyer_6,Manuel,Díez,1979-02-14,43668965S,manuel.díez@extremetech.io,146712,ES97209541159222930896,1625.21,2022-03-02T05:01:32,Valladolid,expenses,leisure,-58.29,1125.24
buyer_6,Manuel,Díez,1979-02-14,43668965S,manuel.díez@extremetech.io,146712,ES97209541159222930896,1625.21,2022-03-05T15:37:35,Valladolid,expenses,mortgage,-1147.51,-22.27
buyer_6,Manuel,Díez,1979-02-14,43668965S,manuel.díez@extremetech.io,146712,ES97209541159222930896,1625.21,2022-03-05T15:56:30,Valladolid,expenses,phone,-66.8,-89.07
buyer_6,Manuel,Díez,1979-02-14,43668965S,manuel.díez@extremetech.io,146712,ES97209541159222930896,1625.21,2022-03-05T13:43:25,Valladolid,expenses,clothing,-107.98,-197.05
buyer_6,Manuel,Díez,1979-02-14,43668965S,manuel.díez@extremetech.io,146712,ES97209541159222930896,1625.21,2022-03-06T08:45:02,Valladolid,expenses,water,-41.03,-238.08
buyer_6,Manuel,Díez,1979-02-14,43668965S,manuel.díez@extremetech.io,146712,ES97209541159222930896,1625.21,2022-03-07T20:22:57,Valladolid,expenses,water,-40.91,-278.99
buyer_6,Manuel,Díez,1979-02-14,43668965S,manuel.díez@extremetech.io,146712,ES97209541159222930896,1625.21,2022-03-07T13:29:42,Valladolid,expenses,gifts,-477.89,-756.88
buyer_6,Manuel,Díez,1979-02-14,43668965S,manuel.díez@extremetech.io,146712,ES97209541159222930896,1625.21,2022-03-08T16:39:05,Valladolid,expenses,clothing,-124.01,-880.89
buyer_6,Manuel,Díez,1979-02-14,43668965S,manuel.díez@extremetech.io,146712,ES97209541159222930896,1625.21,2022-03-09T23:33:31,Valladolid,expenses,food,-93.48,-974.37
buyer_6,Manuel,Díez,1979-02-14,43668965S,manuel.díez@extremetech.io,146712,ES97209541159222930896,1625.21,2022-03-09T13:47:29,Valladolid,expenses,education,-46.65,-1021.02
buyer_6,Manuel,Díez,1979-02-14,43668965S,manuel.díez@extremetech.io,146712,ES97209541159222930896,1625.21,2022-03-09T17:55:58,Valladolid,expenses,repairs,-291.18,-1312.2
buyer_6,Manuel,Díez,1979-02-14,43668965S,manuel.díez@extremetech.io,146712,ES97209541159222930896,1625.21,2022-03-10T10:40:37,Valladolid,expenses,food,-115.23,-1427.43
buyer_6,Manuel,Díez,1979-02-14,43668965S,manuel.díez@extremetech.io,146712,ES97209541159222930896,1625.21,2022-03-12T13:35:42,Valladolid,expenses,transport,-50.29,-1477.72
buyer_6,Manuel,Díez,1979-02-14,43668965S,manuel.díez@extremetech.io,146712,ES97209541159222930896,1625.21,2022-03-13T16:39:18,Valladolid,expenses,healthcare,-176.58,-1654.3
buyer_6,Manuel,Díez,1979-02-14,43668965S,manuel.díez@extremetech.io,146712,ES97209541159222930896,1625.21,2022-03-14T15:14:48,Valladolid,expenses,leisure,-30.23,-1684.53
buyer_6,Manuel,Díez,1979-02-14,43668965S,manuel.díez@extremetech.io,146712,ES97209541159222930896,1625.21,2022-03-14T08:58:53,Valladolid,expenses,gifts,-642.93,-2327.46
buyer_6,Manuel,Díez,1979-02-14,43668965S,manuel.díez@extremetech.io,146712,ES97209541159222930896,1625.21,2022-03-17T11:12:50,Valladolid,expenses,cash,-100.0,-2427.46
buyer_6,Manuel,Díez,1979-02-14,43668965S,manuel.díez@extremetech.io,146712,ES97209541159222930896,1625.21,2022-03-18T19:37:25,Valladolid,expenses,cash,-100.0,-2527.46
buyer_6,Manuel,Díez,1979-02-14,43668965S,manuel.díez@extremetech.io,146712,ES97209541159222930896,1625.21,2022-03-20T16:35:05,Valladolid,expenses,cash,-100.0,-2627.46
buyer_6,Manuel,Díez,1979-02-14,43668965S,manuel.díez@extremetech.io,146712,ES97209541159222930896,1625.21,2022-03-21T12:40:52,Valladolid,expenses,healthcare,-39.54,-2667.0
buyer_6,Manuel,Díez,1979-02-14,43668965S,manuel.díez@extremetech.io,146712,ES97209541159222930896,1625.21,2022-03-24T17:21:42,Valladolid,expenses,food,-116.5,-2783.5
buyer_6,Manuel,Díez,1979-02-14,43668965S,manuel.díez@extremetech.io,146712,ES97209541159222930896,1625.21,2022-03-24T11:57:54,Valladolid,expenses,cash,-100.0,-2883.5
buyer_6,Manuel,Díez,1979-02-14,43668965S,manuel.díez@extremetech.io,146712,ES97209541159222930896,1625.21,2022-03-28T15:56:57,Valladolid,expenses,transport,-77.38,-2960.88
buyer_6,Manuel,Díez,1979-02-14,43668965S,manuel.díez@extremetech.io,146712,ES97209541159222930896,1625.21,2022-03-30T17:28:30,Valladolid,expenses,cash,-100.0,-3060.88
buyer_6,Manuel,Díez,1979-02-14,43668965S,manuel.díez@extremetech.io,146712,ES97209541159222930896,1625.21,2022-04-01T12:38:06,Valladolid,incomes,salary,2976.14,-84.74
buyer_6,Manuel,Díez,1979-02-14,43668965S,manuel.díez@extremetech.io,146712,ES97209541159222930896,1625.21,2022-04-01T12:38:06,Valladolid,incomes,extra_income,330.25,245.51
buyer_6,Manuel,Díez,1979-02-14,43668965S,manuel.díez@extremetech.io,146712,ES97209541159222930896,1625.21,2022-04-01T20:49:26,Valladolid,expenses,leisure,-83.03,162.48
buyer_6,Manuel,Díez,1979-02-14,43668965S,manuel.díez@extremetech.io,146712,ES97209541159222930896,1625.21,2022-04-02T18:24:46,Valladolid,expenses,leisure,-26.55,135.93
buyer_6,Manuel,Díez,1979-02-14,43668965S,manuel.díez@extremetech.io,146712,ES97209541159222930896,1625.21,2022-04-03T13:55:34,Valladolid,expenses,cash,-100.0,35.93
buyer_6,Manuel,Díez,1979-02-14,43668965S,manuel.díez@extremetech.io,146712,ES97209541159222930896,1625.21,2022-04-05T15:25:42,Valladolid,expenses,mortgage,-1147.51,-1111.58
buyer_6,Manuel,Díez,1979-02-14,43668965S,manuel.díez@extremetech.io,146712,ES97209541159222930896,1625.21,2022-04-05T14:00:34,Valladolid,expenses,internet,-62.5,-1174.08
buyer_6,Manuel,Díez,1979-02-14,43668965S,manuel.díez@extremetech.io,146712,ES97209541159222930896,1625.21,2022-04-05T18:42:35,Valladolid,expenses,food,-115.78,-1289.86
buyer_6,Manuel,Díez,1979-02-14,43668965S,manuel.díez@extremetech.io,146712,ES97209541159222930896,1625.21,2022-04-06T08:29:35,Valladolid,expenses,electricity,-90.13,-1379.99
buyer_6,Manuel,Díez,1979-02-14,43668965S,manuel.díez@extremetech.io,146712,ES97209541159222930896,1625.21,2022-04-06T14:33:04,Valladolid,expenses,cash,-100.0,-1479.99
buyer_6,Manuel,Díez,1979-02-14,43668965S,manuel.díez@extremetech.io,146712,ES97209541159222930896,1625.21,2022-04-07T15:53:03,Valladolid,expenses,internet,-62.5,-1542.49
buyer_6,Manuel,Díez,1979-02-14,43668965S,manuel.díez@extremetech.io,146712,ES97209541159222930896,1625.21,2022-04-07T17:54:01,Valladolid,expenses,food,-122.45,-1664.94
buyer_6,Manuel,Díez,1979-02-14,43668965S,manuel.díez@extremetech.io,146712,ES97209541159222930896,1625.21,2022-04-07T13:59:55,Valladolid,expenses,cash,-100.0,-1764.94
buyer_6,Manuel,Díez,1979-02-14,43668965S,manuel.díez@extremetech.io,146712,ES97209541159222930896,1625.21,2022-04-07T20:42:16,Valladolid,expenses,gifts,-260.13,-2025.07
buyer_6,Manuel,Díez,1979-02-14,43668965S,manuel.díez@extremetech.io,146712,ES97209541159222930896,1625.21,2022-04-09T09:28:29,Valladolid,expenses,education,-45.7,-2070.77
buyer_6,Manuel,Díez,1979-02-14,43668965S,manuel.díez@extremetech.io,146712,ES97209541159222930896,1625.21,2022-04-10T12:41:16,Valladolid,expenses,gifts,-304.17,-2374.94
buyer_6,Manuel,Díez,1979-02-14,43668965S,manuel.díez@extremetech.io,146712,ES97209541159222930896,1625.21,2022-04-12T10:32:14,Valladolid,expenses,repairs,-332.25,-2707.19
buyer_6,Manuel,Díez,1979-02-14,43668965S,manuel.díez@extremetech.io,146712,ES97209541159222930896,1625.21,2022-04-13T13:41:53,Valladolid,expenses,cash,-100.0,-2807.19
buyer_6,Manuel,Díez,1979-02-14,43668965S,manuel.díez@extremetech.io,146712,ES97209541159222930896,1625.21,2022-04-15T09:33:30,Valladolid,expenses,transport,-84.47,-2891.66
buyer_6,Manuel,Díez,1979-02-14,43668965S,manuel.díez@extremetech.io,146712,ES97209541159222930896,1625.21,2022-04-19T18:33:52,Valladolid,expenses,cash,-100.0,-2991.66
buyer_6,Manuel,Díez,1979-02-14,43668965S,manuel.díez@extremetech.io,146712,ES97209541159222930896,1625.21,2022-04-21T19:41:21,Valladolid,expenses,healthcare,-105.52,-3097.18
buyer_6,Manuel,Díez,1979-02-14,43668965S,manuel.díez@extremetech.io,146712,ES97209541159222930896,1625.21,2022-04-22T19:41:54,Valladolid,expenses,transport,-86.21,-3183.39
buyer_6,Manuel,Díez,1979-02-14,43668965S,manuel.díez@extremetech.io,146712,ES97209541159222930896,1625.21,2022-04-22T12:35:54,Valladolid,expenses,gifts,-418.56,-3601.95
buyer_6,Manuel,Díez,1979-02-14,43668965S,manuel.díez@extremetech.io,146712,ES97209541159222930896,1625.21,2022-04-23T10:55:59,Valladolid,expenses,food,-81.41,-3683.36
buyer_6,Manuel,Díez,1979-02-14,43668965S,manuel.díez@extremetech.io,146712,ES97209541159222930896,1625.21,2022-04-23T15:02:46,Valladolid,expenses,appliances,-293.59,-3976.95
buyer_6,Manuel,Díez,1979-02-14,43668965S,manuel.díez@extremetech.io,146712,ES97209541159222930896,1625.21,2022-04-24T13:07:04,Valladolid,expenses,clothing,-79.16,-4056.11
buyer_6,Manuel,Díez,1979-02-14,43668965S,manuel.díez@extremetech.io,146712,ES97209541159222930896,1625.21,2022-04-27T02:17:09,Valladolid,expenses,cash,-100.0,-4156.11
buyer_6,Manuel,Díez,1979-02-14,43668965S,manuel.díez@extremetech.io,146712,ES97209541159222930896,1625.21,2022-04-29T15:08:40,Valladolid,expenses,repairs,-156.17,-4312.28
buyer_6,Manuel,Díez,1979-02-14,43668965S,manuel.díez@extremetech.io,146712,ES97209541159222930896,1625.21,2022-04-30T23:10:43,Valladolid,expenses,leisure,-33.04,-4345.32
buyer_6,Manuel,Díez,1979-02-14,43668965S,manuel.díez@extremetech.io,146712,ES97209541159222930896,1625.21,2022-05-01T09:04:49,Valladolid,incomes,salary,2976.14,-1369.18
buyer_6,Manuel,Díez,1979-02-14,43668965S,manuel.díez@extremetech.io,146712,ES97209541159222930896,1625.21,2022-05-05T08:07:55,Valladolid,expenses,mortgage,-1147.51,-2516.69
buyer_6,Manuel,Díez,1979-02-14,43668965S,manuel.díez@extremetech.io,146712,ES97209541159222930896,1625.21,2022-05-05T20:03:14,Valladolid,expenses,water,-33.73,-2550.42
buyer_6,Manuel,Díez,1979-02-14,43668965S,manuel.díez@extremetech.io,146712,ES97209541159222930896,1625.21,2022-05-05T08:03:21,Valladolid,expenses,gas,-95.44,-2645.86
buyer_6,Manuel,Díez,1979-02-14,43668965S,manuel.díez@extremetech.io,146712,ES97209541159222930896,1625.21,2022-05-05T11:17:27,Valladolid,expenses,phone,-47.54,-2693.4
buyer_6,Manuel,Díez,1979-02-14,43668965S,manuel.díez@extremetech.io,146712,ES97209541159222930896,1625.21,2022-05-06T10:52:44,Valladolid,expenses,electricity,-113.32,-2806.72
buyer_6,Manuel,Díez,1979-02-14,43668965S,manuel.díez@extremetech.io,146712,ES97209541159222930896,1625.21,2022-05-06T20:37:04,Valladolid,expenses,internet,-62.5,-2869.22
buyer_6,Manuel,Díez,1979-02-14,43668965S,manuel.díez@extremetech.io,146712,ES97209541159222930896,1625.21,2022-05-07T12:17:11,Valladolid,expenses,electricity,-97.69,-2966.91
buyer_6,Manuel,Díez,1979-02-14,43668965S,manuel.díez@extremetech.io,146712,ES97209541159222930896,1625.21,2022-05-07T10:05:48,Valladolid,expenses,repairs,-229.45,-3196.36
buyer_6,Manuel,Díez,1979-02-14,43668965S,manuel.díez@extremetech.io,146712,ES97209541159222930896,1625.21,2022-05-08T00:33:54,Valladolid,expenses,water,-60.39,-3256.75
buyer_6,Manuel,Díez,1979-02-14,43668965S,manuel.díez@extremetech.io,146712,ES97209541159222930896,1625.21,2022-05-08T18:46:21,Valladolid,expenses,gas,-150.28,-3407.03
buyer_6,Manuel,Díez,1979-02-14,43668965S,manuel.díez@extremetech.io,146712,ES97209541159222930896,1625.21,2022-05-10T11:54:19,Valladolid,expenses,leisure,-49.95,-3456.98
buyer_6,Manuel,Díez,1979-02-14,43668965S,manuel.díez@extremetech.io,146712,ES97209541159222930896,1625.21,2022-05-12T12:41:41,Valladolid,expenses,leisure,-21.45,-3478.43
buyer_6,Manuel,Díez,1979-02-14,43668965S,manuel.díez@extremetech.io,146712,ES97209541159222930896,1625.21,2022-05-13T20:07:19,Valladolid,expenses,gifts,-291.3,-3769.73
buyer_6,Manuel,Díez,1979-02-14,43668965S,manuel.díez@extremetech.io,146712,ES97209541159222930896,1625.21,2022-05-15T13:14:27,Valladolid,expenses,leisure,-19.84,-3789.57
buyer_6,Manuel,Díez,1979-02-14,43668965S,manuel.díez@extremetech.io,146712,ES97209541159222930896,1625.21,2022-05-15T14:25:07,Valladolid,expenses,cash,-100.0,-3889.57
buyer_6,Manuel,Díez,1979-02-14,43668965S,manuel.díez@extremetech.io,146712,ES97209541159222930896,1625.21,2022-05-17T10:52:39,Valladolid,expenses,transport,-40.82,-3930.39
buyer_6,Manuel,Díez,1979-02-14,43668965S,manuel.díez@extremetech.io,146712,ES97209541159222930896,1625.21,2022-05-17T09:07:04,Valladolid,expenses,education,-71.38,-4001.77
buyer_6,Manuel,Díez,1979-02-14,43668965S,manuel.díez@extremetech.io,146712,ES97209541159222930896,1625.21,2022-05-17T17:37:50,Valladolid,expenses,cash,-100.0,-4101.77
buyer_6,Manuel,Díez,1979-02-14,43668965S,manuel.díez@extremetech.io,146712,ES97209541159222930896,1625.21,2022-05-19T21:00:39,Valladolid,expenses,repairs,-291.47,-4393.24
buyer_6,Manuel,Díez,1979-02-14,43668965S,manuel.díez@extremetech.io,146712,ES97209541159222930896,1625.21,2022-05-20T09:30:36,Valladolid,expenses,leisure,-29.67,-4422.91
buyer_6,Manuel,Díez,1979-02-14,43668965S,manuel.díez@extremetech.io,146712,ES97209541159222930896,1625.21,2022-05-26T08:51:56,Valladolid,expenses,food,-76.58,-4499.49
buyer_6,Manuel,Díez,1979-02-14,43668965S,manuel.díez@extremetech.io,146712,ES97209541159222930896,1625.21,2022-05-30T15:16:51,Valladolid,expenses,cash,-100.0,-4599.49
buyer_6,Manuel,Díez,1979-02-14,43668965S,manuel.díez@extremetech.io,146712,ES97209541159222930896,1625.21,2022-05-31T00:47:41,Valladolid,expenses,leisure,-49.56,-4649.05
buyer_6,Manuel,Díez,1979-02-14,43668965S,manuel.díez@extremetech.io,146712,ES97209541159222930896,1625.21,2022-05-31T15:26:16,Valladolid,expenses,education,-59.14,-4708.19
buyer_6,Manuel,Díez,1979-02-14,43668965S,manuel.díez@extremetech.io,146712,ES97209541159222930896,1625.21,2022-06-01T12:39:48,Valladolid,incomes,salary,2976.14,-1732.05
buyer_6,Manuel,Díez,1979-02-14,43668965S,manuel.díez@extremetech.io,146712,ES97209541159222930896,1625.21,2022-06-01T12:39:48,Valladolid,incomes,salary_bonus,2162.97,430.92
buyer_6,Manuel,Díez,1979-02-14,43668965S,manuel.díez@extremetech.io,146712,ES97209541159222930896,1625.21,2022-06-01T08:21:52,Valladolid,expenses,food,-119.68,311.24
buyer_6,Manuel,Díez,1979-02-14,43668965S,manuel.díez@extremetech.io,146712,ES97209541159222930896,1625.21,2022-06-01T12:55:20,Valladolid,expenses,repairs,-86.92,224.32
buyer_6,Manuel,Díez,1979-02-14,43668965S,manuel.díez@extremetech.io,146712,ES97209541159222930896,1625.21,2022-06-03T10:01:59,Valladolid,expenses,repairs,-242.75,-18.43
buyer_6,Manuel,Díez,1979-02-14,43668965S,manuel.díez@extremetech.io,146712,ES97209541159222930896,1625.21,2022-06-04T08:21:11,Valladolid,expenses,taxes,-1824.71,-1843.14
buyer_6,Manuel,Díez,1979-02-14,43668965S,manuel.díez@extremetech.io,146712,ES97209541159222930896,1625.21,2022-06-04T12:22:59,Valladolid,expenses,insurance,-877.69,-2720.83
buyer_6,Manuel,Díez,1979-02-14,43668965S,manuel.díez@extremetech.io,146712,ES97209541159222930896,1625.21,2022-06-05T20:30:11,Valladolid,expenses,mortgage,-1147.51,-3868.34
buyer_6,Manuel,Díez,1979-02-14,43668965S,manuel.díez@extremetech.io,146712,ES97209541159222930896,1625.21,2022-06-05T10:37:00,Valladolid,expenses,food,-124.75,-3993.09
buyer_6,Manuel,Díez,1979-02-14,43668965S,manuel.díez@extremetech.io,146712,ES97209541159222930896,1625.21,2022-06-06T20:04:43,Valladolid,expenses,phone,-46.49,-4039.58
buyer_6,Manuel,Díez,1979-02-14,43668965S,manuel.díez@extremetech.io,146712,ES97209541159222930896,1625.21,2022-06-07T12:52:42,Valladolid,expenses,electricity,-123.4,-4162.98
buyer_6,Manuel,Díez,1979-02-14,43668965S,manuel.díez@extremetech.io,146712,ES97209541159222930896,1625.21,2022-06-07T07:43:31,Valladolid,expenses,internet,-62.5,-4225.48
buyer_6,Manuel,Díez,1979-02-14,43668965S,manuel.díez@extremetech.io,146712,ES97209541159222930896,1625.21,2022-06-07T11:41:57,Valladolid,expenses,phone,-55.17,-4280.65
buyer_6,Manuel,Díez,1979-02-14,43668965S,manuel.díez@extremetech.io,146712,ES97209541159222930896,1625.21,2022-06-07T14:52:52,Valladolid,expenses,clothing,-73.09,-4353.74
buyer_6,Manuel,Díez,1979-02-14,43668965S,manuel.díez@extremetech.io,146712,ES97209541159222930896,1625.21,2022-06-07T13:19:07,Valladolid,expenses,gifts,-763.86,-5117.6
buyer_6,Manuel,Díez,1979-02-14,43668965S,manuel.díez@extremetech.io,146712,ES97209541159222930896,1625.21,2022-06-08T09:54:24,Valladolid,expenses,water,-65.1,-5182.7
buyer_6,Manuel,Díez,1979-02-14,43668965S,manuel.díez@extremetech.io,146712,ES97209541159222930896,1625.21,2022-06-08T08:47:23,Valladolid,expenses,gas,-168.35,-5351.05
buyer_6,Manuel,Díez,1979-02-14,43668965S,manuel.díez@extremetech.io,146712,ES97209541159222930896,1625.21,2022-06-08T17:43:07,Valladolid,expenses,gifts,-218.26,-5569.31
buyer_6,Manuel,Díez,1979-02-14,43668965S,manuel.díez@extremetech.io,146712,ES97209541159222930896,1625.21,2022-06-10T07:07:28,Valladolid,expenses,food,-86.45,-5655.76
buyer_6,Manuel,Díez,1979-02-14,43668965S,manuel.díez@extremetech.io,146712,ES97209541159222930896,1625.21,2022-06-10T13:01:20,Valladolid,expenses,transport,-49.24,-5705.0
buyer_6,Manuel,Díez,1979-02-14,43668965S,manuel.díez@extremetech.io,146712,ES97209541159222930896,1625.21,2022-06-11T22:50:50,Valladolid,expenses,food,-87.69,-5792.69
buyer_6,Manuel,Díez,1979-02-14,43668965S,manuel.díez@extremetech.io,146712,ES97209541159222930896,1625.21,2022-06-17T10:07:07,Valladolid,expenses,repairs,-179.25,-5971.94
buyer_6,Manuel,Díez,1979-02-14,43668965S,manuel.díez@extremetech.io,146712,ES97209541159222930896,1625.21,2022-06-18T17:30:52,Valladolid,expenses,cash,-100.0,-6071.94
buyer_6,Manuel,Díez,1979-02-14,43668965S,manuel.díez@extremetech.io,146712,ES97209541159222930896,1625.21,2022-06-20T21:22:22,Valladolid,expenses,food,-108.11,-6180.05
buyer_6,Manuel,Díez,1979-02-14,43668965S,manuel.díez@extremetech.io,146712,ES97209541159222930896,1625.21,2022-06-21T09:14:21,Valladolid,expenses,cash,-100.0,-6280.05
buyer_6,Manuel,Díez,1979-02-14,43668965S,manuel.díez@extremetech.io,146712,ES97209541159222930896,1625.21,2022-06-22T15:51:04,Valladolid,expenses,cash,-100.0,-6380.05
buyer_6,Manuel,Díez,1979-02-14,43668965S,manuel.díez@extremetech.io,146712,ES97209541159222930896,1625.21,2022-06-22T20:20:11,Valladolid,expenses,repairs,-109.3,-6489.35
buyer_6,Manuel,Díez,1979-02-14,43668965S,manuel.díez@extremetech.io,146712,ES97209541159222930896,1625.21,2022-06-24T13:45:24,Valladolid,expenses,appliances,-255.33,-6744.68
buyer_6,Manuel,Díez,1979-02-14,43668965S,manuel.díez@extremetech.io,146712,ES97209541159222930896,1625.21,2022-06-26T17:11:26,Valladolid,expenses,gifts,-849.56,-7594.24
buyer_6,Manuel,Díez,1979-02-14,43668965S,manuel.díez@extremetech.io,146712,ES97209541159222930896,1625.21,2022-06-28T11:30:52,Valladolid,expenses,leisure,-63.19,-7657.43
buyer_6,Manuel,Díez,1979-02-14,43668965S,manuel.díez@extremetech.io,146712,ES97209541159222930896,1625.21,2022-07-01T13:22:58,Valladolid,incomes,salary,2976.14,-4681.29
buyer_6,Manuel,Díez,1979-02-14,43668965S,manuel.díez@extremetech.io,146712,ES97209541159222930896,1625.21,2022-07-01T13:22:58,Valladolid,incomes,extra_income,330.25,-4351.04
buyer_6,Manuel,Díez,1979-02-14,43668965S,manuel.díez@extremetech.io,146712,ES97209541159222930896,1625.21,2022-07-01T10:26:19,Valladolid,expenses,food,-90.09,-4441.13
buyer_6,Manuel,Díez,1979-02-14,43668965S,manuel.díez@extremetech.io,146712,ES97209541159222930896,1625.21,2022-07-02T02:33:05,Valladolid,expenses,leisure,-73.42,-4514.55
buyer_6,Manuel,Díez,1979-02-14,43668965S,manuel.díez@extremetech.io,146712,ES97209541159222930896,1625.21,2022-07-03T20:14:56,Valladolid,expenses,leisure,-26.06,-4540.61
buyer_6,Manuel,Díez,1979-02-14,43668965S,manuel.díez@extremetech.io,146712,ES97209541159222930896,1625.21,2022-07-03T16:41:47,Valladolid,expenses,repairs,-111.74,-4652.35
buyer_6,Manuel,Díez,1979-02-14,43668965S,manuel.díez@extremetech.io,146712,ES97209541159222930896,1625.21,2022-07-05T17:38:52,Valladolid,expenses,mortgage,-1147.51,-5799.86
buyer_6,Manuel,Díez,1979-02-14,43668965S,manuel.díez@extremetech.io,146712,ES97209541159222930896,1625.21,2022-07-05T17:23:29,Valladolid,expenses,water,-34.08,-5833.94
buyer_6,Manuel,Díez,1979-02-14,43668965S,manuel.díez@extremetech.io,146712,ES97209541159222930896,1625.21,2022-07-05T17:40:49,Valladolid,expenses,food,-74.37,-5908.31
buyer_6,Manuel,Díez,1979-02-14,43668965S,manuel.díez@extremetech.io,146712,ES97209541159222930896,1625.21,2022-07-05T20:31:16,Valladolid,expenses,transport,-81.54,-5989.85
buyer_6,Manuel,Díez,1979-02-14,43668965S,manuel.díez@extremetech.io,146712,ES97209541159222930896,1625.21,2022-07-05T18:25:40,Valladolid,expenses,healthcare,-138.39,-6128.24
buyer_6,Manuel,Díez,1979-02-14,43668965S,manuel.díez@extremetech.io,146712,ES97209541159222930896,1625.21,2022-07-06T13:23:56,Valladolid,expenses,food,-91.51,-6219.75
buyer_6,Manuel,Díez,1979-02-14,43668965S,manuel.díez@extremetech.io,146712,ES97209541159222930896,1625.21,2022-07-06T11:37:03,Valladolid,expenses,leisure,-27.75,-6247.5
buyer_6,Manuel,Díez,1979-02-14,43668965S,manuel.díez@extremetech.io,146712,ES97209541159222930896,1625.21,2022-07-07T21:02:29,Valladolid,expenses,electricity,-45.44,-6292.94
buyer_6,Manuel,Díez,1979-02-14,43668965S,manuel.díez@extremetech.io,146712,ES97209541159222930896,1625.21,2022-07-07T13:02:29,Valladolid,expenses,gas,-165.61,-6458.55
buyer_6,Manuel,Díez,1979-02-14,43668965S,manuel.díez@extremetech.io,146712,ES97209541159222930896,1625.21,2022-07-07T09:06:06,Valladolid,expenses,internet,-62.5,-6521.05
buyer_6,Manuel,Díez,1979-02-14,43668965S,manuel.díez@extremetech.io,146712,ES97209541159222930896,1625.21,2022-07-08T19:28:26,Valladolid,expenses,internet,-62.5,-6583.55
buyer_6,Manuel,Díez,1979-02-14,43668965S,manuel.díez@extremetech.io,146712,ES97209541159222930896,1625.21,2022-07-11T15:55:16,Valladolid,expenses,clothing,-48.49,-6632.04
buyer_6,Manuel,Díez,1979-02-14,43668965S,manuel.díez@extremetech.io,146712,ES97209541159222930896,1625.21,2022-07-12T15:45:15,Valladolid,expenses,food,-76.58,-6708.62
buyer_6,Manuel,Díez,1979-02-14,43668965S,manuel.díez@extremetech.io,146712,ES97209541159222930896,1625.21,2022-07-14T19:28:29,Valladolid,expenses,food,-98.28,-6806.9
buyer_6,Manuel,Díez,1979-02-14,43668965S,manuel.díez@extremetech.io,146712,ES97209541159222930896,1625.21,2022-07-16T14:54:36,Valladolid,expenses,food,-121.46,-6928.36
buyer_6,Manuel,Díez,1979-02-14,43668965S,manuel.díez@extremetech.io,146712,ES97209541159222930896,1625.21,2022-07-16T23:36:51,Valladolid,expenses,transport,-56.94,-6985.3
buyer_6,Manuel,Díez,1979-02-14,43668965S,manuel.díez@extremetech.io,146712,ES97209541159222930896,1625.21,2022-07-18T11:32:33,Valladolid,expenses,cash,-100.0,-7085.3
buyer_6,Manuel,Díez,1979-02-14,43668965S,manuel.díez@extremetech.io,146712,ES97209541159222930896,1625.21,2022-07-19T00:11:54,Valladolid,expenses,food,-92.83,-7178.13
buyer_6,Manuel,Díez,1979-02-14,43668965S,manuel.díez@extremetech.io,146712,ES97209541159222930896,1625.21,2022-07-21T08:21:32,Valladolid,expenses,transport,-74.7,-7252.83
buyer_6,Manuel,Díez,1979-02-14,43668965S,manuel.díez@extremetech.io,146712,ES97209541159222930896,1625.21,2022-07-21T23:42:36,Valladolid,expenses,leisure,-50.31,-7303.14
buyer_6,Manuel,Díez,1979-02-14,43668965S,manuel.díez@extremetech.io,146712,ES97209541159222930896,1625.21,2022-07-21T11:15:21,Valladolid,expenses,cash,-100.0,-7403.14
buyer_6,Manuel,Díez,1979-02-14,43668965S,manuel.díez@extremetech.io,146712,ES97209541159222930896,1625.21,2022-07-24T10:08:28,Valladolid,expenses,travel,-787.09,-8190.23
buyer_6,Manuel,Díez,1979-02-14,43668965S,manuel.díez@extremetech.io,146712,ES97209541159222930896,1625.21,2022-07-27T12:59:27,Valladolid,expenses,transport,-43.78,-8234.01
buyer_6,Manuel,Díez,1979-02-14,43668965S,manuel.díez@extremetech.io,146712,ES97209541159222930896,1625.21,2022-07-27T09:18:03,Valladolid,expenses,leisure,-61.79,-8295.8
buyer_6,Manuel,Díez,1979-02-14,43668965S,manuel.díez@extremetech.io,146712,ES97209541159222930896,1625.21,2022-07-29T16:52:32,Valladolid,expenses,food,-106.23,-8402.03
buyer_6,Manuel,Díez,1979-02-14,43668965S,manuel.díez@extremetech.io,146712,ES97209541159222930896,1625.21,2022-07-29T13:21:35,Valladolid,expenses,gifts,-350.24,-8752.27
buyer_6,Manuel,Díez,1979-02-14,43668965S,manuel.díez@extremetech.io,146712,ES97209541159222930896,1625.21,2022-07-30T10:14:52,Valladolid,expenses,food,-96.79,-8849.06
buyer_6,Manuel,Díez,1979-02-14,43668965S,manuel.díez@extremetech.io,146712,ES97209541159222930896,1625.21,2022-07-31T05:50:14,Valladolid,expenses,education,-72.74,-8921.8
buyer_6,Manuel,Díez,1979-02-14,43668965S,manuel.díez@extremetech.io,146712,ES97209541159222930896,1625.21,2022-08-01T12:55:59,Valladolid,incomes,salary,2976.14,-5945.66
buyer_6,Manuel,Díez,1979-02-14,43668965S,manuel.díez@extremetech.io,146712,ES97209541159222930896,1625.21,2022-08-01T14:52:21,Valladolid,expenses,leisure,-75.97,-6021.63
buyer_6,Manuel,Díez,1979-02-14,43668965S,manuel.díez@extremetech.io,146712,ES97209541159222930896,1625.21,2022-08-03T18:09:37,Valladolid,expenses,leisure,-76.27,-6097.9
buyer_6,Manuel,Díez,1979-02-14,43668965S,manuel.díez@extremetech.io,146712,ES97209541159222930896,1625.21,2022-08-03T13:18:36,Valladolid,expenses,cash,-100.0,-6197.9
buyer_6,Manuel,Díez,1979-02-14,43668965S,manuel.díez@extremetech.io,146712,ES97209541159222930896,1625.21,2022-08-05T13:40:53,Valladolid,expenses,mortgage,-1147.51,-7345.41
buyer_6,Manuel,Díez,1979-02-14,43668965S,manuel.díez@extremetech.io,146712,ES97209541159222930896,1625.21,2022-08-05T23:06:04,Valladolid,expenses,water,-65.12,-7410.53
buyer_6,Manuel,Díez,1979-02-14,43668965S,manuel.díez@extremetech.io,146712,ES97209541159222930896,1625.21,2022-08-06T20:49:55,Valladolid,expenses,gas,-83.64,-7494.17
buyer_6,Manuel,Díez,1979-02-14,43668965S,manuel.díez@extremetech.io,146712,ES97209541159222930896,1625.21,2022-08-06T17:20:58,Valladolid,expenses,internet,-62.5,-7556.67
buyer_6,Manuel,Díez,1979-02-14,43668965S,manuel.díez@extremetech.io,146712,ES97209541159222930896,1625.21,2022-08-07T16:22:04,Valladolid,expenses,water,-65.73,-7622.4
buyer_6,Manuel,Díez,1979-02-14,43668965S,manuel.díez@extremetech.io,146712,ES97209541159222930896,1625.21,2022-08-07T18:46:51,Valladolid,expenses,electricity,-97.27,-7719.67
buyer_6,Manuel,Díez,1979-02-14,43668965S,manuel.díez@extremetech.io,146712,ES97209541159222930896,1625.21,2022-08-07T20:51:55,Valladolid,expenses,food,-119.39,-7839.06
buyer_6,Manuel,Díez,1979-02-14,43668965S,manuel.díez@extremetech.io,146712,ES97209541159222930896,1625.21,2022-08-07T14:31:52,Valladolid,expenses,cash,-100.0,-7939.06
buyer_6,Manuel,Díez,1979-02-14,43668965S,manuel.díez@extremetech.io,146712,ES97209541159222930896,1625.21,2022-08-08T15:48:55,Valladolid,expenses,gas,-91.57,-8030.63
buyer_6,Manuel,Díez,1979-02-14,43668965S,manuel.díez@extremetech.io,146712,ES97209541159222930896,1625.21,2022-08-09T20:16:30,Valladolid,expenses,leisure,-81.42,-8112.05
buyer_6,Manuel,Díez,1979-02-14,43668965S,manuel.díez@extremetech.io,146712,ES97209541159222930896,1625.21,2022-08-11T08:10:46,Valladolid,expenses,cash,-100.0,-8212.05
buyer_6,Manuel,Díez,1979-02-14,43668965S,manuel.díez@extremetech.io,146712,ES97209541159222930896,1625.21,2022-08-12T16:33:41,Valladolid,expenses,repairs,-112.85,-8324.9
buyer_6,Manuel,Díez,1979-02-14,43668965S,manuel.díez@extremetech.io,146712,ES97209541159222930896,1625.21,2022-08-14T01:13:48,Valladolid,expenses,healthcare,-51.91,-8376.81
buyer_6,Manuel,Díez,1979-02-14,43668965S,manuel.díez@extremetech.io,146712,ES97209541159222930896,1625.21,2022-08-15T16:59:52,Valladolid,expenses,food,-73.56,-8450.37
buyer_6,Manuel,Díez,1979-02-14,43668965S,manuel.díez@extremetech.io,146712,ES97209541159222930896,1625.21,2022-08-16T17:32:06,Valladolid,expenses,leisure,-35.63,-8486.0
buyer_6,Manuel,Díez,1979-02-14,43668965S,manuel.díez@extremetech.io,146712,ES97209541159222930896,1625.21,2022-08-17T08:52:29,Valladolid,expenses,transport,-72.85,-8558.85
buyer_6,Manuel,Díez,1979-02-14,43668965S,manuel.díez@extremetech.io,146712,ES97209541159222930896,1625.21,2022-08-18T08:51:48,Valladolid,expenses,food,-118.45,-8677.3
buyer_6,Manuel,Díez,1979-02-14,43668965S,manuel.díez@extremetech.io,146712,ES97209541159222930896,1625.21,2022-08-18T17:13:03,Valladolid,expenses,cash,-100.0,-8777.3
buyer_6,Manuel,Díez,1979-02-14,43668965S,manuel.díez@extremetech.io,146712,ES97209541159222930896,1625.21,2022-08-20T08:17:45,Valladolid,expenses,food,-68.78,-8846.08
buyer_6,Manuel,Díez,1979-02-14,43668965S,manuel.díez@extremetech.io,146712,ES97209541159222930896,1625.21,2022-08-21T11:00:36,Valladolid,expenses,food,-64.15,-8910.23
buyer_6,Manuel,Díez,1979-02-14,43668965S,manuel.díez@extremetech.io,146712,ES97209541159222930896,1625.21,2022-08-25T11:56:28,Valladolid,expenses,cash,-100.0,-9010.23
buyer_6,Manuel,Díez,1979-02-14,43668965S,manuel.díez@extremetech.io,146712,ES97209541159222930896,1625.21,2022-08-26T13:07:09,Valladolid,expenses,food,-85.73,-9095.96
buyer_6,Manuel,Díez,1979-02-14,43668965S,manuel.díez@extremetech.io,146712,ES97209541159222930896,1625.21,2022-08-26T14:14:08,Valladolid,expenses,leisure,-44.24,-9140.2
buyer_6,Manuel,Díez,1979-02-14,43668965S,manuel.díez@extremetech.io,146712,ES97209541159222930896,1625.21,2022-08-26T14:21:05,Valladolid,expenses,cash,-100.0,-9240.2
buyer_6,Manuel,Díez,1979-02-14,43668965S,manuel.díez@extremetech.io,146712,ES97209541159222930896,1625.21,2022-08-29T11:56:27,Valladolid,expenses,food,-63.86,-9304.06
buyer_6,Manuel,Díez,1979-02-14,43668965S,manuel.díez@extremetech.io,146712,ES97209541159222930896,1625.21,2022-08-29T11:55:33,Valladolid,expenses,gifts,-357.02,-9661.08
buyer_6,Manuel,Díez,1979-02-14,43668965S,manuel.díez@extremetech.io,146712,ES97209541159222930896,1625.21,2022-08-31T20:40:51,Valladolid,expenses,leisure,-29.16,-9690.24
buyer_6,Manuel,Díez,1979-02-14,43668965S,manuel.díez@extremetech.io,146712,ES97209541159222930896,1625.21,2022-08-31T10:17:51,Valladolid,expenses,healthcare,-176.26,-9866.5
buyer_6,Manuel,Díez,1979-02-14,43668965S,manuel.díez@extremetech.io,146712,ES97209541159222930896,1625.21,2022-08-31T18:31:53,Valladolid,expenses,gifts,-356.0,-10222.5
buyer_6,Manuel,Díez,1979-02-14,43668965S,manuel.díez@extremetech.io,146712,ES97209541159222930896,1625.21,2022-09-01T20:28:13,Valladolid,incomes,salary,2976.14,-7246.36
buyer_6,Manuel,Díez,1979-02-14,43668965S,manuel.díez@extremetech.io,146712,ES97209541159222930896,1625.21,2022-09-01T16:33:56,Valladolid,expenses,cash,-100.0,-7346.36
buyer_6,Manuel,Díez,1979-02-14,43668965S,manuel.díez@extremetech.io,146712,ES97209541159222930896,1625.21,2022-09-01T23:14:44,Valladolid,expenses,repairs,-182.8,-7529.16
buyer_6,Manuel,Díez,1979-02-14,43668965S,manuel.díez@extremetech.io,146712,ES97209541159222930896,1625.21,2022-09-02T08:05:28,Valladolid,expenses,cash,-100.0,-7629.16
buyer_6,Manuel,Díez,1979-02-14,43668965S,manuel.díez@extremetech.io,146712,ES97209541159222930896,1625.21,2022-09-03T13:06:22,Valladolid,expenses,cash,-100.0,-7729.16
buyer_6,Manuel,Díez,1979-02-14,43668965S,manuel.díez@extremetech.io,146712,ES97209541159222930896,1625.21,2022-09-05T20:21:17,Valladolid,expenses,mortgage,-1147.51,-8876.67
buyer_6,Manuel,Díez,1979-02-14,43668965S,manuel.díez@extremetech.io,146712,ES97209541159222930896,1625.21,2022-09-05T20:30:36,Valladolid,expenses,gas,-117.97,-8994.64
buyer_6,Manuel,Díez,1979-02-14,43668965S,manuel.díez@extremetech.io,146712,ES97209541159222930896,1625.21,2022-09-05T15:55:16,Valladolid,expenses,food,-65.33,-9059.97
buyer_6,Manuel,Díez,1979-02-14,43668965S,manuel.díez@extremetech.io,146712,ES97209541159222930896,1625.21,2022-09-05T18:15:41,Valladolid,expenses,repairs,-84.8,-9144.77
buyer_6,Manuel,Díez,1979-02-14,43668965S,manuel.díez@extremetech.io,146712,ES97209541159222930896,1625.21,2022-09-06T16:28:33,Valladolid,expenses,water,-46.46,-9191.23
buyer_6,Manuel,Díez,1979-02-14,43668965S,manuel.díez@extremetech.io,146712,ES97209541159222930896,1625.21,2022-09-07T16:53:40,Valladolid,expenses,phone,-60.89,-9252.12
buyer_6,Manuel,Díez,1979-02-14,43668965S,manuel.díez@extremetech.io,146712,ES97209541159222930896,1625.21,2022-09-08T19:14:30,Valladolid,expenses,electricity,-62.91,-9315.03
buyer_6,Manuel,Díez,1979-02-14,43668965S,manuel.díez@extremetech.io,146712,ES97209541159222930896,1625.21,2022-09-08T15:57:32,Valladolid,expenses,leisure,-18.14,-9333.17
buyer_6,Manuel,Díez,1979-02-14,43668965S,manuel.díez@extremetech.io,146712,ES97209541159222930896,1625.21,2022-09-10T12:45:48,Valladolid,expenses,education,-63.92,-9397.09
buyer_6,Manuel,Díez,1979-02-14,43668965S,manuel.díez@extremetech.io,146712,ES97209541159222930896,1625.21,2022-09-10T16:52:09,Valladolid,expenses,cash,-100.0,-9497.09
buyer_6,Manuel,Díez,1979-02-14,43668965S,manuel.díez@extremetech.io,146712,ES97209541159222930896,1625.21,2022-09-11T08:38:13,Valladolid,expenses,transport,-54.82,-9551.91
buyer_6,Manuel,Díez,1979-02-14,43668965S,manuel.díez@extremetech.io,146712,ES97209541159222930896,1625.21,2022-09-11T18:22:43,Valladolid,expenses,clothing,-74.4,-9626.31
buyer_6,Manuel,Díez,1979-02-14,43668965S,manuel.díez@extremetech.io,146712,ES97209541159222930896,1625.21,2022-09-12T09:54:06,Valladolid,expenses,food,-72.04,-9698.35
buyer_6,Manuel,Díez,1979-02-14,43668965S,manuel.díez@extremetech.io,146712,ES97209541159222930896,1625.21,2022-09-13T13:48:31,Valladolid,expenses,gifts,-672.49,-10370.84
buyer_6,Manuel,Díez,1979-02-14,43668965S,manuel.díez@extremetech.io,146712,ES97209541159222930896,1625.21,2022-09-15T17:00:44,Valladolid,expenses,transport,-82.92,-10453.76
buyer_6,Manuel,Díez,1979-02-14,43668965S,manuel.díez@extremetech.io,146712,ES97209541159222930896,1625.21,2022-09-15T18:48:34,Valladolid,expenses,gifts,-751.37,-11205.13
buyer_6,Manuel,Díez,1979-02-14,43668965S,manuel.díez@extremetech.io,146712,ES97209541159222930896,1625.21,2022-09-16T18:33:53,Valladolid,expenses,cash,-100.0,-11305.13
buyer_6,Manuel,Díez,1979-02-14,43668965S,manuel.díez@extremetech.io,146712,ES97209541159222930896,1625.21,2022-09-17T14:36:58,Valladolid,expenses,leisure,-74.24,-11379.37
buyer_6,Manuel,Díez,1979-02-14,43668965S,manuel.díez@extremetech.io,146712,ES97209541159222930896,1625.21,2022-09-17T11:37:26,Valladolid,expenses,cash,-100.0,-11479.37
buyer_6,Manuel,Díez,1979-02-14,43668965S,manuel.díez@extremetech.io,146712,ES97209541159222930896,1625.21,2022-09-17T11:45:45,Valladolid,expenses,appliances,-198.16,-11677.53
buyer_6,Manuel,Díez,1979-02-14,43668965S,manuel.díez@extremetech.io,146712,ES97209541159222930896,1625.21,2022-09-18T15:40:31,Valladolid,expenses,education,-76.71,-11754.24
buyer_6,Manuel,Díez,1979-02-14,43668965S,manuel.díez@extremetech.io,146712,ES97209541159222930896,1625.21,2022-09-22T05:30:41,Valladolid,expenses,food,-62.67,-11816.91
buyer_6,Manuel,Díez,1979-02-14,43668965S,manuel.díez@extremetech.io,146712,ES97209541159222930896,1625.21,2022-09-22T13:48:13,Valladolid,expenses,leisure,-21.33,-11838.24
buyer_6,Manuel,Díez,1979-02-14,43668965S,manuel.díez@extremetech.io,146712,ES97209541159222930896,1625.21,2022-09-23T14:15:29,Valladolid,expenses,education,-49.77,-11888.01
buyer_6,Manuel,Díez,1979-02-14,43668965S,manuel.díez@extremetech.io,146712,ES97209541159222930896,1625.21,2022-09-25T14:55:36,Valladolid,expenses,food,-82.68,-11970.69
buyer_6,Manuel,Díez,1979-02-14,43668965S,manuel.díez@extremetech.io,146712,ES97209541159222930896,1625.21,2022-09-26T21:50:18,Valladolid,expenses,food,-116.83,-12087.52
buyer_6,Manuel,Díez,1979-02-14,43668965S,manuel.díez@extremetech.io,146712,ES97209541159222930896,1625.21,2022-09-27T11:18:50,Valladolid,expenses,gifts,-79.31,-12166.83
buyer_6,Manuel,Díez,1979-02-14,43668965S,manuel.díez@extremetech.io,146712,ES97209541159222930896,1625.21,2022-09-28T22:39:43,Valladolid,expenses,cash,-100.0,-12266.83
buyer_6,Manuel,Díez,1979-02-14,43668965S,manuel.díez@extremetech.io,146712,ES97209541159222930896,1625.21,2022-09-29T17:37:32,Valladolid,expenses,leisure,-35.27,-12302.1
buyer_6,Manuel,Díez,1979-02-14,43668965S,manuel.díez@extremetech.io,146712,ES97209541159222930896,1625.21,2022-09-30T12:40:29,Valladolid,expenses,food,-116.9,-12419.0
buyer_6,Manuel,Díez,1979-02-14,43668965S,manuel.díez@extremetech.io,146712,ES97209541159222930896,1625.21,2022-09-30T16:08:26,Valladolid,expenses,cash,-100.0,-12519.0
buyer_6,Manuel,Díez,1979-02-14,43668965S,manuel.díez@extremetech.io,146712,ES97209541159222930896,1625.21,2022-09-30T09:44:50,Valladolid,expenses,repairs,-139.61,-12658.61
buyer_6,Manuel,Díez,1979-02-14,43668965S,manuel.díez@extremetech.io,146712,ES97209541159222930896,1625.21,2022-10-01T18:09:24,Valladolid,incomes,salary,2976.14,-9682.47
buyer_6,Manuel,Díez,1979-02-14,43668965S,manuel.díez@extremetech.io,146712,ES97209541159222930896,1625.21,2022-10-01T18:09:24,Valladolid,incomes,extra_income,330.25,-9352.22
buyer_6,Manuel,Díez,1979-02-14,43668965S,manuel.díez@extremetech.io,146712,ES97209541159222930896,1625.21,2022-10-05T16:03:52,Valladolid,expenses,mortgage,-1147.51,-10499.73
buyer_6,Manuel,Díez,1979-02-14,43668965S,manuel.díez@extremetech.io,146712,ES97209541159222930896,1625.21,2022-10-05T00:07:32,Valladolid,expenses,water,-38.84,-10538.57
buyer_6,Manuel,Díez,1979-02-14,43668965S,manuel.díez@extremetech.io,146712,ES97209541159222930896,1625.21,2022-10-05T10:23:57,Valladolid,expenses,gas,-110.71,-10649.28
buyer_6,Manuel,Díez,1979-02-14,43668965S,manuel.díez@extremetech.io,146712,ES97209541159222930896,1625.21,2022-10-05T07:37:07,Valladolid,expenses,internet,-62.5,-10711.78
buyer_6,Manuel,Díez,1979-02-14,43668965S,manuel.díez@extremetech.io,146712,ES97209541159222930896,1625.21,2022-10-05T18:57:41,Valladolid,expenses,clothing,-61.3,-10773.08
buyer_6,Manuel,Díez,1979-02-14,43668965S,manuel.díez@extremetech.io,146712,ES97209541159222930896,1625.21,2022-10-05T18:26:25,Valladolid,expenses,appliances,-94.27,-10867.35
buyer_6,Manuel,Díez,1979-02-14,43668965S,manuel.díez@extremetech.io,146712,ES97209541159222930896,1625.21,2022-10-06T23:40:26,Valladolid,expenses,electricity,-94.11,-10961.46
buyer_6,Manuel,Díez,1979-02-14,43668965S,manuel.díez@extremetech.io,146712,ES97209541159222930896,1625.21,2022-10-06T12:30:08,Valladolid,expenses,phone,-64.84,-11026.3
buyer_6,Manuel,Díez,1979-02-14,43668965S,manuel.díez@extremetech.io,146712,ES97209541159222930896,1625.21,2022-10-06T19:22:40,Valladolid,expenses,cash,-100.0,-11126.3
buyer_6,Manuel,Díez,1979-02-14,43668965S,manuel.díez@extremetech.io,146712,ES97209541159222930896,1625.21,2022-10-07T23:41:02,Valladolid,expenses,phone,-59.63,-11185.93
buyer_6,Manuel,Díez,1979-02-14,43668965S,manuel.díez@extremetech.io,146712,ES97209541159222930896,1625.21,2022-10-08T12:53:05,Valladolid,expenses,water,-56.61,-11242.54
buyer_6,Manuel,Díez,1979-02-14,43668965S,manuel.díez@extremetech.io,146712,ES97209541159222930896,1625.21,2022-10-08T15:46:31,Valladolid,expenses,phone,-56.29,-11298.83
buyer_6,Manuel,Díez,1979-02-14,43668965S,manuel.díez@extremetech.io,146712,ES97209541159222930896,1625.21,2022-10-08T11:59:09,Valladolid,expenses,healthcare,-166.35,-11465.18
buyer_6,Manuel,Díez,1979-02-14,43668965S,manuel.díez@extremetech.io,146712,ES97209541159222930896,1625.21,2022-10-10T13:32:36,Valladolid,expenses,gifts,-186.2,-11651.38
buyer_6,Manuel,Díez,1979-02-14,43668965S,manuel.díez@extremetech.io,146712,ES97209541159222930896,1625.21,2022-10-11T05:31:15,Valladolid,expenses,repairs,-271.24,-11922.62
buyer_6,Manuel,Díez,1979-02-14,43668965S,manuel.díez@extremetech.io,146712,ES97209541159222930896,1625.21,2022-10-12T10:49:05,Valladolid,expenses,cash,-100.0,-12022.62
buyer_6,Manuel,Díez,1979-02-14,43668965S,manuel.díez@extremetech.io,146712,ES97209541159222930896,1625.21,2022-10-13T20:23:29,Valladolid,expenses,cash,-100.0,-12122.62
buyer_6,Manuel,Díez,1979-02-14,43668965S,manuel.díez@extremetech.io,146712,ES97209541159222930896,1625.21,2022-10-13T15:15:49,Valladolid,expenses,repairs,-245.17,-12367.79
buyer_6,Manuel,Díez,1979-02-14,43668965S,manuel.díez@extremetech.io,146712,ES97209541159222930896,1625.21,2022-10-15T19:39:50,Valladolid,expenses,leisure,-72.26,-12440.05
buyer_6,Manuel,Díez,1979-02-14,43668965S,manuel.díez@extremetech.io,146712,ES97209541159222930896,1625.21,2022-10-15T16:28:13,Valladolid,expenses,education,-74.89,-12514.94
buyer_6,Manuel,Díez,1979-02-14,43668965S,manuel.díez@extremetech.io,146712,ES97209541159222930896,1625.21,2022-10-16T10:26:46,Valladolid,expenses,cash,-100.0,-12614.94
buyer_6,Manuel,Díez,1979-02-14,43668965S,manuel.díez@extremetech.io,146712,ES97209541159222930896,1625.21,2022-10-16T22:49:25,Valladolid,expenses,repairs,-62.65,-12677.59
buyer_6,Manuel,Díez,1979-02-14,43668965S,manuel.díez@extremetech.io,146712,ES97209541159222930896,1625.21,2022-10-18T23:38:51,Valladolid,expenses,gifts,-542.17,-13219.76
buyer_6,Manuel,Díez,1979-02-14,43668965S,manuel.díez@extremetech.io,146712,ES97209541159222930896,1625.21,2022-10-21T08:03:05,Valladolid,expenses,cash,-100.0,-13319.76
buyer_6,Manuel,Díez,1979-02-14,43668965S,manuel.díez@extremetech.io,146712,ES97209541159222930896,1625.21,2022-10-21T11:53:22,Valladolid,expenses,gifts,-50.36,-13370.12
buyer_6,Manuel,Díez,1979-02-14,43668965S,manuel.díez@extremetech.io,146712,ES97209541159222930896,1625.21,2022-10-24T12:40:45,Valladolid,expenses,food,-90.12,-13460.24
buyer_6,Manuel,Díez,1979-02-14,43668965S,manuel.díez@extremetech.io,146712,ES97209541159222930896,1625.21,2022-10-24T11:48:50,Valladolid,expenses,cash,-100.0,-13560.24
buyer_6,Manuel,Díez,1979-02-14,43668965S,manuel.díez@extremetech.io,146712,ES97209541159222930896,1625.21,2022-10-25T16:22:56,Valladolid,expenses,repairs,-43.78,-13604.02
buyer_6,Manuel,Díez,1979-02-14,43668965S,manuel.díez@extremetech.io,146712,ES97209541159222930896,1625.21,2022-10-26T12:01:31,Valladolid,expenses,cash,-100.0,-13704.02
buyer_6,Manuel,Díez,1979-02-14,43668965S,manuel.díez@extremetech.io,146712,ES97209541159222930896,1625.21,2022-10-26T15:03:58,Valladolid,expenses,repairs,-284.07,-13988.09
buyer_6,Manuel,Díez,1979-02-14,43668965S,manuel.díez@extremetech.io,146712,ES97209541159222930896,1625.21,2022-10-27T21:21:19,Valladolid,expenses,repairs,-42.57,-14030.66
buyer_6,Manuel,Díez,1979-02-14,43668965S,manuel.díez@extremetech.io,146712,ES97209541159222930896,1625.21,2022-10-28T09:43:57,Valladolid,expenses,transport,-50.45,-14081.11
buyer_6,Manuel,Díez,1979-02-14,43668965S,manuel.díez@extremetech.io,146712,ES97209541159222930896,1625.21,2022-11-01T20:00:05,Valladolid,incomes,salary,2976.14,-11104.97
buyer_6,Manuel,Díez,1979-02-14,43668965S,manuel.díez@extremetech.io,146712,ES97209541159222930896,1625.21,2022-11-01T17:07:54,Valladolid,expenses,clothing,-96.74,-11201.71
buyer_6,Manuel,Díez,1979-02-14,43668965S,manuel.díez@extremetech.io,146712,ES97209541159222930896,1625.21,2022-11-01T10:58:49,Valladolid,expenses,cash,-100.0,-11301.71
buyer_6,Manuel,Díez,1979-02-14,43668965S,manuel.díez@extremetech.io,146712,ES97209541159222930896,1625.21,2022-11-01T23:57:06,Valladolid,expenses,gifts,-659.92,-11961.63
buyer_6,Manuel,Díez,1979-02-14,43668965S,manuel.díez@extremetech.io,146712,ES97209541159222930896,1625.21,2022-11-02T15:32:21,Valladolid,expenses,food,-61.62,-12023.25
buyer_6,Manuel,Díez,1979-02-14,43668965S,manuel.díez@extremetech.io,146712,ES97209541159222930896,1625.21,2022-11-03T03:06:00,Valladolid,expenses,cash,-100.0,-12123.25
buyer_6,Manuel,Díez,1979-02-14,43668965S,manuel.díez@extremetech.io,146712,ES97209541159222930896,1625.21,2022-11-05T09:49:53,Valladolid,expenses,mortgage,-1147.51,-13270.76
buyer_6,Manuel,Díez,1979-02-14,43668965S,manuel.díez@extremetech.io,146712,ES97209541159222930896,1625.21,2022-11-05T09:45:14,Valladolid,expenses,gas,-139.81,-13410.57
buyer_6,Manuel,Díez,1979-02-14,43668965S,manuel.díez@extremetech.io,146712,ES97209541159222930896,1625.21,2022-11-05T12:11:44,Valladolid,expenses,internet,-62.5,-13473.07
buyer_6,Manuel,Díez,1979-02-14,43668965S,manuel.díez@extremetech.io,146712,ES97209541159222930896,1625.21,2022-11-05T10:18:19,Valladolid,expenses,leisure,-18.16,-13491.23
buyer_6,Manuel,Díez,1979-02-14,43668965S,manuel.díez@extremetech.io,146712,ES97209541159222930896,1625.21,2022-11-06T20:19:17,Valladolid,expenses,gas,-156.07,-13647.3
buyer_6,Manuel,Díez,1979-02-14,43668965S,manuel.díez@extremetech.io,146712,ES97209541159222930896,1625.21,2022-11-06T18:32:10,Valladolid,expenses,leisure,-29.9,-13677.2
buyer_6,Manuel,Díez,1979-02-14,43668965S,manuel.díez@extremetech.io,146712,ES97209541159222930896,1625.21,2022-11-07T21:45:37,Valladolid,expenses,gas,-157.19,-13834.39
buyer_6,Manuel,Díez,1979-02-14,43668965S,manuel.díez@extremetech.io,146712,ES97209541159222930896,1625.21,2022-11-07T08:09:59,Valladolid,expenses,cash,-100.0,-13934.39
buyer_6,Manuel,Díez,1979-02-14,43668965S,manuel.díez@extremetech.io,146712,ES97209541159222930896,1625.21,2022-11-08T13:20:00,Valladolid,expenses,healthcare,-137.02,-14071.41
buyer_6,Manuel,Díez,1979-02-14,43668965S,manuel.díez@extremetech.io,146712,ES97209541159222930896,1625.21,2022-11-09T11:27:40,Valladolid,expenses,education,-78.83,-14150.24
buyer_6,Manuel,Díez,1979-02-14,43668965S,manuel.díez@extremetech.io,146712,ES97209541159222930896,1625.21,2022-11-09T11:33:31,Valladolid,expenses,cash,-100.0,-14250.24
buyer_6,Manuel,Díez,1979-02-14,43668965S,manuel.díez@extremetech.io,146712,ES97209541159222930896,1625.21,2022-11-11T12:55:13,Valladolid,expenses,healthcare,-106.17,-14356.41
buyer_6,Manuel,Díez,1979-02-14,43668965S,manuel.díez@extremetech.io,146712,ES97209541159222930896,1625.21,2022-11-11T12:20:08,Valladolid,expenses,gifts,-383.05,-14739.46
buyer_6,Manuel,Díez,1979-02-14,43668965S,manuel.díez@extremetech.io,146712,ES97209541159222930896,1625.21,2022-11-12T08:58:08,Valladolid,expenses,healthcare,-49.01,-14788.47
buyer_6,Manuel,Díez,1979-02-14,43668965S,manuel.díez@extremetech.io,146712,ES97209541159222930896,1625.21,2022-11-12T20:21:52,Valladolid,expenses,gifts,-26.14,-14814.61
buyer_6,Manuel,Díez,1979-02-14,43668965S,manuel.díez@extremetech.io,146712,ES97209541159222930896,1625.21,2022-11-22T18:08:26,Valladolid,expenses,food,-65.47,-14880.08
buyer_6,Manuel,Díez,1979-02-14,43668965S,manuel.díez@extremetech.io,146712,ES97209541159222930896,1625.21,2022-11-22T16:17:33,Valladolid,expenses,travel,-1689.09,-16569.17
buyer_6,Manuel,Díez,1979-02-14,43668965S,manuel.díez@extremetech.io,146712,ES97209541159222930896,1625.21,2022-11-23T19:50:26,Valladolid,expenses,leisure,-54.53,-16623.7
buyer_6,Manuel,Díez,1979-02-14,43668965S,manuel.díez@extremetech.io,146712,ES97209541159222930896,1625.21,2022-11-24T19:29:10,Valladolid,expenses,gifts,-406.92,-17030.62
buyer_6,Manuel,Díez,1979-02-14,43668965S,manuel.díez@extremetech.io,146712,ES97209541159222930896,1625.21,2022-11-25T17:42:29,Valladolid,expenses,food,-72.65,-17103.27
buyer_6,Manuel,Díez,1979-02-14,43668965S,manuel.díez@extremetech.io,146712,ES97209541159222930896,1625.21,2022-11-26T11:22:22,Valladolid,expenses,food,-80.12,-17183.39
buyer_6,Manuel,Díez,1979-02-14,43668965S,manuel.díez@extremetech.io,146712,ES97209541159222930896,1625.21,2022-11-28T12:49:23,Valladolid,expenses,food,-123.24,-17306.63
buyer_6,Manuel,Díez,1979-02-14,43668965S,manuel.díez@extremetech.io,146712,ES97209541159222930896,1625.21,2022-11-28T10:58:56,Valladolid,expenses,leisure,-38.32,-17344.95
buyer_6,Manuel,Díez,1979-02-14,43668965S,manuel.díez@extremetech.io,146712,ES97209541159222930896,1625.21,2022-11-28T17:15:43,Valladolid,expenses,cash,-100.0,-17444.95
buyer_6,Manuel,Díez,1979-02-14,43668965S,manuel.díez@extremetech.io,146712,ES97209541159222930896,1625.21,2022-11-30T17:33:58,Valladolid,expenses,cash,-100.0,-17544.95
buyer_6,Manuel,Díez,1979-02-14,43668965S,manuel.díez@extremetech.io,146712,ES97209541159222930896,1625.21,2022-12-01T17:15:55,Valladolid,incomes,salary,2976.14,-14568.81
buyer_6,Manuel,Díez,1979-02-14,43668965S,manuel.díez@extremetech.io,146712,ES97209541159222930896,1625.21,2022-12-01T17:15:55,Valladolid,incomes,salary_bonus,2317.74,-12251.07
buyer_6,Manuel,Díez,1979-02-14,43668965S,manuel.díez@extremetech.io,146712,ES97209541159222930896,1625.21,2022-12-02T11:14:45,Valladolid,expenses,transport,-69.56,-12320.63
buyer_6,Manuel,Díez,1979-02-14,43668965S,manuel.díez@extremetech.io,146712,ES97209541159222930896,1625.21,2022-12-02T07:52:58,Valladolid,expenses,repairs,-70.81,-12391.44
buyer_6,Manuel,Díez,1979-02-14,43668965S,manuel.díez@extremetech.io,146712,ES97209541159222930896,1625.21,2022-12-02T08:58:36,Valladolid,expenses,gifts,-377.83,-12769.27
buyer_6,Manuel,Díez,1979-02-14,43668965S,manuel.díez@extremetech.io,146712,ES97209541159222930896,1625.21,2022-12-03T12:50:22,Valladolid,expenses,travel,-1132.19,-13901.46
buyer_6,Manuel,Díez,1979-02-14,43668965S,manuel.díez@extremetech.io,146712,ES97209541159222930896,1625.21,2022-12-05T00:51:06,Valladolid,expenses,mortgage,-1147.51,-15048.97
buyer_6,Manuel,Díez,1979-02-14,43668965S,manuel.díez@extremetech.io,146712,ES97209541159222930896,1625.21,2022-12-05T14:20:03,Valladolid,expenses,internet,-62.5,-15111.47
buyer_6,Manuel,Díez,1979-02-14,43668965S,manuel.díez@extremetech.io,146712,ES97209541159222930896,1625.21,2022-12-05T11:47:19,Valladolid,expenses,phone,-55.31,-15166.78
buyer_6,Manuel,Díez,1979-02-14,43668965S,manuel.díez@extremetech.io,146712,ES97209541159222930896,1625.21,2022-12-06T12:29:49,Valladolid,expenses,transport,-66.05,-15232.83
buyer_6,Manuel,Díez,1979-02-14,43668965S,manuel.díez@extremetech.io,146712,ES97209541159222930896,1625.21,2022-12-06T12:50:33,Valladolid,expenses,clothing,-48.31,-15281.14
buyer_6,Manuel,Díez,1979-02-14,43668965S,manuel.díez@extremetech.io,146712,ES97209541159222930896,1625.21,2022-12-06T12:23:51,Valladolid,expenses,education,-66.22,-15347.36
buyer_6,Manuel,Díez,1979-02-14,43668965S,manuel.díez@extremetech.io,146712,ES97209541159222930896,1625.21,2022-12-07T16:33:15,Valladolid,expenses,food,-70.3,-15417.66
buyer_6,Manuel,Díez,1979-02-14,43668965S,manuel.díez@extremetech.io,146712,ES97209541159222930896,1625.21,2022-12-07T14:42:00,Valladolid,expenses,cash,-100.0,-15517.66
buyer_6,Manuel,Díez,1979-02-14,43668965S,manuel.díez@extremetech.io,146712,ES97209541159222930896,1625.21,2022-12-08T08:00:57,Valladolid,expenses,electricity,-119.63,-15637.29
buyer_6,Manuel,Díez,1979-02-14,43668965S,manuel.díez@extremetech.io,146712,ES97209541159222930896,1625.21,2022-12-08T23:50:31,Valladolid,expenses,leisure,-35.61,-15672.9
buyer_6,Manuel,Díez,1979-02-14,43668965S,manuel.díez@extremetech.io,146712,ES97209541159222930896,1625.21,2022-12-09T19:32:43,Valladolid,expenses,education,-56.93,-15729.83
buyer_6,Manuel,Díez,1979-02-14,43668965S,manuel.díez@extremetech.io,146712,ES97209541159222930896,1625.21,2022-12-09T12:29:34,Valladolid,expenses,cash,-100.0,-15829.83
buyer_6,Manuel,Díez,1979-02-14,43668965S,manuel.díez@extremetech.io,146712,ES97209541159222930896,1625.21,2022-12-10T19:14:22,Valladolid,expenses,food,-102.08,-15931.91
buyer_6,Manuel,Díez,1979-02-14,43668965S,manuel.díez@extremetech.io,146712,ES97209541159222930896,1625.21,2022-12-10T12:07:22,Valladolid,expenses,cash,-100.0,-16031.91
buyer_6,Manuel,Díez,1979-02-14,43668965S,manuel.díez@extremetech.io,146712,ES97209541159222930896,1625.21,2022-12-11T09:43:57,Valladolid,expenses,gifts,-277.6,-16309.51
buyer_6,Manuel,Díez,1979-02-14,43668965S,manuel.díez@extremetech.io,146712,ES97209541159222930896,1625.21,2022-12-12T15:04:39,Valladolid,expenses,food,-77.75,-16387.26
buyer_6,Manuel,Díez,1979-02-14,43668965S,manuel.díez@extremetech.io,146712,ES97209541159222930896,1625.21,2022-12-13T16:56:48,Valladolid,expenses,food,-107.87,-16495.13
buyer_6,Manuel,Díez,1979-02-14,43668965S,manuel.díez@extremetech.io,146712,ES97209541159222930896,1625.21,2022-12-14T05:20:03,Valladolid,expenses,transport,-74.38,-16569.51
buyer_6,Manuel,Díez,1979-02-14,43668965S,manuel.díez@extremetech.io,146712,ES97209541159222930896,1625.21,2022-12-15T11:32:48,Valladolid,expenses,food,-117.04,-16686.55
buyer_6,Manuel,Díez,1979-02-14,43668965S,manuel.díez@extremetech.io,146712,ES97209541159222930896,1625.21,2022-12-16T16:20:15,Valladolid,expenses,gifts,-823.3,-17509.85
buyer_6,Manuel,Díez,1979-02-14,43668965S,manuel.díez@extremetech.io,146712,ES97209541159222930896,1625.21,2022-12-17T14:27:03,Valladolid,expenses,transport,-80.6,-17590.45
buyer_6,Manuel,Díez,1979-02-14,43668965S,manuel.díez@extremetech.io,146712,ES97209541159222930896,1625.21,2022-12-18T01:21:36,Valladolid,expenses,transport,-88.52,-17678.97
buyer_6,Manuel,Díez,1979-02-14,43668965S,manuel.díez@extremetech.io,146712,ES97209541159222930896,1625.21,2022-12-20T04:15:21,Valladolid,expenses,transport,-44.05,-17723.02
buyer_6,Manuel,Díez,1979-02-14,43668965S,manuel.díez@extremetech.io,146712,ES97209541159222930896,1625.21,2022-12-20T18:41:15,Valladolid,expenses,cash,-100.0,-17823.02
buyer_6,Manuel,Díez,1979-02-14,43668965S,manuel.díez@extremetech.io,146712,ES97209541159222930896,1625.21,2022-12-21T15:40:53,Valladolid,expenses,food,-77.24,-17900.26
buyer_6,Manuel,Díez,1979-02-14,43668965S,manuel.díez@extremetech.io,146712,ES97209541159222930896,1625.21,2022-12-24T19:00:59,Valladolid,expenses,food,-107.99,-18008.25
buyer_6,Manuel,Díez,1979-02-14,43668965S,manuel.díez@extremetech.io,146712,ES97209541159222930896,1625.21,2022-12-25T18:40:50,Valladolid,expenses,gifts,-797.08,-18805.33
buyer_6,Manuel,Díez,1979-02-14,43668965S,manuel.díez@extremetech.io,146712,ES97209541159222930896,1625.21,2022-12-26T12:14:41,Valladolid,expenses,food,-89.65,-18894.98
buyer_6,Manuel,Díez,1979-02-14,43668965S,manuel.díez@extremetech.io,146712,ES97209541159222930896,1625.21,2022-12-26T20:22:03,Valladolid,expenses,cash,-100.0,-18994.98
buyer_6,Manuel,Díez,1979-02-14,43668965S,manuel.díez@extremetech.io,146712,ES97209541159222930896,1625.21,2022-12-27T21:04:30,Valladolid,expenses,food,-111.24,-19106.22
buyer_6,Manuel,Díez,1979-02-14,43668965S,manuel.díez@extremetech.io,146712,ES97209541159222930896,1625.21,2022-12-27T11:23:19,Valladolid,expenses,cash,-100.0,-19206.22
buyer_6,Manuel,Díez,1979-02-14,43668965S,manuel.díez@extremetech.io,146712,ES97209541159222930896,1625.21,2022-12-28T10:56:56,Valladolid,expenses,leisure,-54.71,-19260.93
buyer_6,Manuel,Díez,1979-02-14,43668965S,manuel.díez@extremetech.io,146712,ES97209541159222930896,1625.21,2022-12-28T14:45:15,Valladolid,expenses,appliances,-383.26,-19644.19
buyer_6,Manuel,Díez,1979-02-14,43668965S,manuel.díez@extremetech.io,146712,ES97209541159222930896,1625.21,2022-12-30T09:05:56,Valladolid,expenses,leisure,-73.25,-19717.44
buyer_6,Manuel,Díez,1979-02-14,43668965S,manuel.díez@extremetech.io,146712,ES97209541159222930896,1625.21,2022-12-31T22:22:34,Valladolid,expenses,cash,-100.0,-19817.44
buyer_6,Manuel,Díez,1979-02-14,43668965S,manuel.díez@extremetech.io,146712,ES97209541159222930896,1625.21,2023-01-01T17:21:41,Valladolid,incomes,salary,3062.36,-16755.08
buyer_6,Manuel,Díez,1979-02-14,43668965S,manuel.díez@extremetech.io,146712,ES97209541159222930896,1625.21,2023-01-01T17:21:41,Valladolid,incomes,extra_income,330.25,-16424.83
buyer_6,Manuel,Díez,1979-02-14,43668965S,manuel.díez@extremetech.io,146712,ES97209541159222930896,1625.21,2023-01-01T19:38:43,Valladolid,expenses,cash,-100.0,-16524.83
buyer_6,Manuel,Díez,1979-02-14,43668965S,manuel.díez@extremetech.io,146712,ES97209541159222930896,1625.21,2023-01-03T13:13:29,Valladolid,expenses,cash,-100.0,-16624.83
buyer_6,Manuel,Díez,1979-02-14,43668965S,manuel.díez@extremetech.io,146712,ES97209541159222930896,1625.21,2023-01-04T14:10:35,Valladolid,expenses,repairs,-153.84,-16778.67
buyer_6,Manuel,Díez,1979-02-14,43668965S,manuel.díez@extremetech.io,146712,ES97209541159222930896,1625.21,2023-01-05T15:31:56,Valladolid,expenses,mortgage,-1572.51,-18351.18
buyer_6,Manuel,Díez,1979-02-14,43668965S,manuel.díez@extremetech.io,146712,ES97209541159222930896,1625.21,2023-01-05T00:22:22,Valladolid,expenses,cash,-100.0,-18451.18
buyer_6,Manuel,Díez,1979-02-14,43668965S,manuel.díez@extremetech.io,146712,ES97209541159222930896,1625.21,2023-01-06T10:01:19,Valladolid,expenses,cash,-100.0,-18551.18
buyer_6,Manuel,Díez,1979-02-14,43668965S,manuel.díez@extremetech.io,146712,ES97209541159222930896,1625.21,2023-01-07T16:08:41,Valladolid,expenses,internet,-64.31,-18615.49
buyer_6,Manuel,Díez,1979-02-14,43668965S,manuel.díez@extremetech.io,146712,ES97209541159222930896,1625.21,2023-01-07T17:47:01,Valladolid,expenses,food,-62.27,-18677.76
buyer_6,Manuel,Díez,1979-02-14,43668965S,manuel.díez@extremetech.io,146712,ES97209541159222930896,1625.21,2023-01-08T08:33:46,Valladolid,expenses,food,-68.1,-18745.86
buyer_6,Manuel,Díez,1979-02-14,43668965S,manuel.díez@extremetech.io,146712,ES97209541159222930896,1625.21,2023-01-09T20:35:02,Valladolid,expenses,gifts,-379.41,-19125.27
buyer_6,Manuel,Díez,1979-02-14,43668965S,manuel.díez@extremetech.io,146712,ES97209541159222930896,1625.21,2023-01-14T18:20:09,Valladolid,expenses,appliances,-194.18,-19319.45
buyer_6,Manuel,Díez,1979-02-14,43668965S,manuel.díez@extremetech.io,146712,ES97209541159222930896,1625.21,2023-01-14T10:11:57,Valladolid,expenses,repairs,-302.26,-19621.71
buyer_6,Manuel,Díez,1979-02-14,43668965S,manuel.díez@extremetech.io,146712,ES97209541159222930896,1625.21,2023-01-15T16:40:51,Valladolid,expenses,cash,-100.0,-19721.71
buyer_6,Manuel,Díez,1979-02-14,43668965S,manuel.díez@extremetech.io,146712,ES97209541159222930896,1625.21,2023-01-17T12:56:32,Valladolid,expenses,repairs,-159.9,-19881.61
buyer_6,Manuel,Díez,1979-02-14,43668965S,manuel.díez@extremetech.io,146712,ES97209541159222930896,1625.21,2023-01-19T10:03:57,Valladolid,expenses,food,-88.85,-19970.46
buyer_6,Manuel,Díez,1979-02-14,43668965S,manuel.díez@extremetech.io,146712,ES97209541159222930896,1625.21,2023-01-24T09:34:34,Valladolid,expenses,food,-99.38,-20069.84
buyer_6,Manuel,Díez,1979-02-14,43668965S,manuel.díez@extremetech.io,146712,ES97209541159222930896,1625.21,2023-01-25T09:43:48,Valladolid,expenses,cash,-100.0,-20169.84
buyer_6,Manuel,Díez,1979-02-14,43668965S,manuel.díez@extremetech.io,146712,ES97209541159222930896,1625.21,2023-01-26T10:12:36,Valladolid,expenses,education,-57.1,-20226.94
buyer_6,Manuel,Díez,1979-02-14,43668965S,manuel.díez@extremetech.io,146712,ES97209541159222930896,1625.21,2023-01-27T20:44:33,Valladolid,expenses,cash,-100.0,-20326.94
buyer_6,Manuel,Díez,1979-02-14,43668965S,manuel.díez@extremetech.io,146712,ES97209541159222930896,1625.21,2023-01-28T10:28:21,Valladolid,expenses,leisure,-33.41,-20360.35
buyer_6,Manuel,Díez,1979-02-14,43668965S,manuel.díez@extremetech.io,146712,ES97209541159222930896,1625.21,2023-01-29T08:06:36,Valladolid,expenses,transport,-80.19,-20440.54
buyer_6,Manuel,Díez,1979-02-14,43668965S,manuel.díez@extremetech.io,146712,ES97209541159222930896,1625.21,2023-01-30T10:23:48,Valladolid,expenses,transport,-43.08,-20483.62
buyer_6,Manuel,Díez,1979-02-14,43668965S,manuel.díez@extremetech.io,146712,ES97209541159222930896,1625.21,2023-02-01T15:24:29,Valladolid,incomes,salary,3062.36,-17421.26
buyer_6,Manuel,Díez,1979-02-14,43668965S,manuel.díez@extremetech.io,146712,ES97209541159222930896,1625.21,2023-02-02T11:30:37,Valladolid,expenses,repairs,-171.99,-17593.25
buyer_6,Manuel,Díez,1979-02-14,43668965S,manuel.díez@extremetech.io,146712,ES97209541159222930896,1625.21,2023-02-04T09:06:34,Valladolid,expenses,food,-69.31,-17662.56
buyer_6,Manuel,Díez,1979-02-14,43668965S,manuel.díez@extremetech.io,146712,ES97209541159222930896,1625.21,2023-02-04T13:31:28,Valladolid,expenses,cash,-100.0,-17762.56
buyer_6,Manuel,Díez,1979-02-14,43668965S,manuel.díez@extremetech.io,146712,ES97209541159222930896,1625.21,2023-02-05T02:20:00,Valladolid,expenses,mortgage,-1572.51,-19335.07
buyer_6,Manuel,Díez,1979-02-14,43668965S,manuel.díez@extremetech.io,146712,ES97209541159222930896,1625.21,2023-02-05T12:15:36,Valladolid,expenses,electricity,-83.07,-19418.14
buyer_6,Manuel,Díez,1979-02-14,43668965S,manuel.díez@extremetech.io,146712,ES97209541159222930896,1625.21,2023-02-05T00:03:00,Valladolid,expenses,gas,-106.48,-19524.62
buyer_6,Manuel,Díez,1979-02-14,43668965S,manuel.díez@extremetech.io,146712,ES97209541159222930896,1625.21,2023-02-05T12:51:50,Valladolid,expenses,cash,-100.0,-19624.62
buyer_6,Manuel,Díez,1979-02-14,43668965S,manuel.díez@extremetech.io,146712,ES97209541159222930896,1625.21,2023-02-06T11:11:54,Valladolid,expenses,water,-60.19,-19684.81
buyer_6,Manuel,Díez,1979-02-14,43668965S,manuel.díez@extremetech.io,146712,ES97209541159222930896,1625.21,2023-02-06T08:11:09,Valladolid,expenses,appliances,-104.18,-19788.99
buyer_6,Manuel,Díez,1979-02-14,43668965S,manuel.díez@extremetech.io,146712,ES97209541159222930896,1625.21,2023-02-06T14:49:45,Valladolid,expenses,repairs,-271.17,-20060.16
buyer_6,Manuel,Díez,1979-02-14,43668965S,manuel.díez@extremetech.io,146712,ES97209541159222930896,1625.21,2023-02-07T21:10:51,Valladolid,expenses,gas,-108.73,-20168.89
buyer_6,Manuel,Díez,1979-02-14,43668965S,manuel.díez@extremetech.io,146712,ES97209541159222930896,1625.21,2023-02-07T19:30:01,Valladolid,expenses,internet,-64.31,-20233.2
buyer_6,Manuel,Díez,1979-02-14,43668965S,manuel.díez@extremetech.io,146712,ES97209541159222930896,1625.21,2023-02-07T12:05:01,Valladolid,expenses,cash,-100.0,-20333.2
buyer_6,Manuel,Díez,1979-02-14,43668965S,manuel.díez@extremetech.io,146712,ES97209541159222930896,1625.21,2023-02-08T14:27:18,Valladolid,expenses,water,-62.51,-20395.71
buyer_6,Manuel,Díez,1979-02-14,43668965S,manuel.díez@extremetech.io,146712,ES97209541159222930896,1625.21,2023-02-08T17:15:29,Valladolid,expenses,gas,-53.75,-20449.46
buyer_6,Manuel,Díez,1979-02-14,43668965S,manuel.díez@extremetech.io,146712,ES97209541159222930896,1625.21,2023-02-08T09:25:46,Valladolid,expenses,clothing,-130.71,-20580.17
buyer_6,Manuel,Díez,1979-02-14,43668965S,manuel.díez@extremetech.io,146712,ES97209541159222930896,1625.21,2023-02-09T16:56:37,Valladolid,expenses,leisure,-71.14,-20651.31
buyer_6,Manuel,Díez,1979-02-14,43668965S,manuel.díez@extremetech.io,146712,ES97209541159222930896,1625.21,2023-02-11T20:30:51,Valladolid,expenses,transport,-65.62,-20716.93
buyer_6,Manuel,Díez,1979-02-14,43668965S,manuel.díez@extremetech.io,146712,ES97209541159222930896,1625.21,2023-02-12T18:20:08,Valladolid,expenses,repairs,-310.46,-21027.39
buyer_6,Manuel,Díez,1979-02-14,43668965S,manuel.díez@extremetech.io,146712,ES97209541159222930896,1625.21,2023-02-13T10:33:50,Valladolid,expenses,repairs,-56.09,-21083.48
buyer_6,Manuel,Díez,1979-02-14,43668965S,manuel.díez@extremetech.io,146712,ES97209541159222930896,1625.21,2023-02-14T04:39:56,Valladolid,expenses,food,-101.05,-21184.53
buyer_6,Manuel,Díez,1979-02-14,43668965S,manuel.díez@extremetech.io,146712,ES97209541159222930896,1625.21,2023-02-14T23:13:12,Valladolid,expenses,transport,-70.28,-21254.81
buyer_6,Manuel,Díez,1979-02-14,43668965S,manuel.díez@extremetech.io,146712,ES97209541159222930896,1625.21,2023-02-16T10:01:36,Valladolid,expenses,food,-87.56,-21342.37
buyer_6,Manuel,Díez,1979-02-14,43668965S,manuel.díez@extremetech.io,146712,ES97209541159222930896,1625.21,2023-02-16T08:18:40,Valladolid,expenses,gifts,-682.22,-22024.59
buyer_6,Manuel,Díez,1979-02-14,43668965S,manuel.díez@extremetech.io,146712,ES97209541159222930896,1625.21,2023-02-17T17:00:06,Valladolid,expenses,appliances,-258.13,-22282.72
buyer_6,Manuel,Díez,1979-02-14,43668965S,manuel.díez@extremetech.io,146712,ES97209541159222930896,1625.21,2023-02-20T14:41:53,Valladolid,expenses,healthcare,-179.63,-22462.35
buyer_6,Manuel,Díez,1979-02-14,43668965S,manuel.díez@extremetech.io,146712,ES97209541159222930896,1625.21,2023-02-24T19:01:29,Valladolid,expenses,clothing,-126.15,-22588.5
buyer_6,Manuel,Díez,1979-02-14,43668965S,manuel.díez@extremetech.io,146712,ES97209541159222930896,1625.21,2023-02-27T11:32:21,Valladolid,expenses,food,-80.54,-22669.04
buyer_6,Manuel,Díez,1979-02-14,43668965S,manuel.díez@extremetech.io,146712,ES97209541159222930896,1625.21,2023-02-28T14:52:32,Valladolid,expenses,gifts,-767.84,-23436.88
buyer_6,Manuel,Díez,1979-02-14,43668965S,manuel.díez@extremetech.io,146712,ES97209541159222930896,1625.21,2023-03-01T19:50:17,Valladolid,incomes,salary,3062.36,-20374.52
buyer_6,Manuel,Díez,1979-02-14,43668965S,manuel.díez@extremetech.io,146712,ES97209541159222930896,1625.21,2023-03-03T12:48:03,Valladolid,expenses,cash,-100.0,-20474.52
buyer_6,Manuel,Díez,1979-02-14,43668965S,manuel.díez@extremetech.io,146712,ES97209541159222930896,1625.21,2023-03-05T20:54:16,Valladolid,expenses,mortgage,-1572.51,-22047.03
buyer_6,Manuel,Díez,1979-02-14,43668965S,manuel.díez@extremetech.io,146712,ES97209541159222930896,1625.21,2023-03-05T15:11:50,Valladolid,expenses,water,-46.35,-22093.38
buyer_6,Manuel,Díez,1979-02-14,43668965S,manuel.díez@extremetech.io,146712,ES97209541159222930896,1625.21,2023-03-06T05:07:48,Valladolid,expenses,water,-63.66,-22157.04
buyer_6,Manuel,Díez,1979-02-14,43668965S,manuel.díez@extremetech.io,146712,ES97209541159222930896,1625.21,2023-03-06T22:53:53,Valladolid,expenses,gas,-93.27,-22250.31
buyer_6,Manuel,Díez,1979-02-14,43668965S,manuel.díez@extremetech.io,146712,ES97209541159222930896,1625.21,2023-03-06T18:17:07,Valladolid,expenses,food,-110.25,-22360.56
buyer_6,Manuel,Díez,1979-02-14,43668965S,manuel.díez@extremetech.io,146712,ES97209541159222930896,1625.21,2023-03-07T12:21:01,Valladolid,expenses,gas,-73.2,-22433.76
buyer_6,Manuel,Díez,1979-02-14,43668965S,manuel.díez@extremetech.io,146712,ES97209541159222930896,1625.21,2023-03-07T17:53:02,Valladolid,expenses,internet,-64.31,-22498.07
buyer_6,Manuel,Díez,1979-02-14,43668965S,manuel.díez@extremetech.io,146712,ES97209541159222930896,1625.21,2023-03-08T08:58:10,Valladolid,expenses,water,-61.58,-22559.65
buyer_6,Manuel,Díez,1979-02-14,43668965S,manuel.díez@extremetech.io,146712,ES97209541159222930896,1625.21,2023-03-09T08:13:20,Valladolid,expenses,gifts,-334.3,-22893.95
buyer_6,Manuel,Díez,1979-02-14,43668965S,manuel.díez@extremetech.io,146712,ES97209541159222930896,1625.21,2023-03-10T14:32:42,Valladolid,expenses,food,-122.45,-23016.4
buyer_6,Manuel,Díez,1979-02-14,43668965S,manuel.díez@extremetech.io,146712,ES97209541159222930896,1625.21,2023-03-10T15:55:23,Valladolid,expenses,cash,-100.0,-23116.4
buyer_6,Manuel,Díez,1979-02-14,43668965S,manuel.díez@extremetech.io,146712,ES97209541159222930896,1625.21,2023-03-11T19:15:26,Valladolid,expenses,transport,-60.37,-23176.77
buyer_6,Manuel,Díez,1979-02-14,43668965S,manuel.díez@extremetech.io,146712,ES97209541159222930896,1625.21,2023-03-11T10:41:24,Valladolid,expenses,cash,-100.0,-23276.77
buyer_6,Manuel,Díez,1979-02-14,43668965S,manuel.díez@extremetech.io,146712,ES97209541159222930896,1625.21,2023-03-13T15:23:07,Valladolid,expenses,food,-61.38,-23338.15
buyer_6,Manuel,Díez,1979-02-14,43668965S,manuel.díez@extremetech.io,146712,ES97209541159222930896,1625.21,2023-03-14T16:13:38,Valladolid,expenses,repairs,-297.47,-23635.62
buyer_6,Manuel,Díez,1979-02-14,43668965S,manuel.díez@extremetech.io,146712,ES97209541159222930896,1625.21,2023-03-15T20:51:59,Valladolid,expenses,cash,-100.0,-23735.62
buyer_6,Manuel,Díez,1979-02-14,43668965S,manuel.díez@extremetech.io,146712,ES97209541159222930896,1625.21,2023-03-16T08:25:02,Valladolid,expenses,healthcare,-93.43,-23829.05
buyer_6,Manuel,Díez,1979-02-14,43668965S,manuel.díez@extremetech.io,146712,ES97209541159222930896,1625.21,2023-03-16T17:20:26,Valladolid,expenses,appliances,-148.94,-23977.99
buyer_6,Manuel,Díez,1979-02-14,43668965S,manuel.díez@extremetech.io,146712,ES97209541159222930896,1625.21,2023-03-21T13:56:39,Valladolid,expenses,clothing,-118.14,-24096.13
buyer_6,Manuel,Díez,1979-02-14,43668965S,manuel.díez@extremetech.io,146712,ES97209541159222930896,1625.21,2023-03-22T16:34:23,Valladolid,expenses,repairs,-173.55,-24269.68
buyer_6,Manuel,Díez,1979-02-14,43668965S,manuel.díez@extremetech.io,146712,ES97209541159222930896,1625.21,2023-03-24T20:43:31,Valladolid,expenses,food,-77.31,-24346.99
buyer_6,Manuel,Díez,1979-02-14,43668965S,manuel.díez@extremetech.io,146712,ES97209541159222930896,1625.21,2023-03-25T13:36:33,Valladolid,expenses,food,-97.38,-24444.37
buyer_6,Manuel,Díez,1979-02-14,43668965S,manuel.díez@extremetech.io,146712,ES97209541159222930896,1625.21,2023-03-25T15:00:08,Valladolid,expenses,cash,-100.0,-24544.37
buyer_6,Manuel,Díez,1979-02-14,43668965S,manuel.díez@extremetech.io,146712,ES97209541159222930896,1625.21,2023-03-30T11:19:35,Valladolid,expenses,clothing,-45.33,-24589.7
buyer_6,Manuel,Díez,1979-02-14,43668965S,manuel.díez@extremetech.io,146712,ES97209541159222930896,1625.21,2023-04-01T15:48:17,Valladolid,incomes,salary,3062.36,-21527.34
buyer_6,Manuel,Díez,1979-02-14,43668965S,manuel.díez@extremetech.io,146712,ES97209541159222930896,1625.21,2023-04-01T15:48:17,Valladolid,incomes,extra_income,330.25,-21197.09
buyer_6,Manuel,Díez,1979-02-14,43668965S,manuel.díez@extremetech.io,146712,ES97209541159222930896,1625.21,2023-04-02T13:52:35,Valladolid,expenses,food,-122.03,-21319.12
buyer_6,Manuel,Díez,1979-02-14,43668965S,manuel.díez@extremetech.io,146712,ES97209541159222930896,1625.21,2023-04-03T11:28:44,Valladolid,expenses,food,-75.52,-21394.64
buyer_6,Manuel,Díez,1979-02-14,43668965S,manuel.díez@extremetech.io,146712,ES97209541159222930896,1625.21,2023-04-03T22:32:46,Valladolid,expenses,cash,-100.0,-21494.64
buyer_6,Manuel,Díez,1979-02-14,43668965S,manuel.díez@extremetech.io,146712,ES97209541159222930896,1625.21,2023-04-04T12:02:32,Valladolid,expenses,education,-55.67,-21550.31
buyer_6,Manuel,Díez,1979-02-14,43668965S,manuel.díez@extremetech.io,146712,ES97209541159222930896,1625.21,2023-04-05T19:54:39,Valladolid,expenses,mortgage,-1572.51,-23122.82
buyer_6,Manuel,Díez,1979-02-14,43668965S,manuel.díez@extremetech.io,146712,ES97209541159222930896,1625.21,2023-04-05T18:50:40,Valladolid,expenses,water,-66.26,-23189.08
buyer_6,Manuel,Díez,1979-02-14,43668965S,manuel.díez@extremetech.io,146712,ES97209541159222930896,1625.21,2023-04-05T14:41:06,Valladolid,expenses,electricity,-101.51,-23290.59
buyer_6,Manuel,Díez,1979-02-14,43668965S,manuel.díez@extremetech.io,146712,ES97209541159222930896,1625.21,2023-04-05T11:19:46,Valladolid,expenses,gas,-164.71,-23455.3
buyer_6,Manuel,Díez,1979-02-14,43668965S,manuel.díez@extremetech.io,146712,ES97209541159222930896,1625.21,2023-04-06T16:04:02,Valladolid,expenses,gas,-161.42,-23616.72
buyer_6,Manuel,Díez,1979-02-14,43668965S,manuel.díez@extremetech.io,146712,ES97209541159222930896,1625.21,2023-04-06T10:10:47,Valladolid,expenses,internet,-64.31,-23681.03
buyer_6,Manuel,Díez,1979-02-14,43668965S,manuel.díez@extremetech.io,146712,ES97209541159222930896,1625.21,2023-04-07T13:24:41,Valladolid,expenses,phone,-47.47,-23728.5
buyer_6,Manuel,Díez,1979-02-14,43668965S,manuel.díez@extremetech.io,146712,ES97209541159222930896,1625.21,2023-04-08T18:15:05,Valladolid,expenses,food,-96.85,-23825.35
buyer_6,Manuel,Díez,1979-02-14,43668965S,manuel.díez@extremetech.io,146712,ES97209541159222930896,1625.21,2023-04-11T17:52:24,Valladolid,expenses,leisure,-57.35,-23882.7
buyer_6,Manuel,Díez,1979-02-14,43668965S,manuel.díez@extremetech.io,146712,ES97209541159222930896,1625.21,2023-04-11T06:14:47,Valladolid,expenses,cash,-100.0,-23982.7
buyer_6,Manuel,Díez,1979-02-14,43668965S,manuel.díez@extremetech.io,146712,ES97209541159222930896,1625.21,2023-04-16T20:48:00,Valladolid,expenses,food,-123.68,-24106.38
buyer_6,Manuel,Díez,1979-02-14,43668965S,manuel.díez@extremetech.io,146712,ES97209541159222930896,1625.21,2023-04-17T18:03:47,Valladolid,expenses,cash,-100.0,-24206.38
buyer_6,Manuel,Díez,1979-02-14,43668965S,manuel.díez@extremetech.io,146712,ES97209541159222930896,1625.21,2023-04-18T21:11:19,Valladolid,expenses,clothing,-111.39,-24317.77
buyer_6,Manuel,Díez,1979-02-14,43668965S,manuel.díez@extremetech.io,146712,ES97209541159222930896,1625.21,2023-04-18T15:42:54,Valladolid,expenses,repairs,-163.18,-24480.95
buyer_6,Manuel,Díez,1979-02-14,43668965S,manuel.díez@extremetech.io,146712,ES97209541159222930896,1625.21,2023-04-20T20:47:22,Valladolid,expenses,food,-121.66,-24602.61
buyer_6,Manuel,Díez,1979-02-14,43668965S,manuel.díez@extremetech.io,146712,ES97209541159222930896,1625.21,2023-04-21T19:48:57,Valladolid,expenses,food,-82.99,-24685.6
buyer_6,Manuel,Díez,1979-02-14,43668965S,manuel.díez@extremetech.io,146712,ES97209541159222930896,1625.21,2023-04-21T03:55:19,Valladolid,expenses,gifts,-294.42,-24980.02
buyer_6,Manuel,Díez,1979-02-14,43668965S,manuel.díez@extremetech.io,146712,ES97209541159222930896,1625.21,2023-04-22T15:49:37,Valladolid,expenses,healthcare,-135.6,-25115.62
buyer_6,Manuel,Díez,1979-02-14,43668965S,manuel.díez@extremetech.io,146712,ES97209541159222930896,1625.21,2023-04-24T17:35:10,Valladolid,expenses,food,-80.83,-25196.45
buyer_6,Manuel,Díez,1979-02-14,43668965S,manuel.díez@extremetech.io,146712,ES97209541159222930896,1625.21,2023-04-24T14:19:17,Valladolid,expenses,transport,-51.23,-25247.68
buyer_6,Manuel,Díez,1979-02-14,43668965S,manuel.díez@extremetech.io,146712,ES97209541159222930896,1625.21,2023-04-25T21:47:33,Valladolid,expenses,education,-78.07,-25325.75
buyer_6,Manuel,Díez,1979-02-14,43668965S,manuel.díez@extremetech.io,146712,ES97209541159222930896,1625.21,2023-04-28T10:10:44,Valladolid,expenses,transport,-46.24,-25371.99
buyer_6,Manuel,Díez,1979-02-14,43668965S,manuel.díez@extremetech.io,146712,ES97209541159222930896,1625.21,2023-04-29T13:04:43,Valladolid,expenses,transport,-41.32,-25413.31
buyer_6,Manuel,Díez,1979-02-14,43668965S,manuel.díez@extremetech.io,146712,ES97209541159222930896,1625.21,2023-04-29T13:00:18,Valladolid,expenses,healthcare,-162.61,-25575.92
buyer_6,Manuel,Díez,1979-02-14,43668965S,manuel.díez@extremetech.io,146712,ES97209541159222930896,1625.21,2023-04-29T12:21:42,Valladolid,expenses,cash,-100.0,-25675.92
buyer_6,Manuel,Díez,1979-02-14,43668965S,manuel.díez@extremetech.io,146712,ES97209541159222930896,1625.21,2023-05-01T15:18:23,Valladolid,incomes,salary,3062.36,-22613.56
buyer_6,Manuel,Díez,1979-02-14,43668965S,manuel.díez@extremetech.io,146712,ES97209541159222930896,1625.21,2023-05-01T15:21:05,Valladolid,expenses,leisure,-23.48,-22637.04
buyer_6,Manuel,Díez,1979-02-14,43668965S,manuel.díez@extremetech.io,146712,ES97209541159222930896,1625.21,2023-05-01T13:51:39,Valladolid,expenses,gifts,-824.53,-23461.57
buyer_6,Manuel,Díez,1979-02-14,43668965S,manuel.díez@extremetech.io,146712,ES97209541159222930896,1625.21,2023-05-02T06:54:18,Valladolid,expenses,leisure,-54.38,-23515.95
buyer_6,Manuel,Díez,1979-02-14,43668965S,manuel.díez@extremetech.io,146712,ES97209541159222930896,1625.21,2023-05-05T09:07:15,Valladolid,expenses,mortgage,-1572.51,-25088.46
buyer_6,Manuel,Díez,1979-02-14,43668965S,manuel.díez@extremetech.io,146712,ES97209541159222930896,1625.21,2023-05-05T02:11:38,Valladolid,expenses,food,-76.54,-25165.0
buyer_6,Manuel,Díez,1979-02-14,43668965S,manuel.díez@extremetech.io,146712,ES97209541159222930896,1625.21,2023-05-05T09:55:19,Valladolid,expenses,clothing,-77.09,-25242.09
buyer_6,Manuel,Díez,1979-02-14,43668965S,manuel.díez@extremetech.io,146712,ES97209541159222930896,1625.21,2023-05-06T19:53:35,Valladolid,expenses,internet,-64.31,-25306.4
buyer_6,Manuel,Díez,1979-02-14,43668965S,manuel.díez@extremetech.io,146712,ES97209541159222930896,1625.21,2023-05-06T14:35:02,Valladolid,expenses,phone,-47.03,-25353.43
buyer_6,Manuel,Díez,1979-02-14,43668965S,manuel.díez@extremetech.io,146712,ES97209541159222930896,1625.21,2023-05-07T19:14:13,Valladolid,expenses,phone,-58.54,-25411.97
buyer_6,Manuel,Díez,1979-02-14,43668965S,manuel.díez@extremetech.io,146712,ES97209541159222930896,1625.21,2023-05-07T22:33:59,Valladolid,expenses,transport,-77.63,-25489.6
buyer_6,Manuel,Díez,1979-02-14,43668965S,manuel.díez@extremetech.io,146712,ES97209541159222930896,1625.21,2023-05-07T17:42:15,Valladolid,expenses,leisure,-46.19,-25535.79
buyer_6,Manuel,Díez,1979-02-14,43668965S,manuel.díez@extremetech.io,146712,ES97209541159222930896,1625.21,2023-05-07T17:09:19,Valladolid,expenses,appliances,-232.76,-25768.55
buyer_6,Manuel,Díez,1979-02-14,43668965S,manuel.díez@extremetech.io,146712,ES97209541159222930896,1625.21,2023-05-08T19:54:23,Valladolid,expenses,gas,-84.15,-25852.7
buyer_6,Manuel,Díez,1979-02-14,43668965S,manuel.díez@extremetech.io,146712,ES97209541159222930896,1625.21,2023-05-09T15:34:56,Valladolid,expenses,healthcare,-41.09,-25893.79
buyer_6,Manuel,Díez,1979-02-14,43668965S,manuel.díez@extremetech.io,146712,ES97209541159222930896,1625.21,2023-05-09T21:01:19,Valladolid,expenses,education,-46.78,-25940.57
buyer_6,Manuel,Díez,1979-02-14,43668965S,manuel.díez@extremetech.io,146712,ES97209541159222930896,1625.21,2023-05-09T17:37:03,Valladolid,expenses,repairs,-250.67,-26191.24
buyer_6,Manuel,Díez,1979-02-14,43668965S,manuel.díez@extremetech.io,146712,ES97209541159222930896,1625.21,2023-05-10T13:14:57,Valladolid,expenses,leisure,-80.12,-26271.36
buyer_6,Manuel,Díez,1979-02-14,43668965S,manuel.díez@extremetech.io,146712,ES97209541159222930896,1625.21,2023-05-13T15:28:06,Valladolid,expenses,leisure,-36.18,-26307.54
buyer_6,Manuel,Díez,1979-02-14,43668965S,manuel.díez@extremetech.io,146712,ES97209541159222930896,1625.21,2023-05-13T16:29:46,Valladolid,expenses,repairs,-220.53,-26528.07
buyer_6,Manuel,Díez,1979-02-14,43668965S,manuel.díez@extremetech.io,146712,ES97209541159222930896,1625.21,2023-05-14T20:10:57,Valladolid,expenses,leisure,-27.77,-26555.84
buyer_6,Manuel,Díez,1979-02-14,43668965S,manuel.díez@extremetech.io,146712,ES97209541159222930896,1625.21,2023-05-14T10:08:10,Valladolid,expenses,cash,-100.0,-26655.84
buyer_6,Manuel,Díez,1979-02-14,43668965S,manuel.díez@extremetech.io,146712,ES97209541159222930896,1625.21,2023-05-15T19:45:00,Valladolid,expenses,gifts,-551.24,-27207.08
buyer_6,Manuel,Díez,1979-02-14,43668965S,manuel.díez@extremetech.io,146712,ES97209541159222930896,1625.21,2023-05-17T17:56:06,Valladolid,expenses,repairs,-86.83,-27293.91
buyer_6,Manuel,Díez,1979-02-14,43668965S,manuel.díez@extremetech.io,146712,ES97209541159222930896,1625.21,2023-05-18T20:01:21,Valladolid,expenses,gifts,-109.81,-27403.72
buyer_6,Manuel,Díez,1979-02-14,43668965S,manuel.díez@extremetech.io,146712,ES97209541159222930896,1625.21,2023-05-20T14:38:25,Valladolid,expenses,repairs,-117.4,-27521.12
buyer_6,Manuel,Díez,1979-02-14,43668965S,manuel.díez@extremetech.io,146712,ES97209541159222930896,1625.21,2023-05-21T15:39:45,Valladolid,expenses,cash,-100.0,-27621.12
buyer_6,Manuel,Díez,1979-02-14,43668965S,manuel.díez@extremetech.io,146712,ES97209541159222930896,1625.21,2023-05-21T16:31:02,Valladolid,expenses,appliances,-339.09,-27960.21
buyer_6,Manuel,Díez,1979-02-14,43668965S,manuel.díez@extremetech.io,146712,ES97209541159222930896,1625.21,2023-05-23T17:45:22,Valladolid,expenses,leisure,-19.68,-27979.89
buyer_6,Manuel,Díez,1979-02-14,43668965S,manuel.díez@extremetech.io,146712,ES97209541159222930896,1625.21,2023-05-23T18:57:06,Valladolid,expenses,clothing,-83.46,-28063.35
buyer_6,Manuel,Díez,1979-02-14,43668965S,manuel.díez@extremetech.io,146712,ES97209541159222930896,1625.21,2023-05-23T19:17:15,Valladolid,expenses,cash,-100.0,-28163.35
buyer_6,Manuel,Díez,1979-02-14,43668965S,manuel.díez@extremetech.io,146712,ES97209541159222930896,1625.21,2023-05-25T12:32:02,Valladolid,expenses,leisure,-30.57,-28193.92
buyer_6,Manuel,Díez,1979-02-14,43668965S,manuel.díez@extremetech.io,146712,ES97209541159222930896,1625.21,2023-05-25T09:29:24,Valladolid,expenses,travel,-391.09,-28585.01
buyer_6,Manuel,Díez,1979-02-14,43668965S,manuel.díez@extremetech.io,146712,ES97209541159222930896,1625.21,2023-05-26T12:22:37,Valladolid,expenses,repairs,-115.73,-28700.74
buyer_6,Manuel,Díez,1979-02-14,43668965S,manuel.díez@extremetech.io,146712,ES97209541159222930896,1625.21,2023-05-29T17:51:23,Valladolid,expenses,transport,-51.85,-28752.59
buyer_6,Manuel,Díez,1979-02-14,43668965S,manuel.díez@extremetech.io,146712,ES97209541159222930896,1625.21,2023-05-30T03:22:22,Valladolid,expenses,food,-90.32,-28842.91
buyer_6,Manuel,Díez,1979-02-14,43668965S,manuel.díez@extremetech.io,146712,ES97209541159222930896,1625.21,2023-06-01T13:36:10,Valladolid,incomes,salary,3062.36,-25780.55
buyer_6,Manuel,Díez,1979-02-14,43668965S,manuel.díez@extremetech.io,146712,ES97209541159222930896,1625.21,2023-06-01T13:36:10,Valladolid,incomes,salary_bonus,2203.39,-23577.16
buyer_6,Manuel,Díez,1979-02-14,43668965S,manuel.díez@extremetech.io,146712,ES97209541159222930896,1625.21,2023-06-01T20:08:16,Valladolid,expenses,taxes,-1966.19,-25543.35
buyer_6,Manuel,Díez,1979-02-14,43668965S,manuel.díez@extremetech.io,146712,ES97209541159222930896,1625.21,2023-06-01T11:02:36,Valladolid,expenses,insurance,-559.12,-26102.47
buyer_6,Manuel,Díez,1979-02-14,43668965S,manuel.díez@extremetech.io,146712,ES97209541159222930896,1625.21,2023-06-03T14:43:56,Valladolid,expenses,leisure,-48.0,-26150.47
buyer_6,Manuel,Díez,1979-02-14,43668965S,manuel.díez@extremetech.io,146712,ES97209541159222930896,1625.21,2023-06-03T17:26:12,Valladolid,expenses,cash,-100.0,-26250.47
buyer_6,Manuel,Díez,1979-02-14,43668965S,manuel.díez@extremetech.io,146712,ES97209541159222930896,1625.21,2023-06-05T08:57:01,Valladolid,expenses,mortgage,-1572.51,-27822.98
buyer_6,Manuel,Díez,1979-02-14,43668965S,manuel.díez@extremetech.io,146712,ES97209541159222930896,1625.21,2023-06-05T18:13:46,Valladolid,expenses,water,-33.34,-27856.32
buyer_6,Manuel,Díez,1979-02-14,43668965S,manuel.díez@extremetech.io,146712,ES97209541159222930896,1625.21,2023-06-05T08:31:57,Valladolid,expenses,electricity,-47.68,-27904.0
buyer_6,Manuel,Díez,1979-02-14,43668965S,manuel.díez@extremetech.io,146712,ES97209541159222930896,1625.21,2023-06-05T19:31:53,Valladolid,expenses,gas,-166.92,-28070.92
buyer_6,Manuel,Díez,1979-02-14,43668965S,manuel.díez@extremetech.io,146712,ES97209541159222930896,1625.21,2023-06-05T10:38:55,Valladolid,expenses,internet,-64.31,-28135.23
buyer_6,Manuel,Díez,1979-02-14,43668965S,manuel.díez@extremetech.io,146712,ES97209541159222930896,1625.21,2023-06-05T11:54:28,Valladolid,expenses,cash,-100.0,-28235.23
buyer_6,Manuel,Díez,1979-02-14,43668965S,manuel.díez@extremetech.io,146712,ES97209541159222930896,1625.21,2023-06-06T08:46:47,Valladolid,expenses,gas,-114.9,-28350.13
buyer_6,Manuel,Díez,1979-02-14,43668965S,manuel.díez@extremetech.io,146712,ES97209541159222930896,1625.21,2023-06-07T14:57:10,Valladolid,expenses,water,-61.61,-28411.74
buyer_6,Manuel,Díez,1979-02-14,43668965S,manuel.díez@extremetech.io,146712,ES97209541159222930896,1625.21,2023-06-07T11:17:04,Valladolid,expenses,internet,-64.31,-28476.05
buyer_6,Manuel,Díez,1979-02-14,43668965S,manuel.díez@extremetech.io,146712,ES97209541159222930896,1625.21,2023-06-08T19:07:51,Valladolid,expenses,electricity,-127.4,-28603.45
buyer_6,Manuel,Díez,1979-02-14,43668965S,manuel.díez@extremetech.io,146712,ES97209541159222930896,1625.21,2023-06-08T20:25:39,Valladolid,expenses,food,-83.72,-28687.17
buyer_6,Manuel,Díez,1979-02-14,43668965S,manuel.díez@extremetech.io,146712,ES97209541159222930896,1625.21,2023-06-09T10:35:26,Valladolid,expenses,travel,-925.75,-29612.92
buyer_6,Manuel,Díez,1979-02-14,43668965S,manuel.díez@extremetech.io,146712,ES97209541159222930896,1625.21,2023-06-10T11:43:48,Valladolid,expenses,cash,-100.0,-29712.92
buyer_6,Manuel,Díez,1979-02-14,43668965S,manuel.díez@extremetech.io,146712,ES97209541159222930896,1625.21,2023-06-11T17:34:33,Valladolid,expenses,food,-95.98,-29808.9
buyer_6,Manuel,Díez,1979-02-14,43668965S,manuel.díez@extremetech.io,146712,ES97209541159222930896,1625.21,2023-06-12T09:17:48,Valladolid,expenses,cash,-100.0,-29908.9
buyer_6,Manuel,Díez,1979-02-14,43668965S,manuel.díez@extremetech.io,146712,ES97209541159222930896,1625.21,2023-06-13T16:07:21,Valladolid,expenses,leisure,-63.21,-29972.11
buyer_6,Manuel,Díez,1979-02-14,43668965S,manuel.díez@extremetech.io,146712,ES97209541159222930896,1625.21,2023-06-15T11:19:58,Valladolid,expenses,healthcare,-145.45,-30117.56
buyer_6,Manuel,Díez,1979-02-14,43668965S,manuel.díez@extremetech.io,146712,ES97209541159222930896,1625.21,2023-06-17T11:58:19,Valladolid,expenses,transport,-80.04,-30197.6
buyer_6,Manuel,Díez,1979-02-14,43668965S,manuel.díez@extremetech.io,146712,ES97209541159222930896,1625.21,2023-06-18T09:34:56,Valladolid,expenses,transport,-61.04,-30258.64
buyer_6,Manuel,Díez,1979-02-14,43668965S,manuel.díez@extremetech.io,146712,ES97209541159222930896,1625.21,2023-06-19T09:34:26,Valladolid,expenses,leisure,-43.88,-30302.52
buyer_6,Manuel,Díez,1979-02-14,43668965S,manuel.díez@extremetech.io,146712,ES97209541159222930896,1625.21,2023-06-21T14:48:48,Valladolid,expenses,transport,-70.07,-30372.59
buyer_6,Manuel,Díez,1979-02-14,43668965S,manuel.díez@extremetech.io,146712,ES97209541159222930896,1625.21,2023-06-22T17:27:26,Valladolid,expenses,leisure,-25.74,-30398.33
buyer_6,Manuel,Díez,1979-02-14,43668965S,manuel.díez@extremetech.io,146712,ES97209541159222930896,1625.21,2023-06-22T16:18:44,Valladolid,expenses,cash,-100.0,-30498.33
buyer_6,Manuel,Díez,1979-02-14,43668965S,manuel.díez@extremetech.io,146712,ES97209541159222930896,1625.21,2023-06-23T09:18:34,Valladolid,expenses,cash,-100.0,-30598.33
buyer_6,Manuel,Díez,1979-02-14,43668965S,manuel.díez@extremetech.io,146712,ES97209541159222930896,1625.21,2023-06-24T13:12:58,Valladolid,expenses,repairs,-224.82,-30823.15
buyer_6,Manuel,Díez,1979-02-14,43668965S,manuel.díez@extremetech.io,146712,ES97209541159222930896,1625.21,2023-06-26T11:00:09,Valladolid,expenses,clothing,-150.1,-30973.25
buyer_6,Manuel,Díez,1979-02-14,43668965S,manuel.díez@extremetech.io,146712,ES97209541159222930896,1625.21,2023-06-27T13:26:39,Valladolid,expenses,cash,-100.0,-31073.25
buyer_6,Manuel,Díez,1979-02-14,43668965S,manuel.díez@extremetech.io,146712,ES97209541159222930896,1625.21,2023-06-29T16:44:49,Valladolid,expenses,cash,-100.0,-31173.25
buyer_6,Manuel,Díez,1979-02-14,43668965S,manuel.díez@extremetech.io,146712,ES97209541159222930896,1625.21,2023-06-29T18:36:33,Valladolid,expenses,repairs,-157.13,-31330.38
buyer_6,Manuel,Díez,1979-02-14,43668965S,manuel.díez@extremetech.io,146712,ES97209541159222930896,1625.21,2023-06-30T19:57:36,Valladolid,expenses,healthcare,-180.98,-31511.36
buyer_6,Manuel,Díez,1979-02-14,43668965S,manuel.díez@extremetech.io,146712,ES97209541159222930896,1625.21,2023-06-30T12:03:49,Valladolid,expenses,cash,-100.0,-31611.36
buyer_6,Manuel,Díez,1979-02-14,43668965S,manuel.díez@extremetech.io,146712,ES97209541159222930896,1625.21,2023-06-30T13:18:59,Valladolid,expenses,appliances,-96.11,-31707.47
buyer_6,Manuel,Díez,1979-02-14,43668965S,manuel.díez@extremetech.io,146712,ES97209541159222930896,1625.21,2023-07-01T11:47:29,Valladolid,incomes,salary,3062.36,-28645.11
buyer_6,Manuel,Díez,1979-02-14,43668965S,manuel.díez@extremetech.io,146712,ES97209541159222930896,1625.21,2023-07-01T14:47:33,Valladolid,expenses,education,-71.49,-28716.6
buyer_6,Manuel,Díez,1979-02-14,43668965S,manuel.díez@extremetech.io,146712,ES97209541159222930896,1625.21,2023-07-01T20:21:57,Valladolid,expenses,cash,-100.0,-28816.6
buyer_6,Manuel,Díez,1979-02-14,43668965S,manuel.díez@extremetech.io,146712,ES97209541159222930896,1625.21,2023-07-04T22:18:06,Valladolid,expenses,transport,-69.6,-28886.2
buyer_6,Manuel,Díez,1979-02-14,43668965S,manuel.díez@extremetech.io,146712,ES97209541159222930896,1625.21,2023-07-05T18:41:57,Valladolid,expenses,mortgage,-1572.51,-30458.71
buyer_6,Manuel,Díez,1979-02-14,43668965S,manuel.díez@extremetech.io,146712,ES97209541159222930896,1625.21,2023-07-05T09:31:47,Valladolid,expenses,electricity,-97.68,-30556.39
buyer_6,Manuel,Díez,1979-02-14,43668965S,manuel.díez@extremetech.io,146712,ES97209541159222930896,1625.21,2023-07-05T14:52:01,Valladolid,expenses,cash,-100.0,-30656.39
buyer_6,Manuel,Díez,1979-02-14,43668965S,manuel.díez@extremetech.io,146712,ES97209541159222930896,1625.21,2023-07-06T13:59:35,Valladolid,expenses,water,-52.87,-30709.26
buyer_6,Manuel,Díez,1979-02-14,43668965S,manuel.díez@extremetech.io,146712,ES97209541159222930896,1625.21,2023-07-06T08:31:21,Valladolid,expenses,phone,-61.13,-30770.39
buyer_6,Manuel,Díez,1979-02-14,43668965S,manuel.díez@extremetech.io,146712,ES97209541159222930896,1625.21,2023-07-06T17:18:12,Valladolid,expenses,food,-96.16,-30866.55
buyer_6,Manuel,Díez,1979-02-14,43668965S,manuel.díez@extremetech.io,146712,ES97209541159222930896,1625.21,2023-07-06T18:13:59,Valladolid,expenses,transport,-66.29,-30932.84
buyer_6,Manuel,Díez,1979-02-14,43668965S,manuel.díez@extremetech.io,146712,ES97209541159222930896,1625.21,2023-07-06T22:02:21,Valladolid,expenses,healthcare,-145.02,-31077.86
buyer_6,Manuel,Díez,1979-02-14,43668965S,manuel.díez@extremetech.io,146712,ES97209541159222930896,1625.21,2023-07-06T11:04:33,Valladolid,expenses,cash,-100.0,-31177.86
buyer_6,Manuel,Díez,1979-02-14,43668965S,manuel.díez@extremetech.io,146712,ES97209541159222930896,1625.21,2023-07-07T14:20:08,Valladolid,expenses,phone,-58.74,-31236.6
buyer_6,Manuel,Díez,1979-02-14,43668965S,manuel.díez@extremetech.io,146712,ES97209541159222930896,1625.21,2023-07-07T10:58:08,Valladolid,expenses,healthcare,-132.9,-31369.5
buyer_6,Manuel,Díez,1979-02-14,43668965S,manuel.díez@extremetech.io,146712,ES97209541159222930896,1625.21,2023-07-08T09:44:13,Valladolid,expenses,electricity,-42.09,-31411.59
buyer_6,Manuel,Díez,1979-02-14,43668965S,manuel.díez@extremetech.io,146712,ES97209541159222930896,1625.21,2023-07-08T17:53:19,Valladolid,expenses,gas,-116.24,-31527.83
buyer_6,Manuel,Díez,1979-02-14,43668965S,manuel.díez@extremetech.io,146712,ES97209541159222930896,1625.21,2023-07-08T10:53:59,Valladolid,expenses,phone,-67.46,-31595.29
buyer_6,Manuel,Díez,1979-02-14,43668965S,manuel.díez@extremetech.io,146712,ES97209541159222930896,1625.21,2023-07-13T17:57:40,Valladolid,expenses,cash,-100.0,-31695.29
buyer_6,Manuel,Díez,1979-02-14,43668965S,manuel.díez@extremetech.io,146712,ES97209541159222930896,1625.21,2023-07-16T07:06:21,Valladolid,expenses,transport,-77.11,-31772.4
buyer_6,Manuel,Díez,1979-02-14,43668965S,manuel.díez@extremetech.io,146712,ES97209541159222930896,1625.21,2023-07-17T10:14:41,Valladolid,expenses,repairs,-318.87,-32091.27
buyer_6,Manuel,Díez,1979-02-14,43668965S,manuel.díez@extremetech.io,146712,ES97209541159222930896,1625.21,2023-07-17T08:45:28,Valladolid,expenses,gifts,-72.99,-32164.26
buyer_6,Manuel,Díez,1979-02-14,43668965S,manuel.díez@extremetech.io,146712,ES97209541159222930896,1625.21,2023-07-18T09:33:00,Valladolid,expenses,food,-73.2,-32237.46
buyer_6,Manuel,Díez,1979-02-14,43668965S,manuel.díez@extremetech.io,146712,ES97209541159222930896,1625.21,2023-07-19T20:28:33,Valladolid,expenses,food,-102.89,-32340.35
buyer_6,Manuel,Díez,1979-02-14,43668965S,manuel.díez@extremetech.io,146712,ES97209541159222930896,1625.21,2023-07-20T19:54:06,Valladolid,expenses,leisure,-78.51,-32418.86
buyer_6,Manuel,Díez,1979-02-14,43668965S,manuel.díez@extremetech.io,146712,ES97209541159222930896,1625.21,2023-07-21T22:40:32,Valladolid,expenses,transport,-57.47,-32476.33
buyer_6,Manuel,Díez,1979-02-14,43668965S,manuel.díez@extremetech.io,146712,ES97209541159222930896,1625.21,2023-07-22T16:09:56,Valladolid,expenses,food,-97.84,-32574.17
buyer_6,Manuel,Díez,1979-02-14,43668965S,manuel.díez@extremetech.io,146712,ES97209541159222930896,1625.21,2023-07-22T19:49:35,Valladolid,expenses,education,-66.64,-32640.81
buyer_6,Manuel,Díez,1979-02-14,43668965S,manuel.díez@extremetech.io,146712,ES97209541159222930896,1625.21,2023-07-25T10:48:52,Valladolid,expenses,leisure,-35.34,-32676.15
buyer_6,Manuel,Díez,1979-02-14,43668965S,manuel.díez@extremetech.io,146712,ES97209541159222930896,1625.21,2023-07-26T15:00:57,Valladolid,expenses,transport,-88.11,-32764.26
buyer_6,Manuel,Díez,1979-02-14,43668965S,manuel.díez@extremetech.io,146712,ES97209541159222930896,1625.21,2023-07-27T21:21:28,Valladolid,expenses,cash,-100.0,-32864.26
buyer_6,Manuel,Díez,1979-02-14,43668965S,manuel.díez@extremetech.io,146712,ES97209541159222930896,1625.21,2023-07-27T20:13:54,Valladolid,expenses,repairs,-47.24,-32911.5
buyer_6,Manuel,Díez,1979-02-14,43668965S,manuel.díez@extremetech.io,146712,ES97209541159222930896,1625.21,2023-07-28T20:37:39,Valladolid,expenses,repairs,-218.03,-33129.53
buyer_6,Manuel,Díez,1979-02-14,43668965S,manuel.díez@extremetech.io,146712,ES97209541159222930896,1625.21,2023-07-29T10:52:11,Valladolid,expenses,transport,-71.08,-33200.61
buyer_6,Manuel,Díez,1979-02-14,43668965S,manuel.díez@extremetech.io,146712,ES97209541159222930896,1625.21,2023-07-29T16:25:27,Valladolid,expenses,leisure,-40.08,-33240.69
buyer_6,Manuel,Díez,1979-02-14,43668965S,manuel.díez@extremetech.io,146712,ES97209541159222930896,1625.21,2023-07-29T16:52:26,Valladolid,expenses,cash,-100.0,-33340.69
buyer_6,Manuel,Díez,1979-02-14,43668965S,manuel.díez@extremetech.io,146712,ES97209541159222930896,1625.21,2023-07-30T11:47:45,Valladolid,expenses,cash,-100.0,-33440.69
buyer_6,Manuel,Díez,1979-02-14,43668965S,manuel.díez@extremetech.io,146712,ES97209541159222930896,1625.21,2023-07-30T12:27:24,Valladolid,expenses,repairs,-154.0,-33594.69
buyer_6,Manuel,Díez,1979-02-14,43668965S,manuel.díez@extremetech.io,146712,ES97209541159222930896,1625.21,2023-08-01T08:46:42,Valladolid,incomes,salary,3062.36,-30532.33
buyer_6,Manuel,Díez,1979-02-14,43668965S,manuel.díez@extremetech.io,146712,ES97209541159222930896,1625.21,2023-08-01T08:46:42,Valladolid,incomes,extra_income,330.25,-30202.08
buyer_6,Manuel,Díez,1979-02-14,43668965S,manuel.díez@extremetech.io,146712,ES97209541159222930896,1625.21,2023-08-01T08:49:56,Valladolid,expenses,healthcare,-40.66,-30242.74
buyer_6,Manuel,Díez,1979-02-14,43668965S,manuel.díez@extremetech.io,146712,ES97209541159222930896,1625.21,2023-08-01T10:32:42,Valladolid,expenses,repairs,-224.87,-30467.61
buyer_6,Manuel,Díez,1979-02-14,43668965S,manuel.díez@extremetech.io,146712,ES97209541159222930896,1625.21,2023-08-02T10:48:46,Valladolid,expenses,leisure,-33.59,-30501.2
buyer_6,Manuel,Díez,1979-02-14,43668965S,manuel.díez@extremetech.io,146712,ES97209541159222930896,1625.21,2023-08-02T15:29:52,Valladolid,expenses,cash,-100.0,-30601.2
buyer_6,Manuel,Díez,1979-02-14,43668965S,manuel.díez@extremetech.io,146712,ES97209541159222930896,1625.21,2023-08-03T14:14:54,Valladolid,expenses,transport,-54.52,-30655.72
buyer_6,Manuel,Díez,1979-02-14,43668965S,manuel.díez@extremetech.io,146712,ES97209541159222930896,1625.21,2023-08-03T16:04:39,Valladolid,expenses,cash,-100.0,-30755.72
buyer_6,Manuel,Díez,1979-02-14,43668965S,manuel.díez@extremetech.io,146712,ES97209541159222930896,1625.21,2023-08-03T13:18:23,Valladolid,expenses,travel,-792.11,-31547.83
buyer_6,Manuel,Díez,1979-02-14,43668965S,manuel.díez@extremetech.io,146712,ES97209541159222930896,1625.21,2023-08-05T18:47:04,Valladolid,expenses,mortgage,-1572.51,-33120.34
buyer_6,Manuel,Díez,1979-02-14,43668965S,manuel.díez@extremetech.io,146712,ES97209541159222930896,1625.21,2023-08-05T15:18:55,Valladolid,expenses,water,-67.82,-33188.16
buyer_6,Manuel,Díez,1979-02-14,43668965S,manuel.díez@extremetech.io,146712,ES97209541159222930896,1625.21,2023-08-05T20:58:02,Valladolid,expenses,internet,-64.31,-33252.47
buyer_6,Manuel,Díez,1979-02-14,43668965S,manuel.díez@extremetech.io,146712,ES97209541159222930896,1625.21,2023-08-05T19:28:35,Valladolid,expenses,leisure,-47.4,-33299.87
buyer_6,Manuel,Díez,1979-02-14,43668965S,manuel.díez@extremetech.io,146712,ES97209541159222930896,1625.21,2023-08-06T08:39:57,Valladolid,expenses,electricity,-82.15,-33382.02
buyer_6,Manuel,Díez,1979-02-14,43668965S,manuel.díez@extremetech.io,146712,ES97209541159222930896,1625.21,2023-08-06T22:54:42,Valladolid,expenses,leisure,-32.54,-33414.56
buyer_6,Manuel,Díez,1979-02-14,43668965S,manuel.díez@extremetech.io,146712,ES97209541159222930896,1625.21,2023-08-07T08:00:21,Valladolid,expenses,gas,-78.13,-33492.69
buyer_6,Manuel,Díez,1979-02-14,43668965S,manuel.díez@extremetech.io,146712,ES97209541159222930896,1625.21,2023-08-07T23:54:57,Valladolid,expenses,leisure,-80.59,-33573.28
buyer_6,Manuel,Díez,1979-02-14,43668965S,manuel.díez@extremetech.io,146712,ES97209541159222930896,1625.21,2023-08-07T20:03:59,Valladolid,expenses,cash,-100.0,-33673.28
buyer_6,Manuel,Díez,1979-02-14,43668965S,manuel.díez@extremetech.io,146712,ES97209541159222930896,1625.21,2023-08-08T15:33:08,Valladolid,expenses,gas,-128.19,-33801.47
buyer_6,Manuel,Díez,1979-02-14,43668965S,manuel.díez@extremetech.io,146712,ES97209541159222930896,1625.21,2023-08-08T09:28:09,Valladolid,expenses,transport,-45.54,-33847.01
buyer_6,Manuel,Díez,1979-02-14,43668965S,manuel.díez@extremetech.io,146712,ES97209541159222930896,1625.21,2023-08-09T12:30:19,Valladolid,expenses,food,-87.06,-33934.07
buyer_6,Manuel,Díez,1979-02-14,43668965S,manuel.díez@extremetech.io,146712,ES97209541159222930896,1625.21,2023-08-11T08:33:41,Valladolid,expenses,cash,-100.0,-34034.07
buyer_6,Manuel,Díez,1979-02-14,43668965S,manuel.díez@extremetech.io,146712,ES97209541159222930896,1625.21,2023-08-11T16:43:15,Valladolid,expenses,gifts,-301.5,-34335.57
buyer_6,Manuel,Díez,1979-02-14,43668965S,manuel.díez@extremetech.io,146712,ES97209541159222930896,1625.21,2023-08-14T13:17:09,Valladolid,expenses,transport,-66.88,-34402.45
buyer_6,Manuel,Díez,1979-02-14,43668965S,manuel.díez@extremetech.io,146712,ES97209541159222930896,1625.21,2023-08-14T20:21:40,Valladolid,expenses,cash,-100.0,-34502.45
buyer_6,Manuel,Díez,1979-02-14,43668965S,manuel.díez@extremetech.io,146712,ES97209541159222930896,1625.21,2023-08-16T22:29:15,Valladolid,expenses,gifts,-94.11,-34596.56
buyer_6,Manuel,Díez,1979-02-14,43668965S,manuel.díez@extremetech.io,146712,ES97209541159222930896,1625.21,2023-08-17T08:10:07,Valladolid,expenses,leisure,-57.5,-34654.06
buyer_6,Manuel,Díez,1979-02-14,43668965S,manuel.díez@extremetech.io,146712,ES97209541159222930896,1625.21,2023-08-18T13:39:17,Valladolid,expenses,transport,-69.82,-34723.88
buyer_6,Manuel,Díez,1979-02-14,43668965S,manuel.díez@extremetech.io,146712,ES97209541159222930896,1625.21,2023-08-18T10:16:22,Valladolid,expenses,leisure,-56.69,-34780.57
buyer_6,Manuel,Díez,1979-02-14,43668965S,manuel.díez@extremetech.io,146712,ES97209541159222930896,1625.21,2023-08-19T20:45:43,Valladolid,expenses,transport,-72.08,-34852.65
buyer_6,Manuel,Díez,1979-02-14,43668965S,manuel.díez@extremetech.io,146712,ES97209541159222930896,1625.21,2023-08-23T08:51:20,Valladolid,expenses,leisure,-83.05,-34935.7
buyer_6,Manuel,Díez,1979-02-14,43668965S,manuel.díez@extremetech.io,146712,ES97209541159222930896,1625.21,2023-08-25T22:58:31,Valladolid,expenses,food,-93.05,-35028.75
buyer_6,Manuel,Díez,1979-02-14,43668965S,manuel.díez@extremetech.io,146712,ES97209541159222930896,1625.21,2023-08-26T10:20:39,Valladolid,expenses,transport,-73.37,-35102.12
buyer_6,Manuel,Díez,1979-02-14,43668965S,manuel.díez@extremetech.io,146712,ES97209541159222930896,1625.21,2023-08-27T12:25:59,Valladolid,expenses,gifts,-776.27,-35878.39
buyer_6,Manuel,Díez,1979-02-14,43668965S,manuel.díez@extremetech.io,146712,ES97209541159222930896,1625.21,2023-08-28T19:23:09,Valladolid,expenses,leisure,-31.44,-35909.83
buyer_6,Manuel,Díez,1979-02-14,43668965S,manuel.díez@extremetech.io,146712,ES97209541159222930896,1625.21,2023-08-29T10:16:25,Valladolid,expenses,transport,-86.62,-35996.45
buyer_6,Manuel,Díez,1979-02-14,43668965S,manuel.díez@extremetech.io,146712,ES97209541159222930896,1625.21,2023-08-30T12:22:34,Valladolid,expenses,food,-106.63,-36103.08
buyer_6,Manuel,Díez,1979-02-14,43668965S,manuel.díez@extremetech.io,146712,ES97209541159222930896,1625.21,2023-09-01T10:18:23,Valladolid,incomes,salary,3062.36,-33040.72
buyer_6,Manuel,Díez,1979-02-14,43668965S,manuel.díez@extremetech.io,146712,ES97209541159222930896,1625.21,2023-09-01T15:29:48,Valladolid,expenses,food,-96.56,-33137.28
buyer_6,Manuel,Díez,1979-02-14,43668965S,manuel.díez@extremetech.io,146712,ES97209541159222930896,1625.21,2023-09-01T19:42:04,Valladolid,expenses,cash,-100.0,-33237.28
buyer_6,Manuel,Díez,1979-02-14,43668965S,manuel.díez@extremetech.io,146712,ES97209541159222930896,1625.21,2023-09-02T18:47:14,Valladolid,expenses,food,-87.18,-33324.46
buyer_6,Manuel,Díez,1979-02-14,43668965S,manuel.díez@extremetech.io,146712,ES97209541159222930896,1625.21,2023-09-04T21:39:41,Valladolid,expenses,healthcare,-187.05,-33511.51
buyer_6,Manuel,Díez,1979-02-14,43668965S,manuel.díez@extremetech.io,146712,ES97209541159222930896,1625.21,2023-09-05T12:05:35,Valladolid,expenses,mortgage,-1572.51,-35084.02
buyer_6,Manuel,Díez,1979-02-14,43668965S,manuel.díez@extremetech.io,146712,ES97209541159222930896,1625.21,2023-09-05T16:33:24,Valladolid,expenses,water,-35.78,-35119.8
buyer_6,Manuel,Díez,1979-02-14,43668965S,manuel.díez@extremetech.io,146712,ES97209541159222930896,1625.21,2023-09-05T08:13:15,Valladolid,expenses,healthcare,-156.57,-35276.37
buyer_6,Manuel,Díez,1979-02-14,43668965S,manuel.díez@extremetech.io,146712,ES97209541159222930896,1625.21,2023-09-06T20:52:56,Valladolid,expenses,gas,-64.4,-35340.77
buyer_6,Manuel,Díez,1979-02-14,43668965S,manuel.díez@extremetech.io,146712,ES97209541159222930896,1625.21,2023-09-06T17:09:13,Valladolid,expenses,food,-104.31,-35445.08
buyer_6,Manuel,Díez,1979-02-14,43668965S,manuel.díez@extremetech.io,146712,ES97209541159222930896,1625.21,2023-09-07T11:16:03,Valladolid,expenses,repairs,-34.68,-35479.76
buyer_6,Manuel,Díez,1979-02-14,43668965S,manuel.díez@extremetech.io,146712,ES97209541159222930896,1625.21,2023-09-08T09:38:41,Valladolid,expenses,water,-59.8,-35539.56
buyer_6,Manuel,Díez,1979-02-14,43668965S,manuel.díez@extremetech.io,146712,ES97209541159222930896,1625.21,2023-09-08T18:50:12,Valladolid,expenses,gas,-138.67,-35678.23
buyer_6,Manuel,Díez,1979-02-14,43668965S,manuel.díez@extremetech.io,146712,ES97209541159222930896,1625.21,2023-09-08T10:16:58,Valladolid,expenses,leisure,-42.59,-35720.82
buyer_6,Manuel,Díez,1979-02-14,43668965S,manuel.díez@extremetech.io,146712,ES97209541159222930896,1625.21,2023-09-09T19:22:30,Valladolid,expenses,food,-65.41,-35786.23
buyer_6,Manuel,Díez,1979-02-14,43668965S,manuel.díez@extremetech.io,146712,ES97209541159222930896,1625.21,2023-09-10T22:09:00,Valladolid,expenses,food,-77.87,-35864.1
buyer_6,Manuel,Díez,1979-02-14,43668965S,manuel.díez@extremetech.io,146712,ES97209541159222930896,1625.21,2023-09-10T13:15:57,Valladolid,expenses,cash,-100.0,-35964.1
buyer_6,Manuel,Díez,1979-02-14,43668965S,manuel.díez@extremetech.io,146712,ES97209541159222930896,1625.21,2023-09-10T09:23:44,Valladolid,expenses,travel,-637.97,-36602.07
buyer_6,Manuel,Díez,1979-02-14,43668965S,manuel.díez@extremetech.io,146712,ES97209541159222930896,1625.21,2023-09-12T09:45:54,Valladolid,expenses,cash,-100.0,-36702.07
buyer_6,Manuel,Díez,1979-02-14,43668965S,manuel.díez@extremetech.io,146712,ES97209541159222930896,1625.21,2023-09-14T09:55:45,Valladolid,expenses,leisure,-52.77,-36754.84
buyer_6,Manuel,Díez,1979-02-14,43668965S,manuel.díez@extremetech.io,146712,ES97209541159222930896,1625.21,2023-09-14T11:33:41,Valladolid,expenses,cash,-100.0,-36854.84
buyer_6,Manuel,Díez,1979-02-14,43668965S,manuel.díez@extremetech.io,146712,ES97209541159222930896,1625.21,2023-09-21T10:07:33,Valladolid,expenses,food,-64.54,-36919.38
buyer_6,Manuel,Díez,1979-02-14,43668965S,manuel.díez@extremetech.io,146712,ES97209541159222930896,1625.21,2023-09-24T14:40:10,Valladolid,expenses,leisure,-55.08,-36974.46
buyer_6,Manuel,Díez,1979-02-14,43668965S,manuel.díez@extremetech.io,146712,ES97209541159222930896,1625.21,2023-09-24T09:06:02,Valladolid,expenses,cash,-100.0,-37074.46
buyer_6,Manuel,Díez,1979-02-14,43668965S,manuel.díez@extremetech.io,146712,ES97209541159222930896,1625.21,2023-09-25T18:16:00,Valladolid,expenses,cash,-100.0,-37174.46
buyer_6,Manuel,Díez,1979-02-14,43668965S,manuel.díez@extremetech.io,146712,ES97209541159222930896,1625.21,2023-09-25T08:13:49,Valladolid,expenses,appliances,-239.02,-37413.48
buyer_6,Manuel,Díez,1979-02-14,43668965S,manuel.díez@extremetech.io,146712,ES97209541159222930896,1625.21,2023-09-26T12:16:01,Valladolid,expenses,cash,-100.0,-37513.48
buyer_6,Manuel,Díez,1979-02-14,43668965S,manuel.díez@extremetech.io,146712,ES97209541159222930896,1625.21,2023-09-29T15:36:23,Valladolid,expenses,transport,-71.26,-37584.74
buyer_6,Manuel,Díez,1979-02-14,43668965S,manuel.díez@extremetech.io,146712,ES97209541159222930896,1625.21,2023-09-29T20:50:13,Valladolid,expenses,cash,-100.0,-37684.74
buyer_6,Manuel,Díez,1979-02-14,43668965S,manuel.díez@extremetech.io,146712,ES97209541159222930896,1625.21,2023-09-30T17:05:36,Valladolid,expenses,leisure,-75.19,-37759.93
buyer_6,Manuel,Díez,1979-02-14,43668965S,manuel.díez@extremetech.io,146712,ES97209541159222930896,1625.21,2023-10-01T12:10:12,Valladolid,incomes,salary,3062.36,-34697.57
buyer_6,Manuel,Díez,1979-02-14,43668965S,manuel.díez@extremetech.io,146712,ES97209541159222930896,1625.21,2023-10-02T10:13:55,Valladolid,expenses,education,-72.39,-34769.96
buyer_6,Manuel,Díez,1979-02-14,43668965S,manuel.díez@extremetech.io,146712,ES97209541159222930896,1625.21,2023-10-04T10:11:58,Valladolid,expenses,cash,-100.0,-34869.96
buyer_6,Manuel,Díez,1979-02-14,43668965S,manuel.díez@extremetech.io,146712,ES97209541159222930896,1625.21,2023-10-05T17:59:57,Valladolid,expenses,mortgage,-1572.51,-36442.47
buyer_6,Manuel,Díez,1979-02-14,43668965S,manuel.díez@extremetech.io,146712,ES97209541159222930896,1625.21,2023-10-05T17:51:29,Valladolid,expenses,water,-61.74,-36504.21
buyer_6,Manuel,Díez,1979-02-14,43668965S,manuel.díez@extremetech.io,146712,ES97209541159222930896,1625.21,2023-10-05T08:52:08,Valladolid,expenses,electricity,-42.8,-36547.01
buyer_6,Manuel,Díez,1979-02-14,43668965S,manuel.díez@extremetech.io,146712,ES97209541159222930896,1625.21,2023-10-05T08:01:01,Valladolid,expenses,healthcare,-43.43,-36590.44
buyer_6,Manuel,Díez,1979-02-14,43668965S,manuel.díez@extremetech.io,146712,ES97209541159222930896,1625.21,2023-10-06T22:38:42,Valladolid,expenses,appliances,-301.76,-36892.2
buyer_6,Manuel,Díez,1979-02-14,43668965S,manuel.díez@extremetech.io,146712,ES97209541159222930896,1625.21,2023-10-08T12:19:41,Valladolid,expenses,electricity,-101.45,-36993.65
buyer_6,Manuel,Díez,1979-02-14,43668965S,manuel.díez@extremetech.io,146712,ES97209541159222930896,1625.21,2023-10-08T11:17:07,Valladolid,expenses,gas,-137.72,-37131.37
buyer_6,Manuel,Díez,1979-02-14,43668965S,manuel.díez@extremetech.io,146712,ES97209541159222930896,1625.21,2023-10-08T15:25:55,Valladolid,expenses,phone,-56.08,-37187.45
buyer_6,Manuel,Díez,1979-02-14,43668965S,manuel.díez@extremetech.io,146712,ES97209541159222930896,1625.21,2023-10-08T08:13:25,Valladolid,expenses,cash,-100.0,-37287.45
buyer_6,Manuel,Díez,1979-02-14,43668965S,manuel.díez@extremetech.io,146712,ES97209541159222930896,1625.21,2023-10-09T13:42:23,Valladolid,expenses,appliances,-181.47,-37468.92
buyer_6,Manuel,Díez,1979-02-14,43668965S,manuel.díez@extremetech.io,146712,ES97209541159222930896,1625.21,2023-10-11T00:52:04,Valladolid,expenses,clothing,-116.29,-37585.21
buyer_6,Manuel,Díez,1979-02-14,43668965S,manuel.díez@extremetech.io,146712,ES97209541159222930896,1625.21,2023-10-13T19:26:52,Valladolid,expenses,transport,-74.86,-37660.07
buyer_6,Manuel,Díez,1979-02-14,43668965S,manuel.díez@extremetech.io,146712,ES97209541159222930896,1625.21,2023-10-13T23:02:12,Valladolid,expenses,cash,-100.0,-37760.07
buyer_6,Manuel,Díez,1979-02-14,43668965S,manuel.díez@extremetech.io,146712,ES97209541159222930896,1625.21,2023-10-13T12:58:37,Valladolid,expenses,gifts,-175.2,-37935.27
buyer_6,Manuel,Díez,1979-02-14,43668965S,manuel.díez@extremetech.io,146712,ES97209541159222930896,1625.21,2023-10-14T10:26:00,Valladolid,expenses,cash,-100.0,-38035.27
buyer_6,Manuel,Díez,1979-02-14,43668965S,manuel.díez@extremetech.io,146712,ES97209541159222930896,1625.21,2023-10-15T15:42:39,Valladolid,expenses,clothing,-91.08,-38126.35
buyer_6,Manuel,Díez,1979-02-14,43668965S,manuel.díez@extremetech.io,146712,ES97209541159222930896,1625.21,2023-10-18T11:04:11,Valladolid,expenses,cash,-100.0,-38226.35
buyer_6,Manuel,Díez,1979-02-14,43668965S,manuel.díez@extremetech.io,146712,ES97209541159222930896,1625.21,2023-10-19T12:32:24,Valladolid,expenses,transport,-55.17,-38281.52
buyer_6,Manuel,Díez,1979-02-14,43668965S,manuel.díez@extremetech.io,146712,ES97209541159222930896,1625.21,2023-10-21T18:38:10,Valladolid,expenses,transport,-57.69,-38339.21
buyer_6,Manuel,Díez,1979-02-14,43668965S,manuel.díez@extremetech.io,146712,ES97209541159222930896,1625.21,2023-10-22T13:00:31,Valladolid,expenses,food,-116.23,-38455.44
buyer_6,Manuel,Díez,1979-02-14,43668965S,manuel.díez@extremetech.io,146712,ES97209541159222930896,1625.21,2023-10-22T15:32:02,Valladolid,expenses,cash,-100.0,-38555.44
buyer_6,Manuel,Díez,1979-02-14,43668965S,manuel.díez@extremetech.io,146712,ES97209541159222930896,1625.21,2023-10-24T16:20:26,Valladolid,expenses,repairs,-224.59,-38780.03
buyer_6,Manuel,Díez,1979-02-14,43668965S,manuel.díez@extremetech.io,146712,ES97209541159222930896,1625.21,2023-10-26T13:54:43,Valladolid,expenses,leisure,-64.55,-38844.58
buyer_6,Manuel,Díez,1979-02-14,43668965S,manuel.díez@extremetech.io,146712,ES97209541159222930896,1625.21,2023-10-26T16:43:02,Valladolid,expenses,cash,-100.0,-38944.58
buyer_6,Manuel,Díez,1979-02-14,43668965S,manuel.díez@extremetech.io,146712,ES97209541159222930896,1625.21,2023-10-27T10:54:03,Valladolid,expenses,food,-106.27,-39050.85
buyer_6,Manuel,Díez,1979-02-14,43668965S,manuel.díez@extremetech.io,146712,ES97209541159222930896,1625.21,2023-10-27T16:44:26,Valladolid,expenses,transport,-78.33,-39129.18
buyer_6,Manuel,Díez,1979-02-14,43668965S,manuel.díez@extremetech.io,146712,ES97209541159222930896,1625.21,2023-10-28T11:17:24,Valladolid,expenses,appliances,-328.0,-39457.18
buyer_6,Manuel,Díez,1979-02-14,43668965S,manuel.díez@extremetech.io,146712,ES97209541159222930896,1625.21,2023-10-29T16:48:08,Valladolid,expenses,repairs,-102.99,-39560.17
buyer_6,Manuel,Díez,1979-02-14,43668965S,manuel.díez@extremetech.io,146712,ES97209541159222930896,1625.21,2023-10-30T03:02:13,Valladolid,expenses,leisure,-38.73,-39598.9
buyer_6,Manuel,Díez,1979-02-14,43668965S,manuel.díez@extremetech.io,146712,ES97209541159222930896,1625.21,2023-10-31T22:46:40,Valladolid,expenses,leisure,-51.8,-39650.7
buyer_6,Manuel,Díez,1979-02-14,43668965S,manuel.díez@extremetech.io,146712,ES97209541159222930896,1625.21,2023-10-31T08:30:57,Valladolid,expenses,cash,-100.0,-39750.7
buyer_6,Manuel,Díez,1979-02-14,43668965S,manuel.díez@extremetech.io,146712,ES97209541159222930896,1625.21,2023-11-01T15:40:26,Valladolid,incomes,salary,3062.36,-36688.34
buyer_6,Manuel,Díez,1979-02-14,43668965S,manuel.díez@extremetech.io,146712,ES97209541159222930896,1625.21,2023-11-01T15:40:26,Valladolid,incomes,extra_income,330.25,-36358.09
buyer_6,Manuel,Díez,1979-02-14,43668965S,manuel.díez@extremetech.io,146712,ES97209541159222930896,1625.21,2023-11-01T10:12:16,Valladolid,expenses,cash,-100.0,-36458.09
buyer_6,Manuel,Díez,1979-02-14,43668965S,manuel.díez@extremetech.io,146712,ES97209541159222930896,1625.21,2023-11-01T01:59:41,Valladolid,expenses,repairs,-227.77,-36685.86
buyer_6,Manuel,Díez,1979-02-14,43668965S,manuel.díez@extremetech.io,146712,ES97209541159222930896,1625.21,2023-11-03T14:45:59,Valladolid,expenses,cash,-100.0,-36785.86
buyer_6,Manuel,Díez,1979-02-14,43668965S,manuel.díez@extremetech.io,146712,ES97209541159222930896,1625.21,2023-11-04T20:51:50,Valladolid,expenses,food,-62.47,-36848.33
buyer_6,Manuel,Díez,1979-02-14,43668965S,manuel.díez@extremetech.io,146712,ES97209541159222930896,1625.21,2023-11-04T18:31:23,Valladolid,expenses,clothing,-48.22,-36896.55
buyer_6,Manuel,Díez,1979-02-14,43668965S,manuel.díez@extremetech.io,146712,ES97209541159222930896,1625.21,2023-11-05T10:04:51,Valladolid,expenses,mortgage,-1572.51,-38469.06
buyer_6,Manuel,Díez,1979-02-14,43668965S,manuel.díez@extremetech.io,146712,ES97209541159222930896,1625.21,2023-11-05T07:08:00,Valladolid,expenses,repairs,-328.49,-38797.55
buyer_6,Manuel,Díez,1979-02-14,43668965S,manuel.díez@extremetech.io,146712,ES97209541159222930896,1625.21,2023-11-07T19:37:44,Valladolid,expenses,gas,-75.83,-38873.38
buyer_6,Manuel,Díez,1979-02-14,43668965S,manuel.díez@extremetech.io,146712,ES97209541159222930896,1625.21,2023-11-07T13:02:22,Valladolid,expenses,cash,-100.0,-38973.38
buyer_6,Manuel,Díez,1979-02-14,43668965S,manuel.díez@extremetech.io,146712,ES97209541159222930896,1625.21,2023-11-08T23:16:27,Valladolid,expenses,water,-55.41,-39028.79
buyer_6,Manuel,Díez,1979-02-14,43668965S,manuel.díez@extremetech.io,146712,ES97209541159222930896,1625.21,2023-11-12T11:54:32,Valladolid,expenses,food,-66.36,-39095.15
buyer_6,Manuel,Díez,1979-02-14,43668965S,manuel.díez@extremetech.io,146712,ES97209541159222930896,1625.21,2023-11-12T15:18:58,Valladolid,expenses,leisure,-84.18,-39179.33
buyer_6,Manuel,Díez,1979-02-14,43668965S,manuel.díez@extremetech.io,146712,ES97209541159222930896,1625.21,2023-11-12T10:54:48,Valladolid,expenses,healthcare,-56.38,-39235.71
buyer_6,Manuel,Díez,1979-02-14,43668965S,manuel.díez@extremetech.io,146712,ES97209541159222930896,1625.21,2023-11-13T15:07:04,Valladolid,expenses,food,-120.55,-39356.26
buyer_6,Manuel,Díez,1979-02-14,43668965S,manuel.díez@extremetech.io,146712,ES97209541159222930896,1625.21,2023-11-14T12:22:48,Valladolid,expenses,food,-83.93,-39440.19
buyer_6,Manuel,Díez,1979-02-14,43668965S,manuel.díez@extremetech.io,146712,ES97209541159222930896,1625.21,2023-11-14T20:08:56,Valladolid,expenses,cash,-100.0,-39540.19
buyer_6,Manuel,Díez,1979-02-14,43668965S,manuel.díez@extremetech.io,146712,ES97209541159222930896,1625.21,2023-11-16T13:14:36,Valladolid,expenses,education,-77.14,-39617.33
buyer_6,Manuel,Díez,1979-02-14,43668965S,manuel.díez@extremetech.io,146712,ES97209541159222930896,1625.21,2023-11-18T14:22:42,Valladolid,expenses,food,-110.79,-39728.12
buyer_6,Manuel,Díez,1979-02-14,43668965S,manuel.díez@extremetech.io,146712,ES97209541159222930896,1625.21,2023-11-18T16:07:14,Valladolid,expenses,transport,-43.63,-39771.75
buyer_6,Manuel,Díez,1979-02-14,43668965S,manuel.díez@extremetech.io,146712,ES97209541159222930896,1625.21,2023-11-19T08:47:41,Valladolid,expenses,food,-107.22,-39878.97
buyer_6,Manuel,Díez,1979-02-14,43668965S,manuel.díez@extremetech.io,146712,ES97209541159222930896,1625.21,2023-11-20T10:38:45,Valladolid,expenses,clothing,-132.61,-40011.58
buyer_6,Manuel,Díez,1979-02-14,43668965S,manuel.díez@extremetech.io,146712,ES97209541159222930896,1625.21,2023-11-21T18:19:58,Valladolid,expenses,gifts,-498.08,-40509.66
buyer_6,Manuel,Díez,1979-02-14,43668965S,manuel.díez@extremetech.io,146712,ES97209541159222930896,1625.21,2023-11-28T11:13:24,Valladolid,expenses,cash,-100.0,-40609.66
buyer_6,Manuel,Díez,1979-02-14,43668965S,manuel.díez@extremetech.io,146712,ES97209541159222930896,1625.21,2023-11-29T09:33:26,Valladolid,expenses,healthcare,-67.1,-40676.76
buyer_6,Manuel,Díez,1979-02-14,43668965S,manuel.díez@extremetech.io,146712,ES97209541159222930896,1625.21,2023-11-30T12:34:47,Valladolid,expenses,food,-94.6,-40771.36
buyer_6,Manuel,Díez,1979-02-14,43668965S,manuel.díez@extremetech.io,146712,ES97209541159222930896,1625.21,2023-12-01T09:40:03,Valladolid,incomes,salary,3062.36,-37709.0
buyer_6,Manuel,Díez,1979-02-14,43668965S,manuel.díez@extremetech.io,146712,ES97209541159222930896,1625.21,2023-12-01T09:40:03,Valladolid,incomes,salary_bonus,2361.78,-35347.22
buyer_6,Manuel,Díez,1979-02-14,43668965S,manuel.díez@extremetech.io,146712,ES97209541159222930896,1625.21,2023-12-03T16:51:41,Valladolid,expenses,healthcare,-145.29,-35492.51
buyer_6,Manuel,Díez,1979-02-14,43668965S,manuel.díez@extremetech.io,146712,ES97209541159222930896,1625.21,2023-12-03T19:08:12,Valladolid,expenses,cash,-100.0,-35592.51
buyer_6,Manuel,Díez,1979-02-14,43668965S,manuel.díez@extremetech.io,146712,ES97209541159222930896,1625.21,2023-12-04T10:48:45,Valladolid,expenses,repairs,-248.88,-35841.39
buyer_6,Manuel,Díez,1979-02-14,43668965S,manuel.díez@extremetech.io,146712,ES97209541159222930896,1625.21,2023-12-05T16:43:26,Valladolid,expenses,mortgage,-1572.51,-37413.9
buyer_6,Manuel,Díez,1979-02-14,43668965S,manuel.díez@extremetech.io,146712,ES97209541159222930896,1625.21,2023-12-06T05:29:11,Valladolid,expenses,water,-43.1,-37457.0
buyer_6,Manuel,Díez,1979-02-14,43668965S,manuel.díez@extremetech.io,146712,ES97209541159222930896,1625.21,2023-12-07T20:58:32,Valladolid,expenses,gas,-81.62,-37538.62
buyer_6,Manuel,Díez,1979-02-14,43668965S,manuel.díez@extremetech.io,146712,ES97209541159222930896,1625.21,2023-12-07T23:33:20,Valladolid,expenses,phone,-57.01,-37595.63
buyer_6,Manuel,Díez,1979-02-14,43668965S,manuel.díez@extremetech.io,146712,ES97209541159222930896,1625.21,2023-12-08T20:54:02,Valladolid,expenses,internet,-64.31,-37659.94
buyer_6,Manuel,Díez,1979-02-14,43668965S,manuel.díez@extremetech.io,146712,ES97209541159222930896,1625.21,2023-12-08T05:47:51,Valladolid,expenses,cash,-100.0,-37759.94
buyer_6,Manuel,Díez,1979-02-14,43668965S,manuel.díez@extremetech.io,146712,ES97209541159222930896,1625.21,2023-12-09T19:37:53,Valladolid,expenses,cash,-100.0,-37859.94
buyer_6,Manuel,Díez,1979-02-14,43668965S,manuel.díez@extremetech.io,146712,ES97209541159222930896,1625.21,2023-12-11T16:06:53,Valladolid,expenses,appliances,-375.59,-38235.53
buyer_6,Manuel,Díez,1979-02-14,43668965S,manuel.díez@extremetech.io,146712,ES97209541159222930896,1625.21,2023-12-12T01:53:05,Valladolid,expenses,clothing,-142.8,-38378.33
buyer_6,Manuel,Díez,1979-02-14,43668965S,manuel.díez@extremetech.io,146712,ES97209541159222930896,1625.21,2023-12-13T15:31:40,Valladolid,expenses,travel,-392.9,-38771.23
buyer_6,Manuel,Díez,1979-02-14,43668965S,manuel.díez@extremetech.io,146712,ES97209541159222930896,1625.21,2023-12-14T08:36:21,Valladolid,expenses,food,-75.79,-38847.02
buyer_6,Manuel,Díez,1979-02-14,43668965S,manuel.díez@extremetech.io,146712,ES97209541159222930896,1625.21,2023-12-16T09:41:27,Valladolid,expenses,education,-64.11,-38911.13
buyer_6,Manuel,Díez,1979-02-14,43668965S,manuel.díez@extremetech.io,146712,ES97209541159222930896,1625.21,2023-12-16T15:52:36,Valladolid,expenses,repairs,-167.8,-39078.93
buyer_6,Manuel,Díez,1979-02-14,43668965S,manuel.díez@extremetech.io,146712,ES97209541159222930896,1625.21,2023-12-17T20:25:13,Valladolid,expenses,cash,-100.0,-39178.93
buyer_6,Manuel,Díez,1979-02-14,43668965S,manuel.díez@extremetech.io,146712,ES97209541159222930896,1625.21,2023-12-18T08:20:48,Valladolid,expenses,appliances,-388.96,-39567.89
buyer_6,Manuel,Díez,1979-02-14,43668965S,manuel.díez@extremetech.io,146712,ES97209541159222930896,1625.21,2023-12-20T15:22:45,Valladolid,expenses,transport,-44.26,-39612.15
buyer_6,Manuel,Díez,1979-02-14,43668965S,manuel.díez@extremetech.io,146712,ES97209541159222930896,1625.21,2023-12-20T14:42:32,Valladolid,expenses,leisure,-45.87,-39658.02
buyer_6,Manuel,Díez,1979-02-14,43668965S,manuel.díez@extremetech.io,146712,ES97209541159222930896,1625.21,2023-12-20T15:07:46,Valladolid,expenses,repairs,-59.49,-39717.51
buyer_6,Manuel,Díez,1979-02-14,43668965S,manuel.díez@extremetech.io,146712,ES97209541159222930896,1625.21,2023-12-21T01:26:48,Valladolid,expenses,food,-120.87,-39838.38
buyer_6,Manuel,Díez,1979-02-14,43668965S,manuel.díez@extremetech.io,146712,ES97209541159222930896,1625.21,2023-12-21T14:22:48,Valladolid,expenses,gifts,-573.69,-40412.07
buyer_6,Manuel,Díez,1979-02-14,43668965S,manuel.díez@extremetech.io,146712,ES97209541159222930896,1625.21,2023-12-23T15:12:22,Valladolid,expenses,transport,-56.73,-40468.8
buyer_6,Manuel,Díez,1979-02-14,43668965S,manuel.díez@extremetech.io,146712,ES97209541159222930896,1625.21,2023-12-25T08:46:21,Valladolid,expenses,clothing,-55.09,-40523.89
buyer_6,Manuel,Díez,1979-02-14,43668965S,manuel.díez@extremetech.io,146712,ES97209541159222930896,1625.21,2023-12-25T14:46:14,Valladolid,expenses,cash,-100.0,-40623.89
buyer_6,Manuel,Díez,1979-02-14,43668965S,manuel.díez@extremetech.io,146712,ES97209541159222930896,1625.21,2023-12-26T14:36:08,Valladolid,expenses,leisure,-79.1,-40702.99
buyer_6,Manuel,Díez,1979-02-14,43668965S,manuel.díez@extremetech.io,146712,ES97209541159222930896,1625.21,2023-12-26T04:01:40,Valladolid,expenses,gifts,-372.87,-41075.86
buyer_6,Manuel,Díez,1979-02-14,43668965S,manuel.díez@extremetech.io,146712,ES97209541159222930896,1625.21,2023-12-27T21:20:02,Valladolid,expenses,food,-115.73,-41191.59
buyer_6,Manuel,Díez,1979-02-14,43668965S,manuel.díez@extremetech.io,146712,ES97209541159222930896,1625.21,2023-12-27T13:50:28,Valladolid,expenses,leisure,-23.55,-41215.14
buyer_6,Manuel,Díez,1979-02-14,43668965S,manuel.díez@extremetech.io,146712,ES97209541159222930896,1625.21,2023-12-28T05:40:30,Valladolid,expenses,healthcare,-102.7,-41317.84
buyer_6,Manuel,Díez,1979-02-14,43668965S,manuel.díez@extremetech.io,146712,ES97209541159222930896,1625.21,2023-12-30T23:09:27,Valladolid,expenses,food,-99.07,-41416.91
buyer_6,Manuel,Díez,1979-02-14,43668965S,manuel.díez@extremetech.io,146712,ES97209541159222930896,1625.21,2023-12-31T09:25:00,Valladolid,expenses,repairs,-35.85,-41452.76
buyer_6,Manuel,Díez,1979-02-14,43668965S,manuel.díez@extremetech.io,146712,ES97209541159222930896,1625.21,2024-01-01T06:01:32,Valladolid,incomes,salary,3183.05,-38269.71
buyer_6,Manuel,Díez,1979-02-14,43668965S,manuel.díez@extremetech.io,146712,ES97209541159222930896,1625.21,2024-01-03T09:56:57,Valladolid,expenses,transport,-87.14,-38356.85
buyer_6,Manuel,Díez,1979-02-14,43668965S,manuel.díez@extremetech.io,146712,ES97209541159222930896,1625.21,2024-01-05T06:55:17,Valladolid,expenses,mortgage,-1749.08,-40105.93
buyer_6,Manuel,Díez,1979-02-14,43668965S,manuel.díez@extremetech.io,146712,ES97209541159222930896,1625.21,2024-01-05T09:27:47,Valladolid,expenses,phone,-54.66,-40160.59
buyer_6,Manuel,Díez,1979-02-14,43668965S,manuel.díez@extremetech.io,146712,ES97209541159222930896,1625.21,2024-01-06T19:35:03,Valladolid,expenses,water,-69.85,-40230.44
buyer_6,Manuel,Díez,1979-02-14,43668965S,manuel.díez@extremetech.io,146712,ES97209541159222930896,1625.21,2024-01-06T18:56:01,Valladolid,expenses,electricity,-53.54,-40283.98
buyer_6,Manuel,Díez,1979-02-14,43668965S,manuel.díez@extremetech.io,146712,ES97209541159222930896,1625.21,2024-01-06T11:40:00,Valladolid,expenses,phone,-53.41,-40337.39
buyer_6,Manuel,Díez,1979-02-14,43668965S,manuel.díez@extremetech.io,146712,ES97209541159222930896,1625.21,2024-01-07T23:39:07,Valladolid,expenses,phone,-53.92,-40391.31
buyer_6,Manuel,Díez,1979-02-14,43668965S,manuel.díez@extremetech.io,146712,ES97209541159222930896,1625.21,2024-01-08T12:04:06,Valladolid,expenses,education,-65.03,-40456.34
buyer_6,Manuel,Díez,1979-02-14,43668965S,manuel.díez@extremetech.io,146712,ES97209541159222930896,1625.21,2024-01-09T13:02:17,Valladolid,expenses,cash,-100.0,-40556.34
buyer_6,Manuel,Díez,1979-02-14,43668965S,manuel.díez@extremetech.io,146712,ES97209541159222930896,1625.21,2024-01-16T12:16:54,Valladolid,expenses,leisure,-21.05,-40577.39
buyer_6,Manuel,Díez,1979-02-14,43668965S,manuel.díez@extremetech.io,146712,ES97209541159222930896,1625.21,2024-01-18T23:36:26,Valladolid,expenses,gifts,-802.0,-41379.39
buyer_6,Manuel,Díez,1979-02-14,43668965S,manuel.díez@extremetech.io,146712,ES97209541159222930896,1625.21,2024-01-20T14:42:12,Valladolid,expenses,transport,-43.45,-41422.84
buyer_6,Manuel,Díez,1979-02-14,43668965S,manuel.díez@extremetech.io,146712,ES97209541159222930896,1625.21,2024-01-21T21:53:55,Valladolid,expenses,cash,-100.0,-41522.84
buyer_6,Manuel,Díez,1979-02-14,43668965S,manuel.díez@extremetech.io,146712,ES97209541159222930896,1625.21,2024-01-23T10:42:49,Valladolid,expenses,food,-75.22,-41598.06
buyer_6,Manuel,Díez,1979-02-14,43668965S,manuel.díez@extremetech.io,146712,ES97209541159222930896,1625.21,2024-01-23T19:46:41,Valladolid,expenses,transport,-87.54,-41685.6
buyer_6,Manuel,Díez,1979-02-14,43668965S,manuel.díez@extremetech.io,146712,ES97209541159222930896,1625.21,2024-01-23T09:00:01,Valladolid,expenses,education,-60.96,-41746.56
buyer_6,Manuel,Díez,1979-02-14,43668965S,manuel.díez@extremetech.io,146712,ES97209541159222930896,1625.21,2024-01-23T23:01:43,Valladolid,expenses,cash,-100.0,-41846.56
buyer_6,Manuel,Díez,1979-02-14,43668965S,manuel.díez@extremetech.io,146712,ES97209541159222930896,1625.21,2024-01-23T22:25:29,Valladolid,expenses,gifts,-824.39,-42670.95
buyer_6,Manuel,Díez,1979-02-14,43668965S,manuel.díez@extremetech.io,146712,ES97209541159222930896,1625.21,2024-01-25T17:29:23,Valladolid,expenses,cash,-100.0,-42770.95
buyer_6,Manuel,Díez,1979-02-14,43668965S,manuel.díez@extremetech.io,146712,ES97209541159222930896,1625.21,2024-01-26T10:52:54,Valladolid,expenses,clothing,-58.29,-42829.24
buyer_6,Manuel,Díez,1979-02-14,43668965S,manuel.díez@extremetech.io,146712,ES97209541159222930896,1625.21,2024-01-29T17:47:45,Valladolid,expenses,transport,-69.66,-42898.9
buyer_6,Manuel,Díez,1979-02-14,43668965S,manuel.díez@extremetech.io,146712,ES97209541159222930896,1625.21,2024-01-29T11:08:15,Valladolid,expenses,education,-49.84,-42948.74
buyer_6,Manuel,Díez,1979-02-14,43668965S,manuel.díez@extremetech.io,146712,ES97209541159222930896,1625.21,2024-01-29T13:05:46,Valladolid,expenses,cash,-100.0,-43048.74
buyer_6,Manuel,Díez,1979-02-14,43668965S,manuel.díez@extremetech.io,146712,ES97209541159222930896,1625.21,2024-01-30T16:44:12,Valladolid,expenses,food,-64.73,-43113.47
buyer_6,Manuel,Díez,1979-02-14,43668965S,manuel.díez@extremetech.io,146712,ES97209541159222930896,1625.21,2024-01-30T10:44:15,Valladolid,expenses,leisure,-59.5,-43172.97
buyer_6,Manuel,Díez,1979-02-14,43668965S,manuel.díez@extremetech.io,146712,ES97209541159222930896,1625.21,2024-01-30T22:29:09,Valladolid,expenses,education,-71.71,-43244.68
buyer_6,Manuel,Díez,1979-02-14,43668965S,manuel.díez@extremetech.io,146712,ES97209541159222930896,1625.21,2024-02-01T18:56:35,Valladolid,incomes,salary,3183.05,-40061.63
buyer_6,Manuel,Díez,1979-02-14,43668965S,manuel.díez@extremetech.io,146712,ES97209541159222930896,1625.21,2024-02-01T14:55:20,Valladolid,expenses,repairs,-277.88,-40339.51
buyer_6,Manuel,Díez,1979-02-14,43668965S,manuel.díez@extremetech.io,146712,ES97209541159222930896,1625.21,2024-02-02T15:42:28,Valladolid,expenses,leisure,-30.23,-40369.74
buyer_6,Manuel,Díez,1979-02-14,43668965S,manuel.díez@extremetech.io,146712,ES97209541159222930896,1625.21,2024-02-03T14:47:01,Valladolid,expenses,gifts,-176.36,-40546.1
buyer_6,Manuel,Díez,1979-02-14,43668965S,manuel.díez@extremetech.io,146712,ES97209541159222930896,1625.21,2024-02-04T08:37:53,Valladolid,expenses,healthcare,-134.49,-40680.59
buyer_6,Manuel,Díez,1979-02-14,43668965S,manuel.díez@extremetech.io,146712,ES97209541159222930896,1625.21,2024-02-05T20:58:57,Valladolid,expenses,mortgage,-1749.08,-42429.67
buyer_6,Manuel,Díez,1979-02-14,43668965S,manuel.díez@extremetech.io,146712,ES97209541159222930896,1625.21,2024-02-05T19:10:08,Valladolid,expenses,internet,-66.84,-42496.51
buyer_6,Manuel,Díez,1979-02-14,43668965S,manuel.díez@extremetech.io,146712,ES97209541159222930896,1625.21,2024-02-05T20:15:44,Valladolid,expenses,phone,-55.84,-42552.35
buyer_6,Manuel,Díez,1979-02-14,43668965S,manuel.díez@extremetech.io,146712,ES97209541159222930896,1625.21,2024-02-06T15:07:51,Valladolid,expenses,phone,-54.91,-42607.26
buyer_6,Manuel,Díez,1979-02-14,43668965S,manuel.díez@extremetech.io,146712,ES97209541159222930896,1625.21,2024-02-06T21:34:39,Valladolid,expenses,food,-71.34,-42678.6
buyer_6,Manuel,Díez,1979-02-14,43668965S,manuel.díez@extremetech.io,146712,ES97209541159222930896,1625.21,2024-02-06T18:13:52,Valladolid,expenses,education,-72.52,-42751.12
buyer_6,Manuel,Díez,1979-02-14,43668965S,manuel.díez@extremetech.io,146712,ES97209541159222930896,1625.21,2024-02-07T12:44:04,Valladolid,expenses,water,-58.8,-42809.92
buyer_6,Manuel,Díez,1979-02-14,43668965S,manuel.díez@extremetech.io,146712,ES97209541159222930896,1625.21,2024-02-07T16:55:20,Valladolid,expenses,cash,-100.0,-42909.92
buyer_6,Manuel,Díez,1979-02-14,43668965S,manuel.díez@extremetech.io,146712,ES97209541159222930896,1625.21,2024-02-07T13:22:52,Valladolid,expenses,repairs,-162.04,-43071.96
buyer_6,Manuel,Díez,1979-02-14,43668965S,manuel.díez@extremetech.io,146712,ES97209541159222930896,1625.21,2024-02-08T11:26:56,Valladolid,expenses,internet,-66.84,-43138.8
buyer_6,Manuel,Díez,1979-02-14,43668965S,manuel.díez@extremetech.io,146712,ES97209541159222930896,1625.21,2024-02-09T23:11:22,Valladolid,expenses,transport,-42.35,-43181.15
buyer_6,Manuel,Díez,1979-02-14,43668965S,manuel.díez@extremetech.io,146712,ES97209541159222930896,1625.21,2024-02-12T21:51:19,Valladolid,expenses,transport,-56.33,-43237.48
buyer_6,Manuel,Díez,1979-02-14,43668965S,manuel.díez@extremetech.io,146712,ES97209541159222930896,1625.21,2024-02-13T12:05:51,Valladolid,expenses,cash,-100.0,-43337.48
buyer_6,Manuel,Díez,1979-02-14,43668965S,manuel.díez@extremetech.io,146712,ES97209541159222930896,1625.21,2024-02-14T11:01:48,Valladolid,expenses,food,-103.39,-43440.87
buyer_6,Manuel,Díez,1979-02-14,43668965S,manuel.díez@extremetech.io,146712,ES97209541159222930896,1625.21,2024-02-17T04:05:42,Valladolid,expenses,transport,-64.93,-43505.8
buyer_6,Manuel,Díez,1979-02-14,43668965S,manuel.díez@extremetech.io,146712,ES97209541159222930896,1625.21,2024-02-17T10:01:07,Valladolid,expenses,appliances,-121.82,-43627.62
buyer_6,Manuel,Díez,1979-02-14,43668965S,manuel.díez@extremetech.io,146712,ES97209541159222930896,1625.21,2024-02-18T17:46:03,Valladolid,expenses,food,-63.26,-43690.88
buyer_6,Manuel,Díez,1979-02-14,43668965S,manuel.díez@extremetech.io,146712,ES97209541159222930896,1625.21,2024-02-20T08:19:05,Valladolid,expenses,food,-94.93,-43785.81
buyer_6,Manuel,Díez,1979-02-14,43668965S,manuel.díez@extremetech.io,146712,ES97209541159222930896,1625.21,2024-02-22T00:02:39,Valladolid,expenses,leisure,-78.53,-43864.34
buyer_6,Manuel,Díez,1979-02-14,43668965S,manuel.díez@extremetech.io,146712,ES97209541159222930896,1625.21,2024-02-25T14:27:24,Valladolid,expenses,education,-58.86,-43923.2
buyer_6,Manuel,Díez,1979-02-14,43668965S,manuel.díez@extremetech.io,146712,ES97209541159222930896,1625.21,2024-02-29T14:40:01,Valladolid,expenses,leisure,-34.37,-43957.57
buyer_6,Manuel,Díez,1979-02-14,43668965S,manuel.díez@extremetech.io,146712,ES97209541159222930896,1625.21,2024-03-01T16:08:46,Valladolid,incomes,salary,3183.05,-40774.52
buyer_6,Manuel,Díez,1979-02-14,43668965S,manuel.díez@extremetech.io,146712,ES97209541159222930896,1625.21,2024-03-01T16:08:46,Valladolid,incomes,extra_income,330.25,-40444.27
buyer_6,Manuel,Díez,1979-02-14,43668965S,manuel.díez@extremetech.io,146712,ES97209541159222930896,1625.21,2024-03-02T02:31:47,Valladolid,expenses,food,-97.4,-40541.67
buyer_6,Manuel,Díez,1979-02-14,43668965S,manuel.díez@extremetech.io,146712,ES97209541159222930896,1625.21,2024-03-05T13:11:26,Valladolid,expenses,mortgage,-1749.08,-42290.75
buyer_6,Manuel,Díez,1979-02-14,43668965S,manuel.díez@extremetech.io,146712,ES97209541159222930896,1625.21,2024-03-05T03:29:31,Valladolid,expenses,water,-33.36,-42324.11
buyer_6,Manuel,Díez,1979-02-14,43668965S,manuel.díez@extremetech.io,146712,ES97209541159222930896,1625.21,2024-03-05T15:03:22,Valladolid,expenses,phone,-61.48,-42385.59
buyer_6,Manuel,Díez,1979-02-14,43668965S,manuel.díez@extremetech.io,146712,ES97209541159222930896,1625.21,2024-03-05T13:40:37,Valladolid,expenses,leisure,-71.72,-42457.31
buyer_6,Manuel,Díez,1979-02-14,43668965S,manuel.díez@extremetech.io,146712,ES97209541159222930896,1625.21,2024-03-05T15:51:46,Valladolid,expenses,cash,-100.0,-42557.31
buyer_6,Manuel,Díez,1979-02-14,43668965S,manuel.díez@extremetech.io,146712,ES97209541159222930896,1625.21,2024-03-06T15:58:28,Valladolid,expenses,water,-45.69,-42603.0
buyer_6,Manuel,Díez,1979-02-14,43668965S,manuel.díez@extremetech.io,146712,ES97209541159222930896,1625.21,2024-03-06T16:18:33,Valladolid,expenses,gas,-69.82,-42672.82
buyer_6,Manuel,Díez,1979-02-14,43668965S,manuel.díez@extremetech.io,146712,ES97209541159222930896,1625.21,2024-03-06T10:25:21,Valladolid,expenses,phone,-65.91,-42738.73
buyer_6,Manuel,Díez,1979-02-14,43668965S,manuel.díez@extremetech.io,146712,ES97209541159222930896,1625.21,2024-03-06T19:11:48,Valladolid,expenses,leisure,-83.75,-42822.48
buyer_6,Manuel,Díez,1979-02-14,43668965S,manuel.díez@extremetech.io,146712,ES97209541159222930896,1625.21,2024-03-07T08:55:01,Valladolid,expenses,water,-39.84,-42862.32
buyer_6,Manuel,Díez,1979-02-14,43668965S,manuel.díez@extremetech.io,146712,ES97209541159222930896,1625.21,2024-03-07T23:28:54,Valladolid,expenses,electricity,-70.14,-42932.46
buyer_6,Manuel,Díez,1979-02-14,43668965S,manuel.díez@extremetech.io,146712,ES97209541159222930896,1625.21,2024-03-07T08:26:29,Valladolid,expenses,food,-111.24,-43043.7
buyer_6,Manuel,Díez,1979-02-14,43668965S,manuel.díez@extremetech.io,146712,ES97209541159222930896,1625.21,2024-03-08T15:47:17,Valladolid,expenses,phone,-66.9,-43110.6
buyer_6,Manuel,Díez,1979-02-14,43668965S,manuel.díez@extremetech.io,146712,ES97209541159222930896,1625.21,2024-03-08T13:55:40,Valladolid,expenses,healthcare,-55.98,-43166.58
buyer_6,Manuel,Díez,1979-02-14,43668965S,manuel.díez@extremetech.io,146712,ES97209541159222930896,1625.21,2024-03-08T10:22:20,Valladolid,expenses,gifts,-273.73,-43440.31
buyer_6,Manuel,Díez,1979-02-14,43668965S,manuel.díez@extremetech.io,146712,ES97209541159222930896,1625.21,2024-03-09T09:45:15,Valladolid,expenses,food,-65.6,-43505.91
buyer_6,Manuel,Díez,1979-02-14,43668965S,manuel.díez@extremetech.io,146712,ES97209541159222930896,1625.21,2024-03-09T18:33:51,Valladolid,expenses,gifts,-300.53,-43806.44
buyer_6,Manuel,Díez,1979-02-14,43668965S,manuel.díez@extremetech.io,146712,ES97209541159222930896,1625.21,2024-03-10T21:22:19,Valladolid,expenses,food,-85.91,-43892.35
buyer_6,Manuel,Díez,1979-02-14,43668965S,manuel.díez@extremetech.io,146712,ES97209541159222930896,1625.21,2024-03-10T08:39:20,Valladolid,expenses,transport,-51.4,-43943.75
buyer_6,Manuel,Díez,1979-02-14,43668965S,manuel.díez@extremetech.io,146712,ES97209541159222930896,1625.21,2024-03-11T11:16:11,Valladolid,expenses,cash,-100.0,-44043.75
buyer_6,Manuel,Díez,1979-02-14,43668965S,manuel.díez@extremetech.io,146712,ES97209541159222930896,1625.21,2024-03-11T09:03:04,Valladolid,expenses,appliances,-304.21,-44347.96
buyer_6,Manuel,Díez,1979-02-14,43668965S,manuel.díez@extremetech.io,146712,ES97209541159222930896,1625.21,2024-03-12T20:28:43,Valladolid,expenses,transport,-89.34,-44437.3
buyer_6,Manuel,Díez,1979-02-14,43668965S,manuel.díez@extremetech.io,146712,ES97209541159222930896,1625.21,2024-03-12T16:15:50,Valladolid,expenses,travel,-411.99,-44849.29
buyer_6,Manuel,Díez,1979-02-14,43668965S,manuel.díez@extremetech.io,146712,ES97209541159222930896,1625.21,2024-03-14T16:00:16,Valladolid,expenses,transport,-73.17,-44922.46
buyer_6,Manuel,Díez,1979-02-14,43668965S,manuel.díez@extremetech.io,146712,ES97209541159222930896,1625.21,2024-03-14T10:17:49,Valladolid,expenses,leisure,-39.04,-44961.5
buyer_6,Manuel,Díez,1979-02-14,43668965S,manuel.díez@extremetech.io,146712,ES97209541159222930896,1625.21,2024-03-14T13:42:48,Valladolid,expenses,cash,-100.0,-45061.5
buyer_6,Manuel,Díez,1979-02-14,43668965S,manuel.díez@extremetech.io,146712,ES97209541159222930896,1625.21,2024-03-16T18:30:21,Valladolid,expenses,cash,-100.0,-45161.5
buyer_6,Manuel,Díez,1979-02-14,43668965S,manuel.díez@extremetech.io,146712,ES97209541159222930896,1625.21,2024-03-18T19:34:46,Valladolid,expenses,cash,-100.0,-45261.5
buyer_6,Manuel,Díez,1979-02-14,43668965S,manuel.díez@extremetech.io,146712,ES97209541159222930896,1625.21,2024-03-19T20:29:12,Valladolid,expenses,leisure,-24.87,-45286.37
buyer_6,Manuel,Díez,1979-02-14,43668965S,manuel.díez@extremetech.io,146712,ES97209541159222930896,1625.21,2024-03-20T16:45:49,Valladolid,expenses,food,-89.02,-45375.39
buyer_6,Manuel,Díez,1979-02-14,43668965S,manuel.díez@extremetech.io,146712,ES97209541159222930896,1625.21,2024-03-21T15:53:14,Valladolid,expenses,leisure,-56.24,-45431.63
buyer_6,Manuel,Díez,1979-02-14,43668965S,manuel.díez@extremetech.io,146712,ES97209541159222930896,1625.21,2024-03-21T21:41:33,Valladolid,expenses,cash,-100.0,-45531.63
buyer_6,Manuel,Díez,1979-02-14,43668965S,manuel.díez@extremetech.io,146712,ES97209541159222930896,1625.21,2024-03-22T20:57:11,Valladolid,expenses,food,-98.4,-45630.03
buyer_6,Manuel,Díez,1979-02-14,43668965S,manuel.díez@extremetech.io,146712,ES97209541159222930896,1625.21,2024-03-25T11:23:42,Valladolid,expenses,transport,-87.0,-45717.03
buyer_6,Manuel,Díez,1979-02-14,43668965S,manuel.díez@extremetech.io,146712,ES97209541159222930896,1625.21,2024-03-26T10:44:22,Valladolid,expenses,leisure,-59.83,-45776.86
buyer_6,Manuel,Díez,1979-02-14,43668965S,manuel.díez@extremetech.io,146712,ES97209541159222930896,1625.21,2024-03-26T14:09:53,Valladolid,expenses,education,-74.06,-45850.92
buyer_6,Manuel,Díez,1979-02-14,43668965S,manuel.díez@extremetech.io,146712,ES97209541159222930896,1625.21,2024-03-28T12:11:11,Valladolid,expenses,cash,-100.0,-45950.92
buyer_6,Manuel,Díez,1979-02-14,43668965S,manuel.díez@extremetech.io,146712,ES97209541159222930896,1625.21,2024-03-29T19:38:48,Valladolid,expenses,transport,-57.41,-46008.33
buyer_6,Manuel,Díez,1979-02-14,43668965S,manuel.díez@extremetech.io,146712,ES97209541159222930896,1625.21,2024-03-30T04:35:59,Valladolid,expenses,leisure,-53.58,-46061.91
buyer_6,Manuel,Díez,1979-02-14,43668965S,manuel.díez@extremetech.io,146712,ES97209541159222930896,1625.21,2024-03-30T06:56:52,Valladolid,expenses,clothing,-70.17,-46132.08
buyer_6,Manuel,Díez,1979-02-14,43668965S,manuel.díez@extremetech.io,146712,ES97209541159222930896,1625.21,2024-03-31T18:27:26,Valladolid,expenses,healthcare,-81.9,-46213.98
buyer_6,Manuel,Díez,1979-02-14,43668965S,manuel.díez@extremetech.io,146712,ES97209541159222930896,1625.21,2024-04-01T11:11:08,Valladolid,incomes,salary,3183.05,-43030.93
buyer_6,Manuel,Díez,1979-02-14,43668965S,manuel.díez@extremetech.io,146712,ES97209541159222930896,1625.21,2024-04-01T08:47:19,Valladolid,expenses,gifts,-507.43,-43538.36
buyer_6,Manuel,Díez,1979-02-14,43668965S,manuel.díez@extremetech.io,146712,ES97209541159222930896,1625.21,2024-04-02T09:19:30,Valladolid,expenses,transport,-47.53,-43585.89
buyer_6,Manuel,Díez,1979-02-14,43668965S,manuel.díez@extremetech.io,146712,ES97209541159222930896,1625.21,2024-04-02T15:33:39,Valladolid,expenses,healthcare,-143.75,-43729.64
buyer_6,Manuel,Díez,1979-02-14,43668965S,manuel.díez@extremetech.io,146712,ES97209541159222930896,1625.21,2024-04-02T10:37:43,Valladolid,expenses,cash,-100.0,-43829.64
buyer_6,Manuel,Díez,1979-02-14,43668965S,manuel.díez@extremetech.io,146712,ES97209541159222930896,1625.21,2024-04-03T13:18:21,Valladolid,expenses,leisure,-59.25,-43888.89
buyer_6,Manuel,Díez,1979-02-14,43668965S,manuel.díez@extremetech.io,146712,ES97209541159222930896,1625.21,2024-04-05T14:08:23,Valladolid,expenses,mortgage,-1749.08,-45637.97
buyer_6,Manuel,Díez,1979-02-14,43668965S,manuel.díez@extremetech.io,146712,ES97209541159222930896,1625.21,2024-04-05T15:53:19,Valladolid,expenses,water,-64.87,-45702.84
buyer_6,Manuel,Díez,1979-02-14,43668965S,manuel.díez@extremetech.io,146712,ES97209541159222930896,1625.21,2024-04-05T15:27:44,Valladolid,expenses,gas,-153.39,-45856.23
buyer_6,Manuel,Díez,1979-02-14,43668965S,manuel.díez@extremetech.io,146712,ES97209541159222930896,1625.21,2024-04-05T11:37:37,Valladolid,expenses,internet,-66.84,-45923.07
buyer_6,Manuel,Díez,1979-02-14,43668965S,manuel.díez@extremetech.io,146712,ES97209541159222930896,1625.21,2024-04-05T19:34:34,Valladolid,expenses,cash,-100.0,-46023.07
buyer_6,Manuel,Díez,1979-02-14,43668965S,manuel.díez@extremetech.io,146712,ES97209541159222930896,1625.21,2024-04-06T09:22:14,Valladolid,expenses,water,-59.38,-46082.45
buyer_6,Manuel,Díez,1979-02-14,43668965S,manuel.díez@extremetech.io,146712,ES97209541159222930896,1625.21,2024-04-07T13:04:53,Valladolid,expenses,gas,-151.94,-46234.39
buyer_6,Manuel,Díez,1979-02-14,43668965S,manuel.díez@extremetech.io,146712,ES97209541159222930896,1625.21,2024-04-08T15:03:38,Valladolid,expenses,water,-41.77,-46276.16
buyer_6,Manuel,Díez,1979-02-14,43668965S,manuel.díez@extremetech.io,146712,ES97209541159222930896,1625.21,2024-04-08T00:45:50,Valladolid,expenses,phone,-68.45,-46344.61
buyer_6,Manuel,Díez,1979-02-14,43668965S,manuel.díez@extremetech.io,146712,ES97209541159222930896,1625.21,2024-04-09T12:26:36,Valladolid,expenses,gifts,-705.95,-47050.56
buyer_6,Manuel,Díez,1979-02-14,43668965S,manuel.díez@extremetech.io,146712,ES97209541159222930896,1625.21,2024-04-10T16:49:04,Valladolid,expenses,food,-67.68,-47118.24
buyer_6,Manuel,Díez,1979-02-14,43668965S,manuel.díez@extremetech.io,146712,ES97209541159222930896,1625.21,2024-04-12T16:46:44,Valladolid,expenses,food,-109.26,-47227.5
buyer_6,Manuel,Díez,1979-02-14,43668965S,manuel.díez@extremetech.io,146712,ES97209541159222930896,1625.21,2024-04-13T19:59:38,Valladolid,expenses,food,-104.69,-47332.19
buyer_6,Manuel,Díez,1979-02-14,43668965S,manuel.díez@extremetech.io,146712,ES97209541159222930896,1625.21,2024-04-14T18:44:22,Valladolid,expenses,leisure,-25.88,-47358.07
buyer_6,Manuel,Díez,1979-02-14,43668965S,manuel.díez@extremetech.io,146712,ES97209541159222930896,1625.21,2024-04-14T15:16:15,Valladolid,expenses,gifts,-843.83,-48201.9
buyer_6,Manuel,Díez,1979-02-14,43668965S,manuel.díez@extremetech.io,146712,ES97209541159222930896,1625.21,2024-04-15T13:19:54,Valladolid,expenses,food,-83.54,-48285.44
buyer_6,Manuel,Díez,1979-02-14,43668965S,manuel.díez@extremetech.io,146712,ES97209541159222930896,1625.21,2024-04-16T16:50:33,Valladolid,expenses,transport,-45.4,-48330.84
buyer_6,Manuel,Díez,1979-02-14,43668965S,manuel.díez@extremetech.io,146712,ES97209541159222930896,1625.21,2024-04-17T13:28:54,Valladolid,expenses,food,-81.65,-48412.49
buyer_6,Manuel,Díez,1979-02-14,43668965S,manuel.díez@extremetech.io,146712,ES97209541159222930896,1625.21,2024-04-17T16:19:13,Valladolid,expenses,leisure,-84.77,-48497.26
buyer_6,Manuel,Díez,1979-02-14,43668965S,manuel.díez@extremetech.io,146712,ES97209541159222930896,1625.21,2024-04-18T11:28:48,Valladolid,expenses,food,-114.15,-48611.41
buyer_6,Manuel,Díez,1979-02-14,43668965S,manuel.díez@extremetech.io,146712,ES97209541159222930896,1625.21,2024-04-18T08:30:28,Valladolid,expenses,leisure,-23.23,-48634.64
buyer_6,Manuel,Díez,1979-02-14,43668965S,manuel.díez@extremetech.io,146712,ES97209541159222930896,1625.21,2024-04-22T08:14:35,Valladolid,expenses,gifts,-580.77,-49215.41
buyer_6,Manuel,Díez,1979-02-14,43668965S,manuel.díez@extremetech.io,146712,ES97209541159222930896,1625.21,2024-04-23T20:53:12,Valladolid,expenses,cash,-100.0,-49315.41
buyer_6,Manuel,Díez,1979-02-14,43668965S,manuel.díez@extremetech.io,146712,ES97209541159222930896,1625.21,2024-04-23T11:41:48,Valladolid,expenses,travel,-331.39,-49646.8
buyer_6,Manuel,Díez,1979-02-14,43668965S,manuel.díez@extremetech.io,146712,ES97209541159222930896,1625.21,2024-04-24T23:10:44,Valladolid,expenses,cash,-100.0,-49746.8
buyer_6,Manuel,Díez,1979-02-14,43668965S,manuel.díez@extremetech.io,146712,ES97209541159222930896,1625.21,2024-04-25T06:04:44,Valladolid,expenses,leisure,-68.3,-49815.1
buyer_6,Manuel,Díez,1979-02-14,43668965S,manuel.díez@extremetech.io,146712,ES97209541159222930896,1625.21,2024-04-26T20:48:40,Valladolid,expenses,leisure,-58.47,-49873.57
buyer_6,Manuel,Díez,1979-02-14,43668965S,manuel.díez@extremetech.io,146712,ES97209541159222930896,1625.21,2024-04-28T15:55:02,Valladolid,expenses,cash,-100.0,-49973.57
buyer_6,Manuel,Díez,1979-02-14,43668965S,manuel.díez@extremetech.io,146712,ES97209541159222930896,1625.21,2024-04-28T16:16:33,Valladolid,expenses,repairs,-227.89,-50201.46
buyer_6,Manuel,Díez,1979-02-14,43668965S,manuel.díez@extremetech.io,146712,ES97209541159222930896,1625.21,2024-04-29T09:10:52,Valladolid,expenses,healthcare,-114.72,-50316.18
buyer_6,Manuel,Díez,1979-02-14,43668965S,manuel.díez@extremetech.io,146712,ES97209541159222930896,1625.21,2024-04-30T20:25:43,Valladolid,expenses,food,-79.99,-50396.17
buyer_6,Manuel,Díez,1979-02-14,43668965S,manuel.díez@extremetech.io,146712,ES97209541159222930896,1625.21,2024-05-01T09:00:28,Valladolid,incomes,salary,3183.05,-47213.12
buyer_6,Manuel,Díez,1979-02-14,43668965S,manuel.díez@extremetech.io,146712,ES97209541159222930896,1625.21,2024-05-02T20:16:37,Valladolid,expenses,food,-86.28,-47299.4
buyer_6,Manuel,Díez,1979-02-14,43668965S,manuel.díez@extremetech.io,146712,ES97209541159222930896,1625.21,2024-05-02T10:26:57,Valladolid,expenses,gifts,-164.72,-47464.12
buyer_6,Manuel,Díez,1979-02-14,43668965S,manuel.díez@extremetech.io,146712,ES97209541159222930896,1625.21,2024-05-03T16:47:25,Valladolid,expenses,food,-99.13,-47563.25
buyer_6,Manuel,Díez,1979-02-14,43668965S,manuel.díez@extremetech.io,146712,ES97209541159222930896,1625.21,2024-05-05T13:21:23,Valladolid,expenses,mortgage,-1749.08,-49312.33
buyer_6,Manuel,Díez,1979-02-14,43668965S,manuel.díez@extremetech.io,146712,ES97209541159222930896,1625.21,2024-05-05T13:25:21,Valladolid,expenses,transport,-82.3,-49394.63
buyer_6,Manuel,Díez,1979-02-14,43668965S,manuel.díez@extremetech.io,146712,ES97209541159222930896,1625.21,2024-05-05T23:58:50,Valladolid,expenses,clothing,-105.87,-49500.5
buyer_6,Manuel,Díez,1979-02-14,43668965S,manuel.díez@extremetech.io,146712,ES97209541159222930896,1625.21,2024-05-06T20:45:25,Valladolid,expenses,water,-38.53,-49539.03
buyer_6,Manuel,Díez,1979-02-14,43668965S,manuel.díez@extremetech.io,146712,ES97209541159222930896,1625.21,2024-05-06T16:55:31,Valladolid,expenses,food,-69.68,-49608.71
buyer_6,Manuel,Díez,1979-02-14,43668965S,manuel.díez@extremetech.io,146712,ES97209541159222930896,1625.21,2024-05-07T15:02:22,Valladolid,expenses,phone,-69.64,-49678.35
buyer_6,Manuel,Díez,1979-02-14,43668965S,manuel.díez@extremetech.io,146712,ES97209541159222930896,1625.21,2024-05-08T17:52:26,Valladolid,expenses,phone,-55.19,-49733.54
buyer_6,Manuel,Díez,1979-02-14,43668965S,manuel.díez@extremetech.io,146712,ES97209541159222930896,1625.21,2024-05-08T18:09:02,Valladolid,expenses,cash,-100.0,-49833.54
buyer_6,Manuel,Díez,1979-02-14,43668965S,manuel.díez@extremetech.io,146712,ES97209541159222930896,1625.21,2024-05-09T20:06:55,Valladolid,expenses,food,-121.07,-49954.61
buyer_6,Manuel,Díez,1979-02-14,43668965S,manuel.díez@extremetech.io,146712,ES97209541159222930896,1625.21,2024-05-09T10:39:26,Valladolid,expenses,leisure,-35.36,-49989.97
buyer_6,Manuel,Díez,1979-02-14,43668965S,manuel.díez@extremetech.io,146712,ES97209541159222930896,1625.21,2024-05-09T18:30:56,Valladolid,expenses,cash,-100.0,-50089.97
buyer_6,Manuel,Díez,1979-02-14,43668965S,manuel.díez@extremetech.io,146712,ES97209541159222930896,1625.21,2024-05-10T03:49:33,Valladolid,expenses,cash,-100.0,-50189.97
buyer_6,Manuel,Díez,1979-02-14,43668965S,manuel.díez@extremetech.io,146712,ES97209541159222930896,1625.21,2024-05-11T12:23:57,Valladolid,expenses,cash,-100.0,-50289.97
buyer_6,Manuel,Díez,1979-02-14,43668965S,manuel.díez@extremetech.io,146712,ES97209541159222930896,1625.21,2024-05-13T17:23:23,Valladolid,expenses,healthcare,-93.57,-50383.54
buyer_6,Manuel,Díez,1979-02-14,43668965S,manuel.díez@extremetech.io,146712,ES97209541159222930896,1625.21,2024-05-14T15:30:12,Valladolid,expenses,transport,-45.13,-50428.67
buyer_6,Manuel,Díez,1979-02-14,43668965S,manuel.díez@extremetech.io,146712,ES97209541159222930896,1625.21,2024-05-16T15:54:14,Valladolid,expenses,cash,-100.0,-50528.67
buyer_6,Manuel,Díez,1979-02-14,43668965S,manuel.díez@extremetech.io,146712,ES97209541159222930896,1625.21,2024-05-18T01:41:26,Valladolid,expenses,cash,-100.0,-50628.67
buyer_6,Manuel,Díez,1979-02-14,43668965S,manuel.díez@extremetech.io,146712,ES97209541159222930896,1625.21,2024-05-19T12:49:24,Valladolid,expenses,clothing,-140.27,-50768.94
buyer_6,Manuel,Díez,1979-02-14,43668965S,manuel.díez@extremetech.io,146712,ES97209541159222930896,1625.21,2024-05-20T17:40:05,Valladolid,expenses,transport,-67.64,-50836.58
buyer_6,Manuel,Díez,1979-02-14,43668965S,manuel.díez@extremetech.io,146712,ES97209541159222930896,1625.21,2024-05-21T22:18:25,Valladolid,expenses,clothing,-88.12,-50924.7
buyer_6,Manuel,Díez,1979-02-14,43668965S,manuel.díez@extremetech.io,146712,ES97209541159222930896,1625.21,2024-05-21T22:36:17,Valladolid,expenses,healthcare,-59.46,-50984.16
buyer_6,Manuel,Díez,1979-02-14,43668965S,manuel.díez@extremetech.io,146712,ES97209541159222930896,1625.21,2024-05-21T10:43:30,Valladolid,expenses,education,-68.33,-51052.49
buyer_6,Manuel,Díez,1979-02-14,43668965S,manuel.díez@extremetech.io,146712,ES97209541159222930896,1625.21,2024-05-21T09:09:36,Valladolid,expenses,gifts,-431.29,-51483.78
buyer_6,Manuel,Díez,1979-02-14,43668965S,manuel.díez@extremetech.io,146712,ES97209541159222930896,1625.21,2024-05-22T09:31:05,Valladolid,expenses,transport,-48.24,-51532.02
buyer_6,Manuel,Díez,1979-02-14,43668965S,manuel.díez@extremetech.io,146712,ES97209541159222930896,1625.21,2024-05-24T11:47:45,Valladolid,expenses,leisure,-67.2,-51599.22
buyer_6,Manuel,Díez,1979-02-14,43668965S,manuel.díez@extremetech.io,146712,ES97209541159222930896,1625.21,2024-05-27T13:13:17,Valladolid,expenses,leisure,-47.04,-51646.26
buyer_6,Manuel,Díez,1979-02-14,43668965S,manuel.díez@extremetech.io,146712,ES97209541159222930896,1625.21,2024-05-28T18:55:50,Valladolid,expenses,leisure,-30.86,-51677.12
buyer_6,Manuel,Díez,1979-02-14,43668965S,manuel.díez@extremetech.io,146712,ES97209541159222930896,1625.21,2024-05-30T18:54:11,Valladolid,expenses,transport,-55.75,-51732.87
buyer_6,Manuel,Díez,1979-02-14,43668965S,manuel.díez@extremetech.io,146712,ES97209541159222930896,1625.21,2024-05-31T12:23:50,Valladolid,expenses,transport,-79.14,-51812.01
buyer_6,Manuel,Díez,1979-02-14,43668965S,manuel.díez@extremetech.io,146712,ES97209541159222930896,1625.21,2024-06-01T10:30:04,Valladolid,incomes,salary,3183.05,-48628.96
buyer_6,Manuel,Díez,1979-02-14,43668965S,manuel.díez@extremetech.io,146712,ES97209541159222930896,1625.21,2024-06-01T10:30:04,Valladolid,incomes,extra_income,330.25,-48298.71
buyer_6,Manuel,Díez,1979-02-14,43668965S,manuel.díez@extremetech.io,146712,ES97209541159222930896,1625.21,2024-06-01T10:30:04,Valladolid,incomes,salary_bonus,2463.19,-45835.52
buyer_6,Manuel,Díez,1979-02-14,43668965S,manuel.díez@extremetech.io,146712,ES97209541159222930896,1625.21,2024-06-01T10:44:52,Valladolid,expenses,taxes,-2094.49,-47930.01
buyer_6,Manuel,Díez,1979-02-14,43668965S,manuel.díez@extremetech.io,146712,ES97209541159222930896,1625.21,2024-06-01T23:45:49,Valladolid,expenses,insurance,-599.65,-48529.66
buyer_6,Manuel,Díez,1979-02-14,43668965S,manuel.díez@extremetech.io,146712,ES97209541159222930896,1625.21,2024-06-01T10:55:58,Valladolid,expenses,food,-110.48,-48640.14
buyer_6,Manuel,Díez,1979-02-14,43668965S,manuel.díez@extremetech.io,146712,ES97209541159222930896,1625.21,2024-06-02T15:41:51,Valladolid,expenses,leisure,-25.15,-48665.29
buyer_6,Manuel,Díez,1979-02-14,43668965S,manuel.díez@extremetech.io,146712,ES97209541159222930896,1625.21,2024-06-02T19:15:45,Valladolid,expenses,gifts,-266.72,-48932.01
buyer_6,Manuel,Díez,1979-02-14,43668965S,manuel.díez@extremetech.io,146712,ES97209541159222930896,1625.21,2024-06-03T13:26:51,Valladolid,expenses,education,-65.39,-48997.4
buyer_6,Manuel,Díez,1979-02-14,43668965S,manuel.díez@extremetech.io,146712,ES97209541159222930896,1625.21,2024-06-04T10:13:24,Valladolid,expenses,repairs,-114.97,-49112.37
buyer_6,Manuel,Díez,1979-02-14,43668965S,manuel.díez@extremetech.io,146712,ES97209541159222930896,1625.21,2024-06-05T14:56:38,Valladolid,expenses,mortgage,-1749.08,-50861.45
buyer_6,Manuel,Díez,1979-02-14,43668965S,manuel.díez@extremetech.io,146712,ES97209541159222930896,1625.21,2024-06-05T19:29:22,Valladolid,expenses,gas,-153.99,-51015.44
buyer_6,Manuel,Díez,1979-02-14,43668965S,manuel.díez@extremetech.io,146712,ES97209541159222930896,1625.21,2024-06-05T10:51:42,Valladolid,expenses,internet,-66.84,-51082.28
buyer_6,Manuel,Díez,1979-02-14,43668965S,manuel.díez@extremetech.io,146712,ES97209541159222930896,1625.21,2024-06-05T14:56:46,Valladolid,expenses,repairs,-300.81,-51383.09
buyer_6,Manuel,Díez,1979-02-14,43668965S,manuel.díez@extremetech.io,146712,ES97209541159222930896,1625.21,2024-06-07T13:01:40,Valladolid,expenses,food,-124.79,-51507.88
buyer_6,Manuel,Díez,1979-02-14,43668965S,manuel.díez@extremetech.io,146712,ES97209541159222930896,1625.21,2024-06-08T13:51:37,Valladolid,expenses,food,-103.06,-51610.94
buyer_6,Manuel,Díez,1979-02-14,43668965S,manuel.díez@extremetech.io,146712,ES97209541159222930896,1625.21,2024-06-08T14:58:07,Valladolid,expenses,leisure,-70.25,-51681.19
buyer_6,Manuel,Díez,1979-02-14,43668965S,manuel.díez@extremetech.io,146712,ES97209541159222930896,1625.21,2024-06-08T12:41:30,Valladolid,expenses,cash,-100.0,-51781.19
buyer_6,Manuel,Díez,1979-02-14,43668965S,manuel.díez@extremetech.io,146712,ES97209541159222930896,1625.21,2024-06-09T08:11:12,Valladolid,expenses,food,-95.06,-51876.25
buyer_6,Manuel,Díez,1979-02-14,43668965S,manuel.díez@extremetech.io,146712,ES97209541159222930896,1625.21,2024-06-11T02:25:27,Valladolid,expenses,transport,-81.9,-51958.15
buyer_6,Manuel,Díez,1979-02-14,43668965S,manuel.díez@extremetech.io,146712,ES97209541159222930896,1625.21,2024-06-12T21:14:49,Valladolid,expenses,leisure,-40.88,-51999.03
buyer_6,Manuel,Díez,1979-02-14,43668965S,manuel.díez@extremetech.io,146712,ES97209541159222930896,1625.21,2024-06-13T14:24:24,Valladolid,expenses,leisure,-48.8,-52047.83
buyer_6,Manuel,Díez,1979-02-14,43668965S,manuel.díez@extremetech.io,146712,ES97209541159222930896,1625.21,2024-06-14T16:00:32,Valladolid,expenses,repairs,-277.73,-52325.56
buyer_6,Manuel,Díez,1979-02-14,43668965S,manuel.díez@extremetech.io,146712,ES97209541159222930896,1625.21,2024-06-15T23:42:56,Valladolid,expenses,repairs,-167.06,-52492.62
buyer_6,Manuel,Díez,1979-02-14,43668965S,manuel.díez@extremetech.io,146712,ES97209541159222930896,1625.21,2024-06-16T17:10:27,Valladolid,expenses,appliances,-324.22,-52816.84
buyer_6,Manuel,Díez,1979-02-14,43668965S,manuel.díez@extremetech.io,146712,ES97209541159222930896,1625.21,2024-06-19T08:06:46,Valladolid,expenses,food,-90.69,-52907.53
buyer_6,Manuel,Díez,1979-02-14,43668965S,manuel.díez@extremetech.io,146712,ES97209541159222930896,1625.21,2024-06-19T07:54:00,Valladolid,expenses,cash,-100.0,-53007.53
buyer_6,Manuel,Díez,1979-02-14,43668965S,manuel.díez@extremetech.io,146712,ES97209541159222930896,1625.21,2024-06-19T13:44:45,Valladolid,expenses,repairs,-166.72,-53174.25
buyer_6,Manuel,Díez,1979-02-14,43668965S,manuel.díez@extremetech.io,146712,ES97209541159222930896,1625.21,2024-06-20T06:42:24,Valladolid,expenses,leisure,-81.06,-53255.31
buyer_6,Manuel,Díez,1979-02-14,43668965S,manuel.díez@extremetech.io,146712,ES97209541159222930896,1625.21,2024-06-20T14:12:14,Valladolid,expenses,cash,-100.0,-53355.31
buyer_6,Manuel,Díez,1979-02-14,43668965S,manuel.díez@extremetech.io,146712,ES97209541159222930896,1625.21,2024-06-22T08:40:51,Valladolid,expenses,leisure,-60.38,-53415.69
buyer_6,Manuel,Díez,1979-02-14,43668965S,manuel.díez@extremetech.io,146712,ES97209541159222930896,1625.21,2024-06-23T14:44:11,Valladolid,expenses,clothing,-50.59,-53466.28
buyer_6,Manuel,Díez,1979-02-14,43668965S,manuel.díez@extremetech.io,146712,ES97209541159222930896,1625.21,2024-06-23T19:49:52,Valladolid,expenses,cash,-100.0,-53566.28
buyer_6,Manuel,Díez,1979-02-14,43668965S,manuel.díez@extremetech.io,146712,ES97209541159222930896,1625.21,2024-06-23T09:48:51,Valladolid,expenses,repairs,-86.69,-53652.97
buyer_6,Manuel,Díez,1979-02-14,43668965S,manuel.díez@extremetech.io,146712,ES97209541159222930896,1625.21,2024-06-24T18:30:55,Valladolid,expenses,cash,-100.0,-53752.97
buyer_6,Manuel,Díez,1979-02-14,43668965S,manuel.díez@extremetech.io,146712,ES97209541159222930896,1625.21,2024-06-25T18:57:31,Valladolid,expenses,transport,-52.52,-53805.49
buyer_6,Manuel,Díez,1979-02-14,43668965S,manuel.díez@extremetech.io,146712,ES97209541159222930896,1625.21,2024-06-29T22:36:00,Valladolid,expenses,cash,-100.0,-53905.49
buyer_6,Manuel,Díez,1979-02-14,43668965S,manuel.díez@extremetech.io,146712,ES97209541159222930896,1625.21,2024-06-29T16:17:16,Valladolid,expenses,repairs,-217.37,-54122.86
buyer_6,Manuel,Díez,1979-02-14,43668965S,manuel.díez@extremetech.io,146712,ES97209541159222930896,1625.21,2024-07-01T18:50:34,Valladolid,incomes,salary,3183.05,-50939.81
buyer_6,Manuel,Díez,1979-02-14,43668965S,manuel.díez@extremetech.io,146712,ES97209541159222930896,1625.21,2024-07-01T13:41:48,Valladolid,expenses,food,-75.09,-51014.9
buyer_6,Manuel,Díez,1979-02-14,43668965S,manuel.díez@extremetech.io,146712,ES97209541159222930896,1625.21,2024-07-02T18:04:34,Valladolid,expenses,transport,-73.56,-51088.46
buyer_6,Manuel,Díez,1979-02-14,43668965S,manuel.díez@extremetech.io,146712,ES97209541159222930896,1625.21,2024-07-03T20:23:33,Valladolid,expenses,clothing,-90.51,-51178.97
buyer_6,Manuel,Díez,1979-02-14,43668965S,manuel.díez@extremetech.io,146712,ES97209541159222930896,1625.21,2024-07-03T11:58:59,Valladolid,expenses,cash,-100.0,-51278.97
buyer_6,Manuel,Díez,1979-02-14,43668965S,manuel.díez@extremetech.io,146712,ES97209541159222930896,1625.21,2024-07-05T17:47:01,Valladolid,expenses,mortgage,-1749.08,-53028.05
buyer_6,Manuel,Díez,1979-02-14,43668965S,manuel.díez@extremetech.io,146712,ES97209541159222930896,1625.21,2024-07-05T20:39:19,Valladolid,expenses,appliances,-229.69,-53257.74
buyer_6,Manuel,Díez,1979-02-14,43668965S,manuel.díez@extremetech.io,146712,ES97209541159222930896,1625.21,2024-07-06T20:14:04,Valladolid,expenses,water,-59.26,-53317.0
buyer_6,Manuel,Díez,1979-02-14,43668965S,manuel.díez@extremetech.io,146712,ES97209541159222930896,1625.21,2024-07-06T14:57:31,Valladolid,expenses,travel,-1191.83,-54508.83
buyer_6,Manuel,Díez,1979-02-14,43668965S,manuel.díez@extremetech.io,146712,ES97209541159222930896,1625.21,2024-07-08T16:23:25,Valladolid,expenses,phone,-50.92,-54559.75
buyer_6,Manuel,Díez,1979-02-14,43668965S,manuel.díez@extremetech.io,146712,ES97209541159222930896,1625.21,2024-07-08T10:48:15,Valladolid,expenses,leisure,-47.89,-54607.64
buyer_6,Manuel,Díez,1979-02-14,43668965S,manuel.díez@extremetech.io,146712,ES97209541159222930896,1625.21,2024-07-08T15:59:55,Valladolid,expenses,gifts,-561.84,-55169.48
buyer_6,Manuel,Díez,1979-02-14,43668965S,manuel.díez@extremetech.io,146712,ES97209541159222930896,1625.21,2024-07-09T10:17:13,Valladolid,expenses,cash,-100.0,-55269.48
buyer_6,Manuel,Díez,1979-02-14,43668965S,manuel.díez@extremetech.io,146712,ES97209541159222930896,1625.21,2024-07-12T20:21:26,Valladolid,expenses,transport,-42.64,-55312.12
buyer_6,Manuel,Díez,1979-02-14,43668965S,manuel.díez@extremetech.io,146712,ES97209541159222930896,1625.21,2024-07-12T15:42:34,Valladolid,expenses,leisure,-45.92,-55358.04
buyer_6,Manuel,Díez,1979-02-14,43668965S,manuel.díez@extremetech.io,146712,ES97209541159222930896,1625.21,2024-07-13T13:41:11,Valladolid,expenses,food,-66.11,-55424.15
buyer_6,Manuel,Díez,1979-02-14,43668965S,manuel.díez@extremetech.io,146712,ES97209541159222930896,1625.21,2024-07-14T11:50:36,Valladolid,expenses,food,-81.66,-55505.81
buyer_6,Manuel,Díez,1979-02-14,43668965S,manuel.díez@extremetech.io,146712,ES97209541159222930896,1625.21,2024-07-14T07:40:20,Valladolid,expenses,education,-56.47,-55562.28
buyer_6,Manuel,Díez,1979-02-14,43668965S,manuel.díez@extremetech.io,146712,ES97209541159222930896,1625.21,2024-07-16T20:33:22,Valladolid,expenses,cash,-100.0,-55662.28
buyer_6,Manuel,Díez,1979-02-14,43668965S,manuel.díez@extremetech.io,146712,ES97209541159222930896,1625.21,2024-07-17T04:32:24,Valladolid,expenses,food,-91.68,-55753.96
buyer_6,Manuel,Díez,1979-02-14,43668965S,manuel.díez@extremetech.io,146712,ES97209541159222930896,1625.21,2024-07-21T18:23:31,Valladolid,expenses,food,-78.24,-55832.2
buyer_6,Manuel,Díez,1979-02-14,43668965S,manuel.díez@extremetech.io,146712,ES97209541159222930896,1625.21,2024-07-21T10:59:43,Valladolid,expenses,clothing,-121.31,-55953.51
buyer_6,Manuel,Díez,1979-02-14,43668965S,manuel.díez@extremetech.io,146712,ES97209541159222930896,1625.21,2024-07-22T10:57:39,Valladolid,expenses,food,-67.22,-56020.73
buyer_6,Manuel,Díez,1979-02-14,43668965S,manuel.díez@extremetech.io,146712,ES97209541159222930896,1625.21,2024-07-24T08:25:53,Valladolid,expenses,leisure,-61.59,-56082.32
buyer_6,Manuel,Díez,1979-02-14,43668965S,manuel.díez@extremetech.io,146712,ES97209541159222930896,1625.21,2024-07-25T13:24:49,Valladolid,expenses,transport,-44.67,-56126.99
buyer_6,Manuel,Díez,1979-02-14,43668965S,manuel.díez@extremetech.io,146712,ES97209541159222930896,1625.21,2024-07-26T21:47:56,Valladolid,expenses,gifts,-840.55,-56967.54
buyer_6,Manuel,Díez,1979-02-14,43668965S,manuel.díez@extremetech.io,146712,ES97209541159222930896,1625.21,2024-07-27T11:05:59,Valladolid,expenses,transport,-45.61,-57013.15
buyer_6,Manuel,Díez,1979-02-14,43668965S,manuel.díez@extremetech.io,146712,ES97209541159222930896,1625.21,2024-07-28T19:05:17,Valladolid,expenses,transport,-59.08,-57072.23
buyer_6,Manuel,Díez,1979-02-14,43668965S,manuel.díez@extremetech.io,146712,ES97209541159222930896,1625.21,2024-07-29T09:45:01,Valladolid,expenses,healthcare,-178.42,-57250.65
buyer_6,Manuel,Díez,1979-02-14,43668965S,manuel.díez@extremetech.io,146712,ES97209541159222930896,1625.21,2024-07-30T13:45:36,Valladolid,expenses,cash,-100.0,-57350.65
buyer_6,Manuel,Díez,1979-02-14,43668965S,manuel.díez@extremetech.io,146712,ES97209541159222930896,1625.21,2024-07-31T18:50:55,Valladolid,expenses,food,-69.78,-57420.43
buyer_6,Manuel,Díez,1979-02-14,43668965S,manuel.díez@extremetech.io,146712,ES97209541159222930896,1625.21,2024-08-01T20:21:36,Valladolid,incomes,salary,3183.05,-54237.38
buyer_6,Manuel,Díez,1979-02-14,43668965S,manuel.díez@extremetech.io,146712,ES97209541159222930896,1625.21,2024-08-03T14:42:26,Valladolid,expenses,food,-63.99,-54301.37
buyer_6,Manuel,Díez,1979-02-14,43668965S,manuel.díez@extremetech.io,146712,ES97209541159222930896,1625.21,2024-08-05T20:32:25,Valladolid,expenses,mortgage,-1749.08,-56050.45
buyer_6,Manuel,Díez,1979-02-14,43668965S,manuel.díez@extremetech.io,146712,ES97209541159222930896,1625.21,2024-08-05T16:27:08,Valladolid,expenses,electricity,-125.4,-56175.85
buyer_6,Manuel,Díez,1979-02-14,43668965S,manuel.díez@extremetech.io,146712,ES97209541159222930896,1625.21,2024-08-05T09:49:39,Valladolid,expenses,gas,-88.66,-56264.51
buyer_6,Manuel,Díez,1979-02-14,43668965S,manuel.díez@extremetech.io,146712,ES97209541159222930896,1625.21,2024-08-05T19:33:56,Valladolid,expenses,food,-62.13,-56326.64
buyer_6,Manuel,Díez,1979-02-14,43668965S,manuel.díez@extremetech.io,146712,ES97209541159222930896,1625.21,2024-08-06T16:39:51,Valladolid,expenses,water,-68.31,-56394.95
buyer_6,Manuel,Díez,1979-02-14,43668965S,manuel.díez@extremetech.io,146712,ES97209541159222930896,1625.21,2024-08-06T19:48:27,Valladolid,expenses,electricity,-101.33,-56496.28
buyer_6,Manuel,Díez,1979-02-14,43668965S,manuel.díez@extremetech.io,146712,ES97209541159222930896,1625.21,2024-08-06T13:10:33,Valladolid,expenses,internet,-66.84,-56563.12
buyer_6,Manuel,Díez,1979-02-14,43668965S,manuel.díez@extremetech.io,146712,ES97209541159222930896,1625.21,2024-08-06T12:25:13,Valladolid,expenses,phone,-70.01,-56633.13
buyer_6,Manuel,Díez,1979-02-14,43668965S,manuel.díez@extremetech.io,146712,ES97209541159222930896,1625.21,2024-08-06T20:28:11,Valladolid,expenses,food,-115.98,-56749.11
buyer_6,Manuel,Díez,1979-02-14,43668965S,manuel.díez@extremetech.io,146712,ES97209541159222930896,1625.21,2024-08-06T19:42:57,Valladolid,expenses,cash,-100.0,-56849.11
buyer_6,Manuel,Díez,1979-02-14,43668965S,manuel.díez@extremetech.io,146712,ES97209541159222930896,1625.21,2024-08-07T19:00:54,Valladolid,expenses,water,-32.86,-56881.97
buyer_6,Manuel,Díez,1979-02-14,43668965S,manuel.díez@extremetech.io,146712,ES97209541159222930896,1625.21,2024-08-07T17:27:40,Valladolid,expenses,gas,-52.36,-56934.33
buyer_6,Manuel,Díez,1979-02-14,43668965S,manuel.díez@extremetech.io,146712,ES97209541159222930896,1625.21,2024-08-07T16:44:32,Valladolid,expenses,internet,-66.84,-57001.17
buyer_6,Manuel,Díez,1979-02-14,43668965S,manuel.díez@extremetech.io,146712,ES97209541159222930896,1625.21,2024-08-07T20:57:10,Valladolid,expenses,phone,-51.88,-57053.05
buyer_6,Manuel,Díez,1979-02-14,43668965S,manuel.díez@extremetech.io,146712,ES97209541159222930896,1625.21,2024-08-08T16:51:41,Valladolid,expenses,internet,-66.84,-57119.89
buyer_6,Manuel,Díez,1979-02-14,43668965S,manuel.díez@extremetech.io,146712,ES97209541159222930896,1625.21,2024-08-08T15:44:08,Valladolid,expenses,phone,-52.03,-57171.92
buyer_6,Manuel,Díez,1979-02-14,43668965S,manuel.díez@extremetech.io,146712,ES97209541159222930896,1625.21,2024-08-08T22:10:33,Valladolid,expenses,food,-60.9,-57232.82
buyer_6,Manuel,Díez,1979-02-14,43668965S,manuel.díez@extremetech.io,146712,ES97209541159222930896,1625.21,2024-08-10T09:49:12,Valladolid,expenses,transport,-57.79,-57290.61
buyer_6,Manuel,Díez,1979-02-14,43668965S,manuel.díez@extremetech.io,146712,ES97209541159222930896,1625.21,2024-08-11T12:35:51,Valladolid,expenses,food,-102.98,-57393.59
buyer_6,Manuel,Díez,1979-02-14,43668965S,manuel.díez@extremetech.io,146712,ES97209541159222930896,1625.21,2024-08-14T11:03:33,Valladolid,expenses,leisure,-50.37,-57443.96
buyer_6,Manuel,Díez,1979-02-14,43668965S,manuel.díez@extremetech.io,146712,ES97209541159222930896,1625.21,2024-08-15T11:56:21,Valladolid,expenses,leisure,-53.09,-57497.05
buyer_6,Manuel,Díez,1979-02-14,43668965S,manuel.díez@extremetech.io,146712,ES97209541159222930896,1625.21,2024-08-17T13:40:50,Valladolid,expenses,leisure,-70.42,-57567.47
buyer_6,Manuel,Díez,1979-02-14,43668965S,manuel.díez@extremetech.io,146712,ES97209541159222930896,1625.21,2024-08-23T22:31:58,Valladolid,expenses,cash,-100.0,-57667.47
buyer_6,Manuel,Díez,1979-02-14,43668965S,manuel.díez@extremetech.io,146712,ES97209541159222930896,1625.21,2024-08-24T05:55:07,Valladolid,expenses,transport,-50.53,-57718.0
buyer_6,Manuel,Díez,1979-02-14,43668965S,manuel.díez@extremetech.io,146712,ES97209541159222930896,1625.21,2024-08-24T11:37:52,Valladolid,expenses,leisure,-45.14,-57763.14
buyer_6,Manuel,Díez,1979-02-14,43668965S,manuel.díez@extremetech.io,146712,ES97209541159222930896,1625.21,2024-08-25T09:11:17,Valladolid,expenses,food,-92.08,-57855.22
buyer_6,Manuel,Díez,1979-02-14,43668965S,manuel.díez@extremetech.io,146712,ES97209541159222930896,1625.21,2024-08-25T09:08:18,Valladolid,expenses,repairs,-313.02,-58168.24
buyer_6,Manuel,Díez,1979-02-14,43668965S,manuel.díez@extremetech.io,146712,ES97209541159222930896,1625.21,2024-08-27T17:10:11,Valladolid,expenses,clothing,-149.99,-58318.23
buyer_6,Manuel,Díez,1979-02-14,43668965S,manuel.díez@extremetech.io,146712,ES97209541159222930896,1625.21,2024-08-27T10:16:49,Valladolid,expenses,education,-70.04,-58388.27
buyer_6,Manuel,Díez,1979-02-14,43668965S,manuel.díez@extremetech.io,146712,ES97209541159222930896,1625.21,2024-08-30T19:08:19,Valladolid,expenses,clothing,-158.39,-58546.66
buyer_6,Manuel,Díez,1979-02-14,43668965S,manuel.díez@extremetech.io,146712,ES97209541159222930896,1625.21,2024-08-31T15:29:32,Valladolid,expenses,gifts,-430.03,-58976.69
buyer_6,Manuel,Díez,1979-02-14,43668965S,manuel.díez@extremetech.io,146712,ES97209541159222930896,1625.21,2024-09-01T15:48:54,Valladolid,incomes,salary,3183.05,-55793.64
buyer_6,Manuel,Díez,1979-02-14,43668965S,manuel.díez@extremetech.io,146712,ES97209541159222930896,1625.21,2024-09-01T02:24:23,Valladolid,expenses,gifts,-401.13,-56194.77
buyer_6,Manuel,Díez,1979-02-14,43668965S,manuel.díez@extremetech.io,146712,ES97209541159222930896,1625.21,2024-09-02T14:01:22,Valladolid,expenses,leisure,-21.1,-56215.87
buyer_6,Manuel,Díez,1979-02-14,43668965S,manuel.díez@extremetech.io,146712,ES97209541159222930896,1625.21,2024-09-03T13:47:30,Valladolid,expenses,leisure,-20.32,-56236.19
buyer_6,Manuel,Díez,1979-02-14,43668965S,manuel.díez@extremetech.io,146712,ES97209541159222930896,1625.21,2024-09-05T18:06:33,Valladolid,expenses,mortgage,-1749.08,-57985.27
buyer_6,Manuel,Díez,1979-02-14,43668965S,manuel.díez@extremetech.io,146712,ES97209541159222930896,1625.21,2024-09-05T17:06:38,Valladolid,expenses,gas,-138.06,-58123.33
buyer_6,Manuel,Díez,1979-02-14,43668965S,manuel.díez@extremetech.io,146712,ES97209541159222930896,1625.21,2024-09-05T16:46:43,Valladolid,expenses,phone,-61.86,-58185.19
buyer_6,Manuel,Díez,1979-02-14,43668965S,manuel.díez@extremetech.io,146712,ES97209541159222930896,1625.21,2024-09-06T17:33:32,Valladolid,expenses,electricity,-32.27,-58217.46
buyer_6,Manuel,Díez,1979-02-14,43668965S,manuel.díez@extremetech.io,146712,ES97209541159222930896,1625.21,2024-09-06T21:12:37,Valladolid,expenses,gas,-99.88,-58317.34
buyer_6,Manuel,Díez,1979-02-14,43668965S,manuel.díez@extremetech.io,146712,ES97209541159222930896,1625.21,2024-09-08T09:50:51,Valladolid,expenses,water,-50.57,-58367.91
buyer_6,Manuel,Díez,1979-02-14,43668965S,manuel.díez@extremetech.io,146712,ES97209541159222930896,1625.21,2024-09-08T17:58:19,Valladolid,expenses,electricity,-49.79,-58417.7
buyer_6,Manuel,Díez,1979-02-14,43668965S,manuel.díez@extremetech.io,146712,ES97209541159222930896,1625.21,2024-09-10T21:33:43,Valladolid,expenses,food,-91.32,-58509.02
buyer_6,Manuel,Díez,1979-02-14,43668965S,manuel.díez@extremetech.io,146712,ES97209541159222930896,1625.21,2024-09-10T11:17:12,Valladolid,expenses,cash,-100.0,-58609.02
buyer_6,Manuel,Díez,1979-02-14,43668965S,manuel.díez@extremetech.io,146712,ES97209541159222930896,1625.21,2024-09-13T22:08:02,Valladolid,expenses,food,-63.54,-58672.56
buyer_6,Manuel,Díez,1979-02-14,43668965S,manuel.díez@extremetech.io,146712,ES97209541159222930896,1625.21,2024-09-13T21:49:53,Valladolid,expenses,transport,-54.37,-58726.93
buyer_6,Manuel,Díez,1979-02-14,43668965S,manuel.díez@extremetech.io,146712,ES97209541159222930896,1625.21,2024-09-14T05:42:06,Valladolid,expenses,education,-65.4,-58792.33
buyer_6,Manuel,Díez,1979-02-14,43668965S,manuel.díez@extremetech.io,146712,ES97209541159222930896,1625.21,2024-09-15T16:59:23,Valladolid,expenses,transport,-79.7,-58872.03
buyer_6,Manuel,Díez,1979-02-14,43668965S,manuel.díez@extremetech.io,146712,ES97209541159222930896,1625.21,2024-09-15T18:21:40,Valladolid,expenses,gifts,-630.69,-59502.72
buyer_6,Manuel,Díez,1979-02-14,43668965S,manuel.díez@extremetech.io,146712,ES97209541159222930896,1625.21,2024-09-16T20:32:52,Valladolid,expenses,food,-94.45,-59597.17
buyer_6,Manuel,Díez,1979-02-14,43668965S,manuel.díez@extremetech.io,146712,ES97209541159222930896,1625.21,2024-09-19T13:34:12,Valladolid,expenses,gifts,-397.04,-59994.21
buyer_6,Manuel,Díez,1979-02-14,43668965S,manuel.díez@extremetech.io,146712,ES97209541159222930896,1625.21,2024-09-21T23:27:54,Valladolid,expenses,food,-69.56,-60063.77
buyer_6,Manuel,Díez,1979-02-14,43668965S,manuel.díez@extremetech.io,146712,ES97209541159222930896,1625.21,2024-09-22T18:06:26,Valladolid,expenses,leisure,-58.36,-60122.13
buyer_6,Manuel,Díez,1979-02-14,43668965S,manuel.díez@extremetech.io,146712,ES97209541159222930896,1625.21,2024-09-22T21:31:34,Valladolid,expenses,cash,-100.0,-60222.13
buyer_6,Manuel,Díez,1979-02-14,43668965S,manuel.díez@extremetech.io,146712,ES97209541159222930896,1625.21,2024-09-23T21:47:48,Valladolid,expenses,clothing,-66.36,-60288.49
buyer_6,Manuel,Díez,1979-02-14,43668965S,manuel.díez@extremetech.io,146712,ES97209541159222930896,1625.21,2024-09-23T14:52:09,Valladolid,expenses,healthcare,-112.78,-60401.27
buyer_6,Manuel,Díez,1979-02-14,43668965S,manuel.díez@extremetech.io,146712,ES97209541159222930896,1625.21,2024-09-23T13:13:15,Valladolid,expenses,gifts,-729.57,-61130.84
buyer_6,Manuel,Díez,1979-02-14,43668965S,manuel.díez@extremetech.io,146712,ES97209541159222930896,1625.21,2024-09-24T09:34:44,Valladolid,expenses,food,-91.94,-61222.78
buyer_6,Manuel,Díez,1979-02-14,43668965S,manuel.díez@extremetech.io,146712,ES97209541159222930896,1625.21,2024-09-25T11:42:51,Valladolid,expenses,food,-122.41,-61345.19
buyer_6,Manuel,Díez,1979-02-14,43668965S,manuel.díez@extremetech.io,146712,ES97209541159222930896,1625.21,2024-09-28T18:16:05,Valladolid,expenses,cash,-100.0,-61445.19
buyer_6,Manuel,Díez,1979-02-14,43668965S,manuel.díez@extremetech.io,146712,ES97209541159222930896,1625.21,2024-09-30T17:33:26,Valladolid,expenses,transport,-46.34,-61491.53
buyer_6,Manuel,Díez,1979-02-14,43668965S,manuel.díez@extremetech.io,146712,ES97209541159222930896,1625.21,2024-09-30T20:00:38,Valladolid,expenses,repairs,-234.55,-61726.08
buyer_6,Manuel,Díez,1979-02-14,43668965S,manuel.díez@extremetech.io,146712,ES97209541159222930896,1625.21,2024-10-01T15:20:32,Valladolid,incomes,salary,3183.05,-58543.03
buyer_6,Manuel,Díez,1979-02-14,43668965S,manuel.díez@extremetech.io,146712,ES97209541159222930896,1625.21,2024-10-01T15:20:32,Valladolid,incomes,extra_income,330.25,-58212.78
buyer_6,Manuel,Díez,1979-02-14,43668965S,manuel.díez@extremetech.io,146712,ES97209541159222930896,1625.21,2024-10-03T18:30:01,Valladolid,expenses,appliances,-246.39,-58459.17
buyer_6,Manuel,Díez,1979-02-14,43668965S,manuel.díez@extremetech.io,146712,ES97209541159222930896,1625.21,2024-10-05T08:00:54,Valladolid,expenses,mortgage,-1749.08,-60208.25
buyer_6,Manuel,Díez,1979-02-14,43668965S,manuel.díez@extremetech.io,146712,ES97209541159222930896,1625.21,2024-10-05T15:30:50,Valladolid,expenses,water,-65.91,-60274.16
buyer_6,Manuel,Díez,1979-02-14,43668965S,manuel.díez@extremetech.io,146712,ES97209541159222930896,1625.21,2024-10-05T15:54:44,Valladolid,expenses,food,-81.55,-60355.71
buyer_6,Manuel,Díez,1979-02-14,43668965S,manuel.díez@extremetech.io,146712,ES97209541159222930896,1625.21,2024-10-06T17:47:50,Valladolid,expenses,water,-61.62,-60417.33
buyer_6,Manuel,Díez,1979-02-14,43668965S,manuel.díez@extremetech.io,146712,ES97209541159222930896,1625.21,2024-10-06T12:28:26,Valladolid,expenses,cash,-100.0,-60517.33
buyer_6,Manuel,Díez,1979-02-14,43668965S,manuel.díez@extremetech.io,146712,ES97209541159222930896,1625.21,2024-10-06T18:47:08,Valladolid,expenses,gifts,-643.82,-61161.15
buyer_6,Manuel,Díez,1979-02-14,43668965S,manuel.díez@extremetech.io,146712,ES97209541159222930896,1625.21,2024-10-07T09:36:55,Valladolid,expenses,internet,-66.84,-61227.99
buyer_6,Manuel,Díez,1979-02-14,43668965S,manuel.díez@extremetech.io,146712,ES97209541159222930896,1625.21,2024-10-07T15:54:28,Valladolid,expenses,healthcare,-127.15,-61355.14
buyer_6,Manuel,Díez,1979-02-14,43668965S,manuel.díez@extremetech.io,146712,ES97209541159222930896,1625.21,2024-10-07T08:55:24,Valladolid,expenses,cash,-100.0,-61455.14
buyer_6,Manuel,Díez,1979-02-14,43668965S,manuel.díez@extremetech.io,146712,ES97209541159222930896,1625.21,2024-10-08T10:39:37,Valladolid,expenses,water,-41.07,-61496.21
buyer_6,Manuel,Díez,1979-02-14,43668965S,manuel.díez@extremetech.io,146712,ES97209541159222930896,1625.21,2024-10-08T12:55:10,Valladolid,expenses,food,-60.88,-61557.09
buyer_6,Manuel,Díez,1979-02-14,43668965S,manuel.díez@extremetech.io,146712,ES97209541159222930896,1625.21,2024-10-09T13:41:25,Valladolid,expenses,leisure,-25.51,-61582.6
buyer_6,Manuel,Díez,1979-02-14,43668965S,manuel.díez@extremetech.io,146712,ES97209541159222930896,1625.21,2024-10-09T19:51:21,Valladolid,expenses,healthcare,-140.4,-61723.0
buyer_6,Manuel,Díez,1979-02-14,43668965S,manuel.díez@extremetech.io,146712,ES97209541159222930896,1625.21,2024-10-10T15:45:48,Valladolid,expenses,food,-86.79,-61809.79
buyer_6,Manuel,Díez,1979-02-14,43668965S,manuel.díez@extremetech.io,146712,ES97209541159222930896,1625.21,2024-10-10T23:12:15,Valladolid,expenses,leisure,-77.43,-61887.22
buyer_6,Manuel,Díez,1979-02-14,43668965S,manuel.díez@extremetech.io,146712,ES97209541159222930896,1625.21,2024-10-10T23:25:11,Valladolid,expenses,cash,-100.0,-61987.22
buyer_6,Manuel,Díez,1979-02-14,43668965S,manuel.díez@extremetech.io,146712,ES97209541159222930896,1625.21,2024-10-10T13:00:01,Valladolid,expenses,gifts,-448.01,-62435.23
buyer_7,Agurtzane,Laka,1968-12-31,26592366L,agurtzane.laka@awesomecloud.co,463672,ES23209508102455354994,1990.94,2022-01-01T14:22:34,Bilbao,incomes,salary,1512.47,3503.41
buyer_7,Agurtzane,Laka,1968-12-31,26592366L,agurtzane.laka@awesomecloud.co,463672,ES23209508102455354994,1990.94,2022-01-03T09:04:16,Bilbao,expenses,leisure,-30.07,3473.34
buyer_7,Agurtzane,Laka,1968-12-31,26592366L,agurtzane.laka@awesomecloud.co,463672,ES23209508102455354994,1990.94,2022-01-03T18:22:45,Bilbao,expenses,repairs,-109.29,3364.05
buyer_7,Agurtzane,Laka,1968-12-31,26592366L,agurtzane.laka@awesomecloud.co,463672,ES23209508102455354994,1990.94,2022-01-05T22:03:26,Bilbao,expenses,mortgage,-769.48,2594.57
buyer_7,Agurtzane,Laka,1968-12-31,26592366L,agurtzane.laka@awesomecloud.co,463672,ES23209508102455354994,1990.94,2022-01-05T11:25:25,Bilbao,expenses,internet,-31.76,2562.81
buyer_7,Agurtzane,Laka,1968-12-31,26592366L,agurtzane.laka@awesomecloud.co,463672,ES23209508102455354994,1990.94,2022-01-06T21:25:56,Bilbao,expenses,internet,-31.76,2531.05
buyer_7,Agurtzane,Laka,1968-12-31,26592366L,agurtzane.laka@awesomecloud.co,463672,ES23209508102455354994,1990.94,2022-01-07T11:50:48,Bilbao,expenses,gas,-65.63,2465.42
buyer_7,Agurtzane,Laka,1968-12-31,26592366L,agurtzane.laka@awesomecloud.co,463672,ES23209508102455354994,1990.94,2022-01-07T10:25:54,Bilbao,expenses,leisure,-78.24,2387.18
buyer_7,Agurtzane,Laka,1968-12-31,26592366L,agurtzane.laka@awesomecloud.co,463672,ES23209508102455354994,1990.94,2022-01-07T14:15:53,Bilbao,expenses,clothing,-100.1,2287.08
buyer_7,Agurtzane,Laka,1968-12-31,26592366L,agurtzane.laka@awesomecloud.co,463672,ES23209508102455354994,1990.94,2022-01-07T12:12:47,Bilbao,expenses,repairs,-68.84,2218.24
buyer_7,Agurtzane,Laka,1968-12-31,26592366L,agurtzane.laka@awesomecloud.co,463672,ES23209508102455354994,1990.94,2022-01-08T14:57:38,Bilbao,expenses,gas,-40.65,2177.59
buyer_7,Agurtzane,Laka,1968-12-31,26592366L,agurtzane.laka@awesomecloud.co,463672,ES23209508102455354994,1990.94,2022-01-08T14:06:02,Bilbao,expenses,healthcare,-130.18,2047.41
buyer_7,Agurtzane,Laka,1968-12-31,26592366L,agurtzane.laka@awesomecloud.co,463672,ES23209508102455354994,1990.94,2022-01-08T11:15:22,Bilbao,expenses,children,-124.2,1923.21
buyer_7,Agurtzane,Laka,1968-12-31,26592366L,agurtzane.laka@awesomecloud.co,463672,ES23209508102455354994,1990.94,2022-01-09T10:28:19,Bilbao,expenses,leisure,-19.57,1903.64
buyer_7,Agurtzane,Laka,1968-12-31,26592366L,agurtzane.laka@awesomecloud.co,463672,ES23209508102455354994,1990.94,2022-01-10T12:58:38,Bilbao,expenses,appliances,-318.15,1585.49
buyer_7,Agurtzane,Laka,1968-12-31,26592366L,agurtzane.laka@awesomecloud.co,463672,ES23209508102455354994,1990.94,2022-01-11T22:26:37,Bilbao,expenses,transport,-78.97,1506.52
buyer_7,Agurtzane,Laka,1968-12-31,26592366L,agurtzane.laka@awesomecloud.co,463672,ES23209508102455354994,1990.94,2022-01-13T19:13:43,Bilbao,expenses,leisure,-59.64,1446.88
buyer_7,Agurtzane,Laka,1968-12-31,26592366L,agurtzane.laka@awesomecloud.co,463672,ES23209508102455354994,1990.94,2022-01-13T17:57:54,Bilbao,expenses,cash,-100.0,1346.88
buyer_7,Agurtzane,Laka,1968-12-31,26592366L,agurtzane.laka@awesomecloud.co,463672,ES23209508102455354994,1990.94,2022-01-15T18:57:45,Bilbao,expenses,cash,-100.0,1246.88
buyer_7,Agurtzane,Laka,1968-12-31,26592366L,agurtzane.laka@awesomecloud.co,463672,ES23209508102455354994,1990.94,2022-01-16T13:39:45,Bilbao,expenses,food,-96.17,1150.71
buyer_7,Agurtzane,Laka,1968-12-31,26592366L,agurtzane.laka@awesomecloud.co,463672,ES23209508102455354994,1990.94,2022-01-17T04:52:38,Bilbao,expenses,food,-101.52,1049.19
buyer_7,Agurtzane,Laka,1968-12-31,26592366L,agurtzane.laka@awesomecloud.co,463672,ES23209508102455354994,1990.94,2022-01-19T08:21:10,Bilbao,expenses,gifts,-165.19,884.0
buyer_7,Agurtzane,Laka,1968-12-31,26592366L,agurtzane.laka@awesomecloud.co,463672,ES23209508102455354994,1990.94,2022-01-21T17:00:47,Bilbao,expenses,transport,-70.03,813.97
buyer_7,Agurtzane,Laka,1968-12-31,26592366L,agurtzane.laka@awesomecloud.co,463672,ES23209508102455354994,1990.94,2022-01-21T13:59:55,Bilbao,expenses,leisure,-52.72,761.25
buyer_7,Agurtzane,Laka,1968-12-31,26592366L,agurtzane.laka@awesomecloud.co,463672,ES23209508102455354994,1990.94,2022-01-21T16:01:33,Bilbao,expenses,clothing,-124.0,637.25
buyer_7,Agurtzane,Laka,1968-12-31,26592366L,agurtzane.laka@awesomecloud.co,463672,ES23209508102455354994,1990.94,2022-01-22T14:29:50,Bilbao,expenses,cash,-100.0,537.25
buyer_7,Agurtzane,Laka,1968-12-31,26592366L,agurtzane.laka@awesomecloud.co,463672,ES23209508102455354994,1990.94,2022-01-23T15:17:16,Bilbao,expenses,cash,-100.0,437.25
buyer_7,Agurtzane,Laka,1968-12-31,26592366L,agurtzane.laka@awesomecloud.co,463672,ES23209508102455354994,1990.94,2022-01-23T16:16:15,Bilbao,expenses,repairs,-56.93,380.32
buyer_7,Agurtzane,Laka,1968-12-31,26592366L,agurtzane.laka@awesomecloud.co,463672,ES23209508102455354994,1990.94,2022-01-24T08:38:49,Bilbao,expenses,food,-63.77,316.55
buyer_7,Agurtzane,Laka,1968-12-31,26592366L,agurtzane.laka@awesomecloud.co,463672,ES23209508102455354994,1990.94,2022-01-25T10:40:30,Bilbao,expenses,food,-114.39,202.16
buyer_7,Agurtzane,Laka,1968-12-31,26592366L,agurtzane.laka@awesomecloud.co,463672,ES23209508102455354994,1990.94,2022-01-25T10:44:17,Bilbao,expenses,appliances,-147.27,54.89
buyer_7,Agurtzane,Laka,1968-12-31,26592366L,agurtzane.laka@awesomecloud.co,463672,ES23209508102455354994,1990.94,2022-01-27T15:38:59,Bilbao,expenses,clothing,-90.03,-35.14
buyer_7,Agurtzane,Laka,1968-12-31,26592366L,agurtzane.laka@awesomecloud.co,463672,ES23209508102455354994,1990.94,2022-01-27T12:16:48,Bilbao,expenses,cash,-100.0,-135.14
buyer_7,Agurtzane,Laka,1968-12-31,26592366L,agurtzane.laka@awesomecloud.co,463672,ES23209508102455354994,1990.94,2022-01-28T09:37:01,Bilbao,expenses,repairs,-180.88,-316.02
buyer_7,Agurtzane,Laka,1968-12-31,26592366L,agurtzane.laka@awesomecloud.co,463672,ES23209508102455354994,1990.94,2022-01-30T23:16:39,Bilbao,expenses,healthcare,-187.66,-503.68
buyer_7,Agurtzane,Laka,1968-12-31,26592366L,agurtzane.laka@awesomecloud.co,463672,ES23209508102455354994,1990.94,2022-02-01T16:13:07,Bilbao,incomes,salary,1512.47,1008.79
buyer_7,Agurtzane,Laka,1968-12-31,26592366L,agurtzane.laka@awesomecloud.co,463672,ES23209508102455354994,1990.94,2022-02-02T23:55:16,Bilbao,expenses,gifts,-211.36,797.43
buyer_7,Agurtzane,Laka,1968-12-31,26592366L,agurtzane.laka@awesomecloud.co,463672,ES23209508102455354994,1990.94,2022-02-03T20:52:13,Bilbao,expenses,clothing,-153.98,643.45
buyer_7,Agurtzane,Laka,1968-12-31,26592366L,agurtzane.laka@awesomecloud.co,463672,ES23209508102455354994,1990.94,2022-02-03T08:25:21,Bilbao,expenses,cash,-100.0,543.45
buyer_7,Agurtzane,Laka,1968-12-31,26592366L,agurtzane.laka@awesomecloud.co,463672,ES23209508102455354994,1990.94,2022-02-04T20:48:16,Bilbao,expenses,clothing,-54.34,489.11
buyer_7,Agurtzane,Laka,1968-12-31,26592366L,agurtzane.laka@awesomecloud.co,463672,ES23209508102455354994,1990.94,2022-02-05T05:12:21,Bilbao,expenses,mortgage,-769.48,-280.37
buyer_7,Agurtzane,Laka,1968-12-31,26592366L,agurtzane.laka@awesomecloud.co,463672,ES23209508102455354994,1990.94,2022-02-06T19:47:45,Bilbao,expenses,internet,-31.76,-312.13
buyer_7,Agurtzane,Laka,1968-12-31,26592366L,agurtzane.laka@awesomecloud.co,463672,ES23209508102455354994,1990.94,2022-02-07T13:44:32,Bilbao,expenses,electricity,-23.13,-335.26
buyer_7,Agurtzane,Laka,1968-12-31,26592366L,agurtzane.laka@awesomecloud.co,463672,ES23209508102455354994,1990.94,2022-02-08T08:29:19,Bilbao,expenses,phone,-31.43,-366.69
buyer_7,Agurtzane,Laka,1968-12-31,26592366L,agurtzane.laka@awesomecloud.co,463672,ES23209508102455354994,1990.94,2022-02-08T08:18:58,Bilbao,expenses,clothing,-112.88,-479.57
buyer_7,Agurtzane,Laka,1968-12-31,26592366L,agurtzane.laka@awesomecloud.co,463672,ES23209508102455354994,1990.94,2022-02-08T09:08:54,Bilbao,expenses,cash,-100.0,-579.57
buyer_7,Agurtzane,Laka,1968-12-31,26592366L,agurtzane.laka@awesomecloud.co,463672,ES23209508102455354994,1990.94,2022-02-08T22:55:09,Bilbao,expenses,gifts,-45.05,-624.62
buyer_7,Agurtzane,Laka,1968-12-31,26592366L,agurtzane.laka@awesomecloud.co,463672,ES23209508102455354994,1990.94,2022-02-10T04:54:50,Bilbao,expenses,transport,-73.5,-698.12
buyer_7,Agurtzane,Laka,1968-12-31,26592366L,agurtzane.laka@awesomecloud.co,463672,ES23209508102455354994,1990.94,2022-02-11T02:07:58,Bilbao,expenses,food,-120.0,-818.12
buyer_7,Agurtzane,Laka,1968-12-31,26592366L,agurtzane.laka@awesomecloud.co,463672,ES23209508102455354994,1990.94,2022-02-12T18:37:00,Bilbao,expenses,clothing,-100.81,-918.93
buyer_7,Agurtzane,Laka,1968-12-31,26592366L,agurtzane.laka@awesomecloud.co,463672,ES23209508102455354994,1990.94,2022-02-12T15:51:46,Bilbao,expenses,gifts,-198.23,-1117.16
buyer_7,Agurtzane,Laka,1968-12-31,26592366L,agurtzane.laka@awesomecloud.co,463672,ES23209508102455354994,1990.94,2022-02-14T14:52:54,Bilbao,expenses,food,-98.7,-1215.86
buyer_7,Agurtzane,Laka,1968-12-31,26592366L,agurtzane.laka@awesomecloud.co,463672,ES23209508102455354994,1990.94,2022-02-16T12:08:43,Bilbao,expenses,leisure,-73.59,-1289.45
buyer_7,Agurtzane,Laka,1968-12-31,26592366L,agurtzane.laka@awesomecloud.co,463672,ES23209508102455354994,1990.94,2022-02-18T17:39:32,Bilbao,expenses,food,-110.83,-1400.28
buyer_7,Agurtzane,Laka,1968-12-31,26592366L,agurtzane.laka@awesomecloud.co,463672,ES23209508102455354994,1990.94,2022-02-18T11:07:50,Bilbao,expenses,transport,-49.58,-1449.86
buyer_7,Agurtzane,Laka,1968-12-31,26592366L,agurtzane.laka@awesomecloud.co,463672,ES23209508102455354994,1990.94,2022-02-24T13:48:02,Bilbao,expenses,transport,-72.4,-1522.26
buyer_7,Agurtzane,Laka,1968-12-31,26592366L,agurtzane.laka@awesomecloud.co,463672,ES23209508102455354994,1990.94,2022-02-24T17:17:30,Bilbao,expenses,clothing,-61.85,-1584.11
buyer_7,Agurtzane,Laka,1968-12-31,26592366L,agurtzane.laka@awesomecloud.co,463672,ES23209508102455354994,1990.94,2022-02-28T16:37:14,Bilbao,expenses,transport,-68.24,-1652.35
buyer_7,Agurtzane,Laka,1968-12-31,26592366L,agurtzane.laka@awesomecloud.co,463672,ES23209508102455354994,1990.94,2022-02-28T17:50:26,Bilbao,expenses,leisure,-50.29,-1702.64
buyer_7,Agurtzane,Laka,1968-12-31,26592366L,agurtzane.laka@awesomecloud.co,463672,ES23209508102455354994,1990.94,2022-02-28T16:05:12,Bilbao,expenses,repairs,-137.3,-1839.94
buyer_7,Agurtzane,Laka,1968-12-31,26592366L,agurtzane.laka@awesomecloud.co,463672,ES23209508102455354994,1990.94,2022-03-01T09:24:08,Bilbao,incomes,salary,1512.47,-327.47
buyer_7,Agurtzane,Laka,1968-12-31,26592366L,agurtzane.laka@awesomecloud.co,463672,ES23209508102455354994,1990.94,2022-03-03T19:29:05,Bilbao,expenses,clothing,-107.89,-435.36
buyer_7,Agurtzane,Laka,1968-12-31,26592366L,agurtzane.laka@awesomecloud.co,463672,ES23209508102455354994,1990.94,2022-03-04T03:57:50,Bilbao,expenses,leisure,-33.74,-469.1
buyer_7,Agurtzane,Laka,1968-12-31,26592366L,agurtzane.laka@awesomecloud.co,463672,ES23209508102455354994,1990.94,2022-03-04T18:27:59,Bilbao,expenses,gifts,-65.53,-534.63
buyer_7,Agurtzane,Laka,1968-12-31,26592366L,agurtzane.laka@awesomecloud.co,463672,ES23209508102455354994,1990.94,2022-03-05T20:10:39,Bilbao,expenses,mortgage,-769.48,-1304.11
buyer_7,Agurtzane,Laka,1968-12-31,26592366L,agurtzane.laka@awesomecloud.co,463672,ES23209508102455354994,1990.94,2022-03-05T22:54:43,Bilbao,expenses,phone,-27.66,-1331.77
buyer_7,Agurtzane,Laka,1968-12-31,26592366L,agurtzane.laka@awesomecloud.co,463672,ES23209508102455354994,1990.94,2022-03-05T17:18:42,Bilbao,expenses,education,-72.73,-1404.5
buyer_7,Agurtzane,Laka,1968-12-31,26592366L,agurtzane.laka@awesomecloud.co,463672,ES23209508102455354994,1990.94,2022-03-06T12:19:15,Bilbao,expenses,electricity,-21.34,-1425.84
buyer_7,Agurtzane,Laka,1968-12-31,26592366L,agurtzane.laka@awesomecloud.co,463672,ES23209508102455354994,1990.94,2022-03-06T18:33:29,Bilbao,expenses,phone,-24.95,-1450.79
buyer_7,Agurtzane,Laka,1968-12-31,26592366L,agurtzane.laka@awesomecloud.co,463672,ES23209508102455354994,1990.94,2022-03-06T19:46:56,Bilbao,expenses,cash,-100.0,-1550.79
buyer_7,Agurtzane,Laka,1968-12-31,26592366L,agurtzane.laka@awesomecloud.co,463672,ES23209508102455354994,1990.94,2022-03-07T20:15:17,Bilbao,expenses,water,-24.59,-1575.38
buyer_7,Agurtzane,Laka,1968-12-31,26592366L,agurtzane.laka@awesomecloud.co,463672,ES23209508102455354994,1990.94,2022-03-07T16:53:00,Bilbao,expenses,gas,-45.53,-1620.91
buyer_7,Agurtzane,Laka,1968-12-31,26592366L,agurtzane.laka@awesomecloud.co,463672,ES23209508102455354994,1990.94,2022-03-07T16:50:39,Bilbao,expenses,internet,-31.76,-1652.67
buyer_7,Agurtzane,Laka,1968-12-31,26592366L,agurtzane.laka@awesomecloud.co,463672,ES23209508102455354994,1990.94,2022-03-07T20:42:16,Bilbao,expenses,phone,-25.4,-1678.07
buyer_7,Agurtzane,Laka,1968-12-31,26592366L,agurtzane.laka@awesomecloud.co,463672,ES23209508102455354994,1990.94,2022-03-08T12:34:54,Bilbao,expenses,phone,-29.33,-1707.4
buyer_7,Agurtzane,Laka,1968-12-31,26592366L,agurtzane.laka@awesomecloud.co,463672,ES23209508102455354994,1990.94,2022-03-08T17:11:16,Bilbao,expenses,appliances,-144.03,-1851.43
buyer_7,Agurtzane,Laka,1968-12-31,26592366L,agurtzane.laka@awesomecloud.co,463672,ES23209508102455354994,1990.94,2022-03-09T23:36:35,Bilbao,expenses,food,-116.0,-1967.43
buyer_7,Agurtzane,Laka,1968-12-31,26592366L,agurtzane.laka@awesomecloud.co,463672,ES23209508102455354994,1990.94,2022-03-09T15:55:26,Bilbao,expenses,gifts,-150.3,-2117.73
buyer_7,Agurtzane,Laka,1968-12-31,26592366L,agurtzane.laka@awesomecloud.co,463672,ES23209508102455354994,1990.94,2022-03-11T18:51:31,Bilbao,expenses,healthcare,-113.5,-2231.23
buyer_7,Agurtzane,Laka,1968-12-31,26592366L,agurtzane.laka@awesomecloud.co,463672,ES23209508102455354994,1990.94,2022-03-11T09:28:02,Bilbao,expenses,cash,-100.0,-2331.23
buyer_7,Agurtzane,Laka,1968-12-31,26592366L,agurtzane.laka@awesomecloud.co,463672,ES23209508102455354994,1990.94,2022-03-14T13:54:55,Bilbao,expenses,transport,-60.95,-2392.18
buyer_7,Agurtzane,Laka,1968-12-31,26592366L,agurtzane.laka@awesomecloud.co,463672,ES23209508102455354994,1990.94,2022-03-14T20:59:55,Bilbao,expenses,appliances,-196.36,-2588.54
buyer_7,Agurtzane,Laka,1968-12-31,26592366L,agurtzane.laka@awesomecloud.co,463672,ES23209508102455354994,1990.94,2022-03-14T18:17:04,Bilbao,expenses,gifts,-30.09,-2618.63
buyer_7,Agurtzane,Laka,1968-12-31,26592366L,agurtzane.laka@awesomecloud.co,463672,ES23209508102455354994,1990.94,2022-03-15T13:42:51,Bilbao,expenses,repairs,-250.37,-2869.0
buyer_7,Agurtzane,Laka,1968-12-31,26592366L,agurtzane.laka@awesomecloud.co,463672,ES23209508102455354994,1990.94,2022-03-17T20:36:41,Bilbao,expenses,cash,-100.0,-2969.0
buyer_7,Agurtzane,Laka,1968-12-31,26592366L,agurtzane.laka@awesomecloud.co,463672,ES23209508102455354994,1990.94,2022-03-19T09:58:13,Bilbao,expenses,cash,-100.0,-3069.0
buyer_7,Agurtzane,Laka,1968-12-31,26592366L,agurtzane.laka@awesomecloud.co,463672,ES23209508102455354994,1990.94,2022-03-20T05:01:41,Bilbao,expenses,cash,-100.0,-3169.0
buyer_7,Agurtzane,Laka,1968-12-31,26592366L,agurtzane.laka@awesomecloud.co,463672,ES23209508102455354994,1990.94,2022-03-21T14:18:50,Bilbao,expenses,food,-60.5,-3229.5
buyer_7,Agurtzane,Laka,1968-12-31,26592366L,agurtzane.laka@awesomecloud.co,463672,ES23209508102455354994,1990.94,2022-03-22T09:29:05,Bilbao,expenses,food,-67.26,-3296.76
buyer_7,Agurtzane,Laka,1968-12-31,26592366L,agurtzane.laka@awesomecloud.co,463672,ES23209508102455354994,1990.94,2022-03-22T18:48:28,Bilbao,expenses,appliances,-200.74,-3497.5
buyer_7,Agurtzane,Laka,1968-12-31,26592366L,agurtzane.laka@awesomecloud.co,463672,ES23209508102455354994,1990.94,2022-03-24T13:22:47,Bilbao,expenses,food,-109.37,-3606.87
buyer_7,Agurtzane,Laka,1968-12-31,26592366L,agurtzane.laka@awesomecloud.co,463672,ES23209508102455354994,1990.94,2022-03-24T13:59:42,Bilbao,expenses,transport,-55.8,-3662.67
buyer_7,Agurtzane,Laka,1968-12-31,26592366L,agurtzane.laka@awesomecloud.co,463672,ES23209508102455354994,1990.94,2022-03-25T14:59:42,Bilbao,expenses,healthcare,-126.87,-3789.54
buyer_7,Agurtzane,Laka,1968-12-31,26592366L,agurtzane.laka@awesomecloud.co,463672,ES23209508102455354994,1990.94,2022-03-26T12:24:15,Bilbao,expenses,cash,-100.0,-3889.54
buyer_7,Agurtzane,Laka,1968-12-31,26592366L,agurtzane.laka@awesomecloud.co,463672,ES23209508102455354994,1990.94,2022-03-28T15:06:03,Bilbao,expenses,clothing,-98.48,-3988.02
buyer_7,Agurtzane,Laka,1968-12-31,26592366L,agurtzane.laka@awesomecloud.co,463672,ES23209508102455354994,1990.94,2022-03-30T17:54:41,Bilbao,expenses,food,-100.57,-4088.59
buyer_7,Agurtzane,Laka,1968-12-31,26592366L,agurtzane.laka@awesomecloud.co,463672,ES23209508102455354994,1990.94,2022-03-30T11:41:17,Bilbao,expenses,transport,-45.94,-4134.53
buyer_7,Agurtzane,Laka,1968-12-31,26592366L,agurtzane.laka@awesomecloud.co,463672,ES23209508102455354994,1990.94,2022-03-30T12:57:54,Bilbao,expenses,cash,-100.0,-4234.53
buyer_7,Agurtzane,Laka,1968-12-31,26592366L,agurtzane.laka@awesomecloud.co,463672,ES23209508102455354994,1990.94,2022-03-30T08:24:39,Bilbao,expenses,gifts,-36.85,-4271.38
buyer_7,Agurtzane,Laka,1968-12-31,26592366L,agurtzane.laka@awesomecloud.co,463672,ES23209508102455354994,1990.94,2022-03-31T10:43:42,Bilbao,expenses,transport,-87.12,-4358.5
buyer_7,Agurtzane,Laka,1968-12-31,26592366L,agurtzane.laka@awesomecloud.co,463672,ES23209508102455354994,1990.94,2022-04-01T19:59:21,Bilbao,incomes,salary,1512.47,-2846.03
buyer_7,Agurtzane,Laka,1968-12-31,26592366L,agurtzane.laka@awesomecloud.co,463672,ES23209508102455354994,1990.94,2022-04-01T19:59:21,Bilbao,incomes,extra_income,185.75,-2660.28
buyer_7,Agurtzane,Laka,1968-12-31,26592366L,agurtzane.laka@awesomecloud.co,463672,ES23209508102455354994,1990.94,2022-04-02T17:26:09,Bilbao,expenses,leisure,-29.18,-2689.46
buyer_7,Agurtzane,Laka,1968-12-31,26592366L,agurtzane.laka@awesomecloud.co,463672,ES23209508102455354994,1990.94,2022-04-03T17:36:35,Bilbao,expenses,healthcare,-122.73,-2812.19
buyer_7,Agurtzane,Laka,1968-12-31,26592366L,agurtzane.laka@awesomecloud.co,463672,ES23209508102455354994,1990.94,2022-04-05T09:54:53,Bilbao,expenses,mortgage,-769.48,-3581.67
buyer_7,Agurtzane,Laka,1968-12-31,26592366L,agurtzane.laka@awesomecloud.co,463672,ES23209508102455354994,1990.94,2022-04-05T14:33:46,Bilbao,expenses,transport,-80.03,-3661.7
buyer_7,Agurtzane,Laka,1968-12-31,26592366L,agurtzane.laka@awesomecloud.co,463672,ES23209508102455354994,1990.94,2022-04-06T17:09:51,Bilbao,expenses,electricity,-32.67,-3694.37
buyer_7,Agurtzane,Laka,1968-12-31,26592366L,agurtzane.laka@awesomecloud.co,463672,ES23209508102455354994,1990.94,2022-04-07T19:21:39,Bilbao,expenses,gas,-65.26,-3759.63
buyer_7,Agurtzane,Laka,1968-12-31,26592366L,agurtzane.laka@awesomecloud.co,463672,ES23209508102455354994,1990.94,2022-04-07T08:13:35,Bilbao,expenses,healthcare,-173.79,-3933.42
buyer_7,Agurtzane,Laka,1968-12-31,26592366L,agurtzane.laka@awesomecloud.co,463672,ES23209508102455354994,1990.94,2022-04-08T22:25:03,Bilbao,expenses,leisure,-63.64,-3997.06
buyer_7,Agurtzane,Laka,1968-12-31,26592366L,agurtzane.laka@awesomecloud.co,463672,ES23209508102455354994,1990.94,2022-04-08T09:12:04,Bilbao,expenses,cash,-100.0,-4097.06
buyer_7,Agurtzane,Laka,1968-12-31,26592366L,agurtzane.laka@awesomecloud.co,463672,ES23209508102455354994,1990.94,2022-04-08T18:42:36,Bilbao,expenses,gifts,-133.87,-4230.93
buyer_7,Agurtzane,Laka,1968-12-31,26592366L,agurtzane.laka@awesomecloud.co,463672,ES23209508102455354994,1990.94,2022-04-10T03:01:59,Bilbao,expenses,food,-105.57,-4336.5
buyer_7,Agurtzane,Laka,1968-12-31,26592366L,agurtzane.laka@awesomecloud.co,463672,ES23209508102455354994,1990.94,2022-04-10T13:33:15,Bilbao,expenses,transport,-45.44,-4381.94
buyer_7,Agurtzane,Laka,1968-12-31,26592366L,agurtzane.laka@awesomecloud.co,463672,ES23209508102455354994,1990.94,2022-04-11T10:09:50,Bilbao,expenses,cash,-100.0,-4481.94
buyer_7,Agurtzane,Laka,1968-12-31,26592366L,agurtzane.laka@awesomecloud.co,463672,ES23209508102455354994,1990.94,2022-04-13T12:41:02,Bilbao,expenses,gifts,-243.84,-4725.78
buyer_7,Agurtzane,Laka,1968-12-31,26592366L,agurtzane.laka@awesomecloud.co,463672,ES23209508102455354994,1990.94,2022-04-14T14:42:35,Bilbao,expenses,food,-120.61,-4846.39
buyer_7,Agurtzane,Laka,1968-12-31,26592366L,agurtzane.laka@awesomecloud.co,463672,ES23209508102455354994,1990.94,2022-04-14T16:32:03,Bilbao,expenses,cash,-100.0,-4946.39
buyer_7,Agurtzane,Laka,1968-12-31,26592366L,agurtzane.laka@awesomecloud.co,463672,ES23209508102455354994,1990.94,2022-04-17T18:36:15,Bilbao,expenses,leisure,-35.67,-4982.06
buyer_7,Agurtzane,Laka,1968-12-31,26592366L,agurtzane.laka@awesomecloud.co,463672,ES23209508102455354994,1990.94,2022-04-18T19:36:28,Bilbao,expenses,food,-121.63,-5103.69
buyer_7,Agurtzane,Laka,1968-12-31,26592366L,agurtzane.laka@awesomecloud.co,463672,ES23209508102455354994,1990.94,2022-04-18T09:05:38,Bilbao,expenses,gifts,-138.9,-5242.59
buyer_7,Agurtzane,Laka,1968-12-31,26592366L,agurtzane.laka@awesomecloud.co,463672,ES23209508102455354994,1990.94,2022-04-19T20:33:47,Bilbao,expenses,healthcare,-104.82,-5347.41
buyer_7,Agurtzane,Laka,1968-12-31,26592366L,agurtzane.laka@awesomecloud.co,463672,ES23209508102455354994,1990.94,2022-04-22T08:04:20,Bilbao,expenses,food,-61.65,-5409.06
buyer_7,Agurtzane,Laka,1968-12-31,26592366L,agurtzane.laka@awesomecloud.co,463672,ES23209508102455354994,1990.94,2022-04-26T09:27:33,Bilbao,expenses,repairs,-164.19,-5573.25
buyer_7,Agurtzane,Laka,1968-12-31,26592366L,agurtzane.laka@awesomecloud.co,463672,ES23209508102455354994,1990.94,2022-04-27T10:52:13,Bilbao,expenses,repairs,-56.09,-5629.34
buyer_7,Agurtzane,Laka,1968-12-31,26592366L,agurtzane.laka@awesomecloud.co,463672,ES23209508102455354994,1990.94,2022-04-28T19:02:09,Bilbao,expenses,healthcare,-140.59,-5769.93
buyer_7,Agurtzane,Laka,1968-12-31,26592366L,agurtzane.laka@awesomecloud.co,463672,ES23209508102455354994,1990.94,2022-04-29T12:25:05,Bilbao,expenses,gifts,-232.96,-6002.89
buyer_7,Agurtzane,Laka,1968-12-31,26592366L,agurtzane.laka@awesomecloud.co,463672,ES23209508102455354994,1990.94,2022-04-30T13:40:34,Bilbao,expenses,transport,-71.6,-6074.49
buyer_7,Agurtzane,Laka,1968-12-31,26592366L,agurtzane.laka@awesomecloud.co,463672,ES23209508102455354994,1990.94,2022-04-30T18:40:10,Bilbao,expenses,leisure,-48.58,-6123.07
buyer_7,Agurtzane,Laka,1968-12-31,26592366L,agurtzane.laka@awesomecloud.co,463672,ES23209508102455354994,1990.94,2022-05-01T20:06:34,Bilbao,incomes,salary,1512.47,-4610.6
buyer_7,Agurtzane,Laka,1968-12-31,26592366L,agurtzane.laka@awesomecloud.co,463672,ES23209508102455354994,1990.94,2022-05-01T12:35:42,Bilbao,expenses,repairs,-297.69,-4908.29
buyer_7,Agurtzane,Laka,1968-12-31,26592366L,agurtzane.laka@awesomecloud.co,463672,ES23209508102455354994,1990.94,2022-05-04T20:03:37,Bilbao,expenses,food,-111.34,-5019.63
buyer_7,Agurtzane,Laka,1968-12-31,26592366L,agurtzane.laka@awesomecloud.co,463672,ES23209508102455354994,1990.94,2022-05-04T15:10:22,Bilbao,expenses,transport,-67.43,-5087.06
buyer_7,Agurtzane,Laka,1968-12-31,26592366L,agurtzane.laka@awesomecloud.co,463672,ES23209508102455354994,1990.94,2022-05-04T20:43:51,Bilbao,expenses,cash,-100.0,-5187.06
buyer_7,Agurtzane,Laka,1968-12-31,26592366L,agurtzane.laka@awesomecloud.co,463672,ES23209508102455354994,1990.94,2022-05-05T14:03:34,Bilbao,expenses,mortgage,-769.48,-5956.54
buyer_7,Agurtzane,Laka,1968-12-31,26592366L,agurtzane.laka@awesomecloud.co,463672,ES23209508102455354994,1990.94,2022-05-05T13:12:25,Bilbao,expenses,water,-27.64,-5984.18
buyer_7,Agurtzane,Laka,1968-12-31,26592366L,agurtzane.laka@awesomecloud.co,463672,ES23209508102455354994,1990.94,2022-05-05T17:11:24,Bilbao,expenses,internet,-31.76,-6015.94
buyer_7,Agurtzane,Laka,1968-12-31,26592366L,agurtzane.laka@awesomecloud.co,463672,ES23209508102455354994,1990.94,2022-05-06T09:28:34,Bilbao,expenses,electricity,-65.24,-6081.18
buyer_7,Agurtzane,Laka,1968-12-31,26592366L,agurtzane.laka@awesomecloud.co,463672,ES23209508102455354994,1990.94,2022-05-06T01:19:12,Bilbao,expenses,gas,-48.61,-6129.79
buyer_7,Agurtzane,Laka,1968-12-31,26592366L,agurtzane.laka@awesomecloud.co,463672,ES23209508102455354994,1990.94,2022-05-09T11:03:57,Bilbao,expenses,gifts,-325.32,-6455.11
buyer_7,Agurtzane,Laka,1968-12-31,26592366L,agurtzane.laka@awesomecloud.co,463672,ES23209508102455354994,1990.94,2022-05-12T19:09:50,Bilbao,expenses,repairs,-241.55,-6696.66
buyer_7,Agurtzane,Laka,1968-12-31,26592366L,agurtzane.laka@awesomecloud.co,463672,ES23209508102455354994,1990.94,2022-05-15T09:24:04,Bilbao,expenses,cash,-100.0,-6796.66
buyer_7,Agurtzane,Laka,1968-12-31,26592366L,agurtzane.laka@awesomecloud.co,463672,ES23209508102455354994,1990.94,2022-05-16T15:18:47,Bilbao,expenses,leisure,-27.28,-6823.94
buyer_7,Agurtzane,Laka,1968-12-31,26592366L,agurtzane.laka@awesomecloud.co,463672,ES23209508102455354994,1990.94,2022-05-18T14:38:01,Bilbao,expenses,gifts,-291.12,-7115.06
buyer_7,Agurtzane,Laka,1968-12-31,26592366L,agurtzane.laka@awesomecloud.co,463672,ES23209508102455354994,1990.94,2022-05-18T20:29:38,Bilbao,expenses,children,-47.173083333333466,-7162.23
buyer_7,Agurtzane,Laka,1968-12-31,26592366L,agurtzane.laka@awesomecloud.co,463672,ES23209508102455354994,1990.94,2022-05-19T18:16:36,Bilbao,expenses,food,-101.88,-7264.11
buyer_7,Agurtzane,Laka,1968-12-31,26592366L,agurtzane.laka@awesomecloud.co,463672,ES23209508102455354994,1990.94,2022-05-19T17:26:04,Bilbao,expenses,transport,-71.71,-7335.82
buyer_7,Agurtzane,Laka,1968-12-31,26592366L,agurtzane.laka@awesomecloud.co,463672,ES23209508102455354994,1990.94,2022-05-21T22:34:04,Bilbao,expenses,leisure,-18.89,-7354.71
buyer_7,Agurtzane,Laka,1968-12-31,26592366L,agurtzane.laka@awesomecloud.co,463672,ES23209508102455354994,1990.94,2022-05-21T10:29:45,Bilbao,expenses,cash,-100.0,-7454.71
buyer_7,Agurtzane,Laka,1968-12-31,26592366L,agurtzane.laka@awesomecloud.co,463672,ES23209508102455354994,1990.94,2022-05-23T08:16:34,Bilbao,expenses,food,-116.04,-7570.75
buyer_7,Agurtzane,Laka,1968-12-31,26592366L,agurtzane.laka@awesomecloud.co,463672,ES23209508102455354994,1990.94,2022-05-24T16:49:26,Bilbao,expenses,cash,-100.0,-7670.75
buyer_7,Agurtzane,Laka,1968-12-31,26592366L,agurtzane.laka@awesomecloud.co,463672,ES23209508102455354994,1990.94,2022-05-24T09:01:11,Bilbao,expenses,car,-87.68,-7758.43
buyer_7,Agurtzane,Laka,1968-12-31,26592366L,agurtzane.laka@awesomecloud.co,463672,ES23209508102455354994,1990.94,2022-05-26T18:06:08,Bilbao,expenses,clothing,-133.8,-7892.23
buyer_7,Agurtzane,Laka,1968-12-31,26592366L,agurtzane.laka@awesomecloud.co,463672,ES23209508102455354994,1990.94,2022-05-27T13:17:53,Bilbao,expenses,food,-87.12,-7979.35
buyer_7,Agurtzane,Laka,1968-12-31,26592366L,agurtzane.laka@awesomecloud.co,463672,ES23209508102455354994,1990.94,2022-05-28T17:03:15,Bilbao,expenses,food,-77.84,-8057.19
buyer_7,Agurtzane,Laka,1968-12-31,26592366L,agurtzane.laka@awesomecloud.co,463672,ES23209508102455354994,1990.94,2022-05-28T13:20:19,Bilbao,expenses,transport,-52.42,-8109.61
buyer_7,Agurtzane,Laka,1968-12-31,26592366L,agurtzane.laka@awesomecloud.co,463672,ES23209508102455354994,1990.94,2022-05-29T19:22:53,Bilbao,expenses,transport,-67.7,-8177.31
buyer_7,Agurtzane,Laka,1968-12-31,26592366L,agurtzane.laka@awesomecloud.co,463672,ES23209508102455354994,1990.94,2022-05-29T16:55:27,Bilbao,expenses,education,-71.63,-8248.94
buyer_7,Agurtzane,Laka,1968-12-31,26592366L,agurtzane.laka@awesomecloud.co,463672,ES23209508102455354994,1990.94,2022-05-30T10:56:34,Bilbao,expenses,food,-83.88,-8332.82
buyer_7,Agurtzane,Laka,1968-12-31,26592366L,agurtzane.laka@awesomecloud.co,463672,ES23209508102455354994,1990.94,2022-05-30T19:36:15,Bilbao,expenses,cash,-100.0,-8432.82
buyer_7,Agurtzane,Laka,1968-12-31,26592366L,agurtzane.laka@awesomecloud.co,463672,ES23209508102455354994,1990.94,2022-06-01T08:22:35,Bilbao,incomes,salary,1512.47,-6920.35
buyer_7,Agurtzane,Laka,1968-12-31,26592366L,agurtzane.laka@awesomecloud.co,463672,ES23209508102455354994,1990.94,2022-06-01T08:22:35,Bilbao,incomes,salary_bonus,1061.41,-5858.94
buyer_7,Agurtzane,Laka,1968-12-31,26592366L,agurtzane.laka@awesomecloud.co,463672,ES23209508102455354994,1990.94,2022-06-02T21:23:48,Bilbao,expenses,taxes,-1247.63,-7106.57
buyer_7,Agurtzane,Laka,1968-12-31,26592366L,agurtzane.laka@awesomecloud.co,463672,ES23209508102455354994,1990.94,2022-06-02T12:03:54,Bilbao,expenses,insurance,-377.03,-7483.6
buyer_7,Agurtzane,Laka,1968-12-31,26592366L,agurtzane.laka@awesomecloud.co,463672,ES23209508102455354994,1990.94,2022-06-04T11:20:46,Bilbao,expenses,education,-78.8,-7562.4
buyer_7,Agurtzane,Laka,1968-12-31,26592366L,agurtzane.laka@awesomecloud.co,463672,ES23209508102455354994,1990.94,2022-06-04T16:52:36,Bilbao,expenses,gifts,-105.5,-7667.9
buyer_7,Agurtzane,Laka,1968-12-31,26592366L,agurtzane.laka@awesomecloud.co,463672,ES23209508102455354994,1990.94,2022-06-05T13:54:48,Bilbao,expenses,mortgage,-769.48,-8437.38
buyer_7,Agurtzane,Laka,1968-12-31,26592366L,agurtzane.laka@awesomecloud.co,463672,ES23209508102455354994,1990.94,2022-06-05T17:59:32,Bilbao,expenses,electricity,-31.07,-8468.45
buyer_7,Agurtzane,Laka,1968-12-31,26592366L,agurtzane.laka@awesomecloud.co,463672,ES23209508102455354994,1990.94,2022-06-05T13:15:30,Bilbao,expenses,healthcare,-153.93,-8622.38
buyer_7,Agurtzane,Laka,1968-12-31,26592366L,agurtzane.laka@awesomecloud.co,463672,ES23209508102455354994,1990.94,2022-06-06T11:05:32,Bilbao,expenses,gas,-52.24,-8674.62
buyer_7,Agurtzane,Laka,1968-12-31,26592366L,agurtzane.laka@awesomecloud.co,463672,ES23209508102455354994,1990.94,2022-06-06T13:30:25,Bilbao,expenses,internet,-31.76,-8706.38
buyer_7,Agurtzane,Laka,1968-12-31,26592366L,agurtzane.laka@awesomecloud.co,463672,ES23209508102455354994,1990.94,2022-06-06T16:15:45,Bilbao,expenses,leisure,-56.76,-8763.14
buyer_7,Agurtzane,Laka,1968-12-31,26592366L,agurtzane.laka@awesomecloud.co,463672,ES23209508102455354994,1990.94,2022-06-07T15:29:54,Bilbao,expenses,internet,-31.76,-8794.9
buyer_7,Agurtzane,Laka,1968-12-31,26592366L,agurtzane.laka@awesomecloud.co,463672,ES23209508102455354994,1990.94,2022-06-07T13:53:25,Bilbao,expenses,phone,-28.21,-8823.11
buyer_7,Agurtzane,Laka,1968-12-31,26592366L,agurtzane.laka@awesomecloud.co,463672,ES23209508102455354994,1990.94,2022-06-07T06:22:53,Bilbao,expenses,travel,-282.6,-9105.71
buyer_7,Agurtzane,Laka,1968-12-31,26592366L,agurtzane.laka@awesomecloud.co,463672,ES23209508102455354994,1990.94,2022-06-07T14:16:08,Bilbao,expenses,children,-55.69308333333345,-9161.4
buyer_7,Agurtzane,Laka,1968-12-31,26592366L,agurtzane.laka@awesomecloud.co,463672,ES23209508102455354994,1990.94,2022-06-08T21:42:46,Bilbao,expenses,water,-19.98,-9181.38
buyer_7,Agurtzane,Laka,1968-12-31,26592366L,agurtzane.laka@awesomecloud.co,463672,ES23209508102455354994,1990.94,2022-06-08T09:27:35,Bilbao,expenses,gas,-63.35,-9244.73
buyer_7,Agurtzane,Laka,1968-12-31,26592366L,agurtzane.laka@awesomecloud.co,463672,ES23209508102455354994,1990.94,2022-06-08T11:30:03,Bilbao,expenses,gifts,-178.03,-9422.76
buyer_7,Agurtzane,Laka,1968-12-31,26592366L,agurtzane.laka@awesomecloud.co,463672,ES23209508102455354994,1990.94,2022-06-12T08:46:59,Bilbao,expenses,repairs,-96.29,-9519.05
buyer_7,Agurtzane,Laka,1968-12-31,26592366L,agurtzane.laka@awesomecloud.co,463672,ES23209508102455354994,1990.94,2022-06-17T16:38:58,Bilbao,expenses,appliances,-92.49,-9611.54
buyer_7,Agurtzane,Laka,1968-12-31,26592366L,agurtzane.laka@awesomecloud.co,463672,ES23209508102455354994,1990.94,2022-06-18T14:48:38,Bilbao,expenses,clothing,-91.63,-9703.17
buyer_7,Agurtzane,Laka,1968-12-31,26592366L,agurtzane.laka@awesomecloud.co,463672,ES23209508102455354994,1990.94,2022-06-18T18:49:54,Bilbao,expenses,cash,-100.0,-9803.17
buyer_7,Agurtzane,Laka,1968-12-31,26592366L,agurtzane.laka@awesomecloud.co,463672,ES23209508102455354994,1990.94,2022-06-18T08:51:44,Bilbao,expenses,gifts,-94.32,-9897.49
buyer_7,Agurtzane,Laka,1968-12-31,26592366L,agurtzane.laka@awesomecloud.co,463672,ES23209508102455354994,1990.94,2022-06-23T10:45:58,Bilbao,expenses,food,-64.08,-9961.57
buyer_7,Agurtzane,Laka,1968-12-31,26592366L,agurtzane.laka@awesomecloud.co,463672,ES23209508102455354994,1990.94,2022-06-23T19:58:42,Bilbao,expenses,leisure,-38.87,-10000.44
buyer_7,Agurtzane,Laka,1968-12-31,26592366L,agurtzane.laka@awesomecloud.co,463672,ES23209508102455354994,1990.94,2022-06-25T12:04:22,Bilbao,expenses,transport,-51.46,-10051.9
buyer_7,Agurtzane,Laka,1968-12-31,26592366L,agurtzane.laka@awesomecloud.co,463672,ES23209508102455354994,1990.94,2022-06-25T12:31:05,Bilbao,expenses,healthcare,-163.21,-10215.11
buyer_7,Agurtzane,Laka,1968-12-31,26592366L,agurtzane.laka@awesomecloud.co,463672,ES23209508102455354994,1990.94,2022-06-25T06:33:01,Bilbao,expenses,gifts,-75.46,-10290.57
buyer_7,Agurtzane,Laka,1968-12-31,26592366L,agurtzane.laka@awesomecloud.co,463672,ES23209508102455354994,1990.94,2022-06-26T09:49:30,Bilbao,expenses,repairs,-223.72,-10514.29
buyer_7,Agurtzane,Laka,1968-12-31,26592366L,agurtzane.laka@awesomecloud.co,463672,ES23209508102455354994,1990.94,2022-06-27T16:50:01,Bilbao,expenses,children,-158.05,-10672.34
buyer_7,Agurtzane,Laka,1968-12-31,26592366L,agurtzane.laka@awesomecloud.co,463672,ES23209508102455354994,1990.94,2022-06-28T23:27:51,Bilbao,expenses,children,-174.1,-10846.44
buyer_7,Agurtzane,Laka,1968-12-31,26592366L,agurtzane.laka@awesomecloud.co,463672,ES23209508102455354994,1990.94,2022-06-29T03:49:42,Bilbao,expenses,healthcare,-188.72,-11035.16
buyer_7,Agurtzane,Laka,1968-12-31,26592366L,agurtzane.laka@awesomecloud.co,463672,ES23209508102455354994,1990.94,2022-06-30T08:20:49,Bilbao,expenses,leisure,-53.79,-11088.95
buyer_7,Agurtzane,Laka,1968-12-31,26592366L,agurtzane.laka@awesomecloud.co,463672,ES23209508102455354994,1990.94,2022-07-01T10:43:54,Bilbao,incomes,salary,1512.47,-9576.48
buyer_7,Agurtzane,Laka,1968-12-31,26592366L,agurtzane.laka@awesomecloud.co,463672,ES23209508102455354994,1990.94,2022-07-01T10:43:54,Bilbao,incomes,extra_income,185.75,-9390.73
buyer_7,Agurtzane,Laka,1968-12-31,26592366L,agurtzane.laka@awesomecloud.co,463672,ES23209508102455354994,1990.94,2022-07-01T19:20:22,Bilbao,expenses,food,-105.77,-9496.5
buyer_7,Agurtzane,Laka,1968-12-31,26592366L,agurtzane.laka@awesomecloud.co,463672,ES23209508102455354994,1990.94,2022-07-02T08:11:55,Bilbao,expenses,food,-122.39,-9618.89
buyer_7,Agurtzane,Laka,1968-12-31,26592366L,agurtzane.laka@awesomecloud.co,463672,ES23209508102455354994,1990.94,2022-07-04T18:27:17,Bilbao,expenses,clothing,-159.86,-9778.75
buyer_7,Agurtzane,Laka,1968-12-31,26592366L,agurtzane.laka@awesomecloud.co,463672,ES23209508102455354994,1990.94,2022-07-05T10:14:11,Bilbao,expenses,mortgage,-769.48,-10548.23
buyer_7,Agurtzane,Laka,1968-12-31,26592366L,agurtzane.laka@awesomecloud.co,463672,ES23209508102455354994,1990.94,2022-07-05T16:42:07,Bilbao,expenses,water,-16.47,-10564.7
buyer_7,Agurtzane,Laka,1968-12-31,26592366L,agurtzane.laka@awesomecloud.co,463672,ES23209508102455354994,1990.94,2022-07-06T10:50:14,Bilbao,expenses,gas,-35.51,-10600.21
buyer_7,Agurtzane,Laka,1968-12-31,26592366L,agurtzane.laka@awesomecloud.co,463672,ES23209508102455354994,1990.94,2022-07-06T14:12:25,Bilbao,expenses,internet,-31.76,-10631.97
buyer_7,Agurtzane,Laka,1968-12-31,26592366L,agurtzane.laka@awesomecloud.co,463672,ES23209508102455354994,1990.94,2022-07-06T07:06:31,Bilbao,expenses,gifts,-31.45,-10663.42
buyer_7,Agurtzane,Laka,1968-12-31,26592366L,agurtzane.laka@awesomecloud.co,463672,ES23209508102455354994,1990.94,2022-07-07T01:32:32,Bilbao,expenses,water,-16.03,-10679.45
buyer_7,Agurtzane,Laka,1968-12-31,26592366L,agurtzane.laka@awesomecloud.co,463672,ES23209508102455354994,1990.94,2022-07-07T17:39:24,Bilbao,expenses,transport,-67.25,-10746.7
buyer_7,Agurtzane,Laka,1968-12-31,26592366L,agurtzane.laka@awesomecloud.co,463672,ES23209508102455354994,1990.94,2022-07-09T14:32:59,Bilbao,expenses,education,-78.12,-10824.82
buyer_7,Agurtzane,Laka,1968-12-31,26592366L,agurtzane.laka@awesomecloud.co,463672,ES23209508102455354994,1990.94,2022-07-09T11:37:16,Bilbao,expenses,cash,-100.0,-10924.82
buyer_7,Agurtzane,Laka,1968-12-31,26592366L,agurtzane.laka@awesomecloud.co,463672,ES23209508102455354994,1990.94,2022-07-11T17:12:06,Bilbao,expenses,food,-76.23,-11001.05
buyer_7,Agurtzane,Laka,1968-12-31,26592366L,agurtzane.laka@awesomecloud.co,463672,ES23209508102455354994,1990.94,2022-07-12T17:11:48,Bilbao,expenses,food,-106.66,-11107.71
buyer_7,Agurtzane,Laka,1968-12-31,26592366L,agurtzane.laka@awesomecloud.co,463672,ES23209508102455354994,1990.94,2022-07-13T13:57:41,Bilbao,expenses,clothing,-138.98,-11246.69
buyer_7,Agurtzane,Laka,1968-12-31,26592366L,agurtzane.laka@awesomecloud.co,463672,ES23209508102455354994,1990.94,2022-07-14T16:02:28,Bilbao,expenses,food,-86.18,-11332.87
buyer_7,Agurtzane,Laka,1968-12-31,26592366L,agurtzane.laka@awesomecloud.co,463672,ES23209508102455354994,1990.94,2022-07-14T20:11:53,Bilbao,expenses,leisure,-35.85,-11368.72
buyer_7,Agurtzane,Laka,1968-12-31,26592366L,agurtzane.laka@awesomecloud.co,463672,ES23209508102455354994,1990.94,2022-07-15T18:23:23,Bilbao,expenses,leisure,-26.43,-11395.15
buyer_7,Agurtzane,Laka,1968-12-31,26592366L,agurtzane.laka@awesomecloud.co,463672,ES23209508102455354994,1990.94,2022-07-17T16:27:26,Bilbao,expenses,repairs,-90.41,-11485.56
buyer_7,Agurtzane,Laka,1968-12-31,26592366L,agurtzane.laka@awesomecloud.co,463672,ES23209508102455354994,1990.94,2022-07-19T02:44:11,Bilbao,expenses,leisure,-28.7,-11514.26
buyer_7,Agurtzane,Laka,1968-12-31,26592366L,agurtzane.laka@awesomecloud.co,463672,ES23209508102455354994,1990.94,2022-07-21T18:08:30,Bilbao,expenses,education,-61.3,-11575.56
buyer_7,Agurtzane,Laka,1968-12-31,26592366L,agurtzane.laka@awesomecloud.co,463672,ES23209508102455354994,1990.94,2022-07-22T03:43:44,Bilbao,expenses,food,-85.87,-11661.43
buyer_7,Agurtzane,Laka,1968-12-31,26592366L,agurtzane.laka@awesomecloud.co,463672,ES23209508102455354994,1990.94,2022-07-22T11:19:49,Bilbao,expenses,cash,-100.0,-11761.43
buyer_7,Agurtzane,Laka,1968-12-31,26592366L,agurtzane.laka@awesomecloud.co,463672,ES23209508102455354994,1990.94,2022-07-23T21:17:17,Bilbao,expenses,food,-100.24,-11861.67
buyer_7,Agurtzane,Laka,1968-12-31,26592366L,agurtzane.laka@awesomecloud.co,463672,ES23209508102455354994,1990.94,2022-07-23T20:47:55,Bilbao,expenses,cash,-100.0,-11961.67
buyer_7,Agurtzane,Laka,1968-12-31,26592366L,agurtzane.laka@awesomecloud.co,463672,ES23209508102455354994,1990.94,2022-07-24T11:11:03,Bilbao,expenses,transport,-87.72,-12049.39
buyer_7,Agurtzane,Laka,1968-12-31,26592366L,agurtzane.laka@awesomecloud.co,463672,ES23209508102455354994,1990.94,2022-07-24T15:47:42,Bilbao,expenses,leisure,-74.58,-12123.97
buyer_7,Agurtzane,Laka,1968-12-31,26592366L,agurtzane.laka@awesomecloud.co,463672,ES23209508102455354994,1990.94,2022-07-24T17:01:02,Bilbao,expenses,cash,-100.0,-12223.97
buyer_7,Agurtzane,Laka,1968-12-31,26592366L,agurtzane.laka@awesomecloud.co,463672,ES23209508102455354994,1990.94,2022-07-25T21:01:32,Bilbao,expenses,transport,-62.12,-12286.09
buyer_7,Agurtzane,Laka,1968-12-31,26592366L,agurtzane.laka@awesomecloud.co,463672,ES23209508102455354994,1990.94,2022-07-28T19:00:20,Bilbao,expenses,transport,-61.87,-12347.96
buyer_7,Agurtzane,Laka,1968-12-31,26592366L,agurtzane.laka@awesomecloud.co,463672,ES23209508102455354994,1990.94,2022-07-28T17:59:05,Bilbao,expenses,leisure,-75.18,-12423.14
buyer_7,Agurtzane,Laka,1968-12-31,26592366L,agurtzane.laka@awesomecloud.co,463672,ES23209508102455354994,1990.94,2022-07-29T09:53:19,Bilbao,expenses,repairs,-138.92,-12562.06
buyer_7,Agurtzane,Laka,1968-12-31,26592366L,agurtzane.laka@awesomecloud.co,463672,ES23209508102455354994,1990.94,2022-08-01T16:24:21,Bilbao,incomes,salary,1512.47,-11049.59
buyer_7,Agurtzane,Laka,1968-12-31,26592366L,agurtzane.laka@awesomecloud.co,463672,ES23209508102455354994,1990.94,2022-08-01T09:56:38,Bilbao,expenses,food,-91.6,-11141.19
buyer_7,Agurtzane,Laka,1968-12-31,26592366L,agurtzane.laka@awesomecloud.co,463672,ES23209508102455354994,1990.94,2022-08-01T13:26:05,Bilbao,expenses,transport,-74.71,-11215.9
buyer_7,Agurtzane,Laka,1968-12-31,26592366L,agurtzane.laka@awesomecloud.co,463672,ES23209508102455354994,1990.94,2022-08-01T08:39:29,Bilbao,expenses,children,-171.98308333333347,-11387.88
buyer_7,Agurtzane,Laka,1968-12-31,26592366L,agurtzane.laka@awesomecloud.co,463672,ES23209508102455354994,1990.94,2022-08-03T19:25:52,Bilbao,expenses,cash,-100.0,-11487.88
buyer_7,Agurtzane,Laka,1968-12-31,26592366L,agurtzane.laka@awesomecloud.co,463672,ES23209508102455354994,1990.94,2022-08-04T14:00:09,Bilbao,expenses,leisure,-81.31,-11569.19
buyer_7,Agurtzane,Laka,1968-12-31,26592366L,agurtzane.laka@awesomecloud.co,463672,ES23209508102455354994,1990.94,2022-08-04T20:20:52,Bilbao,expenses,repairs,-34.42,-11603.61
buyer_7,Agurtzane,Laka,1968-12-31,26592366L,agurtzane.laka@awesomecloud.co,463672,ES23209508102455354994,1990.94,2022-08-05T21:07:57,Bilbao,expenses,mortgage,-769.48,-12373.09
buyer_7,Agurtzane,Laka,1968-12-31,26592366L,agurtzane.laka@awesomecloud.co,463672,ES23209508102455354994,1990.94,2022-08-05T10:09:41,Bilbao,expenses,electricity,-50.55,-12423.64
buyer_7,Agurtzane,Laka,1968-12-31,26592366L,agurtzane.laka@awesomecloud.co,463672,ES23209508102455354994,1990.94,2022-08-05T13:46:21,Bilbao,expenses,internet,-31.76,-12455.4
buyer_7,Agurtzane,Laka,1968-12-31,26592366L,agurtzane.laka@awesomecloud.co,463672,ES23209508102455354994,1990.94,2022-08-05T09:11:47,Bilbao,expenses,phone,-27.43,-12482.83
buyer_7,Agurtzane,Laka,1968-12-31,26592366L,agurtzane.laka@awesomecloud.co,463672,ES23209508102455354994,1990.94,2022-08-05T20:14:04,Bilbao,expenses,gifts,-205.94,-12688.77
buyer_7,Agurtzane,Laka,1968-12-31,26592366L,agurtzane.laka@awesomecloud.co,463672,ES23209508102455354994,1990.94,2022-08-06T09:30:28,Bilbao,expenses,food,-107.07,-12795.84
buyer_7,Agurtzane,Laka,1968-12-31,26592366L,agurtzane.laka@awesomecloud.co,463672,ES23209508102455354994,1990.94,2022-08-06T08:45:07,Bilbao,expenses,healthcare,-99.92,-12895.76
buyer_7,Agurtzane,Laka,1968-12-31,26592366L,agurtzane.laka@awesomecloud.co,463672,ES23209508102455354994,1990.94,2022-08-06T11:18:35,Bilbao,expenses,appliances,-78.8,-12974.56
buyer_7,Agurtzane,Laka,1968-12-31,26592366L,agurtzane.laka@awesomecloud.co,463672,ES23209508102455354994,1990.94,2022-08-07T12:47:26,Bilbao,expenses,water,-20.56,-12995.12
buyer_7,Agurtzane,Laka,1968-12-31,26592366L,agurtzane.laka@awesomecloud.co,463672,ES23209508102455354994,1990.94,2022-08-07T12:36:17,Bilbao,expenses,electricity,-66.76,-13061.88
buyer_7,Agurtzane,Laka,1968-12-31,26592366L,agurtzane.laka@awesomecloud.co,463672,ES23209508102455354994,1990.94,2022-08-07T06:11:32,Bilbao,expenses,cash,-100.0,-13161.88
buyer_7,Agurtzane,Laka,1968-12-31,26592366L,agurtzane.laka@awesomecloud.co,463672,ES23209508102455354994,1990.94,2022-08-08T14:54:25,Bilbao,expenses,gas,-75.59,-13237.47
buyer_7,Agurtzane,Laka,1968-12-31,26592366L,agurtzane.laka@awesomecloud.co,463672,ES23209508102455354994,1990.94,2022-08-08T04:27:14,Bilbao,expenses,gifts,-177.67,-13415.14
buyer_7,Agurtzane,Laka,1968-12-31,26592366L,agurtzane.laka@awesomecloud.co,463672,ES23209508102455354994,1990.94,2022-08-09T18:58:37,Bilbao,expenses,transport,-48.56,-13463.7
buyer_7,Agurtzane,Laka,1968-12-31,26592366L,agurtzane.laka@awesomecloud.co,463672,ES23209508102455354994,1990.94,2022-08-10T09:49:34,Bilbao,expenses,leisure,-37.6,-13501.3
buyer_7,Agurtzane,Laka,1968-12-31,26592366L,agurtzane.laka@awesomecloud.co,463672,ES23209508102455354994,1990.94,2022-08-10T14:15:37,Bilbao,expenses,cash,-100.0,-13601.3
buyer_7,Agurtzane,Laka,1968-12-31,26592366L,agurtzane.laka@awesomecloud.co,463672,ES23209508102455354994,1990.94,2022-08-11T08:14:40,Bilbao,expenses,leisure,-32.56,-13633.86
buyer_7,Agurtzane,Laka,1968-12-31,26592366L,agurtzane.laka@awesomecloud.co,463672,ES23209508102455354994,1990.94,2022-08-11T16:56:22,Bilbao,expenses,cash,-100.0,-13733.86
buyer_7,Agurtzane,Laka,1968-12-31,26592366L,agurtzane.laka@awesomecloud.co,463672,ES23209508102455354994,1990.94,2022-08-12T08:46:05,Bilbao,expenses,food,-109.45,-13843.31
buyer_7,Agurtzane,Laka,1968-12-31,26592366L,agurtzane.laka@awesomecloud.co,463672,ES23209508102455354994,1990.94,2022-08-13T18:31:25,Bilbao,expenses,cash,-100.0,-13943.31
buyer_7,Agurtzane,Laka,1968-12-31,26592366L,agurtzane.laka@awesomecloud.co,463672,ES23209508102455354994,1990.94,2022-08-14T17:05:38,Bilbao,expenses,leisure,-28.64,-13971.95
buyer_7,Agurtzane,Laka,1968-12-31,26592366L,agurtzane.laka@awesomecloud.co,463672,ES23209508102455354994,1990.94,2022-08-14T16:42:43,Bilbao,expenses,cash,-100.0,-14071.95
buyer_7,Agurtzane,Laka,1968-12-31,26592366L,agurtzane.laka@awesomecloud.co,463672,ES23209508102455354994,1990.94,2022-08-15T14:08:01,Bilbao,expenses,gifts,-104.39,-14176.34
buyer_7,Agurtzane,Laka,1968-12-31,26592366L,agurtzane.laka@awesomecloud.co,463672,ES23209508102455354994,1990.94,2022-08-15T20:54:17,Bilbao,expenses,children,-88.53,-14264.87
buyer_7,Agurtzane,Laka,1968-12-31,26592366L,agurtzane.laka@awesomecloud.co,463672,ES23209508102455354994,1990.94,2022-08-16T08:50:47,Bilbao,expenses,leisure,-32.22,-14297.09
buyer_7,Agurtzane,Laka,1968-12-31,26592366L,agurtzane.laka@awesomecloud.co,463672,ES23209508102455354994,1990.94,2022-08-17T12:00:14,Bilbao,expenses,transport,-54.26,-14351.35
buyer_7,Agurtzane,Laka,1968-12-31,26592366L,agurtzane.laka@awesomecloud.co,463672,ES23209508102455354994,1990.94,2022-08-17T19:53:26,Bilbao,expenses,cash,-100.0,-14451.35
buyer_7,Agurtzane,Laka,1968-12-31,26592366L,agurtzane.laka@awesomecloud.co,463672,ES23209508102455354994,1990.94,2022-08-19T10:36:44,Bilbao,expenses,repairs,-280.87,-14732.22
buyer_7,Agurtzane,Laka,1968-12-31,26592366L,agurtzane.laka@awesomecloud.co,463672,ES23209508102455354994,1990.94,2022-08-23T09:44:03,Bilbao,expenses,cash,-100.0,-14832.22
buyer_7,Agurtzane,Laka,1968-12-31,26592366L,agurtzane.laka@awesomecloud.co,463672,ES23209508102455354994,1990.94,2022-08-23T20:30:50,Bilbao,expenses,repairs,-165.63,-14997.85
buyer_7,Agurtzane,Laka,1968-12-31,26592366L,agurtzane.laka@awesomecloud.co,463672,ES23209508102455354994,1990.94,2022-08-24T10:44:18,Bilbao,expenses,transport,-74.11,-15071.96
buyer_7,Agurtzane,Laka,1968-12-31,26592366L,agurtzane.laka@awesomecloud.co,463672,ES23209508102455354994,1990.94,2022-08-25T18:40:20,Bilbao,expenses,leisure,-69.1,-15141.06
buyer_7,Agurtzane,Laka,1968-12-31,26592366L,agurtzane.laka@awesomecloud.co,463672,ES23209508102455354994,1990.94,2022-08-25T19:45:29,Bilbao,expenses,cash,-100.0,-15241.06
buyer_7,Agurtzane,Laka,1968-12-31,26592366L,agurtzane.laka@awesomecloud.co,463672,ES23209508102455354994,1990.94,2022-08-25T19:05:43,Bilbao,expenses,gifts,-46.63,-15287.69
buyer_7,Agurtzane,Laka,1968-12-31,26592366L,agurtzane.laka@awesomecloud.co,463672,ES23209508102455354994,1990.94,2022-08-26T08:04:53,Bilbao,expenses,transport,-85.57,-15373.26
buyer_7,Agurtzane,Laka,1968-12-31,26592366L,agurtzane.laka@awesomecloud.co,463672,ES23209508102455354994,1990.94,2022-08-27T20:54:25,Bilbao,expenses,cash,-100.0,-15473.26
buyer_7,Agurtzane,Laka,1968-12-31,26592366L,agurtzane.laka@awesomecloud.co,463672,ES23209508102455354994,1990.94,2022-08-29T04:45:41,Bilbao,expenses,cash,-100.0,-15573.26
buyer_7,Agurtzane,Laka,1968-12-31,26592366L,agurtzane.laka@awesomecloud.co,463672,ES23209508102455354994,1990.94,2022-08-31T09:17:15,Bilbao,expenses,gifts,-67.82,-15641.08
buyer_7,Agurtzane,Laka,1968-12-31,26592366L,agurtzane.laka@awesomecloud.co,463672,ES23209508102455354994,1990.94,2022-09-01T13:39:55,Bilbao,incomes,salary,1512.47,-14128.61
buyer_7,Agurtzane,Laka,1968-12-31,26592366L,agurtzane.laka@awesomecloud.co,463672,ES23209508102455354994,1990.94,2022-09-01T16:55:17,Bilbao,expenses,food,-90.42,-14219.03
buyer_7,Agurtzane,Laka,1968-12-31,26592366L,agurtzane.laka@awesomecloud.co,463672,ES23209508102455354994,1990.94,2022-09-01T09:35:33,Bilbao,expenses,leisure,-24.35,-14243.38
buyer_7,Agurtzane,Laka,1968-12-31,26592366L,agurtzane.laka@awesomecloud.co,463672,ES23209508102455354994,1990.94,2022-09-02T10:45:28,Bilbao,expenses,transport,-50.79,-14294.17
buyer_7,Agurtzane,Laka,1968-12-31,26592366L,agurtzane.laka@awesomecloud.co,463672,ES23209508102455354994,1990.94,2022-09-03T19:15:05,Bilbao,expenses,leisure,-35.16,-14329.33
buyer_7,Agurtzane,Laka,1968-12-31,26592366L,agurtzane.laka@awesomecloud.co,463672,ES23209508102455354994,1990.94,2022-09-03T06:40:27,Bilbao,expenses,cash,-100.0,-14429.33
buyer_7,Agurtzane,Laka,1968-12-31,26592366L,agurtzane.laka@awesomecloud.co,463672,ES23209508102455354994,1990.94,2022-09-04T10:36:15,Bilbao,expenses,leisure,-53.65,-14482.98
buyer_7,Agurtzane,Laka,1968-12-31,26592366L,agurtzane.laka@awesomecloud.co,463672,ES23209508102455354994,1990.94,2022-09-05T11:21:59,Bilbao,expenses,mortgage,-769.48,-15252.46
buyer_7,Agurtzane,Laka,1968-12-31,26592366L,agurtzane.laka@awesomecloud.co,463672,ES23209508102455354994,1990.94,2022-09-05T17:46:47,Bilbao,expenses,internet,-31.76,-15284.22
buyer_7,Agurtzane,Laka,1968-12-31,26592366L,agurtzane.laka@awesomecloud.co,463672,ES23209508102455354994,1990.94,2022-09-06T15:32:46,Bilbao,expenses,children,-159.3,-15443.52
buyer_7,Agurtzane,Laka,1968-12-31,26592366L,agurtzane.laka@awesomecloud.co,463672,ES23209508102455354994,1990.94,2022-09-07T15:12:18,Bilbao,expenses,food,-85.05,-15528.57
buyer_7,Agurtzane,Laka,1968-12-31,26592366L,agurtzane.laka@awesomecloud.co,463672,ES23209508102455354994,1990.94,2022-09-08T11:04:54,Bilbao,expenses,electricity,-44.64,-15573.21
buyer_7,Agurtzane,Laka,1968-12-31,26592366L,agurtzane.laka@awesomecloud.co,463672,ES23209508102455354994,1990.94,2022-09-08T06:14:46,Bilbao,expenses,cash,-100.0,-15673.21
buyer_7,Agurtzane,Laka,1968-12-31,26592366L,agurtzane.laka@awesomecloud.co,463672,ES23209508102455354994,1990.94,2022-09-09T20:06:15,Bilbao,expenses,cash,-100.0,-15773.21
buyer_7,Agurtzane,Laka,1968-12-31,26592366L,agurtzane.laka@awesomecloud.co,463672,ES23209508102455354994,1990.94,2022-09-09T07:14:19,Bilbao,expenses,gifts,-64.51,-15837.72
buyer_7,Agurtzane,Laka,1968-12-31,26592366L,agurtzane.laka@awesomecloud.co,463672,ES23209508102455354994,1990.94,2022-09-10T15:26:16,Bilbao,expenses,food,-88.04,-15925.76
buyer_7,Agurtzane,Laka,1968-12-31,26592366L,agurtzane.laka@awesomecloud.co,463672,ES23209508102455354994,1990.94,2022-09-12T19:36:11,Bilbao,expenses,cash,-100.0,-16025.76
buyer_7,Agurtzane,Laka,1968-12-31,26592366L,agurtzane.laka@awesomecloud.co,463672,ES23209508102455354994,1990.94,2022-09-16T18:36:26,Bilbao,expenses,leisure,-41.86,-16067.62
buyer_7,Agurtzane,Laka,1968-12-31,26592366L,agurtzane.laka@awesomecloud.co,463672,ES23209508102455354994,1990.94,2022-09-16T18:54:59,Bilbao,expenses,gifts,-65.62,-16133.24
buyer_7,Agurtzane,Laka,1968-12-31,26592366L,agurtzane.laka@awesomecloud.co,463672,ES23209508102455354994,1990.94,2022-09-17T05:06:14,Bilbao,expenses,leisure,-71.8,-16205.04
buyer_7,Agurtzane,Laka,1968-12-31,26592366L,agurtzane.laka@awesomecloud.co,463672,ES23209508102455354994,1990.94,2022-09-17T18:11:06,Bilbao,expenses,cash,-100.0,-16305.04
buyer_7,Agurtzane,Laka,1968-12-31,26592366L,agurtzane.laka@awesomecloud.co,463672,ES23209508102455354994,1990.94,2022-09-19T19:20:36,Bilbao,expenses,cash,-100.0,-16405.04
buyer_7,Agurtzane,Laka,1968-12-31,26592366L,agurtzane.laka@awesomecloud.co,463672,ES23209508102455354994,1990.94,2022-09-20T11:36:45,Bilbao,expenses,healthcare,-156.57,-16561.61
buyer_7,Agurtzane,Laka,1968-12-31,26592366L,agurtzane.laka@awesomecloud.co,463672,ES23209508102455354994,1990.94,2022-09-21T12:09:24,Bilbao,expenses,children,-149.55,-16711.16
buyer_7,Agurtzane,Laka,1968-12-31,26592366L,agurtzane.laka@awesomecloud.co,463672,ES23209508102455354994,1990.94,2022-09-23T16:12:15,Bilbao,expenses,cash,-100.0,-16811.16
buyer_7,Agurtzane,Laka,1968-12-31,26592366L,agurtzane.laka@awesomecloud.co,463672,ES23209508102455354994,1990.94,2022-09-25T13:16:26,Bilbao,expenses,food,-73.66,-16884.82
buyer_7,Agurtzane,Laka,1968-12-31,26592366L,agurtzane.laka@awesomecloud.co,463672,ES23209508102455354994,1990.94,2022-09-27T11:53:27,Bilbao,expenses,cash,-100.0,-16984.82
buyer_7,Agurtzane,Laka,1968-12-31,26592366L,agurtzane.laka@awesomecloud.co,463672,ES23209508102455354994,1990.94,2022-09-27T15:52:23,Bilbao,expenses,repairs,-137.11,-17121.93
buyer_7,Agurtzane,Laka,1968-12-31,26592366L,agurtzane.laka@awesomecloud.co,463672,ES23209508102455354994,1990.94,2022-09-29T10:47:28,Bilbao,expenses,healthcare,-66.73,-17188.66
buyer_7,Agurtzane,Laka,1968-12-31,26592366L,agurtzane.laka@awesomecloud.co,463672,ES23209508102455354994,1990.94,2022-10-01T09:47:14,Bilbao,incomes,salary,1512.47,-15676.19
buyer_7,Agurtzane,Laka,1968-12-31,26592366L,agurtzane.laka@awesomecloud.co,463672,ES23209508102455354994,1990.94,2022-10-01T09:47:14,Bilbao,incomes,extra_income,185.75,-15490.44
buyer_7,Agurtzane,Laka,1968-12-31,26592366L,agurtzane.laka@awesomecloud.co,463672,ES23209508102455354994,1990.94,2022-10-04T16:56:03,Bilbao,expenses,repairs,-67.12,-15557.56
buyer_7,Agurtzane,Laka,1968-12-31,26592366L,agurtzane.laka@awesomecloud.co,463672,ES23209508102455354994,1990.94,2022-10-04T19:52:31,Bilbao,expenses,gifts,-74.21,-15631.77
buyer_7,Agurtzane,Laka,1968-12-31,26592366L,agurtzane.laka@awesomecloud.co,463672,ES23209508102455354994,1990.94,2022-10-05T14:38:58,Bilbao,expenses,mortgage,-769.48,-16401.25
buyer_7,Agurtzane,Laka,1968-12-31,26592366L,agurtzane.laka@awesomecloud.co,463672,ES23209508102455354994,1990.94,2022-10-05T09:39:21,Bilbao,expenses,water,-22.51,-16423.76
buyer_7,Agurtzane,Laka,1968-12-31,26592366L,agurtzane.laka@awesomecloud.co,463672,ES23209508102455354994,1990.94,2022-10-05T00:13:38,Bilbao,expenses,electricity,-21.41,-16445.17
buyer_7,Agurtzane,Laka,1968-12-31,26592366L,agurtzane.laka@awesomecloud.co,463672,ES23209508102455354994,1990.94,2022-10-05T10:23:09,Bilbao,expenses,internet,-31.76,-16476.93
buyer_7,Agurtzane,Laka,1968-12-31,26592366L,agurtzane.laka@awesomecloud.co,463672,ES23209508102455354994,1990.94,2022-10-06T12:33:07,Bilbao,expenses,electricity,-63.35,-16540.28
buyer_7,Agurtzane,Laka,1968-12-31,26592366L,agurtzane.laka@awesomecloud.co,463672,ES23209508102455354994,1990.94,2022-10-06T11:06:35,Bilbao,expenses,gas,-83.19,-16623.47
buyer_7,Agurtzane,Laka,1968-12-31,26592366L,agurtzane.laka@awesomecloud.co,463672,ES23209508102455354994,1990.94,2022-10-06T11:11:15,Bilbao,expenses,transport,-63.73,-16687.2
buyer_7,Agurtzane,Laka,1968-12-31,26592366L,agurtzane.laka@awesomecloud.co,463672,ES23209508102455354994,1990.94,2022-10-07T11:23:40,Bilbao,expenses,water,-25.62,-16712.82
buyer_7,Agurtzane,Laka,1968-12-31,26592366L,agurtzane.laka@awesomecloud.co,463672,ES23209508102455354994,1990.94,2022-10-08T19:20:54,Bilbao,expenses,electricity,-35.12,-16747.94
buyer_7,Agurtzane,Laka,1968-12-31,26592366L,agurtzane.laka@awesomecloud.co,463672,ES23209508102455354994,1990.94,2022-10-08T08:49:14,Bilbao,expenses,gas,-78.67,-16826.61
buyer_7,Agurtzane,Laka,1968-12-31,26592366L,agurtzane.laka@awesomecloud.co,463672,ES23209508102455354994,1990.94,2022-10-08T11:45:25,Bilbao,expenses,internet,-31.76,-16858.37
buyer_7,Agurtzane,Laka,1968-12-31,26592366L,agurtzane.laka@awesomecloud.co,463672,ES23209508102455354994,1990.94,2022-10-10T14:04:39,Bilbao,expenses,healthcare,-181.84,-17040.21
buyer_7,Agurtzane,Laka,1968-12-31,26592366L,agurtzane.laka@awesomecloud.co,463672,ES23209508102455354994,1990.94,2022-10-12T13:33:31,Bilbao,expenses,appliances,-308.72,-17348.93
buyer_7,Agurtzane,Laka,1968-12-31,26592366L,agurtzane.laka@awesomecloud.co,463672,ES23209508102455354994,1990.94,2022-10-13T15:51:25,Bilbao,expenses,gifts,-311.42,-17660.35
buyer_7,Agurtzane,Laka,1968-12-31,26592366L,agurtzane.laka@awesomecloud.co,463672,ES23209508102455354994,1990.94,2022-10-15T15:34:55,Bilbao,expenses,transport,-54.77,-17715.12
buyer_7,Agurtzane,Laka,1968-12-31,26592366L,agurtzane.laka@awesomecloud.co,463672,ES23209508102455354994,1990.94,2022-10-15T06:29:24,Bilbao,expenses,education,-51.34,-17766.46
buyer_7,Agurtzane,Laka,1968-12-31,26592366L,agurtzane.laka@awesomecloud.co,463672,ES23209508102455354994,1990.94,2022-10-17T04:58:27,Bilbao,expenses,leisure,-39.17,-17805.63
buyer_7,Agurtzane,Laka,1968-12-31,26592366L,agurtzane.laka@awesomecloud.co,463672,ES23209508102455354994,1990.94,2022-10-18T11:11:41,Bilbao,expenses,food,-112.64,-17918.27
buyer_7,Agurtzane,Laka,1968-12-31,26592366L,agurtzane.laka@awesomecloud.co,463672,ES23209508102455354994,1990.94,2022-10-19T12:28:04,Bilbao,expenses,transport,-76.81,-17995.08
buyer_7,Agurtzane,Laka,1968-12-31,26592366L,agurtzane.laka@awesomecloud.co,463672,ES23209508102455354994,1990.94,2022-10-19T14:22:21,Bilbao,expenses,gifts,-86.35,-18081.43
buyer_7,Agurtzane,Laka,1968-12-31,26592366L,agurtzane.laka@awesomecloud.co,463672,ES23209508102455354994,1990.94,2022-10-23T12:52:44,Bilbao,expenses,leisure,-40.52,-18121.95
buyer_7,Agurtzane,Laka,1968-12-31,26592366L,agurtzane.laka@awesomecloud.co,463672,ES23209508102455354994,1990.94,2022-10-23T10:53:23,Bilbao,expenses,cash,-100.0,-18221.95
buyer_7,Agurtzane,Laka,1968-12-31,26592366L,agurtzane.laka@awesomecloud.co,463672,ES23209508102455354994,1990.94,2022-10-25T07:29:46,Bilbao,expenses,food,-118.54,-18340.49
buyer_7,Agurtzane,Laka,1968-12-31,26592366L,agurtzane.laka@awesomecloud.co,463672,ES23209508102455354994,1990.94,2022-10-27T05:38:07,Bilbao,expenses,cash,-100.0,-18440.49
buyer_7,Agurtzane,Laka,1968-12-31,26592366L,agurtzane.laka@awesomecloud.co,463672,ES23209508102455354994,1990.94,2022-10-28T19:55:52,Bilbao,expenses,clothing,-52.73,-18493.22
buyer_7,Agurtzane,Laka,1968-12-31,26592366L,agurtzane.laka@awesomecloud.co,463672,ES23209508102455354994,1990.94,2022-10-28T19:36:25,Bilbao,expenses,cash,-100.0,-18593.22
buyer_7,Agurtzane,Laka,1968-12-31,26592366L,agurtzane.laka@awesomecloud.co,463672,ES23209508102455354994,1990.94,2022-10-29T17:22:03,Bilbao,expenses,appliances,-124.89,-18718.11
buyer_7,Agurtzane,Laka,1968-12-31,26592366L,agurtzane.laka@awesomecloud.co,463672,ES23209508102455354994,1990.94,2022-11-01T18:05:31,Bilbao,incomes,salary,1512.47,-17205.64
buyer_7,Agurtzane,Laka,1968-12-31,26592366L,agurtzane.laka@awesomecloud.co,463672,ES23209508102455354994,1990.94,2022-11-01T11:22:52,Bilbao,expenses,gifts,-40.21,-17245.85
buyer_7,Agurtzane,Laka,1968-12-31,26592366L,agurtzane.laka@awesomecloud.co,463672,ES23209508102455354994,1990.94,2022-11-02T13:58:58,Bilbao,expenses,transport,-83.23,-17329.08
buyer_7,Agurtzane,Laka,1968-12-31,26592366L,agurtzane.laka@awesomecloud.co,463672,ES23209508102455354994,1990.94,2022-11-02T18:50:19,Bilbao,expenses,cash,-100.0,-17429.08
buyer_7,Agurtzane,Laka,1968-12-31,26592366L,agurtzane.laka@awesomecloud.co,463672,ES23209508102455354994,1990.94,2022-11-03T14:46:31,Bilbao,expenses,cash,-100.0,-17529.08
buyer_7,Agurtzane,Laka,1968-12-31,26592366L,agurtzane.laka@awesomecloud.co,463672,ES23209508102455354994,1990.94,2022-11-04T15:05:58,Bilbao,expenses,food,-94.82,-17623.9
buyer_7,Agurtzane,Laka,1968-12-31,26592366L,agurtzane.laka@awesomecloud.co,463672,ES23209508102455354994,1990.94,2022-11-04T18:09:09,Bilbao,expenses,gifts,-58.45,-17682.35
buyer_7,Agurtzane,Laka,1968-12-31,26592366L,agurtzane.laka@awesomecloud.co,463672,ES23209508102455354994,1990.94,2022-11-05T08:22:14,Bilbao,expenses,mortgage,-769.48,-18451.83
buyer_7,Agurtzane,Laka,1968-12-31,26592366L,agurtzane.laka@awesomecloud.co,463672,ES23209508102455354994,1990.94,2022-11-05T17:22:05,Bilbao,expenses,water,-23.92,-18475.75
buyer_7,Agurtzane,Laka,1968-12-31,26592366L,agurtzane.laka@awesomecloud.co,463672,ES23209508102455354994,1990.94,2022-11-05T00:14:21,Bilbao,expenses,gas,-86.06,-18561.81
buyer_7,Agurtzane,Laka,1968-12-31,26592366L,agurtzane.laka@awesomecloud.co,463672,ES23209508102455354994,1990.94,2022-11-05T10:48:36,Bilbao,expenses,internet,-31.76,-18593.57
buyer_7,Agurtzane,Laka,1968-12-31,26592366L,agurtzane.laka@awesomecloud.co,463672,ES23209508102455354994,1990.94,2022-11-05T11:29:18,Bilbao,expenses,repairs,-142.99,-18736.56
buyer_7,Agurtzane,Laka,1968-12-31,26592366L,agurtzane.laka@awesomecloud.co,463672,ES23209508102455354994,1990.94,2022-11-06T09:09:34,Bilbao,expenses,leisure,-58.71,-18795.27
buyer_7,Agurtzane,Laka,1968-12-31,26592366L,agurtzane.laka@awesomecloud.co,463672,ES23209508102455354994,1990.94,2022-11-06T08:18:09,Bilbao,expenses,cash,-100.0,-18895.27
buyer_7,Agurtzane,Laka,1968-12-31,26592366L,agurtzane.laka@awesomecloud.co,463672,ES23209508102455354994,1990.94,2022-11-06T07:56:16,Bilbao,expenses,gifts,-103.58,-18998.85
buyer_7,Agurtzane,Laka,1968-12-31,26592366L,agurtzane.laka@awesomecloud.co,463672,ES23209508102455354994,1990.94,2022-11-07T01:58:10,Bilbao,expenses,transport,-65.66,-19064.51
buyer_7,Agurtzane,Laka,1968-12-31,26592366L,agurtzane.laka@awesomecloud.co,463672,ES23209508102455354994,1990.94,2022-11-08T03:00:22,Bilbao,expenses,gas,-77.59,-19142.1
buyer_7,Agurtzane,Laka,1968-12-31,26592366L,agurtzane.laka@awesomecloud.co,463672,ES23209508102455354994,1990.94,2022-11-08T17:30:20,Bilbao,expenses,clothing,-102.61,-19244.71
buyer_7,Agurtzane,Laka,1968-12-31,26592366L,agurtzane.laka@awesomecloud.co,463672,ES23209508102455354994,1990.94,2022-11-08T15:43:10,Bilbao,expenses,education,-43.95,-19288.66
buyer_7,Agurtzane,Laka,1968-12-31,26592366L,agurtzane.laka@awesomecloud.co,463672,ES23209508102455354994,1990.94,2022-11-10T19:21:03,Bilbao,expenses,cash,-100.0,-19388.66
buyer_7,Agurtzane,Laka,1968-12-31,26592366L,agurtzane.laka@awesomecloud.co,463672,ES23209508102455354994,1990.94,2022-11-11T15:19:10,Bilbao,expenses,repairs,-101.2,-19489.86
buyer_7,Agurtzane,Laka,1968-12-31,26592366L,agurtzane.laka@awesomecloud.co,463672,ES23209508102455354994,1990.94,2022-11-13T22:44:10,Bilbao,expenses,food,-96.87,-19586.73
buyer_7,Agurtzane,Laka,1968-12-31,26592366L,agurtzane.laka@awesomecloud.co,463672,ES23209508102455354994,1990.94,2022-11-20T14:40:55,Bilbao,expenses,leisure,-22.84,-19609.57
buyer_7,Agurtzane,Laka,1968-12-31,26592366L,agurtzane.laka@awesomecloud.co,463672,ES23209508102455354994,1990.94,2022-11-23T18:38:54,Bilbao,expenses,cash,-100.0,-19709.57
buyer_7,Agurtzane,Laka,1968-12-31,26592366L,agurtzane.laka@awesomecloud.co,463672,ES23209508102455354994,1990.94,2022-11-23T13:07:52,Bilbao,expenses,gifts,-134.3,-19843.87
buyer_7,Agurtzane,Laka,1968-12-31,26592366L,agurtzane.laka@awesomecloud.co,463672,ES23209508102455354994,1990.94,2022-11-24T12:56:07,Bilbao,expenses,cash,-100.0,-19943.87
buyer_7,Agurtzane,Laka,1968-12-31,26592366L,agurtzane.laka@awesomecloud.co,463672,ES23209508102455354994,1990.94,2022-11-24T22:46:04,Bilbao,expenses,repairs,-205.26,-20149.13
buyer_7,Agurtzane,Laka,1968-12-31,26592366L,agurtzane.laka@awesomecloud.co,463672,ES23209508102455354994,1990.94,2022-11-26T08:32:07,Bilbao,expenses,transport,-76.55,-20225.68
buyer_7,Agurtzane,Laka,1968-12-31,26592366L,agurtzane.laka@awesomecloud.co,463672,ES23209508102455354994,1990.94,2022-11-27T17:22:20,Bilbao,expenses,education,-46.2,-20271.88
buyer_7,Agurtzane,Laka,1968-12-31,26592366L,agurtzane.laka@awesomecloud.co,463672,ES23209508102455354994,1990.94,2022-11-28T09:47:54,Bilbao,expenses,cash,-100.0,-20371.88
buyer_7,Agurtzane,Laka,1968-12-31,26592366L,agurtzane.laka@awesomecloud.co,463672,ES23209508102455354994,1990.94,2022-12-01T20:38:09,Bilbao,incomes,salary,1512.47,-18859.41
buyer_7,Agurtzane,Laka,1968-12-31,26592366L,agurtzane.laka@awesomecloud.co,463672,ES23209508102455354994,1990.94,2022-12-01T20:38:09,Bilbao,incomes,salary_bonus,1059.05,-17800.36
buyer_7,Agurtzane,Laka,1968-12-31,26592366L,agurtzane.laka@awesomecloud.co,463672,ES23209508102455354994,1990.94,2022-12-01T15:00:38,Bilbao,expenses,food,-81.41,-17881.77
buyer_7,Agurtzane,Laka,1968-12-31,26592366L,agurtzane.laka@awesomecloud.co,463672,ES23209508102455354994,1990.94,2022-12-01T18:03:35,Bilbao,expenses,children,-165.91,-18047.68
buyer_7,Agurtzane,Laka,1968-12-31,26592366L,agurtzane.laka@awesomecloud.co,463672,ES23209508102455354994,1990.94,2022-12-02T12:43:43,Bilbao,expenses,food,-92.29,-18139.97
buyer_7,Agurtzane,Laka,1968-12-31,26592366L,agurtzane.laka@awesomecloud.co,463672,ES23209508102455354994,1990.94,2022-12-02T13:36:42,Bilbao,expenses,leisure,-68.78,-18208.75
buyer_7,Agurtzane,Laka,1968-12-31,26592366L,agurtzane.laka@awesomecloud.co,463672,ES23209508102455354994,1990.94,2022-12-02T11:56:33,Bilbao,expenses,clothing,-80.41,-18289.16
buyer_7,Agurtzane,Laka,1968-12-31,26592366L,agurtzane.laka@awesomecloud.co,463672,ES23209508102455354994,1990.94,2022-12-03T09:36:07,Bilbao,expenses,transport,-84.97,-18374.13
buyer_7,Agurtzane,Laka,1968-12-31,26592366L,agurtzane.laka@awesomecloud.co,463672,ES23209508102455354994,1990.94,2022-12-04T19:39:32,Bilbao,expenses,clothing,-142.4,-18516.53
buyer_7,Agurtzane,Laka,1968-12-31,26592366L,agurtzane.laka@awesomecloud.co,463672,ES23209508102455354994,1990.94,2022-12-04T07:43:51,Bilbao,expenses,cash,-100.0,-18616.53
buyer_7,Agurtzane,Laka,1968-12-31,26592366L,agurtzane.laka@awesomecloud.co,463672,ES23209508102455354994,1990.94,2022-12-05T09:10:43,Bilbao,expenses,mortgage,-769.48,-19386.01
buyer_7,Agurtzane,Laka,1968-12-31,26592366L,agurtzane.laka@awesomecloud.co,463672,ES23209508102455354994,1990.94,2022-12-05T20:31:17,Bilbao,expenses,water,-19.76,-19405.77
buyer_7,Agurtzane,Laka,1968-12-31,26592366L,agurtzane.laka@awesomecloud.co,463672,ES23209508102455354994,1990.94,2022-12-05T19:52:20,Bilbao,expenses,internet,-31.76,-19437.53
buyer_7,Agurtzane,Laka,1968-12-31,26592366L,agurtzane.laka@awesomecloud.co,463672,ES23209508102455354994,1990.94,2022-12-05T12:19:38,Bilbao,expenses,cash,-100.0,-19537.53
buyer_7,Agurtzane,Laka,1968-12-31,26592366L,agurtzane.laka@awesomecloud.co,463672,ES23209508102455354994,1990.94,2022-12-06T11:58:10,Bilbao,expenses,water,-29.44,-19566.97
buyer_7,Agurtzane,Laka,1968-12-31,26592366L,agurtzane.laka@awesomecloud.co,463672,ES23209508102455354994,1990.94,2022-12-06T20:12:31,Bilbao,expenses,phone,-31.12,-19598.09
buyer_7,Agurtzane,Laka,1968-12-31,26592366L,agurtzane.laka@awesomecloud.co,463672,ES23209508102455354994,1990.94,2022-12-06T23:51:56,Bilbao,expenses,food,-77.77,-19675.86
buyer_7,Agurtzane,Laka,1968-12-31,26592366L,agurtzane.laka@awesomecloud.co,463672,ES23209508102455354994,1990.94,2022-12-06T15:46:45,Bilbao,expenses,gifts,-54.68,-19730.54
buyer_7,Agurtzane,Laka,1968-12-31,26592366L,agurtzane.laka@awesomecloud.co,463672,ES23209508102455354994,1990.94,2022-12-07T09:12:37,Bilbao,expenses,electricity,-15.41,-19745.95
buyer_7,Agurtzane,Laka,1968-12-31,26592366L,agurtzane.laka@awesomecloud.co,463672,ES23209508102455354994,1990.94,2022-12-07T17:38:41,Bilbao,expenses,transport,-56.43,-19802.38
buyer_7,Agurtzane,Laka,1968-12-31,26592366L,agurtzane.laka@awesomecloud.co,463672,ES23209508102455354994,1990.94,2022-12-09T09:08:16,Bilbao,expenses,cash,-100.0,-19902.38
buyer_7,Agurtzane,Laka,1968-12-31,26592366L,agurtzane.laka@awesomecloud.co,463672,ES23209508102455354994,1990.94,2022-12-14T12:13:13,Bilbao,expenses,food,-105.68,-20008.06
buyer_7,Agurtzane,Laka,1968-12-31,26592366L,agurtzane.laka@awesomecloud.co,463672,ES23209508102455354994,1990.94,2022-12-17T14:57:38,Bilbao,expenses,transport,-66.91,-20074.97
buyer_7,Agurtzane,Laka,1968-12-31,26592366L,agurtzane.laka@awesomecloud.co,463672,ES23209508102455354994,1990.94,2022-12-18T01:29:32,Bilbao,expenses,cash,-100.0,-20174.97
buyer_7,Agurtzane,Laka,1968-12-31,26592366L,agurtzane.laka@awesomecloud.co,463672,ES23209508102455354994,1990.94,2022-12-19T18:54:14,Bilbao,expenses,food,-74.57,-20249.54
buyer_7,Agurtzane,Laka,1968-12-31,26592366L,agurtzane.laka@awesomecloud.co,463672,ES23209508102455354994,1990.94,2022-12-19T18:32:17,Bilbao,expenses,gifts,-205.25,-20454.79
buyer_7,Agurtzane,Laka,1968-12-31,26592366L,agurtzane.laka@awesomecloud.co,463672,ES23209508102455354994,1990.94,2022-12-21T13:53:00,Bilbao,expenses,cash,-100.0,-20554.79
buyer_7,Agurtzane,Laka,1968-12-31,26592366L,agurtzane.laka@awesomecloud.co,463672,ES23209508102455354994,1990.94,2022-12-23T20:58:40,Bilbao,expenses,food,-70.22,-20625.01
buyer_7,Agurtzane,Laka,1968-12-31,26592366L,agurtzane.laka@awesomecloud.co,463672,ES23209508102455354994,1990.94,2022-12-26T10:38:16,Bilbao,expenses,education,-78.47,-20703.48
buyer_7,Agurtzane,Laka,1968-12-31,26592366L,agurtzane.laka@awesomecloud.co,463672,ES23209508102455354994,1990.94,2022-12-27T20:22:10,Bilbao,expenses,transport,-43.82,-20747.3
buyer_7,Agurtzane,Laka,1968-12-31,26592366L,agurtzane.laka@awesomecloud.co,463672,ES23209508102455354994,1990.94,2022-12-27T09:15:35,Bilbao,expenses,cash,-100.0,-20847.3
buyer_7,Agurtzane,Laka,1968-12-31,26592366L,agurtzane.laka@awesomecloud.co,463672,ES23209508102455354994,1990.94,2022-12-30T21:07:22,Bilbao,expenses,transport,-73.54,-20920.84
buyer_7,Agurtzane,Laka,1968-12-31,26592366L,agurtzane.laka@awesomecloud.co,463672,ES23209508102455354994,1990.94,2022-12-31T07:17:09,Bilbao,expenses,food,-118.83,-21039.67
buyer_7,Agurtzane,Laka,1968-12-31,26592366L,agurtzane.laka@awesomecloud.co,463672,ES23209508102455354994,1990.94,2023-01-01T16:37:52,Bilbao,incomes,salary,1566.41,-19473.26
buyer_7,Agurtzane,Laka,1968-12-31,26592366L,agurtzane.laka@awesomecloud.co,463672,ES23209508102455354994,1990.94,2023-01-01T16:37:52,Bilbao,incomes,extra_income,185.75,-19287.51
buyer_7,Agurtzane,Laka,1968-12-31,26592366L,agurtzane.laka@awesomecloud.co,463672,ES23209508102455354994,1990.94,2023-01-01T12:06:05,Bilbao,expenses,transport,-89.57,-19377.08
buyer_7,Agurtzane,Laka,1968-12-31,26592366L,agurtzane.laka@awesomecloud.co,463672,ES23209508102455354994,1990.94,2023-01-02T14:24:37,Bilbao,expenses,cash,-100.0,-19477.08
buyer_7,Agurtzane,Laka,1968-12-31,26592366L,agurtzane.laka@awesomecloud.co,463672,ES23209508102455354994,1990.94,2023-01-02T17:01:40,Bilbao,expenses,repairs,-61.56,-19538.64
buyer_7,Agurtzane,Laka,1968-12-31,26592366L,agurtzane.laka@awesomecloud.co,463672,ES23209508102455354994,1990.94,2023-01-05T22:16:31,Bilbao,expenses,mortgage,-688.78,-20227.42
buyer_7,Agurtzane,Laka,1968-12-31,26592366L,agurtzane.laka@awesomecloud.co,463672,ES23209508102455354994,1990.94,2023-01-05T11:23:58,Bilbao,expenses,water,-32.81,-20260.23
buyer_7,Agurtzane,Laka,1968-12-31,26592366L,agurtzane.laka@awesomecloud.co,463672,ES23209508102455354994,1990.94,2023-01-05T17:48:53,Bilbao,expenses,electricity,-33.87,-20294.1
buyer_7,Agurtzane,Laka,1968-12-31,26592366L,agurtzane.laka@awesomecloud.co,463672,ES23209508102455354994,1990.94,2023-01-06T15:28:22,Bilbao,expenses,water,-18.3,-20312.4
buyer_7,Agurtzane,Laka,1968-12-31,26592366L,agurtzane.laka@awesomecloud.co,463672,ES23209508102455354994,1990.94,2023-01-06T17:04:09,Bilbao,expenses,gas,-78.81,-20391.21
buyer_7,Agurtzane,Laka,1968-12-31,26592366L,agurtzane.laka@awesomecloud.co,463672,ES23209508102455354994,1990.94,2023-01-06T16:02:29,Bilbao,expenses,repairs,-254.93,-20646.14
buyer_7,Agurtzane,Laka,1968-12-31,26592366L,agurtzane.laka@awesomecloud.co,463672,ES23209508102455354994,1990.94,2023-01-07T08:35:07,Bilbao,expenses,water,-16.14,-20662.28
buyer_7,Agurtzane,Laka,1968-12-31,26592366L,agurtzane.laka@awesomecloud.co,463672,ES23209508102455354994,1990.94,2023-01-07T15:23:06,Bilbao,expenses,gas,-25.44,-20687.72
buyer_7,Agurtzane,Laka,1968-12-31,26592366L,agurtzane.laka@awesomecloud.co,463672,ES23209508102455354994,1990.94,2023-01-08T14:55:25,Bilbao,expenses,healthcare,-175.54,-20863.26
buyer_7,Agurtzane,Laka,1968-12-31,26592366L,agurtzane.laka@awesomecloud.co,463672,ES23209508102455354994,1990.94,2023-01-08T10:00:48,Bilbao,expenses,education,-71.79,-20935.05
buyer_7,Agurtzane,Laka,1968-12-31,26592366L,agurtzane.laka@awesomecloud.co,463672,ES23209508102455354994,1990.94,2023-01-09T18:13:40,Bilbao,expenses,food,-62.73,-20997.78
buyer_7,Agurtzane,Laka,1968-12-31,26592366L,agurtzane.laka@awesomecloud.co,463672,ES23209508102455354994,1990.94,2023-01-09T14:43:59,Bilbao,expenses,repairs,-131.54,-21129.32
buyer_7,Agurtzane,Laka,1968-12-31,26592366L,agurtzane.laka@awesomecloud.co,463672,ES23209508102455354994,1990.94,2023-01-12T15:35:13,Bilbao,expenses,leisure,-45.81,-21175.13
buyer_7,Agurtzane,Laka,1968-12-31,26592366L,agurtzane.laka@awesomecloud.co,463672,ES23209508102455354994,1990.94,2023-01-13T19:38:37,Bilbao,expenses,leisure,-78.23,-21253.36
buyer_7,Agurtzane,Laka,1968-12-31,26592366L,agurtzane.laka@awesomecloud.co,463672,ES23209508102455354994,1990.94,2023-01-15T20:04:35,Bilbao,expenses,gifts,-398.9,-21652.26
buyer_7,Agurtzane,Laka,1968-12-31,26592366L,agurtzane.laka@awesomecloud.co,463672,ES23209508102455354994,1990.94,2023-01-20T22:12:55,Bilbao,expenses,transport,-49.6,-21701.86
buyer_7,Agurtzane,Laka,1968-12-31,26592366L,agurtzane.laka@awesomecloud.co,463672,ES23209508102455354994,1990.94,2023-01-20T12:57:08,Bilbao,expenses,cash,-100.0,-21801.86
buyer_7,Agurtzane,Laka,1968-12-31,26592366L,agurtzane.laka@awesomecloud.co,463672,ES23209508102455354994,1990.94,2023-01-21T20:15:16,Bilbao,expenses,food,-74.61,-21876.47
buyer_7,Agurtzane,Laka,1968-12-31,26592366L,agurtzane.laka@awesomecloud.co,463672,ES23209508102455354994,1990.94,2023-01-21T18:21:58,Bilbao,expenses,cash,-100.0,-21976.47
buyer_7,Agurtzane,Laka,1968-12-31,26592366L,agurtzane.laka@awesomecloud.co,463672,ES23209508102455354994,1990.94,2023-01-22T16:22:13,Bilbao,expenses,food,-87.25,-22063.72
buyer_7,Agurtzane,Laka,1968-12-31,26592366L,agurtzane.laka@awesomecloud.co,463672,ES23209508102455354994,1990.94,2023-01-22T21:06:56,Bilbao,expenses,transport,-48.15,-22111.87
buyer_7,Agurtzane,Laka,1968-12-31,26592366L,agurtzane.laka@awesomecloud.co,463672,ES23209508102455354994,1990.94,2023-01-22T16:06:51,Bilbao,expenses,leisure,-81.04,-22192.91
buyer_7,Agurtzane,Laka,1968-12-31,26592366L,agurtzane.laka@awesomecloud.co,463672,ES23209508102455354994,1990.94,2023-01-22T16:48:56,Bilbao,expenses,cash,-100.0,-22292.91
buyer_7,Agurtzane,Laka,1968-12-31,26592366L,agurtzane.laka@awesomecloud.co,463672,ES23209508102455354994,1990.94,2023-01-23T15:19:43,Bilbao,expenses,food,-95.94,-22388.85
buyer_7,Agurtzane,Laka,1968-12-31,26592366L,agurtzane.laka@awesomecloud.co,463672,ES23209508102455354994,1990.94,2023-01-24T08:17:35,Bilbao,expenses,leisure,-30.34,-22419.19
buyer_7,Agurtzane,Laka,1968-12-31,26592366L,agurtzane.laka@awesomecloud.co,463672,ES23209508102455354994,1990.94,2023-01-24T16:46:06,Bilbao,expenses,clothing,-49.35,-22468.54
buyer_7,Agurtzane,Laka,1968-12-31,26592366L,agurtzane.laka@awesomecloud.co,463672,ES23209508102455354994,1990.94,2023-01-24T15:52:42,Bilbao,expenses,repairs,-322.63,-22791.17
buyer_7,Agurtzane,Laka,1968-12-31,26592366L,agurtzane.laka@awesomecloud.co,463672,ES23209508102455354994,1990.94,2023-01-25T20:50:43,Bilbao,expenses,healthcare,-129.15,-22920.32
buyer_7,Agurtzane,Laka,1968-12-31,26592366L,agurtzane.laka@awesomecloud.co,463672,ES23209508102455354994,1990.94,2023-01-25T16:12:50,Bilbao,expenses,children,-286.8075000000001,-23207.13
buyer_7,Agurtzane,Laka,1968-12-31,26592366L,agurtzane.laka@awesomecloud.co,463672,ES23209508102455354994,1990.94,2023-01-26T19:40:33,Bilbao,expenses,children,-144.27,-23351.4
buyer_7,Agurtzane,Laka,1968-12-31,26592366L,agurtzane.laka@awesomecloud.co,463672,ES23209508102455354994,1990.94,2023-01-27T06:25:44,Bilbao,expenses,leisure,-60.1,-23411.5
buyer_7,Agurtzane,Laka,1968-12-31,26592366L,agurtzane.laka@awesomecloud.co,463672,ES23209508102455354994,1990.94,2023-02-01T17:08:57,Bilbao,incomes,salary,1566.41,-21845.09
buyer_7,Agurtzane,Laka,1968-12-31,26592366L,agurtzane.laka@awesomecloud.co,463672,ES23209508102455354994,1990.94,2023-02-03T18:54:44,Bilbao,expenses,transport,-85.62,-21930.71
buyer_7,Agurtzane,Laka,1968-12-31,26592366L,agurtzane.laka@awesomecloud.co,463672,ES23209508102455354994,1990.94,2023-02-04T16:11:05,Bilbao,expenses,gifts,-273.5,-22204.21
buyer_7,Agurtzane,Laka,1968-12-31,26592366L,agurtzane.laka@awesomecloud.co,463672,ES23209508102455354994,1990.94,2023-02-05T15:34:40,Bilbao,expenses,mortgage,-688.78,-22892.99
buyer_7,Agurtzane,Laka,1968-12-31,26592366L,agurtzane.laka@awesomecloud.co,463672,ES23209508102455354994,1990.94,2023-02-05T19:58:14,Bilbao,expenses,food,-110.91,-23003.9
buyer_7,Agurtzane,Laka,1968-12-31,26592366L,agurtzane.laka@awesomecloud.co,463672,ES23209508102455354994,1990.94,2023-02-05T15:31:32,Bilbao,expenses,transport,-58.16,-23062.06
buyer_7,Agurtzane,Laka,1968-12-31,26592366L,agurtzane.laka@awesomecloud.co,463672,ES23209508102455354994,1990.94,2023-02-05T22:28:20,Bilbao,expenses,leisure,-57.5,-23119.56
buyer_7,Agurtzane,Laka,1968-12-31,26592366L,agurtzane.laka@awesomecloud.co,463672,ES23209508102455354994,1990.94,2023-02-06T17:48:08,Bilbao,expenses,water,-22.48,-23142.04
buyer_7,Agurtzane,Laka,1968-12-31,26592366L,agurtzane.laka@awesomecloud.co,463672,ES23209508102455354994,1990.94,2023-02-06T11:21:15,Bilbao,expenses,transport,-81.47,-23223.51
buyer_7,Agurtzane,Laka,1968-12-31,26592366L,agurtzane.laka@awesomecloud.co,463672,ES23209508102455354994,1990.94,2023-02-06T14:04:44,Bilbao,expenses,travel,-314.9,-23538.41
buyer_7,Agurtzane,Laka,1968-12-31,26592366L,agurtzane.laka@awesomecloud.co,463672,ES23209508102455354994,1990.94,2023-02-07T12:55:27,Bilbao,expenses,electricity,-18.62,-23557.03
buyer_7,Agurtzane,Laka,1968-12-31,26592366L,agurtzane.laka@awesomecloud.co,463672,ES23209508102455354994,1990.94,2023-02-07T17:01:35,Bilbao,expenses,internet,-32.89,-23589.92
buyer_7,Agurtzane,Laka,1968-12-31,26592366L,agurtzane.laka@awesomecloud.co,463672,ES23209508102455354994,1990.94,2023-02-08T12:57:46,Bilbao,expenses,internet,-32.89,-23622.81
buyer_7,Agurtzane,Laka,1968-12-31,26592366L,agurtzane.laka@awesomecloud.co,463672,ES23209508102455354994,1990.94,2023-02-08T20:07:29,Bilbao,expenses,phone,-28.16,-23650.97
buyer_7,Agurtzane,Laka,1968-12-31,26592366L,agurtzane.laka@awesomecloud.co,463672,ES23209508102455354994,1990.94,2023-02-08T15:50:27,Bilbao,expenses,food,-67.5,-23718.47
buyer_7,Agurtzane,Laka,1968-12-31,26592366L,agurtzane.laka@awesomecloud.co,463672,ES23209508102455354994,1990.94,2023-02-08T14:45:43,Bilbao,expenses,healthcare,-40.18,-23758.65
buyer_7,Agurtzane,Laka,1968-12-31,26592366L,agurtzane.laka@awesomecloud.co,463672,ES23209508102455354994,1990.94,2023-02-09T08:43:55,Bilbao,expenses,transport,-44.65,-23803.3
buyer_7,Agurtzane,Laka,1968-12-31,26592366L,agurtzane.laka@awesomecloud.co,463672,ES23209508102455354994,1990.94,2023-02-09T15:59:18,Bilbao,expenses,cash,-100.0,-23903.3
buyer_7,Agurtzane,Laka,1968-12-31,26592366L,agurtzane.laka@awesomecloud.co,463672,ES23209508102455354994,1990.94,2023-02-10T13:53:36,Bilbao,expenses,leisure,-70.81,-23974.11
buyer_7,Agurtzane,Laka,1968-12-31,26592366L,agurtzane.laka@awesomecloud.co,463672,ES23209508102455354994,1990.94,2023-02-10T19:05:16,Bilbao,expenses,healthcare,-85.16,-24059.27
buyer_7,Agurtzane,Laka,1968-12-31,26592366L,agurtzane.laka@awesomecloud.co,463672,ES23209508102455354994,1990.94,2023-02-11T18:40:58,Bilbao,expenses,children,-206.88,-24266.15
buyer_7,Agurtzane,Laka,1968-12-31,26592366L,agurtzane.laka@awesomecloud.co,463672,ES23209508102455354994,1990.94,2023-02-14T16:30:43,Bilbao,expenses,children,-208.44,-24474.59
buyer_7,Agurtzane,Laka,1968-12-31,26592366L,agurtzane.laka@awesomecloud.co,463672,ES23209508102455354994,1990.94,2023-02-15T20:37:37,Bilbao,expenses,cash,-100.0,-24574.59
buyer_7,Agurtzane,Laka,1968-12-31,26592366L,agurtzane.laka@awesomecloud.co,463672,ES23209508102455354994,1990.94,2023-02-16T12:32:16,Bilbao,expenses,food,-111.19,-24685.78
buyer_7,Agurtzane,Laka,1968-12-31,26592366L,agurtzane.laka@awesomecloud.co,463672,ES23209508102455354994,1990.94,2023-02-17T17:20:58,Bilbao,expenses,gifts,-363.73,-25049.51
buyer_7,Agurtzane,Laka,1968-12-31,26592366L,agurtzane.laka@awesomecloud.co,463672,ES23209508102455354994,1990.94,2023-02-18T18:41:58,Bilbao,expenses,cash,-100.0,-25149.51
buyer_7,Agurtzane,Laka,1968-12-31,26592366L,agurtzane.laka@awesomecloud.co,463672,ES23209508102455354994,1990.94,2023-02-19T06:46:52,Bilbao,expenses,transport,-42.4,-25191.91
buyer_7,Agurtzane,Laka,1968-12-31,26592366L,agurtzane.laka@awesomecloud.co,463672,ES23209508102455354994,1990.94,2023-02-24T10:44:30,Bilbao,expenses,food,-111.21,-25303.12
buyer_7,Agurtzane,Laka,1968-12-31,26592366L,agurtzane.laka@awesomecloud.co,463672,ES23209508102455354994,1990.94,2023-02-25T23:25:30,Bilbao,expenses,gifts,-339.3,-25642.42
buyer_7,Agurtzane,Laka,1968-12-31,26592366L,agurtzane.laka@awesomecloud.co,463672,ES23209508102455354994,1990.94,2023-02-26T13:08:29,Bilbao,expenses,cash,-100.0,-25742.42
buyer_7,Agurtzane,Laka,1968-12-31,26592366L,agurtzane.laka@awesomecloud.co,463672,ES23209508102455354994,1990.94,2023-02-26T19:27:54,Bilbao,expenses,appliances,-227.32,-25969.74
buyer_7,Agurtzane,Laka,1968-12-31,26592366L,agurtzane.laka@awesomecloud.co,463672,ES23209508102455354994,1990.94,2023-02-27T19:10:03,Bilbao,expenses,leisure,-50.15,-26019.89
buyer_7,Agurtzane,Laka,1968-12-31,26592366L,agurtzane.laka@awesomecloud.co,463672,ES23209508102455354994,1990.94,2023-02-27T01:54:08,Bilbao,expenses,cash,-100.0,-26119.89
buyer_7,Agurtzane,Laka,1968-12-31,26592366L,agurtzane.laka@awesomecloud.co,463672,ES23209508102455354994,1990.94,2023-02-27T07:31:02,Bilbao,expenses,travel,-278.78,-26398.67
buyer_7,Agurtzane,Laka,1968-12-31,26592366L,agurtzane.laka@awesomecloud.co,463672,ES23209508102455354994,1990.94,2023-02-28T10:36:44,Bilbao,expenses,food,-104.73,-26503.4
buyer_7,Agurtzane,Laka,1968-12-31,26592366L,agurtzane.laka@awesomecloud.co,463672,ES23209508102455354994,1990.94,2023-02-28T13:15:00,Bilbao,expenses,leisure,-57.6,-26561.0
buyer_7,Agurtzane,Laka,1968-12-31,26592366L,agurtzane.laka@awesomecloud.co,463672,ES23209508102455354994,1990.94,2023-03-01T02:19:25,Bilbao,incomes,salary,1566.41,-24994.59
buyer_7,Agurtzane,Laka,1968-12-31,26592366L,agurtzane.laka@awesomecloud.co,463672,ES23209508102455354994,1990.94,2023-03-02T14:07:03,Bilbao,expenses,transport,-86.59,-25081.18
buyer_7,Agurtzane,Laka,1968-12-31,26592366L,agurtzane.laka@awesomecloud.co,463672,ES23209508102455354994,1990.94,2023-03-05T08:42:32,Bilbao,expenses,mortgage,-688.78,-25769.96
buyer_7,Agurtzane,Laka,1968-12-31,26592366L,agurtzane.laka@awesomecloud.co,463672,ES23209508102455354994,1990.94,2023-03-05T21:41:55,Bilbao,expenses,gas,-26.86,-25796.82
buyer_7,Agurtzane,Laka,1968-12-31,26592366L,agurtzane.laka@awesomecloud.co,463672,ES23209508102455354994,1990.94,2023-03-05T08:11:10,Bilbao,expenses,internet,-32.89,-25829.71
buyer_7,Agurtzane,Laka,1968-12-31,26592366L,agurtzane.laka@awesomecloud.co,463672,ES23209508102455354994,1990.94,2023-03-06T19:13:22,Bilbao,expenses,electricity,-40.28,-25869.99
buyer_7,Agurtzane,Laka,1968-12-31,26592366L,agurtzane.laka@awesomecloud.co,463672,ES23209508102455354994,1990.94,2023-03-06T13:03:11,Bilbao,expenses,phone,-23.8,-25893.79
buyer_7,Agurtzane,Laka,1968-12-31,26592366L,agurtzane.laka@awesomecloud.co,463672,ES23209508102455354994,1990.94,2023-03-07T20:10:38,Bilbao,expenses,food,-113.1,-26006.89
buyer_7,Agurtzane,Laka,1968-12-31,26592366L,agurtzane.laka@awesomecloud.co,463672,ES23209508102455354994,1990.94,2023-03-08T08:32:38,Bilbao,expenses,electricity,-41.48,-26048.37
buyer_7,Agurtzane,Laka,1968-12-31,26592366L,agurtzane.laka@awesomecloud.co,463672,ES23209508102455354994,1990.94,2023-03-08T09:01:18,Bilbao,expenses,gas,-37.56,-26085.93
buyer_7,Agurtzane,Laka,1968-12-31,26592366L,agurtzane.laka@awesomecloud.co,463672,ES23209508102455354994,1990.94,2023-03-08T23:19:31,Bilbao,expenses,phone,-30.0,-26115.93
buyer_7,Agurtzane,Laka,1968-12-31,26592366L,agurtzane.laka@awesomecloud.co,463672,ES23209508102455354994,1990.94,2023-03-08T05:59:52,Bilbao,expenses,repairs,-221.45,-26337.38
buyer_7,Agurtzane,Laka,1968-12-31,26592366L,agurtzane.laka@awesomecloud.co,463672,ES23209508102455354994,1990.94,2023-03-09T20:27:37,Bilbao,expenses,leisure,-76.78,-26414.16
buyer_7,Agurtzane,Laka,1968-12-31,26592366L,agurtzane.laka@awesomecloud.co,463672,ES23209508102455354994,1990.94,2023-03-09T23:08:20,Bilbao,expenses,appliances,-90.93,-26505.09
buyer_7,Agurtzane,Laka,1968-12-31,26592366L,agurtzane.laka@awesomecloud.co,463672,ES23209508102455354994,1990.94,2023-03-09T16:22:14,Bilbao,expenses,repairs,-27.35,-26532.44
buyer_7,Agurtzane,Laka,1968-12-31,26592366L,agurtzane.laka@awesomecloud.co,463672,ES23209508102455354994,1990.94,2023-03-10T08:17:08,Bilbao,expenses,leisure,-28.71,-26561.15
buyer_7,Agurtzane,Laka,1968-12-31,26592366L,agurtzane.laka@awesomecloud.co,463672,ES23209508102455354994,1990.94,2023-03-11T11:14:27,Bilbao,expenses,food,-88.27,-26649.42
buyer_7,Agurtzane,Laka,1968-12-31,26592366L,agurtzane.laka@awesomecloud.co,463672,ES23209508102455354994,1990.94,2023-03-11T10:16:45,Bilbao,expenses,healthcare,-149.51,-26798.93
buyer_7,Agurtzane,Laka,1968-12-31,26592366L,agurtzane.laka@awesomecloud.co,463672,ES23209508102455354994,1990.94,2023-03-12T01:32:32,Bilbao,expenses,transport,-55.54,-26854.47
buyer_7,Agurtzane,Laka,1968-12-31,26592366L,agurtzane.laka@awesomecloud.co,463672,ES23209508102455354994,1990.94,2023-03-13T19:17:21,Bilbao,expenses,leisure,-60.22,-26914.69
buyer_7,Agurtzane,Laka,1968-12-31,26592366L,agurtzane.laka@awesomecloud.co,463672,ES23209508102455354994,1990.94,2023-03-13T15:17:56,Bilbao,expenses,cash,-100.0,-27014.69
buyer_7,Agurtzane,Laka,1968-12-31,26592366L,agurtzane.laka@awesomecloud.co,463672,ES23209508102455354994,1990.94,2023-03-15T21:39:48,Bilbao,expenses,cash,-100.0,-27114.69
buyer_7,Agurtzane,Laka,1968-12-31,26592366L,agurtzane.laka@awesomecloud.co,463672,ES23209508102455354994,1990.94,2023-03-16T16:56:22,Bilbao,expenses,education,-51.28,-27165.97
buyer_7,Agurtzane,Laka,1968-12-31,26592366L,agurtzane.laka@awesomecloud.co,463672,ES23209508102455354994,1990.94,2023-03-16T12:22:11,Bilbao,expenses,cash,-100.0,-27265.97
buyer_7,Agurtzane,Laka,1968-12-31,26592366L,agurtzane.laka@awesomecloud.co,463672,ES23209508102455354994,1990.94,2023-03-17T11:35:54,Bilbao,expenses,cash,-100.0,-27365.97
buyer_7,Agurtzane,Laka,1968-12-31,26592366L,agurtzane.laka@awesomecloud.co,463672,ES23209508102455354994,1990.94,2023-03-18T00:09:51,Bilbao,expenses,repairs,-164.0,-27529.97
buyer_7,Agurtzane,Laka,1968-12-31,26592366L,agurtzane.laka@awesomecloud.co,463672,ES23209508102455354994,1990.94,2023-03-19T11:42:26,Bilbao,expenses,clothing,-46.1,-27576.07
buyer_7,Agurtzane,Laka,1968-12-31,26592366L,agurtzane.laka@awesomecloud.co,463672,ES23209508102455354994,1990.94,2023-03-19T15:29:57,Bilbao,expenses,education,-64.41,-27640.48
buyer_7,Agurtzane,Laka,1968-12-31,26592366L,agurtzane.laka@awesomecloud.co,463672,ES23209508102455354994,1990.94,2023-03-21T15:30:02,Bilbao,expenses,food,-62.28,-27702.76
buyer_7,Agurtzane,Laka,1968-12-31,26592366L,agurtzane.laka@awesomecloud.co,463672,ES23209508102455354994,1990.94,2023-03-23T18:37:40,Bilbao,expenses,healthcare,-71.16,-27773.92
buyer_7,Agurtzane,Laka,1968-12-31,26592366L,agurtzane.laka@awesomecloud.co,463672,ES23209508102455354994,1990.94,2023-03-24T12:47:45,Bilbao,expenses,cash,-100.0,-27873.92
buyer_7,Agurtzane,Laka,1968-12-31,26592366L,agurtzane.laka@awesomecloud.co,463672,ES23209508102455354994,1990.94,2023-03-27T20:25:29,Bilbao,expenses,transport,-82.79,-27956.71
buyer_7,Agurtzane,Laka,1968-12-31,26592366L,agurtzane.laka@awesomecloud.co,463672,ES23209508102455354994,1990.94,2023-03-27T17:17:25,Bilbao,expenses,education,-60.25,-28016.96
buyer_7,Agurtzane,Laka,1968-12-31,26592366L,agurtzane.laka@awesomecloud.co,463672,ES23209508102455354994,1990.94,2023-03-28T20:35:17,Bilbao,expenses,food,-85.96,-28102.92
buyer_7,Agurtzane,Laka,1968-12-31,26592366L,agurtzane.laka@awesomecloud.co,463672,ES23209508102455354994,1990.94,2023-03-29T16:58:41,Bilbao,expenses,transport,-59.55,-28162.47
buyer_7,Agurtzane,Laka,1968-12-31,26592366L,agurtzane.laka@awesomecloud.co,463672,ES23209508102455354994,1990.94,2023-03-31T17:48:38,Bilbao,expenses,food,-76.76,-28239.23
buyer_7,Agurtzane,Laka,1968-12-31,26592366L,agurtzane.laka@awesomecloud.co,463672,ES23209508102455354994,1990.94,2023-03-31T03:52:51,Bilbao,expenses,healthcare,-106.58,-28345.81
buyer_7,Agurtzane,Laka,1968-12-31,26592366L,agurtzane.laka@awesomecloud.co,463672,ES23209508102455354994,1990.94,2023-03-31T20:12:35,Bilbao,expenses,cash,-100.0,-28445.81
buyer_7,Agurtzane,Laka,1968-12-31,26592366L,agurtzane.laka@awesomecloud.co,463672,ES23209508102455354994,1990.94,2023-04-01T23:20:24,Bilbao,incomes,salary,1566.41,-26879.4
buyer_7,Agurtzane,Laka,1968-12-31,26592366L,agurtzane.laka@awesomecloud.co,463672,ES23209508102455354994,1990.94,2023-04-01T21:06:19,Bilbao,expenses,leisure,-55.92,-26935.32
buyer_7,Agurtzane,Laka,1968-12-31,26592366L,agurtzane.laka@awesomecloud.co,463672,ES23209508102455354994,1990.94,2023-04-02T09:30:40,Bilbao,expenses,leisure,-56.81,-26992.13
buyer_7,Agurtzane,Laka,1968-12-31,26592366L,agurtzane.laka@awesomecloud.co,463672,ES23209508102455354994,1990.94,2023-04-02T16:13:12,Bilbao,expenses,clothing,-137.73,-27129.86
buyer_7,Agurtzane,Laka,1968-12-31,26592366L,agurtzane.laka@awesomecloud.co,463672,ES23209508102455354994,1990.94,2023-04-03T17:00:21,Bilbao,expenses,cash,-100.0,-27229.86
buyer_7,Agurtzane,Laka,1968-12-31,26592366L,agurtzane.laka@awesomecloud.co,463672,ES23209508102455354994,1990.94,2023-04-04T01:07:28,Bilbao,expenses,leisure,-62.26,-27292.12
buyer_7,Agurtzane,Laka,1968-12-31,26592366L,agurtzane.laka@awesomecloud.co,463672,ES23209508102455354994,1990.94,2023-04-05T17:30:04,Bilbao,expenses,mortgage,-688.78,-27980.9
buyer_7,Agurtzane,Laka,1968-12-31,26592366L,agurtzane.laka@awesomecloud.co,463672,ES23209508102455354994,1990.94,2023-04-05T16:53:49,Bilbao,expenses,water,-31.72,-28012.62
buyer_7,Agurtzane,Laka,1968-12-31,26592366L,agurtzane.laka@awesomecloud.co,463672,ES23209508102455354994,1990.94,2023-04-05T08:00:03,Bilbao,expenses,gas,-75.98,-28088.6
buyer_7,Agurtzane,Laka,1968-12-31,26592366L,agurtzane.laka@awesomecloud.co,463672,ES23209508102455354994,1990.94,2023-04-05T08:35:46,Bilbao,expenses,internet,-32.89,-28121.49
buyer_7,Agurtzane,Laka,1968-12-31,26592366L,agurtzane.laka@awesomecloud.co,463672,ES23209508102455354994,1990.94,2023-04-05T13:29:18,Bilbao,expenses,food,-74.29,-28195.78
buyer_7,Agurtzane,Laka,1968-12-31,26592366L,agurtzane.laka@awesomecloud.co,463672,ES23209508102455354994,1990.94,2023-04-06T14:32:02,Bilbao,expenses,food,-94.34,-28290.12
buyer_7,Agurtzane,Laka,1968-12-31,26592366L,agurtzane.laka@awesomecloud.co,463672,ES23209508102455354994,1990.94,2023-04-06T17:19:59,Bilbao,expenses,clothing,-47.23,-28337.35
buyer_7,Agurtzane,Laka,1968-12-31,26592366L,agurtzane.laka@awesomecloud.co,463672,ES23209508102455354994,1990.94,2023-04-07T17:56:40,Bilbao,expenses,transport,-49.85,-28387.2
buyer_7,Agurtzane,Laka,1968-12-31,26592366L,agurtzane.laka@awesomecloud.co,463672,ES23209508102455354994,1990.94,2023-04-08T18:01:15,Bilbao,expenses,water,-35.04,-28422.24
buyer_7,Agurtzane,Laka,1968-12-31,26592366L,agurtzane.laka@awesomecloud.co,463672,ES23209508102455354994,1990.94,2023-04-08T16:44:23,Bilbao,expenses,phone,-34.49,-28456.73
buyer_7,Agurtzane,Laka,1968-12-31,26592366L,agurtzane.laka@awesomecloud.co,463672,ES23209508102455354994,1990.94,2023-04-08T22:07:30,Bilbao,expenses,food,-104.97,-28561.7
buyer_7,Agurtzane,Laka,1968-12-31,26592366L,agurtzane.laka@awesomecloud.co,463672,ES23209508102455354994,1990.94,2023-04-10T14:47:18,Bilbao,expenses,leisure,-34.99,-28596.69
buyer_7,Agurtzane,Laka,1968-12-31,26592366L,agurtzane.laka@awesomecloud.co,463672,ES23209508102455354994,1990.94,2023-04-10T15:20:37,Bilbao,expenses,education,-73.26,-28669.95
buyer_7,Agurtzane,Laka,1968-12-31,26592366L,agurtzane.laka@awesomecloud.co,463672,ES23209508102455354994,1990.94,2023-04-10T09:06:36,Bilbao,expenses,cash,-100.0,-28769.95
buyer_7,Agurtzane,Laka,1968-12-31,26592366L,agurtzane.laka@awesomecloud.co,463672,ES23209508102455354994,1990.94,2023-04-13T08:14:47,Bilbao,expenses,transport,-68.32,-28838.27
buyer_7,Agurtzane,Laka,1968-12-31,26592366L,agurtzane.laka@awesomecloud.co,463672,ES23209508102455354994,1990.94,2023-04-13T19:27:13,Bilbao,expenses,leisure,-21.44,-28859.71
buyer_7,Agurtzane,Laka,1968-12-31,26592366L,agurtzane.laka@awesomecloud.co,463672,ES23209508102455354994,1990.94,2023-04-15T16:12:39,Bilbao,expenses,appliances,-137.07,-28996.78
buyer_7,Agurtzane,Laka,1968-12-31,26592366L,agurtzane.laka@awesomecloud.co,463672,ES23209508102455354994,1990.94,2023-04-17T04:30:52,Bilbao,expenses,food,-78.26,-29075.04
buyer_7,Agurtzane,Laka,1968-12-31,26592366L,agurtzane.laka@awesomecloud.co,463672,ES23209508102455354994,1990.94,2023-04-19T05:58:28,Bilbao,expenses,transport,-79.89,-29154.93
buyer_7,Agurtzane,Laka,1968-12-31,26592366L,agurtzane.laka@awesomecloud.co,463672,ES23209508102455354994,1990.94,2023-04-20T18:56:36,Bilbao,expenses,leisure,-77.77,-29232.7
buyer_7,Agurtzane,Laka,1968-12-31,26592366L,agurtzane.laka@awesomecloud.co,463672,ES23209508102455354994,1990.94,2023-04-21T11:08:11,Bilbao,expenses,transport,-43.46,-29276.16
buyer_7,Agurtzane,Laka,1968-12-31,26592366L,agurtzane.laka@awesomecloud.co,463672,ES23209508102455354994,1990.94,2023-04-23T12:22:07,Bilbao,expenses,food,-78.15,-29354.31
buyer_7,Agurtzane,Laka,1968-12-31,26592366L,agurtzane.laka@awesomecloud.co,463672,ES23209508102455354994,1990.94,2023-04-23T16:22:50,Bilbao,expenses,repairs,-203.99,-29558.3
buyer_7,Agurtzane,Laka,1968-12-31,26592366L,agurtzane.laka@awesomecloud.co,463672,ES23209508102455354994,1990.94,2023-04-24T18:05:09,Bilbao,expenses,food,-79.6,-29637.9
buyer_7,Agurtzane,Laka,1968-12-31,26592366L,agurtzane.laka@awesomecloud.co,463672,ES23209508102455354994,1990.94,2023-04-24T06:22:27,Bilbao,expenses,leisure,-55.95,-29693.85
buyer_7,Agurtzane,Laka,1968-12-31,26592366L,agurtzane.laka@awesomecloud.co,463672,ES23209508102455354994,1990.94,2023-04-24T17:47:57,Bilbao,expenses,gifts,-104.82,-29798.67
buyer_7,Agurtzane,Laka,1968-12-31,26592366L,agurtzane.laka@awesomecloud.co,463672,ES23209508102455354994,1990.94,2023-04-26T13:34:50,Bilbao,expenses,clothing,-92.42,-29891.09
buyer_7,Agurtzane,Laka,1968-12-31,26592366L,agurtzane.laka@awesomecloud.co,463672,ES23209508102455354994,1990.94,2023-04-27T14:01:19,Bilbao,expenses,appliances,-189.25,-30080.34
buyer_7,Agurtzane,Laka,1968-12-31,26592366L,agurtzane.laka@awesomecloud.co,463672,ES23209508102455354994,1990.94,2023-04-28T20:08:33,Bilbao,expenses,cash,-100.0,-30180.34
buyer_7,Agurtzane,Laka,1968-12-31,26592366L,agurtzane.laka@awesomecloud.co,463672,ES23209508102455354994,1990.94,2023-04-28T02:07:33,Bilbao,expenses,gifts,-34.73,-30215.07
buyer_7,Agurtzane,Laka,1968-12-31,26592366L,agurtzane.laka@awesomecloud.co,463672,ES23209508102455354994,1990.94,2023-04-29T15:28:06,Bilbao,expenses,cash,-100.0,-30315.07
buyer_7,Agurtzane,Laka,1968-12-31,26592366L,agurtzane.laka@awesomecloud.co,463672,ES23209508102455354994,1990.94,2023-04-30T19:16:04,Bilbao,expenses,clothing,-68.88,-30383.95
buyer_7,Agurtzane,Laka,1968-12-31,26592366L,agurtzane.laka@awesomecloud.co,463672,ES23209508102455354994,1990.94,2023-05-01T15:02:37,Bilbao,incomes,salary,1566.41,-28817.54
buyer_7,Agurtzane,Laka,1968-12-31,26592366L,agurtzane.laka@awesomecloud.co,463672,ES23209508102455354994,1990.94,2023-05-01T15:02:37,Bilbao,incomes,extra_income,185.75,-28631.79
buyer_7,Agurtzane,Laka,1968-12-31,26592366L,agurtzane.laka@awesomecloud.co,463672,ES23209508102455354994,1990.94,2023-05-01T13:02:41,Bilbao,expenses,transport,-63.96,-28695.75
buyer_7,Agurtzane,Laka,1968-12-31,26592366L,agurtzane.laka@awesomecloud.co,463672,ES23209508102455354994,1990.94,2023-05-03T21:53:22,Bilbao,expenses,gifts,-205.29,-28901.04
buyer_7,Agurtzane,Laka,1968-12-31,26592366L,agurtzane.laka@awesomecloud.co,463672,ES23209508102455354994,1990.94,2023-05-04T14:31:48,Bilbao,expenses,children,-165.05,-29066.09
buyer_7,Agurtzane,Laka,1968-12-31,26592366L,agurtzane.laka@awesomecloud.co,463672,ES23209508102455354994,1990.94,2023-05-05T19:27:07,Bilbao,expenses,mortgage,-688.78,-29754.87
buyer_7,Agurtzane,Laka,1968-12-31,26592366L,agurtzane.laka@awesomecloud.co,463672,ES23209508102455354994,1990.94,2023-05-05T11:59:55,Bilbao,expenses,travel,-348.31,-30103.18
buyer_7,Agurtzane,Laka,1968-12-31,26592366L,agurtzane.laka@awesomecloud.co,463672,ES23209508102455354994,1990.94,2023-05-05T21:38:14,Bilbao,expenses,gifts,-36.83,-30140.01
buyer_7,Agurtzane,Laka,1968-12-31,26592366L,agurtzane.laka@awesomecloud.co,463672,ES23209508102455354994,1990.94,2023-05-06T16:13:12,Bilbao,expenses,electricity,-19.7,-30159.71
buyer_7,Agurtzane,Laka,1968-12-31,26592366L,agurtzane.laka@awesomecloud.co,463672,ES23209508102455354994,1990.94,2023-05-06T16:50:46,Bilbao,expenses,transport,-79.27,-30238.98
buyer_7,Agurtzane,Laka,1968-12-31,26592366L,agurtzane.laka@awesomecloud.co,463672,ES23209508102455354994,1990.94,2023-05-07T16:12:29,Bilbao,expenses,electricity,-44.96,-30283.94
buyer_7,Agurtzane,Laka,1968-12-31,26592366L,agurtzane.laka@awesomecloud.co,463672,ES23209508102455354994,1990.94,2023-05-07T10:49:55,Bilbao,expenses,gas,-87.88,-30371.82
buyer_7,Agurtzane,Laka,1968-12-31,26592366L,agurtzane.laka@awesomecloud.co,463672,ES23209508102455354994,1990.94,2023-05-07T15:46:06,Bilbao,expenses,food,-66.53,-30438.35
buyer_7,Agurtzane,Laka,1968-12-31,26592366L,agurtzane.laka@awesomecloud.co,463672,ES23209508102455354994,1990.94,2023-05-07T11:29:54,Bilbao,expenses,education,-73.82,-30512.17
buyer_7,Agurtzane,Laka,1968-12-31,26592366L,agurtzane.laka@awesomecloud.co,463672,ES23209508102455354994,1990.94,2023-05-08T12:40:55,Bilbao,expenses,water,-29.32,-30541.49
buyer_7,Agurtzane,Laka,1968-12-31,26592366L,agurtzane.laka@awesomecloud.co,463672,ES23209508102455354994,1990.94,2023-05-08T10:45:50,Bilbao,expenses,internet,-32.89,-30574.38
buyer_7,Agurtzane,Laka,1968-12-31,26592366L,agurtzane.laka@awesomecloud.co,463672,ES23209508102455354994,1990.94,2023-05-08T12:45:06,Bilbao,expenses,phone,-23.53,-30597.91
buyer_7,Agurtzane,Laka,1968-12-31,26592366L,agurtzane.laka@awesomecloud.co,463672,ES23209508102455354994,1990.94,2023-05-08T10:04:40,Bilbao,expenses,cash,-100.0,-30697.91
buyer_7,Agurtzane,Laka,1968-12-31,26592366L,agurtzane.laka@awesomecloud.co,463672,ES23209508102455354994,1990.94,2023-05-11T10:20:25,Bilbao,expenses,healthcare,-87.38,-30785.29
buyer_7,Agurtzane,Laka,1968-12-31,26592366L,agurtzane.laka@awesomecloud.co,463672,ES23209508102455354994,1990.94,2023-05-12T14:38:49,Bilbao,expenses,repairs,-118.91,-30904.2
buyer_7,Agurtzane,Laka,1968-12-31,26592366L,agurtzane.laka@awesomecloud.co,463672,ES23209508102455354994,1990.94,2023-05-14T13:59:34,Bilbao,expenses,clothing,-127.86,-31032.06
buyer_7,Agurtzane,Laka,1968-12-31,26592366L,agurtzane.laka@awesomecloud.co,463672,ES23209508102455354994,1990.94,2023-05-14T16:12:06,Bilbao,expenses,travel,-281.26,-31313.32
buyer_7,Agurtzane,Laka,1968-12-31,26592366L,agurtzane.laka@awesomecloud.co,463672,ES23209508102455354994,1990.94,2023-05-14T13:15:47,Bilbao,expenses,repairs,-9.53,-31322.85
buyer_7,Agurtzane,Laka,1968-12-31,26592366L,agurtzane.laka@awesomecloud.co,463672,ES23209508102455354994,1990.94,2023-05-16T16:46:54,Bilbao,expenses,education,-75.24,-31398.09
buyer_7,Agurtzane,Laka,1968-12-31,26592366L,agurtzane.laka@awesomecloud.co,463672,ES23209508102455354994,1990.94,2023-05-17T17:32:35,Bilbao,expenses,cash,-100.0,-31498.09
buyer_7,Agurtzane,Laka,1968-12-31,26592366L,agurtzane.laka@awesomecloud.co,463672,ES23209508102455354994,1990.94,2023-05-21T18:20:37,Bilbao,expenses,food,-92.47,-31590.56
buyer_7,Agurtzane,Laka,1968-12-31,26592366L,agurtzane.laka@awesomecloud.co,463672,ES23209508102455354994,1990.94,2023-05-23T12:41:36,Bilbao,expenses,clothing,-71.36,-31661.92
buyer_7,Agurtzane,Laka,1968-12-31,26592366L,agurtzane.laka@awesomecloud.co,463672,ES23209508102455354994,1990.94,2023-05-24T19:15:46,Bilbao,expenses,food,-94.59,-31756.51
buyer_7,Agurtzane,Laka,1968-12-31,26592366L,agurtzane.laka@awesomecloud.co,463672,ES23209508102455354994,1990.94,2023-05-26T16:58:49,Bilbao,expenses,food,-76.54,-31833.05
buyer_7,Agurtzane,Laka,1968-12-31,26592366L,agurtzane.laka@awesomecloud.co,463672,ES23209508102455354994,1990.94,2023-05-26T19:33:43,Bilbao,expenses,cash,-100.0,-31933.05
buyer_7,Agurtzane,Laka,1968-12-31,26592366L,agurtzane.laka@awesomecloud.co,463672,ES23209508102455354994,1990.94,2023-05-27T15:16:49,Bilbao,expenses,clothing,-86.95,-32020.0
buyer_7,Agurtzane,Laka,1968-12-31,26592366L,agurtzane.laka@awesomecloud.co,463672,ES23209508102455354994,1990.94,2023-05-27T13:18:03,Bilbao,expenses,education,-50.41,-32070.41
buyer_7,Agurtzane,Laka,1968-12-31,26592366L,agurtzane.laka@awesomecloud.co,463672,ES23209508102455354994,1990.94,2023-05-29T09:12:24,Bilbao,expenses,food,-82.72,-32153.13
buyer_7,Agurtzane,Laka,1968-12-31,26592366L,agurtzane.laka@awesomecloud.co,463672,ES23209508102455354994,1990.94,2023-05-31T13:07:43,Bilbao,expenses,clothing,-128.56,-32281.69
buyer_7,Agurtzane,Laka,1968-12-31,26592366L,agurtzane.laka@awesomecloud.co,463672,ES23209508102455354994,1990.94,2023-06-01T20:31:30,Bilbao,incomes,salary,1566.41,-30715.28
buyer_7,Agurtzane,Laka,1968-12-31,26592366L,agurtzane.laka@awesomecloud.co,463672,ES23209508102455354994,1990.94,2023-06-01T20:31:30,Bilbao,incomes,salary_bonus,1183.7,-29531.58
buyer_7,Agurtzane,Laka,1968-12-31,26592366L,agurtzane.laka@awesomecloud.co,463672,ES23209508102455354994,1990.94,2023-06-01T23:53:03,Bilbao,expenses,food,-96.85,-29628.43
buyer_7,Agurtzane,Laka,1968-12-31,26592366L,agurtzane.laka@awesomecloud.co,463672,ES23209508102455354994,1990.94,2023-06-01T20:31:47,Bilbao,expenses,travel,-307.52,-29935.95
buyer_7,Agurtzane,Laka,1968-12-31,26592366L,agurtzane.laka@awesomecloud.co,463672,ES23209508102455354994,1990.94,2023-06-01T11:13:24,Bilbao,expenses,appliances,-54.43,-29990.38
buyer_7,Agurtzane,Laka,1968-12-31,26592366L,agurtzane.laka@awesomecloud.co,463672,ES23209508102455354994,1990.94,2023-06-02T16:26:58,Bilbao,expenses,taxes,-1110.53,-31100.91
buyer_7,Agurtzane,Laka,1968-12-31,26592366L,agurtzane.laka@awesomecloud.co,463672,ES23209508102455354994,1990.94,2023-06-02T03:15:53,Bilbao,expenses,insurance,-324.12,-31425.03
buyer_7,Agurtzane,Laka,1968-12-31,26592366L,agurtzane.laka@awesomecloud.co,463672,ES23209508102455354994,1990.94,2023-06-02T11:52:28,Bilbao,expenses,food,-114.13,-31539.16
buyer_7,Agurtzane,Laka,1968-12-31,26592366L,agurtzane.laka@awesomecloud.co,463672,ES23209508102455354994,1990.94,2023-06-02T09:35:05,Bilbao,expenses,gifts,-156.12,-31695.28
buyer_7,Agurtzane,Laka,1968-12-31,26592366L,agurtzane.laka@awesomecloud.co,463672,ES23209508102455354994,1990.94,2023-06-03T16:16:53,Bilbao,expenses,food,-62.54,-31757.82
buyer_7,Agurtzane,Laka,1968-12-31,26592366L,agurtzane.laka@awesomecloud.co,463672,ES23209508102455354994,1990.94,2023-06-04T12:39:53,Bilbao,expenses,cash,-100.0,-31857.82
buyer_7,Agurtzane,Laka,1968-12-31,26592366L,agurtzane.laka@awesomecloud.co,463672,ES23209508102455354994,1990.94,2023-06-04T19:40:37,Bilbao,expenses,children,-82.58,-31940.4
buyer_7,Agurtzane,Laka,1968-12-31,26592366L,agurtzane.laka@awesomecloud.co,463672,ES23209508102455354994,1990.94,2023-06-05T14:04:40,Bilbao,expenses,mortgage,-688.78,-32629.18
buyer_7,Agurtzane,Laka,1968-12-31,26592366L,agurtzane.laka@awesomecloud.co,463672,ES23209508102455354994,1990.94,2023-06-05T23:32:23,Bilbao,expenses,electricity,-70.35,-32699.53
buyer_7,Agurtzane,Laka,1968-12-31,26592366L,agurtzane.laka@awesomecloud.co,463672,ES23209508102455354994,1990.94,2023-06-05T16:50:32,Bilbao,expenses,appliances,-287.96,-32987.49
buyer_7,Agurtzane,Laka,1968-12-31,26592366L,agurtzane.laka@awesomecloud.co,463672,ES23209508102455354994,1990.94,2023-06-06T23:32:47,Bilbao,expenses,water,-33.24,-33020.73
buyer_7,Agurtzane,Laka,1968-12-31,26592366L,agurtzane.laka@awesomecloud.co,463672,ES23209508102455354994,1990.94,2023-06-06T16:08:28,Bilbao,expenses,gas,-72.74,-33093.47
buyer_7,Agurtzane,Laka,1968-12-31,26592366L,agurtzane.laka@awesomecloud.co,463672,ES23209508102455354994,1990.94,2023-06-06T19:36:58,Bilbao,expenses,internet,-32.89,-33126.36
buyer_7,Agurtzane,Laka,1968-12-31,26592366L,agurtzane.laka@awesomecloud.co,463672,ES23209508102455354994,1990.94,2023-06-06T15:51:42,Bilbao,expenses,children,-218.92,-33345.28
buyer_7,Agurtzane,Laka,1968-12-31,26592366L,agurtzane.laka@awesomecloud.co,463672,ES23209508102455354994,1990.94,2023-06-07T14:14:04,Bilbao,expenses,phone,-34.38,-33379.66
buyer_7,Agurtzane,Laka,1968-12-31,26592366L,agurtzane.laka@awesomecloud.co,463672,ES23209508102455354994,1990.94,2023-06-08T11:23:27,Bilbao,expenses,internet,-32.89,-33412.55
buyer_7,Agurtzane,Laka,1968-12-31,26592366L,agurtzane.laka@awesomecloud.co,463672,ES23209508102455354994,1990.94,2023-06-11T23:39:02,Bilbao,expenses,leisure,-35.16,-33447.71
buyer_7,Agurtzane,Laka,1968-12-31,26592366L,agurtzane.laka@awesomecloud.co,463672,ES23209508102455354994,1990.94,2023-06-11T12:04:39,Bilbao,expenses,cash,-100.0,-33547.71
buyer_7,Agurtzane,Laka,1968-12-31,26592366L,agurtzane.laka@awesomecloud.co,463672,ES23209508102455354994,1990.94,2023-06-12T17:40:11,Bilbao,expenses,healthcare,-92.28,-33639.99
buyer_7,Agurtzane,Laka,1968-12-31,26592366L,agurtzane.laka@awesomecloud.co,463672,ES23209508102455354994,1990.94,2023-06-14T16:55:00,Bilbao,expenses,cash,-100.0,-33739.99
buyer_7,Agurtzane,Laka,1968-12-31,26592366L,agurtzane.laka@awesomecloud.co,463672,ES23209508102455354994,1990.94,2023-06-16T19:40:43,Bilbao,expenses,clothing,-151.99,-33891.98
buyer_7,Agurtzane,Laka,1968-12-31,26592366L,agurtzane.laka@awesomecloud.co,463672,ES23209508102455354994,1990.94,2023-06-17T23:16:04,Bilbao,expenses,clothing,-158.81,-34050.79
buyer_7,Agurtzane,Laka,1968-12-31,26592366L,agurtzane.laka@awesomecloud.co,463672,ES23209508102455354994,1990.94,2023-06-19T18:45:33,Bilbao,expenses,food,-63.05,-34113.84
buyer_7,Agurtzane,Laka,1968-12-31,26592366L,agurtzane.laka@awesomecloud.co,463672,ES23209508102455354994,1990.94,2023-06-19T10:31:59,Bilbao,expenses,cash,-100.0,-34213.84
buyer_7,Agurtzane,Laka,1968-12-31,26592366L,agurtzane.laka@awesomecloud.co,463672,ES23209508102455354994,1990.94,2023-06-21T19:54:09,Bilbao,expenses,leisure,-20.92,-34234.76
buyer_7,Agurtzane,Laka,1968-12-31,26592366L,agurtzane.laka@awesomecloud.co,463672,ES23209508102455354994,1990.94,2023-06-22T18:45:17,Bilbao,expenses,children,-308.44,-34543.2
buyer_7,Agurtzane,Laka,1968-12-31,26592366L,agurtzane.laka@awesomecloud.co,463672,ES23209508102455354994,1990.94,2023-06-24T23:08:46,Bilbao,expenses,transport,-77.93,-34621.13
buyer_7,Agurtzane,Laka,1968-12-31,26592366L,agurtzane.laka@awesomecloud.co,463672,ES23209508102455354994,1990.94,2023-06-25T13:15:43,Bilbao,expenses,food,-63.2,-34684.33
buyer_7,Agurtzane,Laka,1968-12-31,26592366L,agurtzane.laka@awesomecloud.co,463672,ES23209508102455354994,1990.94,2023-06-25T13:02:04,Bilbao,expenses,repairs,-248.03,-34932.36
buyer_7,Agurtzane,Laka,1968-12-31,26592366L,agurtzane.laka@awesomecloud.co,463672,ES23209508102455354994,1990.94,2023-06-29T12:44:42,Bilbao,expenses,transport,-59.93,-34992.29
buyer_7,Agurtzane,Laka,1968-12-31,26592366L,agurtzane.laka@awesomecloud.co,463672,ES23209508102455354994,1990.94,2023-07-01T17:56:57,Bilbao,incomes,salary,1566.41,-33425.88
buyer_7,Agurtzane,Laka,1968-12-31,26592366L,agurtzane.laka@awesomecloud.co,463672,ES23209508102455354994,1990.94,2023-07-01T05:56:32,Bilbao,expenses,food,-110.83,-33536.71
buyer_7,Agurtzane,Laka,1968-12-31,26592366L,agurtzane.laka@awesomecloud.co,463672,ES23209508102455354994,1990.94,2023-07-01T20:54:14,Bilbao,expenses,transport,-81.88,-33618.59
buyer_7,Agurtzane,Laka,1968-12-31,26592366L,agurtzane.laka@awesomecloud.co,463672,ES23209508102455354994,1990.94,2023-07-02T12:18:44,Bilbao,expenses,food,-105.85,-33724.44
buyer_7,Agurtzane,Laka,1968-12-31,26592366L,agurtzane.laka@awesomecloud.co,463672,ES23209508102455354994,1990.94,2023-07-02T18:47:46,Bilbao,expenses,travel,-298.38,-34022.82
buyer_7,Agurtzane,Laka,1968-12-31,26592366L,agurtzane.laka@awesomecloud.co,463672,ES23209508102455354994,1990.94,2023-07-03T09:17:34,Bilbao,expenses,food,-72.0,-34094.82
buyer_7,Agurtzane,Laka,1968-12-31,26592366L,agurtzane.laka@awesomecloud.co,463672,ES23209508102455354994,1990.94,2023-07-05T09:17:48,Bilbao,expenses,mortgage,-688.78,-34783.6
buyer_7,Agurtzane,Laka,1968-12-31,26592366L,agurtzane.laka@awesomecloud.co,463672,ES23209508102455354994,1990.94,2023-07-05T17:57:58,Bilbao,expenses,food,-72.0,-34855.6
buyer_7,Agurtzane,Laka,1968-12-31,26592366L,agurtzane.laka@awesomecloud.co,463672,ES23209508102455354994,1990.94,2023-07-05T17:14:41,Bilbao,expenses,clothing,-139.52,-34995.12
buyer_7,Agurtzane,Laka,1968-12-31,26592366L,agurtzane.laka@awesomecloud.co,463672,ES23209508102455354994,1990.94,2023-07-06T14:49:19,Bilbao,expenses,phone,-30.93,-35026.05
buyer_7,Agurtzane,Laka,1968-12-31,26592366L,agurtzane.laka@awesomecloud.co,463672,ES23209508102455354994,1990.94,2023-07-06T10:59:05,Bilbao,expenses,appliances,-393.17,-35419.22
buyer_7,Agurtzane,Laka,1968-12-31,26592366L,agurtzane.laka@awesomecloud.co,463672,ES23209508102455354994,1990.94,2023-07-07T20:18:41,Bilbao,expenses,electricity,-52.57,-35471.79
buyer_7,Agurtzane,Laka,1968-12-31,26592366L,agurtzane.laka@awesomecloud.co,463672,ES23209508102455354994,1990.94,2023-07-07T09:26:19,Bilbao,expenses,internet,-32.89,-35504.68
buyer_7,Agurtzane,Laka,1968-12-31,26592366L,agurtzane.laka@awesomecloud.co,463672,ES23209508102455354994,1990.94,2023-07-07T20:29:02,Bilbao,expenses,phone,-25.39,-35530.07
buyer_7,Agurtzane,Laka,1968-12-31,26592366L,agurtzane.laka@awesomecloud.co,463672,ES23209508102455354994,1990.94,2023-07-07T12:52:38,Bilbao,expenses,food,-124.87,-35654.94
buyer_7,Agurtzane,Laka,1968-12-31,26592366L,agurtzane.laka@awesomecloud.co,463672,ES23209508102455354994,1990.94,2023-07-07T15:39:03,Bilbao,expenses,transport,-79.31,-35734.25
buyer_7,Agurtzane,Laka,1968-12-31,26592366L,agurtzane.laka@awesomecloud.co,463672,ES23209508102455354994,1990.94,2023-07-07T20:40:01,Bilbao,expenses,clothing,-81.28,-35815.53
buyer_7,Agurtzane,Laka,1968-12-31,26592366L,agurtzane.laka@awesomecloud.co,463672,ES23209508102455354994,1990.94,2023-07-07T22:23:01,Bilbao,expenses,cash,-100.0,-35915.53
buyer_7,Agurtzane,Laka,1968-12-31,26592366L,agurtzane.laka@awesomecloud.co,463672,ES23209508102455354994,1990.94,2023-07-08T11:26:55,Bilbao,expenses,food,-71.08,-35986.61
buyer_7,Agurtzane,Laka,1968-12-31,26592366L,agurtzane.laka@awesomecloud.co,463672,ES23209508102455354994,1990.94,2023-07-10T18:30:32,Bilbao,expenses,cash,-100.0,-36086.61
buyer_7,Agurtzane,Laka,1968-12-31,26592366L,agurtzane.laka@awesomecloud.co,463672,ES23209508102455354994,1990.94,2023-07-11T10:54:40,Bilbao,expenses,cash,-100.0,-36186.61
buyer_7,Agurtzane,Laka,1968-12-31,26592366L,agurtzane.laka@awesomecloud.co,463672,ES23209508102455354994,1990.94,2023-07-15T08:28:35,Bilbao,expenses,food,-61.86,-36248.47
buyer_7,Agurtzane,Laka,1968-12-31,26592366L,agurtzane.laka@awesomecloud.co,463672,ES23209508102455354994,1990.94,2023-07-15T12:40:02,Bilbao,expenses,repairs,-327.98,-36576.45
buyer_7,Agurtzane,Laka,1968-12-31,26592366L,agurtzane.laka@awesomecloud.co,463672,ES23209508102455354994,1990.94,2023-07-16T12:50:36,Bilbao,expenses,appliances,-385.84,-36962.29
buyer_7,Agurtzane,Laka,1968-12-31,26592366L,agurtzane.laka@awesomecloud.co,463672,ES23209508102455354994,1990.94,2023-07-19T10:59:48,Bilbao,expenses,transport,-81.7,-37043.99
buyer_7,Agurtzane,Laka,1968-12-31,26592366L,agurtzane.laka@awesomecloud.co,463672,ES23209508102455354994,1990.94,2023-07-19T19:21:35,Bilbao,expenses,children,-91.68,-37135.67
buyer_7,Agurtzane,Laka,1968-12-31,26592366L,agurtzane.laka@awesomecloud.co,463672,ES23209508102455354994,1990.94,2023-07-20T12:57:39,Bilbao,expenses,gifts,-199.78,-37335.45
buyer_7,Agurtzane,Laka,1968-12-31,26592366L,agurtzane.laka@awesomecloud.co,463672,ES23209508102455354994,1990.94,2023-07-21T12:42:40,Bilbao,expenses,travel,-347.29,-37682.74
buyer_7,Agurtzane,Laka,1968-12-31,26592366L,agurtzane.laka@awesomecloud.co,463672,ES23209508102455354994,1990.94,2023-07-23T14:39:18,Bilbao,expenses,leisure,-59.2,-37741.94
buyer_7,Agurtzane,Laka,1968-12-31,26592366L,agurtzane.laka@awesomecloud.co,463672,ES23209508102455354994,1990.94,2023-07-23T20:52:18,Bilbao,expenses,repairs,-160.89,-37902.83
buyer_7,Agurtzane,Laka,1968-12-31,26592366L,agurtzane.laka@awesomecloud.co,463672,ES23209508102455354994,1990.94,2023-07-24T15:54:02,Bilbao,expenses,transport,-73.67,-37976.5
buyer_7,Agurtzane,Laka,1968-12-31,26592366L,agurtzane.laka@awesomecloud.co,463672,ES23209508102455354994,1990.94,2023-07-25T12:26:33,Bilbao,expenses,children,-337.84,-38314.34
buyer_7,Agurtzane,Laka,1968-12-31,26592366L,agurtzane.laka@awesomecloud.co,463672,ES23209508102455354994,1990.94,2023-07-31T08:05:50,Bilbao,expenses,cash,-100.0,-38414.34
buyer_7,Agurtzane,Laka,1968-12-31,26592366L,agurtzane.laka@awesomecloud.co,463672,ES23209508102455354994,1990.94,2023-08-01T20:51:59,Bilbao,incomes,salary,1566.41,-36847.93
buyer_7,Agurtzane,Laka,1968-12-31,26592366L,agurtzane.laka@awesomecloud.co,463672,ES23209508102455354994,1990.94,2023-08-03T09:39:00,Bilbao,expenses,transport,-81.9,-36929.83
buyer_7,Agurtzane,Laka,1968-12-31,26592366L,agurtzane.laka@awesomecloud.co,463672,ES23209508102455354994,1990.94,2023-08-05T16:14:23,Bilbao,expenses,mortgage,-688.78,-37618.61
buyer_7,Agurtzane,Laka,1968-12-31,26592366L,agurtzane.laka@awesomecloud.co,463672,ES23209508102455354994,1990.94,2023-08-05T11:04:24,Bilbao,expenses,water,-18.18,-37636.79
buyer_7,Agurtzane,Laka,1968-12-31,26592366L,agurtzane.laka@awesomecloud.co,463672,ES23209508102455354994,1990.94,2023-08-05T16:16:21,Bilbao,expenses,internet,-32.89,-37669.68
buyer_7,Agurtzane,Laka,1968-12-31,26592366L,agurtzane.laka@awesomecloud.co,463672,ES23209508102455354994,1990.94,2023-08-06T17:43:10,Bilbao,expenses,gas,-79.38,-37749.06
buyer_7,Agurtzane,Laka,1968-12-31,26592366L,agurtzane.laka@awesomecloud.co,463672,ES23209508102455354994,1990.94,2023-08-06T08:21:17,Bilbao,expenses,phone,-29.68,-37778.74
buyer_7,Agurtzane,Laka,1968-12-31,26592366L,agurtzane.laka@awesomecloud.co,463672,ES23209508102455354994,1990.94,2023-08-07T17:44:08,Bilbao,expenses,gas,-44.46,-37823.2
buyer_7,Agurtzane,Laka,1968-12-31,26592366L,agurtzane.laka@awesomecloud.co,463672,ES23209508102455354994,1990.94,2023-08-07T10:46:00,Bilbao,expenses,internet,-32.89,-37856.09
buyer_7,Agurtzane,Laka,1968-12-31,26592366L,agurtzane.laka@awesomecloud.co,463672,ES23209508102455354994,1990.94,2023-08-07T23:19:00,Bilbao,expenses,cash,-100.0,-37956.09
buyer_7,Agurtzane,Laka,1968-12-31,26592366L,agurtzane.laka@awesomecloud.co,463672,ES23209508102455354994,1990.94,2023-08-07T19:56:33,Bilbao,expenses,repairs,-281.51,-38237.6
buyer_7,Agurtzane,Laka,1968-12-31,26592366L,agurtzane.laka@awesomecloud.co,463672,ES23209508102455354994,1990.94,2023-08-08T08:11:07,Bilbao,expenses,gas,-36.97,-38274.57
buyer_7,Agurtzane,Laka,1968-12-31,26592366L,agurtzane.laka@awesomecloud.co,463672,ES23209508102455354994,1990.94,2023-08-08T23:51:12,Bilbao,expenses,phone,-29.39,-38303.96
buyer_7,Agurtzane,Laka,1968-12-31,26592366L,agurtzane.laka@awesomecloud.co,463672,ES23209508102455354994,1990.94,2023-08-10T16:12:06,Bilbao,expenses,food,-77.31,-38381.27
buyer_7,Agurtzane,Laka,1968-12-31,26592366L,agurtzane.laka@awesomecloud.co,463672,ES23209508102455354994,1990.94,2023-08-10T18:07:37,Bilbao,expenses,repairs,-286.79,-38668.06
buyer_7,Agurtzane,Laka,1968-12-31,26592366L,agurtzane.laka@awesomecloud.co,463672,ES23209508102455354994,1990.94,2023-08-11T00:03:43,Bilbao,expenses,food,-81.86,-38749.92
buyer_7,Agurtzane,Laka,1968-12-31,26592366L,agurtzane.laka@awesomecloud.co,463672,ES23209508102455354994,1990.94,2023-08-13T09:44:52,Bilbao,expenses,leisure,-50.99,-38800.91
buyer_7,Agurtzane,Laka,1968-12-31,26592366L,agurtzane.laka@awesomecloud.co,463672,ES23209508102455354994,1990.94,2023-08-14T14:43:47,Bilbao,expenses,travel,-410.33,-39211.24
buyer_7,Agurtzane,Laka,1968-12-31,26592366L,agurtzane.laka@awesomecloud.co,463672,ES23209508102455354994,1990.94,2023-08-16T21:10:50,Bilbao,expenses,gifts,-256.87,-39468.11
buyer_7,Agurtzane,Laka,1968-12-31,26592366L,agurtzane.laka@awesomecloud.co,463672,ES23209508102455354994,1990.94,2023-08-18T19:42:08,Bilbao,expenses,food,-99.44,-39567.55
buyer_7,Agurtzane,Laka,1968-12-31,26592366L,agurtzane.laka@awesomecloud.co,463672,ES23209508102455354994,1990.94,2023-08-18T11:35:15,Bilbao,expenses,cash,-100.0,-39667.55
buyer_7,Agurtzane,Laka,1968-12-31,26592366L,agurtzane.laka@awesomecloud.co,463672,ES23209508102455354994,1990.94,2023-08-21T02:24:29,Bilbao,expenses,healthcare,-136.13,-39803.68
buyer_7,Agurtzane,Laka,1968-12-31,26592366L,agurtzane.laka@awesomecloud.co,463672,ES23209508102455354994,1990.94,2023-08-21T13:23:12,Bilbao,expenses,cash,-100.0,-39903.68
buyer_7,Agurtzane,Laka,1968-12-31,26592366L,agurtzane.laka@awesomecloud.co,463672,ES23209508102455354994,1990.94,2023-08-21T09:17:17,Bilbao,expenses,gifts,-36.41,-39940.09
buyer_7,Agurtzane,Laka,1968-12-31,26592366L,agurtzane.laka@awesomecloud.co,463672,ES23209508102455354994,1990.94,2023-08-22T15:47:06,Bilbao,expenses,transport,-50.35,-39990.44
buyer_7,Agurtzane,Laka,1968-12-31,26592366L,agurtzane.laka@awesomecloud.co,463672,ES23209508102455354994,1990.94,2023-08-24T18:38:01,Bilbao,expenses,transport,-51.55,-40041.99
buyer_7,Agurtzane,Laka,1968-12-31,26592366L,agurtzane.laka@awesomecloud.co,463672,ES23209508102455354994,1990.94,2023-08-25T19:00:09,Bilbao,expenses,food,-117.99,-40159.98
buyer_7,Agurtzane,Laka,1968-12-31,26592366L,agurtzane.laka@awesomecloud.co,463672,ES23209508102455354994,1990.94,2023-08-25T10:39:55,Bilbao,expenses,gifts,-211.82,-40371.8
buyer_7,Agurtzane,Laka,1968-12-31,26592366L,agurtzane.laka@awesomecloud.co,463672,ES23209508102455354994,1990.94,2023-08-27T13:01:45,Bilbao,expenses,cash,-100.0,-40471.8
buyer_7,Agurtzane,Laka,1968-12-31,26592366L,agurtzane.laka@awesomecloud.co,463672,ES23209508102455354994,1990.94,2023-09-01T07:47:17,Bilbao,incomes,salary,1566.41,-38905.39
buyer_7,Agurtzane,Laka,1968-12-31,26592366L,agurtzane.laka@awesomecloud.co,463672,ES23209508102455354994,1990.94,2023-09-01T07:47:17,Bilbao,incomes,extra_income,185.75,-38719.64
buyer_7,Agurtzane,Laka,1968-12-31,26592366L,agurtzane.laka@awesomecloud.co,463672,ES23209508102455354994,1990.94,2023-09-02T13:44:04,Bilbao,expenses,transport,-55.1,-38774.74
buyer_7,Agurtzane,Laka,1968-12-31,26592366L,agurtzane.laka@awesomecloud.co,463672,ES23209508102455354994,1990.94,2023-09-03T16:55:56,Bilbao,expenses,cash,-100.0,-38874.74
buyer_7,Agurtzane,Laka,1968-12-31,26592366L,agurtzane.laka@awesomecloud.co,463672,ES23209508102455354994,1990.94,2023-09-03T23:39:17,Bilbao,expenses,appliances,-308.32,-39183.06
buyer_7,Agurtzane,Laka,1968-12-31,26592366L,agurtzane.laka@awesomecloud.co,463672,ES23209508102455354994,1990.94,2023-09-05T00:55:06,Bilbao,expenses,mortgage,-688.78,-39871.84
buyer_7,Agurtzane,Laka,1968-12-31,26592366L,agurtzane.laka@awesomecloud.co,463672,ES23209508102455354994,1990.94,2023-09-05T05:51:58,Bilbao,expenses,gas,-43.65,-39915.49
buyer_7,Agurtzane,Laka,1968-12-31,26592366L,agurtzane.laka@awesomecloud.co,463672,ES23209508102455354994,1990.94,2023-09-05T16:01:51,Bilbao,expenses,repairs,-89.81,-40005.3
buyer_7,Agurtzane,Laka,1968-12-31,26592366L,agurtzane.laka@awesomecloud.co,463672,ES23209508102455354994,1990.94,2023-09-06T12:20:35,Bilbao,expenses,clothing,-115.39,-40120.69
buyer_7,Agurtzane,Laka,1968-12-31,26592366L,agurtzane.laka@awesomecloud.co,463672,ES23209508102455354994,1990.94,2023-09-06T15:42:55,Bilbao,expenses,repairs,-136.65,-40257.34
buyer_7,Agurtzane,Laka,1968-12-31,26592366L,agurtzane.laka@awesomecloud.co,463672,ES23209508102455354994,1990.94,2023-09-07T23:04:31,Bilbao,expenses,water,-21.93,-40279.27
buyer_7,Agurtzane,Laka,1968-12-31,26592366L,agurtzane.laka@awesomecloud.co,463672,ES23209508102455354994,1990.94,2023-09-07T12:19:42,Bilbao,expenses,cash,-100.0,-40379.27
buyer_7,Agurtzane,Laka,1968-12-31,26592366L,agurtzane.laka@awesomecloud.co,463672,ES23209508102455354994,1990.94,2023-09-09T12:00:04,Bilbao,expenses,food,-61.14,-40440.41
buyer_7,Agurtzane,Laka,1968-12-31,26592366L,agurtzane.laka@awesomecloud.co,463672,ES23209508102455354994,1990.94,2023-09-11T19:30:04,Bilbao,expenses,food,-105.74,-40546.15
buyer_7,Agurtzane,Laka,1968-12-31,26592366L,agurtzane.laka@awesomecloud.co,463672,ES23209508102455354994,1990.94,2023-09-13T09:56:27,Bilbao,expenses,leisure,-62.08,-40608.23
buyer_7,Agurtzane,Laka,1968-12-31,26592366L,agurtzane.laka@awesomecloud.co,463672,ES23209508102455354994,1990.94,2023-09-13T15:33:54,Bilbao,expenses,cash,-100.0,-40708.23
buyer_7,Agurtzane,Laka,1968-12-31,26592366L,agurtzane.laka@awesomecloud.co,463672,ES23209508102455354994,1990.94,2023-09-14T11:54:56,Bilbao,expenses,leisure,-73.81,-40782.04
buyer_7,Agurtzane,Laka,1968-12-31,26592366L,agurtzane.laka@awesomecloud.co,463672,ES23209508102455354994,1990.94,2023-09-14T09:02:22,Bilbao,expenses,repairs,-91.9,-40873.94
buyer_7,Agurtzane,Laka,1968-12-31,26592366L,agurtzane.laka@awesomecloud.co,463672,ES23209508102455354994,1990.94,2023-09-15T09:02:30,Bilbao,expenses,transport,-70.62,-40944.56
buyer_7,Agurtzane,Laka,1968-12-31,26592366L,agurtzane.laka@awesomecloud.co,463672,ES23209508102455354994,1990.94,2023-09-16T13:40:45,Bilbao,expenses,food,-73.44,-41018.0
buyer_7,Agurtzane,Laka,1968-12-31,26592366L,agurtzane.laka@awesomecloud.co,463672,ES23209508102455354994,1990.94,2023-09-16T09:03:32,Bilbao,expenses,clothing,-106.0,-41124.0
buyer_7,Agurtzane,Laka,1968-12-31,26592366L,agurtzane.laka@awesomecloud.co,463672,ES23209508102455354994,1990.94,2023-09-17T11:15:22,Bilbao,expenses,clothing,-114.57,-41238.57
buyer_7,Agurtzane,Laka,1968-12-31,26592366L,agurtzane.laka@awesomecloud.co,463672,ES23209508102455354994,1990.94,2023-09-17T01:45:06,Bilbao,expenses,appliances,-279.48,-41518.05
buyer_7,Agurtzane,Laka,1968-12-31,26592366L,agurtzane.laka@awesomecloud.co,463672,ES23209508102455354994,1990.94,2023-09-19T20:32:25,Bilbao,expenses,transport,-48.5,-41566.55
buyer_7,Agurtzane,Laka,1968-12-31,26592366L,agurtzane.laka@awesomecloud.co,463672,ES23209508102455354994,1990.94,2023-09-21T19:17:37,Bilbao,expenses,transport,-52.04,-41618.59
buyer_7,Agurtzane,Laka,1968-12-31,26592366L,agurtzane.laka@awesomecloud.co,463672,ES23209508102455354994,1990.94,2023-09-21T17:05:30,Bilbao,expenses,children,-220.12,-41838.71
buyer_7,Agurtzane,Laka,1968-12-31,26592366L,agurtzane.laka@awesomecloud.co,463672,ES23209508102455354994,1990.94,2023-09-22T04:52:21,Bilbao,expenses,food,-94.4,-41933.11
buyer_7,Agurtzane,Laka,1968-12-31,26592366L,agurtzane.laka@awesomecloud.co,463672,ES23209508102455354994,1990.94,2023-09-25T09:39:11,Bilbao,expenses,clothing,-85.11,-42018.22
buyer_7,Agurtzane,Laka,1968-12-31,26592366L,agurtzane.laka@awesomecloud.co,463672,ES23209508102455354994,1990.94,2023-09-27T20:09:33,Bilbao,expenses,leisure,-35.92,-42054.14
buyer_7,Agurtzane,Laka,1968-12-31,26592366L,agurtzane.laka@awesomecloud.co,463672,ES23209508102455354994,1990.94,2023-09-27T09:46:38,Bilbao,expenses,cash,-100.0,-42154.14
buyer_7,Agurtzane,Laka,1968-12-31,26592366L,agurtzane.laka@awesomecloud.co,463672,ES23209508102455354994,1990.94,2023-09-28T10:51:19,Bilbao,expenses,cash,-100.0,-42254.14
buyer_7,Agurtzane,Laka,1968-12-31,26592366L,agurtzane.laka@awesomecloud.co,463672,ES23209508102455354994,1990.94,2023-09-29T11:58:54,Bilbao,expenses,leisure,-38.6,-42292.74
buyer_7,Agurtzane,Laka,1968-12-31,26592366L,agurtzane.laka@awesomecloud.co,463672,ES23209508102455354994,1990.94,2023-10-01T05:38:47,Bilbao,incomes,salary,1566.41,-40726.33
buyer_7,Agurtzane,Laka,1968-12-31,26592366L,agurtzane.laka@awesomecloud.co,463672,ES23209508102455354994,1990.94,2023-10-01T08:17:14,Bilbao,expenses,food,-116.32,-40842.65
buyer_7,Agurtzane,Laka,1968-12-31,26592366L,agurtzane.laka@awesomecloud.co,463672,ES23209508102455354994,1990.94,2023-10-01T02:13:21,Bilbao,expenses,cash,-100.0,-40942.65
buyer_7,Agurtzane,Laka,1968-12-31,26592366L,agurtzane.laka@awesomecloud.co,463672,ES23209508102455354994,1990.94,2023-10-01T09:42:38,Bilbao,expenses,appliances,-123.23,-41065.88
buyer_7,Agurtzane,Laka,1968-12-31,26592366L,agurtzane.laka@awesomecloud.co,463672,ES23209508102455354994,1990.94,2023-10-01T06:12:26,Bilbao,expenses,repairs,-34.33,-41100.21
buyer_7,Agurtzane,Laka,1968-12-31,26592366L,agurtzane.laka@awesomecloud.co,463672,ES23209508102455354994,1990.94,2023-10-02T08:33:58,Bilbao,expenses,repairs,-283.84,-41384.05
buyer_7,Agurtzane,Laka,1968-12-31,26592366L,agurtzane.laka@awesomecloud.co,463672,ES23209508102455354994,1990.94,2023-10-03T09:33:58,Bilbao,expenses,food,-117.42,-41501.47
buyer_7,Agurtzane,Laka,1968-12-31,26592366L,agurtzane.laka@awesomecloud.co,463672,ES23209508102455354994,1990.94,2023-10-03T17:48:59,Bilbao,expenses,cash,-100.0,-41601.47
buyer_7,Agurtzane,Laka,1968-12-31,26592366L,agurtzane.laka@awesomecloud.co,463672,ES23209508102455354994,1990.94,2023-10-04T16:08:20,Bilbao,expenses,clothing,-130.71,-41732.18
buyer_7,Agurtzane,Laka,1968-12-31,26592366L,agurtzane.laka@awesomecloud.co,463672,ES23209508102455354994,1990.94,2023-10-05T15:01:09,Bilbao,expenses,mortgage,-688.78,-42420.96
buyer_7,Agurtzane,Laka,1968-12-31,26592366L,agurtzane.laka@awesomecloud.co,463672,ES23209508102455354994,1990.94,2023-10-05T15:22:50,Bilbao,expenses,phone,-24.61,-42445.57
buyer_7,Agurtzane,Laka,1968-12-31,26592366L,agurtzane.laka@awesomecloud.co,463672,ES23209508102455354994,1990.94,2023-10-06T20:27:47,Bilbao,expenses,phone,-34.23,-42479.8
buyer_7,Agurtzane,Laka,1968-12-31,26592366L,agurtzane.laka@awesomecloud.co,463672,ES23209508102455354994,1990.94,2023-10-06T15:37:47,Bilbao,expenses,food,-124.11,-42603.91
buyer_7,Agurtzane,Laka,1968-12-31,26592366L,agurtzane.laka@awesomecloud.co,463672,ES23209508102455354994,1990.94,2023-10-07T07:37:11,Bilbao,expenses,phone,-26.32,-42630.23
buyer_7,Agurtzane,Laka,1968-12-31,26592366L,agurtzane.laka@awesomecloud.co,463672,ES23209508102455354994,1990.94,2023-10-07T19:16:03,Bilbao,expenses,clothing,-62.52,-42692.75
buyer_7,Agurtzane,Laka,1968-12-31,26592366L,agurtzane.laka@awesomecloud.co,463672,ES23209508102455354994,1990.94,2023-10-07T14:03:47,Bilbao,expenses,gifts,-215.73,-42908.48
buyer_7,Agurtzane,Laka,1968-12-31,26592366L,agurtzane.laka@awesomecloud.co,463672,ES23209508102455354994,1990.94,2023-10-08T18:55:50,Bilbao,expenses,water,-21.01,-42929.49
buyer_7,Agurtzane,Laka,1968-12-31,26592366L,agurtzane.laka@awesomecloud.co,463672,ES23209508102455354994,1990.94,2023-10-08T23:21:11,Bilbao,expenses,leisure,-69.34,-42998.83
buyer_7,Agurtzane,Laka,1968-12-31,26592366L,agurtzane.laka@awesomecloud.co,463672,ES23209508102455354994,1990.94,2023-10-10T14:44:43,Bilbao,expenses,food,-124.95,-43123.78
buyer_7,Agurtzane,Laka,1968-12-31,26592366L,agurtzane.laka@awesomecloud.co,463672,ES23209508102455354994,1990.94,2023-10-10T12:17:54,Bilbao,expenses,cash,-100.0,-43223.78
buyer_7,Agurtzane,Laka,1968-12-31,26592366L,agurtzane.laka@awesomecloud.co,463672,ES23209508102455354994,1990.94,2023-10-13T09:26:25,Bilbao,expenses,leisure,-56.33,-43280.11
buyer_7,Agurtzane,Laka,1968-12-31,26592366L,agurtzane.laka@awesomecloud.co,463672,ES23209508102455354994,1990.94,2023-10-14T15:39:01,Bilbao,expenses,cash,-100.0,-43380.11
buyer_7,Agurtzane,Laka,1968-12-31,26592366L,agurtzane.laka@awesomecloud.co,463672,ES23209508102455354994,1990.94,2023-10-16T19:25:18,Bilbao,expenses,transport,-46.38,-43426.49
buyer_7,Agurtzane,Laka,1968-12-31,26592366L,agurtzane.laka@awesomecloud.co,463672,ES23209508102455354994,1990.94,2023-10-16T00:07:19,Bilbao,expenses,clothing,-118.99,-43545.48
buyer_7,Agurtzane,Laka,1968-12-31,26592366L,agurtzane.laka@awesomecloud.co,463672,ES23209508102455354994,1990.94,2023-10-17T09:32:23,Bilbao,expenses,repairs,-136.31,-43681.79
buyer_7,Agurtzane,Laka,1968-12-31,26592366L,agurtzane.laka@awesomecloud.co,463672,ES23209508102455354994,1990.94,2023-10-20T19:06:00,Bilbao,expenses,leisure,-76.35,-43758.14
buyer_7,Agurtzane,Laka,1968-12-31,26592366L,agurtzane.laka@awesomecloud.co,463672,ES23209508102455354994,1990.94,2023-10-20T08:31:09,Bilbao,expenses,healthcare,-187.95,-43946.09
buyer_7,Agurtzane,Laka,1968-12-31,26592366L,agurtzane.laka@awesomecloud.co,463672,ES23209508102455354994,1990.94,2023-10-21T16:55:46,Bilbao,expenses,food,-118.26,-44064.35
buyer_7,Agurtzane,Laka,1968-12-31,26592366L,agurtzane.laka@awesomecloud.co,463672,ES23209508102455354994,1990.94,2023-10-24T18:06:43,Bilbao,expenses,cash,-100.0,-44164.35
buyer_7,Agurtzane,Laka,1968-12-31,26592366L,agurtzane.laka@awesomecloud.co,463672,ES23209508102455354994,1990.94,2023-10-26T08:00:22,Bilbao,expenses,repairs,-116.18,-44280.53
buyer_7,Agurtzane,Laka,1968-12-31,26592366L,agurtzane.laka@awesomecloud.co,463672,ES23209508102455354994,1990.94,2023-10-27T04:57:30,Bilbao,expenses,transport,-73.7,-44354.23
buyer_7,Agurtzane,Laka,1968-12-31,26592366L,agurtzane.laka@awesomecloud.co,463672,ES23209508102455354994,1990.94,2023-10-27T20:49:38,Bilbao,expenses,cash,-100.0,-44454.23
buyer_7,Agurtzane,Laka,1968-12-31,26592366L,agurtzane.laka@awesomecloud.co,463672,ES23209508102455354994,1990.94,2023-10-28T18:04:14,Bilbao,expenses,cash,-100.0,-44554.23
buyer_7,Agurtzane,Laka,1968-12-31,26592366L,agurtzane.laka@awesomecloud.co,463672,ES23209508102455354994,1990.94,2023-10-28T09:14:38,Bilbao,expenses,repairs,-27.58,-44581.81
buyer_7,Agurtzane,Laka,1968-12-31,26592366L,agurtzane.laka@awesomecloud.co,463672,ES23209508102455354994,1990.94,2023-10-30T08:18:34,Bilbao,expenses,clothing,-53.1,-44634.91
buyer_7,Agurtzane,Laka,1968-12-31,26592366L,agurtzane.laka@awesomecloud.co,463672,ES23209508102455354994,1990.94,2023-10-30T08:57:33,Bilbao,expenses,healthcare,-100.73,-44735.64
buyer_7,Agurtzane,Laka,1968-12-31,26592366L,agurtzane.laka@awesomecloud.co,463672,ES23209508102455354994,1990.94,2023-10-31T08:06:53,Bilbao,expenses,leisure,-68.62,-44804.26
buyer_7,Agurtzane,Laka,1968-12-31,26592366L,agurtzane.laka@awesomecloud.co,463672,ES23209508102455354994,1990.94,2023-10-31T10:34:47,Bilbao,expenses,cash,-100.0,-44904.26
buyer_7,Agurtzane,Laka,1968-12-31,26592366L,agurtzane.laka@awesomecloud.co,463672,ES23209508102455354994,1990.94,2023-11-01T16:43:21,Bilbao,incomes,salary,1566.41,-43337.85
buyer_7,Agurtzane,Laka,1968-12-31,26592366L,agurtzane.laka@awesomecloud.co,463672,ES23209508102455354994,1990.94,2023-11-05T14:20:46,Bilbao,expenses,mortgage,-688.78,-44026.63
buyer_7,Agurtzane,Laka,1968-12-31,26592366L,agurtzane.laka@awesomecloud.co,463672,ES23209508102455354994,1990.94,2023-11-05T09:39:19,Bilbao,expenses,phone,-25.24,-44051.87
buyer_7,Agurtzane,Laka,1968-12-31,26592366L,agurtzane.laka@awesomecloud.co,463672,ES23209508102455354994,1990.94,2023-11-06T06:10:00,Bilbao,expenses,electricity,-38.77,-44090.64
buyer_7,Agurtzane,Laka,1968-12-31,26592366L,agurtzane.laka@awesomecloud.co,463672,ES23209508102455354994,1990.94,2023-11-07T19:03:47,Bilbao,expenses,food,-79.16,-44169.8
buyer_7,Agurtzane,Laka,1968-12-31,26592366L,agurtzane.laka@awesomecloud.co,463672,ES23209508102455354994,1990.94,2023-11-07T09:44:18,Bilbao,expenses,cash,-100.0,-44269.8
buyer_7,Agurtzane,Laka,1968-12-31,26592366L,agurtzane.laka@awesomecloud.co,463672,ES23209508102455354994,1990.94,2023-11-08T22:21:01,Bilbao,expenses,water,-23.51,-44293.31
buyer_7,Agurtzane,Laka,1968-12-31,26592366L,agurtzane.laka@awesomecloud.co,463672,ES23209508102455354994,1990.94,2023-11-08T19:27:49,Bilbao,expenses,internet,-32.89,-44326.2
buyer_7,Agurtzane,Laka,1968-12-31,26592366L,agurtzane.laka@awesomecloud.co,463672,ES23209508102455354994,1990.94,2023-11-08T20:00:32,Bilbao,expenses,clothing,-120.13,-44446.33
buyer_7,Agurtzane,Laka,1968-12-31,26592366L,agurtzane.laka@awesomecloud.co,463672,ES23209508102455354994,1990.94,2023-11-08T01:16:19,Bilbao,expenses,children,-172.2,-44618.53
buyer_7,Agurtzane,Laka,1968-12-31,26592366L,agurtzane.laka@awesomecloud.co,463672,ES23209508102455354994,1990.94,2023-11-09T16:52:23,Bilbao,expenses,cash,-100.0,-44718.53
buyer_7,Agurtzane,Laka,1968-12-31,26592366L,agurtzane.laka@awesomecloud.co,463672,ES23209508102455354994,1990.94,2023-11-11T13:09:18,Bilbao,expenses,transport,-75.04,-44793.57
buyer_7,Agurtzane,Laka,1968-12-31,26592366L,agurtzane.laka@awesomecloud.co,463672,ES23209508102455354994,1990.94,2023-11-11T23:02:34,Bilbao,expenses,education,-45.73,-44839.3
buyer_7,Agurtzane,Laka,1968-12-31,26592366L,agurtzane.laka@awesomecloud.co,463672,ES23209508102455354994,1990.94,2023-11-14T13:13:36,Bilbao,expenses,clothing,-80.89,-44920.19
buyer_7,Agurtzane,Laka,1968-12-31,26592366L,agurtzane.laka@awesomecloud.co,463672,ES23209508102455354994,1990.94,2023-11-15T11:08:56,Bilbao,expenses,food,-70.77,-44990.96
buyer_7,Agurtzane,Laka,1968-12-31,26592366L,agurtzane.laka@awesomecloud.co,463672,ES23209508102455354994,1990.94,2023-11-15T00:08:55,Bilbao,expenses,healthcare,-83.87,-45074.83
buyer_7,Agurtzane,Laka,1968-12-31,26592366L,agurtzane.laka@awesomecloud.co,463672,ES23209508102455354994,1990.94,2023-11-16T20:58:55,Bilbao,expenses,cash,-100.0,-45174.83
buyer_7,Agurtzane,Laka,1968-12-31,26592366L,agurtzane.laka@awesomecloud.co,463672,ES23209508102455354994,1990.94,2023-11-17T09:04:44,Bilbao,expenses,food,-96.33,-45271.16
buyer_7,Agurtzane,Laka,1968-12-31,26592366L,agurtzane.laka@awesomecloud.co,463672,ES23209508102455354994,1990.94,2023-11-18T09:12:50,Bilbao,expenses,cash,-100.0,-45371.16
buyer_7,Agurtzane,Laka,1968-12-31,26592366L,agurtzane.laka@awesomecloud.co,463672,ES23209508102455354994,1990.94,2023-11-19T13:37:30,Bilbao,expenses,transport,-89.86,-45461.02
buyer_7,Agurtzane,Laka,1968-12-31,26592366L,agurtzane.laka@awesomecloud.co,463672,ES23209508102455354994,1990.94,2023-11-19T17:40:11,Bilbao,expenses,leisure,-42.7,-45503.72
buyer_7,Agurtzane,Laka,1968-12-31,26592366L,agurtzane.laka@awesomecloud.co,463672,ES23209508102455354994,1990.94,2023-11-22T16:00:05,Bilbao,expenses,clothing,-139.84,-45643.56
buyer_7,Agurtzane,Laka,1968-12-31,26592366L,agurtzane.laka@awesomecloud.co,463672,ES23209508102455354994,1990.94,2023-11-23T14:40:42,Bilbao,expenses,food,-71.12,-45714.68
buyer_7,Agurtzane,Laka,1968-12-31,26592366L,agurtzane.laka@awesomecloud.co,463672,ES23209508102455354994,1990.94,2023-11-23T14:01:14,Bilbao,expenses,appliances,-204.63,-45919.31
buyer_7,Agurtzane,Laka,1968-12-31,26592366L,agurtzane.laka@awesomecloud.co,463672,ES23209508102455354994,1990.94,2023-11-24T16:26:11,Bilbao,expenses,transport,-46.95,-45966.26
buyer_7,Agurtzane,Laka,1968-12-31,26592366L,agurtzane.laka@awesomecloud.co,463672,ES23209508102455354994,1990.94,2023-11-25T14:40:36,Bilbao,expenses,repairs,-329.99,-46296.25
buyer_7,Agurtzane,Laka,1968-12-31,26592366L,agurtzane.laka@awesomecloud.co,463672,ES23209508102455354994,1990.94,2023-11-27T08:13:55,Bilbao,expenses,leisure,-55.66,-46351.91
buyer_7,Agurtzane,Laka,1968-12-31,26592366L,agurtzane.laka@awesomecloud.co,463672,ES23209508102455354994,1990.94,2023-11-29T19:06:03,Bilbao,expenses,cash,-100.0,-46451.91
buyer_7,Agurtzane,Laka,1968-12-31,26592366L,agurtzane.laka@awesomecloud.co,463672,ES23209508102455354994,1990.94,2023-11-30T11:26:15,Bilbao,expenses,cash,-100.0,-46551.91
buyer_7,Agurtzane,Laka,1968-12-31,26592366L,agurtzane.laka@awesomecloud.co,463672,ES23209508102455354994,1990.94,2023-11-30T20:11:26,Bilbao,expenses,children,-308.49,-46860.4
buyer_7,Agurtzane,Laka,1968-12-31,26592366L,agurtzane.laka@awesomecloud.co,463672,ES23209508102455354994,1990.94,2023-12-01T19:28:57,Bilbao,incomes,salary,1566.41,-45293.99
buyer_7,Agurtzane,Laka,1968-12-31,26592366L,agurtzane.laka@awesomecloud.co,463672,ES23209508102455354994,1990.94,2023-12-01T19:28:57,Bilbao,incomes,extra_income,185.75,-45108.24
buyer_7,Agurtzane,Laka,1968-12-31,26592366L,agurtzane.laka@awesomecloud.co,463672,ES23209508102455354994,1990.94,2023-12-01T19:28:57,Bilbao,incomes,salary_bonus,1179.33,-43928.91
buyer_7,Agurtzane,Laka,1968-12-31,26592366L,agurtzane.laka@awesomecloud.co,463672,ES23209508102455354994,1990.94,2023-12-01T21:54:11,Bilbao,expenses,leisure,-32.59,-43961.5
buyer_7,Agurtzane,Laka,1968-12-31,26592366L,agurtzane.laka@awesomecloud.co,463672,ES23209508102455354994,1990.94,2023-12-01T10:20:42,Bilbao,expenses,clothing,-129.31,-44090.81
buyer_7,Agurtzane,Laka,1968-12-31,26592366L,agurtzane.laka@awesomecloud.co,463672,ES23209508102455354994,1990.94,2023-12-01T13:11:43,Bilbao,expenses,cash,-100.0,-44190.81
buyer_7,Agurtzane,Laka,1968-12-31,26592366L,agurtzane.laka@awesomecloud.co,463672,ES23209508102455354994,1990.94,2023-12-01T00:33:11,Bilbao,expenses,travel,-184.45,-44375.26
buyer_7,Agurtzane,Laka,1968-12-31,26592366L,agurtzane.laka@awesomecloud.co,463672,ES23209508102455354994,1990.94,2023-12-02T15:37:46,Bilbao,expenses,repairs,-316.54,-44691.8
buyer_7,Agurtzane,Laka,1968-12-31,26592366L,agurtzane.laka@awesomecloud.co,463672,ES23209508102455354994,1990.94,2023-12-03T20:04:29,Bilbao,expenses,children,-203.5,-44895.3
buyer_7,Agurtzane,Laka,1968-12-31,26592366L,agurtzane.laka@awesomecloud.co,463672,ES23209508102455354994,1990.94,2023-12-05T15:02:21,Bilbao,expenses,mortgage,-688.78,-45584.08
buyer_7,Agurtzane,Laka,1968-12-31,26592366L,agurtzane.laka@awesomecloud.co,463672,ES23209508102455354994,1990.94,2023-12-05T14:24:53,Bilbao,expenses,food,-71.18,-45655.26
buyer_7,Agurtzane,Laka,1968-12-31,26592366L,agurtzane.laka@awesomecloud.co,463672,ES23209508102455354994,1990.94,2023-12-05T11:18:14,Bilbao,expenses,travel,-341.4,-45996.66
buyer_7,Agurtzane,Laka,1968-12-31,26592366L,agurtzane.laka@awesomecloud.co,463672,ES23209508102455354994,1990.94,2023-12-06T12:59:12,Bilbao,expenses,gas,-77.82,-46074.48
buyer_7,Agurtzane,Laka,1968-12-31,26592366L,agurtzane.laka@awesomecloud.co,463672,ES23209508102455354994,1990.94,2023-12-06T11:21:34,Bilbao,expenses,phone,-28.3,-46102.78
buyer_7,Agurtzane,Laka,1968-12-31,26592366L,agurtzane.laka@awesomecloud.co,463672,ES23209508102455354994,1990.94,2023-12-06T15:38:14,Bilbao,expenses,transport,-86.24,-46189.02
buyer_7,Agurtzane,Laka,1968-12-31,26592366L,agurtzane.laka@awesomecloud.co,463672,ES23209508102455354994,1990.94,2023-12-06T15:26:36,Bilbao,expenses,education,-44.43,-46233.45
buyer_7,Agurtzane,Laka,1968-12-31,26592366L,agurtzane.laka@awesomecloud.co,463672,ES23209508102455354994,1990.94,2023-12-07T15:51:28,Bilbao,expenses,water,-20.26,-46253.71
buyer_7,Agurtzane,Laka,1968-12-31,26592366L,agurtzane.laka@awesomecloud.co,463672,ES23209508102455354994,1990.94,2023-12-07T20:25:54,Bilbao,expenses,cash,-100.0,-46353.71
buyer_7,Agurtzane,Laka,1968-12-31,26592366L,agurtzane.laka@awesomecloud.co,463672,ES23209508102455354994,1990.94,2023-12-08T11:24:15,Bilbao,expenses,leisure,-64.44,-46418.15
buyer_7,Agurtzane,Laka,1968-12-31,26592366L,agurtzane.laka@awesomecloud.co,463672,ES23209508102455354994,1990.94,2023-12-10T10:25:58,Bilbao,expenses,transport,-88.04,-46506.19
buyer_7,Agurtzane,Laka,1968-12-31,26592366L,agurtzane.laka@awesomecloud.co,463672,ES23209508102455354994,1990.94,2023-12-10T10:20:02,Bilbao,expenses,gifts,-238.09,-46744.28
buyer_7,Agurtzane,Laka,1968-12-31,26592366L,agurtzane.laka@awesomecloud.co,463672,ES23209508102455354994,1990.94,2023-12-11T17:23:06,Bilbao,expenses,children,-149.4,-46893.68
buyer_7,Agurtzane,Laka,1968-12-31,26592366L,agurtzane.laka@awesomecloud.co,463672,ES23209508102455354994,1990.94,2023-12-12T12:50:18,Bilbao,expenses,leisure,-74.45,-46968.13
buyer_7,Agurtzane,Laka,1968-12-31,26592366L,agurtzane.laka@awesomecloud.co,463672,ES23209508102455354994,1990.94,2023-12-13T05:09:24,Bilbao,expenses,gifts,-153.38,-47121.51
buyer_7,Agurtzane,Laka,1968-12-31,26592366L,agurtzane.laka@awesomecloud.co,463672,ES23209508102455354994,1990.94,2023-12-18T09:15:39,Bilbao,expenses,leisure,-45.1,-47166.61
buyer_7,Agurtzane,Laka,1968-12-31,26592366L,agurtzane.laka@awesomecloud.co,463672,ES23209508102455354994,1990.94,2023-12-20T18:05:55,Bilbao,expenses,food,-95.05,-47261.66
buyer_7,Agurtzane,Laka,1968-12-31,26592366L,agurtzane.laka@awesomecloud.co,463672,ES23209508102455354994,1990.94,2023-12-21T07:38:25,Bilbao,expenses,children,-307.29,-47568.95
buyer_7,Agurtzane,Laka,1968-12-31,26592366L,agurtzane.laka@awesomecloud.co,463672,ES23209508102455354994,1990.94,2023-12-22T09:56:24,Bilbao,expenses,transport,-82.55,-47651.5
buyer_7,Agurtzane,Laka,1968-12-31,26592366L,agurtzane.laka@awesomecloud.co,463672,ES23209508102455354994,1990.94,2023-12-23T17:27:34,Bilbao,expenses,food,-92.15,-47743.65
buyer_7,Agurtzane,Laka,1968-12-31,26592366L,agurtzane.laka@awesomecloud.co,463672,ES23209508102455354994,1990.94,2023-12-23T16:30:19,Bilbao,expenses,cash,-100.0,-47843.65
buyer_7,Agurtzane,Laka,1968-12-31,26592366L,agurtzane.laka@awesomecloud.co,463672,ES23209508102455354994,1990.94,2023-12-24T20:32:16,Bilbao,expenses,cash,-100.0,-47943.65
buyer_7,Agurtzane,Laka,1968-12-31,26592366L,agurtzane.laka@awesomecloud.co,463672,ES23209508102455354994,1990.94,2023-12-25T13:22:27,Bilbao,expenses,food,-105.25,-48048.9
buyer_7,Agurtzane,Laka,1968-12-31,26592366L,agurtzane.laka@awesomecloud.co,463672,ES23209508102455354994,1990.94,2023-12-25T12:43:28,Bilbao,expenses,clothing,-77.03,-48125.93
buyer_7,Agurtzane,Laka,1968-12-31,26592366L,agurtzane.laka@awesomecloud.co,463672,ES23209508102455354994,1990.94,2023-12-26T12:47:26,Bilbao,expenses,food,-105.05,-48230.98
buyer_7,Agurtzane,Laka,1968-12-31,26592366L,agurtzane.laka@awesomecloud.co,463672,ES23209508102455354994,1990.94,2023-12-27T15:43:25,Bilbao,expenses,food,-67.68,-48298.66
buyer_7,Agurtzane,Laka,1968-12-31,26592366L,agurtzane.laka@awesomecloud.co,463672,ES23209508102455354994,1990.94,2023-12-27T03:52:55,Bilbao,expenses,healthcare,-158.49,-48457.15
buyer_7,Agurtzane,Laka,1968-12-31,26592366L,agurtzane.laka@awesomecloud.co,463672,ES23209508102455354994,1990.94,2023-12-27T20:35:08,Bilbao,expenses,cash,-100.0,-48557.15
buyer_7,Agurtzane,Laka,1968-12-31,26592366L,agurtzane.laka@awesomecloud.co,463672,ES23209508102455354994,1990.94,2023-12-28T11:24:37,Bilbao,expenses,education,-72.07,-48629.22
buyer_7,Agurtzane,Laka,1968-12-31,26592366L,agurtzane.laka@awesomecloud.co,463672,ES23209508102455354994,1990.94,2023-12-28T15:14:28,Bilbao,expenses,appliances,-210.09,-48839.31
buyer_7,Agurtzane,Laka,1968-12-31,26592366L,agurtzane.laka@awesomecloud.co,463672,ES23209508102455354994,1990.94,2023-12-30T09:32:49,Bilbao,expenses,food,-119.32,-48958.63
buyer_7,Agurtzane,Laka,1968-12-31,26592366L,agurtzane.laka@awesomecloud.co,463672,ES23209508102455354994,1990.94,2023-12-31T02:57:05,Bilbao,expenses,appliances,-223.86,-49182.49
buyer_7,Agurtzane,Laka,1968-12-31,26592366L,agurtzane.laka@awesomecloud.co,463672,ES23209508102455354994,1990.94,2024-01-01T16:40:03,Bilbao,incomes,salary,1613.33,-47569.16
buyer_7,Agurtzane,Laka,1968-12-31,26592366L,agurtzane.laka@awesomecloud.co,463672,ES23209508102455354994,1990.94,2024-01-01T16:04:57,Bilbao,expenses,cash,-100.0,-47669.16
buyer_7,Agurtzane,Laka,1968-12-31,26592366L,agurtzane.laka@awesomecloud.co,463672,ES23209508102455354994,1990.94,2024-01-02T15:04:00,Bilbao,expenses,transport,-78.74,-47747.9
buyer_7,Agurtzane,Laka,1968-12-31,26592366L,agurtzane.laka@awesomecloud.co,463672,ES23209508102455354994,1990.94,2024-01-02T12:12:47,Bilbao,expenses,appliances,-95.81,-47843.71
buyer_7,Agurtzane,Laka,1968-12-31,26592366L,agurtzane.laka@awesomecloud.co,463672,ES23209508102455354994,1990.94,2024-01-03T20:23:31,Bilbao,expenses,appliances,-309.29,-48153.0
buyer_7,Agurtzane,Laka,1968-12-31,26592366L,agurtzane.laka@awesomecloud.co,463672,ES23209508102455354994,1990.94,2024-01-04T10:26:15,Bilbao,expenses,repairs,-60.17,-48213.17
buyer_7,Agurtzane,Laka,1968-12-31,26592366L,agurtzane.laka@awesomecloud.co,463672,ES23209508102455354994,1990.94,2024-01-05T03:49:45,Bilbao,expenses,mortgage,-824.16,-49037.33
buyer_7,Agurtzane,Laka,1968-12-31,26592366L,agurtzane.laka@awesomecloud.co,463672,ES23209508102455354994,1990.94,2024-01-05T14:58:47,Bilbao,expenses,electricity,-36.05,-49073.38
buyer_7,Agurtzane,Laka,1968-12-31,26592366L,agurtzane.laka@awesomecloud.co,463672,ES23209508102455354994,1990.94,2024-01-05T20:36:59,Bilbao,expenses,food,-79.23,-49152.61
buyer_7,Agurtzane,Laka,1968-12-31,26592366L,agurtzane.laka@awesomecloud.co,463672,ES23209508102455354994,1990.94,2024-01-05T10:54:07,Bilbao,expenses,cash,-100.0,-49252.61
buyer_7,Agurtzane,Laka,1968-12-31,26592366L,agurtzane.laka@awesomecloud.co,463672,ES23209508102455354994,1990.94,2024-01-06T18:25:09,Bilbao,expenses,gas,-32.47,-49285.08
buyer_7,Agurtzane,Laka,1968-12-31,26592366L,agurtzane.laka@awesomecloud.co,463672,ES23209508102455354994,1990.94,2024-01-06T20:20:53,Bilbao,expenses,cash,-100.0,-49385.08
buyer_7,Agurtzane,Laka,1968-12-31,26592366L,agurtzane.laka@awesomecloud.co,463672,ES23209508102455354994,1990.94,2024-01-07T22:25:38,Bilbao,expenses,water,-33.29,-49418.37
buyer_7,Agurtzane,Laka,1968-12-31,26592366L,agurtzane.laka@awesomecloud.co,463672,ES23209508102455354994,1990.94,2024-01-08T15:51:56,Bilbao,expenses,phone,-35.95,-49454.32
buyer_7,Agurtzane,Laka,1968-12-31,26592366L,agurtzane.laka@awesomecloud.co,463672,ES23209508102455354994,1990.94,2024-01-08T15:38:32,Bilbao,expenses,leisure,-74.1,-49528.42
buyer_7,Agurtzane,Laka,1968-12-31,26592366L,agurtzane.laka@awesomecloud.co,463672,ES23209508102455354994,1990.94,2024-01-08T10:56:08,Bilbao,expenses,children,-284.78241666666656,-49813.2
buyer_7,Agurtzane,Laka,1968-12-31,26592366L,agurtzane.laka@awesomecloud.co,463672,ES23209508102455354994,1990.94,2024-01-10T06:41:04,Bilbao,expenses,transport,-75.37,-49888.57
buyer_7,Agurtzane,Laka,1968-12-31,26592366L,agurtzane.laka@awesomecloud.co,463672,ES23209508102455354994,1990.94,2024-01-10T22:46:00,Bilbao,expenses,clothing,-115.41,-50003.98
buyer_7,Agurtzane,Laka,1968-12-31,26592366L,agurtzane.laka@awesomecloud.co,463672,ES23209508102455354994,1990.94,2024-01-12T11:48:27,Bilbao,expenses,food,-106.56,-50110.54
buyer_7,Agurtzane,Laka,1968-12-31,26592366L,agurtzane.laka@awesomecloud.co,463672,ES23209508102455354994,1990.94,2024-01-14T06:14:55,Bilbao,expenses,food,-109.03,-50219.57
buyer_7,Agurtzane,Laka,1968-12-31,26592366L,agurtzane.laka@awesomecloud.co,463672,ES23209508102455354994,1990.94,2024-01-14T13:50:05,Bilbao,expenses,leisure,-39.76,-50259.33
buyer_7,Agurtzane,Laka,1968-12-31,26592366L,agurtzane.laka@awesomecloud.co,463672,ES23209508102455354994,1990.94,2024-01-15T22:24:26,Bilbao,expenses,cash,-100.0,-50359.33
buyer_7,Agurtzane,Laka,1968-12-31,26592366L,agurtzane.laka@awesomecloud.co,463672,ES23209508102455354994,1990.94,2024-01-16T07:17:28,Bilbao,expenses,leisure,-65.23,-50424.56
buyer_7,Agurtzane,Laka,1968-12-31,26592366L,agurtzane.laka@awesomecloud.co,463672,ES23209508102455354994,1990.94,2024-01-17T08:56:58,Bilbao,expenses,car,-179.7,-50604.26
buyer_7,Agurtzane,Laka,1968-12-31,26592366L,agurtzane.laka@awesomecloud.co,463672,ES23209508102455354994,1990.94,2024-01-19T08:34:03,Bilbao,expenses,appliances,-96.73,-50700.99
buyer_7,Agurtzane,Laka,1968-12-31,26592366L,agurtzane.laka@awesomecloud.co,463672,ES23209508102455354994,1990.94,2024-01-19T03:28:36,Bilbao,expenses,children,-262.15241666666657,-50963.14
buyer_7,Agurtzane,Laka,1968-12-31,26592366L,agurtzane.laka@awesomecloud.co,463672,ES23209508102455354994,1990.94,2024-01-20T13:59:17,Bilbao,expenses,food,-115.2,-51078.34
buyer_7,Agurtzane,Laka,1968-12-31,26592366L,agurtzane.laka@awesomecloud.co,463672,ES23209508102455354994,1990.94,2024-01-21T17:35:44,Bilbao,expenses,cash,-100.0,-51178.34
buyer_7,Agurtzane,Laka,1968-12-31,26592366L,agurtzane.laka@awesomecloud.co,463672,ES23209508102455354994,1990.94,2024-01-22T10:01:00,Bilbao,expenses,children,-315.15,-51493.49
buyer_7,Agurtzane,Laka,1968-12-31,26592366L,agurtzane.laka@awesomecloud.co,463672,ES23209508102455354994,1990.94,2024-01-23T19:25:16,Bilbao,expenses,travel,-309.44,-51802.93
buyer_7,Agurtzane,Laka,1968-12-31,26592366L,agurtzane.laka@awesomecloud.co,463672,ES23209508102455354994,1990.94,2024-01-25T13:28:01,Bilbao,expenses,repairs,-189.05,-51991.98
buyer_7,Agurtzane,Laka,1968-12-31,26592366L,agurtzane.laka@awesomecloud.co,463672,ES23209508102455354994,1990.94,2024-01-26T14:00:50,Bilbao,expenses,gifts,-100.84,-52092.82
buyer_7,Agurtzane,Laka,1968-12-31,26592366L,agurtzane.laka@awesomecloud.co,463672,ES23209508102455354994,1990.94,2024-01-26T11:10:00,Bilbao,expenses,children,-258.04241666666655,-52350.86
buyer_7,Agurtzane,Laka,1968-12-31,26592366L,agurtzane.laka@awesomecloud.co,463672,ES23209508102455354994,1990.94,2024-01-27T17:54:22,Bilbao,expenses,appliances,-206.99,-52557.85
buyer_7,Agurtzane,Laka,1968-12-31,26592366L,agurtzane.laka@awesomecloud.co,463672,ES23209508102455354994,1990.94,2024-01-27T19:17:39,Bilbao,expenses,repairs,-54.3,-52612.15
buyer_7,Agurtzane,Laka,1968-12-31,26592366L,agurtzane.laka@awesomecloud.co,463672,ES23209508102455354994,1990.94,2024-01-29T22:10:24,Bilbao,expenses,food,-71.33,-52683.48
buyer_7,Agurtzane,Laka,1968-12-31,26592366L,agurtzane.laka@awesomecloud.co,463672,ES23209508102455354994,1990.94,2024-01-29T15:01:46,Bilbao,expenses,transport,-86.12,-52769.6
buyer_7,Agurtzane,Laka,1968-12-31,26592366L,agurtzane.laka@awesomecloud.co,463672,ES23209508102455354994,1990.94,2024-01-31T09:11:44,Bilbao,expenses,leisure,-51.55,-52821.15
buyer_7,Agurtzane,Laka,1968-12-31,26592366L,agurtzane.laka@awesomecloud.co,463672,ES23209508102455354994,1990.94,2024-01-31T13:19:25,Bilbao,expenses,cash,-100.0,-52921.15
buyer_7,Agurtzane,Laka,1968-12-31,26592366L,agurtzane.laka@awesomecloud.co,463672,ES23209508102455354994,1990.94,2024-02-01T10:19:20,Bilbao,incomes,salary,1613.33,-51307.82
buyer_7,Agurtzane,Laka,1968-12-31,26592366L,agurtzane.laka@awesomecloud.co,463672,ES23209508102455354994,1990.94,2024-02-01T09:42:24,Bilbao,expenses,appliances,-326.36,-51634.18
buyer_7,Agurtzane,Laka,1968-12-31,26592366L,agurtzane.laka@awesomecloud.co,463672,ES23209508102455354994,1990.94,2024-02-03T09:14:31,Bilbao,expenses,repairs,-274.35,-51908.53
buyer_7,Agurtzane,Laka,1968-12-31,26592366L,agurtzane.laka@awesomecloud.co,463672,ES23209508102455354994,1990.94,2024-02-04T20:06:56,Bilbao,expenses,food,-62.05,-51970.58
buyer_7,Agurtzane,Laka,1968-12-31,26592366L,agurtzane.laka@awesomecloud.co,463672,ES23209508102455354994,1990.94,2024-02-04T10:27:04,Bilbao,expenses,repairs,-137.25,-52107.83
buyer_7,Agurtzane,Laka,1968-12-31,26592366L,agurtzane.laka@awesomecloud.co,463672,ES23209508102455354994,1990.94,2024-02-05T00:53:02,Bilbao,expenses,mortgage,-824.16,-52931.99
buyer_7,Agurtzane,Laka,1968-12-31,26592366L,agurtzane.laka@awesomecloud.co,463672,ES23209508102455354994,1990.94,2024-02-05T13:30:41,Bilbao,expenses,food,-94.78,-53026.77
buyer_7,Agurtzane,Laka,1968-12-31,26592366L,agurtzane.laka@awesomecloud.co,463672,ES23209508102455354994,1990.94,2024-02-05T19:45:33,Bilbao,expenses,clothing,-71.84,-53098.61
buyer_7,Agurtzane,Laka,1968-12-31,26592366L,agurtzane.laka@awesomecloud.co,463672,ES23209508102455354994,1990.94,2024-02-07T12:21:52,Bilbao,expenses,internet,-33.88,-53132.49
buyer_7,Agurtzane,Laka,1968-12-31,26592366L,agurtzane.laka@awesomecloud.co,463672,ES23209508102455354994,1990.94,2024-02-07T04:46:03,Bilbao,expenses,phone,-30.08,-53162.57
buyer_7,Agurtzane,Laka,1968-12-31,26592366L,agurtzane.laka@awesomecloud.co,463672,ES23209508102455354994,1990.94,2024-02-07T03:51:41,Bilbao,expenses,food,-75.99,-53238.56
buyer_7,Agurtzane,Laka,1968-12-31,26592366L,agurtzane.laka@awesomecloud.co,463672,ES23209508102455354994,1990.94,2024-02-08T16:06:32,Bilbao,expenses,internet,-33.88,-53272.44
buyer_7,Agurtzane,Laka,1968-12-31,26592366L,agurtzane.laka@awesomecloud.co,463672,ES23209508102455354994,1990.94,2024-02-08T17:17:27,Bilbao,expenses,phone,-24.97,-53297.41
buyer_7,Agurtzane,Laka,1968-12-31,26592366L,agurtzane.laka@awesomecloud.co,463672,ES23209508102455354994,1990.94,2024-02-08T10:37:48,Bilbao,expenses,repairs,-95.74,-53393.15
buyer_7,Agurtzane,Laka,1968-12-31,26592366L,agurtzane.laka@awesomecloud.co,463672,ES23209508102455354994,1990.94,2024-02-09T06:07:50,Bilbao,expenses,repairs,-72.93,-53466.08
buyer_7,Agurtzane,Laka,1968-12-31,26592366L,agurtzane.laka@awesomecloud.co,463672,ES23209508102455354994,1990.94,2024-02-10T13:00:12,Bilbao,expenses,leisure,-47.62,-53513.7
buyer_7,Agurtzane,Laka,1968-12-31,26592366L,agurtzane.laka@awesomecloud.co,463672,ES23209508102455354994,1990.94,2024-02-15T18:30:34,Bilbao,expenses,leisure,-28.98,-53542.68
buyer_7,Agurtzane,Laka,1968-12-31,26592366L,agurtzane.laka@awesomecloud.co,463672,ES23209508102455354994,1990.94,2024-02-15T12:21:36,Bilbao,expenses,cash,-100.0,-53642.68
buyer_7,Agurtzane,Laka,1968-12-31,26592366L,agurtzane.laka@awesomecloud.co,463672,ES23209508102455354994,1990.94,2024-02-16T12:44:40,Bilbao,expenses,repairs,-194.88,-53837.56
buyer_7,Agurtzane,Laka,1968-12-31,26592366L,agurtzane.laka@awesomecloud.co,463672,ES23209508102455354994,1990.94,2024-02-20T17:08:26,Bilbao,expenses,food,-93.16,-53930.72
buyer_7,Agurtzane,Laka,1968-12-31,26592366L,agurtzane.laka@awesomecloud.co,463672,ES23209508102455354994,1990.94,2024-02-22T10:59:25,Bilbao,expenses,transport,-48.14,-53978.86
buyer_7,Agurtzane,Laka,1968-12-31,26592366L,agurtzane.laka@awesomecloud.co,463672,ES23209508102455354994,1990.94,2024-02-23T19:54:48,Bilbao,expenses,cash,-100.0,-54078.86
buyer_7,Agurtzane,Laka,1968-12-31,26592366L,agurtzane.laka@awesomecloud.co,463672,ES23209508102455354994,1990.94,2024-02-27T23:03:39,Bilbao,expenses,food,-99.26,-54178.12
buyer_7,Agurtzane,Laka,1968-12-31,26592366L,agurtzane.laka@awesomecloud.co,463672,ES23209508102455354994,1990.94,2024-02-28T11:52:46,Bilbao,expenses,healthcare,-135.4,-54313.52
buyer_7,Agurtzane,Laka,1968-12-31,26592366L,agurtzane.laka@awesomecloud.co,463672,ES23209508102455354994,1990.94,2024-03-01T20:22:43,Bilbao,incomes,salary,1613.33,-52700.19
buyer_7,Agurtzane,Laka,1968-12-31,26592366L,agurtzane.laka@awesomecloud.co,463672,ES23209508102455354994,1990.94,2024-03-01T20:22:43,Bilbao,incomes,extra_income,185.75,-52514.44
buyer_7,Agurtzane,Laka,1968-12-31,26592366L,agurtzane.laka@awesomecloud.co,463672,ES23209508102455354994,1990.94,2024-03-01T11:20:29,Bilbao,expenses,food,-81.29,-52595.73
buyer_7,Agurtzane,Laka,1968-12-31,26592366L,agurtzane.laka@awesomecloud.co,463672,ES23209508102455354994,1990.94,2024-03-02T10:30:46,Bilbao,expenses,food,-108.5,-52704.23
buyer_7,Agurtzane,Laka,1968-12-31,26592366L,agurtzane.laka@awesomecloud.co,463672,ES23209508102455354994,1990.94,2024-03-04T11:04:59,Bilbao,expenses,food,-100.58,-52804.81
buyer_7,Agurtzane,Laka,1968-12-31,26592366L,agurtzane.laka@awesomecloud.co,463672,ES23209508102455354994,1990.94,2024-03-04T13:23:16,Bilbao,expenses,gifts,-77.19,-52882.0
buyer_7,Agurtzane,Laka,1968-12-31,26592366L,agurtzane.laka@awesomecloud.co,463672,ES23209508102455354994,1990.94,2024-03-05T01:42:29,Bilbao,expenses,mortgage,-824.16,-53706.16
buyer_7,Agurtzane,Laka,1968-12-31,26592366L,agurtzane.laka@awesomecloud.co,463672,ES23209508102455354994,1990.94,2024-03-05T11:09:27,Bilbao,expenses,water,-30.14,-53736.3
buyer_7,Agurtzane,Laka,1968-12-31,26592366L,agurtzane.laka@awesomecloud.co,463672,ES23209508102455354994,1990.94,2024-03-05T14:15:17,Bilbao,expenses,electricity,-23.01,-53759.31
buyer_7,Agurtzane,Laka,1968-12-31,26592366L,agurtzane.laka@awesomecloud.co,463672,ES23209508102455354994,1990.94,2024-03-05T09:57:52,Bilbao,expenses,gas,-39.93,-53799.24
buyer_7,Agurtzane,Laka,1968-12-31,26592366L,agurtzane.laka@awesomecloud.co,463672,ES23209508102455354994,1990.94,2024-03-05T18:18:10,Bilbao,expenses,phone,-32.45,-53831.69
buyer_7,Agurtzane,Laka,1968-12-31,26592366L,agurtzane.laka@awesomecloud.co,463672,ES23209508102455354994,1990.94,2024-03-05T17:12:36,Bilbao,expenses,food,-83.49,-53915.18
buyer_7,Agurtzane,Laka,1968-12-31,26592366L,agurtzane.laka@awesomecloud.co,463672,ES23209508102455354994,1990.94,2024-03-06T20:16:33,Bilbao,expenses,electricity,-28.82,-53944.0
buyer_7,Agurtzane,Laka,1968-12-31,26592366L,agurtzane.laka@awesomecloud.co,463672,ES23209508102455354994,1990.94,2024-03-06T14:48:58,Bilbao,expenses,gas,-37.68,-53981.68
buyer_7,Agurtzane,Laka,1968-12-31,26592366L,agurtzane.laka@awesomecloud.co,463672,ES23209508102455354994,1990.94,2024-03-06T15:43:26,Bilbao,expenses,internet,-33.88,-54015.56
buyer_7,Agurtzane,Laka,1968-12-31,26592366L,agurtzane.laka@awesomecloud.co,463672,ES23209508102455354994,1990.94,2024-03-06T23:42:34,Bilbao,expenses,phone,-36.16,-54051.72
buyer_7,Agurtzane,Laka,1968-12-31,26592366L,agurtzane.laka@awesomecloud.co,463672,ES23209508102455354994,1990.94,2024-03-07T20:28:35,Bilbao,expenses,electricity,-71.16,-54122.88
buyer_7,Agurtzane,Laka,1968-12-31,26592366L,agurtzane.laka@awesomecloud.co,463672,ES23209508102455354994,1990.94,2024-03-07T21:59:04,Bilbao,expenses,education,-50.86,-54173.74
buyer_7,Agurtzane,Laka,1968-12-31,26592366L,agurtzane.laka@awesomecloud.co,463672,ES23209508102455354994,1990.94,2024-03-08T16:22:30,Bilbao,expenses,water,-18.54,-54192.28
buyer_7,Agurtzane,Laka,1968-12-31,26592366L,agurtzane.laka@awesomecloud.co,463672,ES23209508102455354994,1990.94,2024-03-08T08:24:48,Bilbao,expenses,phone,-34.56,-54226.84
buyer_7,Agurtzane,Laka,1968-12-31,26592366L,agurtzane.laka@awesomecloud.co,463672,ES23209508102455354994,1990.94,2024-03-10T12:43:14,Bilbao,expenses,cash,-100.0,-54326.84
buyer_7,Agurtzane,Laka,1968-12-31,26592366L,agurtzane.laka@awesomecloud.co,463672,ES23209508102455354994,1990.94,2024-03-11T06:31:16,Bilbao,expenses,cash,-100.0,-54426.84
buyer_7,Agurtzane,Laka,1968-12-31,26592366L,agurtzane.laka@awesomecloud.co,463672,ES23209508102455354994,1990.94,2024-03-12T14:05:43,Bilbao,expenses,repairs,-208.38,-54635.22
buyer_7,Agurtzane,Laka,1968-12-31,26592366L,agurtzane.laka@awesomecloud.co,463672,ES23209508102455354994,1990.94,2024-03-17T08:54:40,Bilbao,expenses,food,-68.5,-54703.72
buyer_7,Agurtzane,Laka,1968-12-31,26592366L,agurtzane.laka@awesomecloud.co,463672,ES23209508102455354994,1990.94,2024-03-17T18:56:56,Bilbao,expenses,transport,-62.57,-54766.29
buyer_7,Agurtzane,Laka,1968-12-31,26592366L,agurtzane.laka@awesomecloud.co,463672,ES23209508102455354994,1990.94,2024-03-17T13:18:01,Bilbao,expenses,leisure,-37.39,-54803.68
buyer_7,Agurtzane,Laka,1968-12-31,26592366L,agurtzane.laka@awesomecloud.co,463672,ES23209508102455354994,1990.94,2024-03-18T01:01:10,Bilbao,expenses,food,-71.98,-54875.66
buyer_7,Agurtzane,Laka,1968-12-31,26592366L,agurtzane.laka@awesomecloud.co,463672,ES23209508102455354994,1990.94,2024-03-18T16:00:07,Bilbao,expenses,leisure,-31.05,-54906.71
buyer_7,Agurtzane,Laka,1968-12-31,26592366L,agurtzane.laka@awesomecloud.co,463672,ES23209508102455354994,1990.94,2024-03-20T20:26:14,Bilbao,expenses,cash,-100.0,-55006.71
buyer_7,Agurtzane,Laka,1968-12-31,26592366L,agurtzane.laka@awesomecloud.co,463672,ES23209508102455354994,1990.94,2024-03-21T16:12:22,Bilbao,expenses,appliances,-266.45,-55273.16
buyer_7,Agurtzane,Laka,1968-12-31,26592366L,agurtzane.laka@awesomecloud.co,463672,ES23209508102455354994,1990.94,2024-03-21T14:32:39,Bilbao,expenses,children,-74.39,-55347.55
buyer_7,Agurtzane,Laka,1968-12-31,26592366L,agurtzane.laka@awesomecloud.co,463672,ES23209508102455354994,1990.94,2024-03-22T15:14:22,Bilbao,expenses,clothing,-63.98,-55411.53
buyer_7,Agurtzane,Laka,1968-12-31,26592366L,agurtzane.laka@awesomecloud.co,463672,ES23209508102455354994,1990.94,2024-03-24T14:49:45,Bilbao,expenses,leisure,-78.81,-55490.34
buyer_7,Agurtzane,Laka,1968-12-31,26592366L,agurtzane.laka@awesomecloud.co,463672,ES23209508102455354994,1990.94,2024-03-27T11:00:20,Bilbao,expenses,food,-103.93,-55594.27
buyer_7,Agurtzane,Laka,1968-12-31,26592366L,agurtzane.laka@awesomecloud.co,463672,ES23209508102455354994,1990.94,2024-03-27T16:01:42,Bilbao,expenses,education,-77.83,-55672.1
buyer_7,Agurtzane,Laka,1968-12-31,26592366L,agurtzane.laka@awesomecloud.co,463672,ES23209508102455354994,1990.94,2024-03-29T15:30:32,Bilbao,expenses,cash,-100.0,-55772.1
buyer_7,Agurtzane,Laka,1968-12-31,26592366L,agurtzane.laka@awesomecloud.co,463672,ES23209508102455354994,1990.94,2024-03-31T10:39:00,Bilbao,expenses,children,-358.8824166666666,-56130.98
buyer_7,Agurtzane,Laka,1968-12-31,26592366L,agurtzane.laka@awesomecloud.co,463672,ES23209508102455354994,1990.94,2024-04-01T21:39:33,Bilbao,incomes,salary,1613.33,-54517.65
buyer_7,Agurtzane,Laka,1968-12-31,26592366L,agurtzane.laka@awesomecloud.co,463672,ES23209508102455354994,1990.94,2024-04-01T18:26:49,Bilbao,expenses,cash,-100.0,-54617.65
buyer_7,Agurtzane,Laka,1968-12-31,26592366L,agurtzane.laka@awesomecloud.co,463672,ES23209508102455354994,1990.94,2024-04-02T17:10:35,Bilbao,expenses,food,-78.13,-54695.78
buyer_7,Agurtzane,Laka,1968-12-31,26592366L,agurtzane.laka@awesomecloud.co,463672,ES23209508102455354994,1990.94,2024-04-04T13:31:49,Bilbao,expenses,food,-118.89,-54814.67
buyer_7,Agurtzane,Laka,1968-12-31,26592366L,agurtzane.laka@awesomecloud.co,463672,ES23209508102455354994,1990.94,2024-04-05T10:17:08,Bilbao,expenses,mortgage,-824.16,-55638.83
buyer_7,Agurtzane,Laka,1968-12-31,26592366L,agurtzane.laka@awesomecloud.co,463672,ES23209508102455354994,1990.94,2024-04-05T10:17:55,Bilbao,expenses,phone,-28.41,-55667.24
buyer_7,Agurtzane,Laka,1968-12-31,26592366L,agurtzane.laka@awesomecloud.co,463672,ES23209508102455354994,1990.94,2024-04-07T15:09:50,Bilbao,expenses,phone,-36.0,-55703.24
buyer_7,Agurtzane,Laka,1968-12-31,26592366L,agurtzane.laka@awesomecloud.co,463672,ES23209508102455354994,1990.94,2024-04-07T19:17:12,Bilbao,expenses,transport,-59.68,-55762.92
buyer_7,Agurtzane,Laka,1968-12-31,26592366L,agurtzane.laka@awesomecloud.co,463672,ES23209508102455354994,1990.94,2024-04-07T16:38:47,Bilbao,expenses,cash,-100.0,-55862.92
buyer_7,Agurtzane,Laka,1968-12-31,26592366L,agurtzane.laka@awesomecloud.co,463672,ES23209508102455354994,1990.94,2024-04-08T11:08:16,Bilbao,expenses,water,-23.51,-55886.43
buyer_7,Agurtzane,Laka,1968-12-31,26592366L,agurtzane.laka@awesomecloud.co,463672,ES23209508102455354994,1990.94,2024-04-08T10:14:29,Bilbao,expenses,gas,-81.71,-55968.14
buyer_7,Agurtzane,Laka,1968-12-31,26592366L,agurtzane.laka@awesomecloud.co,463672,ES23209508102455354994,1990.94,2024-04-08T19:48:48,Bilbao,expenses,internet,-33.88,-56002.02
buyer_7,Agurtzane,Laka,1968-12-31,26592366L,agurtzane.laka@awesomecloud.co,463672,ES23209508102455354994,1990.94,2024-04-09T14:50:50,Bilbao,expenses,gifts,-61.7,-56063.72
buyer_7,Agurtzane,Laka,1968-12-31,26592366L,agurtzane.laka@awesomecloud.co,463672,ES23209508102455354994,1990.94,2024-04-10T13:53:21,Bilbao,expenses,cash,-100.0,-56163.72
buyer_7,Agurtzane,Laka,1968-12-31,26592366L,agurtzane.laka@awesomecloud.co,463672,ES23209508102455354994,1990.94,2024-04-10T16:28:34,Bilbao,expenses,repairs,-76.82,-56240.54
buyer_7,Agurtzane,Laka,1968-12-31,26592366L,agurtzane.laka@awesomecloud.co,463672,ES23209508102455354994,1990.94,2024-04-11T11:48:23,Bilbao,expenses,transport,-73.28,-56313.82
buyer_7,Agurtzane,Laka,1968-12-31,26592366L,agurtzane.laka@awesomecloud.co,463672,ES23209508102455354994,1990.94,2024-04-11T19:18:07,Bilbao,expenses,leisure,-19.57,-56333.39
buyer_7,Agurtzane,Laka,1968-12-31,26592366L,agurtzane.laka@awesomecloud.co,463672,ES23209508102455354994,1990.94,2024-04-11T10:01:24,Bilbao,expenses,cash,-100.0,-56433.39
buyer_7,Agurtzane,Laka,1968-12-31,26592366L,agurtzane.laka@awesomecloud.co,463672,ES23209508102455354994,1990.94,2024-04-13T21:16:53,Bilbao,expenses,cash,-100.0,-56533.39
buyer_7,Agurtzane,Laka,1968-12-31,26592366L,agurtzane.laka@awesomecloud.co,463672,ES23209508102455354994,1990.94,2024-04-13T08:16:59,Bilbao,expenses,children,-75.32,-56608.71
buyer_7,Agurtzane,Laka,1968-12-31,26592366L,agurtzane.laka@awesomecloud.co,463672,ES23209508102455354994,1990.94,2024-04-14T16:44:50,Bilbao,expenses,repairs,-271.9,-56880.61
buyer_7,Agurtzane,Laka,1968-12-31,26592366L,agurtzane.laka@awesomecloud.co,463672,ES23209508102455354994,1990.94,2024-04-15T16:22:47,Bilbao,expenses,transport,-46.61,-56927.22
buyer_7,Agurtzane,Laka,1968-12-31,26592366L,agurtzane.laka@awesomecloud.co,463672,ES23209508102455354994,1990.94,2024-04-17T14:36:21,Bilbao,expenses,transport,-42.58,-56969.8
buyer_7,Agurtzane,Laka,1968-12-31,26592366L,agurtzane.laka@awesomecloud.co,463672,ES23209508102455354994,1990.94,2024-04-18T13:50:34,Bilbao,expenses,healthcare,-113.39,-57083.19
buyer_7,Agurtzane,Laka,1968-12-31,26592366L,agurtzane.laka@awesomecloud.co,463672,ES23209508102455354994,1990.94,2024-04-19T14:05:33,Bilbao,expenses,children,-112.4,-57195.59
buyer_7,Agurtzane,Laka,1968-12-31,26592366L,agurtzane.laka@awesomecloud.co,463672,ES23209508102455354994,1990.94,2024-04-20T16:28:50,Bilbao,expenses,leisure,-52.33,-57247.92
buyer_7,Agurtzane,Laka,1968-12-31,26592366L,agurtzane.laka@awesomecloud.co,463672,ES23209508102455354994,1990.94,2024-04-20T07:38:10,Bilbao,expenses,children,-202.28,-57450.2
buyer_7,Agurtzane,Laka,1968-12-31,26592366L,agurtzane.laka@awesomecloud.co,463672,ES23209508102455354994,1990.94,2024-04-21T20:22:53,Bilbao,expenses,leisure,-74.84,-57525.04
buyer_7,Agurtzane,Laka,1968-12-31,26592366L,agurtzane.laka@awesomecloud.co,463672,ES23209508102455354994,1990.94,2024-04-24T20:45:32,Bilbao,expenses,clothing,-53.07,-57578.11
buyer_7,Agurtzane,Laka,1968-12-31,26592366L,agurtzane.laka@awesomecloud.co,463672,ES23209508102455354994,1990.94,2024-04-26T19:38:23,Bilbao,expenses,healthcare,-38.88,-57616.99
buyer_7,Agurtzane,Laka,1968-12-31,26592366L,agurtzane.laka@awesomecloud.co,463672,ES23209508102455354994,1990.94,2024-04-27T19:43:41,Bilbao,expenses,cash,-100.0,-57716.99
buyer_7,Agurtzane,Laka,1968-12-31,26592366L,agurtzane.laka@awesomecloud.co,463672,ES23209508102455354994,1990.94,2024-04-27T12:38:12,Bilbao,expenses,repairs,-47.75,-57764.74
buyer_7,Agurtzane,Laka,1968-12-31,26592366L,agurtzane.laka@awesomecloud.co,463672,ES23209508102455354994,1990.94,2024-04-28T08:53:38,Bilbao,expenses,transport,-49.26,-57814.0
buyer_7,Agurtzane,Laka,1968-12-31,26592366L,agurtzane.laka@awesomecloud.co,463672,ES23209508102455354994,1990.94,2024-04-30T02:17:22,Bilbao,expenses,cash,-100.0,-57914.0
buyer_7,Agurtzane,Laka,1968-12-31,26592366L,agurtzane.laka@awesomecloud.co,463672,ES23209508102455354994,1990.94,2024-05-01T17:54:22,Bilbao,incomes,salary,1613.33,-56300.67
buyer_7,Agurtzane,Laka,1968-12-31,26592366L,agurtzane.laka@awesomecloud.co,463672,ES23209508102455354994,1990.94,2024-05-01T11:11:11,Bilbao,expenses,food,-72.26,-56372.93
buyer_7,Agurtzane,Laka,1968-12-31,26592366L,agurtzane.laka@awesomecloud.co,463672,ES23209508102455354994,1990.94,2024-05-03T19:01:59,Bilbao,expenses,repairs,-230.01,-56602.94
buyer_7,Agurtzane,Laka,1968-12-31,26592366L,agurtzane.laka@awesomecloud.co,463672,ES23209508102455354994,1990.94,2024-05-05T12:07:45,Bilbao,expenses,mortgage,-824.16,-57427.1
buyer_7,Agurtzane,Laka,1968-12-31,26592366L,agurtzane.laka@awesomecloud.co,463672,ES23209508102455354994,1990.94,2024-05-05T12:00:46,Bilbao,expenses,water,-26.2,-57453.3
buyer_7,Agurtzane,Laka,1968-12-31,26592366L,agurtzane.laka@awesomecloud.co,463672,ES23209508102455354994,1990.94,2024-05-06T09:21:53,Bilbao,expenses,food,-113.84,-57567.14
buyer_7,Agurtzane,Laka,1968-12-31,26592366L,agurtzane.laka@awesomecloud.co,463672,ES23209508102455354994,1990.94,2024-05-07T11:21:34,Bilbao,expenses,leisure,-46.36,-57613.5
buyer_7,Agurtzane,Laka,1968-12-31,26592366L,agurtzane.laka@awesomecloud.co,463672,ES23209508102455354994,1990.94,2024-05-07T10:47:28,Bilbao,expenses,appliances,-109.98,-57723.48
buyer_7,Agurtzane,Laka,1968-12-31,26592366L,agurtzane.laka@awesomecloud.co,463672,ES23209508102455354994,1990.94,2024-05-08T18:41:38,Bilbao,expenses,water,-28.95,-57752.43
buyer_7,Agurtzane,Laka,1968-12-31,26592366L,agurtzane.laka@awesomecloud.co,463672,ES23209508102455354994,1990.94,2024-05-10T17:32:47,Bilbao,expenses,transport,-76.06,-57828.49
buyer_7,Agurtzane,Laka,1968-12-31,26592366L,agurtzane.laka@awesomecloud.co,463672,ES23209508102455354994,1990.94,2024-05-11T10:14:16,Bilbao,expenses,leisure,-42.63,-57871.12
buyer_7,Agurtzane,Laka,1968-12-31,26592366L,agurtzane.laka@awesomecloud.co,463672,ES23209508102455354994,1990.94,2024-05-12T08:21:12,Bilbao,expenses,cash,-100.0,-57971.12
buyer_7,Agurtzane,Laka,1968-12-31,26592366L,agurtzane.laka@awesomecloud.co,463672,ES23209508102455354994,1990.94,2024-05-12T15:48:27,Bilbao,expenses,gifts,-119.81,-58090.93
buyer_7,Agurtzane,Laka,1968-12-31,26592366L,agurtzane.laka@awesomecloud.co,463672,ES23209508102455354994,1990.94,2024-05-13T17:22:22,Bilbao,expenses,food,-77.2,-58168.13
buyer_7,Agurtzane,Laka,1968-12-31,26592366L,agurtzane.laka@awesomecloud.co,463672,ES23209508102455354994,1990.94,2024-05-13T10:08:56,Bilbao,expenses,car,-135.62,-58303.75
buyer_7,Agurtzane,Laka,1968-12-31,26592366L,agurtzane.laka@awesomecloud.co,463672,ES23209508102455354994,1990.94,2024-05-17T13:59:41,Bilbao,expenses,healthcare,-147.74,-58451.49
buyer_7,Agurtzane,Laka,1968-12-31,26592366L,agurtzane.laka@awesomecloud.co,463672,ES23209508102455354994,1990.94,2024-05-20T11:27:08,Bilbao,expenses,cash,-100.0,-58551.49
buyer_7,Agurtzane,Laka,1968-12-31,26592366L,agurtzane.laka@awesomecloud.co,463672,ES23209508102455354994,1990.94,2024-05-21T11:22:20,Bilbao,expenses,gifts,-76.92,-58628.41
buyer_7,Agurtzane,Laka,1968-12-31,26592366L,agurtzane.laka@awesomecloud.co,463672,ES23209508102455354994,1990.94,2024-05-21T18:55:30,Bilbao,expenses,car,-91.06,-58719.47
buyer_7,Agurtzane,Laka,1968-12-31,26592366L,agurtzane.laka@awesomecloud.co,463672,ES23209508102455354994,1990.94,2024-05-22T09:02:18,Bilbao,expenses,leisure,-80.17,-58799.64
buyer_7,Agurtzane,Laka,1968-12-31,26592366L,agurtzane.laka@awesomecloud.co,463672,ES23209508102455354994,1990.94,2024-05-22T20:21:38,Bilbao,expenses,children,-278.71241666666657,-59078.35
buyer_7,Agurtzane,Laka,1968-12-31,26592366L,agurtzane.laka@awesomecloud.co,463672,ES23209508102455354994,1990.94,2024-05-23T16:07:16,Bilbao,expenses,healthcare,-83.47,-59161.82
buyer_7,Agurtzane,Laka,1968-12-31,26592366L,agurtzane.laka@awesomecloud.co,463672,ES23209508102455354994,1990.94,2024-05-25T16:12:19,Bilbao,expenses,gifts,-102.37,-59264.19
buyer_7,Agurtzane,Laka,1968-12-31,26592366L,agurtzane.laka@awesomecloud.co,463672,ES23209508102455354994,1990.94,2024-05-27T12:55:34,Bilbao,expenses,travel,-355.81,-59620.0
buyer_7,Agurtzane,Laka,1968-12-31,26592366L,agurtzane.laka@awesomecloud.co,463672,ES23209508102455354994,1990.94,2024-05-28T09:33:19,Bilbao,expenses,repairs,-263.07,-59883.07
buyer_7,Agurtzane,Laka,1968-12-31,26592366L,agurtzane.laka@awesomecloud.co,463672,ES23209508102455354994,1990.94,2024-05-29T01:23:58,Bilbao,expenses,cash,-100.0,-59983.07
buyer_7,Agurtzane,Laka,1968-12-31,26592366L,agurtzane.laka@awesomecloud.co,463672,ES23209508102455354994,1990.94,2024-05-31T14:39:54,Bilbao,expenses,food,-113.3,-60096.37
buyer_7,Agurtzane,Laka,1968-12-31,26592366L,agurtzane.laka@awesomecloud.co,463672,ES23209508102455354994,1990.94,2024-06-01T13:39:21,Bilbao,incomes,salary,1613.33,-58483.04
buyer_7,Agurtzane,Laka,1968-12-31,26592366L,agurtzane.laka@awesomecloud.co,463672,ES23209508102455354994,1990.94,2024-06-01T13:39:21,Bilbao,incomes,salary_bonus,1253.04,-57230.0
buyer_7,Agurtzane,Laka,1968-12-31,26592366L,agurtzane.laka@awesomecloud.co,463672,ES23209508102455354994,1990.94,2024-06-01T09:00:36,Bilbao,expenses,taxes,-1264.19,-58494.19
buyer_7,Agurtzane,Laka,1968-12-31,26592366L,agurtzane.laka@awesomecloud.co,463672,ES23209508102455354994,1990.94,2024-06-01T20:43:00,Bilbao,expenses,insurance,-453.13,-58947.32
buyer_7,Agurtzane,Laka,1968-12-31,26592366L,agurtzane.laka@awesomecloud.co,463672,ES23209508102455354994,1990.94,2024-06-02T11:57:17,Bilbao,expenses,food,-114.5,-59061.82
buyer_7,Agurtzane,Laka,1968-12-31,26592366L,agurtzane.laka@awesomecloud.co,463672,ES23209508102455354994,1990.94,2024-06-02T10:07:45,Bilbao,expenses,cash,-100.0,-59161.82
buyer_7,Agurtzane,Laka,1968-12-31,26592366L,agurtzane.laka@awesomecloud.co,463672,ES23209508102455354994,1990.94,2024-06-03T20:45:40,Bilbao,expenses,travel,-340.59,-59502.41
buyer_7,Agurtzane,Laka,1968-12-31,26592366L,agurtzane.laka@awesomecloud.co,463672,ES23209508102455354994,1990.94,2024-06-03T09:44:30,Bilbao,expenses,gifts,-22.43,-59524.84
buyer_7,Agurtzane,Laka,1968-12-31,26592366L,agurtzane.laka@awesomecloud.co,463672,ES23209508102455354994,1990.94,2024-06-04T08:57:04,Bilbao,expenses,food,-99.69,-59624.53
buyer_7,Agurtzane,Laka,1968-12-31,26592366L,agurtzane.laka@awesomecloud.co,463672,ES23209508102455354994,1990.94,2024-06-05T19:30:30,Bilbao,expenses,mortgage,-824.16,-60448.69
buyer_7,Agurtzane,Laka,1968-12-31,26592366L,agurtzane.laka@awesomecloud.co,463672,ES23209508102455354994,1990.94,2024-06-05T16:59:37,Bilbao,expenses,water,-20.39,-60469.08
buyer_7,Agurtzane,Laka,1968-12-31,26592366L,agurtzane.laka@awesomecloud.co,463672,ES23209508102455354994,1990.94,2024-06-05T10:02:12,Bilbao,expenses,electricity,-71.06,-60540.14
buyer_7,Agurtzane,Laka,1968-12-31,26592366L,agurtzane.laka@awesomecloud.co,463672,ES23209508102455354994,1990.94,2024-06-05T12:00:50,Bilbao,expenses,gas,-43.17,-60583.31
buyer_7,Agurtzane,Laka,1968-12-31,26592366L,agurtzane.laka@awesomecloud.co,463672,ES23209508102455354994,1990.94,2024-06-05T10:10:37,Bilbao,expenses,phone,-28.64,-60611.95
buyer_7,Agurtzane,Laka,1968-12-31,26592366L,agurtzane.laka@awesomecloud.co,463672,ES23209508102455354994,1990.94,2024-06-05T12:26:25,Bilbao,expenses,education,-69.49,-60681.44
buyer_7,Agurtzane,Laka,1968-12-31,26592366L,agurtzane.laka@awesomecloud.co,463672,ES23209508102455354994,1990.94,2024-06-06T14:35:14,Bilbao,expenses,phone,-25.78,-60707.22
buyer_7,Agurtzane,Laka,1968-12-31,26592366L,agurtzane.laka@awesomecloud.co,463672,ES23209508102455354994,1990.94,2024-06-06T14:17:22,Bilbao,expenses,cash,-100.0,-60807.22
buyer_7,Agurtzane,Laka,1968-12-31,26592366L,agurtzane.laka@awesomecloud.co,463672,ES23209508102455354994,1990.94,2024-06-07T18:55:08,Bilbao,expenses,gas,-46.58,-60853.8
buyer_7,Agurtzane,Laka,1968-12-31,26592366L,agurtzane.laka@awesomecloud.co,463672,ES23209508102455354994,1990.94,2024-06-07T03:12:11,Bilbao,expenses,internet,-33.88,-60887.68
buyer_7,Agurtzane,Laka,1968-12-31,26592366L,agurtzane.laka@awesomecloud.co,463672,ES23209508102455354994,1990.94,2024-06-07T19:39:59,Bilbao,expenses,clothing,-87.82,-60975.5
buyer_7,Agurtzane,Laka,1968-12-31,26592366L,agurtzane.laka@awesomecloud.co,463672,ES23209508102455354994,1990.94,2024-06-07T10:57:59,Bilbao,expenses,education,-49.67,-61025.17
buyer_7,Agurtzane,Laka,1968-12-31,26592366L,agurtzane.laka@awesomecloud.co,463672,ES23209508102455354994,1990.94,2024-06-08T14:00:01,Bilbao,expenses,water,-26.67,-61051.84
buyer_7,Agurtzane,Laka,1968-12-31,26592366L,agurtzane.laka@awesomecloud.co,463672,ES23209508102455354994,1990.94,2024-06-08T10:52:52,Bilbao,expenses,gas,-42.95,-61094.79
buyer_7,Agurtzane,Laka,1968-12-31,26592366L,agurtzane.laka@awesomecloud.co,463672,ES23209508102455354994,1990.94,2024-06-08T04:17:02,Bilbao,expenses,transport,-81.52,-61176.31
buyer_7,Agurtzane,Laka,1968-12-31,26592366L,agurtzane.laka@awesomecloud.co,463672,ES23209508102455354994,1990.94,2024-06-08T08:28:40,Bilbao,expenses,repairs,-226.03,-61402.34
buyer_7,Agurtzane,Laka,1968-12-31,26592366L,agurtzane.laka@awesomecloud.co,463672,ES23209508102455354994,1990.94,2024-06-10T18:41:13,Bilbao,expenses,cash,-100.0,-61502.34
buyer_7,Agurtzane,Laka,1968-12-31,26592366L,agurtzane.laka@awesomecloud.co,463672,ES23209508102455354994,1990.94,2024-06-13T13:52:40,Bilbao,expenses,transport,-70.27,-61572.61
buyer_7,Agurtzane,Laka,1968-12-31,26592366L,agurtzane.laka@awesomecloud.co,463672,ES23209508102455354994,1990.94,2024-06-13T08:37:41,Bilbao,expenses,appliances,-252.02,-61824.63
buyer_7,Agurtzane,Laka,1968-12-31,26592366L,agurtzane.laka@awesomecloud.co,463672,ES23209508102455354994,1990.94,2024-06-13T10:05:47,Bilbao,expenses,gifts,-32.77,-61857.4
buyer_7,Agurtzane,Laka,1968-12-31,26592366L,agurtzane.laka@awesomecloud.co,463672,ES23209508102455354994,1990.94,2024-06-15T14:50:12,Bilbao,expenses,leisure,-84.06,-61941.46
buyer_7,Agurtzane,Laka,1968-12-31,26592366L,agurtzane.laka@awesomecloud.co,463672,ES23209508102455354994,1990.94,2024-06-17T18:14:08,Bilbao,expenses,leisure,-48.17,-61989.63
buyer_7,Agurtzane,Laka,1968-12-31,26592366L,agurtzane.laka@awesomecloud.co,463672,ES23209508102455354994,1990.94,2024-06-18T11:01:31,Bilbao,expenses,education,-64.7,-62054.33
buyer_7,Agurtzane,Laka,1968-12-31,26592366L,agurtzane.laka@awesomecloud.co,463672,ES23209508102455354994,1990.94,2024-06-19T23:34:29,Bilbao,expenses,cash,-100.0,-62154.33
buyer_7,Agurtzane,Laka,1968-12-31,26592366L,agurtzane.laka@awesomecloud.co,463672,ES23209508102455354994,1990.94,2024-06-20T17:20:01,Bilbao,expenses,cash,-100.0,-62254.33
buyer_7,Agurtzane,Laka,1968-12-31,26592366L,agurtzane.laka@awesomecloud.co,463672,ES23209508102455354994,1990.94,2024-06-21T03:26:14,Bilbao,expenses,leisure,-18.46,-62272.79
buyer_7,Agurtzane,Laka,1968-12-31,26592366L,agurtzane.laka@awesomecloud.co,463672,ES23209508102455354994,1990.94,2024-06-22T09:45:19,Bilbao,expenses,cash,-100.0,-62372.79
buyer_7,Agurtzane,Laka,1968-12-31,26592366L,agurtzane.laka@awesomecloud.co,463672,ES23209508102455354994,1990.94,2024-06-24T08:29:58,Bilbao,expenses,gifts,-191.51,-62564.3
buyer_7,Agurtzane,Laka,1968-12-31,26592366L,agurtzane.laka@awesomecloud.co,463672,ES23209508102455354994,1990.94,2024-06-25T02:53:24,Bilbao,expenses,food,-109.01,-62673.31
buyer_7,Agurtzane,Laka,1968-12-31,26592366L,agurtzane.laka@awesomecloud.co,463672,ES23209508102455354994,1990.94,2024-06-25T23:04:48,Bilbao,expenses,leisure,-61.7,-62735.01
buyer_7,Agurtzane,Laka,1968-12-31,26592366L,agurtzane.laka@awesomecloud.co,463672,ES23209508102455354994,1990.94,2024-06-26T12:48:08,Bilbao,expenses,transport,-84.82,-62819.83
buyer_7,Agurtzane,Laka,1968-12-31,26592366L,agurtzane.laka@awesomecloud.co,463672,ES23209508102455354994,1990.94,2024-06-27T18:20:41,Bilbao,expenses,cash,-100.0,-62919.83
buyer_7,Agurtzane,Laka,1968-12-31,26592366L,agurtzane.laka@awesomecloud.co,463672,ES23209508102455354994,1990.94,2024-06-29T16:56:33,Bilbao,expenses,transport,-80.05,-62999.88
buyer_7,Agurtzane,Laka,1968-12-31,26592366L,agurtzane.laka@awesomecloud.co,463672,ES23209508102455354994,1990.94,2024-06-30T19:25:02,Bilbao,expenses,cash,-100.0,-63099.88
buyer_7,Agurtzane,Laka,1968-12-31,26592366L,agurtzane.laka@awesomecloud.co,463672,ES23209508102455354994,1990.94,2024-07-01T11:40:14,Bilbao,incomes,salary,1613.33,-61486.55
buyer_7,Agurtzane,Laka,1968-12-31,26592366L,agurtzane.laka@awesomecloud.co,463672,ES23209508102455354994,1990.94,2024-07-01T11:40:14,Bilbao,incomes,extra_income,185.75,-61300.8
buyer_7,Agurtzane,Laka,1968-12-31,26592366L,agurtzane.laka@awesomecloud.co,463672,ES23209508102455354994,1990.94,2024-07-01T09:43:21,Bilbao,expenses,transport,-79.26,-61380.06
buyer_7,Agurtzane,Laka,1968-12-31,26592366L,agurtzane.laka@awesomecloud.co,463672,ES23209508102455354994,1990.94,2024-07-01T22:41:48,Bilbao,expenses,leisure,-45.65,-61425.71
buyer_7,Agurtzane,Laka,1968-12-31,26592366L,agurtzane.laka@awesomecloud.co,463672,ES23209508102455354994,1990.94,2024-07-04T08:49:33,Bilbao,expenses,food,-85.96,-61511.67
buyer_7,Agurtzane,Laka,1968-12-31,26592366L,agurtzane.laka@awesomecloud.co,463672,ES23209508102455354994,1990.94,2024-07-05T15:58:10,Bilbao,expenses,mortgage,-824.16,-62335.83
buyer_7,Agurtzane,Laka,1968-12-31,26592366L,agurtzane.laka@awesomecloud.co,463672,ES23209508102455354994,1990.94,2024-07-05T12:04:05,Bilbao,expenses,water,-19.02,-62354.85
buyer_7,Agurtzane,Laka,1968-12-31,26592366L,agurtzane.laka@awesomecloud.co,463672,ES23209508102455354994,1990.94,2024-07-06T10:06:25,Bilbao,expenses,water,-27.49,-62382.34
buyer_7,Agurtzane,Laka,1968-12-31,26592366L,agurtzane.laka@awesomecloud.co,463672,ES23209508102455354994,1990.94,2024-07-06T11:12:58,Bilbao,expenses,cash,-100.0,-62482.34
buyer_7,Agurtzane,Laka,1968-12-31,26592366L,agurtzane.laka@awesomecloud.co,463672,ES23209508102455354994,1990.94,2024-07-06T15:31:25,Bilbao,expenses,repairs,-240.96,-62723.3
buyer_7,Agurtzane,Laka,1968-12-31,26592366L,agurtzane.laka@awesomecloud.co,463672,ES23209508102455354994,1990.94,2024-07-07T08:34:27,Bilbao,expenses,phone,-35.63,-62758.93
buyer_7,Agurtzane,Laka,1968-12-31,26592366L,agurtzane.laka@awesomecloud.co,463672,ES23209508102455354994,1990.94,2024-07-08T15:27:24,Bilbao,expenses,children,-358.8824166666666,-63117.81
buyer_7,Agurtzane,Laka,1968-12-31,26592366L,agurtzane.laka@awesomecloud.co,463672,ES23209508102455354994,1990.94,2024-07-09T16:28:06,Bilbao,expenses,food,-84.67,-63202.48
buyer_7,Agurtzane,Laka,1968-12-31,26592366L,agurtzane.laka@awesomecloud.co,463672,ES23209508102455354994,1990.94,2024-07-09T09:41:15,Bilbao,expenses,clothing,-95.49,-63297.97
buyer_7,Agurtzane,Laka,1968-12-31,26592366L,agurtzane.laka@awesomecloud.co,463672,ES23209508102455354994,1990.94,2024-07-10T16:30:21,Bilbao,expenses,leisure,-52.26,-63350.23
buyer_7,Agurtzane,Laka,1968-12-31,26592366L,agurtzane.laka@awesomecloud.co,463672,ES23209508102455354994,1990.94,2024-07-10T08:06:14,Bilbao,expenses,cash,-100.0,-63450.23
buyer_7,Agurtzane,Laka,1968-12-31,26592366L,agurtzane.laka@awesomecloud.co,463672,ES23209508102455354994,1990.94,2024-07-10T18:41:20,Bilbao,expenses,children,-186.58,-63636.81
buyer_7,Agurtzane,Laka,1968-12-31,26592366L,agurtzane.laka@awesomecloud.co,463672,ES23209508102455354994,1990.94,2024-07-11T08:11:47,Bilbao,expenses,education,-63.33,-63700.14
buyer_7,Agurtzane,Laka,1968-12-31,26592366L,agurtzane.laka@awesomecloud.co,463672,ES23209508102455354994,1990.94,2024-07-12T09:37:53,Bilbao,expenses,clothing,-119.79,-63819.93
buyer_7,Agurtzane,Laka,1968-12-31,26592366L,agurtzane.laka@awesomecloud.co,463672,ES23209508102455354994,1990.94,2024-07-12T10:37:48,Bilbao,expenses,healthcare,-145.54,-63965.47
buyer_7,Agurtzane,Laka,1968-12-31,26592366L,agurtzane.laka@awesomecloud.co,463672,ES23209508102455354994,1990.94,2024-07-13T03:44:25,Bilbao,expenses,transport,-87.31,-64052.78
buyer_7,Agurtzane,Laka,1968-12-31,26592366L,agurtzane.laka@awesomecloud.co,463672,ES23209508102455354994,1990.94,2024-07-13T11:35:47,Bilbao,expenses,leisure,-55.13,-64107.91
buyer_7,Agurtzane,Laka,1968-12-31,26592366L,agurtzane.laka@awesomecloud.co,463672,ES23209508102455354994,1990.94,2024-07-14T21:39:06,Bilbao,expenses,food,-77.63,-64185.54
buyer_7,Agurtzane,Laka,1968-12-31,26592366L,agurtzane.laka@awesomecloud.co,463672,ES23209508102455354994,1990.94,2024-07-14T20:08:00,Bilbao,expenses,cash,-100.0,-64285.54
buyer_7,Agurtzane,Laka,1968-12-31,26592366L,agurtzane.laka@awesomecloud.co,463672,ES23209508102455354994,1990.94,2024-07-15T17:49:03,Bilbao,expenses,leisure,-42.58,-64328.12
buyer_7,Agurtzane,Laka,1968-12-31,26592366L,agurtzane.laka@awesomecloud.co,463672,ES23209508102455354994,1990.94,2024-07-16T17:07:03,Bilbao,expenses,cash,-100.0,-64428.12
buyer_7,Agurtzane,Laka,1968-12-31,26592366L,agurtzane.laka@awesomecloud.co,463672,ES23209508102455354994,1990.94,2024-07-17T13:45:39,Bilbao,expenses,cash,-100.0,-64528.12
buyer_7,Agurtzane,Laka,1968-12-31,26592366L,agurtzane.laka@awesomecloud.co,463672,ES23209508102455354994,1990.94,2024-07-21T03:26:41,Bilbao,expenses,food,-112.16,-64640.28
buyer_7,Agurtzane,Laka,1968-12-31,26592366L,agurtzane.laka@awesomecloud.co,463672,ES23209508102455354994,1990.94,2024-07-25T10:28:51,Bilbao,expenses,food,-109.24,-64749.52
buyer_7,Agurtzane,Laka,1968-12-31,26592366L,agurtzane.laka@awesomecloud.co,463672,ES23209508102455354994,1990.94,2024-07-26T08:33:24,Bilbao,expenses,food,-83.29,-64832.81
buyer_7,Agurtzane,Laka,1968-12-31,26592366L,agurtzane.laka@awesomecloud.co,463672,ES23209508102455354994,1990.94,2024-07-26T16:41:20,Bilbao,expenses,healthcare,-145.19,-64978.0
buyer_7,Agurtzane,Laka,1968-12-31,26592366L,agurtzane.laka@awesomecloud.co,463672,ES23209508102455354994,1990.94,2024-07-28T16:27:19,Bilbao,expenses,food,-90.78,-65068.78
buyer_7,Agurtzane,Laka,1968-12-31,26592366L,agurtzane.laka@awesomecloud.co,463672,ES23209508102455354994,1990.94,2024-07-30T19:19:42,Bilbao,expenses,food,-77.86,-65146.64
buyer_7,Agurtzane,Laka,1968-12-31,26592366L,agurtzane.laka@awesomecloud.co,463672,ES23209508102455354994,1990.94,2024-07-30T19:02:02,Bilbao,expenses,transport,-80.73,-65227.37
buyer_7,Agurtzane,Laka,1968-12-31,26592366L,agurtzane.laka@awesomecloud.co,463672,ES23209508102455354994,1990.94,2024-07-31T14:56:52,Bilbao,expenses,food,-119.69,-65347.06
buyer_7,Agurtzane,Laka,1968-12-31,26592366L,agurtzane.laka@awesomecloud.co,463672,ES23209508102455354994,1990.94,2024-07-31T04:40:13,Bilbao,expenses,education,-73.69,-65420.75
buyer_7,Agurtzane,Laka,1968-12-31,26592366L,agurtzane.laka@awesomecloud.co,463672,ES23209508102455354994,1990.94,2024-07-31T11:17:33,Bilbao,expenses,children,-165.5024166666666,-65586.25
buyer_7,Agurtzane,Laka,1968-12-31,26592366L,agurtzane.laka@awesomecloud.co,463672,ES23209508102455354994,1990.94,2024-08-01T14:24:41,Bilbao,incomes,salary,1613.33,-63972.92
buyer_7,Agurtzane,Laka,1968-12-31,26592366L,agurtzane.laka@awesomecloud.co,463672,ES23209508102455354994,1990.94,2024-08-01T15:36:30,Bilbao,expenses,transport,-54.64,-64027.56
buyer_7,Agurtzane,Laka,1968-12-31,26592366L,agurtzane.laka@awesomecloud.co,463672,ES23209508102455354994,1990.94,2024-08-01T10:54:35,Bilbao,expenses,clothing,-50.87,-64078.43
buyer_7,Agurtzane,Laka,1968-12-31,26592366L,agurtzane.laka@awesomecloud.co,463672,ES23209508102455354994,1990.94,2024-08-01T17:48:25,Bilbao,expenses,education,-61.71,-64140.14
buyer_7,Agurtzane,Laka,1968-12-31,26592366L,agurtzane.laka@awesomecloud.co,463672,ES23209508102455354994,1990.94,2024-08-01T16:04:52,Bilbao,expenses,cash,-100.0,-64240.14
buyer_7,Agurtzane,Laka,1968-12-31,26592366L,agurtzane.laka@awesomecloud.co,463672,ES23209508102455354994,1990.94,2024-08-02T15:50:11,Bilbao,expenses,transport,-87.18,-64327.32
buyer_7,Agurtzane,Laka,1968-12-31,26592366L,agurtzane.laka@awesomecloud.co,463672,ES23209508102455354994,1990.94,2024-08-02T13:02:59,Bilbao,expenses,leisure,-65.55,-64392.87
buyer_7,Agurtzane,Laka,1968-12-31,26592366L,agurtzane.laka@awesomecloud.co,463672,ES23209508102455354994,1990.94,2024-08-02T07:06:32,Bilbao,expenses,education,-71.21,-64464.08
buyer_7,Agurtzane,Laka,1968-12-31,26592366L,agurtzane.laka@awesomecloud.co,463672,ES23209508102455354994,1990.94,2024-08-03T03:17:22,Bilbao,expenses,food,-120.65,-64584.73
buyer_7,Agurtzane,Laka,1968-12-31,26592366L,agurtzane.laka@awesomecloud.co,463672,ES23209508102455354994,1990.94,2024-08-04T08:20:12,Bilbao,expenses,education,-74.98,-64659.71
buyer_7,Agurtzane,Laka,1968-12-31,26592366L,agurtzane.laka@awesomecloud.co,463672,ES23209508102455354994,1990.94,2024-08-05T13:20:38,Bilbao,expenses,mortgage,-824.16,-65483.87
buyer_7,Agurtzane,Laka,1968-12-31,26592366L,agurtzane.laka@awesomecloud.co,463672,ES23209508102455354994,1990.94,2024-08-05T14:27:49,Bilbao,expenses,electricity,-18.75,-65502.62
buyer_7,Agurtzane,Laka,1968-12-31,26592366L,agurtzane.laka@awesomecloud.co,463672,ES23209508102455354994,1990.94,2024-08-05T18:25:43,Bilbao,expenses,gas,-86.6,-65589.22
buyer_7,Agurtzane,Laka,1968-12-31,26592366L,agurtzane.laka@awesomecloud.co,463672,ES23209508102455354994,1990.94,2024-08-05T16:30:57,Bilbao,expenses,leisure,-52.34,-65641.56
buyer_7,Agurtzane,Laka,1968-12-31,26592366L,agurtzane.laka@awesomecloud.co,463672,ES23209508102455354994,1990.94,2024-08-05T08:37:23,Bilbao,expenses,cash,-100.0,-65741.56
buyer_7,Agurtzane,Laka,1968-12-31,26592366L,agurtzane.laka@awesomecloud.co,463672,ES23209508102455354994,1990.94,2024-08-06T15:34:37,Bilbao,expenses,gas,-41.67,-65783.23
buyer_7,Agurtzane,Laka,1968-12-31,26592366L,agurtzane.laka@awesomecloud.co,463672,ES23209508102455354994,1990.94,2024-08-06T23:11:54,Bilbao,expenses,phone,-28.95,-65812.18
buyer_7,Agurtzane,Laka,1968-12-31,26592366L,agurtzane.laka@awesomecloud.co,463672,ES23209508102455354994,1990.94,2024-08-08T11:19:33,Bilbao,expenses,water,-22.33,-65834.51
buyer_7,Agurtzane,Laka,1968-12-31,26592366L,agurtzane.laka@awesomecloud.co,463672,ES23209508102455354994,1990.94,2024-08-08T15:55:46,Bilbao,expenses,food,-100.61,-65935.12
buyer_7,Agurtzane,Laka,1968-12-31,26592366L,agurtzane.laka@awesomecloud.co,463672,ES23209508102455354994,1990.94,2024-08-10T11:10:36,Bilbao,expenses,healthcare,-42.88,-65978.0
buyer_7,Agurtzane,Laka,1968-12-31,26592366L,agurtzane.laka@awesomecloud.co,463672,ES23209508102455354994,1990.94,2024-08-11T19:53:30,Bilbao,expenses,leisure,-67.83,-66045.83
buyer_7,Agurtzane,Laka,1968-12-31,26592366L,agurtzane.laka@awesomecloud.co,463672,ES23209508102455354994,1990.94,2024-08-11T22:07:59,Bilbao,expenses,gifts,-141.48,-66187.31
buyer_7,Agurtzane,Laka,1968-12-31,26592366L,agurtzane.laka@awesomecloud.co,463672,ES23209508102455354994,1990.94,2024-08-12T04:32:01,Bilbao,expenses,leisure,-48.39,-66235.7
buyer_7,Agurtzane,Laka,1968-12-31,26592366L,agurtzane.laka@awesomecloud.co,463672,ES23209508102455354994,1990.94,2024-08-12T23:01:51,Bilbao,expenses,cash,-100.0,-66335.7
buyer_7,Agurtzane,Laka,1968-12-31,26592366L,agurtzane.laka@awesomecloud.co,463672,ES23209508102455354994,1990.94,2024-08-13T14:56:41,Bilbao,expenses,leisure,-37.48,-66373.18
buyer_7,Agurtzane,Laka,1968-12-31,26592366L,agurtzane.laka@awesomecloud.co,463672,ES23209508102455354994,1990.94,2024-08-14T17:34:33,Bilbao,expenses,leisure,-60.75,-66433.93
buyer_7,Agurtzane,Laka,1968-12-31,26592366L,agurtzane.laka@awesomecloud.co,463672,ES23209508102455354994,1990.94,2024-08-15T02:52:04,Bilbao,expenses,clothing,-102.99,-66536.92
buyer_7,Agurtzane,Laka,1968-12-31,26592366L,agurtzane.laka@awesomecloud.co,463672,ES23209508102455354994,1990.94,2024-08-16T18:05:13,Bilbao,expenses,healthcare,-146.22,-66683.14
buyer_7,Agurtzane,Laka,1968-12-31,26592366L,agurtzane.laka@awesomecloud.co,463672,ES23209508102455354994,1990.94,2024-08-16T14:15:37,Bilbao,expenses,repairs,-169.41,-66852.55
buyer_7,Agurtzane,Laka,1968-12-31,26592366L,agurtzane.laka@awesomecloud.co,463672,ES23209508102455354994,1990.94,2024-08-19T10:26:24,Bilbao,expenses,food,-64.49,-66917.04
buyer_7,Agurtzane,Laka,1968-12-31,26592366L,agurtzane.laka@awesomecloud.co,463672,ES23209508102455354994,1990.94,2024-08-20T04:57:50,Bilbao,expenses,transport,-88.71,-67005.75
buyer_7,Agurtzane,Laka,1968-12-31,26592366L,agurtzane.laka@awesomecloud.co,463672,ES23209508102455354994,1990.94,2024-08-20T23:22:22,Bilbao,expenses,healthcare,-148.65,-67154.4
buyer_7,Agurtzane,Laka,1968-12-31,26592366L,agurtzane.laka@awesomecloud.co,463672,ES23209508102455354994,1990.94,2024-08-21T17:19:00,Bilbao,expenses,leisure,-83.65,-67238.05
buyer_7,Agurtzane,Laka,1968-12-31,26592366L,agurtzane.laka@awesomecloud.co,463672,ES23209508102455354994,1990.94,2024-08-22T15:09:42,Bilbao,expenses,food,-94.6,-67332.65
buyer_7,Agurtzane,Laka,1968-12-31,26592366L,agurtzane.laka@awesomecloud.co,463672,ES23209508102455354994,1990.94,2024-08-22T20:00:39,Bilbao,expenses,children,-171.78,-67504.43
buyer_7,Agurtzane,Laka,1968-12-31,26592366L,agurtzane.laka@awesomecloud.co,463672,ES23209508102455354994,1990.94,2024-08-28T15:37:52,Bilbao,expenses,leisure,-83.3,-67587.73
buyer_7,Agurtzane,Laka,1968-12-31,26592366L,agurtzane.laka@awesomecloud.co,463672,ES23209508102455354994,1990.94,2024-08-30T14:04:10,Bilbao,expenses,leisure,-22.06,-67609.79
buyer_7,Agurtzane,Laka,1968-12-31,26592366L,agurtzane.laka@awesomecloud.co,463672,ES23209508102455354994,1990.94,2024-08-31T23:13:04,Bilbao,expenses,transport,-82.64,-67692.43
buyer_7,Agurtzane,Laka,1968-12-31,26592366L,agurtzane.laka@awesomecloud.co,463672,ES23209508102455354994,1990.94,2024-08-31T21:56:58,Bilbao,expenses,cash,-100.0,-67792.43
buyer_7,Agurtzane,Laka,1968-12-31,26592366L,agurtzane.laka@awesomecloud.co,463672,ES23209508102455354994,1990.94,2024-09-01T09:34:42,Bilbao,incomes,salary,1613.33,-66179.1
buyer_7,Agurtzane,Laka,1968-12-31,26592366L,agurtzane.laka@awesomecloud.co,463672,ES23209508102455354994,1990.94,2024-09-01T20:43:29,Bilbao,expenses,food,-91.59,-66270.69
buyer_7,Agurtzane,Laka,1968-12-31,26592366L,agurtzane.laka@awesomecloud.co,463672,ES23209508102455354994,1990.94,2024-09-01T18:13:20,Bilbao,expenses,repairs,-113.56,-66384.25
buyer_7,Agurtzane,Laka,1968-12-31,26592366L,agurtzane.laka@awesomecloud.co,463672,ES23209508102455354994,1990.94,2024-09-03T12:47:48,Bilbao,expenses,cash,-100.0,-66484.25
buyer_7,Agurtzane,Laka,1968-12-31,26592366L,agurtzane.laka@awesomecloud.co,463672,ES23209508102455354994,1990.94,2024-09-05T08:23:09,Bilbao,expenses,mortgage,-824.16,-67308.41
buyer_7,Agurtzane,Laka,1968-12-31,26592366L,agurtzane.laka@awesomecloud.co,463672,ES23209508102455354994,1990.94,2024-09-05T09:12:49,Bilbao,expenses,water,-33.83,-67342.24
buyer_7,Agurtzane,Laka,1968-12-31,26592366L,agurtzane.laka@awesomecloud.co,463672,ES23209508102455354994,1990.94,2024-09-05T08:27:07,Bilbao,expenses,electricity,-16.66,-67358.9
buyer_7,Agurtzane,Laka,1968-12-31,26592366L,agurtzane.laka@awesomecloud.co,463672,ES23209508102455354994,1990.94,2024-09-05T15:24:35,Bilbao,expenses,phone,-25.54,-67384.44
buyer_7,Agurtzane,Laka,1968-12-31,26592366L,agurtzane.laka@awesomecloud.co,463672,ES23209508102455354994,1990.94,2024-09-06T01:17:12,Bilbao,expenses,food,-63.15,-67447.59
buyer_7,Agurtzane,Laka,1968-12-31,26592366L,agurtzane.laka@awesomecloud.co,463672,ES23209508102455354994,1990.94,2024-09-06T23:02:14,Bilbao,expenses,repairs,-31.8,-67479.39
buyer_7,Agurtzane,Laka,1968-12-31,26592366L,agurtzane.laka@awesomecloud.co,463672,ES23209508102455354994,1990.94,2024-09-07T20:48:01,Bilbao,expenses,water,-24.94,-67504.33
buyer_7,Agurtzane,Laka,1968-12-31,26592366L,agurtzane.laka@awesomecloud.co,463672,ES23209508102455354994,1990.94,2024-09-07T10:23:31,Bilbao,expenses,internet,-33.88,-67538.21
buyer_7,Agurtzane,Laka,1968-12-31,26592366L,agurtzane.laka@awesomecloud.co,463672,ES23209508102455354994,1990.94,2024-09-08T03:05:46,Bilbao,expenses,water,-33.71,-67571.92
buyer_7,Agurtzane,Laka,1968-12-31,26592366L,agurtzane.laka@awesomecloud.co,463672,ES23209508102455354994,1990.94,2024-09-08T15:02:15,Bilbao,expenses,internet,-33.88,-67605.8
buyer_7,Agurtzane,Laka,1968-12-31,26592366L,agurtzane.laka@awesomecloud.co,463672,ES23209508102455354994,1990.94,2024-09-08T17:33:58,Bilbao,expenses,phone,-33.28,-67639.08
buyer_7,Agurtzane,Laka,1968-12-31,26592366L,agurtzane.laka@awesomecloud.co,463672,ES23209508102455354994,1990.94,2024-09-09T15:19:41,Bilbao,expenses,healthcare,-109.44,-67748.52
buyer_7,Agurtzane,Laka,1968-12-31,26592366L,agurtzane.laka@awesomecloud.co,463672,ES23209508102455354994,1990.94,2024-09-09T19:43:23,Bilbao,expenses,repairs,-60.63,-67809.15
buyer_7,Agurtzane,Laka,1968-12-31,26592366L,agurtzane.laka@awesomecloud.co,463672,ES23209508102455354994,1990.94,2024-09-11T06:46:44,Bilbao,expenses,transport,-81.37,-67890.52
buyer_7,Agurtzane,Laka,1968-12-31,26592366L,agurtzane.laka@awesomecloud.co,463672,ES23209508102455354994,1990.94,2024-09-13T08:57:58,Bilbao,expenses,cash,-100.0,-67990.52
buyer_7,Agurtzane,Laka,1968-12-31,26592366L,agurtzane.laka@awesomecloud.co,463672,ES23209508102455354994,1990.94,2024-09-13T09:01:03,Bilbao,expenses,children,-244.66,-68235.18
buyer_7,Agurtzane,Laka,1968-12-31,26592366L,agurtzane.laka@awesomecloud.co,463672,ES23209508102455354994,1990.94,2024-09-16T12:59:53,Bilbao,expenses,cash,-100.0,-68335.18
buyer_7,Agurtzane,Laka,1968-12-31,26592366L,agurtzane.laka@awesomecloud.co,463672,ES23209508102455354994,1990.94,2024-09-19T14:46:14,Bilbao,expenses,transport,-82.54,-68417.72
buyer_7,Agurtzane,Laka,1968-12-31,26592366L,agurtzane.laka@awesomecloud.co,463672,ES23209508102455354994,1990.94,2024-09-19T16:39:08,Bilbao,expenses,healthcare,-94.26,-68511.98
buyer_7,Agurtzane,Laka,1968-12-31,26592366L,agurtzane.laka@awesomecloud.co,463672,ES23209508102455354994,1990.94,2024-09-20T13:04:42,Bilbao,expenses,leisure,-80.31,-68592.29
buyer_7,Agurtzane,Laka,1968-12-31,26592366L,agurtzane.laka@awesomecloud.co,463672,ES23209508102455354994,1990.94,2024-09-22T16:25:25,Bilbao,expenses,transport,-62.83,-68655.12
buyer_7,Agurtzane,Laka,1968-12-31,26592366L,agurtzane.laka@awesomecloud.co,463672,ES23209508102455354994,1990.94,2024-09-22T15:49:28,Bilbao,expenses,clothing,-91.52,-68746.64
buyer_7,Agurtzane,Laka,1968-12-31,26592366L,agurtzane.laka@awesomecloud.co,463672,ES23209508102455354994,1990.94,2024-09-23T15:35:17,Bilbao,expenses,transport,-83.79,-68830.43
buyer_7,Agurtzane,Laka,1968-12-31,26592366L,agurtzane.laka@awesomecloud.co,463672,ES23209508102455354994,1990.94,2024-09-24T11:59:33,Bilbao,expenses,repairs,-139.14,-68969.57
buyer_7,Agurtzane,Laka,1968-12-31,26592366L,agurtzane.laka@awesomecloud.co,463672,ES23209508102455354994,1990.94,2024-09-25T19:33:39,Bilbao,expenses,appliances,-261.78,-69231.35
buyer_7,Agurtzane,Laka,1968-12-31,26592366L,agurtzane.laka@awesomecloud.co,463672,ES23209508102455354994,1990.94,2024-09-26T13:05:56,Bilbao,expenses,cash,-100.0,-69331.35
buyer_7,Agurtzane,Laka,1968-12-31,26592366L,agurtzane.laka@awesomecloud.co,463672,ES23209508102455354994,1990.94,2024-09-26T12:31:26,Bilbao,expenses,appliances,-97.82,-69429.17
buyer_7,Agurtzane,Laka,1968-12-31,26592366L,agurtzane.laka@awesomecloud.co,463672,ES23209508102455354994,1990.94,2024-09-26T19:47:04,Bilbao,expenses,children,-161.0624166666666,-69590.23
buyer_7,Agurtzane,Laka,1968-12-31,26592366L,agurtzane.laka@awesomecloud.co,463672,ES23209508102455354994,1990.94,2024-09-28T19:36:42,Bilbao,expenses,leisure,-44.75,-69634.98
buyer_7,Agurtzane,Laka,1968-12-31,26592366L,agurtzane.laka@awesomecloud.co,463672,ES23209508102455354994,1990.94,2024-09-28T19:49:05,Bilbao,expenses,healthcare,-181.99,-69816.97
buyer_7,Agurtzane,Laka,1968-12-31,26592366L,agurtzane.laka@awesomecloud.co,463672,ES23209508102455354994,1990.94,2024-09-28T18:43:52,Bilbao,expenses,travel,-198.76,-70015.73
buyer_7,Agurtzane,Laka,1968-12-31,26592366L,agurtzane.laka@awesomecloud.co,463672,ES23209508102455354994,1990.94,2024-09-29T09:46:13,Bilbao,expenses,food,-62.13,-70077.86
buyer_7,Agurtzane,Laka,1968-12-31,26592366L,agurtzane.laka@awesomecloud.co,463672,ES23209508102455354994,1990.94,2024-09-29T15:36:43,Bilbao,expenses,cash,-100.0,-70177.86
buyer_7,Agurtzane,Laka,1968-12-31,26592366L,agurtzane.laka@awesomecloud.co,463672,ES23209508102455354994,1990.94,2024-09-29T13:23:30,Bilbao,expenses,appliances,-123.22,-70301.08
buyer_7,Agurtzane,Laka,1968-12-31,26592366L,agurtzane.laka@awesomecloud.co,463672,ES23209508102455354994,1990.94,2024-09-30T10:52:05,Bilbao,expenses,repairs,-176.72,-70477.8
buyer_7,Agurtzane,Laka,1968-12-31,26592366L,agurtzane.laka@awesomecloud.co,463672,ES23209508102455354994,1990.94,2024-10-01T20:28:12,Bilbao,incomes,salary,1613.33,-68864.47
buyer_7,Agurtzane,Laka,1968-12-31,26592366L,agurtzane.laka@awesomecloud.co,463672,ES23209508102455354994,1990.94,2024-10-01T20:28:12,Bilbao,incomes,extra_income,185.75,-68678.72
buyer_7,Agurtzane,Laka,1968-12-31,26592366L,agurtzane.laka@awesomecloud.co,463672,ES23209508102455354994,1990.94,2024-10-01T08:43:23,Bilbao,expenses,transport,-61.85,-68740.57
buyer_7,Agurtzane,Laka,1968-12-31,26592366L,agurtzane.laka@awesomecloud.co,463672,ES23209508102455354994,1990.94,2024-10-03T03:19:35,Bilbao,expenses,food,-89.65,-68830.22
buyer_7,Agurtzane,Laka,1968-12-31,26592366L,agurtzane.laka@awesomecloud.co,463672,ES23209508102455354994,1990.94,2024-10-05T22:52:35,Bilbao,expenses,mortgage,-824.16,-69654.38
buyer_7,Agurtzane,Laka,1968-12-31,26592366L,agurtzane.laka@awesomecloud.co,463672,ES23209508102455354994,1990.94,2024-10-05T14:29:50,Bilbao,expenses,electricity,-34.06,-69688.44
buyer_7,Agurtzane,Laka,1968-12-31,26592366L,agurtzane.laka@awesomecloud.co,463672,ES23209508102455354994,1990.94,2024-10-06T13:16:55,Bilbao,expenses,gas,-33.69,-69722.13
buyer_7,Agurtzane,Laka,1968-12-31,26592366L,agurtzane.laka@awesomecloud.co,463672,ES23209508102455354994,1990.94,2024-10-06T13:27:36,Bilbao,expenses,appliances,-250.72,-69972.85
buyer_7,Agurtzane,Laka,1968-12-31,26592366L,agurtzane.laka@awesomecloud.co,463672,ES23209508102455354994,1990.94,2024-10-07T08:50:47,Bilbao,expenses,water,-34.14,-70006.99
buyer_7,Agurtzane,Laka,1968-12-31,26592366L,agurtzane.laka@awesomecloud.co,463672,ES23209508102455354994,1990.94,2024-10-07T19:54:53,Bilbao,expenses,gas,-75.83,-70082.82
buyer_7,Agurtzane,Laka,1968-12-31,26592366L,agurtzane.laka@awesomecloud.co,463672,ES23209508102455354994,1990.94,2024-10-07T18:22:43,Bilbao,expenses,phone,-34.73,-70117.55
buyer_7,Agurtzane,Laka,1968-12-31,26592366L,agurtzane.laka@awesomecloud.co,463672,ES23209508102455354994,1990.94,2024-10-07T13:24:27,Bilbao,expenses,food,-60.22,-70177.77
buyer_7,Agurtzane,Laka,1968-12-31,26592366L,agurtzane.laka@awesomecloud.co,463672,ES23209508102455354994,1990.94,2024-10-07T19:59:42,Bilbao,expenses,leisure,-24.2,-70201.97
buyer_7,Agurtzane,Laka,1968-12-31,26592366L,agurtzane.laka@awesomecloud.co,463672,ES23209508102455354994,1990.94,2024-10-07T17:41:36,Bilbao,expenses,children,-274.46241666666657,-70476.43
buyer_7,Agurtzane,Laka,1968-12-31,26592366L,agurtzane.laka@awesomecloud.co,463672,ES23209508102455354994,1990.94,2024-10-08T13:11:04,Bilbao,expenses,transport,-78.84,-70555.27
buyer_7,Agurtzane,Laka,1968-12-31,26592366L,agurtzane.laka@awesomecloud.co,463672,ES23209508102455354994,1990.94,2024-10-08T13:12:24,Bilbao,expenses,cash,-100.0,-70655.27
buyer_7,Agurtzane,Laka,1968-12-31,26592366L,agurtzane.laka@awesomecloud.co,463672,ES23209508102455354994,1990.94,2024-10-10T14:44:19,Bilbao,expenses,leisure,-56.71,-70711.98
buyer_8,Patxi,Urrutia,1979-04-04,93497737T,patxi.urrutia@hyperapp.online,421269,ES88209508878651879704,1800.62,2022-01-01T05:25:45,Durango,incomes,salary,3185.84,4986.46
buyer_8,Patxi,Urrutia,1979-04-04,93497737T,patxi.urrutia@hyperapp.online,421269,ES88209508878651879704,1800.62,2022-01-02T10:42:57,Durango,expenses,repairs,-150.51,4835.95
buyer_8,Patxi,Urrutia,1979-04-04,93497737T,patxi.urrutia@hyperapp.online,421269,ES88209508878651879704,1800.62,2022-01-04T13:15:40,Durango,expenses,transport,-80.24,4755.71
buyer_8,Patxi,Urrutia,1979-04-04,93497737T,patxi.urrutia@hyperapp.online,421269,ES88209508878651879704,1800.62,2022-01-05T19:06:29,Durango,expenses,mortgage,-1663.38,3092.33
buyer_8,Patxi,Urrutia,1979-04-04,93497737T,patxi.urrutia@hyperapp.online,421269,ES88209508878651879704,1800.62,2022-01-06T22:42:10,Durango,expenses,internet,-73.59,3018.74
buyer_8,Patxi,Urrutia,1979-04-04,93497737T,patxi.urrutia@hyperapp.online,421269,ES88209508878651879704,1800.62,2022-01-07T23:24:45,Durango,expenses,electricity,-149.2,2869.54
buyer_8,Patxi,Urrutia,1979-04-04,93497737T,patxi.urrutia@hyperapp.online,421269,ES88209508878651879704,1800.62,2022-01-08T11:52:09,Durango,expenses,water,-49.99,2819.55
buyer_8,Patxi,Urrutia,1979-04-04,93497737T,patxi.urrutia@hyperapp.online,421269,ES88209508878651879704,1800.62,2022-01-08T16:30:56,Durango,expenses,electricity,-78.26,2741.29
buyer_8,Patxi,Urrutia,1979-04-04,93497737T,patxi.urrutia@hyperapp.online,421269,ES88209508878651879704,1800.62,2022-01-08T09:27:39,Durango,expenses,gas,-182.49,2558.8
buyer_8,Patxi,Urrutia,1979-04-04,93497737T,patxi.urrutia@hyperapp.online,421269,ES88209508878651879704,1800.62,2022-01-08T16:47:52,Durango,expenses,gifts,-398.31,2160.49
buyer_8,Patxi,Urrutia,1979-04-04,93497737T,patxi.urrutia@hyperapp.online,421269,ES88209508878651879704,1800.62,2022-01-10T19:54:49,Durango,expenses,leisure,-50.72,2109.77
buyer_8,Patxi,Urrutia,1979-04-04,93497737T,patxi.urrutia@hyperapp.online,421269,ES88209508878651879704,1800.62,2022-01-14T05:13:52,Durango,expenses,leisure,-53.07,2056.7
buyer_8,Patxi,Urrutia,1979-04-04,93497737T,patxi.urrutia@hyperapp.online,421269,ES88209508878651879704,1800.62,2022-01-14T19:44:56,Durango,expenses,repairs,-207.37,1849.33
buyer_8,Patxi,Urrutia,1979-04-04,93497737T,patxi.urrutia@hyperapp.online,421269,ES88209508878651879704,1800.62,2022-01-17T09:35:00,Durango,expenses,food,-124.4,1724.93
buyer_8,Patxi,Urrutia,1979-04-04,93497737T,patxi.urrutia@hyperapp.online,421269,ES88209508878651879704,1800.62,2022-01-17T14:45:10,Durango,expenses,leisure,-63.88,1661.05
buyer_8,Patxi,Urrutia,1979-04-04,93497737T,patxi.urrutia@hyperapp.online,421269,ES88209508878651879704,1800.62,2022-01-19T09:46:48,Durango,expenses,leisure,-74.31,1586.74
buyer_8,Patxi,Urrutia,1979-04-04,93497737T,patxi.urrutia@hyperapp.online,421269,ES88209508878651879704,1800.62,2022-01-22T18:02:03,Durango,expenses,transport,-76.04,1510.7
buyer_8,Patxi,Urrutia,1979-04-04,93497737T,patxi.urrutia@hyperapp.online,421269,ES88209508878651879704,1800.62,2022-01-23T15:26:45,Durango,expenses,gifts,-488.25,1022.45
buyer_8,Patxi,Urrutia,1979-04-04,93497737T,patxi.urrutia@hyperapp.online,421269,ES88209508878651879704,1800.62,2022-01-25T18:44:46,Durango,expenses,transport,-59.36,963.09
buyer_8,Patxi,Urrutia,1979-04-04,93497737T,patxi.urrutia@hyperapp.online,421269,ES88209508878651879704,1800.62,2022-01-25T18:08:00,Durango,expenses,cash,-100.0,863.09
buyer_8,Patxi,Urrutia,1979-04-04,93497737T,patxi.urrutia@hyperapp.online,421269,ES88209508878651879704,1800.62,2022-01-26T18:04:26,Durango,expenses,food,-94.48,768.61
buyer_8,Patxi,Urrutia,1979-04-04,93497737T,patxi.urrutia@hyperapp.online,421269,ES88209508878651879704,1800.62,2022-01-27T09:48:33,Durango,expenses,food,-117.06,651.55
buyer_8,Patxi,Urrutia,1979-04-04,93497737T,patxi.urrutia@hyperapp.online,421269,ES88209508878651879704,1800.62,2022-01-27T14:04:41,Durango,expenses,transport,-47.78,603.77
buyer_8,Patxi,Urrutia,1979-04-04,93497737T,patxi.urrutia@hyperapp.online,421269,ES88209508878651879704,1800.62,2022-01-28T14:08:21,Durango,expenses,leisure,-18.88,584.89
buyer_8,Patxi,Urrutia,1979-04-04,93497737T,patxi.urrutia@hyperapp.online,421269,ES88209508878651879704,1800.62,2022-01-29T12:57:01,Durango,expenses,food,-109.38,475.51
buyer_8,Patxi,Urrutia,1979-04-04,93497737T,patxi.urrutia@hyperapp.online,421269,ES88209508878651879704,1800.62,2022-01-29T17:55:53,Durango,expenses,cash,-100.0,375.51
buyer_8,Patxi,Urrutia,1979-04-04,93497737T,patxi.urrutia@hyperapp.online,421269,ES88209508878651879704,1800.62,2022-01-30T10:31:15,Durango,expenses,cash,-100.0,275.51
buyer_8,Patxi,Urrutia,1979-04-04,93497737T,patxi.urrutia@hyperapp.online,421269,ES88209508878651879704,1800.62,2022-01-31T14:38:38,Durango,expenses,cash,-100.0,175.51
buyer_8,Patxi,Urrutia,1979-04-04,93497737T,patxi.urrutia@hyperapp.online,421269,ES88209508878651879704,1800.62,2022-02-01T08:02:39,Durango,incomes,salary,3185.84,3361.35
buyer_8,Patxi,Urrutia,1979-04-04,93497737T,patxi.urrutia@hyperapp.online,421269,ES88209508878651879704,1800.62,2022-02-01T09:15:38,Durango,expenses,food,-64.26,3297.09
buyer_8,Patxi,Urrutia,1979-04-04,93497737T,patxi.urrutia@hyperapp.online,421269,ES88209508878651879704,1800.62,2022-02-01T04:24:51,Durango,expenses,cash,-100.0,3197.09
buyer_8,Patxi,Urrutia,1979-04-04,93497737T,patxi.urrutia@hyperapp.online,421269,ES88209508878651879704,1800.62,2022-02-02T18:33:36,Durango,expenses,food,-120.05,3077.04
buyer_8,Patxi,Urrutia,1979-04-04,93497737T,patxi.urrutia@hyperapp.online,421269,ES88209508878651879704,1800.62,2022-02-02T16:40:59,Durango,expenses,cash,-100.0,2977.04
buyer_8,Patxi,Urrutia,1979-04-04,93497737T,patxi.urrutia@hyperapp.online,421269,ES88209508878651879704,1800.62,2022-02-04T19:04:12,Durango,expenses,transport,-72.16,2904.88
buyer_8,Patxi,Urrutia,1979-04-04,93497737T,patxi.urrutia@hyperapp.online,421269,ES88209508878651879704,1800.62,2022-02-05T01:37:40,Durango,expenses,mortgage,-1663.38,1241.5
buyer_8,Patxi,Urrutia,1979-04-04,93497737T,patxi.urrutia@hyperapp.online,421269,ES88209508878651879704,1800.62,2022-02-05T10:16:41,Durango,expenses,water,-52.3,1189.2
buyer_8,Patxi,Urrutia,1979-04-04,93497737T,patxi.urrutia@hyperapp.online,421269,ES88209508878651879704,1800.62,2022-02-05T12:52:47,Durango,expenses,gas,-67.93,1121.27
buyer_8,Patxi,Urrutia,1979-04-04,93497737T,patxi.urrutia@hyperapp.online,421269,ES88209508878651879704,1800.62,2022-02-05T08:25:59,Durango,expenses,internet,-73.59,1047.68
buyer_8,Patxi,Urrutia,1979-04-04,93497737T,patxi.urrutia@hyperapp.online,421269,ES88209508878651879704,1800.62,2022-02-06T13:42:28,Durango,expenses,transport,-80.76,966.92
buyer_8,Patxi,Urrutia,1979-04-04,93497737T,patxi.urrutia@hyperapp.online,421269,ES88209508878651879704,1800.62,2022-02-07T08:13:48,Durango,expenses,electricity,-85.13,881.79
buyer_8,Patxi,Urrutia,1979-04-04,93497737T,patxi.urrutia@hyperapp.online,421269,ES88209508878651879704,1800.62,2022-02-07T10:20:44,Durango,expenses,food,-118.21,763.58
buyer_8,Patxi,Urrutia,1979-04-04,93497737T,patxi.urrutia@hyperapp.online,421269,ES88209508878651879704,1800.62,2022-02-07T15:19:34,Durango,expenses,education,-48.61,714.97
buyer_8,Patxi,Urrutia,1979-04-04,93497737T,patxi.urrutia@hyperapp.online,421269,ES88209508878651879704,1800.62,2022-02-08T11:15:29,Durango,expenses,phone,-57.82,657.15
buyer_8,Patxi,Urrutia,1979-04-04,93497737T,patxi.urrutia@hyperapp.online,421269,ES88209508878651879704,1800.62,2022-02-10T16:12:29,Durango,expenses,healthcare,-188.68,468.47
buyer_8,Patxi,Urrutia,1979-04-04,93497737T,patxi.urrutia@hyperapp.online,421269,ES88209508878651879704,1800.62,2022-02-11T18:57:56,Durango,expenses,food,-83.1,385.37
buyer_8,Patxi,Urrutia,1979-04-04,93497737T,patxi.urrutia@hyperapp.online,421269,ES88209508878651879704,1800.62,2022-02-11T17:07:07,Durango,expenses,repairs,-153.85,231.52
buyer_8,Patxi,Urrutia,1979-04-04,93497737T,patxi.urrutia@hyperapp.online,421269,ES88209508878651879704,1800.62,2022-02-13T13:50:28,Durango,expenses,transport,-71.77,159.75
buyer_8,Patxi,Urrutia,1979-04-04,93497737T,patxi.urrutia@hyperapp.online,421269,ES88209508878651879704,1800.62,2022-02-13T11:34:52,Durango,expenses,leisure,-81.01,78.74
buyer_8,Patxi,Urrutia,1979-04-04,93497737T,patxi.urrutia@hyperapp.online,421269,ES88209508878651879704,1800.62,2022-02-13T13:06:47,Durango,expenses,repairs,-161.36,-82.62
buyer_8,Patxi,Urrutia,1979-04-04,93497737T,patxi.urrutia@hyperapp.online,421269,ES88209508878651879704,1800.62,2022-02-15T12:02:43,Durango,expenses,transport,-59.79,-142.41
buyer_8,Patxi,Urrutia,1979-04-04,93497737T,patxi.urrutia@hyperapp.online,421269,ES88209508878651879704,1800.62,2022-02-15T13:08:11,Durango,expenses,repairs,-118.01,-260.42
buyer_8,Patxi,Urrutia,1979-04-04,93497737T,patxi.urrutia@hyperapp.online,421269,ES88209508878651879704,1800.62,2022-02-16T18:02:14,Durango,expenses,travel,-418.24,-678.66
buyer_8,Patxi,Urrutia,1979-04-04,93497737T,patxi.urrutia@hyperapp.online,421269,ES88209508878651879704,1800.62,2022-02-17T19:48:18,Durango,expenses,healthcare,-42.64,-721.3
buyer_8,Patxi,Urrutia,1979-04-04,93497737T,patxi.urrutia@hyperapp.online,421269,ES88209508878651879704,1800.62,2022-02-18T17:38:11,Durango,expenses,transport,-73.29,-794.59
buyer_8,Patxi,Urrutia,1979-04-04,93497737T,patxi.urrutia@hyperapp.online,421269,ES88209508878651879704,1800.62,2022-02-19T14:18:15,Durango,expenses,repairs,-258.02,-1052.61
buyer_8,Patxi,Urrutia,1979-04-04,93497737T,patxi.urrutia@hyperapp.online,421269,ES88209508878651879704,1800.62,2022-02-23T21:03:37,Durango,expenses,gifts,-705.95,-1758.56
buyer_8,Patxi,Urrutia,1979-04-04,93497737T,patxi.urrutia@hyperapp.online,421269,ES88209508878651879704,1800.62,2022-02-26T13:18:58,Durango,expenses,leisure,-53.84,-1812.4
buyer_8,Patxi,Urrutia,1979-04-04,93497737T,patxi.urrutia@hyperapp.online,421269,ES88209508878651879704,1800.62,2022-02-26T16:01:06,Durango,expenses,travel,-472.16,-2284.56
buyer_8,Patxi,Urrutia,1979-04-04,93497737T,patxi.urrutia@hyperapp.online,421269,ES88209508878651879704,1800.62,2022-02-27T10:29:35,Durango,expenses,education,-43.18,-2327.74
buyer_8,Patxi,Urrutia,1979-04-04,93497737T,patxi.urrutia@hyperapp.online,421269,ES88209508878651879704,1800.62,2022-03-01T08:43:59,Durango,incomes,salary,3185.84,858.1
buyer_8,Patxi,Urrutia,1979-04-04,93497737T,patxi.urrutia@hyperapp.online,421269,ES88209508878651879704,1800.62,2022-03-01T08:43:59,Durango,incomes,extra_income,514.84,1372.94
buyer_8,Patxi,Urrutia,1979-04-04,93497737T,patxi.urrutia@hyperapp.online,421269,ES88209508878651879704,1800.62,2022-03-02T14:18:14,Durango,expenses,cash,-100.0,1272.94
buyer_8,Patxi,Urrutia,1979-04-04,93497737T,patxi.urrutia@hyperapp.online,421269,ES88209508878651879704,1800.62,2022-03-04T07:42:58,Durango,expenses,food,-108.4,1164.54
buyer_8,Patxi,Urrutia,1979-04-04,93497737T,patxi.urrutia@hyperapp.online,421269,ES88209508878651879704,1800.62,2022-03-05T12:22:15,Durango,expenses,mortgage,-1663.38,-498.84
buyer_8,Patxi,Urrutia,1979-04-04,93497737T,patxi.urrutia@hyperapp.online,421269,ES88209508878651879704,1800.62,2022-03-05T02:58:45,Durango,expenses,electricity,-114.44,-613.28
buyer_8,Patxi,Urrutia,1979-04-04,93497737T,patxi.urrutia@hyperapp.online,421269,ES88209508878651879704,1800.62,2022-03-06T22:04:13,Durango,expenses,water,-53.24,-666.52
buyer_8,Patxi,Urrutia,1979-04-04,93497737T,patxi.urrutia@hyperapp.online,421269,ES88209508878651879704,1800.62,2022-03-06T16:16:13,Durango,expenses,internet,-73.59,-740.11
buyer_8,Patxi,Urrutia,1979-04-04,93497737T,patxi.urrutia@hyperapp.online,421269,ES88209508878651879704,1800.62,2022-03-06T02:08:16,Durango,expenses,gifts,-439.86,-1179.97
buyer_8,Patxi,Urrutia,1979-04-04,93497737T,patxi.urrutia@hyperapp.online,421269,ES88209508878651879704,1800.62,2022-03-07T17:28:16,Durango,expenses,electricity,-143.95,-1323.92
buyer_8,Patxi,Urrutia,1979-04-04,93497737T,patxi.urrutia@hyperapp.online,421269,ES88209508878651879704,1800.62,2022-03-07T14:22:27,Durango,expenses,internet,-73.59,-1397.51
buyer_8,Patxi,Urrutia,1979-04-04,93497737T,patxi.urrutia@hyperapp.online,421269,ES88209508878651879704,1800.62,2022-03-08T09:14:05,Durango,expenses,phone,-54.05,-1451.56
buyer_8,Patxi,Urrutia,1979-04-04,93497737T,patxi.urrutia@hyperapp.online,421269,ES88209508878651879704,1800.62,2022-03-11T17:06:12,Durango,expenses,car,-248.21,-1699.77
buyer_8,Patxi,Urrutia,1979-04-04,93497737T,patxi.urrutia@hyperapp.online,421269,ES88209508878651879704,1800.62,2022-03-15T21:34:08,Durango,expenses,repairs,-320.05,-2019.82
buyer_8,Patxi,Urrutia,1979-04-04,93497737T,patxi.urrutia@hyperapp.online,421269,ES88209508878651879704,1800.62,2022-03-16T11:34:48,Durango,expenses,clothing,-60.78,-2080.6
buyer_8,Patxi,Urrutia,1979-04-04,93497737T,patxi.urrutia@hyperapp.online,421269,ES88209508878651879704,1800.62,2022-03-19T16:39:19,Durango,expenses,repairs,-51.65,-2132.25
buyer_8,Patxi,Urrutia,1979-04-04,93497737T,patxi.urrutia@hyperapp.online,421269,ES88209508878651879704,1800.62,2022-03-20T20:21:31,Durango,expenses,transport,-89.6,-2221.85
buyer_8,Patxi,Urrutia,1979-04-04,93497737T,patxi.urrutia@hyperapp.online,421269,ES88209508878651879704,1800.62,2022-03-24T09:54:15,Durango,expenses,cash,-100.0,-2321.85
buyer_8,Patxi,Urrutia,1979-04-04,93497737T,patxi.urrutia@hyperapp.online,421269,ES88209508878651879704,1800.62,2022-03-28T20:46:36,Durango,expenses,food,-75.52,-2397.37
buyer_8,Patxi,Urrutia,1979-04-04,93497737T,patxi.urrutia@hyperapp.online,421269,ES88209508878651879704,1800.62,2022-03-29T11:49:02,Durango,expenses,gifts,-378.25,-2775.62
buyer_8,Patxi,Urrutia,1979-04-04,93497737T,patxi.urrutia@hyperapp.online,421269,ES88209508878651879704,1800.62,2022-03-30T19:00:25,Durango,expenses,food,-85.64,-2861.26
buyer_8,Patxi,Urrutia,1979-04-04,93497737T,patxi.urrutia@hyperapp.online,421269,ES88209508878651879704,1800.62,2022-03-30T15:52:07,Durango,expenses,leisure,-47.47,-2908.73
buyer_8,Patxi,Urrutia,1979-04-04,93497737T,patxi.urrutia@hyperapp.online,421269,ES88209508878651879704,1800.62,2022-03-30T11:31:01,Durango,expenses,repairs,-311.41,-3220.14
buyer_8,Patxi,Urrutia,1979-04-04,93497737T,patxi.urrutia@hyperapp.online,421269,ES88209508878651879704,1800.62,2022-03-31T08:11:22,Durango,expenses,transport,-73.13,-3293.27
buyer_8,Patxi,Urrutia,1979-04-04,93497737T,patxi.urrutia@hyperapp.online,421269,ES88209508878651879704,1800.62,2022-03-31T23:25:58,Durango,expenses,appliances,-396.85,-3690.12
buyer_8,Patxi,Urrutia,1979-04-04,93497737T,patxi.urrutia@hyperapp.online,421269,ES88209508878651879704,1800.62,2022-04-01T16:30:16,Durango,incomes,salary,3185.84,-504.28
buyer_8,Patxi,Urrutia,1979-04-04,93497737T,patxi.urrutia@hyperapp.online,421269,ES88209508878651879704,1800.62,2022-04-03T10:46:53,Durango,expenses,food,-100.85,-605.13
buyer_8,Patxi,Urrutia,1979-04-04,93497737T,patxi.urrutia@hyperapp.online,421269,ES88209508878651879704,1800.62,2022-04-03T20:12:17,Durango,expenses,cash,-100.0,-705.13
buyer_8,Patxi,Urrutia,1979-04-04,93497737T,patxi.urrutia@hyperapp.online,421269,ES88209508878651879704,1800.62,2022-04-05T08:01:43,Durango,expenses,mortgage,-1663.38,-2368.51
buyer_8,Patxi,Urrutia,1979-04-04,93497737T,patxi.urrutia@hyperapp.online,421269,ES88209508878651879704,1800.62,2022-04-05T19:37:39,Durango,expenses,water,-57.18,-2425.69
buyer_8,Patxi,Urrutia,1979-04-04,93497737T,patxi.urrutia@hyperapp.online,421269,ES88209508878651879704,1800.62,2022-04-05T14:08:02,Durango,expenses,travel,-281.59,-2707.28
buyer_8,Patxi,Urrutia,1979-04-04,93497737T,patxi.urrutia@hyperapp.online,421269,ES88209508878651879704,1800.62,2022-04-06T17:10:48,Durango,expenses,water,-54.95,-2762.23
buyer_8,Patxi,Urrutia,1979-04-04,93497737T,patxi.urrutia@hyperapp.online,421269,ES88209508878651879704,1800.62,2022-04-06T23:56:33,Durango,expenses,electricity,-54.17,-2816.4
buyer_8,Patxi,Urrutia,1979-04-04,93497737T,patxi.urrutia@hyperapp.online,421269,ES88209508878651879704,1800.62,2022-04-06T10:07:41,Durango,expenses,clothing,-48.25,-2864.65
buyer_8,Patxi,Urrutia,1979-04-04,93497737T,patxi.urrutia@hyperapp.online,421269,ES88209508878651879704,1800.62,2022-04-06T11:30:37,Durango,expenses,appliances,-126.08,-2990.73
buyer_8,Patxi,Urrutia,1979-04-04,93497737T,patxi.urrutia@hyperapp.online,421269,ES88209508878651879704,1800.62,2022-04-07T14:41:28,Durango,expenses,water,-36.91,-3027.64
buyer_8,Patxi,Urrutia,1979-04-04,93497737T,patxi.urrutia@hyperapp.online,421269,ES88209508878651879704,1800.62,2022-04-07T16:04:51,Durango,expenses,gas,-75.9,-3103.54
buyer_8,Patxi,Urrutia,1979-04-04,93497737T,patxi.urrutia@hyperapp.online,421269,ES88209508878651879704,1800.62,2022-04-08T09:54:02,Durango,expenses,internet,-73.59,-3177.13
buyer_8,Patxi,Urrutia,1979-04-04,93497737T,patxi.urrutia@hyperapp.online,421269,ES88209508878651879704,1800.62,2022-04-08T17:00:59,Durango,expenses,phone,-56.29,-3233.42
buyer_8,Patxi,Urrutia,1979-04-04,93497737T,patxi.urrutia@hyperapp.online,421269,ES88209508878651879704,1800.62,2022-04-08T03:12:14,Durango,expenses,food,-69.86,-3303.28
buyer_8,Patxi,Urrutia,1979-04-04,93497737T,patxi.urrutia@hyperapp.online,421269,ES88209508878651879704,1800.62,2022-04-08T15:10:59,Durango,expenses,healthcare,-94.22,-3397.5
buyer_8,Patxi,Urrutia,1979-04-04,93497737T,patxi.urrutia@hyperapp.online,421269,ES88209508878651879704,1800.62,2022-04-08T09:07:20,Durango,expenses,education,-55.43,-3452.93
buyer_8,Patxi,Urrutia,1979-04-04,93497737T,patxi.urrutia@hyperapp.online,421269,ES88209508878651879704,1800.62,2022-04-11T08:22:31,Durango,expenses,gifts,-849.14,-4302.07
buyer_8,Patxi,Urrutia,1979-04-04,93497737T,patxi.urrutia@hyperapp.online,421269,ES88209508878651879704,1800.62,2022-04-12T12:38:30,Durango,expenses,leisure,-70.89,-4372.96
buyer_8,Patxi,Urrutia,1979-04-04,93497737T,patxi.urrutia@hyperapp.online,421269,ES88209508878651879704,1800.62,2022-04-12T01:48:53,Durango,expenses,repairs,-218.96,-4591.92
buyer_8,Patxi,Urrutia,1979-04-04,93497737T,patxi.urrutia@hyperapp.online,421269,ES88209508878651879704,1800.62,2022-04-14T08:28:32,Durango,expenses,transport,-76.61,-4668.53
buyer_8,Patxi,Urrutia,1979-04-04,93497737T,patxi.urrutia@hyperapp.online,421269,ES88209508878651879704,1800.62,2022-04-14T10:00:55,Durango,expenses,cash,-100.0,-4768.53
buyer_8,Patxi,Urrutia,1979-04-04,93497737T,patxi.urrutia@hyperapp.online,421269,ES88209508878651879704,1800.62,2022-04-14T20:05:37,Durango,expenses,repairs,-111.85,-4880.38
buyer_8,Patxi,Urrutia,1979-04-04,93497737T,patxi.urrutia@hyperapp.online,421269,ES88209508878651879704,1800.62,2022-04-16T13:39:46,Durango,expenses,food,-86.63,-4967.01
buyer_8,Patxi,Urrutia,1979-04-04,93497737T,patxi.urrutia@hyperapp.online,421269,ES88209508878651879704,1800.62,2022-04-17T09:19:55,Durango,expenses,leisure,-21.09,-4988.1
buyer_8,Patxi,Urrutia,1979-04-04,93497737T,patxi.urrutia@hyperapp.online,421269,ES88209508878651879704,1800.62,2022-04-17T17:16:46,Durango,expenses,cash,-100.0,-5088.1
buyer_8,Patxi,Urrutia,1979-04-04,93497737T,patxi.urrutia@hyperapp.online,421269,ES88209508878651879704,1800.62,2022-04-18T22:48:15,Durango,expenses,food,-111.27,-5199.37
buyer_8,Patxi,Urrutia,1979-04-04,93497737T,patxi.urrutia@hyperapp.online,421269,ES88209508878651879704,1800.62,2022-04-18T13:41:51,Durango,expenses,gifts,-157.43,-5356.8
buyer_8,Patxi,Urrutia,1979-04-04,93497737T,patxi.urrutia@hyperapp.online,421269,ES88209508878651879704,1800.62,2022-04-22T16:40:32,Durango,expenses,cash,-100.0,-5456.8
buyer_8,Patxi,Urrutia,1979-04-04,93497737T,patxi.urrutia@hyperapp.online,421269,ES88209508878651879704,1800.62,2022-04-23T12:07:51,Durango,expenses,food,-74.03,-5530.83
buyer_8,Patxi,Urrutia,1979-04-04,93497737T,patxi.urrutia@hyperapp.online,421269,ES88209508878651879704,1800.62,2022-04-23T11:24:31,Durango,expenses,transport,-82.54,-5613.37
buyer_8,Patxi,Urrutia,1979-04-04,93497737T,patxi.urrutia@hyperapp.online,421269,ES88209508878651879704,1800.62,2022-04-23T10:55:25,Durango,expenses,repairs,-220.71,-5834.08
buyer_8,Patxi,Urrutia,1979-04-04,93497737T,patxi.urrutia@hyperapp.online,421269,ES88209508878651879704,1800.62,2022-04-24T14:19:42,Durango,expenses,appliances,-276.24,-6110.32
buyer_8,Patxi,Urrutia,1979-04-04,93497737T,patxi.urrutia@hyperapp.online,421269,ES88209508878651879704,1800.62,2022-04-26T10:02:25,Durango,expenses,cash,-100.0,-6210.32
buyer_8,Patxi,Urrutia,1979-04-04,93497737T,patxi.urrutia@hyperapp.online,421269,ES88209508878651879704,1800.62,2022-04-27T19:29:09,Durango,expenses,food,-117.18,-6327.5
buyer_8,Patxi,Urrutia,1979-04-04,93497737T,patxi.urrutia@hyperapp.online,421269,ES88209508878651879704,1800.62,2022-04-30T09:14:05,Durango,expenses,repairs,-227.33,-6554.83
buyer_8,Patxi,Urrutia,1979-04-04,93497737T,patxi.urrutia@hyperapp.online,421269,ES88209508878651879704,1800.62,2022-05-01T18:53:16,Durango,incomes,salary,3185.84,-3368.99
buyer_8,Patxi,Urrutia,1979-04-04,93497737T,patxi.urrutia@hyperapp.online,421269,ES88209508878651879704,1800.62,2022-05-02T09:46:11,Durango,expenses,cash,-100.0,-3468.99
buyer_8,Patxi,Urrutia,1979-04-04,93497737T,patxi.urrutia@hyperapp.online,421269,ES88209508878651879704,1800.62,2022-05-03T18:54:09,Durango,expenses,food,-95.12,-3564.11
buyer_8,Patxi,Urrutia,1979-04-04,93497737T,patxi.urrutia@hyperapp.online,421269,ES88209508878651879704,1800.62,2022-05-03T10:00:21,Durango,expenses,cash,-100.0,-3664.11
buyer_8,Patxi,Urrutia,1979-04-04,93497737T,patxi.urrutia@hyperapp.online,421269,ES88209508878651879704,1800.62,2022-05-04T12:52:50,Durango,expenses,food,-110.19,-3774.3
buyer_8,Patxi,Urrutia,1979-04-04,93497737T,patxi.urrutia@hyperapp.online,421269,ES88209508878651879704,1800.62,2022-05-04T09:25:44,Durango,expenses,gifts,-265.62,-4039.92
buyer_8,Patxi,Urrutia,1979-04-04,93497737T,patxi.urrutia@hyperapp.online,421269,ES88209508878651879704,1800.62,2022-05-05T17:36:12,Durango,expenses,mortgage,-1663.38,-5703.3
buyer_8,Patxi,Urrutia,1979-04-04,93497737T,patxi.urrutia@hyperapp.online,421269,ES88209508878651879704,1800.62,2022-05-05T15:12:09,Durango,expenses,electricity,-114.45,-5817.75
buyer_8,Patxi,Urrutia,1979-04-04,93497737T,patxi.urrutia@hyperapp.online,421269,ES88209508878651879704,1800.62,2022-05-05T20:23:45,Durango,expenses,phone,-60.77,-5878.52
buyer_8,Patxi,Urrutia,1979-04-04,93497737T,patxi.urrutia@hyperapp.online,421269,ES88209508878651879704,1800.62,2022-05-05T17:01:05,Durango,expenses,cash,-100.0,-5978.52
buyer_8,Patxi,Urrutia,1979-04-04,93497737T,patxi.urrutia@hyperapp.online,421269,ES88209508878651879704,1800.62,2022-05-06T12:10:14,Durango,expenses,water,-77.87,-6056.39
buyer_8,Patxi,Urrutia,1979-04-04,93497737T,patxi.urrutia@hyperapp.online,421269,ES88209508878651879704,1800.62,2022-05-08T21:31:27,Durango,expenses,water,-64.57,-6120.96
buyer_8,Patxi,Urrutia,1979-04-04,93497737T,patxi.urrutia@hyperapp.online,421269,ES88209508878651879704,1800.62,2022-05-08T14:26:32,Durango,expenses,internet,-73.59,-6194.55
buyer_8,Patxi,Urrutia,1979-04-04,93497737T,patxi.urrutia@hyperapp.online,421269,ES88209508878651879704,1800.62,2022-05-09T18:23:52,Durango,expenses,food,-88.81,-6283.36
buyer_8,Patxi,Urrutia,1979-04-04,93497737T,patxi.urrutia@hyperapp.online,421269,ES88209508878651879704,1800.62,2022-05-09T10:37:28,Durango,expenses,transport,-40.33,-6323.69
buyer_8,Patxi,Urrutia,1979-04-04,93497737T,patxi.urrutia@hyperapp.online,421269,ES88209508878651879704,1800.62,2022-05-09T08:30:01,Durango,expenses,repairs,-58.48,-6382.17
buyer_8,Patxi,Urrutia,1979-04-04,93497737T,patxi.urrutia@hyperapp.online,421269,ES88209508878651879704,1800.62,2022-05-11T14:28:14,Durango,expenses,gifts,-694.97,-7077.14
buyer_8,Patxi,Urrutia,1979-04-04,93497737T,patxi.urrutia@hyperapp.online,421269,ES88209508878651879704,1800.62,2022-05-12T09:32:53,Durango,expenses,food,-95.51,-7172.65
buyer_8,Patxi,Urrutia,1979-04-04,93497737T,patxi.urrutia@hyperapp.online,421269,ES88209508878651879704,1800.62,2022-05-12T09:06:11,Durango,expenses,cash,-100.0,-7272.65
buyer_8,Patxi,Urrutia,1979-04-04,93497737T,patxi.urrutia@hyperapp.online,421269,ES88209508878651879704,1800.62,2022-05-14T16:09:51,Durango,expenses,food,-67.11,-7339.76
buyer_8,Patxi,Urrutia,1979-04-04,93497737T,patxi.urrutia@hyperapp.online,421269,ES88209508878651879704,1800.62,2022-05-14T08:06:50,Durango,expenses,transport,-42.2,-7381.96
buyer_8,Patxi,Urrutia,1979-04-04,93497737T,patxi.urrutia@hyperapp.online,421269,ES88209508878651879704,1800.62,2022-05-14T08:09:56,Durango,expenses,cash,-100.0,-7481.96
buyer_8,Patxi,Urrutia,1979-04-04,93497737T,patxi.urrutia@hyperapp.online,421269,ES88209508878651879704,1800.62,2022-05-18T08:56:39,Durango,expenses,transport,-86.15,-7568.11
buyer_8,Patxi,Urrutia,1979-04-04,93497737T,patxi.urrutia@hyperapp.online,421269,ES88209508878651879704,1800.62,2022-05-18T16:36:43,Durango,expenses,education,-68.73,-7636.84
buyer_8,Patxi,Urrutia,1979-04-04,93497737T,patxi.urrutia@hyperapp.online,421269,ES88209508878651879704,1800.62,2022-05-19T19:57:41,Durango,expenses,education,-64.35,-7701.19
buyer_8,Patxi,Urrutia,1979-04-04,93497737T,patxi.urrutia@hyperapp.online,421269,ES88209508878651879704,1800.62,2022-05-19T11:21:57,Durango,expenses,cash,-100.0,-7801.19
buyer_8,Patxi,Urrutia,1979-04-04,93497737T,patxi.urrutia@hyperapp.online,421269,ES88209508878651879704,1800.62,2022-05-21T01:34:02,Durango,expenses,transport,-57.65,-7858.84
buyer_8,Patxi,Urrutia,1979-04-04,93497737T,patxi.urrutia@hyperapp.online,421269,ES88209508878651879704,1800.62,2022-05-21T12:43:03,Durango,expenses,leisure,-42.88,-7901.72
buyer_8,Patxi,Urrutia,1979-04-04,93497737T,patxi.urrutia@hyperapp.online,421269,ES88209508878651879704,1800.62,2022-05-22T15:14:20,Durango,expenses,leisure,-32.57,-7934.29
buyer_8,Patxi,Urrutia,1979-04-04,93497737T,patxi.urrutia@hyperapp.online,421269,ES88209508878651879704,1800.62,2022-05-22T22:20:35,Durango,expenses,cash,-100.0,-8034.29
buyer_8,Patxi,Urrutia,1979-04-04,93497737T,patxi.urrutia@hyperapp.online,421269,ES88209508878651879704,1800.62,2022-05-23T14:36:20,Durango,expenses,food,-92.41,-8126.7
buyer_8,Patxi,Urrutia,1979-04-04,93497737T,patxi.urrutia@hyperapp.online,421269,ES88209508878651879704,1800.62,2022-05-25T16:46:20,Durango,expenses,food,-120.99,-8247.69
buyer_8,Patxi,Urrutia,1979-04-04,93497737T,patxi.urrutia@hyperapp.online,421269,ES88209508878651879704,1800.62,2022-05-25T20:22:37,Durango,expenses,gifts,-588.04,-8835.73
buyer_8,Patxi,Urrutia,1979-04-04,93497737T,patxi.urrutia@hyperapp.online,421269,ES88209508878651879704,1800.62,2022-05-26T03:11:59,Durango,expenses,food,-68.31,-8904.04
buyer_8,Patxi,Urrutia,1979-04-04,93497737T,patxi.urrutia@hyperapp.online,421269,ES88209508878651879704,1800.62,2022-05-26T22:54:11,Durango,expenses,gifts,-681.35,-9585.39
buyer_8,Patxi,Urrutia,1979-04-04,93497737T,patxi.urrutia@hyperapp.online,421269,ES88209508878651879704,1800.62,2022-05-28T11:48:23,Durango,expenses,repairs,-318.61,-9904.0
buyer_8,Patxi,Urrutia,1979-04-04,93497737T,patxi.urrutia@hyperapp.online,421269,ES88209508878651879704,1800.62,2022-05-29T18:48:47,Durango,expenses,cash,-100.0,-10004.0
buyer_8,Patxi,Urrutia,1979-04-04,93497737T,patxi.urrutia@hyperapp.online,421269,ES88209508878651879704,1800.62,2022-05-31T11:32:12,Durango,expenses,cash,-100.0,-10104.0
buyer_8,Patxi,Urrutia,1979-04-04,93497737T,patxi.urrutia@hyperapp.online,421269,ES88209508878651879704,1800.62,2022-06-01T17:42:07,Durango,incomes,salary,3185.84,-6918.16
buyer_8,Patxi,Urrutia,1979-04-04,93497737T,patxi.urrutia@hyperapp.online,421269,ES88209508878651879704,1800.62,2022-06-01T17:42:07,Durango,incomes,salary_bonus,2233.69,-4684.47
buyer_8,Patxi,Urrutia,1979-04-04,93497737T,patxi.urrutia@hyperapp.online,421269,ES88209508878651879704,1800.62,2022-06-01T12:24:19,Durango,expenses,taxes,-2830.86,-7515.33
buyer_8,Patxi,Urrutia,1979-04-04,93497737T,patxi.urrutia@hyperapp.online,421269,ES88209508878651879704,1800.62,2022-06-01T09:53:37,Durango,expenses,insurance,-726.65,-8241.98
buyer_8,Patxi,Urrutia,1979-04-04,93497737T,patxi.urrutia@hyperapp.online,421269,ES88209508878651879704,1800.62,2022-06-01T13:28:51,Durango,expenses,leisure,-64.65,-8306.63
buyer_8,Patxi,Urrutia,1979-04-04,93497737T,patxi.urrutia@hyperapp.online,421269,ES88209508878651879704,1800.62,2022-06-02T15:57:22,Durango,expenses,repairs,-192.98,-8499.61
buyer_8,Patxi,Urrutia,1979-04-04,93497737T,patxi.urrutia@hyperapp.online,421269,ES88209508878651879704,1800.62,2022-06-03T14:03:30,Durango,expenses,food,-112.48,-8612.09
buyer_8,Patxi,Urrutia,1979-04-04,93497737T,patxi.urrutia@hyperapp.online,421269,ES88209508878651879704,1800.62,2022-06-03T15:57:16,Durango,expenses,cash,-100.0,-8712.09
buyer_8,Patxi,Urrutia,1979-04-04,93497737T,patxi.urrutia@hyperapp.online,421269,ES88209508878651879704,1800.62,2022-06-04T10:18:22,Durango,expenses,leisure,-23.98,-8736.07
buyer_8,Patxi,Urrutia,1979-04-04,93497737T,patxi.urrutia@hyperapp.online,421269,ES88209508878651879704,1800.62,2022-06-05T16:18:25,Durango,expenses,mortgage,-1663.38,-10399.45
buyer_8,Patxi,Urrutia,1979-04-04,93497737T,patxi.urrutia@hyperapp.online,421269,ES88209508878651879704,1800.62,2022-06-06T18:41:25,Durango,expenses,food,-85.57,-10485.02
buyer_8,Patxi,Urrutia,1979-04-04,93497737T,patxi.urrutia@hyperapp.online,421269,ES88209508878651879704,1800.62,2022-06-06T16:45:26,Durango,expenses,cash,-100.0,-10585.02
buyer_8,Patxi,Urrutia,1979-04-04,93497737T,patxi.urrutia@hyperapp.online,421269,ES88209508878651879704,1800.62,2022-06-07T20:52:32,Durango,expenses,phone,-57.3,-10642.32
buyer_8,Patxi,Urrutia,1979-04-04,93497737T,patxi.urrutia@hyperapp.online,421269,ES88209508878651879704,1800.62,2022-06-08T09:37:12,Durango,expenses,electricity,-83.48,-10725.8
buyer_8,Patxi,Urrutia,1979-04-04,93497737T,patxi.urrutia@hyperapp.online,421269,ES88209508878651879704,1800.62,2022-06-08T11:26:31,Durango,expenses,internet,-73.59,-10799.39
buyer_8,Patxi,Urrutia,1979-04-04,93497737T,patxi.urrutia@hyperapp.online,421269,ES88209508878651879704,1800.62,2022-06-08T18:22:17,Durango,expenses,phone,-74.75,-10874.14
buyer_8,Patxi,Urrutia,1979-04-04,93497737T,patxi.urrutia@hyperapp.online,421269,ES88209508878651879704,1800.62,2022-06-08T16:46:39,Durango,expenses,leisure,-43.62,-10917.76
buyer_8,Patxi,Urrutia,1979-04-04,93497737T,patxi.urrutia@hyperapp.online,421269,ES88209508878651879704,1800.62,2022-06-10T08:18:52,Durango,expenses,gifts,-423.53,-11341.29
buyer_8,Patxi,Urrutia,1979-04-04,93497737T,patxi.urrutia@hyperapp.online,421269,ES88209508878651879704,1800.62,2022-06-14T12:49:07,Durango,expenses,leisure,-29.89,-11371.18
buyer_8,Patxi,Urrutia,1979-04-04,93497737T,patxi.urrutia@hyperapp.online,421269,ES88209508878651879704,1800.62,2022-06-14T14:24:44,Durango,expenses,repairs,-154.45,-11525.63
buyer_8,Patxi,Urrutia,1979-04-04,93497737T,patxi.urrutia@hyperapp.online,421269,ES88209508878651879704,1800.62,2022-06-15T10:53:00,Durango,expenses,food,-71.43,-11597.06
buyer_8,Patxi,Urrutia,1979-04-04,93497737T,patxi.urrutia@hyperapp.online,421269,ES88209508878651879704,1800.62,2022-06-15T06:48:52,Durango,expenses,education,-48.42,-11645.48
buyer_8,Patxi,Urrutia,1979-04-04,93497737T,patxi.urrutia@hyperapp.online,421269,ES88209508878651879704,1800.62,2022-06-17T16:25:48,Durango,expenses,leisure,-80.34,-11725.82
buyer_8,Patxi,Urrutia,1979-04-04,93497737T,patxi.urrutia@hyperapp.online,421269,ES88209508878651879704,1800.62,2022-06-18T11:29:41,Durango,expenses,food,-66.49,-11792.31
buyer_8,Patxi,Urrutia,1979-04-04,93497737T,patxi.urrutia@hyperapp.online,421269,ES88209508878651879704,1800.62,2022-06-18T10:37:53,Durango,expenses,transport,-65.1,-11857.41
buyer_8,Patxi,Urrutia,1979-04-04,93497737T,patxi.urrutia@hyperapp.online,421269,ES88209508878651879704,1800.62,2022-06-18T19:43:50,Durango,expenses,leisure,-42.38,-11899.79
buyer_8,Patxi,Urrutia,1979-04-04,93497737T,patxi.urrutia@hyperapp.online,421269,ES88209508878651879704,1800.62,2022-06-18T11:26:11,Durango,expenses,cash,-100.0,-11999.79
buyer_8,Patxi,Urrutia,1979-04-04,93497737T,patxi.urrutia@hyperapp.online,421269,ES88209508878651879704,1800.62,2022-06-19T09:45:30,Durango,expenses,repairs,-169.82,-12169.61
buyer_8,Patxi,Urrutia,1979-04-04,93497737T,patxi.urrutia@hyperapp.online,421269,ES88209508878651879704,1800.62,2022-06-20T08:27:20,Durango,expenses,leisure,-76.34,-12245.95
buyer_8,Patxi,Urrutia,1979-04-04,93497737T,patxi.urrutia@hyperapp.online,421269,ES88209508878651879704,1800.62,2022-06-21T19:31:17,Durango,expenses,leisure,-41.3,-12287.25
buyer_8,Patxi,Urrutia,1979-04-04,93497737T,patxi.urrutia@hyperapp.online,421269,ES88209508878651879704,1800.62,2022-06-22T21:33:00,Durango,expenses,education,-61.94,-12349.19
buyer_8,Patxi,Urrutia,1979-04-04,93497737T,patxi.urrutia@hyperapp.online,421269,ES88209508878651879704,1800.62,2022-06-23T08:42:09,Durango,expenses,clothing,-94.62,-12443.81
buyer_8,Patxi,Urrutia,1979-04-04,93497737T,patxi.urrutia@hyperapp.online,421269,ES88209508878651879704,1800.62,2022-06-24T09:10:41,Durango,expenses,transport,-46.26,-12490.07
buyer_8,Patxi,Urrutia,1979-04-04,93497737T,patxi.urrutia@hyperapp.online,421269,ES88209508878651879704,1800.62,2022-06-24T15:44:38,Durango,expenses,cash,-100.0,-12590.07
buyer_8,Patxi,Urrutia,1979-04-04,93497737T,patxi.urrutia@hyperapp.online,421269,ES88209508878651879704,1800.62,2022-06-24T16:10:46,Durango,expenses,gifts,-719.03,-13309.1
buyer_8,Patxi,Urrutia,1979-04-04,93497737T,patxi.urrutia@hyperapp.online,421269,ES88209508878651879704,1800.62,2022-06-26T15:26:24,Durango,expenses,food,-120.23,-13429.33
buyer_8,Patxi,Urrutia,1979-04-04,93497737T,patxi.urrutia@hyperapp.online,421269,ES88209508878651879704,1800.62,2022-06-26T11:24:42,Durango,expenses,transport,-59.36,-13488.69
buyer_8,Patxi,Urrutia,1979-04-04,93497737T,patxi.urrutia@hyperapp.online,421269,ES88209508878651879704,1800.62,2022-06-26T16:41:24,Durango,expenses,leisure,-70.04,-13558.73
buyer_8,Patxi,Urrutia,1979-04-04,93497737T,patxi.urrutia@hyperapp.online,421269,ES88209508878651879704,1800.62,2022-06-28T10:34:04,Durango,expenses,food,-89.24,-13647.97
buyer_8,Patxi,Urrutia,1979-04-04,93497737T,patxi.urrutia@hyperapp.online,421269,ES88209508878651879704,1800.62,2022-06-30T09:55:27,Durango,expenses,food,-69.64,-13717.61
buyer_8,Patxi,Urrutia,1979-04-04,93497737T,patxi.urrutia@hyperapp.online,421269,ES88209508878651879704,1800.62,2022-07-01T11:33:41,Durango,incomes,salary,3185.84,-10531.77
buyer_8,Patxi,Urrutia,1979-04-04,93497737T,patxi.urrutia@hyperapp.online,421269,ES88209508878651879704,1800.62,2022-07-01T11:33:41,Durango,incomes,extra_income,514.84,-10016.93
buyer_8,Patxi,Urrutia,1979-04-04,93497737T,patxi.urrutia@hyperapp.online,421269,ES88209508878651879704,1800.62,2022-07-01T13:29:04,Durango,expenses,leisure,-66.74,-10083.67
buyer_8,Patxi,Urrutia,1979-04-04,93497737T,patxi.urrutia@hyperapp.online,421269,ES88209508878651879704,1800.62,2022-07-04T20:30:55,Durango,expenses,leisure,-77.28,-10160.95
buyer_8,Patxi,Urrutia,1979-04-04,93497737T,patxi.urrutia@hyperapp.online,421269,ES88209508878651879704,1800.62,2022-07-05T17:40:12,Durango,expenses,mortgage,-1663.38,-11824.33
buyer_8,Patxi,Urrutia,1979-04-04,93497737T,patxi.urrutia@hyperapp.online,421269,ES88209508878651879704,1800.62,2022-07-05T11:47:13,Durango,expenses,gas,-119.39,-11943.72
buyer_8,Patxi,Urrutia,1979-04-04,93497737T,patxi.urrutia@hyperapp.online,421269,ES88209508878651879704,1800.62,2022-07-05T12:34:02,Durango,expenses,repairs,-82.66,-12026.38
buyer_8,Patxi,Urrutia,1979-04-04,93497737T,patxi.urrutia@hyperapp.online,421269,ES88209508878651879704,1800.62,2022-07-06T11:46:44,Durango,expenses,electricity,-70.35,-12096.73
buyer_8,Patxi,Urrutia,1979-04-04,93497737T,patxi.urrutia@hyperapp.online,421269,ES88209508878651879704,1800.62,2022-07-06T22:26:10,Durango,expenses,phone,-77.87,-12174.6
buyer_8,Patxi,Urrutia,1979-04-04,93497737T,patxi.urrutia@hyperapp.online,421269,ES88209508878651879704,1800.62,2022-07-08T18:12:24,Durango,expenses,electricity,-115.68,-12290.28
buyer_8,Patxi,Urrutia,1979-04-04,93497737T,patxi.urrutia@hyperapp.online,421269,ES88209508878651879704,1800.62,2022-07-08T16:28:03,Durango,expenses,repairs,-219.37,-12509.65
buyer_8,Patxi,Urrutia,1979-04-04,93497737T,patxi.urrutia@hyperapp.online,421269,ES88209508878651879704,1800.62,2022-07-11T17:49:29,Durango,expenses,food,-99.92,-12609.57
buyer_8,Patxi,Urrutia,1979-04-04,93497737T,patxi.urrutia@hyperapp.online,421269,ES88209508878651879704,1800.62,2022-07-11T08:59:12,Durango,expenses,cash,-100.0,-12709.57
buyer_8,Patxi,Urrutia,1979-04-04,93497737T,patxi.urrutia@hyperapp.online,421269,ES88209508878651879704,1800.62,2022-07-11T15:47:36,Durango,expenses,gifts,-286.46,-12996.03
buyer_8,Patxi,Urrutia,1979-04-04,93497737T,patxi.urrutia@hyperapp.online,421269,ES88209508878651879704,1800.62,2022-07-12T11:57:10,Durango,expenses,transport,-79.46,-13075.49
buyer_8,Patxi,Urrutia,1979-04-04,93497737T,patxi.urrutia@hyperapp.online,421269,ES88209508878651879704,1800.62,2022-07-12T00:12:36,Durango,expenses,travel,-425.0,-13500.49
buyer_8,Patxi,Urrutia,1979-04-04,93497737T,patxi.urrutia@hyperapp.online,421269,ES88209508878651879704,1800.62,2022-07-15T15:43:11,Durango,expenses,food,-90.5,-13590.99
buyer_8,Patxi,Urrutia,1979-04-04,93497737T,patxi.urrutia@hyperapp.online,421269,ES88209508878651879704,1800.62,2022-07-15T23:41:20,Durango,expenses,gifts,-580.0,-14170.99
buyer_8,Patxi,Urrutia,1979-04-04,93497737T,patxi.urrutia@hyperapp.online,421269,ES88209508878651879704,1800.62,2022-07-18T14:33:48,Durango,expenses,leisure,-35.46,-14206.45
buyer_8,Patxi,Urrutia,1979-04-04,93497737T,patxi.urrutia@hyperapp.online,421269,ES88209508878651879704,1800.62,2022-07-21T18:03:36,Durango,expenses,education,-74.18,-14280.63
buyer_8,Patxi,Urrutia,1979-04-04,93497737T,patxi.urrutia@hyperapp.online,421269,ES88209508878651879704,1800.62,2022-07-21T17:47:34,Durango,expenses,cash,-100.0,-14380.63
buyer_8,Patxi,Urrutia,1979-04-04,93497737T,patxi.urrutia@hyperapp.online,421269,ES88209508878651879704,1800.62,2022-07-21T10:47:06,Durango,expenses,gifts,-728.94,-15109.57
buyer_8,Patxi,Urrutia,1979-04-04,93497737T,patxi.urrutia@hyperapp.online,421269,ES88209508878651879704,1800.62,2022-07-22T16:17:03,Durango,expenses,gifts,-522.6,-15632.17
buyer_8,Patxi,Urrutia,1979-04-04,93497737T,patxi.urrutia@hyperapp.online,421269,ES88209508878651879704,1800.62,2022-07-23T17:03:34,Durango,expenses,leisure,-79.68,-15711.85
buyer_8,Patxi,Urrutia,1979-04-04,93497737T,patxi.urrutia@hyperapp.online,421269,ES88209508878651879704,1800.62,2022-07-25T08:44:43,Durango,expenses,cash,-100.0,-15811.85
buyer_8,Patxi,Urrutia,1979-04-04,93497737T,patxi.urrutia@hyperapp.online,421269,ES88209508878651879704,1800.62,2022-07-25T12:54:59,Durango,expenses,gifts,-92.66,-15904.51
buyer_8,Patxi,Urrutia,1979-04-04,93497737T,patxi.urrutia@hyperapp.online,421269,ES88209508878651879704,1800.62,2022-07-28T17:24:17,Durango,expenses,food,-92.29,-15996.8
buyer_8,Patxi,Urrutia,1979-04-04,93497737T,patxi.urrutia@hyperapp.online,421269,ES88209508878651879704,1800.62,2022-07-28T01:08:58,Durango,expenses,cash,-100.0,-16096.8
buyer_8,Patxi,Urrutia,1979-04-04,93497737T,patxi.urrutia@hyperapp.online,421269,ES88209508878651879704,1800.62,2022-07-31T11:26:23,Durango,expenses,travel,-810.82,-16907.62
buyer_8,Patxi,Urrutia,1979-04-04,93497737T,patxi.urrutia@hyperapp.online,421269,ES88209508878651879704,1800.62,2022-08-01T11:24:56,Durango,incomes,salary,3185.84,-13721.78
buyer_8,Patxi,Urrutia,1979-04-04,93497737T,patxi.urrutia@hyperapp.online,421269,ES88209508878651879704,1800.62,2022-08-01T09:40:59,Durango,expenses,food,-78.62,-13800.4
buyer_8,Patxi,Urrutia,1979-04-04,93497737T,patxi.urrutia@hyperapp.online,421269,ES88209508878651879704,1800.62,2022-08-01T05:42:08,Durango,expenses,transport,-66.09,-13866.49
buyer_8,Patxi,Urrutia,1979-04-04,93497737T,patxi.urrutia@hyperapp.online,421269,ES88209508878651879704,1800.62,2022-08-05T12:51:05,Durango,expenses,mortgage,-1663.38,-15529.87
buyer_8,Patxi,Urrutia,1979-04-04,93497737T,patxi.urrutia@hyperapp.online,421269,ES88209508878651879704,1800.62,2022-08-05T18:41:28,Durango,expenses,electricity,-38.25,-15568.12
buyer_8,Patxi,Urrutia,1979-04-04,93497737T,patxi.urrutia@hyperapp.online,421269,ES88209508878651879704,1800.62,2022-08-06T18:42:07,Durango,expenses,water,-73.61,-15641.73
buyer_8,Patxi,Urrutia,1979-04-04,93497737T,patxi.urrutia@hyperapp.online,421269,ES88209508878651879704,1800.62,2022-08-06T16:18:06,Durango,expenses,food,-68.39,-15710.12
buyer_8,Patxi,Urrutia,1979-04-04,93497737T,patxi.urrutia@hyperapp.online,421269,ES88209508878651879704,1800.62,2022-08-07T16:17:38,Durango,expenses,electricity,-99.91,-15810.03
buyer_8,Patxi,Urrutia,1979-04-04,93497737T,patxi.urrutia@hyperapp.online,421269,ES88209508878651879704,1800.62,2022-08-08T23:34:47,Durango,expenses,water,-70.6,-15880.63
buyer_8,Patxi,Urrutia,1979-04-04,93497737T,patxi.urrutia@hyperapp.online,421269,ES88209508878651879704,1800.62,2022-08-08T19:31:03,Durango,expenses,electricity,-96.73,-15977.36
buyer_8,Patxi,Urrutia,1979-04-04,93497737T,patxi.urrutia@hyperapp.online,421269,ES88209508878651879704,1800.62,2022-08-09T06:12:08,Durango,expenses,cash,-100.0,-16077.36
buyer_8,Patxi,Urrutia,1979-04-04,93497737T,patxi.urrutia@hyperapp.online,421269,ES88209508878651879704,1800.62,2022-08-11T21:40:06,Durango,expenses,transport,-83.03,-16160.39
buyer_8,Patxi,Urrutia,1979-04-04,93497737T,patxi.urrutia@hyperapp.online,421269,ES88209508878651879704,1800.62,2022-08-13T17:18:17,Durango,expenses,cash,-100.0,-16260.39
buyer_8,Patxi,Urrutia,1979-04-04,93497737T,patxi.urrutia@hyperapp.online,421269,ES88209508878651879704,1800.62,2022-08-15T11:51:10,Durango,expenses,leisure,-80.6,-16340.99
buyer_8,Patxi,Urrutia,1979-04-04,93497737T,patxi.urrutia@hyperapp.online,421269,ES88209508878651879704,1800.62,2022-08-18T13:22:24,Durango,expenses,food,-80.5,-16421.49
buyer_8,Patxi,Urrutia,1979-04-04,93497737T,patxi.urrutia@hyperapp.online,421269,ES88209508878651879704,1800.62,2022-08-18T10:37:19,Durango,expenses,leisure,-30.03,-16451.52
buyer_8,Patxi,Urrutia,1979-04-04,93497737T,patxi.urrutia@hyperapp.online,421269,ES88209508878651879704,1800.62,2022-08-19T11:17:07,Durango,expenses,cash,-100.0,-16551.52
buyer_8,Patxi,Urrutia,1979-04-04,93497737T,patxi.urrutia@hyperapp.online,421269,ES88209508878651879704,1800.62,2022-08-20T18:40:34,Durango,expenses,repairs,-223.9,-16775.42
buyer_8,Patxi,Urrutia,1979-04-04,93497737T,patxi.urrutia@hyperapp.online,421269,ES88209508878651879704,1800.62,2022-08-23T11:23:23,Durango,expenses,leisure,-70.19,-16845.61
buyer_8,Patxi,Urrutia,1979-04-04,93497737T,patxi.urrutia@hyperapp.online,421269,ES88209508878651879704,1800.62,2022-08-24T08:20:15,Durango,expenses,gifts,-658.78,-17504.39
buyer_8,Patxi,Urrutia,1979-04-04,93497737T,patxi.urrutia@hyperapp.online,421269,ES88209508878651879704,1800.62,2022-08-26T12:41:04,Durango,expenses,leisure,-18.63,-17523.02
buyer_8,Patxi,Urrutia,1979-04-04,93497737T,patxi.urrutia@hyperapp.online,421269,ES88209508878651879704,1800.62,2022-08-31T15:53:10,Durango,expenses,leisure,-43.23,-17566.25
buyer_8,Patxi,Urrutia,1979-04-04,93497737T,patxi.urrutia@hyperapp.online,421269,ES88209508878651879704,1800.62,2022-08-31T19:02:19,Durango,expenses,cash,-100.0,-17666.25
buyer_8,Patxi,Urrutia,1979-04-04,93497737T,patxi.urrutia@hyperapp.online,421269,ES88209508878651879704,1800.62,2022-09-01T14:07:59,Durango,incomes,salary,3185.84,-14480.41
buyer_8,Patxi,Urrutia,1979-04-04,93497737T,patxi.urrutia@hyperapp.online,421269,ES88209508878651879704,1800.62,2022-09-01T20:41:14,Durango,expenses,transport,-79.44,-14559.85
buyer_8,Patxi,Urrutia,1979-04-04,93497737T,patxi.urrutia@hyperapp.online,421269,ES88209508878651879704,1800.62,2022-09-01T10:40:37,Durango,expenses,cash,-100.0,-14659.85
buyer_8,Patxi,Urrutia,1979-04-04,93497737T,patxi.urrutia@hyperapp.online,421269,ES88209508878651879704,1800.62,2022-09-02T16:58:16,Durango,expenses,gifts,-336.33,-14996.18
buyer_8,Patxi,Urrutia,1979-04-04,93497737T,patxi.urrutia@hyperapp.online,421269,ES88209508878651879704,1800.62,2022-09-03T05:42:54,Durango,expenses,education,-76.23,-15072.41
buyer_8,Patxi,Urrutia,1979-04-04,93497737T,patxi.urrutia@hyperapp.online,421269,ES88209508878651879704,1800.62,2022-09-04T12:09:47,Durango,expenses,food,-81.55,-15153.96
buyer_8,Patxi,Urrutia,1979-04-04,93497737T,patxi.urrutia@hyperapp.online,421269,ES88209508878651879704,1800.62,2022-09-05T16:42:47,Durango,expenses,mortgage,-1663.38,-16817.34
buyer_8,Patxi,Urrutia,1979-04-04,93497737T,patxi.urrutia@hyperapp.online,421269,ES88209508878651879704,1800.62,2022-09-05T15:21:27,Durango,expenses,phone,-56.86,-16874.2
buyer_8,Patxi,Urrutia,1979-04-04,93497737T,patxi.urrutia@hyperapp.online,421269,ES88209508878651879704,1800.62,2022-09-05T17:17:39,Durango,expenses,repairs,-102.47,-16976.67
buyer_8,Patxi,Urrutia,1979-04-04,93497737T,patxi.urrutia@hyperapp.online,421269,ES88209508878651879704,1800.62,2022-09-06T20:17:39,Durango,expenses,repairs,-64.14,-17040.81
buyer_8,Patxi,Urrutia,1979-04-04,93497737T,patxi.urrutia@hyperapp.online,421269,ES88209508878651879704,1800.62,2022-09-07T17:22:46,Durango,expenses,water,-74.08,-17114.89
buyer_8,Patxi,Urrutia,1979-04-04,93497737T,patxi.urrutia@hyperapp.online,421269,ES88209508878651879704,1800.62,2022-09-08T19:04:00,Durango,expenses,internet,-73.59,-17188.48
buyer_8,Patxi,Urrutia,1979-04-04,93497737T,patxi.urrutia@hyperapp.online,421269,ES88209508878651879704,1800.62,2022-09-08T18:02:40,Durango,expenses,food,-115.2,-17303.68
buyer_8,Patxi,Urrutia,1979-04-04,93497737T,patxi.urrutia@hyperapp.online,421269,ES88209508878651879704,1800.62,2022-09-10T10:26:16,Durango,expenses,transport,-70.39,-17374.07
buyer_8,Patxi,Urrutia,1979-04-04,93497737T,patxi.urrutia@hyperapp.online,421269,ES88209508878651879704,1800.62,2022-09-10T01:44:36,Durango,expenses,leisure,-84.78,-17458.85
buyer_8,Patxi,Urrutia,1979-04-04,93497737T,patxi.urrutia@hyperapp.online,421269,ES88209508878651879704,1800.62,2022-09-10T05:54:23,Durango,expenses,clothing,-131.29,-17590.14
buyer_8,Patxi,Urrutia,1979-04-04,93497737T,patxi.urrutia@hyperapp.online,421269,ES88209508878651879704,1800.62,2022-09-10T18:00:56,Durango,expenses,car,-433.5,-18023.64
buyer_8,Patxi,Urrutia,1979-04-04,93497737T,patxi.urrutia@hyperapp.online,421269,ES88209508878651879704,1800.62,2022-09-11T12:40:33,Durango,expenses,food,-75.05,-18098.69
buyer_8,Patxi,Urrutia,1979-04-04,93497737T,patxi.urrutia@hyperapp.online,421269,ES88209508878651879704,1800.62,2022-09-12T11:38:38,Durango,expenses,cash,-100.0,-18198.69
buyer_8,Patxi,Urrutia,1979-04-04,93497737T,patxi.urrutia@hyperapp.online,421269,ES88209508878651879704,1800.62,2022-09-16T20:00:57,Durango,expenses,cash,-100.0,-18298.69
buyer_8,Patxi,Urrutia,1979-04-04,93497737T,patxi.urrutia@hyperapp.online,421269,ES88209508878651879704,1800.62,2022-09-18T20:30:18,Durango,expenses,cash,-100.0,-18398.69
buyer_8,Patxi,Urrutia,1979-04-04,93497737T,patxi.urrutia@hyperapp.online,421269,ES88209508878651879704,1800.62,2022-09-19T22:39:33,Durango,expenses,leisure,-81.18,-18479.87
buyer_8,Patxi,Urrutia,1979-04-04,93497737T,patxi.urrutia@hyperapp.online,421269,ES88209508878651879704,1800.62,2022-09-21T07:26:48,Durango,expenses,education,-70.0,-18549.87
buyer_8,Patxi,Urrutia,1979-04-04,93497737T,patxi.urrutia@hyperapp.online,421269,ES88209508878651879704,1800.62,2022-09-22T15:38:38,Durango,expenses,education,-54.25,-18604.12
buyer_8,Patxi,Urrutia,1979-04-04,93497737T,patxi.urrutia@hyperapp.online,421269,ES88209508878651879704,1800.62,2022-09-23T20:51:13,Durango,expenses,transport,-54.44,-18658.56
buyer_8,Patxi,Urrutia,1979-04-04,93497737T,patxi.urrutia@hyperapp.online,421269,ES88209508878651879704,1800.62,2022-09-23T04:24:55,Durango,expenses,education,-65.78,-18724.34
buyer_8,Patxi,Urrutia,1979-04-04,93497737T,patxi.urrutia@hyperapp.online,421269,ES88209508878651879704,1800.62,2022-09-25T19:29:46,Durango,expenses,transport,-40.13,-18764.47
buyer_8,Patxi,Urrutia,1979-04-04,93497737T,patxi.urrutia@hyperapp.online,421269,ES88209508878651879704,1800.62,2022-09-25T21:12:11,Durango,expenses,leisure,-28.66,-18793.13
buyer_8,Patxi,Urrutia,1979-04-04,93497737T,patxi.urrutia@hyperapp.online,421269,ES88209508878651879704,1800.62,2022-09-26T14:20:04,Durango,expenses,food,-97.15,-18890.28
buyer_8,Patxi,Urrutia,1979-04-04,93497737T,patxi.urrutia@hyperapp.online,421269,ES88209508878651879704,1800.62,2022-09-26T19:41:03,Durango,expenses,cash,-100.0,-18990.28
buyer_8,Patxi,Urrutia,1979-04-04,93497737T,patxi.urrutia@hyperapp.online,421269,ES88209508878651879704,1800.62,2022-09-27T17:05:10,Durango,expenses,education,-73.63,-19063.91
buyer_8,Patxi,Urrutia,1979-04-04,93497737T,patxi.urrutia@hyperapp.online,421269,ES88209508878651879704,1800.62,2022-09-27T18:08:35,Durango,expenses,cash,-100.0,-19163.91
buyer_8,Patxi,Urrutia,1979-04-04,93497737T,patxi.urrutia@hyperapp.online,421269,ES88209508878651879704,1800.62,2022-09-28T08:35:57,Durango,expenses,transport,-82.82,-19246.73
buyer_8,Patxi,Urrutia,1979-04-04,93497737T,patxi.urrutia@hyperapp.online,421269,ES88209508878651879704,1800.62,2022-09-29T18:03:48,Durango,expenses,repairs,-118.08,-19364.81
buyer_8,Patxi,Urrutia,1979-04-04,93497737T,patxi.urrutia@hyperapp.online,421269,ES88209508878651879704,1800.62,2022-10-01T11:22:32,Durango,incomes,salary,3185.84,-16178.97
buyer_8,Patxi,Urrutia,1979-04-04,93497737T,patxi.urrutia@hyperapp.online,421269,ES88209508878651879704,1800.62,2022-10-03T22:59:16,Durango,expenses,transport,-54.8,-16233.77
buyer_8,Patxi,Urrutia,1979-04-04,93497737T,patxi.urrutia@hyperapp.online,421269,ES88209508878651879704,1800.62,2022-10-03T11:00:09,Durango,expenses,cash,-100.0,-16333.77
buyer_8,Patxi,Urrutia,1979-04-04,93497737T,patxi.urrutia@hyperapp.online,421269,ES88209508878651879704,1800.62,2022-10-04T09:15:01,Durango,expenses,repairs,-314.13,-16647.9
buyer_8,Patxi,Urrutia,1979-04-04,93497737T,patxi.urrutia@hyperapp.online,421269,ES88209508878651879704,1800.62,2022-10-05T09:48:11,Durango,expenses,mortgage,-1663.38,-18311.28
buyer_8,Patxi,Urrutia,1979-04-04,93497737T,patxi.urrutia@hyperapp.online,421269,ES88209508878651879704,1800.62,2022-10-05T16:52:16,Durango,expenses,water,-35.94,-18347.22
buyer_8,Patxi,Urrutia,1979-04-04,93497737T,patxi.urrutia@hyperapp.online,421269,ES88209508878651879704,1800.62,2022-10-05T09:28:54,Durango,expenses,gas,-156.27,-18503.49
buyer_8,Patxi,Urrutia,1979-04-04,93497737T,patxi.urrutia@hyperapp.online,421269,ES88209508878651879704,1800.62,2022-10-05T08:42:14,Durango,expenses,leisure,-48.79,-18552.28
buyer_8,Patxi,Urrutia,1979-04-04,93497737T,patxi.urrutia@hyperapp.online,421269,ES88209508878651879704,1800.62,2022-10-05T09:05:45,Durango,expenses,cash,-100.0,-18652.28
buyer_8,Patxi,Urrutia,1979-04-04,93497737T,patxi.urrutia@hyperapp.online,421269,ES88209508878651879704,1800.62,2022-10-06T17:56:36,Durango,expenses,gifts,-807.93,-19460.21
buyer_8,Patxi,Urrutia,1979-04-04,93497737T,patxi.urrutia@hyperapp.online,421269,ES88209508878651879704,1800.62,2022-10-07T11:07:01,Durango,expenses,education,-52.81,-19513.02
buyer_8,Patxi,Urrutia,1979-04-04,93497737T,patxi.urrutia@hyperapp.online,421269,ES88209508878651879704,1800.62,2022-10-08T11:39:55,Durango,expenses,phone,-65.24,-19578.26
buyer_8,Patxi,Urrutia,1979-04-04,93497737T,patxi.urrutia@hyperapp.online,421269,ES88209508878651879704,1800.62,2022-10-08T02:12:35,Durango,expenses,cash,-100.0,-19678.26
buyer_8,Patxi,Urrutia,1979-04-04,93497737T,patxi.urrutia@hyperapp.online,421269,ES88209508878651879704,1800.62,2022-10-11T16:42:41,Durango,expenses,transport,-52.26,-19730.52
buyer_8,Patxi,Urrutia,1979-04-04,93497737T,patxi.urrutia@hyperapp.online,421269,ES88209508878651879704,1800.62,2022-10-13T14:44:10,Durango,expenses,leisure,-20.5,-19751.02
buyer_8,Patxi,Urrutia,1979-04-04,93497737T,patxi.urrutia@hyperapp.online,421269,ES88209508878651879704,1800.62,2022-10-14T09:48:48,Durango,expenses,cash,-100.0,-19851.02
buyer_8,Patxi,Urrutia,1979-04-04,93497737T,patxi.urrutia@hyperapp.online,421269,ES88209508878651879704,1800.62,2022-10-15T22:55:38,Durango,expenses,healthcare,-120.23,-19971.25
buyer_8,Patxi,Urrutia,1979-04-04,93497737T,patxi.urrutia@hyperapp.online,421269,ES88209508878651879704,1800.62,2022-10-15T06:49:41,Durango,expenses,cash,-100.0,-20071.25
buyer_8,Patxi,Urrutia,1979-04-04,93497737T,patxi.urrutia@hyperapp.online,421269,ES88209508878651879704,1800.62,2022-10-18T23:05:39,Durango,expenses,gifts,-34.36,-20105.61
buyer_8,Patxi,Urrutia,1979-04-04,93497737T,patxi.urrutia@hyperapp.online,421269,ES88209508878651879704,1800.62,2022-10-19T14:55:18,Durango,expenses,transport,-58.28,-20163.89
buyer_8,Patxi,Urrutia,1979-04-04,93497737T,patxi.urrutia@hyperapp.online,421269,ES88209508878651879704,1800.62,2022-10-20T17:11:10,Durango,expenses,education,-53.73,-20217.62
buyer_8,Patxi,Urrutia,1979-04-04,93497737T,patxi.urrutia@hyperapp.online,421269,ES88209508878651879704,1800.62,2022-10-23T15:09:44,Durango,expenses,food,-81.54,-20299.16
buyer_8,Patxi,Urrutia,1979-04-04,93497737T,patxi.urrutia@hyperapp.online,421269,ES88209508878651879704,1800.62,2022-10-24T12:12:19,Durango,expenses,education,-60.21,-20359.37
buyer_8,Patxi,Urrutia,1979-04-04,93497737T,patxi.urrutia@hyperapp.online,421269,ES88209508878651879704,1800.62,2022-10-24T14:15:13,Durango,expenses,appliances,-117.87,-20477.24
buyer_8,Patxi,Urrutia,1979-04-04,93497737T,patxi.urrutia@hyperapp.online,421269,ES88209508878651879704,1800.62,2022-10-25T14:28:02,Durango,expenses,transport,-49.98,-20527.22
buyer_8,Patxi,Urrutia,1979-04-04,93497737T,patxi.urrutia@hyperapp.online,421269,ES88209508878651879704,1800.62,2022-10-25T19:28:13,Durango,expenses,cash,-100.0,-20627.22
buyer_8,Patxi,Urrutia,1979-04-04,93497737T,patxi.urrutia@hyperapp.online,421269,ES88209508878651879704,1800.62,2022-10-25T17:37:49,Durango,expenses,travel,-680.38,-21307.6
buyer_8,Patxi,Urrutia,1979-04-04,93497737T,patxi.urrutia@hyperapp.online,421269,ES88209508878651879704,1800.62,2022-10-25T17:34:08,Durango,expenses,gifts,-54.38,-21361.98
buyer_8,Patxi,Urrutia,1979-04-04,93497737T,patxi.urrutia@hyperapp.online,421269,ES88209508878651879704,1800.62,2022-10-27T18:16:58,Durango,expenses,transport,-69.54,-21431.52
buyer_8,Patxi,Urrutia,1979-04-04,93497737T,patxi.urrutia@hyperapp.online,421269,ES88209508878651879704,1800.62,2022-10-31T07:30:42,Durango,expenses,cash,-100.0,-21531.52
buyer_8,Patxi,Urrutia,1979-04-04,93497737T,patxi.urrutia@hyperapp.online,421269,ES88209508878651879704,1800.62,2022-10-31T13:05:07,Durango,expenses,appliances,-237.18,-21768.7
buyer_8,Patxi,Urrutia,1979-04-04,93497737T,patxi.urrutia@hyperapp.online,421269,ES88209508878651879704,1800.62,2022-11-01T01:47:54,Durango,incomes,salary,3185.84,-18582.86
buyer_8,Patxi,Urrutia,1979-04-04,93497737T,patxi.urrutia@hyperapp.online,421269,ES88209508878651879704,1800.62,2022-11-01T01:47:54,Durango,incomes,extra_income,514.84,-18068.02
buyer_8,Patxi,Urrutia,1979-04-04,93497737T,patxi.urrutia@hyperapp.online,421269,ES88209508878651879704,1800.62,2022-11-02T16:29:23,Durango,expenses,gifts,-639.96,-18707.98
buyer_8,Patxi,Urrutia,1979-04-04,93497737T,patxi.urrutia@hyperapp.online,421269,ES88209508878651879704,1800.62,2022-11-04T19:33:48,Durango,expenses,healthcare,-102.59,-18810.57
buyer_8,Patxi,Urrutia,1979-04-04,93497737T,patxi.urrutia@hyperapp.online,421269,ES88209508878651879704,1800.62,2022-11-04T17:04:20,Durango,expenses,cash,-100.0,-18910.57
buyer_8,Patxi,Urrutia,1979-04-04,93497737T,patxi.urrutia@hyperapp.online,421269,ES88209508878651879704,1800.62,2022-11-04T15:56:09,Durango,expenses,gifts,-108.69,-19019.26
buyer_8,Patxi,Urrutia,1979-04-04,93497737T,patxi.urrutia@hyperapp.online,421269,ES88209508878651879704,1800.62,2022-11-05T06:33:05,Durango,expenses,mortgage,-1663.38,-20682.64
buyer_8,Patxi,Urrutia,1979-04-04,93497737T,patxi.urrutia@hyperapp.online,421269,ES88209508878651879704,1800.62,2022-11-05T12:04:25,Durango,expenses,internet,-73.59,-20756.23
buyer_8,Patxi,Urrutia,1979-04-04,93497737T,patxi.urrutia@hyperapp.online,421269,ES88209508878651879704,1800.62,2022-11-06T19:23:33,Durango,expenses,internet,-73.59,-20829.82
buyer_8,Patxi,Urrutia,1979-04-04,93497737T,patxi.urrutia@hyperapp.online,421269,ES88209508878651879704,1800.62,2022-11-06T08:20:31,Durango,expenses,leisure,-24.21,-20854.03
buyer_8,Patxi,Urrutia,1979-04-04,93497737T,patxi.urrutia@hyperapp.online,421269,ES88209508878651879704,1800.62,2022-11-06T13:35:44,Durango,expenses,clothing,-51.85,-20905.88
buyer_8,Patxi,Urrutia,1979-04-04,93497737T,patxi.urrutia@hyperapp.online,421269,ES88209508878651879704,1800.62,2022-11-07T19:47:36,Durango,expenses,electricity,-129.41,-21035.29
buyer_8,Patxi,Urrutia,1979-04-04,93497737T,patxi.urrutia@hyperapp.online,421269,ES88209508878651879704,1800.62,2022-11-07T23:07:29,Durango,expenses,gas,-127.33,-21162.62
buyer_8,Patxi,Urrutia,1979-04-04,93497737T,patxi.urrutia@hyperapp.online,421269,ES88209508878651879704,1800.62,2022-11-07T17:04:07,Durango,expenses,internet,-73.59,-21236.21
buyer_8,Patxi,Urrutia,1979-04-04,93497737T,patxi.urrutia@hyperapp.online,421269,ES88209508878651879704,1800.62,2022-11-08T21:16:56,Durango,expenses,gas,-67.39,-21303.6
buyer_8,Patxi,Urrutia,1979-04-04,93497737T,patxi.urrutia@hyperapp.online,421269,ES88209508878651879704,1800.62,2022-11-09T08:06:58,Durango,expenses,repairs,-302.42,-21606.02
buyer_8,Patxi,Urrutia,1979-04-04,93497737T,patxi.urrutia@hyperapp.online,421269,ES88209508878651879704,1800.62,2022-11-09T12:32:28,Durango,expenses,gifts,-159.44,-21765.46
buyer_8,Patxi,Urrutia,1979-04-04,93497737T,patxi.urrutia@hyperapp.online,421269,ES88209508878651879704,1800.62,2022-11-12T09:47:34,Durango,expenses,transport,-54.94,-21820.4
buyer_8,Patxi,Urrutia,1979-04-04,93497737T,patxi.urrutia@hyperapp.online,421269,ES88209508878651879704,1800.62,2022-11-12T20:58:59,Durango,expenses,clothing,-81.86,-21902.26
buyer_8,Patxi,Urrutia,1979-04-04,93497737T,patxi.urrutia@hyperapp.online,421269,ES88209508878651879704,1800.62,2022-11-13T11:27:59,Durango,expenses,appliances,-297.85,-22200.11
buyer_8,Patxi,Urrutia,1979-04-04,93497737T,patxi.urrutia@hyperapp.online,421269,ES88209508878651879704,1800.62,2022-11-16T20:52:49,Durango,expenses,travel,-817.57,-23017.68
buyer_8,Patxi,Urrutia,1979-04-04,93497737T,patxi.urrutia@hyperapp.online,421269,ES88209508878651879704,1800.62,2022-11-17T00:23:24,Durango,expenses,food,-121.65,-23139.33
buyer_8,Patxi,Urrutia,1979-04-04,93497737T,patxi.urrutia@hyperapp.online,421269,ES88209508878651879704,1800.62,2022-11-18T09:55:59,Durango,expenses,transport,-81.62,-23220.95
buyer_8,Patxi,Urrutia,1979-04-04,93497737T,patxi.urrutia@hyperapp.online,421269,ES88209508878651879704,1800.62,2022-11-20T12:50:56,Durango,expenses,transport,-88.36,-23309.31
buyer_8,Patxi,Urrutia,1979-04-04,93497737T,patxi.urrutia@hyperapp.online,421269,ES88209508878651879704,1800.62,2022-11-21T11:23:47,Durango,expenses,leisure,-69.94,-23379.25
buyer_8,Patxi,Urrutia,1979-04-04,93497737T,patxi.urrutia@hyperapp.online,421269,ES88209508878651879704,1800.62,2022-11-23T13:13:30,Durango,expenses,transport,-77.16,-23456.41
buyer_8,Patxi,Urrutia,1979-04-04,93497737T,patxi.urrutia@hyperapp.online,421269,ES88209508878651879704,1800.62,2022-11-24T20:20:23,Durango,expenses,repairs,-249.92,-23706.33
buyer_8,Patxi,Urrutia,1979-04-04,93497737T,patxi.urrutia@hyperapp.online,421269,ES88209508878651879704,1800.62,2022-11-24T14:44:28,Durango,expenses,gifts,-155.38,-23861.71
buyer_8,Patxi,Urrutia,1979-04-04,93497737T,patxi.urrutia@hyperapp.online,421269,ES88209508878651879704,1800.62,2022-11-25T23:31:37,Durango,expenses,gifts,-616.9,-24478.61
buyer_8,Patxi,Urrutia,1979-04-04,93497737T,patxi.urrutia@hyperapp.online,421269,ES88209508878651879704,1800.62,2022-11-30T21:47:16,Durango,expenses,education,-64.65,-24543.26
buyer_8,Patxi,Urrutia,1979-04-04,93497737T,patxi.urrutia@hyperapp.online,421269,ES88209508878651879704,1800.62,2022-11-30T11:51:11,Durango,expenses,gifts,-687.45,-25230.71
buyer_8,Patxi,Urrutia,1979-04-04,93497737T,patxi.urrutia@hyperapp.online,421269,ES88209508878651879704,1800.62,2022-12-01T09:50:39,Durango,incomes,salary,3185.84,-22044.87
buyer_8,Patxi,Urrutia,1979-04-04,93497737T,patxi.urrutia@hyperapp.online,421269,ES88209508878651879704,1800.62,2022-12-01T09:50:39,Durango,incomes,salary_bonus,2346.65,-19698.22
buyer_8,Patxi,Urrutia,1979-04-04,93497737T,patxi.urrutia@hyperapp.online,421269,ES88209508878651879704,1800.62,2022-12-03T06:44:47,Durango,expenses,food,-100.47,-19798.69
buyer_8,Patxi,Urrutia,1979-04-04,93497737T,patxi.urrutia@hyperapp.online,421269,ES88209508878651879704,1800.62,2022-12-03T08:45:31,Durango,expenses,appliances,-365.24,-20163.93
buyer_8,Patxi,Urrutia,1979-04-04,93497737T,patxi.urrutia@hyperapp.online,421269,ES88209508878651879704,1800.62,2022-12-05T13:31:42,Durango,expenses,mortgage,-1663.38,-21827.31
buyer_8,Patxi,Urrutia,1979-04-04,93497737T,patxi.urrutia@hyperapp.online,421269,ES88209508878651879704,1800.62,2022-12-05T12:31:33,Durango,expenses,gas,-66.07,-21893.38
buyer_8,Patxi,Urrutia,1979-04-04,93497737T,patxi.urrutia@hyperapp.online,421269,ES88209508878651879704,1800.62,2022-12-06T13:00:43,Durango,expenses,gas,-134.13,-22027.51
buyer_8,Patxi,Urrutia,1979-04-04,93497737T,patxi.urrutia@hyperapp.online,421269,ES88209508878651879704,1800.62,2022-12-07T14:37:04,Durango,expenses,gas,-81.87,-22109.38
buyer_8,Patxi,Urrutia,1979-04-04,93497737T,patxi.urrutia@hyperapp.online,421269,ES88209508878651879704,1800.62,2022-12-07T16:14:46,Durango,expenses,transport,-54.27,-22163.65
buyer_8,Patxi,Urrutia,1979-04-04,93497737T,patxi.urrutia@hyperapp.online,421269,ES88209508878651879704,1800.62,2022-12-07T09:29:01,Durango,expenses,repairs,-314.47,-22478.12
buyer_8,Patxi,Urrutia,1979-04-04,93497737T,patxi.urrutia@hyperapp.online,421269,ES88209508878651879704,1800.62,2022-12-08T13:56:57,Durango,expenses,phone,-73.91,-22552.03
buyer_8,Patxi,Urrutia,1979-04-04,93497737T,patxi.urrutia@hyperapp.online,421269,ES88209508878651879704,1800.62,2022-12-11T20:50:20,Durango,expenses,transport,-58.6,-22610.63
buyer_8,Patxi,Urrutia,1979-04-04,93497737T,patxi.urrutia@hyperapp.online,421269,ES88209508878651879704,1800.62,2022-12-14T13:07:28,Durango,expenses,leisure,-48.98,-22659.61
buyer_8,Patxi,Urrutia,1979-04-04,93497737T,patxi.urrutia@hyperapp.online,421269,ES88209508878651879704,1800.62,2022-12-14T13:43:41,Durango,expenses,clothing,-152.87,-22812.48
buyer_8,Patxi,Urrutia,1979-04-04,93497737T,patxi.urrutia@hyperapp.online,421269,ES88209508878651879704,1800.62,2022-12-14T14:59:44,Durango,expenses,healthcare,-86.85,-22899.33
buyer_8,Patxi,Urrutia,1979-04-04,93497737T,patxi.urrutia@hyperapp.online,421269,ES88209508878651879704,1800.62,2022-12-15T19:15:39,Durango,expenses,leisure,-64.91,-22964.24
buyer_8,Patxi,Urrutia,1979-04-04,93497737T,patxi.urrutia@hyperapp.online,421269,ES88209508878651879704,1800.62,2022-12-15T11:21:35,Durango,expenses,gifts,-694.14,-23658.38
buyer_8,Patxi,Urrutia,1979-04-04,93497737T,patxi.urrutia@hyperapp.online,421269,ES88209508878651879704,1800.62,2022-12-16T23:44:11,Durango,expenses,cash,-100.0,-23758.38
buyer_8,Patxi,Urrutia,1979-04-04,93497737T,patxi.urrutia@hyperapp.online,421269,ES88209508878651879704,1800.62,2022-12-17T17:43:08,Durango,expenses,food,-116.38,-23874.76
buyer_8,Patxi,Urrutia,1979-04-04,93497737T,patxi.urrutia@hyperapp.online,421269,ES88209508878651879704,1800.62,2022-12-17T19:20:38,Durango,expenses,cash,-100.0,-23974.76
buyer_8,Patxi,Urrutia,1979-04-04,93497737T,patxi.urrutia@hyperapp.online,421269,ES88209508878651879704,1800.62,2022-12-18T20:18:07,Durango,expenses,cash,-100.0,-24074.76
buyer_8,Patxi,Urrutia,1979-04-04,93497737T,patxi.urrutia@hyperapp.online,421269,ES88209508878651879704,1800.62,2022-12-19T16:33:45,Durango,expenses,transport,-81.08,-24155.84
buyer_8,Patxi,Urrutia,1979-04-04,93497737T,patxi.urrutia@hyperapp.online,421269,ES88209508878651879704,1800.62,2022-12-22T17:47:30,Durango,expenses,clothing,-59.08,-24214.92
buyer_8,Patxi,Urrutia,1979-04-04,93497737T,patxi.urrutia@hyperapp.online,421269,ES88209508878651879704,1800.62,2022-12-23T17:42:42,Durango,expenses,leisure,-18.41,-24233.33
buyer_8,Patxi,Urrutia,1979-04-04,93497737T,patxi.urrutia@hyperapp.online,421269,ES88209508878651879704,1800.62,2022-12-24T15:54:21,Durango,expenses,food,-121.37,-24354.7
buyer_8,Patxi,Urrutia,1979-04-04,93497737T,patxi.urrutia@hyperapp.online,421269,ES88209508878651879704,1800.62,2022-12-27T21:13:30,Durango,expenses,food,-67.37,-24422.07
buyer_8,Patxi,Urrutia,1979-04-04,93497737T,patxi.urrutia@hyperapp.online,421269,ES88209508878651879704,1800.62,2022-12-27T17:39:52,Durango,expenses,cash,-100.0,-24522.07
buyer_8,Patxi,Urrutia,1979-04-04,93497737T,patxi.urrutia@hyperapp.online,421269,ES88209508878651879704,1800.62,2022-12-31T12:29:13,Durango,expenses,food,-76.46,-24598.53
buyer_8,Patxi,Urrutia,1979-04-04,93497737T,patxi.urrutia@hyperapp.online,421269,ES88209508878651879704,1800.62,2023-01-01T19:07:09,Durango,incomes,salary,3276.11,-21322.42
buyer_8,Patxi,Urrutia,1979-04-04,93497737T,patxi.urrutia@hyperapp.online,421269,ES88209508878651879704,1800.62,2023-01-02T15:02:58,Durango,expenses,food,-109.76,-21432.18
buyer_8,Patxi,Urrutia,1979-04-04,93497737T,patxi.urrutia@hyperapp.online,421269,ES88209508878651879704,1800.62,2023-01-02T14:07:37,Durango,expenses,cash,-100.0,-21532.18
buyer_8,Patxi,Urrutia,1979-04-04,93497737T,patxi.urrutia@hyperapp.online,421269,ES88209508878651879704,1800.62,2023-01-04T11:25:39,Durango,expenses,food,-122.19,-21654.37
buyer_8,Patxi,Urrutia,1979-04-04,93497737T,patxi.urrutia@hyperapp.online,421269,ES88209508878651879704,1800.62,2023-01-04T12:59:32,Durango,expenses,cash,-100.0,-21754.37
buyer_8,Patxi,Urrutia,1979-04-04,93497737T,patxi.urrutia@hyperapp.online,421269,ES88209508878651879704,1800.62,2023-01-04T11:01:41,Durango,expenses,repairs,-73.09,-21827.46
buyer_8,Patxi,Urrutia,1979-04-04,93497737T,patxi.urrutia@hyperapp.online,421269,ES88209508878651879704,1800.62,2023-01-05T01:34:41,Durango,expenses,mortgage,-1291.34,-23118.8
buyer_8,Patxi,Urrutia,1979-04-04,93497737T,patxi.urrutia@hyperapp.online,421269,ES88209508878651879704,1800.62,2023-01-05T15:31:51,Durango,expenses,internet,-75.68,-23194.48
buyer_8,Patxi,Urrutia,1979-04-04,93497737T,patxi.urrutia@hyperapp.online,421269,ES88209508878651879704,1800.62,2023-01-06T11:39:18,Durango,expenses,water,-47.98,-23242.46
buyer_8,Patxi,Urrutia,1979-04-04,93497737T,patxi.urrutia@hyperapp.online,421269,ES88209508878651879704,1800.62,2023-01-06T16:58:08,Durango,expenses,transport,-56.12,-23298.58
buyer_8,Patxi,Urrutia,1979-04-04,93497737T,patxi.urrutia@hyperapp.online,421269,ES88209508878651879704,1800.62,2023-01-06T08:14:02,Durango,expenses,cash,-100.0,-23398.58
buyer_8,Patxi,Urrutia,1979-04-04,93497737T,patxi.urrutia@hyperapp.online,421269,ES88209508878651879704,1800.62,2023-01-07T20:28:50,Durango,expenses,water,-67.78,-23466.36
buyer_8,Patxi,Urrutia,1979-04-04,93497737T,patxi.urrutia@hyperapp.online,421269,ES88209508878651879704,1800.62,2023-01-07T19:14:59,Durango,expenses,clothing,-66.82,-23533.18
buyer_8,Patxi,Urrutia,1979-04-04,93497737T,patxi.urrutia@hyperapp.online,421269,ES88209508878651879704,1800.62,2023-01-08T11:38:00,Durango,expenses,phone,-80.57,-23613.75
buyer_8,Patxi,Urrutia,1979-04-04,93497737T,patxi.urrutia@hyperapp.online,421269,ES88209508878651879704,1800.62,2023-01-10T08:01:16,Durango,expenses,cash,-100.0,-23713.75
buyer_8,Patxi,Urrutia,1979-04-04,93497737T,patxi.urrutia@hyperapp.online,421269,ES88209508878651879704,1800.62,2023-01-10T15:42:32,Durango,expenses,repairs,-222.65,-23936.4
buyer_8,Patxi,Urrutia,1979-04-04,93497737T,patxi.urrutia@hyperapp.online,421269,ES88209508878651879704,1800.62,2023-01-13T12:44:16,Durango,expenses,appliances,-220.05,-24156.45
buyer_8,Patxi,Urrutia,1979-04-04,93497737T,patxi.urrutia@hyperapp.online,421269,ES88209508878651879704,1800.62,2023-01-14T02:46:16,Durango,expenses,repairs,-216.63,-24373.08
buyer_8,Patxi,Urrutia,1979-04-04,93497737T,patxi.urrutia@hyperapp.online,421269,ES88209508878651879704,1800.62,2023-01-15T19:26:10,Durango,expenses,leisure,-23.77,-24396.85
buyer_8,Patxi,Urrutia,1979-04-04,93497737T,patxi.urrutia@hyperapp.online,421269,ES88209508878651879704,1800.62,2023-01-15T19:17:32,Durango,expenses,cash,-100.0,-24496.85
buyer_8,Patxi,Urrutia,1979-04-04,93497737T,patxi.urrutia@hyperapp.online,421269,ES88209508878651879704,1800.62,2023-01-16T19:01:31,Durango,expenses,transport,-70.03,-24566.88
buyer_8,Patxi,Urrutia,1979-04-04,93497737T,patxi.urrutia@hyperapp.online,421269,ES88209508878651879704,1800.62,2023-01-16T12:03:31,Durango,expenses,cash,-100.0,-24666.88
buyer_8,Patxi,Urrutia,1979-04-04,93497737T,patxi.urrutia@hyperapp.online,421269,ES88209508878651879704,1800.62,2023-01-17T14:48:30,Durango,expenses,cash,-100.0,-24766.88
buyer_8,Patxi,Urrutia,1979-04-04,93497737T,patxi.urrutia@hyperapp.online,421269,ES88209508878651879704,1800.62,2023-01-18T13:17:44,Durango,expenses,repairs,-207.68,-24974.56
buyer_8,Patxi,Urrutia,1979-04-04,93497737T,patxi.urrutia@hyperapp.online,421269,ES88209508878651879704,1800.62,2023-01-19T18:33:04,Durango,expenses,car,-514.57,-25489.13
buyer_8,Patxi,Urrutia,1979-04-04,93497737T,patxi.urrutia@hyperapp.online,421269,ES88209508878651879704,1800.62,2023-01-20T14:25:20,Durango,expenses,food,-122.05,-25611.18
buyer_8,Patxi,Urrutia,1979-04-04,93497737T,patxi.urrutia@hyperapp.online,421269,ES88209508878651879704,1800.62,2023-01-20T11:39:16,Durango,expenses,healthcare,-61.76,-25672.94
buyer_8,Patxi,Urrutia,1979-04-04,93497737T,patxi.urrutia@hyperapp.online,421269,ES88209508878651879704,1800.62,2023-01-20T17:43:52,Durango,expenses,cash,-100.0,-25772.94
buyer_8,Patxi,Urrutia,1979-04-04,93497737T,patxi.urrutia@hyperapp.online,421269,ES88209508878651879704,1800.62,2023-01-22T21:22:54,Durango,expenses,food,-107.61,-25880.55
buyer_8,Patxi,Urrutia,1979-04-04,93497737T,patxi.urrutia@hyperapp.online,421269,ES88209508878651879704,1800.62,2023-01-22T13:59:02,Durango,expenses,leisure,-70.77,-25951.32
buyer_8,Patxi,Urrutia,1979-04-04,93497737T,patxi.urrutia@hyperapp.online,421269,ES88209508878651879704,1800.62,2023-01-22T14:16:21,Durango,expenses,appliances,-130.78,-26082.1
buyer_8,Patxi,Urrutia,1979-04-04,93497737T,patxi.urrutia@hyperapp.online,421269,ES88209508878651879704,1800.62,2023-01-22T19:01:51,Durango,expenses,repairs,-328.61,-26410.71
buyer_8,Patxi,Urrutia,1979-04-04,93497737T,patxi.urrutia@hyperapp.online,421269,ES88209508878651879704,1800.62,2023-01-23T04:18:50,Durango,expenses,transport,-73.83,-26484.54
buyer_8,Patxi,Urrutia,1979-04-04,93497737T,patxi.urrutia@hyperapp.online,421269,ES88209508878651879704,1800.62,2023-01-23T20:33:30,Durango,expenses,leisure,-41.46,-26526.0
buyer_8,Patxi,Urrutia,1979-04-04,93497737T,patxi.urrutia@hyperapp.online,421269,ES88209508878651879704,1800.62,2023-01-24T13:36:21,Durango,expenses,food,-76.63,-26602.63
buyer_8,Patxi,Urrutia,1979-04-04,93497737T,patxi.urrutia@hyperapp.online,421269,ES88209508878651879704,1800.62,2023-01-24T19:07:03,Durango,expenses,transport,-85.01,-26687.64
buyer_8,Patxi,Urrutia,1979-04-04,93497737T,patxi.urrutia@hyperapp.online,421269,ES88209508878651879704,1800.62,2023-01-25T11:22:09,Durango,expenses,cash,-100.0,-26787.64
buyer_8,Patxi,Urrutia,1979-04-04,93497737T,patxi.urrutia@hyperapp.online,421269,ES88209508878651879704,1800.62,2023-01-25T13:48:50,Durango,expenses,repairs,-240.71,-27028.35
buyer_8,Patxi,Urrutia,1979-04-04,93497737T,patxi.urrutia@hyperapp.online,421269,ES88209508878651879704,1800.62,2023-01-26T02:45:59,Durango,expenses,transport,-72.18,-27100.53
buyer_8,Patxi,Urrutia,1979-04-04,93497737T,patxi.urrutia@hyperapp.online,421269,ES88209508878651879704,1800.62,2023-01-26T08:49:02,Durango,expenses,gifts,-741.99,-27842.52
buyer_8,Patxi,Urrutia,1979-04-04,93497737T,patxi.urrutia@hyperapp.online,421269,ES88209508878651879704,1800.62,2023-01-28T16:45:06,Durango,expenses,cash,-100.0,-27942.52
buyer_8,Patxi,Urrutia,1979-04-04,93497737T,patxi.urrutia@hyperapp.online,421269,ES88209508878651879704,1800.62,2023-01-30T11:12:00,Durango,expenses,food,-89.2,-28031.72
buyer_8,Patxi,Urrutia,1979-04-04,93497737T,patxi.urrutia@hyperapp.online,421269,ES88209508878651879704,1800.62,2023-01-30T20:36:19,Durango,expenses,leisure,-26.15,-28057.87
buyer_8,Patxi,Urrutia,1979-04-04,93497737T,patxi.urrutia@hyperapp.online,421269,ES88209508878651879704,1800.62,2023-01-31T09:52:39,Durango,expenses,food,-63.97,-28121.84
buyer_8,Patxi,Urrutia,1979-04-04,93497737T,patxi.urrutia@hyperapp.online,421269,ES88209508878651879704,1800.62,2023-02-01T09:31:07,Durango,incomes,salary,3276.11,-24845.73
buyer_8,Patxi,Urrutia,1979-04-04,93497737T,patxi.urrutia@hyperapp.online,421269,ES88209508878651879704,1800.62,2023-02-01T09:31:07,Durango,incomes,extra_income,514.84,-24330.89
buyer_8,Patxi,Urrutia,1979-04-04,93497737T,patxi.urrutia@hyperapp.online,421269,ES88209508878651879704,1800.62,2023-02-02T17:58:29,Durango,expenses,appliances,-96.6,-24427.49
buyer_8,Patxi,Urrutia,1979-04-04,93497737T,patxi.urrutia@hyperapp.online,421269,ES88209508878651879704,1800.62,2023-02-04T02:40:47,Durango,expenses,food,-73.14,-24500.63
buyer_8,Patxi,Urrutia,1979-04-04,93497737T,patxi.urrutia@hyperapp.online,421269,ES88209508878651879704,1800.62,2023-02-04T14:49:33,Durango,expenses,cash,-100.0,-24600.63
buyer_8,Patxi,Urrutia,1979-04-04,93497737T,patxi.urrutia@hyperapp.online,421269,ES88209508878651879704,1800.62,2023-02-05T11:06:02,Durango,expenses,mortgage,-1291.34,-25891.97
buyer_8,Patxi,Urrutia,1979-04-04,93497737T,patxi.urrutia@hyperapp.online,421269,ES88209508878651879704,1800.62,2023-02-05T14:01:20,Durango,expenses,water,-49.33,-25941.3
buyer_8,Patxi,Urrutia,1979-04-04,93497737T,patxi.urrutia@hyperapp.online,421269,ES88209508878651879704,1800.62,2023-02-05T21:36:39,Durango,expenses,internet,-75.68,-26016.98
buyer_8,Patxi,Urrutia,1979-04-04,93497737T,patxi.urrutia@hyperapp.online,421269,ES88209508878651879704,1800.62,2023-02-06T19:11:21,Durango,expenses,water,-57.65,-26074.63
buyer_8,Patxi,Urrutia,1979-04-04,93497737T,patxi.urrutia@hyperapp.online,421269,ES88209508878651879704,1800.62,2023-02-06T08:42:43,Durango,expenses,gas,-102.43,-26177.06
buyer_8,Patxi,Urrutia,1979-04-04,93497737T,patxi.urrutia@hyperapp.online,421269,ES88209508878651879704,1800.62,2023-02-06T17:27:13,Durango,expenses,internet,-75.68,-26252.74
buyer_8,Patxi,Urrutia,1979-04-04,93497737T,patxi.urrutia@hyperapp.online,421269,ES88209508878651879704,1800.62,2023-02-07T08:03:49,Durango,expenses,gas,-200.23,-26452.97
buyer_8,Patxi,Urrutia,1979-04-04,93497737T,patxi.urrutia@hyperapp.online,421269,ES88209508878651879704,1800.62,2023-02-07T19:17:59,Durango,expenses,transport,-81.27,-26534.24
buyer_8,Patxi,Urrutia,1979-04-04,93497737T,patxi.urrutia@hyperapp.online,421269,ES88209508878651879704,1800.62,2023-02-07T17:56:13,Durango,expenses,healthcare,-152.81,-26687.05
buyer_8,Patxi,Urrutia,1979-04-04,93497737T,patxi.urrutia@hyperapp.online,421269,ES88209508878651879704,1800.62,2023-02-07T12:28:06,Durango,expenses,repairs,-37.73,-26724.78
buyer_8,Patxi,Urrutia,1979-04-04,93497737T,patxi.urrutia@hyperapp.online,421269,ES88209508878651879704,1800.62,2023-02-08T23:38:55,Durango,expenses,internet,-75.68,-26800.46
buyer_8,Patxi,Urrutia,1979-04-04,93497737T,patxi.urrutia@hyperapp.online,421269,ES88209508878651879704,1800.62,2023-02-12T15:34:31,Durango,expenses,food,-84.41,-26884.87
buyer_8,Patxi,Urrutia,1979-04-04,93497737T,patxi.urrutia@hyperapp.online,421269,ES88209508878651879704,1800.62,2023-02-12T14:55:44,Durango,expenses,leisure,-49.69,-26934.56
buyer_8,Patxi,Urrutia,1979-04-04,93497737T,patxi.urrutia@hyperapp.online,421269,ES88209508878651879704,1800.62,2023-02-13T13:02:40,Durango,expenses,leisure,-24.16,-26958.72
buyer_8,Patxi,Urrutia,1979-04-04,93497737T,patxi.urrutia@hyperapp.online,421269,ES88209508878651879704,1800.62,2023-02-13T18:01:50,Durango,expenses,gifts,-178.74,-27137.46
buyer_8,Patxi,Urrutia,1979-04-04,93497737T,patxi.urrutia@hyperapp.online,421269,ES88209508878651879704,1800.62,2023-02-14T15:59:11,Durango,expenses,transport,-82.95,-27220.41
buyer_8,Patxi,Urrutia,1979-04-04,93497737T,patxi.urrutia@hyperapp.online,421269,ES88209508878651879704,1800.62,2023-02-14T02:00:28,Durango,expenses,clothing,-45.22,-27265.63
buyer_8,Patxi,Urrutia,1979-04-04,93497737T,patxi.urrutia@hyperapp.online,421269,ES88209508878651879704,1800.62,2023-02-14T15:52:39,Durango,expenses,repairs,-282.89,-27548.52
buyer_8,Patxi,Urrutia,1979-04-04,93497737T,patxi.urrutia@hyperapp.online,421269,ES88209508878651879704,1800.62,2023-02-15T14:00:24,Durango,expenses,education,-66.75,-27615.27
buyer_8,Patxi,Urrutia,1979-04-04,93497737T,patxi.urrutia@hyperapp.online,421269,ES88209508878651879704,1800.62,2023-02-18T12:57:48,Durango,expenses,food,-115.02,-27730.29
buyer_8,Patxi,Urrutia,1979-04-04,93497737T,patxi.urrutia@hyperapp.online,421269,ES88209508878651879704,1800.62,2023-02-18T13:47:21,Durango,expenses,clothing,-69.31,-27799.6
buyer_8,Patxi,Urrutia,1979-04-04,93497737T,patxi.urrutia@hyperapp.online,421269,ES88209508878651879704,1800.62,2023-02-18T14:11:51,Durango,expenses,cash,-100.0,-27899.6
buyer_8,Patxi,Urrutia,1979-04-04,93497737T,patxi.urrutia@hyperapp.online,421269,ES88209508878651879704,1800.62,2023-02-18T11:10:04,Durango,expenses,repairs,-229.75,-28129.35
buyer_8,Patxi,Urrutia,1979-04-04,93497737T,patxi.urrutia@hyperapp.online,421269,ES88209508878651879704,1800.62,2023-02-20T19:04:10,Durango,expenses,food,-80.62,-28209.97
buyer_8,Patxi,Urrutia,1979-04-04,93497737T,patxi.urrutia@hyperapp.online,421269,ES88209508878651879704,1800.62,2023-02-22T13:26:31,Durango,expenses,repairs,-258.1,-28468.07
buyer_8,Patxi,Urrutia,1979-04-04,93497737T,patxi.urrutia@hyperapp.online,421269,ES88209508878651879704,1800.62,2023-02-22T20:05:29,Durango,expenses,gifts,-29.63,-28497.7
buyer_8,Patxi,Urrutia,1979-04-04,93497737T,patxi.urrutia@hyperapp.online,421269,ES88209508878651879704,1800.62,2023-02-24T12:48:33,Durango,expenses,food,-82.98,-28580.68
buyer_8,Patxi,Urrutia,1979-04-04,93497737T,patxi.urrutia@hyperapp.online,421269,ES88209508878651879704,1800.62,2023-03-01T18:25:02,Durango,incomes,salary,3276.11,-25304.57
buyer_8,Patxi,Urrutia,1979-04-04,93497737T,patxi.urrutia@hyperapp.online,421269,ES88209508878651879704,1800.62,2023-03-01T16:11:40,Durango,expenses,car,-456.56,-25761.13
buyer_8,Patxi,Urrutia,1979-04-04,93497737T,patxi.urrutia@hyperapp.online,421269,ES88209508878651879704,1800.62,2023-03-04T20:38:45,Durango,expenses,transport,-61.94,-25823.07
buyer_8,Patxi,Urrutia,1979-04-04,93497737T,patxi.urrutia@hyperapp.online,421269,ES88209508878651879704,1800.62,2023-03-05T15:50:24,Durango,expenses,mortgage,-1291.34,-27114.41
buyer_8,Patxi,Urrutia,1979-04-04,93497737T,patxi.urrutia@hyperapp.online,421269,ES88209508878651879704,1800.62,2023-03-05T16:22:28,Durango,expenses,electricity,-52.35,-27166.76
buyer_8,Patxi,Urrutia,1979-04-04,93497737T,patxi.urrutia@hyperapp.online,421269,ES88209508878651879704,1800.62,2023-03-05T09:53:35,Durango,expenses,phone,-75.92,-27242.68
buyer_8,Patxi,Urrutia,1979-04-04,93497737T,patxi.urrutia@hyperapp.online,421269,ES88209508878651879704,1800.62,2023-03-05T10:48:51,Durango,expenses,food,-87.68,-27330.36
buyer_8,Patxi,Urrutia,1979-04-04,93497737T,patxi.urrutia@hyperapp.online,421269,ES88209508878651879704,1800.62,2023-03-06T19:25:57,Durango,expenses,appliances,-401.58,-27731.94
buyer_8,Patxi,Urrutia,1979-04-04,93497737T,patxi.urrutia@hyperapp.online,421269,ES88209508878651879704,1800.62,2023-03-07T08:59:06,Durango,expenses,gas,-134.87,-27866.81
buyer_8,Patxi,Urrutia,1979-04-04,93497737T,patxi.urrutia@hyperapp.online,421269,ES88209508878651879704,1800.62,2023-03-07T16:51:10,Durango,expenses,phone,-77.63,-27944.44
buyer_8,Patxi,Urrutia,1979-04-04,93497737T,patxi.urrutia@hyperapp.online,421269,ES88209508878651879704,1800.62,2023-03-07T16:50:20,Durango,expenses,healthcare,-137.74,-28082.18
buyer_8,Patxi,Urrutia,1979-04-04,93497737T,patxi.urrutia@hyperapp.online,421269,ES88209508878651879704,1800.62,2023-03-07T14:39:11,Durango,expenses,gifts,-696.66,-28778.84
buyer_8,Patxi,Urrutia,1979-04-04,93497737T,patxi.urrutia@hyperapp.online,421269,ES88209508878651879704,1800.62,2023-03-08T10:09:17,Durango,expenses,internet,-75.68,-28854.52
buyer_8,Patxi,Urrutia,1979-04-04,93497737T,patxi.urrutia@hyperapp.online,421269,ES88209508878651879704,1800.62,2023-03-08T11:04:16,Durango,expenses,appliances,-261.23,-29115.75
buyer_8,Patxi,Urrutia,1979-04-04,93497737T,patxi.urrutia@hyperapp.online,421269,ES88209508878651879704,1800.62,2023-03-10T19:22:53,Durango,expenses,food,-103.11,-29218.86
buyer_8,Patxi,Urrutia,1979-04-04,93497737T,patxi.urrutia@hyperapp.online,421269,ES88209508878651879704,1800.62,2023-03-11T03:52:49,Durango,expenses,leisure,-53.6,-29272.46
buyer_8,Patxi,Urrutia,1979-04-04,93497737T,patxi.urrutia@hyperapp.online,421269,ES88209508878651879704,1800.62,2023-03-11T11:35:56,Durango,expenses,cash,-100.0,-29372.46
buyer_8,Patxi,Urrutia,1979-04-04,93497737T,patxi.urrutia@hyperapp.online,421269,ES88209508878651879704,1800.62,2023-03-12T09:04:53,Durango,expenses,cash,-100.0,-29472.46
buyer_8,Patxi,Urrutia,1979-04-04,93497737T,patxi.urrutia@hyperapp.online,421269,ES88209508878651879704,1800.62,2023-03-13T22:14:56,Durango,expenses,food,-110.51,-29582.97
buyer_8,Patxi,Urrutia,1979-04-04,93497737T,patxi.urrutia@hyperapp.online,421269,ES88209508878651879704,1800.62,2023-03-14T15:52:34,Durango,expenses,cash,-100.0,-29682.97
buyer_8,Patxi,Urrutia,1979-04-04,93497737T,patxi.urrutia@hyperapp.online,421269,ES88209508878651879704,1800.62,2023-03-15T17:36:11,Durango,expenses,cash,-100.0,-29782.97
buyer_8,Patxi,Urrutia,1979-04-04,93497737T,patxi.urrutia@hyperapp.online,421269,ES88209508878651879704,1800.62,2023-03-17T06:00:20,Durango,expenses,transport,-66.82,-29849.79
buyer_8,Patxi,Urrutia,1979-04-04,93497737T,patxi.urrutia@hyperapp.online,421269,ES88209508878651879704,1800.62,2023-03-19T14:49:48,Durango,expenses,leisure,-82.19,-29931.98
buyer_8,Patxi,Urrutia,1979-04-04,93497737T,patxi.urrutia@hyperapp.online,421269,ES88209508878651879704,1800.62,2023-03-21T13:24:02,Durango,expenses,gifts,-52.16,-29984.14
buyer_8,Patxi,Urrutia,1979-04-04,93497737T,patxi.urrutia@hyperapp.online,421269,ES88209508878651879704,1800.62,2023-03-22T14:42:47,Durango,expenses,food,-112.93,-30097.07
buyer_8,Patxi,Urrutia,1979-04-04,93497737T,patxi.urrutia@hyperapp.online,421269,ES88209508878651879704,1800.62,2023-03-25T14:40:49,Durango,expenses,cash,-100.0,-30197.07
buyer_8,Patxi,Urrutia,1979-04-04,93497737T,patxi.urrutia@hyperapp.online,421269,ES88209508878651879704,1800.62,2023-03-26T20:03:13,Durango,expenses,transport,-81.77,-30278.84
buyer_8,Patxi,Urrutia,1979-04-04,93497737T,patxi.urrutia@hyperapp.online,421269,ES88209508878651879704,1800.62,2023-03-26T18:48:54,Durango,expenses,repairs,-262.66,-30541.5
buyer_8,Patxi,Urrutia,1979-04-04,93497737T,patxi.urrutia@hyperapp.online,421269,ES88209508878651879704,1800.62,2023-03-29T17:29:20,Durango,expenses,clothing,-99.96,-30641.46
buyer_8,Patxi,Urrutia,1979-04-04,93497737T,patxi.urrutia@hyperapp.online,421269,ES88209508878651879704,1800.62,2023-03-30T14:04:14,Durango,expenses,repairs,-186.16,-30827.62
buyer_8,Patxi,Urrutia,1979-04-04,93497737T,patxi.urrutia@hyperapp.online,421269,ES88209508878651879704,1800.62,2023-04-01T13:10:06,Durango,incomes,salary,3276.11,-27551.51
buyer_8,Patxi,Urrutia,1979-04-04,93497737T,patxi.urrutia@hyperapp.online,421269,ES88209508878651879704,1800.62,2023-04-02T08:35:43,Durango,expenses,transport,-56.03,-27607.54
buyer_8,Patxi,Urrutia,1979-04-04,93497737T,patxi.urrutia@hyperapp.online,421269,ES88209508878651879704,1800.62,2023-04-03T13:46:37,Durango,expenses,food,-65.0,-27672.54
buyer_8,Patxi,Urrutia,1979-04-04,93497737T,patxi.urrutia@hyperapp.online,421269,ES88209508878651879704,1800.62,2023-04-04T17:04:59,Durango,expenses,cash,-100.0,-27772.54
buyer_8,Patxi,Urrutia,1979-04-04,93497737T,patxi.urrutia@hyperapp.online,421269,ES88209508878651879704,1800.62,2023-04-05T00:39:49,Durango,expenses,mortgage,-1291.34,-29063.88
buyer_8,Patxi,Urrutia,1979-04-04,93497737T,patxi.urrutia@hyperapp.online,421269,ES88209508878651879704,1800.62,2023-04-05T20:38:13,Durango,expenses,electricity,-98.56,-29162.44
buyer_8,Patxi,Urrutia,1979-04-04,93497737T,patxi.urrutia@hyperapp.online,421269,ES88209508878651879704,1800.62,2023-04-05T14:17:47,Durango,expenses,phone,-63.42,-29225.86
buyer_8,Patxi,Urrutia,1979-04-04,93497737T,patxi.urrutia@hyperapp.online,421269,ES88209508878651879704,1800.62,2023-04-05T11:08:29,Durango,expenses,food,-124.15,-29350.01
buyer_8,Patxi,Urrutia,1979-04-04,93497737T,patxi.urrutia@hyperapp.online,421269,ES88209508878651879704,1800.62,2023-04-06T08:32:10,Durango,expenses,gas,-73.66,-29423.67
buyer_8,Patxi,Urrutia,1979-04-04,93497737T,patxi.urrutia@hyperapp.online,421269,ES88209508878651879704,1800.62,2023-04-06T09:59:55,Durango,expenses,education,-75.0,-29498.67
buyer_8,Patxi,Urrutia,1979-04-04,93497737T,patxi.urrutia@hyperapp.online,421269,ES88209508878651879704,1800.62,2023-04-08T09:03:50,Durango,expenses,electricity,-74.14,-29572.81
buyer_8,Patxi,Urrutia,1979-04-04,93497737T,patxi.urrutia@hyperapp.online,421269,ES88209508878651879704,1800.62,2023-04-08T10:38:58,Durango,expenses,gas,-76.72,-29649.53
buyer_8,Patxi,Urrutia,1979-04-04,93497737T,patxi.urrutia@hyperapp.online,421269,ES88209508878651879704,1800.62,2023-04-08T16:39:44,Durango,expenses,food,-101.62,-29751.15
buyer_8,Patxi,Urrutia,1979-04-04,93497737T,patxi.urrutia@hyperapp.online,421269,ES88209508878651879704,1800.62,2023-04-09T16:49:23,Durango,expenses,transport,-60.56,-29811.71
buyer_8,Patxi,Urrutia,1979-04-04,93497737T,patxi.urrutia@hyperapp.online,421269,ES88209508878651879704,1800.62,2023-04-09T19:59:09,Durango,expenses,cash,-100.0,-29911.71
buyer_8,Patxi,Urrutia,1979-04-04,93497737T,patxi.urrutia@hyperapp.online,421269,ES88209508878651879704,1800.62,2023-04-10T11:13:07,Durango,expenses,transport,-89.97,-30001.68
buyer_8,Patxi,Urrutia,1979-04-04,93497737T,patxi.urrutia@hyperapp.online,421269,ES88209508878651879704,1800.62,2023-04-10T16:51:39,Durango,expenses,cash,-100.0,-30101.68
buyer_8,Patxi,Urrutia,1979-04-04,93497737T,patxi.urrutia@hyperapp.online,421269,ES88209508878651879704,1800.62,2023-04-11T04:06:42,Durango,expenses,repairs,-295.68,-30397.36
buyer_8,Patxi,Urrutia,1979-04-04,93497737T,patxi.urrutia@hyperapp.online,421269,ES88209508878651879704,1800.62,2023-04-12T13:14:19,Durango,expenses,food,-89.1,-30486.46
buyer_8,Patxi,Urrutia,1979-04-04,93497737T,patxi.urrutia@hyperapp.online,421269,ES88209508878651879704,1800.62,2023-04-12T09:52:41,Durango,expenses,leisure,-18.75,-30505.21
buyer_8,Patxi,Urrutia,1979-04-04,93497737T,patxi.urrutia@hyperapp.online,421269,ES88209508878651879704,1800.62,2023-04-13T20:14:57,Durango,expenses,leisure,-72.87,-30578.08
buyer_8,Patxi,Urrutia,1979-04-04,93497737T,patxi.urrutia@hyperapp.online,421269,ES88209508878651879704,1800.62,2023-04-13T05:10:23,Durango,expenses,repairs,-304.26,-30882.34
buyer_8,Patxi,Urrutia,1979-04-04,93497737T,patxi.urrutia@hyperapp.online,421269,ES88209508878651879704,1800.62,2023-04-13T08:18:27,Durango,expenses,gifts,-841.13,-31723.47
buyer_8,Patxi,Urrutia,1979-04-04,93497737T,patxi.urrutia@hyperapp.online,421269,ES88209508878651879704,1800.62,2023-04-14T03:44:24,Durango,expenses,food,-72.75,-31796.22
buyer_8,Patxi,Urrutia,1979-04-04,93497737T,patxi.urrutia@hyperapp.online,421269,ES88209508878651879704,1800.62,2023-04-14T11:01:15,Durango,expenses,repairs,-117.01,-31913.23
buyer_8,Patxi,Urrutia,1979-04-04,93497737T,patxi.urrutia@hyperapp.online,421269,ES88209508878651879704,1800.62,2023-04-15T11:42:03,Durango,expenses,cash,-100.0,-32013.23
buyer_8,Patxi,Urrutia,1979-04-04,93497737T,patxi.urrutia@hyperapp.online,421269,ES88209508878651879704,1800.62,2023-04-17T23:19:57,Durango,expenses,cash,-100.0,-32113.23
buyer_8,Patxi,Urrutia,1979-04-04,93497737T,patxi.urrutia@hyperapp.online,421269,ES88209508878651879704,1800.62,2023-04-18T21:03:32,Durango,expenses,leisure,-49.02,-32162.25
buyer_8,Patxi,Urrutia,1979-04-04,93497737T,patxi.urrutia@hyperapp.online,421269,ES88209508878651879704,1800.62,2023-04-19T08:42:55,Durango,expenses,cash,-100.0,-32262.25
buyer_8,Patxi,Urrutia,1979-04-04,93497737T,patxi.urrutia@hyperapp.online,421269,ES88209508878651879704,1800.62,2023-04-19T11:22:40,Durango,expenses,repairs,-315.86,-32578.11
buyer_8,Patxi,Urrutia,1979-04-04,93497737T,patxi.urrutia@hyperapp.online,421269,ES88209508878651879704,1800.62,2023-04-19T17:50:05,Durango,expenses,gifts,-218.95,-32797.06
buyer_8,Patxi,Urrutia,1979-04-04,93497737T,patxi.urrutia@hyperapp.online,421269,ES88209508878651879704,1800.62,2023-04-20T18:09:27,Durango,expenses,clothing,-113.06,-32910.12
buyer_8,Patxi,Urrutia,1979-04-04,93497737T,patxi.urrutia@hyperapp.online,421269,ES88209508878651879704,1800.62,2023-04-20T13:34:52,Durango,expenses,education,-53.4,-32963.52
buyer_8,Patxi,Urrutia,1979-04-04,93497737T,patxi.urrutia@hyperapp.online,421269,ES88209508878651879704,1800.62,2023-04-22T14:35:58,Durango,expenses,leisure,-80.9,-33044.42
buyer_8,Patxi,Urrutia,1979-04-04,93497737T,patxi.urrutia@hyperapp.online,421269,ES88209508878651879704,1800.62,2023-04-23T10:58:40,Durango,expenses,food,-108.95,-33153.37
buyer_8,Patxi,Urrutia,1979-04-04,93497737T,patxi.urrutia@hyperapp.online,421269,ES88209508878651879704,1800.62,2023-04-25T09:29:31,Durango,expenses,food,-69.24,-33222.61
buyer_8,Patxi,Urrutia,1979-04-04,93497737T,patxi.urrutia@hyperapp.online,421269,ES88209508878651879704,1800.62,2023-04-25T13:04:36,Durango,expenses,cash,-100.0,-33322.61
buyer_8,Patxi,Urrutia,1979-04-04,93497737T,patxi.urrutia@hyperapp.online,421269,ES88209508878651879704,1800.62,2023-04-26T15:52:04,Durango,expenses,transport,-49.43,-33372.04
buyer_8,Patxi,Urrutia,1979-04-04,93497737T,patxi.urrutia@hyperapp.online,421269,ES88209508878651879704,1800.62,2023-04-27T17:40:16,Durango,expenses,cash,-100.0,-33472.04
buyer_8,Patxi,Urrutia,1979-04-04,93497737T,patxi.urrutia@hyperapp.online,421269,ES88209508878651879704,1800.62,2023-04-28T11:43:08,Durango,expenses,transport,-67.6,-33539.64
buyer_8,Patxi,Urrutia,1979-04-04,93497737T,patxi.urrutia@hyperapp.online,421269,ES88209508878651879704,1800.62,2023-04-28T16:42:21,Durango,expenses,cash,-100.0,-33639.64
buyer_8,Patxi,Urrutia,1979-04-04,93497737T,patxi.urrutia@hyperapp.online,421269,ES88209508878651879704,1800.62,2023-04-28T11:14:52,Durango,expenses,repairs,-257.43,-33897.07
buyer_8,Patxi,Urrutia,1979-04-04,93497737T,patxi.urrutia@hyperapp.online,421269,ES88209508878651879704,1800.62,2023-04-29T16:02:38,Durango,expenses,food,-70.0,-33967.07
buyer_8,Patxi,Urrutia,1979-04-04,93497737T,patxi.urrutia@hyperapp.online,421269,ES88209508878651879704,1800.62,2023-04-29T16:02:54,Durango,expenses,gifts,-462.5,-34429.57
buyer_8,Patxi,Urrutia,1979-04-04,93497737T,patxi.urrutia@hyperapp.online,421269,ES88209508878651879704,1800.62,2023-04-30T16:05:20,Durango,expenses,leisure,-62.75,-34492.32
buyer_8,Patxi,Urrutia,1979-04-04,93497737T,patxi.urrutia@hyperapp.online,421269,ES88209508878651879704,1800.62,2023-05-01T18:22:10,Durango,incomes,salary,3276.11,-31216.21
buyer_8,Patxi,Urrutia,1979-04-04,93497737T,patxi.urrutia@hyperapp.online,421269,ES88209508878651879704,1800.62,2023-05-01T14:57:16,Durango,expenses,healthcare,-161.86,-31378.07
buyer_8,Patxi,Urrutia,1979-04-04,93497737T,patxi.urrutia@hyperapp.online,421269,ES88209508878651879704,1800.62,2023-05-01T12:14:36,Durango,expenses,cash,-100.0,-31478.07
buyer_8,Patxi,Urrutia,1979-04-04,93497737T,patxi.urrutia@hyperapp.online,421269,ES88209508878651879704,1800.62,2023-05-03T17:19:14,Durango,expenses,cash,-100.0,-31578.07
buyer_8,Patxi,Urrutia,1979-04-04,93497737T,patxi.urrutia@hyperapp.online,421269,ES88209508878651879704,1800.62,2023-05-05T18:39:56,Durango,expenses,mortgage,-1291.34,-32869.41
buyer_8,Patxi,Urrutia,1979-04-04,93497737T,patxi.urrutia@hyperapp.online,421269,ES88209508878651879704,1800.62,2023-05-05T15:36:11,Durango,expenses,electricity,-91.48,-32960.89
buyer_8,Patxi,Urrutia,1979-04-04,93497737T,patxi.urrutia@hyperapp.online,421269,ES88209508878651879704,1800.62,2023-05-05T11:28:27,Durango,expenses,leisure,-65.53,-33026.42
buyer_8,Patxi,Urrutia,1979-04-04,93497737T,patxi.urrutia@hyperapp.online,421269,ES88209508878651879704,1800.62,2023-05-06T13:00:29,Durango,expenses,gas,-133.55,-33159.97
buyer_8,Patxi,Urrutia,1979-04-04,93497737T,patxi.urrutia@hyperapp.online,421269,ES88209508878651879704,1800.62,2023-05-06T17:54:03,Durango,expenses,education,-52.42,-33212.39
buyer_8,Patxi,Urrutia,1979-04-04,93497737T,patxi.urrutia@hyperapp.online,421269,ES88209508878651879704,1800.62,2023-05-08T12:03:07,Durango,expenses,phone,-56.56,-33268.95
buyer_8,Patxi,Urrutia,1979-04-04,93497737T,patxi.urrutia@hyperapp.online,421269,ES88209508878651879704,1800.62,2023-05-08T13:17:24,Durango,expenses,food,-105.7,-33374.65
buyer_8,Patxi,Urrutia,1979-04-04,93497737T,patxi.urrutia@hyperapp.online,421269,ES88209508878651879704,1800.62,2023-05-09T02:41:41,Durango,expenses,leisure,-19.24,-33393.89
buyer_8,Patxi,Urrutia,1979-04-04,93497737T,patxi.urrutia@hyperapp.online,421269,ES88209508878651879704,1800.62,2023-05-10T12:37:39,Durango,expenses,leisure,-51.65,-33445.54
buyer_8,Patxi,Urrutia,1979-04-04,93497737T,patxi.urrutia@hyperapp.online,421269,ES88209508878651879704,1800.62,2023-05-11T06:09:26,Durango,expenses,leisure,-20.47,-33466.01
buyer_8,Patxi,Urrutia,1979-04-04,93497737T,patxi.urrutia@hyperapp.online,421269,ES88209508878651879704,1800.62,2023-05-12T18:43:39,Durango,expenses,transport,-41.82,-33507.83
buyer_8,Patxi,Urrutia,1979-04-04,93497737T,patxi.urrutia@hyperapp.online,421269,ES88209508878651879704,1800.62,2023-05-18T10:37:33,Durango,expenses,cash,-100.0,-33607.83
buyer_8,Patxi,Urrutia,1979-04-04,93497737T,patxi.urrutia@hyperapp.online,421269,ES88209508878651879704,1800.62,2023-05-19T15:20:27,Durango,expenses,food,-103.57,-33711.4
buyer_8,Patxi,Urrutia,1979-04-04,93497737T,patxi.urrutia@hyperapp.online,421269,ES88209508878651879704,1800.62,2023-05-23T10:55:53,Durango,expenses,leisure,-62.28,-33773.68
buyer_8,Patxi,Urrutia,1979-04-04,93497737T,patxi.urrutia@hyperapp.online,421269,ES88209508878651879704,1800.62,2023-05-24T02:09:31,Durango,expenses,cash,-100.0,-33873.68
buyer_8,Patxi,Urrutia,1979-04-04,93497737T,patxi.urrutia@hyperapp.online,421269,ES88209508878651879704,1800.62,2023-05-25T15:24:36,Durango,expenses,clothing,-137.1,-34010.78
buyer_8,Patxi,Urrutia,1979-04-04,93497737T,patxi.urrutia@hyperapp.online,421269,ES88209508878651879704,1800.62,2023-05-26T19:49:46,Durango,expenses,food,-120.3,-34131.08
buyer_8,Patxi,Urrutia,1979-04-04,93497737T,patxi.urrutia@hyperapp.online,421269,ES88209508878651879704,1800.62,2023-05-26T02:13:31,Durango,expenses,cash,-100.0,-34231.08
buyer_8,Patxi,Urrutia,1979-04-04,93497737T,patxi.urrutia@hyperapp.online,421269,ES88209508878651879704,1800.62,2023-05-28T14:22:18,Durango,expenses,transport,-54.07,-34285.15
buyer_8,Patxi,Urrutia,1979-04-04,93497737T,patxi.urrutia@hyperapp.online,421269,ES88209508878651879704,1800.62,2023-05-28T13:09:41,Durango,expenses,cash,-100.0,-34385.15
buyer_8,Patxi,Urrutia,1979-04-04,93497737T,patxi.urrutia@hyperapp.online,421269,ES88209508878651879704,1800.62,2023-05-29T05:49:09,Durango,expenses,cash,-100.0,-34485.15
buyer_8,Patxi,Urrutia,1979-04-04,93497737T,patxi.urrutia@hyperapp.online,421269,ES88209508878651879704,1800.62,2023-05-30T03:22:23,Durango,expenses,appliances,-370.21,-34855.36
buyer_8,Patxi,Urrutia,1979-04-04,93497737T,patxi.urrutia@hyperapp.online,421269,ES88209508878651879704,1800.62,2023-05-31T09:15:09,Durango,expenses,transport,-60.26,-34915.62
buyer_8,Patxi,Urrutia,1979-04-04,93497737T,patxi.urrutia@hyperapp.online,421269,ES88209508878651879704,1800.62,2023-05-31T10:49:58,Durango,expenses,cash,-100.0,-35015.62
buyer_8,Patxi,Urrutia,1979-04-04,93497737T,patxi.urrutia@hyperapp.online,421269,ES88209508878651879704,1800.62,2023-06-01T10:37:44,Durango,incomes,salary,3276.11,-31739.51
buyer_8,Patxi,Urrutia,1979-04-04,93497737T,patxi.urrutia@hyperapp.online,421269,ES88209508878651879704,1800.62,2023-06-01T10:37:44,Durango,incomes,extra_income,514.84,-31224.67
buyer_8,Patxi,Urrutia,1979-04-04,93497737T,patxi.urrutia@hyperapp.online,421269,ES88209508878651879704,1800.62,2023-06-01T10:37:44,Durango,incomes,salary_bonus,2575.24,-28649.43
buyer_8,Patxi,Urrutia,1979-04-04,93497737T,patxi.urrutia@hyperapp.online,421269,ES88209508878651879704,1800.62,2023-06-01T17:16:59,Durango,expenses,taxes,-3236.83,-31886.26
buyer_8,Patxi,Urrutia,1979-04-04,93497737T,patxi.urrutia@hyperapp.online,421269,ES88209508878651879704,1800.62,2023-06-01T16:39:42,Durango,expenses,insurance,-722.49,-32608.75
buyer_8,Patxi,Urrutia,1979-04-04,93497737T,patxi.urrutia@hyperapp.online,421269,ES88209508878651879704,1800.62,2023-06-01T17:15:59,Durango,expenses,travel,-642.87,-33251.62
buyer_8,Patxi,Urrutia,1979-04-04,93497737T,patxi.urrutia@hyperapp.online,421269,ES88209508878651879704,1800.62,2023-06-02T10:28:10,Durango,expenses,cash,-100.0,-33351.62
buyer_8,Patxi,Urrutia,1979-04-04,93497737T,patxi.urrutia@hyperapp.online,421269,ES88209508878651879704,1800.62,2023-06-03T13:28:22,Durango,expenses,food,-98.22,-33449.84
buyer_8,Patxi,Urrutia,1979-04-04,93497737T,patxi.urrutia@hyperapp.online,421269,ES88209508878651879704,1800.62,2023-06-05T15:11:31,Durango,expenses,mortgage,-1291.34,-34741.18
buyer_8,Patxi,Urrutia,1979-04-04,93497737T,patxi.urrutia@hyperapp.online,421269,ES88209508878651879704,1800.62,2023-06-05T12:44:31,Durango,expenses,electricity,-144.26,-34885.44
buyer_8,Patxi,Urrutia,1979-04-04,93497737T,patxi.urrutia@hyperapp.online,421269,ES88209508878651879704,1800.62,2023-06-05T16:08:19,Durango,expenses,gas,-101.42,-34986.86
buyer_8,Patxi,Urrutia,1979-04-04,93497737T,patxi.urrutia@hyperapp.online,421269,ES88209508878651879704,1800.62,2023-06-05T14:51:11,Durango,expenses,food,-121.74,-35108.6
buyer_8,Patxi,Urrutia,1979-04-04,93497737T,patxi.urrutia@hyperapp.online,421269,ES88209508878651879704,1800.62,2023-06-06T08:50:52,Durango,expenses,gas,-85.95,-35194.55
buyer_8,Patxi,Urrutia,1979-04-04,93497737T,patxi.urrutia@hyperapp.online,421269,ES88209508878651879704,1800.62,2023-06-06T06:58:11,Durango,expenses,phone,-74.35,-35268.9
buyer_8,Patxi,Urrutia,1979-04-04,93497737T,patxi.urrutia@hyperapp.online,421269,ES88209508878651879704,1800.62,2023-06-06T14:51:55,Durango,expenses,healthcare,-102.46,-35371.36
buyer_8,Patxi,Urrutia,1979-04-04,93497737T,patxi.urrutia@hyperapp.online,421269,ES88209508878651879704,1800.62,2023-06-07T15:36:39,Durango,expenses,water,-45.25,-35416.61
buyer_8,Patxi,Urrutia,1979-04-04,93497737T,patxi.urrutia@hyperapp.online,421269,ES88209508878651879704,1800.62,2023-06-07T16:03:57,Durango,expenses,internet,-75.68,-35492.29
buyer_8,Patxi,Urrutia,1979-04-04,93497737T,patxi.urrutia@hyperapp.online,421269,ES88209508878651879704,1800.62,2023-06-08T18:08:48,Durango,expenses,food,-93.83,-35586.12
buyer_8,Patxi,Urrutia,1979-04-04,93497737T,patxi.urrutia@hyperapp.online,421269,ES88209508878651879704,1800.62,2023-06-08T16:41:37,Durango,expenses,clothing,-152.24,-35738.36
buyer_8,Patxi,Urrutia,1979-04-04,93497737T,patxi.urrutia@hyperapp.online,421269,ES88209508878651879704,1800.62,2023-06-15T09:33:39,Durango,expenses,cash,-100.0,-35838.36
buyer_8,Patxi,Urrutia,1979-04-04,93497737T,patxi.urrutia@hyperapp.online,421269,ES88209508878651879704,1800.62,2023-06-16T12:58:10,Durango,expenses,cash,-100.0,-35938.36
buyer_8,Patxi,Urrutia,1979-04-04,93497737T,patxi.urrutia@hyperapp.online,421269,ES88209508878651879704,1800.62,2023-06-17T08:04:35,Durango,expenses,repairs,-109.86,-36048.22
buyer_8,Patxi,Urrutia,1979-04-04,93497737T,patxi.urrutia@hyperapp.online,421269,ES88209508878651879704,1800.62,2023-06-18T19:31:45,Durango,expenses,cash,-100.0,-36148.22
buyer_8,Patxi,Urrutia,1979-04-04,93497737T,patxi.urrutia@hyperapp.online,421269,ES88209508878651879704,1800.62,2023-06-22T13:33:55,Durango,expenses,leisure,-22.06,-36170.28
buyer_8,Patxi,Urrutia,1979-04-04,93497737T,patxi.urrutia@hyperapp.online,421269,ES88209508878651879704,1800.62,2023-06-22T17:17:38,Durango,expenses,cash,-100.0,-36270.28
buyer_8,Patxi,Urrutia,1979-04-04,93497737T,patxi.urrutia@hyperapp.online,421269,ES88209508878651879704,1800.62,2023-06-22T18:40:05,Durango,expenses,gifts,-92.08,-36362.36
buyer_8,Patxi,Urrutia,1979-04-04,93497737T,patxi.urrutia@hyperapp.online,421269,ES88209508878651879704,1800.62,2023-06-24T12:18:56,Durango,expenses,cash,-100.0,-36462.36
buyer_8,Patxi,Urrutia,1979-04-04,93497737T,patxi.urrutia@hyperapp.online,421269,ES88209508878651879704,1800.62,2023-06-25T16:42:25,Durango,expenses,food,-122.7,-36585.06
buyer_8,Patxi,Urrutia,1979-04-04,93497737T,patxi.urrutia@hyperapp.online,421269,ES88209508878651879704,1800.62,2023-06-25T13:05:03,Durango,expenses,healthcare,-155.05,-36740.11
buyer_8,Patxi,Urrutia,1979-04-04,93497737T,patxi.urrutia@hyperapp.online,421269,ES88209508878651879704,1800.62,2023-06-25T21:29:24,Durango,expenses,cash,-100.0,-36840.11
buyer_8,Patxi,Urrutia,1979-04-04,93497737T,patxi.urrutia@hyperapp.online,421269,ES88209508878651879704,1800.62,2023-06-25T08:05:41,Durango,expenses,repairs,-317.37,-37157.48
buyer_8,Patxi,Urrutia,1979-04-04,93497737T,patxi.urrutia@hyperapp.online,421269,ES88209508878651879704,1800.62,2023-06-25T09:21:24,Durango,expenses,gifts,-312.75,-37470.23
buyer_8,Patxi,Urrutia,1979-04-04,93497737T,patxi.urrutia@hyperapp.online,421269,ES88209508878651879704,1800.62,2023-06-29T15:40:01,Durango,expenses,clothing,-125.81,-37596.04
buyer_8,Patxi,Urrutia,1979-04-04,93497737T,patxi.urrutia@hyperapp.online,421269,ES88209508878651879704,1800.62,2023-06-30T10:03:46,Durango,expenses,education,-53.07,-37649.11
buyer_8,Patxi,Urrutia,1979-04-04,93497737T,patxi.urrutia@hyperapp.online,421269,ES88209508878651879704,1800.62,2023-07-01T08:50:30,Durango,incomes,salary,3276.11,-34373.0
buyer_8,Patxi,Urrutia,1979-04-04,93497737T,patxi.urrutia@hyperapp.online,421269,ES88209508878651879704,1800.62,2023-07-01T20:43:03,Durango,expenses,cash,-100.0,-34473.0
buyer_8,Patxi,Urrutia,1979-04-04,93497737T,patxi.urrutia@hyperapp.online,421269,ES88209508878651879704,1800.62,2023-07-02T17:45:02,Durango,expenses,appliances,-303.92,-34776.92
buyer_8,Patxi,Urrutia,1979-04-04,93497737T,patxi.urrutia@hyperapp.online,421269,ES88209508878651879704,1800.62,2023-07-03T05:57:17,Durango,expenses,food,-64.34,-34841.26
buyer_8,Patxi,Urrutia,1979-04-04,93497737T,patxi.urrutia@hyperapp.online,421269,ES88209508878651879704,1800.62,2023-07-03T17:19:07,Durango,expenses,transport,-53.87,-34895.13
buyer_8,Patxi,Urrutia,1979-04-04,93497737T,patxi.urrutia@hyperapp.online,421269,ES88209508878651879704,1800.62,2023-07-03T22:58:39,Durango,expenses,cash,-100.0,-34995.13
buyer_8,Patxi,Urrutia,1979-04-04,93497737T,patxi.urrutia@hyperapp.online,421269,ES88209508878651879704,1800.62,2023-07-05T13:38:32,Durango,expenses,mortgage,-1291.34,-36286.47
buyer_8,Patxi,Urrutia,1979-04-04,93497737T,patxi.urrutia@hyperapp.online,421269,ES88209508878651879704,1800.62,2023-07-05T20:36:47,Durango,expenses,electricity,-75.39,-36361.86
buyer_8,Patxi,Urrutia,1979-04-04,93497737T,patxi.urrutia@hyperapp.online,421269,ES88209508878651879704,1800.62,2023-07-06T20:59:03,Durango,expenses,gas,-127.5,-36489.36
buyer_8,Patxi,Urrutia,1979-04-04,93497737T,patxi.urrutia@hyperapp.online,421269,ES88209508878651879704,1800.62,2023-07-06T08:43:30,Durango,expenses,food,-99.15,-36588.51
buyer_8,Patxi,Urrutia,1979-04-04,93497737T,patxi.urrutia@hyperapp.online,421269,ES88209508878651879704,1800.62,2023-07-06T12:01:27,Durango,expenses,transport,-59.69,-36648.2
buyer_8,Patxi,Urrutia,1979-04-04,93497737T,patxi.urrutia@hyperapp.online,421269,ES88209508878651879704,1800.62,2023-07-07T16:46:04,Durango,expenses,water,-36.37,-36684.57
buyer_8,Patxi,Urrutia,1979-04-04,93497737T,patxi.urrutia@hyperapp.online,421269,ES88209508878651879704,1800.62,2023-07-07T13:14:45,Durango,expenses,internet,-75.68,-36760.25
buyer_8,Patxi,Urrutia,1979-04-04,93497737T,patxi.urrutia@hyperapp.online,421269,ES88209508878651879704,1800.62,2023-07-08T10:16:51,Durango,expenses,electricity,-118.31,-36878.56
buyer_8,Patxi,Urrutia,1979-04-04,93497737T,patxi.urrutia@hyperapp.online,421269,ES88209508878651879704,1800.62,2023-07-08T18:34:09,Durango,expenses,cash,-100.0,-36978.56
buyer_8,Patxi,Urrutia,1979-04-04,93497737T,patxi.urrutia@hyperapp.online,421269,ES88209508878651879704,1800.62,2023-07-09T18:30:56,Durango,expenses,food,-108.25,-37086.81
buyer_8,Patxi,Urrutia,1979-04-04,93497737T,patxi.urrutia@hyperapp.online,421269,ES88209508878651879704,1800.62,2023-07-09T10:43:10,Durango,expenses,healthcare,-134.05,-37220.86
buyer_8,Patxi,Urrutia,1979-04-04,93497737T,patxi.urrutia@hyperapp.online,421269,ES88209508878651879704,1800.62,2023-07-09T08:33:37,Durango,expenses,cash,-100.0,-37320.86
buyer_8,Patxi,Urrutia,1979-04-04,93497737T,patxi.urrutia@hyperapp.online,421269,ES88209508878651879704,1800.62,2023-07-10T14:06:53,Durango,expenses,transport,-46.73,-37367.59
buyer_8,Patxi,Urrutia,1979-04-04,93497737T,patxi.urrutia@hyperapp.online,421269,ES88209508878651879704,1800.62,2023-07-11T16:58:15,Durango,expenses,repairs,-39.36,-37406.95
buyer_8,Patxi,Urrutia,1979-04-04,93497737T,patxi.urrutia@hyperapp.online,421269,ES88209508878651879704,1800.62,2023-07-12T17:00:24,Durango,expenses,healthcare,-159.2,-37566.15
buyer_8,Patxi,Urrutia,1979-04-04,93497737T,patxi.urrutia@hyperapp.online,421269,ES88209508878651879704,1800.62,2023-07-12T18:48:00,Durango,expenses,gifts,-195.24,-37761.39
buyer_8,Patxi,Urrutia,1979-04-04,93497737T,patxi.urrutia@hyperapp.online,421269,ES88209508878651879704,1800.62,2023-07-14T12:57:22,Durango,expenses,cash,-100.0,-37861.39
buyer_8,Patxi,Urrutia,1979-04-04,93497737T,patxi.urrutia@hyperapp.online,421269,ES88209508878651879704,1800.62,2023-07-14T12:50:49,Durango,expenses,repairs,-66.78,-37928.17
buyer_8,Patxi,Urrutia,1979-04-04,93497737T,patxi.urrutia@hyperapp.online,421269,ES88209508878651879704,1800.62,2023-07-16T19:54:23,Durango,expenses,leisure,-83.12,-38011.29
buyer_8,Patxi,Urrutia,1979-04-04,93497737T,patxi.urrutia@hyperapp.online,421269,ES88209508878651879704,1800.62,2023-07-18T13:29:41,Durango,expenses,repairs,-162.39,-38173.68
buyer_8,Patxi,Urrutia,1979-04-04,93497737T,patxi.urrutia@hyperapp.online,421269,ES88209508878651879704,1800.62,2023-07-22T20:39:48,Durango,expenses,food,-74.02,-38247.7
buyer_8,Patxi,Urrutia,1979-04-04,93497737T,patxi.urrutia@hyperapp.online,421269,ES88209508878651879704,1800.62,2023-07-22T15:22:44,Durango,expenses,cash,-100.0,-38347.7
buyer_8,Patxi,Urrutia,1979-04-04,93497737T,patxi.urrutia@hyperapp.online,421269,ES88209508878651879704,1800.62,2023-07-23T15:44:43,Durango,expenses,leisure,-82.99,-38430.69
buyer_8,Patxi,Urrutia,1979-04-04,93497737T,patxi.urrutia@hyperapp.online,421269,ES88209508878651879704,1800.62,2023-07-26T08:59:21,Durango,expenses,leisure,-84.8,-38515.49
buyer_8,Patxi,Urrutia,1979-04-04,93497737T,patxi.urrutia@hyperapp.online,421269,ES88209508878651879704,1800.62,2023-07-27T19:50:49,Durango,expenses,repairs,-268.11,-38783.6
buyer_8,Patxi,Urrutia,1979-04-04,93497737T,patxi.urrutia@hyperapp.online,421269,ES88209508878651879704,1800.62,2023-07-28T20:32:12,Durango,expenses,cash,-100.0,-38883.6
buyer_8,Patxi,Urrutia,1979-04-04,93497737T,patxi.urrutia@hyperapp.online,421269,ES88209508878651879704,1800.62,2023-07-29T17:39:09,Durango,expenses,food,-74.31,-38957.91
buyer_8,Patxi,Urrutia,1979-04-04,93497737T,patxi.urrutia@hyperapp.online,421269,ES88209508878651879704,1800.62,2023-07-29T18:26:21,Durango,expenses,leisure,-48.73,-39006.64
buyer_8,Patxi,Urrutia,1979-04-04,93497737T,patxi.urrutia@hyperapp.online,421269,ES88209508878651879704,1800.62,2023-08-01T15:44:34,Durango,incomes,salary,3276.11,-35730.53
buyer_8,Patxi,Urrutia,1979-04-04,93497737T,patxi.urrutia@hyperapp.online,421269,ES88209508878651879704,1800.62,2023-08-02T20:19:53,Durango,expenses,food,-118.46,-35848.99
buyer_8,Patxi,Urrutia,1979-04-04,93497737T,patxi.urrutia@hyperapp.online,421269,ES88209508878651879704,1800.62,2023-08-03T15:41:01,Durango,expenses,food,-107.91,-35956.9
buyer_8,Patxi,Urrutia,1979-04-04,93497737T,patxi.urrutia@hyperapp.online,421269,ES88209508878651879704,1800.62,2023-08-03T18:53:06,Durango,expenses,gifts,-670.54,-36627.44
buyer_8,Patxi,Urrutia,1979-04-04,93497737T,patxi.urrutia@hyperapp.online,421269,ES88209508878651879704,1800.62,2023-08-04T20:47:06,Durango,expenses,food,-96.81,-36724.25
buyer_8,Patxi,Urrutia,1979-04-04,93497737T,patxi.urrutia@hyperapp.online,421269,ES88209508878651879704,1800.62,2023-08-04T09:21:47,Durango,expenses,transport,-80.42,-36804.67
buyer_8,Patxi,Urrutia,1979-04-04,93497737T,patxi.urrutia@hyperapp.online,421269,ES88209508878651879704,1800.62,2023-08-04T20:14:45,Durango,expenses,cash,-100.0,-36904.67
buyer_8,Patxi,Urrutia,1979-04-04,93497737T,patxi.urrutia@hyperapp.online,421269,ES88209508878651879704,1800.62,2023-08-05T08:39:49,Durango,expenses,mortgage,-1291.34,-38196.01
buyer_8,Patxi,Urrutia,1979-04-04,93497737T,patxi.urrutia@hyperapp.online,421269,ES88209508878651879704,1800.62,2023-08-05T21:52:47,Durango,expenses,water,-64.95,-38260.96
buyer_8,Patxi,Urrutia,1979-04-04,93497737T,patxi.urrutia@hyperapp.online,421269,ES88209508878651879704,1800.62,2023-08-05T00:05:11,Durango,expenses,electricity,-109.78,-38370.74
buyer_8,Patxi,Urrutia,1979-04-04,93497737T,patxi.urrutia@hyperapp.online,421269,ES88209508878651879704,1800.62,2023-08-05T09:21:02,Durango,expenses,gas,-94.55,-38465.29
buyer_8,Patxi,Urrutia,1979-04-04,93497737T,patxi.urrutia@hyperapp.online,421269,ES88209508878651879704,1800.62,2023-08-07T18:43:43,Durango,expenses,internet,-75.68,-38540.97
buyer_8,Patxi,Urrutia,1979-04-04,93497737T,patxi.urrutia@hyperapp.online,421269,ES88209508878651879704,1800.62,2023-08-08T16:54:09,Durango,expenses,water,-49.38,-38590.35
buyer_8,Patxi,Urrutia,1979-04-04,93497737T,patxi.urrutia@hyperapp.online,421269,ES88209508878651879704,1800.62,2023-08-08T10:57:05,Durango,expenses,internet,-75.68,-38666.03
buyer_8,Patxi,Urrutia,1979-04-04,93497737T,patxi.urrutia@hyperapp.online,421269,ES88209508878651879704,1800.62,2023-08-08T19:52:07,Durango,expenses,cash,-100.0,-38766.03
buyer_8,Patxi,Urrutia,1979-04-04,93497737T,patxi.urrutia@hyperapp.online,421269,ES88209508878651879704,1800.62,2023-08-09T20:53:02,Durango,expenses,transport,-67.13,-38833.16
buyer_8,Patxi,Urrutia,1979-04-04,93497737T,patxi.urrutia@hyperapp.online,421269,ES88209508878651879704,1800.62,2023-08-09T12:53:17,Durango,expenses,leisure,-55.12,-38888.28
buyer_8,Patxi,Urrutia,1979-04-04,93497737T,patxi.urrutia@hyperapp.online,421269,ES88209508878651879704,1800.62,2023-08-11T17:20:52,Durango,expenses,cash,-100.0,-38988.28
buyer_8,Patxi,Urrutia,1979-04-04,93497737T,patxi.urrutia@hyperapp.online,421269,ES88209508878651879704,1800.62,2023-08-12T12:04:24,Durango,expenses,food,-102.7,-39090.98
buyer_8,Patxi,Urrutia,1979-04-04,93497737T,patxi.urrutia@hyperapp.online,421269,ES88209508878651879704,1800.62,2023-08-12T18:27:15,Durango,expenses,travel,-1385.25,-40476.23
buyer_8,Patxi,Urrutia,1979-04-04,93497737T,patxi.urrutia@hyperapp.online,421269,ES88209508878651879704,1800.62,2023-08-13T19:48:57,Durango,expenses,food,-122.64,-40598.87
buyer_8,Patxi,Urrutia,1979-04-04,93497737T,patxi.urrutia@hyperapp.online,421269,ES88209508878651879704,1800.62,2023-08-14T09:00:04,Durango,expenses,transport,-69.14,-40668.01
buyer_8,Patxi,Urrutia,1979-04-04,93497737T,patxi.urrutia@hyperapp.online,421269,ES88209508878651879704,1800.62,2023-08-19T16:57:22,Durango,expenses,education,-53.26,-40721.27
buyer_8,Patxi,Urrutia,1979-04-04,93497737T,patxi.urrutia@hyperapp.online,421269,ES88209508878651879704,1800.62,2023-08-19T08:30:44,Durango,expenses,cash,-100.0,-40821.27
buyer_8,Patxi,Urrutia,1979-04-04,93497737T,patxi.urrutia@hyperapp.online,421269,ES88209508878651879704,1800.62,2023-08-20T19:33:44,Durango,expenses,gifts,-526.5,-41347.77
buyer_8,Patxi,Urrutia,1979-04-04,93497737T,patxi.urrutia@hyperapp.online,421269,ES88209508878651879704,1800.62,2023-08-21T21:13:00,Durango,expenses,cash,-100.0,-41447.77
buyer_8,Patxi,Urrutia,1979-04-04,93497737T,patxi.urrutia@hyperapp.online,421269,ES88209508878651879704,1800.62,2023-08-22T15:34:47,Durango,expenses,leisure,-26.16,-41473.93
buyer_8,Patxi,Urrutia,1979-04-04,93497737T,patxi.urrutia@hyperapp.online,421269,ES88209508878651879704,1800.62,2023-08-25T10:15:04,Durango,expenses,food,-109.05,-41582.98
buyer_8,Patxi,Urrutia,1979-04-04,93497737T,patxi.urrutia@hyperapp.online,421269,ES88209508878651879704,1800.62,2023-08-25T17:52:18,Durango,expenses,transport,-72.32,-41655.3
buyer_8,Patxi,Urrutia,1979-04-04,93497737T,patxi.urrutia@hyperapp.online,421269,ES88209508878651879704,1800.62,2023-08-25T13:48:09,Durango,expenses,clothing,-54.04,-41709.34
buyer_8,Patxi,Urrutia,1979-04-04,93497737T,patxi.urrutia@hyperapp.online,421269,ES88209508878651879704,1800.62,2023-08-25T23:28:50,Durango,expenses,repairs,-88.48,-41797.82
buyer_8,Patxi,Urrutia,1979-04-04,93497737T,patxi.urrutia@hyperapp.online,421269,ES88209508878651879704,1800.62,2023-08-26T08:01:53,Durango,expenses,travel,-750.3,-42548.12
buyer_8,Patxi,Urrutia,1979-04-04,93497737T,patxi.urrutia@hyperapp.online,421269,ES88209508878651879704,1800.62,2023-08-27T06:40:19,Durango,expenses,leisure,-43.76,-42591.88
buyer_8,Patxi,Urrutia,1979-04-04,93497737T,patxi.urrutia@hyperapp.online,421269,ES88209508878651879704,1800.62,2023-08-27T08:45:09,Durango,expenses,clothing,-112.79,-42704.67
buyer_8,Patxi,Urrutia,1979-04-04,93497737T,patxi.urrutia@hyperapp.online,421269,ES88209508878651879704,1800.62,2023-08-28T18:53:57,Durango,expenses,education,-78.2,-42782.87
buyer_8,Patxi,Urrutia,1979-04-04,93497737T,patxi.urrutia@hyperapp.online,421269,ES88209508878651879704,1800.62,2023-08-28T17:29:44,Durango,expenses,cash,-100.0,-42882.87
buyer_8,Patxi,Urrutia,1979-04-04,93497737T,patxi.urrutia@hyperapp.online,421269,ES88209508878651879704,1800.62,2023-08-29T19:03:53,Durango,expenses,education,-52.95,-42935.82
buyer_8,Patxi,Urrutia,1979-04-04,93497737T,patxi.urrutia@hyperapp.online,421269,ES88209508878651879704,1800.62,2023-08-31T11:26:18,Durango,expenses,cash,-100.0,-43035.82
buyer_8,Patxi,Urrutia,1979-04-04,93497737T,patxi.urrutia@hyperapp.online,421269,ES88209508878651879704,1800.62,2023-09-01T15:58:55,Durango,incomes,salary,3276.11,-39759.71
buyer_8,Patxi,Urrutia,1979-04-04,93497737T,patxi.urrutia@hyperapp.online,421269,ES88209508878651879704,1800.62,2023-09-01T15:58:55,Durango,incomes,extra_income,514.84,-39244.87
buyer_8,Patxi,Urrutia,1979-04-04,93497737T,patxi.urrutia@hyperapp.online,421269,ES88209508878651879704,1800.62,2023-09-02T19:17:33,Durango,expenses,education,-42.4,-39287.27
buyer_8,Patxi,Urrutia,1979-04-04,93497737T,patxi.urrutia@hyperapp.online,421269,ES88209508878651879704,1800.62,2023-09-02T09:34:24,Durango,expenses,cash,-100.0,-39387.27
buyer_8,Patxi,Urrutia,1979-04-04,93497737T,patxi.urrutia@hyperapp.online,421269,ES88209508878651879704,1800.62,2023-09-04T08:31:15,Durango,expenses,food,-83.55,-39470.82
buyer_8,Patxi,Urrutia,1979-04-04,93497737T,patxi.urrutia@hyperapp.online,421269,ES88209508878651879704,1800.62,2023-09-04T09:28:59,Durango,expenses,gifts,-582.01,-40052.83
buyer_8,Patxi,Urrutia,1979-04-04,93497737T,patxi.urrutia@hyperapp.online,421269,ES88209508878651879704,1800.62,2023-09-05T09:29:20,Durango,expenses,mortgage,-1291.34,-41344.17
buyer_8,Patxi,Urrutia,1979-04-04,93497737T,patxi.urrutia@hyperapp.online,421269,ES88209508878651879704,1800.62,2023-09-05T10:07:22,Durango,expenses,water,-54.16,-41398.33
buyer_8,Patxi,Urrutia,1979-04-04,93497737T,patxi.urrutia@hyperapp.online,421269,ES88209508878651879704,1800.62,2023-09-05T19:08:47,Durango,expenses,electricity,-146.69,-41545.02
buyer_8,Patxi,Urrutia,1979-04-04,93497737T,patxi.urrutia@hyperapp.online,421269,ES88209508878651879704,1800.62,2023-09-05T08:04:19,Durango,expenses,internet,-75.68,-41620.7
buyer_8,Patxi,Urrutia,1979-04-04,93497737T,patxi.urrutia@hyperapp.online,421269,ES88209508878651879704,1800.62,2023-09-06T20:32:24,Durango,expenses,gas,-101.27,-41721.97
buyer_8,Patxi,Urrutia,1979-04-04,93497737T,patxi.urrutia@hyperapp.online,421269,ES88209508878651879704,1800.62,2023-09-07T15:04:06,Durango,expenses,gas,-128.65,-41850.62
buyer_8,Patxi,Urrutia,1979-04-04,93497737T,patxi.urrutia@hyperapp.online,421269,ES88209508878651879704,1800.62,2023-09-07T11:54:30,Durango,expenses,internet,-75.68,-41926.3
buyer_8,Patxi,Urrutia,1979-04-04,93497737T,patxi.urrutia@hyperapp.online,421269,ES88209508878651879704,1800.62,2023-09-08T20:48:16,Durango,expenses,phone,-66.9,-41993.2
buyer_8,Patxi,Urrutia,1979-04-04,93497737T,patxi.urrutia@hyperapp.online,421269,ES88209508878651879704,1800.62,2023-09-08T14:33:51,Durango,expenses,transport,-77.95,-42071.15
buyer_8,Patxi,Urrutia,1979-04-04,93497737T,patxi.urrutia@hyperapp.online,421269,ES88209508878651879704,1800.62,2023-09-11T21:29:03,Durango,expenses,food,-81.62,-42152.77
buyer_8,Patxi,Urrutia,1979-04-04,93497737T,patxi.urrutia@hyperapp.online,421269,ES88209508878651879704,1800.62,2023-09-11T16:46:07,Durango,expenses,leisure,-65.49,-42218.26
buyer_8,Patxi,Urrutia,1979-04-04,93497737T,patxi.urrutia@hyperapp.online,421269,ES88209508878651879704,1800.62,2023-09-12T23:49:31,Durango,expenses,food,-110.94,-42329.2
buyer_8,Patxi,Urrutia,1979-04-04,93497737T,patxi.urrutia@hyperapp.online,421269,ES88209508878651879704,1800.62,2023-09-13T13:33:20,Durango,expenses,clothing,-97.5,-42426.7
buyer_8,Patxi,Urrutia,1979-04-04,93497737T,patxi.urrutia@hyperapp.online,421269,ES88209508878651879704,1800.62,2023-09-14T13:05:44,Durango,expenses,cash,-100.0,-42526.7
buyer_8,Patxi,Urrutia,1979-04-04,93497737T,patxi.urrutia@hyperapp.online,421269,ES88209508878651879704,1800.62,2023-09-16T19:34:26,Durango,expenses,clothing,-157.31,-42684.01
buyer_8,Patxi,Urrutia,1979-04-04,93497737T,patxi.urrutia@hyperapp.online,421269,ES88209508878651879704,1800.62,2023-09-17T12:57:04,Durango,expenses,food,-62.15,-42746.16
buyer_8,Patxi,Urrutia,1979-04-04,93497737T,patxi.urrutia@hyperapp.online,421269,ES88209508878651879704,1800.62,2023-09-19T15:32:56,Durango,expenses,clothing,-147.51,-42893.67
buyer_8,Patxi,Urrutia,1979-04-04,93497737T,patxi.urrutia@hyperapp.online,421269,ES88209508878651879704,1800.62,2023-09-19T12:54:46,Durango,expenses,cash,-100.0,-42993.67
buyer_8,Patxi,Urrutia,1979-04-04,93497737T,patxi.urrutia@hyperapp.online,421269,ES88209508878651879704,1800.62,2023-09-21T08:51:56,Durango,expenses,gifts,-315.01,-43308.68
buyer_8,Patxi,Urrutia,1979-04-04,93497737T,patxi.urrutia@hyperapp.online,421269,ES88209508878651879704,1800.62,2023-09-22T15:43:13,Durango,expenses,leisure,-64.25,-43372.93
buyer_8,Patxi,Urrutia,1979-04-04,93497737T,patxi.urrutia@hyperapp.online,421269,ES88209508878651879704,1800.62,2023-09-23T15:38:13,Durango,expenses,food,-103.47,-43476.4
buyer_8,Patxi,Urrutia,1979-04-04,93497737T,patxi.urrutia@hyperapp.online,421269,ES88209508878651879704,1800.62,2023-09-23T08:49:53,Durango,expenses,repairs,-157.99,-43634.39
buyer_8,Patxi,Urrutia,1979-04-04,93497737T,patxi.urrutia@hyperapp.online,421269,ES88209508878651879704,1800.62,2023-09-28T20:10:21,Durango,expenses,cash,-100.0,-43734.39
buyer_8,Patxi,Urrutia,1979-04-04,93497737T,patxi.urrutia@hyperapp.online,421269,ES88209508878651879704,1800.62,2023-09-29T05:45:09,Durango,expenses,leisure,-67.14,-43801.53
buyer_8,Patxi,Urrutia,1979-04-04,93497737T,patxi.urrutia@hyperapp.online,421269,ES88209508878651879704,1800.62,2023-09-29T15:58:59,Durango,expenses,repairs,-259.32,-44060.85
buyer_8,Patxi,Urrutia,1979-04-04,93497737T,patxi.urrutia@hyperapp.online,421269,ES88209508878651879704,1800.62,2023-09-30T16:53:18,Durango,expenses,travel,-1370.31,-45431.16
buyer_8,Patxi,Urrutia,1979-04-04,93497737T,patxi.urrutia@hyperapp.online,421269,ES88209508878651879704,1800.62,2023-10-01T16:17:01,Durango,incomes,salary,3276.11,-42155.05
buyer_8,Patxi,Urrutia,1979-04-04,93497737T,patxi.urrutia@hyperapp.online,421269,ES88209508878651879704,1800.62,2023-10-01T12:44:38,Durango,expenses,leisure,-54.84,-42209.89
buyer_8,Patxi,Urrutia,1979-04-04,93497737T,patxi.urrutia@hyperapp.online,421269,ES88209508878651879704,1800.62,2023-10-01T13:23:49,Durango,expenses,travel,-731.89,-42941.78
buyer_8,Patxi,Urrutia,1979-04-04,93497737T,patxi.urrutia@hyperapp.online,421269,ES88209508878651879704,1800.62,2023-10-02T15:04:50,Durango,expenses,healthcare,-83.59,-43025.37
buyer_8,Patxi,Urrutia,1979-04-04,93497737T,patxi.urrutia@hyperapp.online,421269,ES88209508878651879704,1800.62,2023-10-04T08:02:17,Durango,expenses,food,-104.35,-43129.72
buyer_8,Patxi,Urrutia,1979-04-04,93497737T,patxi.urrutia@hyperapp.online,421269,ES88209508878651879704,1800.62,2023-10-04T17:39:50,Durango,expenses,gifts,-611.56,-43741.28
buyer_8,Patxi,Urrutia,1979-04-04,93497737T,patxi.urrutia@hyperapp.online,421269,ES88209508878651879704,1800.62,2023-10-05T18:45:54,Durango,expenses,mortgage,-1291.34,-45032.62
buyer_8,Patxi,Urrutia,1979-04-04,93497737T,patxi.urrutia@hyperapp.online,421269,ES88209508878651879704,1800.62,2023-10-05T12:15:16,Durango,expenses,water,-68.53,-45101.15
buyer_8,Patxi,Urrutia,1979-04-04,93497737T,patxi.urrutia@hyperapp.online,421269,ES88209508878651879704,1800.62,2023-10-05T17:26:49,Durango,expenses,electricity,-110.64,-45211.79
buyer_8,Patxi,Urrutia,1979-04-04,93497737T,patxi.urrutia@hyperapp.online,421269,ES88209508878651879704,1800.62,2023-10-05T13:50:24,Durango,expenses,gas,-186.11,-45397.9
buyer_8,Patxi,Urrutia,1979-04-04,93497737T,patxi.urrutia@hyperapp.online,421269,ES88209508878651879704,1800.62,2023-10-05T15:11:27,Durango,expenses,phone,-60.48,-45458.38
buyer_8,Patxi,Urrutia,1979-04-04,93497737T,patxi.urrutia@hyperapp.online,421269,ES88209508878651879704,1800.62,2023-10-05T11:50:54,Durango,expenses,transport,-82.76,-45541.14
buyer_8,Patxi,Urrutia,1979-04-04,93497737T,patxi.urrutia@hyperapp.online,421269,ES88209508878651879704,1800.62,2023-10-06T11:15:35,Durango,expenses,water,-43.34,-45584.48
buyer_8,Patxi,Urrutia,1979-04-04,93497737T,patxi.urrutia@hyperapp.online,421269,ES88209508878651879704,1800.62,2023-10-06T19:37:37,Durango,expenses,gas,-142.26,-45726.74
buyer_8,Patxi,Urrutia,1979-04-04,93497737T,patxi.urrutia@hyperapp.online,421269,ES88209508878651879704,1800.62,2023-10-06T07:25:25,Durango,expenses,internet,-75.68,-45802.42
buyer_8,Patxi,Urrutia,1979-04-04,93497737T,patxi.urrutia@hyperapp.online,421269,ES88209508878651879704,1800.62,2023-10-06T12:39:06,Durango,expenses,phone,-79.85,-45882.27
buyer_8,Patxi,Urrutia,1979-04-04,93497737T,patxi.urrutia@hyperapp.online,421269,ES88209508878651879704,1800.62,2023-10-07T11:39:38,Durango,expenses,electricity,-160.97,-46043.24
buyer_8,Patxi,Urrutia,1979-04-04,93497737T,patxi.urrutia@hyperapp.online,421269,ES88209508878651879704,1800.62,2023-10-07T13:39:35,Durango,expenses,phone,-75.16,-46118.4
buyer_8,Patxi,Urrutia,1979-04-04,93497737T,patxi.urrutia@hyperapp.online,421269,ES88209508878651879704,1800.62,2023-10-07T14:44:57,Durango,expenses,gifts,-463.05,-46581.45
buyer_8,Patxi,Urrutia,1979-04-04,93497737T,patxi.urrutia@hyperapp.online,421269,ES88209508878651879704,1800.62,2023-10-08T16:39:27,Durango,expenses,electricity,-100.43,-46681.88
buyer_8,Patxi,Urrutia,1979-04-04,93497737T,patxi.urrutia@hyperapp.online,421269,ES88209508878651879704,1800.62,2023-10-08T12:42:09,Durango,expenses,internet,-75.68,-46757.56
buyer_8,Patxi,Urrutia,1979-04-04,93497737T,patxi.urrutia@hyperapp.online,421269,ES88209508878651879704,1800.62,2023-10-08T18:31:29,Durango,expenses,cash,-100.0,-46857.56
buyer_8,Patxi,Urrutia,1979-04-04,93497737T,patxi.urrutia@hyperapp.online,421269,ES88209508878651879704,1800.62,2023-10-12T17:12:06,Durango,expenses,cash,-100.0,-46957.56
buyer_8,Patxi,Urrutia,1979-04-04,93497737T,patxi.urrutia@hyperapp.online,421269,ES88209508878651879704,1800.62,2023-10-13T13:21:41,Durango,expenses,food,-98.49,-47056.05
buyer_8,Patxi,Urrutia,1979-04-04,93497737T,patxi.urrutia@hyperapp.online,421269,ES88209508878651879704,1800.62,2023-10-13T14:01:58,Durango,expenses,cash,-100.0,-47156.05
buyer_8,Patxi,Urrutia,1979-04-04,93497737T,patxi.urrutia@hyperapp.online,421269,ES88209508878651879704,1800.62,2023-10-14T09:15:30,Durango,expenses,gifts,-491.57,-47647.62
buyer_8,Patxi,Urrutia,1979-04-04,93497737T,patxi.urrutia@hyperapp.online,421269,ES88209508878651879704,1800.62,2023-10-17T09:57:07,Durango,expenses,appliances,-79.23,-47726.85
buyer_8,Patxi,Urrutia,1979-04-04,93497737T,patxi.urrutia@hyperapp.online,421269,ES88209508878651879704,1800.62,2023-10-18T21:14:50,Durango,expenses,leisure,-77.29,-47804.14
buyer_8,Patxi,Urrutia,1979-04-04,93497737T,patxi.urrutia@hyperapp.online,421269,ES88209508878651879704,1800.62,2023-10-19T20:56:16,Durango,expenses,leisure,-76.23,-47880.37
buyer_8,Patxi,Urrutia,1979-04-04,93497737T,patxi.urrutia@hyperapp.online,421269,ES88209508878651879704,1800.62,2023-10-19T13:53:45,Durango,expenses,gifts,-284.94,-48165.31
buyer_8,Patxi,Urrutia,1979-04-04,93497737T,patxi.urrutia@hyperapp.online,421269,ES88209508878651879704,1800.62,2023-10-20T08:35:45,Durango,expenses,gifts,-479.54,-48644.85
buyer_8,Patxi,Urrutia,1979-04-04,93497737T,patxi.urrutia@hyperapp.online,421269,ES88209508878651879704,1800.62,2023-10-23T10:20:52,Durango,expenses,food,-109.84,-48754.69
buyer_8,Patxi,Urrutia,1979-04-04,93497737T,patxi.urrutia@hyperapp.online,421269,ES88209508878651879704,1800.62,2023-10-23T23:50:57,Durango,expenses,cash,-100.0,-48854.69
buyer_8,Patxi,Urrutia,1979-04-04,93497737T,patxi.urrutia@hyperapp.online,421269,ES88209508878651879704,1800.62,2023-10-24T10:15:54,Durango,expenses,food,-61.33,-48916.02
buyer_8,Patxi,Urrutia,1979-04-04,93497737T,patxi.urrutia@hyperapp.online,421269,ES88209508878651879704,1800.62,2023-10-24T19:58:26,Durango,expenses,appliances,-327.07,-49243.09
buyer_8,Patxi,Urrutia,1979-04-04,93497737T,patxi.urrutia@hyperapp.online,421269,ES88209508878651879704,1800.62,2023-10-26T11:07:30,Durango,expenses,food,-102.65,-49345.74
buyer_8,Patxi,Urrutia,1979-04-04,93497737T,patxi.urrutia@hyperapp.online,421269,ES88209508878651879704,1800.62,2023-10-26T20:42:36,Durango,expenses,transport,-87.61,-49433.35
buyer_8,Patxi,Urrutia,1979-04-04,93497737T,patxi.urrutia@hyperapp.online,421269,ES88209508878651879704,1800.62,2023-10-26T08:46:47,Durango,expenses,repairs,-279.36,-49712.71
buyer_8,Patxi,Urrutia,1979-04-04,93497737T,patxi.urrutia@hyperapp.online,421269,ES88209508878651879704,1800.62,2023-10-27T11:11:25,Durango,expenses,food,-113.66,-49826.37
buyer_8,Patxi,Urrutia,1979-04-04,93497737T,patxi.urrutia@hyperapp.online,421269,ES88209508878651879704,1800.62,2023-10-27T12:42:54,Durango,expenses,clothing,-103.04,-49929.41
buyer_8,Patxi,Urrutia,1979-04-04,93497737T,patxi.urrutia@hyperapp.online,421269,ES88209508878651879704,1800.62,2023-10-29T15:46:17,Durango,expenses,leisure,-65.8,-49995.21
buyer_8,Patxi,Urrutia,1979-04-04,93497737T,patxi.urrutia@hyperapp.online,421269,ES88209508878651879704,1800.62,2023-10-29T11:27:06,Durango,expenses,gifts,-644.49,-50639.7
buyer_8,Patxi,Urrutia,1979-04-04,93497737T,patxi.urrutia@hyperapp.online,421269,ES88209508878651879704,1800.62,2023-10-31T00:08:37,Durango,expenses,education,-69.53,-50709.23
buyer_8,Patxi,Urrutia,1979-04-04,93497737T,patxi.urrutia@hyperapp.online,421269,ES88209508878651879704,1800.62,2023-10-31T09:55:12,Durango,expenses,repairs,-159.52,-50868.75
buyer_8,Patxi,Urrutia,1979-04-04,93497737T,patxi.urrutia@hyperapp.online,421269,ES88209508878651879704,1800.62,2023-10-31T11:42:25,Durango,expenses,gifts,-692.26,-51561.01
buyer_8,Patxi,Urrutia,1979-04-04,93497737T,patxi.urrutia@hyperapp.online,421269,ES88209508878651879704,1800.62,2023-11-01T13:26:23,Durango,incomes,salary,3276.11,-48284.9
buyer_8,Patxi,Urrutia,1979-04-04,93497737T,patxi.urrutia@hyperapp.online,421269,ES88209508878651879704,1800.62,2023-11-03T08:26:07,Durango,expenses,cash,-100.0,-48384.9
buyer_8,Patxi,Urrutia,1979-04-04,93497737T,patxi.urrutia@hyperapp.online,421269,ES88209508878651879704,1800.62,2023-11-04T19:15:46,Durango,expenses,gifts,-631.22,-49016.12
buyer_8,Patxi,Urrutia,1979-04-04,93497737T,patxi.urrutia@hyperapp.online,421269,ES88209508878651879704,1800.62,2023-11-05T08:18:43,Durango,expenses,mortgage,-1291.34,-50307.46
buyer_8,Patxi,Urrutia,1979-04-04,93497737T,patxi.urrutia@hyperapp.online,421269,ES88209508878651879704,1800.62,2023-11-05T18:52:17,Durango,expenses,electricity,-62.18,-50369.64
buyer_8,Patxi,Urrutia,1979-04-04,93497737T,patxi.urrutia@hyperapp.online,421269,ES88209508878651879704,1800.62,2023-11-05T08:00:58,Durango,expenses,phone,-56.68,-50426.32
buyer_8,Patxi,Urrutia,1979-04-04,93497737T,patxi.urrutia@hyperapp.online,421269,ES88209508878651879704,1800.62,2023-11-06T20:48:41,Durango,expenses,phone,-57.38,-50483.7
buyer_8,Patxi,Urrutia,1979-04-04,93497737T,patxi.urrutia@hyperapp.online,421269,ES88209508878651879704,1800.62,2023-11-06T13:31:56,Durango,expenses,transport,-64.18,-50547.88
buyer_8,Patxi,Urrutia,1979-04-04,93497737T,patxi.urrutia@hyperapp.online,421269,ES88209508878651879704,1800.62,2023-11-06T12:16:59,Durango,expenses,leisure,-78.39,-50626.27
buyer_8,Patxi,Urrutia,1979-04-04,93497737T,patxi.urrutia@hyperapp.online,421269,ES88209508878651879704,1800.62,2023-11-06T15:54:14,Durango,expenses,cash,-100.0,-50726.27
buyer_8,Patxi,Urrutia,1979-04-04,93497737T,patxi.urrutia@hyperapp.online,421269,ES88209508878651879704,1800.62,2023-11-07T08:11:10,Durango,expenses,gas,-157.9,-50884.17
buyer_8,Patxi,Urrutia,1979-04-04,93497737T,patxi.urrutia@hyperapp.online,421269,ES88209508878651879704,1800.62,2023-11-07T00:31:34,Durango,expenses,transport,-50.55,-50934.72
buyer_8,Patxi,Urrutia,1979-04-04,93497737T,patxi.urrutia@hyperapp.online,421269,ES88209508878651879704,1800.62,2023-11-07T17:37:46,Durango,expenses,cash,-100.0,-51034.72
buyer_8,Patxi,Urrutia,1979-04-04,93497737T,patxi.urrutia@hyperapp.online,421269,ES88209508878651879704,1800.62,2023-11-08T15:58:12,Durango,expenses,gas,-107.41,-51142.13
buyer_8,Patxi,Urrutia,1979-04-04,93497737T,patxi.urrutia@hyperapp.online,421269,ES88209508878651879704,1800.62,2023-11-09T12:50:34,Durango,expenses,food,-109.18,-51251.31
buyer_8,Patxi,Urrutia,1979-04-04,93497737T,patxi.urrutia@hyperapp.online,421269,ES88209508878651879704,1800.62,2023-11-09T19:42:27,Durango,expenses,leisure,-73.35,-51324.66
buyer_8,Patxi,Urrutia,1979-04-04,93497737T,patxi.urrutia@hyperapp.online,421269,ES88209508878651879704,1800.62,2023-11-09T13:16:44,Durango,expenses,education,-77.79,-51402.45
buyer_8,Patxi,Urrutia,1979-04-04,93497737T,patxi.urrutia@hyperapp.online,421269,ES88209508878651879704,1800.62,2023-11-09T10:48:04,Durango,expenses,cash,-100.0,-51502.45
buyer_8,Patxi,Urrutia,1979-04-04,93497737T,patxi.urrutia@hyperapp.online,421269,ES88209508878651879704,1800.62,2023-11-10T14:33:32,Durango,expenses,leisure,-30.42,-51532.87
buyer_8,Patxi,Urrutia,1979-04-04,93497737T,patxi.urrutia@hyperapp.online,421269,ES88209508878651879704,1800.62,2023-11-10T13:12:14,Durango,expenses,appliances,-313.83,-51846.7
buyer_8,Patxi,Urrutia,1979-04-04,93497737T,patxi.urrutia@hyperapp.online,421269,ES88209508878651879704,1800.62,2023-11-11T13:36:28,Durango,expenses,food,-105.99,-51952.69
buyer_8,Patxi,Urrutia,1979-04-04,93497737T,patxi.urrutia@hyperapp.online,421269,ES88209508878651879704,1800.62,2023-11-12T14:27:59,Durango,expenses,healthcare,-64.51,-52017.2
buyer_8,Patxi,Urrutia,1979-04-04,93497737T,patxi.urrutia@hyperapp.online,421269,ES88209508878651879704,1800.62,2023-11-13T19:12:27,Durango,expenses,cash,-100.0,-52117.2
buyer_8,Patxi,Urrutia,1979-04-04,93497737T,patxi.urrutia@hyperapp.online,421269,ES88209508878651879704,1800.62,2023-11-15T09:57:49,Durango,expenses,leisure,-51.6,-52168.8
buyer_8,Patxi,Urrutia,1979-04-04,93497737T,patxi.urrutia@hyperapp.online,421269,ES88209508878651879704,1800.62,2023-11-15T13:01:07,Durango,expenses,repairs,-194.52,-52363.32
buyer_8,Patxi,Urrutia,1979-04-04,93497737T,patxi.urrutia@hyperapp.online,421269,ES88209508878651879704,1800.62,2023-11-16T10:51:15,Durango,expenses,transport,-53.1,-52416.42
buyer_8,Patxi,Urrutia,1979-04-04,93497737T,patxi.urrutia@hyperapp.online,421269,ES88209508878651879704,1800.62,2023-11-19T17:56:57,Durango,expenses,leisure,-78.19,-52494.61
buyer_8,Patxi,Urrutia,1979-04-04,93497737T,patxi.urrutia@hyperapp.online,421269,ES88209508878651879704,1800.62,2023-11-20T05:43:03,Durango,expenses,healthcare,-43.3,-52537.91
buyer_8,Patxi,Urrutia,1979-04-04,93497737T,patxi.urrutia@hyperapp.online,421269,ES88209508878651879704,1800.62,2023-11-23T23:08:33,Durango,expenses,cash,-100.0,-52637.91
buyer_8,Patxi,Urrutia,1979-04-04,93497737T,patxi.urrutia@hyperapp.online,421269,ES88209508878651879704,1800.62,2023-11-24T15:38:10,Durango,expenses,repairs,-159.82,-52797.73
buyer_8,Patxi,Urrutia,1979-04-04,93497737T,patxi.urrutia@hyperapp.online,421269,ES88209508878651879704,1800.62,2023-11-25T14:30:29,Durango,expenses,transport,-69.17,-52866.9
buyer_8,Patxi,Urrutia,1979-04-04,93497737T,patxi.urrutia@hyperapp.online,421269,ES88209508878651879704,1800.62,2023-11-25T15:34:06,Durango,expenses,clothing,-120.49,-52987.39
buyer_8,Patxi,Urrutia,1979-04-04,93497737T,patxi.urrutia@hyperapp.online,421269,ES88209508878651879704,1800.62,2023-11-26T18:58:05,Durango,expenses,food,-77.67,-53065.06
buyer_8,Patxi,Urrutia,1979-04-04,93497737T,patxi.urrutia@hyperapp.online,421269,ES88209508878651879704,1800.62,2023-11-26T11:35:16,Durango,expenses,transport,-50.73,-53115.79
buyer_8,Patxi,Urrutia,1979-04-04,93497737T,patxi.urrutia@hyperapp.online,421269,ES88209508878651879704,1800.62,2023-11-27T18:06:53,Durango,expenses,transport,-42.11,-53157.9
buyer_8,Patxi,Urrutia,1979-04-04,93497737T,patxi.urrutia@hyperapp.online,421269,ES88209508878651879704,1800.62,2023-11-27T12:19:42,Durango,expenses,gifts,-232.79,-53390.69
buyer_8,Patxi,Urrutia,1979-04-04,93497737T,patxi.urrutia@hyperapp.online,421269,ES88209508878651879704,1800.62,2023-11-28T03:20:12,Durango,expenses,food,-93.0,-53483.69
buyer_8,Patxi,Urrutia,1979-04-04,93497737T,patxi.urrutia@hyperapp.online,421269,ES88209508878651879704,1800.62,2023-11-28T19:37:50,Durango,expenses,leisure,-44.48,-53528.17
buyer_8,Patxi,Urrutia,1979-04-04,93497737T,patxi.urrutia@hyperapp.online,421269,ES88209508878651879704,1800.62,2023-11-29T20:12:24,Durango,expenses,appliances,-308.94,-53837.11
buyer_8,Patxi,Urrutia,1979-04-04,93497737T,patxi.urrutia@hyperapp.online,421269,ES88209508878651879704,1800.62,2023-12-01T12:40:35,Durango,incomes,salary,3276.11,-50561.0
buyer_8,Patxi,Urrutia,1979-04-04,93497737T,patxi.urrutia@hyperapp.online,421269,ES88209508878651879704,1800.62,2023-12-01T12:40:35,Durango,incomes,extra_income,514.84,-50046.16
buyer_8,Patxi,Urrutia,1979-04-04,93497737T,patxi.urrutia@hyperapp.online,421269,ES88209508878651879704,1800.62,2023-12-01T12:40:35,Durango,incomes,salary_bonus,2320.81,-47725.35
buyer_8,Patxi,Urrutia,1979-04-04,93497737T,patxi.urrutia@hyperapp.online,421269,ES88209508878651879704,1800.62,2023-12-01T09:23:30,Durango,expenses,food,-64.51,-47789.86
buyer_8,Patxi,Urrutia,1979-04-04,93497737T,patxi.urrutia@hyperapp.online,421269,ES88209508878651879704,1800.62,2023-12-01T15:27:14,Durango,expenses,transport,-47.5,-47837.36
buyer_8,Patxi,Urrutia,1979-04-04,93497737T,patxi.urrutia@hyperapp.online,421269,ES88209508878651879704,1800.62,2023-12-02T10:31:49,Durango,expenses,repairs,-100.64,-47938.0
buyer_8,Patxi,Urrutia,1979-04-04,93497737T,patxi.urrutia@hyperapp.online,421269,ES88209508878651879704,1800.62,2023-12-03T12:11:45,Durango,expenses,education,-50.4,-47988.4
buyer_8,Patxi,Urrutia,1979-04-04,93497737T,patxi.urrutia@hyperapp.online,421269,ES88209508878651879704,1800.62,2023-12-04T10:02:52,Durango,expenses,food,-117.34,-48105.74
buyer_8,Patxi,Urrutia,1979-04-04,93497737T,patxi.urrutia@hyperapp.online,421269,ES88209508878651879704,1800.62,2023-12-04T08:27:18,Durango,expenses,leisure,-84.25,-48189.99
buyer_8,Patxi,Urrutia,1979-04-04,93497737T,patxi.urrutia@hyperapp.online,421269,ES88209508878651879704,1800.62,2023-12-05T18:49:01,Durango,expenses,mortgage,-1291.34,-49481.33
buyer_8,Patxi,Urrutia,1979-04-04,93497737T,patxi.urrutia@hyperapp.online,421269,ES88209508878651879704,1800.62,2023-12-05T09:35:03,Durango,expenses,water,-60.42,-49541.75
buyer_8,Patxi,Urrutia,1979-04-04,93497737T,patxi.urrutia@hyperapp.online,421269,ES88209508878651879704,1800.62,2023-12-05T23:29:41,Durango,expenses,gas,-81.89,-49623.64
buyer_8,Patxi,Urrutia,1979-04-04,93497737T,patxi.urrutia@hyperapp.online,421269,ES88209508878651879704,1800.62,2023-12-05T17:49:25,Durango,expenses,phone,-61.74,-49685.38
buyer_8,Patxi,Urrutia,1979-04-04,93497737T,patxi.urrutia@hyperapp.online,421269,ES88209508878651879704,1800.62,2023-12-05T18:01:32,Durango,expenses,cash,-100.0,-49785.38
buyer_8,Patxi,Urrutia,1979-04-04,93497737T,patxi.urrutia@hyperapp.online,421269,ES88209508878651879704,1800.62,2023-12-06T09:58:46,Durango,expenses,phone,-70.1,-49855.48
buyer_8,Patxi,Urrutia,1979-04-04,93497737T,patxi.urrutia@hyperapp.online,421269,ES88209508878651879704,1800.62,2023-12-06T17:46:23,Durango,expenses,food,-71.19,-49926.67
buyer_8,Patxi,Urrutia,1979-04-04,93497737T,patxi.urrutia@hyperapp.online,421269,ES88209508878651879704,1800.62,2023-12-06T11:02:34,Durango,expenses,transport,-65.66,-49992.33
buyer_8,Patxi,Urrutia,1979-04-04,93497737T,patxi.urrutia@hyperapp.online,421269,ES88209508878651879704,1800.62,2023-12-06T15:21:50,Durango,expenses,cash,-100.0,-50092.33
buyer_8,Patxi,Urrutia,1979-04-04,93497737T,patxi.urrutia@hyperapp.online,421269,ES88209508878651879704,1800.62,2023-12-07T14:50:10,Durango,expenses,electricity,-57.0,-50149.33
buyer_8,Patxi,Urrutia,1979-04-04,93497737T,patxi.urrutia@hyperapp.online,421269,ES88209508878651879704,1800.62,2023-12-07T18:41:43,Durango,expenses,leisure,-22.87,-50172.2
buyer_8,Patxi,Urrutia,1979-04-04,93497737T,patxi.urrutia@hyperapp.online,421269,ES88209508878651879704,1800.62,2023-12-08T10:17:42,Durango,expenses,water,-43.74,-50215.94
buyer_8,Patxi,Urrutia,1979-04-04,93497737T,patxi.urrutia@hyperapp.online,421269,ES88209508878651879704,1800.62,2023-12-08T01:59:55,Durango,expenses,electricity,-68.34,-50284.28
buyer_8,Patxi,Urrutia,1979-04-04,93497737T,patxi.urrutia@hyperapp.online,421269,ES88209508878651879704,1800.62,2023-12-08T15:00:07,Durango,expenses,internet,-75.68,-50359.96
buyer_8,Patxi,Urrutia,1979-04-04,93497737T,patxi.urrutia@hyperapp.online,421269,ES88209508878651879704,1800.62,2023-12-08T19:56:30,Durango,expenses,food,-65.56,-50425.52
buyer_8,Patxi,Urrutia,1979-04-04,93497737T,patxi.urrutia@hyperapp.online,421269,ES88209508878651879704,1800.62,2023-12-11T18:07:51,Durango,expenses,food,-94.46,-50519.98
buyer_8,Patxi,Urrutia,1979-04-04,93497737T,patxi.urrutia@hyperapp.online,421269,ES88209508878651879704,1800.62,2023-12-12T17:57:38,Durango,expenses,transport,-85.58,-50605.56
buyer_8,Patxi,Urrutia,1979-04-04,93497737T,patxi.urrutia@hyperapp.online,421269,ES88209508878651879704,1800.62,2023-12-13T18:12:01,Durango,expenses,cash,-100.0,-50705.56
buyer_8,Patxi,Urrutia,1979-04-04,93497737T,patxi.urrutia@hyperapp.online,421269,ES88209508878651879704,1800.62,2023-12-14T10:34:22,Durango,expenses,gifts,-659.81,-51365.37
buyer_8,Patxi,Urrutia,1979-04-04,93497737T,patxi.urrutia@hyperapp.online,421269,ES88209508878651879704,1800.62,2023-12-15T15:37:25,Durango,expenses,food,-67.61,-51432.98
buyer_8,Patxi,Urrutia,1979-04-04,93497737T,patxi.urrutia@hyperapp.online,421269,ES88209508878651879704,1800.62,2023-12-15T10:50:28,Durango,expenses,transport,-87.62,-51520.6
buyer_8,Patxi,Urrutia,1979-04-04,93497737T,patxi.urrutia@hyperapp.online,421269,ES88209508878651879704,1800.62,2023-12-15T11:25:19,Durango,expenses,travel,-563.32,-52083.92
buyer_8,Patxi,Urrutia,1979-04-04,93497737T,patxi.urrutia@hyperapp.online,421269,ES88209508878651879704,1800.62,2023-12-16T19:17:41,Durango,expenses,transport,-73.35,-52157.27
buyer_8,Patxi,Urrutia,1979-04-04,93497737T,patxi.urrutia@hyperapp.online,421269,ES88209508878651879704,1800.62,2023-12-16T14:16:40,Durango,expenses,education,-47.44,-52204.71
buyer_8,Patxi,Urrutia,1979-04-04,93497737T,patxi.urrutia@hyperapp.online,421269,ES88209508878651879704,1800.62,2023-12-18T22:38:27,Durango,expenses,cash,-100.0,-52304.71
buyer_8,Patxi,Urrutia,1979-04-04,93497737T,patxi.urrutia@hyperapp.online,421269,ES88209508878651879704,1800.62,2023-12-19T14:08:33,Durango,expenses,gifts,-616.69,-52921.4
buyer_8,Patxi,Urrutia,1979-04-04,93497737T,patxi.urrutia@hyperapp.online,421269,ES88209508878651879704,1800.62,2023-12-21T04:04:25,Durango,expenses,food,-119.35,-53040.75
buyer_8,Patxi,Urrutia,1979-04-04,93497737T,patxi.urrutia@hyperapp.online,421269,ES88209508878651879704,1800.62,2023-12-22T01:07:57,Durango,expenses,gifts,-509.22,-53549.97
buyer_8,Patxi,Urrutia,1979-04-04,93497737T,patxi.urrutia@hyperapp.online,421269,ES88209508878651879704,1800.62,2023-12-25T08:52:15,Durango,expenses,transport,-64.74,-53614.71
buyer_8,Patxi,Urrutia,1979-04-04,93497737T,patxi.urrutia@hyperapp.online,421269,ES88209508878651879704,1800.62,2023-12-25T14:36:08,Durango,expenses,leisure,-73.14,-53687.85
buyer_8,Patxi,Urrutia,1979-04-04,93497737T,patxi.urrutia@hyperapp.online,421269,ES88209508878651879704,1800.62,2023-12-25T18:36:11,Durango,expenses,clothing,-50.85,-53738.7
buyer_8,Patxi,Urrutia,1979-04-04,93497737T,patxi.urrutia@hyperapp.online,421269,ES88209508878651879704,1800.62,2023-12-25T13:47:34,Durango,expenses,cash,-100.0,-53838.7
buyer_8,Patxi,Urrutia,1979-04-04,93497737T,patxi.urrutia@hyperapp.online,421269,ES88209508878651879704,1800.62,2023-12-25T08:49:23,Durango,expenses,travel,-570.26,-54408.96
buyer_8,Patxi,Urrutia,1979-04-04,93497737T,patxi.urrutia@hyperapp.online,421269,ES88209508878651879704,1800.62,2023-12-26T16:52:04,Durango,expenses,appliances,-154.87,-54563.83
buyer_8,Patxi,Urrutia,1979-04-04,93497737T,patxi.urrutia@hyperapp.online,421269,ES88209508878651879704,1800.62,2023-12-29T06:31:18,Durango,expenses,food,-62.81,-54626.64
buyer_8,Patxi,Urrutia,1979-04-04,93497737T,patxi.urrutia@hyperapp.online,421269,ES88209508878651879704,1800.62,2024-01-01T08:44:39,Durango,incomes,salary,3374.74,-51251.9
buyer_8,Patxi,Urrutia,1979-04-04,93497737T,patxi.urrutia@hyperapp.online,421269,ES88209508878651879704,1800.62,2024-01-01T21:56:01,Durango,expenses,cash,-100.0,-51351.9
buyer_8,Patxi,Urrutia,1979-04-04,93497737T,patxi.urrutia@hyperapp.online,421269,ES88209508878651879704,1800.62,2024-01-02T12:12:01,Durango,expenses,clothing,-131.06,-51482.96
buyer_8,Patxi,Urrutia,1979-04-04,93497737T,patxi.urrutia@hyperapp.online,421269,ES88209508878651879704,1800.62,2024-01-04T10:58:14,Durango,expenses,transport,-86.59,-51569.55
buyer_8,Patxi,Urrutia,1979-04-04,93497737T,patxi.urrutia@hyperapp.online,421269,ES88209508878651879704,1800.62,2024-01-05T15:13:26,Durango,expenses,mortgage,-1455.68,-53025.23
buyer_8,Patxi,Urrutia,1979-04-04,93497737T,patxi.urrutia@hyperapp.online,421269,ES88209508878651879704,1800.62,2024-01-05T02:34:11,Durango,expenses,electricity,-43.0,-53068.23
buyer_8,Patxi,Urrutia,1979-04-04,93497737T,patxi.urrutia@hyperapp.online,421269,ES88209508878651879704,1800.62,2024-01-05T08:53:08,Durango,expenses,gas,-58.05,-53126.28
buyer_8,Patxi,Urrutia,1979-04-04,93497737T,patxi.urrutia@hyperapp.online,421269,ES88209508878651879704,1800.62,2024-01-05T11:30:08,Durango,expenses,phone,-66.01,-53192.29
buyer_8,Patxi,Urrutia,1979-04-04,93497737T,patxi.urrutia@hyperapp.online,421269,ES88209508878651879704,1800.62,2024-01-05T10:41:21,Durango,expenses,clothing,-75.7,-53267.99
buyer_8,Patxi,Urrutia,1979-04-04,93497737T,patxi.urrutia@hyperapp.online,421269,ES88209508878651879704,1800.62,2024-01-06T22:24:34,Durango,expenses,electricity,-98.97,-53366.96
buyer_8,Patxi,Urrutia,1979-04-04,93497737T,patxi.urrutia@hyperapp.online,421269,ES88209508878651879704,1800.62,2024-01-06T16:41:26,Durango,expenses,transport,-76.78,-53443.74
buyer_8,Patxi,Urrutia,1979-04-04,93497737T,patxi.urrutia@hyperapp.online,421269,ES88209508878651879704,1800.62,2024-01-06T14:26:53,Durango,expenses,clothing,-64.56,-53508.3
buyer_8,Patxi,Urrutia,1979-04-04,93497737T,patxi.urrutia@hyperapp.online,421269,ES88209508878651879704,1800.62,2024-01-06T13:06:28,Durango,expenses,travel,-498.95,-54007.25
buyer_8,Patxi,Urrutia,1979-04-04,93497737T,patxi.urrutia@hyperapp.online,421269,ES88209508878651879704,1800.62,2024-01-07T09:38:07,Durango,expenses,water,-68.29,-54075.54
buyer_8,Patxi,Urrutia,1979-04-04,93497737T,patxi.urrutia@hyperapp.online,421269,ES88209508878651879704,1800.62,2024-01-07T09:51:20,Durango,expenses,internet,-77.96,-54153.5
buyer_8,Patxi,Urrutia,1979-04-04,93497737T,patxi.urrutia@hyperapp.online,421269,ES88209508878651879704,1800.62,2024-01-07T09:46:53,Durango,expenses,phone,-77.87,-54231.37
buyer_8,Patxi,Urrutia,1979-04-04,93497737T,patxi.urrutia@hyperapp.online,421269,ES88209508878651879704,1800.62,2024-01-07T12:18:11,Durango,expenses,transport,-67.79,-54299.16
buyer_8,Patxi,Urrutia,1979-04-04,93497737T,patxi.urrutia@hyperapp.online,421269,ES88209508878651879704,1800.62,2024-01-07T13:42:01,Durango,expenses,cash,-100.0,-54399.16
buyer_8,Patxi,Urrutia,1979-04-04,93497737T,patxi.urrutia@hyperapp.online,421269,ES88209508878651879704,1800.62,2024-01-07T19:22:51,Durango,expenses,travel,-687.61,-55086.77
buyer_8,Patxi,Urrutia,1979-04-04,93497737T,patxi.urrutia@hyperapp.online,421269,ES88209508878651879704,1800.62,2024-01-08T08:56:32,Durango,expenses,water,-42.7,-55129.47
buyer_8,Patxi,Urrutia,1979-04-04,93497737T,patxi.urrutia@hyperapp.online,421269,ES88209508878651879704,1800.62,2024-01-08T09:32:50,Durango,expenses,electricity,-98.61,-55228.08
buyer_8,Patxi,Urrutia,1979-04-04,93497737T,patxi.urrutia@hyperapp.online,421269,ES88209508878651879704,1800.62,2024-01-08T13:52:38,Durango,expenses,gas,-88.34,-55316.42
buyer_8,Patxi,Urrutia,1979-04-04,93497737T,patxi.urrutia@hyperapp.online,421269,ES88209508878651879704,1800.62,2024-01-08T18:51:36,Durango,expenses,phone,-55.87,-55372.29
buyer_8,Patxi,Urrutia,1979-04-04,93497737T,patxi.urrutia@hyperapp.online,421269,ES88209508878651879704,1800.62,2024-01-09T16:06:05,Durango,expenses,travel,-639.94,-56012.23
buyer_8,Patxi,Urrutia,1979-04-04,93497737T,patxi.urrutia@hyperapp.online,421269,ES88209508878651879704,1800.62,2024-01-09T21:33:14,Durango,expenses,repairs,-232.79,-56245.02
buyer_8,Patxi,Urrutia,1979-04-04,93497737T,patxi.urrutia@hyperapp.online,421269,ES88209508878651879704,1800.62,2024-01-09T12:40:48,Durango,expenses,gifts,-146.78,-56391.8
buyer_8,Patxi,Urrutia,1979-04-04,93497737T,patxi.urrutia@hyperapp.online,421269,ES88209508878651879704,1800.62,2024-01-10T23:37:32,Durango,expenses,education,-72.25,-56464.05
buyer_8,Patxi,Urrutia,1979-04-04,93497737T,patxi.urrutia@hyperapp.online,421269,ES88209508878651879704,1800.62,2024-01-11T16:25:04,Durango,expenses,education,-53.53,-56517.58
buyer_8,Patxi,Urrutia,1979-04-04,93497737T,patxi.urrutia@hyperapp.online,421269,ES88209508878651879704,1800.62,2024-01-14T08:18:15,Durango,expenses,cash,-100.0,-56617.58
buyer_8,Patxi,Urrutia,1979-04-04,93497737T,patxi.urrutia@hyperapp.online,421269,ES88209508878651879704,1800.62,2024-01-15T18:08:18,Durango,expenses,cash,-100.0,-56717.58
buyer_8,Patxi,Urrutia,1979-04-04,93497737T,patxi.urrutia@hyperapp.online,421269,ES88209508878651879704,1800.62,2024-01-16T16:33:50,Durango,expenses,food,-65.68,-56783.26
buyer_8,Patxi,Urrutia,1979-04-04,93497737T,patxi.urrutia@hyperapp.online,421269,ES88209508878651879704,1800.62,2024-01-16T09:38:01,Durango,expenses,transport,-74.41,-56857.67
buyer_8,Patxi,Urrutia,1979-04-04,93497737T,patxi.urrutia@hyperapp.online,421269,ES88209508878651879704,1800.62,2024-01-17T03:37:55,Durango,expenses,food,-96.92,-56954.59
buyer_8,Patxi,Urrutia,1979-04-04,93497737T,patxi.urrutia@hyperapp.online,421269,ES88209508878651879704,1800.62,2024-01-22T18:57:25,Durango,expenses,leisure,-73.25,-57027.84
buyer_8,Patxi,Urrutia,1979-04-04,93497737T,patxi.urrutia@hyperapp.online,421269,ES88209508878651879704,1800.62,2024-01-24T11:45:16,Durango,expenses,cash,-100.0,-57127.84
buyer_8,Patxi,Urrutia,1979-04-04,93497737T,patxi.urrutia@hyperapp.online,421269,ES88209508878651879704,1800.62,2024-01-25T15:02:42,Durango,expenses,cash,-100.0,-57227.84
buyer_8,Patxi,Urrutia,1979-04-04,93497737T,patxi.urrutia@hyperapp.online,421269,ES88209508878651879704,1800.62,2024-01-25T12:50:52,Durango,expenses,appliances,-76.34,-57304.18
buyer_8,Patxi,Urrutia,1979-04-04,93497737T,patxi.urrutia@hyperapp.online,421269,ES88209508878651879704,1800.62,2024-01-27T15:30:14,Durango,expenses,gifts,-89.71,-57393.89
buyer_8,Patxi,Urrutia,1979-04-04,93497737T,patxi.urrutia@hyperapp.online,421269,ES88209508878651879704,1800.62,2024-01-29T10:09:37,Durango,expenses,cash,-100.0,-57493.89
buyer_8,Patxi,Urrutia,1979-04-04,93497737T,patxi.urrutia@hyperapp.online,421269,ES88209508878651879704,1800.62,2024-01-31T19:59:28,Durango,expenses,cash,-100.0,-57593.89
buyer_8,Patxi,Urrutia,1979-04-04,93497737T,patxi.urrutia@hyperapp.online,421269,ES88209508878651879704,1800.62,2024-02-01T13:22:48,Durango,incomes,salary,3374.74,-54219.15
buyer_8,Patxi,Urrutia,1979-04-04,93497737T,patxi.urrutia@hyperapp.online,421269,ES88209508878651879704,1800.62,2024-02-01T15:07:36,Durango,expenses,food,-64.57,-54283.72
buyer_8,Patxi,Urrutia,1979-04-04,93497737T,patxi.urrutia@hyperapp.online,421269,ES88209508878651879704,1800.62,2024-02-01T18:22:42,Durango,expenses,leisure,-71.76,-54355.48
buyer_8,Patxi,Urrutia,1979-04-04,93497737T,patxi.urrutia@hyperapp.online,421269,ES88209508878651879704,1800.62,2024-02-01T14:57:40,Durango,expenses,repairs,-44.2,-54399.68
buyer_8,Patxi,Urrutia,1979-04-04,93497737T,patxi.urrutia@hyperapp.online,421269,ES88209508878651879704,1800.62,2024-02-02T20:11:28,Durango,expenses,leisure,-39.2,-54438.88
buyer_8,Patxi,Urrutia,1979-04-04,93497737T,patxi.urrutia@hyperapp.online,421269,ES88209508878651879704,1800.62,2024-02-03T08:35:43,Durango,expenses,cash,-100.0,-54538.88
buyer_8,Patxi,Urrutia,1979-04-04,93497737T,patxi.urrutia@hyperapp.online,421269,ES88209508878651879704,1800.62,2024-02-05T00:14:29,Durango,expenses,mortgage,-1455.68,-55994.56
buyer_8,Patxi,Urrutia,1979-04-04,93497737T,patxi.urrutia@hyperapp.online,421269,ES88209508878651879704,1800.62,2024-02-05T09:50:28,Durango,expenses,internet,-77.96,-56072.52
buyer_8,Patxi,Urrutia,1979-04-04,93497737T,patxi.urrutia@hyperapp.online,421269,ES88209508878651879704,1800.62,2024-02-05T17:00:19,Durango,expenses,leisure,-52.72,-56125.24
buyer_8,Patxi,Urrutia,1979-04-04,93497737T,patxi.urrutia@hyperapp.online,421269,ES88209508878651879704,1800.62,2024-02-06T10:00:55,Durango,expenses,electricity,-89.23,-56214.47
buyer_8,Patxi,Urrutia,1979-04-04,93497737T,patxi.urrutia@hyperapp.online,421269,ES88209508878651879704,1800.62,2024-02-06T14:52:43,Durango,expenses,phone,-71.6,-56286.07
buyer_8,Patxi,Urrutia,1979-04-04,93497737T,patxi.urrutia@hyperapp.online,421269,ES88209508878651879704,1800.62,2024-02-07T19:48:36,Durango,expenses,gas,-104.52,-56390.59
buyer_8,Patxi,Urrutia,1979-04-04,93497737T,patxi.urrutia@hyperapp.online,421269,ES88209508878651879704,1800.62,2024-02-08T13:47:51,Durango,expenses,cash,-100.0,-56490.59
buyer_8,Patxi,Urrutia,1979-04-04,93497737T,patxi.urrutia@hyperapp.online,421269,ES88209508878651879704,1800.62,2024-02-10T00:44:08,Durango,expenses,repairs,-245.04,-56735.63
buyer_8,Patxi,Urrutia,1979-04-04,93497737T,patxi.urrutia@hyperapp.online,421269,ES88209508878651879704,1800.62,2024-02-11T14:17:03,Durango,expenses,transport,-63.5,-56799.13
buyer_8,Patxi,Urrutia,1979-04-04,93497737T,patxi.urrutia@hyperapp.online,421269,ES88209508878651879704,1800.62,2024-02-11T17:04:22,Durango,expenses,leisure,-36.58,-56835.71
buyer_8,Patxi,Urrutia,1979-04-04,93497737T,patxi.urrutia@hyperapp.online,421269,ES88209508878651879704,1800.62,2024-02-15T16:19:27,Durango,expenses,cash,-100.0,-56935.71
buyer_8,Patxi,Urrutia,1979-04-04,93497737T,patxi.urrutia@hyperapp.online,421269,ES88209508878651879704,1800.62,2024-02-16T08:50:52,Durango,expenses,leisure,-46.77,-56982.48
buyer_8,Patxi,Urrutia,1979-04-04,93497737T,patxi.urrutia@hyperapp.online,421269,ES88209508878651879704,1800.62,2024-02-17T10:07:58,Durango,expenses,cash,-100.0,-57082.48
buyer_8,Patxi,Urrutia,1979-04-04,93497737T,patxi.urrutia@hyperapp.online,421269,ES88209508878651879704,1800.62,2024-02-23T09:55:32,Durango,expenses,leisure,-72.63,-57155.11
buyer_8,Patxi,Urrutia,1979-04-04,93497737T,patxi.urrutia@hyperapp.online,421269,ES88209508878651879704,1800.62,2024-02-23T13:40:02,Durango,expenses,cash,-100.0,-57255.11
buyer_8,Patxi,Urrutia,1979-04-04,93497737T,patxi.urrutia@hyperapp.online,421269,ES88209508878651879704,1800.62,2024-02-26T17:30:22,Durango,expenses,leisure,-25.12,-57280.23
buyer_8,Patxi,Urrutia,1979-04-04,93497737T,patxi.urrutia@hyperapp.online,421269,ES88209508878651879704,1800.62,2024-02-28T15:43:51,Durango,expenses,food,-79.16,-57359.39
buyer_8,Patxi,Urrutia,1979-04-04,93497737T,patxi.urrutia@hyperapp.online,421269,ES88209508878651879704,1800.62,2024-02-28T08:15:32,Durango,expenses,transport,-52.21,-57411.6
buyer_8,Patxi,Urrutia,1979-04-04,93497737T,patxi.urrutia@hyperapp.online,421269,ES88209508878651879704,1800.62,2024-02-29T19:54:20,Durango,expenses,transport,-66.79,-57478.39
buyer_8,Patxi,Urrutia,1979-04-04,93497737T,patxi.urrutia@hyperapp.online,421269,ES88209508878651879704,1800.62,2024-02-29T06:18:57,Durango,expenses,gifts,-576.61,-58055.0
buyer_8,Patxi,Urrutia,1979-04-04,93497737T,patxi.urrutia@hyperapp.online,421269,ES88209508878651879704,1800.62,2024-03-01T13:08:49,Durango,incomes,salary,3374.74,-54680.26
buyer_8,Patxi,Urrutia,1979-04-04,93497737T,patxi.urrutia@hyperapp.online,421269,ES88209508878651879704,1800.62,2024-03-01T13:08:49,Durango,incomes,extra_income,514.84,-54165.42
buyer_8,Patxi,Urrutia,1979-04-04,93497737T,patxi.urrutia@hyperapp.online,421269,ES88209508878651879704,1800.62,2024-03-01T21:10:06,Durango,expenses,leisure,-67.87,-54233.29
buyer_8,Patxi,Urrutia,1979-04-04,93497737T,patxi.urrutia@hyperapp.online,421269,ES88209508878651879704,1800.62,2024-03-01T11:31:45,Durango,expenses,cash,-100.0,-54333.29
buyer_8,Patxi,Urrutia,1979-04-04,93497737T,patxi.urrutia@hyperapp.online,421269,ES88209508878651879704,1800.62,2024-03-05T17:20:13,Durango,expenses,mortgage,-1455.68,-55788.97
buyer_8,Patxi,Urrutia,1979-04-04,93497737T,patxi.urrutia@hyperapp.online,421269,ES88209508878651879704,1800.62,2024-03-05T23:32:47,Durango,expenses,water,-58.67,-55847.64
buyer_8,Patxi,Urrutia,1979-04-04,93497737T,patxi.urrutia@hyperapp.online,421269,ES88209508878651879704,1800.62,2024-03-05T10:28:22,Durango,expenses,gas,-177.29,-56024.93
buyer_8,Patxi,Urrutia,1979-04-04,93497737T,patxi.urrutia@hyperapp.online,421269,ES88209508878651879704,1800.62,2024-03-06T01:19:55,Durango,expenses,education,-70.62,-56095.55
buyer_8,Patxi,Urrutia,1979-04-04,93497737T,patxi.urrutia@hyperapp.online,421269,ES88209508878651879704,1800.62,2024-03-07T08:27:20,Durango,expenses,internet,-77.96,-56173.51
buyer_8,Patxi,Urrutia,1979-04-04,93497737T,patxi.urrutia@hyperapp.online,421269,ES88209508878651879704,1800.62,2024-03-08T14:40:56,Durango,expenses,gas,-138.03,-56311.54
buyer_8,Patxi,Urrutia,1979-04-04,93497737T,patxi.urrutia@hyperapp.online,421269,ES88209508878651879704,1800.62,2024-03-08T15:15:55,Durango,expenses,phone,-76.43,-56387.97
buyer_8,Patxi,Urrutia,1979-04-04,93497737T,patxi.urrutia@hyperapp.online,421269,ES88209508878651879704,1800.62,2024-03-08T16:52:49,Durango,expenses,food,-113.9,-56501.87
buyer_8,Patxi,Urrutia,1979-04-04,93497737T,patxi.urrutia@hyperapp.online,421269,ES88209508878651879704,1800.62,2024-03-08T17:10:20,Durango,expenses,transport,-54.6,-56556.47
buyer_8,Patxi,Urrutia,1979-04-04,93497737T,patxi.urrutia@hyperapp.online,421269,ES88209508878651879704,1800.62,2024-03-08T20:43:24,Durango,expenses,cash,-100.0,-56656.47
buyer_8,Patxi,Urrutia,1979-04-04,93497737T,patxi.urrutia@hyperapp.online,421269,ES88209508878651879704,1800.62,2024-03-09T02:47:36,Durango,expenses,cash,-100.0,-56756.47
buyer_8,Patxi,Urrutia,1979-04-04,93497737T,patxi.urrutia@hyperapp.online,421269,ES88209508878651879704,1800.62,2024-03-12T11:07:33,Durango,expenses,food,-117.39,-56873.86
buyer_8,Patxi,Urrutia,1979-04-04,93497737T,patxi.urrutia@hyperapp.online,421269,ES88209508878651879704,1800.62,2024-03-15T07:20:02,Durango,expenses,food,-121.72,-56995.58
buyer_8,Patxi,Urrutia,1979-04-04,93497737T,patxi.urrutia@hyperapp.online,421269,ES88209508878651879704,1800.62,2024-03-15T10:57:41,Durango,expenses,transport,-71.87,-57067.45
buyer_8,Patxi,Urrutia,1979-04-04,93497737T,patxi.urrutia@hyperapp.online,421269,ES88209508878651879704,1800.62,2024-03-18T08:22:11,Durango,expenses,food,-91.52,-57158.97
buyer_8,Patxi,Urrutia,1979-04-04,93497737T,patxi.urrutia@hyperapp.online,421269,ES88209508878651879704,1800.62,2024-03-18T07:10:58,Durango,expenses,repairs,-104.61,-57263.58
buyer_8,Patxi,Urrutia,1979-04-04,93497737T,patxi.urrutia@hyperapp.online,421269,ES88209508878651879704,1800.62,2024-03-21T16:29:03,Durango,expenses,food,-103.46,-57367.04
buyer_8,Patxi,Urrutia,1979-04-04,93497737T,patxi.urrutia@hyperapp.online,421269,ES88209508878651879704,1800.62,2024-03-21T23:41:32,Durango,expenses,repairs,-169.77,-57536.81
buyer_8,Patxi,Urrutia,1979-04-04,93497737T,patxi.urrutia@hyperapp.online,421269,ES88209508878651879704,1800.62,2024-03-22T08:18:49,Durango,expenses,food,-118.81,-57655.62
buyer_8,Patxi,Urrutia,1979-04-04,93497737T,patxi.urrutia@hyperapp.online,421269,ES88209508878651879704,1800.62,2024-03-23T14:01:30,Durango,expenses,food,-99.51,-57755.13
buyer_8,Patxi,Urrutia,1979-04-04,93497737T,patxi.urrutia@hyperapp.online,421269,ES88209508878651879704,1800.62,2024-03-23T10:19:33,Durango,expenses,gifts,-161.35,-57916.48
buyer_8,Patxi,Urrutia,1979-04-04,93497737T,patxi.urrutia@hyperapp.online,421269,ES88209508878651879704,1800.62,2024-03-24T17:44:06,Durango,expenses,leisure,-78.81,-57995.29
buyer_8,Patxi,Urrutia,1979-04-04,93497737T,patxi.urrutia@hyperapp.online,421269,ES88209508878651879704,1800.62,2024-03-24T04:23:12,Durango,expenses,clothing,-84.08,-58079.37
buyer_8,Patxi,Urrutia,1979-04-04,93497737T,patxi.urrutia@hyperapp.online,421269,ES88209508878651879704,1800.62,2024-03-27T13:47:52,Durango,expenses,leisure,-45.34,-58124.71
buyer_8,Patxi,Urrutia,1979-04-04,93497737T,patxi.urrutia@hyperapp.online,421269,ES88209508878651879704,1800.62,2024-03-27T13:33:28,Durango,expenses,cash,-100.0,-58224.71
buyer_8,Patxi,Urrutia,1979-04-04,93497737T,patxi.urrutia@hyperapp.online,421269,ES88209508878651879704,1800.62,2024-03-29T11:15:08,Durango,expenses,repairs,-161.68,-58386.39
buyer_8,Patxi,Urrutia,1979-04-04,93497737T,patxi.urrutia@hyperapp.online,421269,ES88209508878651879704,1800.62,2024-03-30T14:18:57,Durango,expenses,food,-90.8,-58477.19
buyer_8,Patxi,Urrutia,1979-04-04,93497737T,patxi.urrutia@hyperapp.online,421269,ES88209508878651879704,1800.62,2024-04-01T20:09:52,Durango,incomes,salary,3374.74,-55102.45
buyer_8,Patxi,Urrutia,1979-04-04,93497737T,patxi.urrutia@hyperapp.online,421269,ES88209508878651879704,1800.62,2024-04-01T13:43:56,Durango,expenses,cash,-100.0,-55202.45
buyer_8,Patxi,Urrutia,1979-04-04,93497737T,patxi.urrutia@hyperapp.online,421269,ES88209508878651879704,1800.62,2024-04-03T19:41:14,Durango,expenses,gifts,-641.64,-55844.09
buyer_8,Patxi,Urrutia,1979-04-04,93497737T,patxi.urrutia@hyperapp.online,421269,ES88209508878651879704,1800.62,2024-04-04T09:55:28,Durango,expenses,clothing,-86.8,-55930.89
buyer_8,Patxi,Urrutia,1979-04-04,93497737T,patxi.urrutia@hyperapp.online,421269,ES88209508878651879704,1800.62,2024-04-04T15:50:45,Durango,expenses,cash,-100.0,-56030.89
buyer_8,Patxi,Urrutia,1979-04-04,93497737T,patxi.urrutia@hyperapp.online,421269,ES88209508878651879704,1800.62,2024-04-05T08:13:21,Durango,expenses,mortgage,-1455.68,-57486.57
buyer_8,Patxi,Urrutia,1979-04-04,93497737T,patxi.urrutia@hyperapp.online,421269,ES88209508878651879704,1800.62,2024-04-05T10:16:51,Durango,expenses,electricity,-69.71,-57556.28
buyer_8,Patxi,Urrutia,1979-04-04,93497737T,patxi.urrutia@hyperapp.online,421269,ES88209508878651879704,1800.62,2024-04-05T08:21:07,Durango,expenses,repairs,-255.86,-57812.14
buyer_8,Patxi,Urrutia,1979-04-04,93497737T,patxi.urrutia@hyperapp.online,421269,ES88209508878651879704,1800.62,2024-04-06T18:26:24,Durango,expenses,water,-43.53,-57855.67
buyer_8,Patxi,Urrutia,1979-04-04,93497737T,patxi.urrutia@hyperapp.online,421269,ES88209508878651879704,1800.62,2024-04-06T13:12:47,Durango,expenses,phone,-67.76,-57923.43
buyer_8,Patxi,Urrutia,1979-04-04,93497737T,patxi.urrutia@hyperapp.online,421269,ES88209508878651879704,1800.62,2024-04-07T16:37:55,Durango,expenses,electricity,-103.07,-58026.5
buyer_8,Patxi,Urrutia,1979-04-04,93497737T,patxi.urrutia@hyperapp.online,421269,ES88209508878651879704,1800.62,2024-04-07T18:33:48,Durango,expenses,leisure,-77.04,-58103.54
buyer_8,Patxi,Urrutia,1979-04-04,93497737T,patxi.urrutia@hyperapp.online,421269,ES88209508878651879704,1800.62,2024-04-08T19:59:50,Durango,expenses,water,-48.29,-58151.83
buyer_8,Patxi,Urrutia,1979-04-04,93497737T,patxi.urrutia@hyperapp.online,421269,ES88209508878651879704,1800.62,2024-04-08T16:36:37,Durango,expenses,electricity,-57.63,-58209.46
buyer_8,Patxi,Urrutia,1979-04-04,93497737T,patxi.urrutia@hyperapp.online,421269,ES88209508878651879704,1800.62,2024-04-08T17:19:01,Durango,expenses,phone,-77.55,-58287.01
buyer_8,Patxi,Urrutia,1979-04-04,93497737T,patxi.urrutia@hyperapp.online,421269,ES88209508878651879704,1800.62,2024-04-08T10:34:23,Durango,expenses,leisure,-18.79,-58305.8
buyer_8,Patxi,Urrutia,1979-04-04,93497737T,patxi.urrutia@hyperapp.online,421269,ES88209508878651879704,1800.62,2024-04-11T16:12:05,Durango,expenses,food,-83.96,-58389.76
buyer_8,Patxi,Urrutia,1979-04-04,93497737T,patxi.urrutia@hyperapp.online,421269,ES88209508878651879704,1800.62,2024-04-13T00:46:59,Durango,expenses,transport,-71.03,-58460.79
buyer_8,Patxi,Urrutia,1979-04-04,93497737T,patxi.urrutia@hyperapp.online,421269,ES88209508878651879704,1800.62,2024-04-13T10:34:48,Durango,expenses,cash,-100.0,-58560.79
buyer_8,Patxi,Urrutia,1979-04-04,93497737T,patxi.urrutia@hyperapp.online,421269,ES88209508878651879704,1800.62,2024-04-13T16:16:23,Durango,expenses,gifts,-370.9,-58931.69
buyer_8,Patxi,Urrutia,1979-04-04,93497737T,patxi.urrutia@hyperapp.online,421269,ES88209508878651879704,1800.62,2024-04-14T08:44:30,Durango,expenses,food,-89.93,-59021.62
buyer_8,Patxi,Urrutia,1979-04-04,93497737T,patxi.urrutia@hyperapp.online,421269,ES88209508878651879704,1800.62,2024-04-16T03:36:57,Durango,expenses,appliances,-310.43,-59332.05
buyer_8,Patxi,Urrutia,1979-04-04,93497737T,patxi.urrutia@hyperapp.online,421269,ES88209508878651879704,1800.62,2024-04-17T20:28:13,Durango,expenses,repairs,-58.17,-59390.22
buyer_8,Patxi,Urrutia,1979-04-04,93497737T,patxi.urrutia@hyperapp.online,421269,ES88209508878651879704,1800.62,2024-04-18T20:43:15,Durango,expenses,transport,-48.73,-59438.95
buyer_8,Patxi,Urrutia,1979-04-04,93497737T,patxi.urrutia@hyperapp.online,421269,ES88209508878651879704,1800.62,2024-04-18T14:45:24,Durango,expenses,gifts,-642.72,-60081.67
buyer_8,Patxi,Urrutia,1979-04-04,93497737T,patxi.urrutia@hyperapp.online,421269,ES88209508878651879704,1800.62,2024-04-19T13:42:03,Durango,expenses,transport,-56.84,-60138.51
buyer_8,Patxi,Urrutia,1979-04-04,93497737T,patxi.urrutia@hyperapp.online,421269,ES88209508878651879704,1800.62,2024-04-19T03:07:05,Durango,expenses,repairs,-302.46,-60440.97
buyer_8,Patxi,Urrutia,1979-04-04,93497737T,patxi.urrutia@hyperapp.online,421269,ES88209508878651879704,1800.62,2024-04-20T08:48:22,Durango,expenses,food,-105.41,-60546.38
buyer_8,Patxi,Urrutia,1979-04-04,93497737T,patxi.urrutia@hyperapp.online,421269,ES88209508878651879704,1800.62,2024-04-23T10:16:27,Durango,expenses,clothing,-83.16,-60629.54
buyer_8,Patxi,Urrutia,1979-04-04,93497737T,patxi.urrutia@hyperapp.online,421269,ES88209508878651879704,1800.62,2024-04-24T14:39:52,Durango,expenses,repairs,-289.67,-60919.21
buyer_8,Patxi,Urrutia,1979-04-04,93497737T,patxi.urrutia@hyperapp.online,421269,ES88209508878651879704,1800.62,2024-04-25T02:04:02,Durango,expenses,leisure,-25.56,-60944.77
buyer_8,Patxi,Urrutia,1979-04-04,93497737T,patxi.urrutia@hyperapp.online,421269,ES88209508878651879704,1800.62,2024-04-25T09:57:21,Durango,expenses,education,-67.88,-61012.65
buyer_8,Patxi,Urrutia,1979-04-04,93497737T,patxi.urrutia@hyperapp.online,421269,ES88209508878651879704,1800.62,2024-04-28T13:21:30,Durango,expenses,cash,-100.0,-61112.65
buyer_8,Patxi,Urrutia,1979-04-04,93497737T,patxi.urrutia@hyperapp.online,421269,ES88209508878651879704,1800.62,2024-05-01T11:03:47,Durango,incomes,salary,3374.74,-57737.91
buyer_8,Patxi,Urrutia,1979-04-04,93497737T,patxi.urrutia@hyperapp.online,421269,ES88209508878651879704,1800.62,2024-05-01T17:40:44,Durango,expenses,healthcare,-93.33,-57831.24
buyer_8,Patxi,Urrutia,1979-04-04,93497737T,patxi.urrutia@hyperapp.online,421269,ES88209508878651879704,1800.62,2024-05-02T20:26:17,Durango,expenses,cash,-100.0,-57931.24
buyer_8,Patxi,Urrutia,1979-04-04,93497737T,patxi.urrutia@hyperapp.online,421269,ES88209508878651879704,1800.62,2024-05-03T12:46:54,Durango,expenses,food,-119.18,-58050.42
buyer_8,Patxi,Urrutia,1979-04-04,93497737T,patxi.urrutia@hyperapp.online,421269,ES88209508878651879704,1800.62,2024-05-05T18:14:33,Durango,expenses,mortgage,-1455.68,-59506.1
buyer_8,Patxi,Urrutia,1979-04-04,93497737T,patxi.urrutia@hyperapp.online,421269,ES88209508878651879704,1800.62,2024-05-06T13:46:57,Durango,expenses,water,-68.89,-59574.99
buyer_8,Patxi,Urrutia,1979-04-04,93497737T,patxi.urrutia@hyperapp.online,421269,ES88209508878651879704,1800.62,2024-05-07T11:18:24,Durango,expenses,water,-56.84,-59631.83
buyer_8,Patxi,Urrutia,1979-04-04,93497737T,patxi.urrutia@hyperapp.online,421269,ES88209508878651879704,1800.62,2024-05-07T13:10:19,Durango,expenses,electricity,-57.26,-59689.09
buyer_8,Patxi,Urrutia,1979-04-04,93497737T,patxi.urrutia@hyperapp.online,421269,ES88209508878651879704,1800.62,2024-05-07T11:13:45,Durango,expenses,gas,-134.56,-59823.65
buyer_8,Patxi,Urrutia,1979-04-04,93497737T,patxi.urrutia@hyperapp.online,421269,ES88209508878651879704,1800.62,2024-05-08T08:40:41,Durango,expenses,internet,-77.96,-59901.61
buyer_8,Patxi,Urrutia,1979-04-04,93497737T,patxi.urrutia@hyperapp.online,421269,ES88209508878651879704,1800.62,2024-05-10T18:01:07,Durango,expenses,transport,-48.2,-59949.81
buyer_8,Patxi,Urrutia,1979-04-04,93497737T,patxi.urrutia@hyperapp.online,421269,ES88209508878651879704,1800.62,2024-05-10T08:21:11,Durango,expenses,cash,-100.0,-60049.81
buyer_8,Patxi,Urrutia,1979-04-04,93497737T,patxi.urrutia@hyperapp.online,421269,ES88209508878651879704,1800.62,2024-05-17T08:19:39,Durango,expenses,food,-79.41,-60129.22
buyer_8,Patxi,Urrutia,1979-04-04,93497737T,patxi.urrutia@hyperapp.online,421269,ES88209508878651879704,1800.62,2024-05-17T16:29:45,Durango,expenses,transport,-51.5,-60180.72
buyer_8,Patxi,Urrutia,1979-04-04,93497737T,patxi.urrutia@hyperapp.online,421269,ES88209508878651879704,1800.62,2024-05-17T08:16:14,Durango,expenses,clothing,-109.17,-60289.89
buyer_8,Patxi,Urrutia,1979-04-04,93497737T,patxi.urrutia@hyperapp.online,421269,ES88209508878651879704,1800.62,2024-05-18T08:08:40,Durango,expenses,clothing,-99.45,-60389.34
buyer_8,Patxi,Urrutia,1979-04-04,93497737T,patxi.urrutia@hyperapp.online,421269,ES88209508878651879704,1800.62,2024-05-19T17:02:06,Durango,expenses,leisure,-40.36,-60429.7
buyer_8,Patxi,Urrutia,1979-04-04,93497737T,patxi.urrutia@hyperapp.online,421269,ES88209508878651879704,1800.62,2024-05-19T14:47:27,Durango,expenses,healthcare,-85.73,-60515.43
buyer_8,Patxi,Urrutia,1979-04-04,93497737T,patxi.urrutia@hyperapp.online,421269,ES88209508878651879704,1800.62,2024-05-21T20:01:00,Durango,expenses,transport,-78.26,-60593.69
buyer_8,Patxi,Urrutia,1979-04-04,93497737T,patxi.urrutia@hyperapp.online,421269,ES88209508878651879704,1800.62,2024-05-21T16:39:07,Durango,expenses,leisure,-18.15,-60611.84
buyer_8,Patxi,Urrutia,1979-04-04,93497737T,patxi.urrutia@hyperapp.online,421269,ES88209508878651879704,1800.62,2024-05-22T02:31:56,Durango,expenses,food,-70.24,-60682.08
buyer_8,Patxi,Urrutia,1979-04-04,93497737T,patxi.urrutia@hyperapp.online,421269,ES88209508878651879704,1800.62,2024-05-23T19:46:48,Durango,expenses,transport,-52.24,-60734.32
buyer_8,Patxi,Urrutia,1979-04-04,93497737T,patxi.urrutia@hyperapp.online,421269,ES88209508878651879704,1800.62,2024-05-23T19:29:16,Durango,expenses,clothing,-55.09,-60789.41
buyer_8,Patxi,Urrutia,1979-04-04,93497737T,patxi.urrutia@hyperapp.online,421269,ES88209508878651879704,1800.62,2024-05-24T20:49:13,Durango,expenses,cash,-100.0,-60889.41
buyer_8,Patxi,Urrutia,1979-04-04,93497737T,patxi.urrutia@hyperapp.online,421269,ES88209508878651879704,1800.62,2024-05-28T12:54:32,Durango,expenses,transport,-40.56,-60929.97
buyer_8,Patxi,Urrutia,1979-04-04,93497737T,patxi.urrutia@hyperapp.online,421269,ES88209508878651879704,1800.62,2024-05-28T18:46:09,Durango,expenses,clothing,-80.75,-61010.72
buyer_8,Patxi,Urrutia,1979-04-04,93497737T,patxi.urrutia@hyperapp.online,421269,ES88209508878651879704,1800.62,2024-05-28T14:51:02,Durango,expenses,cash,-100.0,-61110.72
buyer_8,Patxi,Urrutia,1979-04-04,93497737T,patxi.urrutia@hyperapp.online,421269,ES88209508878651879704,1800.62,2024-05-29T14:40:43,Durango,expenses,transport,-82.17,-61192.89
buyer_8,Patxi,Urrutia,1979-04-04,93497737T,patxi.urrutia@hyperapp.online,421269,ES88209508878651879704,1800.62,2024-05-29T08:36:32,Durango,expenses,education,-46.16,-61239.05
buyer_8,Patxi,Urrutia,1979-04-04,93497737T,patxi.urrutia@hyperapp.online,421269,ES88209508878651879704,1800.62,2024-05-30T16:56:36,Durango,expenses,transport,-48.2,-61287.25
buyer_8,Patxi,Urrutia,1979-04-04,93497737T,patxi.urrutia@hyperapp.online,421269,ES88209508878651879704,1800.62,2024-06-01T07:32:11,Durango,incomes,salary,3374.74,-57912.51
buyer_8,Patxi,Urrutia,1979-04-04,93497737T,patxi.urrutia@hyperapp.online,421269,ES88209508878651879704,1800.62,2024-06-01T07:32:11,Durango,incomes,extra_income,514.84,-57397.67
buyer_8,Patxi,Urrutia,1979-04-04,93497737T,patxi.urrutia@hyperapp.online,421269,ES88209508878651879704,1800.62,2024-06-01T07:32:11,Durango,incomes,salary_bonus,2455.75,-54941.92
buyer_8,Patxi,Urrutia,1979-04-04,93497737T,patxi.urrutia@hyperapp.online,421269,ES88209508878651879704,1800.62,2024-06-01T10:44:28,Durango,expenses,cash,-100.0,-55041.92
buyer_8,Patxi,Urrutia,1979-04-04,93497737T,patxi.urrutia@hyperapp.online,421269,ES88209508878651879704,1800.62,2024-06-01T12:43:21,Durango,expenses,appliances,-183.66,-55225.58
buyer_8,Patxi,Urrutia,1979-04-04,93497737T,patxi.urrutia@hyperapp.online,421269,ES88209508878651879704,1800.62,2024-06-01T18:50:51,Durango,expenses,repairs,-203.63,-55429.21
buyer_8,Patxi,Urrutia,1979-04-04,93497737T,patxi.urrutia@hyperapp.online,421269,ES88209508878651879704,1800.62,2024-06-01T12:43:29,Durango,expenses,gifts,-533.99,-55963.2
buyer_8,Patxi,Urrutia,1979-04-04,93497737T,patxi.urrutia@hyperapp.online,421269,ES88209508878651879704,1800.62,2024-06-03T18:16:48,Durango,expenses,food,-76.35,-56039.55
buyer_8,Patxi,Urrutia,1979-04-04,93497737T,patxi.urrutia@hyperapp.online,421269,ES88209508878651879704,1800.62,2024-06-03T09:10:00,Durango,expenses,cash,-100.0,-56139.55
buyer_8,Patxi,Urrutia,1979-04-04,93497737T,patxi.urrutia@hyperapp.online,421269,ES88209508878651879704,1800.62,2024-06-05T16:12:53,Durango,expenses,mortgage,-1455.68,-57595.23
buyer_8,Patxi,Urrutia,1979-04-04,93497737T,patxi.urrutia@hyperapp.online,421269,ES88209508878651879704,1800.62,2024-06-05T06:30:27,Durango,expenses,leisure,-73.47,-57668.7
buyer_8,Patxi,Urrutia,1979-04-04,93497737T,patxi.urrutia@hyperapp.online,421269,ES88209508878651879704,1800.62,2024-06-06T19:47:05,Durango,expenses,taxes,-2698.57,-60367.27
buyer_8,Patxi,Urrutia,1979-04-04,93497737T,patxi.urrutia@hyperapp.online,421269,ES88209508878651879704,1800.62,2024-06-06T08:00:23,Durango,expenses,insurance,-985.83,-61353.1
buyer_8,Patxi,Urrutia,1979-04-04,93497737T,patxi.urrutia@hyperapp.online,421269,ES88209508878651879704,1800.62,2024-06-06T09:42:42,Durango,expenses,water,-37.21,-61390.31
buyer_8,Patxi,Urrutia,1979-04-04,93497737T,patxi.urrutia@hyperapp.online,421269,ES88209508878651879704,1800.62,2024-06-06T03:37:14,Durango,expenses,leisure,-52.42,-61442.73
buyer_8,Patxi,Urrutia,1979-04-04,93497737T,patxi.urrutia@hyperapp.online,421269,ES88209508878651879704,1800.62,2024-06-07T14:04:54,Durango,expenses,gas,-158.14,-61600.87
buyer_8,Patxi,Urrutia,1979-04-04,93497737T,patxi.urrutia@hyperapp.online,421269,ES88209508878651879704,1800.62,2024-06-08T10:57:20,Durango,expenses,healthcare,-188.09,-61788.96
buyer_8,Patxi,Urrutia,1979-04-04,93497737T,patxi.urrutia@hyperapp.online,421269,ES88209508878651879704,1800.62,2024-06-09T18:34:34,Durango,expenses,leisure,-28.78,-61817.74
buyer_8,Patxi,Urrutia,1979-04-04,93497737T,patxi.urrutia@hyperapp.online,421269,ES88209508878651879704,1800.62,2024-06-09T16:30:57,Durango,expenses,cash,-100.0,-61917.74
buyer_8,Patxi,Urrutia,1979-04-04,93497737T,patxi.urrutia@hyperapp.online,421269,ES88209508878651879704,1800.62,2024-06-10T08:56:28,Durango,expenses,transport,-87.86,-62005.6
buyer_8,Patxi,Urrutia,1979-04-04,93497737T,patxi.urrutia@hyperapp.online,421269,ES88209508878651879704,1800.62,2024-06-11T01:44:03,Durango,expenses,repairs,-49.94,-62055.54
buyer_8,Patxi,Urrutia,1979-04-04,93497737T,patxi.urrutia@hyperapp.online,421269,ES88209508878651879704,1800.62,2024-06-12T13:28:46,Durango,expenses,leisure,-51.52,-62107.06
buyer_8,Patxi,Urrutia,1979-04-04,93497737T,patxi.urrutia@hyperapp.online,421269,ES88209508878651879704,1800.62,2024-06-13T20:29:55,Durango,expenses,education,-68.09,-62175.15
buyer_8,Patxi,Urrutia,1979-04-04,93497737T,patxi.urrutia@hyperapp.online,421269,ES88209508878651879704,1800.62,2024-06-14T04:11:28,Durango,expenses,cash,-100.0,-62275.15
buyer_8,Patxi,Urrutia,1979-04-04,93497737T,patxi.urrutia@hyperapp.online,421269,ES88209508878651879704,1800.62,2024-06-15T08:15:34,Durango,expenses,leisure,-73.67,-62348.82
buyer_8,Patxi,Urrutia,1979-04-04,93497737T,patxi.urrutia@hyperapp.online,421269,ES88209508878651879704,1800.62,2024-06-18T09:06:40,Durango,expenses,healthcare,-171.5,-62520.32
buyer_8,Patxi,Urrutia,1979-04-04,93497737T,patxi.urrutia@hyperapp.online,421269,ES88209508878651879704,1800.62,2024-06-19T10:49:34,Durango,expenses,transport,-58.28,-62578.6
buyer_8,Patxi,Urrutia,1979-04-04,93497737T,patxi.urrutia@hyperapp.online,421269,ES88209508878651879704,1800.62,2024-06-19T09:20:18,Durango,expenses,education,-43.6,-62622.2
buyer_8,Patxi,Urrutia,1979-04-04,93497737T,patxi.urrutia@hyperapp.online,421269,ES88209508878651879704,1800.62,2024-06-21T12:32:10,Durango,expenses,repairs,-158.01,-62780.21
buyer_8,Patxi,Urrutia,1979-04-04,93497737T,patxi.urrutia@hyperapp.online,421269,ES88209508878651879704,1800.62,2024-06-21T09:06:16,Durango,expenses,gifts,-288.91,-63069.12
buyer_8,Patxi,Urrutia,1979-04-04,93497737T,patxi.urrutia@hyperapp.online,421269,ES88209508878651879704,1800.62,2024-06-22T08:48:22,Durango,expenses,clothing,-120.73,-63189.85
buyer_8,Patxi,Urrutia,1979-04-04,93497737T,patxi.urrutia@hyperapp.online,421269,ES88209508878651879704,1800.62,2024-06-23T18:29:51,Durango,expenses,cash,-100.0,-63289.85
buyer_8,Patxi,Urrutia,1979-04-04,93497737T,patxi.urrutia@hyperapp.online,421269,ES88209508878651879704,1800.62,2024-06-23T16:46:00,Durango,expenses,repairs,-49.88,-63339.73
buyer_8,Patxi,Urrutia,1979-04-04,93497737T,patxi.urrutia@hyperapp.online,421269,ES88209508878651879704,1800.62,2024-06-24T22:04:43,Durango,expenses,healthcare,-97.32,-63437.05
buyer_8,Patxi,Urrutia,1979-04-04,93497737T,patxi.urrutia@hyperapp.online,421269,ES88209508878651879704,1800.62,2024-06-25T12:57:39,Durango,expenses,appliances,-156.46,-63593.51
buyer_8,Patxi,Urrutia,1979-04-04,93497737T,patxi.urrutia@hyperapp.online,421269,ES88209508878651879704,1800.62,2024-06-27T16:29:43,Durango,expenses,education,-64.33,-63657.84
buyer_8,Patxi,Urrutia,1979-04-04,93497737T,patxi.urrutia@hyperapp.online,421269,ES88209508878651879704,1800.62,2024-06-28T09:44:32,Durango,expenses,travel,-463.02,-64120.86
buyer_8,Patxi,Urrutia,1979-04-04,93497737T,patxi.urrutia@hyperapp.online,421269,ES88209508878651879704,1800.62,2024-06-29T20:13:34,Durango,expenses,cash,-100.0,-64220.86
buyer_8,Patxi,Urrutia,1979-04-04,93497737T,patxi.urrutia@hyperapp.online,421269,ES88209508878651879704,1800.62,2024-07-01T20:47:11,Durango,incomes,salary,3374.74,-60846.12
buyer_8,Patxi,Urrutia,1979-04-04,93497737T,patxi.urrutia@hyperapp.online,421269,ES88209508878651879704,1800.62,2024-07-01T13:46:24,Durango,expenses,food,-80.4,-60926.52
buyer_8,Patxi,Urrutia,1979-04-04,93497737T,patxi.urrutia@hyperapp.online,421269,ES88209508878651879704,1800.62,2024-07-01T18:14:05,Durango,expenses,transport,-46.42,-60972.94
buyer_8,Patxi,Urrutia,1979-04-04,93497737T,patxi.urrutia@hyperapp.online,421269,ES88209508878651879704,1800.62,2024-07-04T12:01:21,Durango,expenses,gifts,-255.31,-61228.25
buyer_8,Patxi,Urrutia,1979-04-04,93497737T,patxi.urrutia@hyperapp.online,421269,ES88209508878651879704,1800.62,2024-07-04T13:51:20,Durango,expenses,car,-496.58,-61724.83
buyer_8,Patxi,Urrutia,1979-04-04,93497737T,patxi.urrutia@hyperapp.online,421269,ES88209508878651879704,1800.62,2024-07-05T09:52:19,Durango,expenses,mortgage,-1455.68,-63180.51
buyer_8,Patxi,Urrutia,1979-04-04,93497737T,patxi.urrutia@hyperapp.online,421269,ES88209508878651879704,1800.62,2024-07-05T19:05:49,Durango,expenses,phone,-78.54,-63259.05
buyer_8,Patxi,Urrutia,1979-04-04,93497737T,patxi.urrutia@hyperapp.online,421269,ES88209508878651879704,1800.62,2024-07-06T22:08:30,Durango,expenses,internet,-77.96,-63337.01
buyer_8,Patxi,Urrutia,1979-04-04,93497737T,patxi.urrutia@hyperapp.online,421269,ES88209508878651879704,1800.62,2024-07-06T11:09:47,Durango,expenses,food,-123.92,-63460.93
buyer_8,Patxi,Urrutia,1979-04-04,93497737T,patxi.urrutia@hyperapp.online,421269,ES88209508878651879704,1800.62,2024-07-07T13:13:48,Durango,expenses,gas,-87.03,-63547.96
buyer_8,Patxi,Urrutia,1979-04-04,93497737T,patxi.urrutia@hyperapp.online,421269,ES88209508878651879704,1800.62,2024-07-07T15:07:13,Durango,expenses,leisure,-24.37,-63572.33
buyer_8,Patxi,Urrutia,1979-04-04,93497737T,patxi.urrutia@hyperapp.online,421269,ES88209508878651879704,1800.62,2024-07-08T17:20:14,Durango,expenses,education,-45.29,-63617.62
buyer_8,Patxi,Urrutia,1979-04-04,93497737T,patxi.urrutia@hyperapp.online,421269,ES88209508878651879704,1800.62,2024-07-09T08:16:09,Durango,expenses,cash,-100.0,-63717.62
buyer_8,Patxi,Urrutia,1979-04-04,93497737T,patxi.urrutia@hyperapp.online,421269,ES88209508878651879704,1800.62,2024-07-10T13:13:15,Durango,expenses,cash,-100.0,-63817.62
buyer_8,Patxi,Urrutia,1979-04-04,93497737T,patxi.urrutia@hyperapp.online,421269,ES88209508878651879704,1800.62,2024-07-11T19:30:28,Durango,expenses,leisure,-75.58,-63893.2
buyer_8,Patxi,Urrutia,1979-04-04,93497737T,patxi.urrutia@hyperapp.online,421269,ES88209508878651879704,1800.62,2024-07-13T15:46:59,Durango,expenses,clothing,-51.52,-63944.72
buyer_8,Patxi,Urrutia,1979-04-04,93497737T,patxi.urrutia@hyperapp.online,421269,ES88209508878651879704,1800.62,2024-07-13T08:10:24,Durango,expenses,cash,-100.0,-64044.72
buyer_8,Patxi,Urrutia,1979-04-04,93497737T,patxi.urrutia@hyperapp.online,421269,ES88209508878651879704,1800.62,2024-07-13T22:16:36,Durango,expenses,gifts,-63.05,-64107.77
buyer_8,Patxi,Urrutia,1979-04-04,93497737T,patxi.urrutia@hyperapp.online,421269,ES88209508878651879704,1800.62,2024-07-17T15:07:15,Durango,expenses,food,-66.26,-64174.03
buyer_8,Patxi,Urrutia,1979-04-04,93497737T,patxi.urrutia@hyperapp.online,421269,ES88209508878651879704,1800.62,2024-07-20T07:59:09,Durango,expenses,leisure,-60.55,-64234.58
buyer_8,Patxi,Urrutia,1979-04-04,93497737T,patxi.urrutia@hyperapp.online,421269,ES88209508878651879704,1800.62,2024-07-21T20:26:47,Durango,expenses,food,-63.84,-64298.42
buyer_8,Patxi,Urrutia,1979-04-04,93497737T,patxi.urrutia@hyperapp.online,421269,ES88209508878651879704,1800.62,2024-07-22T19:04:40,Durango,expenses,transport,-72.97,-64371.39
buyer_8,Patxi,Urrutia,1979-04-04,93497737T,patxi.urrutia@hyperapp.online,421269,ES88209508878651879704,1800.62,2024-07-22T11:04:37,Durango,expenses,healthcare,-69.27,-64440.66
buyer_8,Patxi,Urrutia,1979-04-04,93497737T,patxi.urrutia@hyperapp.online,421269,ES88209508878651879704,1800.62,2024-07-23T08:06:25,Durango,expenses,food,-96.37,-64537.03
buyer_8,Patxi,Urrutia,1979-04-04,93497737T,patxi.urrutia@hyperapp.online,421269,ES88209508878651879704,1800.62,2024-07-23T08:21:43,Durango,expenses,transport,-82.59,-64619.62
buyer_8,Patxi,Urrutia,1979-04-04,93497737T,patxi.urrutia@hyperapp.online,421269,ES88209508878651879704,1800.62,2024-07-23T11:09:18,Durango,expenses,gifts,-674.63,-65294.25
buyer_8,Patxi,Urrutia,1979-04-04,93497737T,patxi.urrutia@hyperapp.online,421269,ES88209508878651879704,1800.62,2024-07-25T15:46:56,Durango,expenses,education,-54.53,-65348.78
buyer_8,Patxi,Urrutia,1979-04-04,93497737T,patxi.urrutia@hyperapp.online,421269,ES88209508878651879704,1800.62,2024-07-25T18:46:35,Durango,expenses,appliances,-160.0,-65508.78
buyer_8,Patxi,Urrutia,1979-04-04,93497737T,patxi.urrutia@hyperapp.online,421269,ES88209508878651879704,1800.62,2024-07-26T16:41:13,Durango,expenses,food,-89.26,-65598.04
buyer_8,Patxi,Urrutia,1979-04-04,93497737T,patxi.urrutia@hyperapp.online,421269,ES88209508878651879704,1800.62,2024-07-27T23:09:40,Durango,expenses,leisure,-36.33,-65634.37
buyer_8,Patxi,Urrutia,1979-04-04,93497737T,patxi.urrutia@hyperapp.online,421269,ES88209508878651879704,1800.62,2024-07-27T12:37:52,Durango,expenses,clothing,-79.37,-65713.74
buyer_8,Patxi,Urrutia,1979-04-04,93497737T,patxi.urrutia@hyperapp.online,421269,ES88209508878651879704,1800.62,2024-07-29T12:21:53,Durango,expenses,food,-87.43,-65801.17
buyer_8,Patxi,Urrutia,1979-04-04,93497737T,patxi.urrutia@hyperapp.online,421269,ES88209508878651879704,1800.62,2024-07-29T08:03:05,Durango,expenses,repairs,-329.4,-66130.57
buyer_8,Patxi,Urrutia,1979-04-04,93497737T,patxi.urrutia@hyperapp.online,421269,ES88209508878651879704,1800.62,2024-07-30T21:17:24,Durango,expenses,healthcare,-61.21,-66191.78
buyer_8,Patxi,Urrutia,1979-04-04,93497737T,patxi.urrutia@hyperapp.online,421269,ES88209508878651879704,1800.62,2024-07-31T14:31:28,Durango,expenses,transport,-47.22,-66239.0
buyer_8,Patxi,Urrutia,1979-04-04,93497737T,patxi.urrutia@hyperapp.online,421269,ES88209508878651879704,1800.62,2024-07-31T06:39:09,Durango,expenses,leisure,-23.97,-66262.97
buyer_8,Patxi,Urrutia,1979-04-04,93497737T,patxi.urrutia@hyperapp.online,421269,ES88209508878651879704,1800.62,2024-08-01T13:34:44,Durango,incomes,salary,3374.74,-62888.23
buyer_8,Patxi,Urrutia,1979-04-04,93497737T,patxi.urrutia@hyperapp.online,421269,ES88209508878651879704,1800.62,2024-08-02T17:11:50,Durango,expenses,cash,-100.0,-62988.23
buyer_8,Patxi,Urrutia,1979-04-04,93497737T,patxi.urrutia@hyperapp.online,421269,ES88209508878651879704,1800.62,2024-08-02T11:39:06,Durango,expenses,gifts,-275.97,-63264.2
buyer_8,Patxi,Urrutia,1979-04-04,93497737T,patxi.urrutia@hyperapp.online,421269,ES88209508878651879704,1800.62,2024-08-04T14:01:45,Durango,expenses,leisure,-45.56,-63309.76
buyer_8,Patxi,Urrutia,1979-04-04,93497737T,patxi.urrutia@hyperapp.online,421269,ES88209508878651879704,1800.62,2024-08-05T17:04:25,Durango,expenses,mortgage,-1455.68,-64765.44
buyer_8,Patxi,Urrutia,1979-04-04,93497737T,patxi.urrutia@hyperapp.online,421269,ES88209508878651879704,1800.62,2024-08-05T17:00:57,Durango,expenses,water,-69.08,-64834.52
buyer_8,Patxi,Urrutia,1979-04-04,93497737T,patxi.urrutia@hyperapp.online,421269,ES88209508878651879704,1800.62,2024-08-05T08:25:55,Durango,expenses,gas,-149.56,-64984.08
buyer_8,Patxi,Urrutia,1979-04-04,93497737T,patxi.urrutia@hyperapp.online,421269,ES88209508878651879704,1800.62,2024-08-07T08:07:09,Durango,expenses,gas,-109.16,-65093.24
buyer_8,Patxi,Urrutia,1979-04-04,93497737T,patxi.urrutia@hyperapp.online,421269,ES88209508878651879704,1800.62,2024-08-07T09:16:57,Durango,expenses,leisure,-19.01,-65112.25
buyer_8,Patxi,Urrutia,1979-04-04,93497737T,patxi.urrutia@hyperapp.online,421269,ES88209508878651879704,1800.62,2024-08-08T18:16:54,Durango,expenses,water,-50.91,-65163.16
buyer_8,Patxi,Urrutia,1979-04-04,93497737T,patxi.urrutia@hyperapp.online,421269,ES88209508878651879704,1800.62,2024-08-09T15:20:27,Durango,expenses,transport,-89.23,-65252.39
buyer_8,Patxi,Urrutia,1979-04-04,93497737T,patxi.urrutia@hyperapp.online,421269,ES88209508878651879704,1800.62,2024-08-09T22:52:12,Durango,expenses,cash,-100.0,-65352.39
buyer_8,Patxi,Urrutia,1979-04-04,93497737T,patxi.urrutia@hyperapp.online,421269,ES88209508878651879704,1800.62,2024-08-09T11:37:04,Durango,expenses,appliances,-243.6,-65595.99
buyer_8,Patxi,Urrutia,1979-04-04,93497737T,patxi.urrutia@hyperapp.online,421269,ES88209508878651879704,1800.62,2024-08-10T19:38:56,Durango,expenses,leisure,-23.83,-65619.82
buyer_8,Patxi,Urrutia,1979-04-04,93497737T,patxi.urrutia@hyperapp.online,421269,ES88209508878651879704,1800.62,2024-08-11T16:25:26,Durango,expenses,transport,-64.55,-65684.37
buyer_8,Patxi,Urrutia,1979-04-04,93497737T,patxi.urrutia@hyperapp.online,421269,ES88209508878651879704,1800.62,2024-08-11T22:44:17,Durango,expenses,clothing,-94.08,-65778.45
buyer_8,Patxi,Urrutia,1979-04-04,93497737T,patxi.urrutia@hyperapp.online,421269,ES88209508878651879704,1800.62,2024-08-12T08:55:37,Durango,expenses,cash,-100.0,-65878.45
buyer_8,Patxi,Urrutia,1979-04-04,93497737T,patxi.urrutia@hyperapp.online,421269,ES88209508878651879704,1800.62,2024-08-14T13:22:52,Durango,expenses,food,-78.81,-65957.26
buyer_8,Patxi,Urrutia,1979-04-04,93497737T,patxi.urrutia@hyperapp.online,421269,ES88209508878651879704,1800.62,2024-08-14T16:33:13,Durango,expenses,gifts,-284.37,-66241.63
buyer_8,Patxi,Urrutia,1979-04-04,93497737T,patxi.urrutia@hyperapp.online,421269,ES88209508878651879704,1800.62,2024-08-15T18:25:13,Durango,expenses,food,-97.22,-66338.85
buyer_8,Patxi,Urrutia,1979-04-04,93497737T,patxi.urrutia@hyperapp.online,421269,ES88209508878651879704,1800.62,2024-08-18T17:31:48,Durango,expenses,cash,-100.0,-66438.85
buyer_8,Patxi,Urrutia,1979-04-04,93497737T,patxi.urrutia@hyperapp.online,421269,ES88209508878651879704,1800.62,2024-08-20T10:48:05,Durango,expenses,food,-65.17,-66504.02
buyer_8,Patxi,Urrutia,1979-04-04,93497737T,patxi.urrutia@hyperapp.online,421269,ES88209508878651879704,1800.62,2024-08-20T16:59:49,Durango,expenses,education,-63.71,-66567.73
buyer_8,Patxi,Urrutia,1979-04-04,93497737T,patxi.urrutia@hyperapp.online,421269,ES88209508878651879704,1800.62,2024-08-24T14:33:12,Durango,expenses,leisure,-29.56,-66597.29
buyer_8,Patxi,Urrutia,1979-04-04,93497737T,patxi.urrutia@hyperapp.online,421269,ES88209508878651879704,1800.62,2024-08-25T03:36:14,Durango,expenses,leisure,-67.18,-66664.47
buyer_8,Patxi,Urrutia,1979-04-04,93497737T,patxi.urrutia@hyperapp.online,421269,ES88209508878651879704,1800.62,2024-08-25T19:36:03,Durango,expenses,cash,-100.0,-66764.47
buyer_8,Patxi,Urrutia,1979-04-04,93497737T,patxi.urrutia@hyperapp.online,421269,ES88209508878651879704,1800.62,2024-08-26T20:57:27,Durango,expenses,appliances,-219.95,-66984.42
buyer_8,Patxi,Urrutia,1979-04-04,93497737T,patxi.urrutia@hyperapp.online,421269,ES88209508878651879704,1800.62,2024-08-29T11:08:49,Durango,expenses,gifts,-239.55,-67223.97
buyer_8,Patxi,Urrutia,1979-04-04,93497737T,patxi.urrutia@hyperapp.online,421269,ES88209508878651879704,1800.62,2024-09-01T08:41:12,Durango,incomes,salary,3374.74,-63849.23
buyer_8,Patxi,Urrutia,1979-04-04,93497737T,patxi.urrutia@hyperapp.online,421269,ES88209508878651879704,1800.62,2024-09-01T08:41:12,Durango,incomes,extra_income,514.84,-63334.39
buyer_8,Patxi,Urrutia,1979-04-04,93497737T,patxi.urrutia@hyperapp.online,421269,ES88209508878651879704,1800.62,2024-09-01T08:16:37,Durango,expenses,leisure,-83.67,-63418.06
buyer_8,Patxi,Urrutia,1979-04-04,93497737T,patxi.urrutia@hyperapp.online,421269,ES88209508878651879704,1800.62,2024-09-01T15:18:26,Durango,expenses,cash,-100.0,-63518.06
buyer_8,Patxi,Urrutia,1979-04-04,93497737T,patxi.urrutia@hyperapp.online,421269,ES88209508878651879704,1800.62,2024-09-03T18:32:49,Durango,expenses,food,-107.23,-63625.29
buyer_8,Patxi,Urrutia,1979-04-04,93497737T,patxi.urrutia@hyperapp.online,421269,ES88209508878651879704,1800.62,2024-09-04T09:51:14,Durango,expenses,cash,-100.0,-63725.29
buyer_8,Patxi,Urrutia,1979-04-04,93497737T,patxi.urrutia@hyperapp.online,421269,ES88209508878651879704,1800.62,2024-09-04T19:00:18,Durango,expenses,repairs,-94.24,-63819.53
buyer_8,Patxi,Urrutia,1979-04-04,93497737T,patxi.urrutia@hyperapp.online,421269,ES88209508878651879704,1800.62,2024-09-05T14:20:56,Durango,expenses,mortgage,-1455.68,-65275.21
buyer_8,Patxi,Urrutia,1979-04-04,93497737T,patxi.urrutia@hyperapp.online,421269,ES88209508878651879704,1800.62,2024-09-05T23:41:36,Durango,expenses,electricity,-133.34,-65408.55
buyer_8,Patxi,Urrutia,1979-04-04,93497737T,patxi.urrutia@hyperapp.online,421269,ES88209508878651879704,1800.62,2024-09-06T12:04:03,Durango,expenses,gas,-193.55,-65602.1
buyer_8,Patxi,Urrutia,1979-04-04,93497737T,patxi.urrutia@hyperapp.online,421269,ES88209508878651879704,1800.62,2024-09-06T04:41:40,Durango,expenses,phone,-72.16,-65674.26
buyer_8,Patxi,Urrutia,1979-04-04,93497737T,patxi.urrutia@hyperapp.online,421269,ES88209508878651879704,1800.62,2024-09-08T16:14:52,Durango,expenses,gas,-78.12,-65752.38
buyer_8,Patxi,Urrutia,1979-04-04,93497737T,patxi.urrutia@hyperapp.online,421269,ES88209508878651879704,1800.62,2024-09-08T03:15:03,Durango,expenses,internet,-77.96,-65830.34
buyer_8,Patxi,Urrutia,1979-04-04,93497737T,patxi.urrutia@hyperapp.online,421269,ES88209508878651879704,1800.62,2024-09-10T09:31:58,Durango,expenses,travel,-693.85,-66524.19
buyer_8,Patxi,Urrutia,1979-04-04,93497737T,patxi.urrutia@hyperapp.online,421269,ES88209508878651879704,1800.62,2024-09-11T13:16:42,Durango,expenses,clothing,-146.13,-66670.32
buyer_8,Patxi,Urrutia,1979-04-04,93497737T,patxi.urrutia@hyperapp.online,421269,ES88209508878651879704,1800.62,2024-09-12T12:23:10,Durango,expenses,repairs,-220.63,-66890.95
buyer_8,Patxi,Urrutia,1979-04-04,93497737T,patxi.urrutia@hyperapp.online,421269,ES88209508878651879704,1800.62,2024-09-13T15:08:20,Durango,expenses,cash,-100.0,-66990.95
buyer_8,Patxi,Urrutia,1979-04-04,93497737T,patxi.urrutia@hyperapp.online,421269,ES88209508878651879704,1800.62,2024-09-13T23:12:31,Durango,expenses,repairs,-101.78,-67092.73
buyer_8,Patxi,Urrutia,1979-04-04,93497737T,patxi.urrutia@hyperapp.online,421269,ES88209508878651879704,1800.62,2024-09-14T10:53:21,Durango,expenses,food,-105.94,-67198.67
buyer_8,Patxi,Urrutia,1979-04-04,93497737T,patxi.urrutia@hyperapp.online,421269,ES88209508878651879704,1800.62,2024-09-14T11:55:36,Durango,expenses,appliances,-96.85,-67295.52
buyer_8,Patxi,Urrutia,1979-04-04,93497737T,patxi.urrutia@hyperapp.online,421269,ES88209508878651879704,1800.62,2024-09-15T17:27:31,Durango,expenses,education,-75.06,-67370.58
buyer_8,Patxi,Urrutia,1979-04-04,93497737T,patxi.urrutia@hyperapp.online,421269,ES88209508878651879704,1800.62,2024-09-19T11:47:00,Durango,expenses,repairs,-64.09,-67434.67
buyer_8,Patxi,Urrutia,1979-04-04,93497737T,patxi.urrutia@hyperapp.online,421269,ES88209508878651879704,1800.62,2024-09-20T17:23:43,Durango,expenses,cash,-100.0,-67534.67
buyer_8,Patxi,Urrutia,1979-04-04,93497737T,patxi.urrutia@hyperapp.online,421269,ES88209508878651879704,1800.62,2024-09-24T23:56:04,Durango,expenses,leisure,-30.26,-67564.93
buyer_8,Patxi,Urrutia,1979-04-04,93497737T,patxi.urrutia@hyperapp.online,421269,ES88209508878651879704,1800.62,2024-09-25T17:54:35,Durango,expenses,leisure,-73.66,-67638.59
buyer_8,Patxi,Urrutia,1979-04-04,93497737T,patxi.urrutia@hyperapp.online,421269,ES88209508878651879704,1800.62,2024-09-26T17:28:36,Durango,expenses,transport,-88.11,-67726.7
buyer_8,Patxi,Urrutia,1979-04-04,93497737T,patxi.urrutia@hyperapp.online,421269,ES88209508878651879704,1800.62,2024-09-26T11:07:21,Durango,expenses,gifts,-28.7,-67755.4
buyer_8,Patxi,Urrutia,1979-04-04,93497737T,patxi.urrutia@hyperapp.online,421269,ES88209508878651879704,1800.62,2024-09-27T12:03:56,Durango,expenses,food,-71.28,-67826.68
buyer_8,Patxi,Urrutia,1979-04-04,93497737T,patxi.urrutia@hyperapp.online,421269,ES88209508878651879704,1800.62,2024-09-27T06:05:30,Durango,expenses,cash,-100.0,-67926.68
buyer_8,Patxi,Urrutia,1979-04-04,93497737T,patxi.urrutia@hyperapp.online,421269,ES88209508878651879704,1800.62,2024-09-30T09:56:19,Durango,expenses,repairs,-181.51,-68108.19
buyer_8,Patxi,Urrutia,1979-04-04,93497737T,patxi.urrutia@hyperapp.online,421269,ES88209508878651879704,1800.62,2024-10-01T23:40:28,Durango,incomes,salary,3374.74,-64733.45
buyer_8,Patxi,Urrutia,1979-04-04,93497737T,patxi.urrutia@hyperapp.online,421269,ES88209508878651879704,1800.62,2024-10-01T15:52:43,Durango,expenses,transport,-70.82,-64804.27
buyer_8,Patxi,Urrutia,1979-04-04,93497737T,patxi.urrutia@hyperapp.online,421269,ES88209508878651879704,1800.62,2024-10-02T09:52:15,Durango,expenses,cash,-100.0,-64904.27
buyer_8,Patxi,Urrutia,1979-04-04,93497737T,patxi.urrutia@hyperapp.online,421269,ES88209508878651879704,1800.62,2024-10-05T17:59:46,Durango,expenses,mortgage,-1455.68,-66359.95
buyer_8,Patxi,Urrutia,1979-04-04,93497737T,patxi.urrutia@hyperapp.online,421269,ES88209508878651879704,1800.62,2024-10-05T16:13:40,Durango,expenses,electricity,-78.91,-66438.86
buyer_8,Patxi,Urrutia,1979-04-04,93497737T,patxi.urrutia@hyperapp.online,421269,ES88209508878651879704,1800.62,2024-10-05T06:20:15,Durango,expenses,cash,-100.0,-66538.86
buyer_8,Patxi,Urrutia,1979-04-04,93497737T,patxi.urrutia@hyperapp.online,421269,ES88209508878651879704,1800.62,2024-10-07T07:14:29,Durango,expenses,phone,-66.82,-66605.68
buyer_8,Patxi,Urrutia,1979-04-04,93497737T,patxi.urrutia@hyperapp.online,421269,ES88209508878651879704,1800.62,2024-10-08T14:20:20,Durango,expenses,gas,-114.16,-66719.84
