profile,name,age,iban,trx_id,timestamp,city,trx_type,trx_cat,amount_eur,balance
buyer_1,Luis,28,ES51209508186894218628,TRX_N-00001-51032369,2020-01-01T09:09:37,Bilbao,transfer,Salary,1388.2,1762.69
buyer_1,Luis,28,ES51209508186894218628,TRX_N-00002-66629706,2020-01-05T08:12:28,Bilbao,Housing,Rent,-1483.81,278.88
buyer_1,Luis,28,ES51209508186894218628,TRX_N-00003-09234434,2020-01-05T11:18:37,Bilbao,Basic services,water,-25.43,253.45
buyer_1,Luis,28,ES51209508186894218628,TRX_N-00004-64194662,2020-01-05T08:48:41,Bilbao,Basic services,internet,-76.24,177.21
buyer_1,Luis,28,ES51209508186894218628,TRX_N-00005-97114720,2020-01-05T09:26:01,Bilbao,Basic services,phone,-92.75,84.46
buyer_1,Luis,28,ES51209508186894218628,TRX_N-00006-37697238,2020-01-06T15:26:53,Bilbao,Basic services,electricity,-137.04,-52.58
buyer_1,Luis,28,ES51209508186894218628,TRX_N-00007-35821660,2020-01-06T17:40:19,Bilbao,Basic services,gas,-78.41,-130.99
buyer_1,Luis,28,ES51209508186894218628,TRX_N-00008-54403285,2020-01-06T16:42:48,Bilbao,Basic services,internet,-46.45,-177.44
buyer_1,Luis,28,ES51209508186894218628,TRX_N-00009-55667141,2020-01-07T21:01:11,Bilbao,Basic services,water,-31.77,-209.21
buyer_1,Luis,28,ES51209508186894218628,TRX_N-00010-74287983,2020-01-07T20:39:29,Bilbao,Basic services,internet,-30.45,-239.66
buyer_1,Luis,28,ES51209508186894218628,TRX_N-00011-65365368,2020-01-07T15:34:45,Bilbao,Basic services,phone,-70.29,-309.95
buyer_1,Luis,28,ES51209508186894218628,TRX_N-00012-32475394,2020-01-12T13:21:51,Durango,Expense,leisure,-77.43,-387.38
buyer_1,Luis,28,ES51209508186894218628,TRX_N-00013-91137117,2020-01-22T20:48:20,Bilbao,Expense,healthcare,-212.59,-599.97
buyer_1,Luis,28,ES51209508186894218628,TRX_N-00014-06076353,2020-01-29T12:56:43,Donostia,Expense,leisure,-45.64,-645.61
buyer_1,Luis,28,ES51209508186894218628,TRX_N-00015-50544919,2020-01-30T18:37:14,Bilbao,Expense,repairs,-645.27,-1290.88
buyer_1,Luis,28,ES51209508186894218628,TRX_N-00016-61042083,2020-02-01T13:05:57,Bilbao,transfer,Salary,1388.2,97.32
buyer_1,Luis,28,ES51209508186894218628,TRX_N-00017-70216087,2020-02-01T13:05:57,Bilbao,transfer,Extra Income,138.82,236.14
buyer_1,Luis,28,ES51209508186894218628,TRX_N-00018-73017692,2020-02-02T15:36:36,Salvatierra/Agurain,Expense,transport,-43.14,193.0
buyer_1,Luis,28,ES51209508186894218628,TRX_N-00019-52159723,2020-02-03T19:19:26,Bilbao,Expense,healthcare,-156.22,36.78
buyer_1,Luis,28,ES51209508186894218628,TRX_N-00020-97933586,2020-02-04T22:51:10,Elciego,Expense,transport,-98.64,-61.86
buyer_1,Luis,28,ES51209508186894218628,TRX_N-00021-25727156,2020-02-05T15:51:46,Bilbao,Housing,Rent,-1483.81,-1545.67
buyer_1,Luis,28,ES51209508186894218628,TRX_N-00022-10438734,2020-02-05T11:21:43,Bilbao,Basic services,gas,-45.51,-1591.18
buyer_1,Luis,28,ES51209508186894218628,TRX_N-00023-17156057,2020-02-05T15:58:53,Bilbao,Basic services,internet,-73.1,-1664.28
buyer_1,Luis,28,ES51209508186894218628,TRX_N-00024-04193940,2020-02-05T08:09:48,Bilbao,Basic services,phone,-22.43,-1686.71
buyer_1,Luis,28,ES51209508186894218628,TRX_N-00025-26771361,2020-02-06T14:51:59,Bilbao,Basic services,electricity,-60.83,-1747.54
buyer_1,Luis,28,ES51209508186894218628,TRX_N-00026-15737408,2020-02-07T11:43:11,Bilbao,Basic services,phone,-32.57,-1780.11
buyer_1,Luis,28,ES51209508186894218628,TRX_N-00027-96038958,2020-02-13T16:43:48,Bilbao,Expense,repairs,-930.6,-2710.71
buyer_1,Luis,28,ES51209508186894218628,TRX_N-00028-96178891,2020-03-01T09:31:43,Bilbao,transfer,Salary,1388.2,-1322.51
buyer_1,Luis,28,ES51209508186894218628,TRX_N-00029-99809906,2020-03-03T17:54:18,Salvatierra/Agurain,Expense,leisure,-22.67,-1345.18
buyer_1,Luis,28,ES51209508186894218628,TRX_N-00030-54491404,2020-03-05T19:55:39,Bilbao,Housing,Rent,-1483.81,-2828.99
buyer_1,Luis,28,ES51209508186894218628,TRX_N-00031-08920068,2020-03-05T12:56:29,Bilbao,Basic services,electricity,-114.24,-2943.23
buyer_1,Luis,28,ES51209508186894218628,TRX_N-00032-58306121,2020-03-05T10:41:49,Bilbao,Basic services,gas,-68.99,-3012.22
buyer_1,Luis,28,ES51209508186894218628,TRX_N-00033-13579558,2020-03-07T15:24:45,Bilbao,Basic services,gas,-25.67,-3037.89
buyer_1,Luis,28,ES51209508186894218628,TRX_N-00034-87587094,2020-03-07T11:48:44,Bilbao,Basic services,internet,-36.11,-3074.0
buyer_1,Luis,28,ES51209508186894218628,TRX_N-00035-38882410,2020-03-07T17:51:18,Bilbao,Expense,clothing,-50.43,-3124.43
buyer_1,Luis,28,ES51209508186894218628,TRX_N-00036-84136178,2020-03-16T09:54:06,Bilbao,Expense,food,-739.04,-3863.47
buyer_1,Luis,28,ES51209508186894218628,TRX_N-00037-59817075,2020-03-18T20:17:34,Zarautz,Expense,clothing,-478.85,-4342.32
buyer_1,Luis,28,ES51209508186894218628,TRX_N-00038-53440886,2020-03-28T18:33:10,Bilbao,Expense,food,-118.55,-4460.87
buyer_1,Luis,28,ES51209508186894218628,TRX_N-00039-15619428,2020-04-01T23:36:58,Bilbao,transfer,Salary,1388.2,-3072.67
buyer_1,Luis,28,ES51209508186894218628,TRX_N-00040-41547160,2020-04-01T23:36:58,Bilbao,transfer,Extra Income,138.82,-2933.85
buyer_1,Luis,28,ES51209508186894218628,TRX_N-00041-37605093,2020-04-03T10:25:31,Bilbao,Expense,transport,-111.53,-3045.38
buyer_1,Luis,28,ES51209508186894218628,TRX_N-00042-59138844,2020-04-05T17:33:31,Bilbao,Housing,Rent,-1483.81,-4529.19
buyer_1,Luis,28,ES51209508186894218628,TRX_N-00043-13902901,2020-04-05T16:43:57,Bilbao,Basic services,water,-17.58,-4546.77
buyer_1,Luis,28,ES51209508186894218628,TRX_N-00044-57221072,2020-04-06T12:45:58,Bilbao,Basic services,gas,-69.93,-4616.7
buyer_1,Luis,28,ES51209508186894218628,TRX_N-00045-66887526,2020-04-07T10:10:59,Bilbao,Basic services,water,-75.06,-4691.76
buyer_1,Luis,28,ES51209508186894218628,TRX_N-00046-62481373,2020-04-07T10:10:03,Bilbao,Basic services,gas,-79.83,-4771.59
buyer_1,Luis,28,ES51209508186894218628,TRX_N-00047-02404400,2020-04-07T09:59:04,Bilbao,Basic services,phone,-58.56,-4830.15
buyer_1,Luis,28,ES51209508186894218628,TRX_N-00048-40778865,2020-04-29T05:59:47,Bilbao,Expense,transport,-71.0,-4901.15
buyer_1,Luis,28,ES51209508186894218628,TRX_N-00049-17275185,2020-05-01T15:56:06,Bilbao,transfer,Salary,1388.2,-3512.95
buyer_1,Luis,28,ES51209508186894218628,TRX_N-00050-15072910,2020-05-05T09:48:36,Bilbao,Housing,Rent,-1483.81,-4996.76
buyer_1,Luis,28,ES51209508186894218628,TRX_N-00051-06402670,2020-05-05T14:32:54,Bilbao,Basic services,water,-77.93,-5074.69
buyer_1,Luis,28,ES51209508186894218628,TRX_N-00052-72295594,2020-05-05T18:55:42,Bilbao,Basic services,internet,-54.58,-5129.27
buyer_1,Luis,28,ES51209508186894218628,TRX_N-00053-89944546,2020-05-05T22:47:07,Bilbao,Basic services,phone,-64.71,-5193.98
buyer_1,Luis,28,ES51209508186894218628,TRX_N-00054-30599741,2020-05-06T19:01:14,Bilbao,Basic services,electricity,-121.2,-5315.18
buyer_1,Luis,28,ES51209508186894218628,TRX_N-00055-17937409,2020-05-06T05:10:54,Bilbao,Basic services,internet,-78.54,-5393.72
buyer_1,Luis,28,ES51209508186894218628,TRX_N-00056-36743634,2020-05-06T20:22:02,Bilbao,Basic services,phone,-69.86,-5463.58
buyer_1,Luis,28,ES51209508186894218628,TRX_N-00057-26856041,2020-05-06T13:48:26,Bilbao,Expense,gifts,-163.94,-5627.52
buyer_1,Luis,28,ES51209508186894218628,TRX_N-00058-71728621,2020-05-07T17:55:59,Bilbao,Basic services,water,-34.67,-5662.19
buyer_1,Luis,28,ES51209508186894218628,TRX_N-00059-89738331,2020-05-12T16:00:39,Bilbao,Expense,food,-202.29,-5864.48
buyer_1,Luis,28,ES51209508186894218628,TRX_N-00060-27116173,2020-05-12T09:49:55,Bilbao,Expense,healthcare,-80.3,-5944.78
buyer_1,Luis,28,ES51209508186894218628,TRX_N-00061-93046965,2020-05-28T17:58:34,Bilbao,Expense,travel,-366.75,-6311.53
buyer_1,Luis,28,ES51209508186894218628,TRX_N-00062-77965843,2020-06-01T20:40:42,Bilbao,transfer,Salary,1388.2,-4923.33
buyer_1,Luis,28,ES51209508186894218628,TRX_N-00063-99454678,2020-06-01T20:40:42,Bilbao,transfer,Extra Income,138.82,-4784.51
buyer_1,Luis,28,ES51209508186894218628,TRX_N-00064-71501881,2020-06-01T20:40:42,Bilbao,transfer,Bonus,1471.23,-3313.28
buyer_1,Luis,28,ES51209508186894218628,TRX_N-00065-27992100,2020-06-02T23:35:14,Errenteria,Expense,healthcare,-222.88,-3536.16
buyer_1,Luis,28,ES51209508186894218628,TRX_N-00066-09986993,2020-06-05T19:58:49,Bilbao,Housing,Rent,-1483.81,-5019.97
buyer_1,Luis,28,ES51209508186894218628,TRX_N-00067-89038849,2020-06-05T11:20:21,Bilbao,Basic services,electricity,-40.35,-5060.32
buyer_1,Luis,28,ES51209508186894218628,TRX_N-00068-07357617,2020-06-06T18:45:54,Bilbao,Basic services,gas,-94.17,-5154.49
buyer_1,Luis,28,ES51209508186894218628,TRX_N-00069-48639284,2020-06-06T15:07:39,Bilbao,Basic services,phone,-52.11,-5206.6
buyer_1,Luis,28,ES51209508186894218628,TRX_N-00070-64441641,2020-06-07T23:21:06,Bilbao,Basic services,gas,-38.81,-5245.41
buyer_1,Luis,28,ES51209508186894218628,TRX_N-00071-63362590,2020-06-16T19:05:16,Bilbao,Expense,leisure,-119.62,-5365.03
buyer_1,Luis,28,ES51209508186894218628,TRX_N-00072-09032367,2020-07-01T11:43:44,Bilbao,transfer,Salary,1388.2,-3976.83
buyer_1,Luis,28,ES51209508186894218628,TRX_N-00073-04343176,2020-07-05T20:34:03,Bilbao,Housing,Rent,-1483.81,-5460.64
buyer_1,Luis,28,ES51209508186894218628,TRX_N-00074-18661733,2020-07-05T04:13:25,Bilbao,Basic services,electricity,-131.99,-5592.63
buyer_1,Luis,28,ES51209508186894218628,TRX_N-00075-09268138,2020-07-05T17:43:23,Bilbao,Basic services,gas,-63.41,-5656.04
buyer_1,Luis,28,ES51209508186894218628,TRX_N-00076-57694166,2020-07-05T11:27:35,Bilbao,Basic services,phone,-64.5,-5720.54
buyer_1,Luis,28,ES51209508186894218628,TRX_N-00077-94336610,2020-07-07T15:42:59,Bilbao,Basic services,water,-34.23,-5754.77
buyer_1,Luis,28,ES51209508186894218628,TRX_N-00078-50974684,2020-07-07T16:06:55,Bilbao,Basic services,internet,-79.74,-5834.51
buyer_1,Luis,28,ES51209508186894218628,TRX_N-00079-00142188,2020-07-20T23:48:31,Bilbao,Expense,food,-730.39,-6564.9
buyer_1,Luis,28,ES51209508186894218628,TRX_N-00080-73196500,2020-08-01T15:24:45,Bilbao,transfer,Salary,1388.2,-5176.7
buyer_1,Luis,28,ES51209508186894218628,TRX_N-00081-91880347,2020-08-05T14:49:25,Bilbao,Housing,Rent,-1483.81,-6660.51
buyer_1,Luis,28,ES51209508186894218628,TRX_N-00082-29169575,2020-08-05T11:48:48,Bilbao,Basic services,water,-57.01,-6717.52
buyer_1,Luis,28,ES51209508186894218628,TRX_N-00083-43384483,2020-08-05T21:44:19,Bilbao,Basic services,internet,-51.48,-6769.0
buyer_1,Luis,28,ES51209508186894218628,TRX_N-00084-19269748,2020-08-06T22:40:06,Bilbao,Basic services,internet,-74.28,-6843.28
buyer_1,Luis,28,ES51209508186894218628,TRX_N-00085-59073379,2020-08-07T13:11:06,Bilbao,Basic services,electricity,-135.45,-6978.73
buyer_1,Luis,28,ES51209508186894218628,TRX_N-00086-24686966,2020-08-07T18:49:00,Bilbao,Basic services,phone,-39.21,-7017.94
buyer_1,Luis,28,ES51209508186894218628,TRX_N-00087-37696823,2020-08-18T14:09:39,Bilbao,Expense,transport,-190.72,-7208.66
buyer_1,Luis,28,ES51209508186894218628,TRX_N-00088-52265664,2020-08-21T10:20:11,Hernani,Expense,transport,-177.16,-7385.82
buyer_1,Luis,28,ES51209508186894218628,TRX_N-00089-03922059,2020-09-01T09:33:23,Bilbao,transfer,Salary,1388.2,-5997.62
buyer_1,Luis,28,ES51209508186894218628,TRX_N-00090-31594348,2020-09-01T09:33:23,Bilbao,transfer,Extra Income,138.82,-5858.8
buyer_1,Luis,28,ES51209508186894218628,TRX_N-00091-18101869,2020-09-05T13:13:51,Bilbao,Housing,Rent,-1483.81,-7342.61
buyer_1,Luis,28,ES51209508186894218628,TRX_N-00092-37428148,2020-09-05T18:42:26,Bilbao,Basic services,water,-70.4,-7413.01
buyer_1,Luis,28,ES51209508186894218628,TRX_N-00093-77037402,2020-09-05T17:43:03,Bilbao,Basic services,phone,-47.43,-7460.44
buyer_1,Luis,28,ES51209508186894218628,TRX_N-00094-24979061,2020-09-06T13:45:17,Bilbao,Basic services,gas,-20.13,-7480.57
buyer_1,Luis,28,ES51209508186894218628,TRX_N-00095-19966840,2020-09-06T23:03:31,Bilbao,Basic services,phone,-79.91,-7560.48
buyer_1,Luis,28,ES51209508186894218628,TRX_N-00096-96107040,2020-09-07T18:05:48,Bilbao,Basic services,internet,-39.79,-7600.27
buyer_1,Luis,28,ES51209508186894218628,TRX_N-00097-53507579,2020-09-07T08:37:06,Bilbao,Basic services,phone,-75.71,-7675.98
buyer_1,Luis,28,ES51209508186894218628,TRX_N-00098-07800743,2020-09-09T21:38:43,Bilbao,Expense,food,-797.85,-8473.83
buyer_1,Luis,28,ES51209508186894218628,TRX_N-00099-23266940,2020-09-11T09:04:42,Bilbao,Expense,gifts,-398.86,-8872.69
buyer_1,Luis,28,ES51209508186894218628,TRX_N-00100-21704779,2020-09-12T15:54:20,Bilbao,Expense,transport,-179.79,-9052.48
buyer_1,Luis,28,ES51209508186894218628,TRX_N-00101-98566337,2020-09-19T15:53:10,Bilbao,Expense,travel,-323.52,-9376.0
buyer_1,Luis,28,ES51209508186894218628,TRX_N-00102-83730967,2020-09-21T15:56:42,Sestao,Expense,leisure,-132.41,-9508.41
buyer_1,Luis,28,ES51209508186894218628,TRX_N-00103-25072762,2020-09-22T11:03:45,Basauri,Expense,gifts,-263.89,-9772.3
buyer_1,Luis,28,ES51209508186894218628,TRX_N-00104-10013862,2020-10-01T16:50:22,Bilbao,transfer,Salary,1388.2,-8384.1
buyer_1,Luis,28,ES51209508186894218628,TRX_N-00105-78124276,2020-10-01T13:16:46,Bilbao,Expense,gifts,-415.39,-8799.49
buyer_1,Luis,28,ES51209508186894218628,TRX_N-00106-81000678,2020-10-05T11:56:29,Bilbao,Housing,Rent,-1483.81,-10283.3
buyer_1,Luis,28,ES51209508186894218628,TRX_N-00107-71184191,2020-10-05T15:29:11,Bilbao,Basic services,water,-40.75,-10324.05
buyer_1,Luis,28,ES51209508186894218628,TRX_N-00108-84172602,2020-10-05T20:07:11,Bilbao,Basic services,electricity,-64.13,-10388.18
buyer_1,Luis,28,ES51209508186894218628,TRX_N-00109-33435707,2020-10-05T09:47:58,Bilbao,Basic services,gas,-88.9,-10477.08
buyer_1,Luis,28,ES51209508186894218628,TRX_N-00110-16721396,2020-10-06T15:48:09,Bilbao,Basic services,phone,-51.1,-10528.18
buyer_1,Luis,28,ES51209508186894218628,TRX_N-00111-33794175,2020-10-11T12:04:49,Bilbao,Expense,leisure,-161.77,-10689.95
buyer_1,Luis,28,ES51209508186894218628,TRX_N-00112-17326248,2020-10-12T08:35:28,Bilbao,Expense,transport,-128.11,-10818.06
buyer_1,Luis,28,ES51209508186894218628,TRX_N-00113-21173873,2020-10-14T16:54:24,Bilbao,Expense,food,-605.9,-11423.96
buyer_1,Luis,28,ES51209508186894218628,TRX_N-00114-91358744,2020-11-01T14:30:45,Bilbao,transfer,Salary,1388.2,-10035.76
buyer_1,Luis,28,ES51209508186894218628,TRX_N-00115-33532110,2020-11-01T14:30:45,Bilbao,transfer,Extra Income,138.82,-9896.94
buyer_1,Luis,28,ES51209508186894218628,TRX_N-00116-36943432,2020-11-05T09:50:42,Bilbao,Housing,Rent,-1483.81,-11380.75
buyer_1,Luis,28,ES51209508186894218628,TRX_N-00117-27773618,2020-11-05T18:52:54,Bilbao,Basic services,internet,-45.52,-11426.27
buyer_1,Luis,28,ES51209508186894218628,TRX_N-00118-17733909,2020-11-06T13:58:06,Bilbao,Basic services,internet,-59.06,-11485.33
buyer_1,Luis,28,ES51209508186894218628,TRX_N-00119-35203451,2020-11-07T19:03:43,Bilbao,Basic services,internet,-31.12,-11516.45
buyer_1,Luis,28,ES51209508186894218628,TRX_N-00120-92974923,2020-11-17T17:04:16,Bilbao,Expense,leisure,-250.94,-11767.39
buyer_1,Luis,28,ES51209508186894218628,TRX_N-00121-16218694,2020-11-27T19:50:14,Mungia,Expense,leisure,-235.72,-12003.11
buyer_1,Luis,28,ES51209508186894218628,TRX_N-00122-22218457,2020-11-30T08:04:55,Durango,Expense,leisure,-116.25,-12119.36
buyer_1,Luis,28,ES51209508186894218628,TRX_N-00123-06835767,2020-12-01T13:24:25,Bilbao,transfer,Salary,1388.2,-10731.16
buyer_1,Luis,28,ES51209508186894218628,TRX_N-00124-49219358,2020-12-01T13:24:25,Bilbao,transfer,Bonus,1494.41,-9236.75
buyer_1,Luis,28,ES51209508186894218628,TRX_N-00125-32521413,2020-12-02T13:27:23,Bilbao,Expense,transport,-115.73,-9352.48
buyer_1,Luis,28,ES51209508186894218628,TRX_N-00126-22513451,2020-12-05T15:14:17,Bilbao,Housing,Rent,-1483.81,-10836.29
buyer_1,Luis,28,ES51209508186894218628,TRX_N-00127-28093136,2020-12-05T10:14:14,Bilbao,Basic services,gas,-80.28,-10916.57
buyer_1,Luis,28,ES51209508186894218628,TRX_N-00128-45540118,2020-12-05T14:39:14,Bilbao,Basic services,internet,-48.01,-10964.58
buyer_1,Luis,28,ES51209508186894218628,TRX_N-00129-24858942,2020-12-06T19:06:52,Bilbao,Basic services,electricity,-94.29,-11058.87
buyer_1,Luis,28,ES51209508186894218628,TRX_N-00130-81811797,2020-12-06T18:37:04,Bilbao,Basic services,gas,-85.73,-11144.6
buyer_1,Luis,28,ES51209508186894218628,TRX_N-00131-11288599,2020-12-07T14:00:55,Bilbao,Basic services,water,-25.68,-11170.28
buyer_1,Luis,28,ES51209508186894218628,TRX_N-00132-56259114,2020-12-07T11:31:08,Bilbao,Basic services,internet,-32.46,-11202.74
buyer_1,Luis,28,ES51209508186894218628,TRX_N-00133-14932178,2020-12-07T08:01:26,Bilbao,Expense,transport,-98.62,-11301.36
buyer_1,Luis,28,ES51209508186894218628,TRX_N-00134-25624650,2020-12-08T13:37:49,Zuia,Expense,clothing,-491.06,-11792.42
buyer_1,Luis,28,ES51209508186894218628,TRX_N-00135-69786500,2020-12-09T13:07:46,Bilbao,Expense,leisure,-126.06,-11918.48
buyer_1,Luis,28,ES51209508186894218628,TRX_N-00136-76419306,2020-12-12T09:41:56,Eibar,Expense,food,-758.77,-12677.25
buyer_1,Luis,28,ES51209508186894218628,TRX_N-00137-31186621,2020-12-25T08:48:02,Arrasate,Expense,healthcare,-227.08,-12904.33
buyer_1,Luis,28,ES51209508186894218628,TRX_N-00138-83292056,2020-12-27T15:08:03,Bilbao,Expense,food,-628.58,-13532.91
buyer_1,Luis,28,ES51209508186894218628,TRX_N-00139-96344636,2021-01-01T10:48:40,Bilbao,transfer,Salary,1388.2,-12144.71
buyer_1,Luis,28,ES51209508186894218628,TRX_N-00140-76890569,2021-01-05T10:11:00,Bilbao,Housing,Rent,-1483.81,-13628.52
buyer_1,Luis,28,ES51209508186894218628,TRX_N-00141-21646586,2021-01-05T13:13:08,Bilbao,Basic services,water,-31.86,-13660.38
buyer_1,Luis,28,ES51209508186894218628,TRX_N-00142-63910300,2021-01-06T17:58:40,Bilbao,Basic services,electricity,-117.08,-13777.46
buyer_1,Luis,28,ES51209508186894218628,TRX_N-00143-50949095,2021-01-06T10:13:47,Bilbao,Basic services,internet,-45.88,-13823.34
buyer_1,Luis,28,ES51209508186894218628,TRX_N-00144-07710417,2021-01-07T08:02:48,Bilbao,Basic services,internet,-54.75,-13878.09
buyer_1,Luis,28,ES51209508186894218628,TRX_N-00145-65630351,2021-01-07T12:03:02,Bilbao,Expense,food,-641.18,-14519.27
buyer_1,Luis,28,ES51209508186894218628,TRX_N-00146-08686261,2021-01-10T10:45:46,Bilbao,Expense,food,-244.79,-14764.06
buyer_1,Luis,28,ES51209508186894218628,TRX_N-00147-56233210,2021-01-10T20:39:42,Bilbao,Expense,transport,-133.65,-14897.71
buyer_1,Luis,28,ES51209508186894218628,TRX_N-00148-35131433,2021-01-15T11:21:16,Bilbao,Expense,healthcare,-302.29,-15200.0
buyer_1,Luis,28,ES51209508186894218628,TRX_N-00149-56452415,2021-01-29T14:41:17,Bilbao,Expense,gifts,-423.13,-15623.13
buyer_1,Luis,28,ES51209508186894218628,TRX_N-00150-24625907,2021-02-01T08:56:45,Bilbao,transfer,Salary,1388.2,-14234.93
buyer_1,Luis,28,ES51209508186894218628,TRX_N-00151-90007366,2021-02-01T08:56:45,Bilbao,transfer,Extra Income,138.82,-14096.11
buyer_1,Luis,28,ES51209508186894218628,TRX_N-00152-35472086,2021-02-01T07:10:43,Bilbao,Expense,transport,-112.46,-14208.57
buyer_1,Luis,28,ES51209508186894218628,TRX_N-00153-71652025,2021-02-05T07:22:12,Bilbao,Housing,Rent,-1483.81,-15692.38
buyer_1,Luis,28,ES51209508186894218628,TRX_N-00154-71596696,2021-02-05T15:36:37,Bilbao,Basic services,internet,-55.18,-15747.56
buyer_1,Luis,28,ES51209508186894218628,TRX_N-00155-71713317,2021-02-06T21:59:59,Bilbao,Basic services,water,-69.08,-15816.64
buyer_1,Luis,28,ES51209508186894218628,TRX_N-00156-41705388,2021-02-06T09:17:33,Bilbao,Basic services,electricity,-86.26,-15902.9
buyer_1,Luis,28,ES51209508186894218628,TRX_N-00157-69493550,2021-02-06T15:11:43,Bilbao,Basic services,phone,-72.34,-15975.24
buyer_1,Luis,28,ES51209508186894218628,TRX_N-00158-77382376,2021-02-07T18:19:02,Bilbao,Basic services,water,-75.01,-16050.25
buyer_1,Luis,28,ES51209508186894218628,TRX_N-00159-05510353,2021-02-07T18:31:31,Bilbao,Basic services,gas,-98.23,-16148.48
buyer_1,Luis,28,ES51209508186894218628,TRX_N-00160-33092974,2021-02-07T12:39:10,Bilbao,Basic services,internet,-66.24,-16214.72
buyer_1,Luis,28,ES51209508186894218628,TRX_N-00161-50474872,2021-02-07T11:43:02,Bilbao,Basic services,phone,-25.18,-16239.9
buyer_1,Luis,28,ES51209508186894218628,TRX_N-00162-06794330,2021-02-27T16:16:58,Bilbao,Expense,food,-422.46,-16662.36
buyer_1,Luis,28,ES51209508186894218628,TRX_N-00163-57113867,2021-03-01T15:07:28,Bilbao,transfer,Salary,1388.2,-15274.16
buyer_1,Luis,28,ES51209508186894218628,TRX_N-00164-05741179,2021-03-05T18:20:58,Bilbao,Housing,Rent,-1483.81,-16757.97
buyer_1,Luis,28,ES51209508186894218628,TRX_N-00165-62296754,2021-03-05T15:27:57,Bilbao,Basic services,gas,-81.01,-16838.98
buyer_1,Luis,28,ES51209508186894218628,TRX_N-00166-34526934,2021-03-05T03:26:19,Bilbao,Basic services,internet,-69.1,-16908.08
buyer_1,Luis,28,ES51209508186894218628,TRX_N-00167-52385124,2021-03-05T04:15:58,Bilbao,Basic services,phone,-47.68,-16955.76
buyer_1,Luis,28,ES51209508186894218628,TRX_N-00168-03588142,2021-03-06T08:15:26,Bilbao,Expense,gifts,-346.93,-17302.69
buyer_1,Luis,28,ES51209508186894218628,TRX_N-00169-35228183,2021-03-07T14:08:47,Bilbao,Basic services,water,-29.73,-17332.42
buyer_1,Luis,28,ES51209508186894218628,TRX_N-00170-61058433,2021-03-07T08:32:59,Bilbao,Basic services,electricity,-58.37,-17390.79
buyer_1,Luis,28,ES51209508186894218628,TRX_N-00171-34334259,2021-03-07T13:00:11,Bilbao,Basic services,internet,-38.7,-17429.49
buyer_1,Luis,28,ES51209508186894218628,TRX_N-00172-78280930,2021-03-14T09:59:37,Bilbao,Expense,healthcare,-304.69,-17734.18
buyer_1,Luis,28,ES51209508186894218628,TRX_N-00173-29070243,2021-03-15T16:54:11,Bilbao,Expense,education,-350.13,-18084.31
buyer_1,Luis,28,ES51209508186894218628,TRX_N-00174-55209815,2021-03-24T17:48:21,Bilbao,Expense,transport,-46.74,-18131.05
buyer_1,Luis,28,ES51209508186894218628,TRX_N-00175-51659809,2021-04-01T22:26:01,Bilbao,transfer,Salary,1388.2,-16742.85
buyer_1,Luis,28,ES51209508186894218628,TRX_N-00176-70343077,2021-04-01T22:26:01,Bilbao,transfer,Extra Income,138.82,-16604.03
buyer_1,Luis,28,ES51209508186894218628,TRX_N-00177-90613880,2021-04-05T15:20:16,Bilbao,Housing,Rent,-1483.81,-18087.84
buyer_1,Luis,28,ES51209508186894218628,TRX_N-00178-52134193,2021-04-05T14:59:01,Bilbao,Basic services,phone,-67.73,-18155.57
buyer_1,Luis,28,ES51209508186894218628,TRX_N-00179-69771013,2021-04-06T09:31:47,Bilbao,Basic services,electricity,-130.78,-18286.35
buyer_1,Luis,28,ES51209508186894218628,TRX_N-00180-15984278,2021-04-06T10:06:34,Bilbao,Basic services,internet,-53.19,-18339.54
buyer_1,Luis,28,ES51209508186894218628,TRX_N-00181-98646372,2021-04-07T11:21:21,Bilbao,Basic services,phone,-39.55,-18379.09
buyer_1,Luis,28,ES51209508186894218628,TRX_N-00182-96585183,2021-04-11T22:39:45,Bilbao,Expense,leisure,-117.22,-18496.31
buyer_1,Luis,28,ES51209508186894218628,TRX_N-00183-06222883,2021-05-01T12:06:22,Bilbao,transfer,Salary,1388.2,-17108.11
buyer_1,Luis,28,ES51209508186894218628,TRX_N-00184-61291431,2021-05-05T14:51:32,Bilbao,Housing,Rent,-1483.81,-18591.92
buyer_1,Luis,28,ES51209508186894218628,TRX_N-00185-40107485,2021-05-05T01:15:09,Bilbao,Basic services,water,-34.72,-18626.64
buyer_1,Luis,28,ES51209508186894218628,TRX_N-00186-45677297,2021-05-05T21:51:32,Bilbao,Basic services,internet,-62.35,-18688.99
buyer_1,Luis,28,ES51209508186894218628,TRX_N-00187-59086472,2021-05-05T20:16:20,Bilbao,Basic services,phone,-46.76,-18735.75
buyer_1,Luis,28,ES51209508186894218628,TRX_N-00188-46819922,2021-05-06T19:16:37,Bilbao,Basic services,internet,-74.82,-18810.57
buyer_1,Luis,28,ES51209508186894218628,TRX_N-00189-78161790,2021-05-07T13:48:46,Bilbao,Basic services,electricity,-87.98,-18898.55
buyer_1,Luis,28,ES51209508186894218628,TRX_N-00190-99238762,2021-05-15T19:50:31,Bilbao,Expense,transport,-75.28,-18973.83
buyer_1,Luis,28,ES51209508186894218628,TRX_N-00191-99278076,2021-06-01T20:03:00,Bilbao,transfer,Salary,1388.2,-17585.63
buyer_1,Luis,28,ES51209508186894218628,TRX_N-00192-20171227,2021-06-01T20:03:00,Bilbao,transfer,Extra Income,138.82,-17446.81
buyer_1,Luis,28,ES51209508186894218628,TRX_N-00193-78709639,2021-06-01T20:03:00,Bilbao,transfer,Bonus,1344.54,-16102.27
buyer_1,Luis,28,ES51209508186894218628,TRX_N-00194-67626440,2021-06-05T10:44:05,Bilbao,Housing,Rent,-1483.81,-17586.08
buyer_1,Luis,28,ES51209508186894218628,TRX_N-00195-54974044,2021-06-06T14:26:30,Bilbao,Basic services,electricity,-64.57,-17650.65
buyer_1,Luis,28,ES51209508186894218628,TRX_N-00196-94000543,2021-06-06T10:26:05,Bilbao,Basic services,phone,-20.66,-17671.31
buyer_1,Luis,28,ES51209508186894218628,TRX_N-00197-60906833,2021-06-06T04:56:00,Bilbao,Expense,food,-616.4,-18287.71
buyer_1,Luis,28,ES51209508186894218628,TRX_N-00198-30094426,2021-06-07T14:42:58,Bilbao,Basic services,electricity,-44.22,-18331.93
buyer_1,Luis,28,ES51209508186894218628,TRX_N-00199-43921741,2021-06-07T15:05:40,Bilbao,Expense,healthcare,-123.18,-18455.11
buyer_1,Luis,28,ES51209508186894218628,TRX_N-00200-34408249,2021-06-24T09:39:29,Bilbao,Expense,food,-492.47,-18947.58
buyer_1,Luis,28,ES51209508186894218628,TRX_N-00201-69224667,2021-07-01T11:56:19,Bilbao,transfer,Salary,1388.2,-17559.38
buyer_1,Luis,28,ES51209508186894218628,TRX_N-00202-53193518,2021-07-05T16:53:11,Bilbao,Housing,Rent,-1483.81,-19043.19
buyer_1,Luis,28,ES51209508186894218628,TRX_N-00203-69949817,2021-07-05T21:10:21,Bilbao,Basic services,electricity,-41.02,-19084.21
buyer_1,Luis,28,ES51209508186894218628,TRX_N-00204-81583946,2021-07-05T04:43:13,Bilbao,Basic services,internet,-69.17,-19153.38
buyer_1,Luis,28,ES51209508186894218628,TRX_N-00205-97384818,2021-07-05T14:04:09,Bilbao,Basic services,phone,-25.45,-19178.83
buyer_1,Luis,28,ES51209508186894218628,TRX_N-00206-69469497,2021-07-06T20:17:27,Bilbao,Basic services,gas,-44.36,-19223.19
buyer_1,Luis,28,ES51209508186894218628,TRX_N-00207-62259610,2021-07-06T13:54:24,Bilbao,Basic services,internet,-34.96,-19258.15
buyer_1,Luis,28,ES51209508186894218628,TRX_N-00208-83943782,2021-07-06T19:49:50,Bilbao,Basic services,phone,-37.75,-19295.9
buyer_1,Luis,28,ES51209508186894218628,TRX_N-00209-52246959,2021-07-06T10:47:22,Bilbao,Expense,food,-262.82,-19558.72
buyer_1,Luis,28,ES51209508186894218628,TRX_N-00210-30783163,2021-07-06T10:40:25,Bilbao,Expense,healthcare,-339.81,-19898.53
buyer_1,Luis,28,ES51209508186894218628,TRX_N-00211-82702149,2021-07-07T16:08:52,Bilbao,Basic services,water,-10.5,-19909.03
buyer_1,Luis,28,ES51209508186894218628,TRX_N-00212-58090764,2021-07-07T22:44:38,Bilbao,Basic services,gas,-15.05,-19924.08
buyer_1,Luis,28,ES51209508186894218628,TRX_N-00213-97242462,2021-07-07T10:13:49,Bilbao,Basic services,internet,-42.14,-19966.22
buyer_1,Luis,28,ES51209508186894218628,TRX_N-00214-28839942,2021-07-07T17:43:25,Bilbao,Basic services,phone,-70.21,-20036.43
buyer_1,Luis,28,ES51209508186894218628,TRX_N-00215-89554996,2021-07-17T06:59:29,Bilbao,Expense,clothing,-459.43,-20495.86
buyer_1,Luis,28,ES51209508186894218628,TRX_N-00216-56198573,2021-07-23T01:55:27,Bilbao,Expense,transport,-82.51,-20578.37
buyer_1,Luis,28,ES51209508186894218628,TRX_N-00217-34366005,2021-08-01T10:57:35,Bilbao,transfer,Salary,1388.2,-19190.17
buyer_1,Luis,28,ES51209508186894218628,TRX_N-00218-88986470,2021-08-01T10:57:35,Bilbao,transfer,Extra Income,138.82,-19051.35
buyer_1,Luis,28,ES51209508186894218628,TRX_N-00219-30402840,2021-08-05T15:06:05,Bilbao,Housing,Rent,-1483.81,-20535.16
buyer_1,Luis,28,ES51209508186894218628,TRX_N-00220-63572503,2021-08-05T13:12:21,Bilbao,Basic services,water,-75.74,-20610.9
buyer_1,Luis,28,ES51209508186894218628,TRX_N-00221-27407956,2021-08-05T08:00:36,Bilbao,Basic services,electricity,-31.16,-20642.06
buyer_1,Luis,28,ES51209508186894218628,TRX_N-00222-27761709,2021-08-06T15:58:08,Bilbao,Basic services,electricity,-132.85,-20774.91
buyer_1,Luis,28,ES51209508186894218628,TRX_N-00223-62056818,2021-08-15T09:45:21,Bilbao,Expense,food,-664.59,-21439.5
buyer_1,Luis,28,ES51209508186894218628,TRX_N-00224-27447512,2021-08-18T02:43:54,Bilbao,Expense,transport,-64.13,-21503.63
buyer_1,Luis,28,ES51209508186894218628,TRX_N-00225-72325758,2021-08-21T11:37:30,Bilbao,Expense,food,-440.33,-21943.96
buyer_1,Luis,28,ES51209508186894218628,TRX_N-00226-40121711,2021-08-27T18:05:43,Bilbao,Expense,transport,-143.0,-22086.96
buyer_1,Luis,28,ES51209508186894218628,TRX_N-00227-59142635,2021-09-01T11:55:47,Bilbao,transfer,Salary,1388.2,-20698.76
buyer_1,Luis,28,ES51209508186894218628,TRX_N-00228-23730172,2021-09-05T12:33:39,Bilbao,Housing,Rent,-1483.81,-22182.57
buyer_1,Luis,28,ES51209508186894218628,TRX_N-00229-06318995,2021-09-05T20:03:44,Bilbao,Basic services,gas,-93.33,-22275.9
buyer_1,Luis,28,ES51209508186894218628,TRX_N-00230-52653701,2021-09-06T15:17:58,Bilbao,Basic services,electricity,-63.2,-22339.1
buyer_1,Luis,28,ES51209508186894218628,TRX_N-00231-22081462,2021-09-06T10:40:50,Bilbao,Basic services,internet,-78.4,-22417.5
buyer_1,Luis,28,ES51209508186894218628,TRX_N-00232-74007234,2021-09-07T11:26:48,Bilbao,Basic services,water,-10.56,-22428.06
buyer_1,Luis,28,ES51209508186894218628,TRX_N-00233-08419899,2021-09-14T18:57:03,Galdakao,Expense,education,-160.41,-22588.47
buyer_1,Luis,28,ES51209508186894218628,TRX_N-00234-82236214,2021-09-27T00:13:48,Bilbao,Expense,clothing,-400.16,-22988.63
buyer_1,Luis,28,ES51209508186894218628,TRX_N-00235-90996546,2021-10-01T19:54:35,Bilbao,transfer,Salary,1388.2,-21600.43
buyer_1,Luis,28,ES51209508186894218628,TRX_N-00236-68846593,2021-10-01T19:54:35,Bilbao,transfer,Extra Income,138.82,-21461.61
buyer_1,Luis,28,ES51209508186894218628,TRX_N-00237-22321122,2021-10-05T15:55:27,Bilbao,Housing,Rent,-1483.81,-22945.42
buyer_1,Luis,28,ES51209508186894218628,TRX_N-00238-19345729,2021-10-05T19:23:46,Bilbao,Basic services,gas,-38.03,-22983.45
buyer_1,Luis,28,ES51209508186894218628,TRX_N-00239-89943888,2021-10-05T01:24:27,Bilbao,Basic services,phone,-59.72,-23043.17
buyer_1,Luis,28,ES51209508186894218628,TRX_N-00240-76850414,2021-10-06T05:20:29,Bilbao,Basic services,gas,-49.91,-23093.08
buyer_1,Luis,28,ES51209508186894218628,TRX_N-00241-44042089,2021-10-06T17:43:09,Bilbao,Basic services,internet,-35.26,-23128.34
buyer_1,Luis,28,ES51209508186894218628,TRX_N-00242-52414970,2021-10-07T21:27:21,Bilbao,Basic services,water,-66.74,-23195.08
buyer_1,Luis,28,ES51209508186894218628,TRX_N-00243-43939929,2021-10-07T20:32:20,Bilbao,Basic services,electricity,-93.96,-23289.04
buyer_1,Luis,28,ES51209508186894218628,TRX_N-00244-37948615,2021-10-28T19:29:22,Bilbao,Expense,healthcare,-301.93,-23590.97
buyer_1,Luis,28,ES51209508186894218628,TRX_N-00245-25997595,2021-10-31T14:08:53,Bilbao,Expense,food,-681.51,-24272.48
buyer_1,Luis,28,ES51209508186894218628,TRX_N-00246-18885056,2021-11-01T09:36:50,Bilbao,transfer,Salary,1388.2,-22884.28
buyer_1,Luis,28,ES51209508186894218628,TRX_N-00247-38333950,2021-11-05T21:19:54,Bilbao,Housing,Rent,-1483.81,-24368.09
buyer_1,Luis,28,ES51209508186894218628,TRX_N-00248-21512267,2021-11-05T22:17:21,Bilbao,Basic services,water,-63.57,-24431.66
buyer_1,Luis,28,ES51209508186894218628,TRX_N-00249-39602582,2021-11-05T08:50:21,Bilbao,Basic services,phone,-99.94,-24531.6
buyer_1,Luis,28,ES51209508186894218628,TRX_N-00250-56023237,2021-11-05T11:44:47,Bilbao,Expense,food,-309.49,-24841.09
buyer_1,Luis,28,ES51209508186894218628,TRX_N-00251-39934095,2021-11-07T17:03:17,Bilbao,Basic services,water,-58.01,-24899.1
buyer_1,Luis,28,ES51209508186894218628,TRX_N-00252-93202362,2021-11-07T12:16:33,Bilbao,Basic services,internet,-66.41,-24965.51
buyer_1,Luis,28,ES51209508186894218628,TRX_N-00253-61860933,2021-11-10T18:52:19,Bilbao,Expense,transport,-80.12,-25045.63
buyer_1,Luis,28,ES51209508186894218628,TRX_N-00254-58224436,2021-11-28T10:40:42,Bilbao,Expense,transport,-26.53,-25072.16
buyer_1,Luis,28,ES51209508186894218628,TRX_N-00255-24979143,2021-11-29T10:45:30,Bilbao,Expense,gifts,-323.29,-25395.45
buyer_1,Luis,28,ES51209508186894218628,TRX_N-00256-98089664,2021-12-01T18:25:05,Bilbao,transfer,Salary,1388.2,-24007.25
buyer_1,Luis,28,ES51209508186894218628,TRX_N-00257-15658800,2021-12-01T18:25:05,Bilbao,transfer,Extra Income,138.82,-23868.43
buyer_1,Luis,28,ES51209508186894218628,TRX_N-00258-08329941,2021-12-01T18:25:05,Bilbao,transfer,Bonus,1346.32,-22522.11
buyer_1,Luis,28,ES51209508186894218628,TRX_N-00259-71953284,2021-12-05T17:18:22,Bilbao,Housing,Rent,-1483.81,-24005.92
buyer_1,Luis,28,ES51209508186894218628,TRX_N-00260-76251216,2021-12-05T23:34:33,Bilbao,Basic services,internet,-55.22,-24061.14
buyer_1,Luis,28,ES51209508186894218628,TRX_N-00261-37370934,2021-12-06T15:34:00,Bilbao,Basic services,water,-68.89,-24130.03
buyer_1,Luis,28,ES51209508186894218628,TRX_N-00262-41092449,2021-12-07T09:17:18,Bilbao,Basic services,phone,-54.45,-24184.48
buyer_1,Luis,28,ES51209508186894218628,TRX_N-00263-51958139,2021-12-15T15:50:05,Bilbao,Expense,clothing,-118.41,-24302.89
buyer_1,Luis,28,ES51209508186894218628,TRX_N-00264-75747447,2021-12-23T12:24:35,Bilbao,Expense,food,-132.25,-24435.14
buyer_1,Luis,28,ES51209508186894218628,TRX_N-00265-37855746,2022-01-01T10:16:55,Bilbao,transfer,Salary,1388.2,-23046.94
buyer_1,Luis,28,ES51209508186894218628,TRX_N-00266-71384909,2022-01-05T13:35:22,Bilbao,Housing,Rent,-1483.81,-24530.75
buyer_1,Luis,28,ES51209508186894218628,TRX_N-00267-51465916,2022-01-05T13:38:28,Bilbao,Basic services,phone,-47.12,-24577.87
buyer_1,Luis,28,ES51209508186894218628,TRX_N-00268-75599848,2022-01-06T08:35:36,Bilbao,Basic services,water,-18.08,-24595.95
buyer_1,Luis,28,ES51209508186894218628,TRX_N-00269-29638753,2022-01-06T13:38:47,Bilbao,Expense,food,-781.02,-25376.97
buyer_1,Luis,28,ES51209508186894218628,TRX_N-00270-13938508,2022-01-07T12:21:37,Bilbao,Basic services,gas,-28.39,-25405.36
buyer_1,Luis,28,ES51209508186894218628,TRX_N-00271-60347845,2022-01-07T22:52:45,Bilbao,Basic services,internet,-66.48,-25471.84
buyer_1,Luis,28,ES51209508186894218628,TRX_N-00272-14796531,2022-01-14T11:11:06,Bilbao,Expense,transport,-98.56,-25570.4
buyer_1,Luis,28,ES51209508186894218628,TRX_N-00273-62296342,2022-01-18T17:56:00,Bilbao,Expense,healthcare,-391.41,-25961.81
buyer_1,Luis,28,ES51209508186894218628,TRX_N-00274-79851927,2022-01-18T20:39:41,Bilbao,Expense,education,-279.66,-26241.47
buyer_1,Luis,28,ES51209508186894218628,TRX_N-00275-36811268,2022-02-01T10:03:16,Bilbao,transfer,Salary,1388.2,-24853.27
buyer_1,Luis,28,ES51209508186894218628,TRX_N-00276-22381543,2022-02-05T14:17:40,Bilbao,Housing,Rent,-1483.81,-26337.08
buyer_1,Luis,28,ES51209508186894218628,TRX_N-00277-58942272,2022-02-05T17:06:54,Bilbao,Basic services,electricity,-80.22,-26417.3
buyer_1,Luis,28,ES51209508186894218628,TRX_N-00278-72595297,2022-02-06T14:47:41,Bilbao,Basic services,water,-60.83,-26478.13
buyer_1,Luis,28,ES51209508186894218628,TRX_N-00279-84453321,2022-02-06T17:47:00,Bilbao,Basic services,electricity,-138.58,-26616.71
buyer_1,Luis,28,ES51209508186894218628,TRX_N-00280-12465217,2022-02-06T21:41:11,Bilbao,Basic services,gas,-92.94,-26709.65
buyer_1,Luis,28,ES51209508186894218628,TRX_N-00281-72723079,2022-02-06T08:10:37,Bilbao,Basic services,internet,-80.0,-26789.65
buyer_1,Luis,28,ES51209508186894218628,TRX_N-00282-94231618,2022-02-07T23:20:36,Bilbao,Basic services,gas,-43.64,-26833.29
buyer_1,Luis,28,ES51209508186894218628,TRX_N-00283-28122944,2022-02-07T10:03:48,Bilbao,Basic services,phone,-78.26,-26911.55
buyer_1,Luis,28,ES51209508186894218628,TRX_N-00284-68602879,2022-02-07T00:57:57,Elciego,Expense,leisure,-161.9,-27073.45
buyer_1,Luis,28,ES51209508186894218628,TRX_N-00285-98935854,2022-02-23T15:46:54,Bilbao,Expense,food,-266.26,-27339.71
buyer_1,Luis,28,ES51209508186894218628,TRX_N-00286-90297405,2022-03-01T22:15:52,Bilbao,transfer,Salary,1388.2,-25951.51
buyer_1,Luis,28,ES51209508186894218628,TRX_N-00287-24287807,2022-03-01T22:15:52,Bilbao,transfer,Extra Income,138.82,-25812.69
buyer_1,Luis,28,ES51209508186894218628,TRX_N-00288-79866040,2022-03-03T22:25:13,Bilbao,Expense,leisure,-29.77,-25842.46
buyer_1,Luis,28,ES51209508186894218628,TRX_N-00289-01598074,2022-03-05T05:47:22,Bilbao,Housing,Rent,-1483.81,-27326.27
buyer_1,Luis,28,ES51209508186894218628,TRX_N-00290-90929788,2022-03-05T19:03:17,Bilbao,Basic services,gas,-41.54,-27367.81
buyer_1,Luis,28,ES51209508186894218628,TRX_N-00291-45927415,2022-03-05T09:13:41,Vitoria-Gasteiz,Expense,food,-314.33,-27682.14
buyer_1,Luis,28,ES51209508186894218628,TRX_N-00292-25663470,2022-03-06T12:45:32,Bilbao,Basic services,internet,-42.98,-27725.12
buyer_1,Luis,28,ES51209508186894218628,TRX_N-00293-08563721,2022-03-07T16:52:40,Bilbao,Basic services,gas,-80.95,-27806.07
buyer_1,Luis,28,ES51209508186894218628,TRX_N-00294-86960094,2022-03-12T12:42:46,Bilbao,Expense,leisure,-123.6,-27929.67
buyer_1,Luis,28,ES51209508186894218628,TRX_N-00295-70664408,2022-03-20T23:29:44,Bilbao,Expense,education,-205.8,-28135.47
buyer_1,Luis,28,ES51209508186894218628,TRX_N-00296-01876758,2022-03-29T10:54:51,Irun,Expense,food,-350.36,-28485.83
buyer_1,Luis,28,ES51209508186894218628,TRX_N-00297-12678262,2022-03-30T20:31:19,Bilbao,Expense,food,-319.59,-28805.42
buyer_1,Luis,28,ES51209508186894218628,TRX_N-00298-58678713,2022-04-01T10:44:32,Bilbao,transfer,Salary,1388.2,-27417.22
buyer_1,Luis,28,ES51209508186894218628,TRX_N-00299-85506012,2022-04-01T23:05:16,Bilbao,Expense,repairs,-713.76,-28130.98
buyer_1,Luis,28,ES51209508186894218628,TRX_N-00300-11887170,2022-04-05T07:18:05,Bilbao,Housing,Rent,-1483.81,-29614.79
buyer_1,Luis,28,ES51209508186894218628,TRX_N-00301-61216161,2022-04-06T18:24:12,Bilbao,Basic services,electricity,-146.97,-29761.76
buyer_1,Luis,28,ES51209508186894218628,TRX_N-00302-11242007,2022-04-06T10:53:51,Bilbao,Basic services,internet,-31.92,-29793.68
buyer_1,Luis,28,ES51209508186894218628,TRX_N-00303-00921669,2022-04-07T08:57:28,Bilbao,Basic services,water,-41.89,-29835.57
buyer_1,Luis,28,ES51209508186894218628,TRX_N-00304-33240597,2022-04-12T15:40:26,Bilbao,Expense,food,-251.03,-30086.6
buyer_1,Luis,28,ES51209508186894218628,TRX_N-00305-16995629,2022-05-01T12:50:37,Bilbao,transfer,Salary,1388.2,-28698.4
buyer_1,Luis,28,ES51209508186894218628,TRX_N-00306-06797298,2022-05-01T12:50:37,Bilbao,transfer,Extra Income,138.82,-28559.58
buyer_1,Luis,28,ES51209508186894218628,TRX_N-00307-77653186,2022-05-05T13:40:42,Bilbao,Housing,Rent,-1483.81,-30043.39
buyer_1,Luis,28,ES51209508186894218628,TRX_N-00308-05808532,2022-05-05T19:39:52,Bilbao,Basic services,water,-77.98,-30121.37
buyer_1,Luis,28,ES51209508186894218628,TRX_N-00309-72046585,2022-05-05T18:49:53,Bilbao,Basic services,gas,-60.2,-30181.57
buyer_1,Luis,28,ES51209508186894218628,TRX_N-00310-22306223,2022-05-05T18:50:29,Bilbao,Basic services,internet,-44.99,-30226.56
buyer_1,Luis,28,ES51209508186894218628,TRX_N-00311-80566720,2022-05-06T17:14:23,Bilbao,Basic services,water,-46.55,-30273.11
buyer_1,Luis,28,ES51209508186894218628,TRX_N-00312-70692558,2022-05-06T15:25:09,Bilbao,Basic services,phone,-46.46,-30319.57
buyer_1,Luis,28,ES51209508186894218628,TRX_N-00313-56519033,2022-05-07T20:52:47,Bilbao,Basic services,internet,-37.52,-30357.09
buyer_1,Luis,28,ES51209508186894218628,TRX_N-00314-90317943,2022-05-15T11:45:27,Bilbao,Expense,food,-636.12,-30993.21
buyer_1,Luis,28,ES51209508186894218628,TRX_N-00315-25783092,2022-05-16T01:23:28,Bilbao,Expense,food,-150.09,-31143.3
buyer_1,Luis,28,ES51209508186894218628,TRX_N-00316-81886427,2022-05-21T11:04:27,Bilbao,Expense,leisure,-139.29,-31282.59
buyer_1,Luis,28,ES51209508186894218628,TRX_N-00317-49609965,2022-05-24T19:09:36,Bilbao,Expense,gifts,-123.65,-31406.24
buyer_1,Luis,28,ES51209508186894218628,TRX_N-00318-00180265,2022-05-30T11:10:57,Bilbao,Expense,transport,-66.56,-31472.8
buyer_1,Luis,28,ES51209508186894218628,TRX_N-00319-41276906,2022-06-01T18:02:25,Bilbao,transfer,Salary,1388.2,-30084.6
buyer_1,Luis,28,ES51209508186894218628,TRX_N-00320-67266498,2022-06-01T18:02:25,Bilbao,transfer,Bonus,1292.15,-28792.45
buyer_1,Luis,28,ES51209508186894218628,TRX_N-00321-82170754,2022-06-05T11:16:19,Bilbao,Housing,Rent,-1483.81,-30276.26
buyer_1,Luis,28,ES51209508186894218628,TRX_N-00322-10728510,2022-06-05T09:40:55,Bilbao,Basic services,water,-46.89,-30323.15
buyer_1,Luis,28,ES51209508186894218628,TRX_N-00323-63099085,2022-06-05T13:07:37,Bilbao,Basic services,gas,-71.13,-30394.28
buyer_1,Luis,28,ES51209508186894218628,TRX_N-00324-68950421,2022-06-06T09:40:22,Bilbao,Basic services,internet,-48.82,-30443.1
buyer_1,Luis,28,ES51209508186894218628,TRX_N-00325-32277808,2022-06-07T19:51:47,Bilbao,Basic services,water,-73.43,-30516.53
buyer_1,Luis,28,ES51209508186894218628,TRX_N-00326-21833733,2022-06-07T17:08:05,Bilbao,Basic services,gas,-26.47,-30543.0
buyer_1,Luis,28,ES51209508186894218628,TRX_N-00327-70590159,2022-06-07T08:01:15,Bilbao,Basic services,internet,-68.65,-30611.65
buyer_1,Luis,28,ES51209508186894218628,TRX_N-00328-87976179,2022-06-07T20:09:43,Bilbao,Expense,clothing,-419.3,-31030.95
buyer_1,Luis,28,ES51209508186894218628,TRX_N-00329-48786571,2022-06-13T11:48:26,Zuia,Expense,appliances,-1070.84,-32101.79
buyer_1,Luis,28,ES51209508186894218628,TRX_N-00330-21402292,2022-06-20T02:43:32,Bermeo,Expense,transport,-105.4,-32207.19
buyer_1,Luis,28,ES51209508186894218628,TRX_N-00331-18716860,2022-07-01T15:53:04,Bilbao,transfer,Salary,1388.2,-30818.99
buyer_1,Luis,28,ES51209508186894218628,TRX_N-00332-52306697,2022-07-01T15:53:04,Bilbao,transfer,Extra Income,138.82,-30680.17
buyer_1,Luis,28,ES51209508186894218628,TRX_N-00333-13931102,2022-07-01T03:13:41,Bilbao,Expense,healthcare,-369.85,-31050.02
buyer_1,Luis,28,ES51209508186894218628,TRX_N-00334-51840892,2022-07-02T11:45:36,Bilbao,Expense,transport,-36.53,-31086.55
buyer_1,Luis,28,ES51209508186894218628,TRX_N-00335-00511873,2022-07-05T03:33:38,Bilbao,Housing,Rent,-1483.81,-32570.36
buyer_1,Luis,28,ES51209508186894218628,TRX_N-00336-45315036,2022-07-05T19:27:07,Bilbao,Basic services,gas,-24.4,-32594.76
buyer_1,Luis,28,ES51209508186894218628,TRX_N-00337-15152629,2022-07-05T19:05:56,Bilbao,Expense,clothing,-69.13,-32663.89
buyer_1,Luis,28,ES51209508186894218628,TRX_N-00338-52581245,2022-07-06T12:33:18,Bilbao,Basic services,electricity,-94.0,-32757.89
buyer_1,Luis,28,ES51209508186894218628,TRX_N-00339-55296775,2022-07-06T10:37:17,Bilbao,Basic services,phone,-89.37,-32847.26
buyer_1,Luis,28,ES51209508186894218628,TRX_N-00340-57414357,2022-07-07T16:01:43,Bilbao,Basic services,internet,-48.39,-32895.65
buyer_1,Luis,28,ES51209508186894218628,TRX_N-00341-25548516,2022-07-07T13:58:24,Bilbao,Basic services,phone,-50.91,-32946.56
buyer_1,Luis,28,ES51209508186894218628,TRX_N-00342-44057625,2022-07-25T19:52:04,Bilbao,Expense,transport,-102.49,-33049.05
buyer_1,Luis,28,ES51209508186894218628,TRX_N-00343-86755133,2022-08-01T13:10:04,Bilbao,transfer,Salary,1388.2,-31660.85
buyer_1,Luis,28,ES51209508186894218628,TRX_N-00344-66798850,2022-08-05T19:50:06,Bilbao,Housing,Rent,-1483.81,-33144.66
buyer_1,Luis,28,ES51209508186894218628,TRX_N-00345-52492182,2022-08-05T21:55:18,Bilbao,Basic services,electricity,-70.27,-33214.93
buyer_1,Luis,28,ES51209508186894218628,TRX_N-00346-93133526,2022-08-05T09:57:55,Bilbao,Basic services,gas,-39.73,-33254.66
buyer_1,Luis,28,ES51209508186894218628,TRX_N-00347-69489496,2022-08-05T09:29:33,Bilbao,Basic services,internet,-44.48,-33299.14
buyer_1,Luis,28,ES51209508186894218628,TRX_N-00348-90415229,2022-08-05T14:51:48,Bilbao,Basic services,phone,-91.83,-33390.97
buyer_1,Luis,28,ES51209508186894218628,TRX_N-00349-49681698,2022-08-06T22:59:29,Bilbao,Basic services,water,-27.84,-33418.81
buyer_1,Luis,28,ES51209508186894218628,TRX_N-00350-71015731,2022-08-06T12:28:20,Bilbao,Expense,gifts,-367.33,-33786.14
buyer_1,Luis,28,ES51209508186894218628,TRX_N-00351-75766156,2022-08-07T09:29:01,Bilbao,Basic services,water,-59.17,-33845.31
buyer_1,Luis,28,ES51209508186894218628,TRX_N-00352-05610340,2022-08-07T15:15:35,Bilbao,Basic services,electricity,-131.45,-33976.76
buyer_1,Luis,28,ES51209508186894218628,TRX_N-00353-20885190,2022-08-07T11:18:56,Bilbao,Basic services,internet,-41.42,-34018.18
buyer_1,Luis,28,ES51209508186894218628,TRX_N-00354-91806010,2022-08-23T19:47:13,Bilbao,Expense,food,-557.75,-34575.93
buyer_1,Luis,28,ES51209508186894218628,TRX_N-00355-17823405,2022-09-01T15:36:09,Bilbao,transfer,Salary,1388.2,-33187.73
buyer_1,Luis,28,ES51209508186894218628,TRX_N-00356-73985482,2022-09-01T15:36:09,Bilbao,transfer,Extra Income,138.82,-33048.91
buyer_1,Luis,28,ES51209508186894218628,TRX_N-00357-15826134,2022-09-04T20:27:36,Bilbao,Expense,transport,-119.84,-33168.75
buyer_1,Luis,28,ES51209508186894218628,TRX_N-00358-90954546,2022-09-05T13:08:31,Bilbao,Housing,Rent,-1483.81,-34652.56
buyer_1,Luis,28,ES51209508186894218628,TRX_N-00359-64345758,2022-09-05T16:54:29,Bilbao,Basic services,internet,-33.44,-34686.0
buyer_1,Luis,28,ES51209508186894218628,TRX_N-00360-25617214,2022-09-05T23:10:34,Bilbao,Expense,transport,-140.45,-34826.45
buyer_1,Luis,28,ES51209508186894218628,TRX_N-00361-09384199,2022-09-06T18:20:43,Bilbao,Basic services,gas,-91.44,-34917.89
buyer_1,Luis,28,ES51209508186894218628,TRX_N-00362-70327374,2022-09-06T15:46:46,Bilbao,Basic services,internet,-51.22,-34969.11
buyer_1,Luis,28,ES51209508186894218628,TRX_N-00363-65896230,2022-09-06T17:27:07,Bilbao,Basic services,phone,-47.5,-35016.61
buyer_1,Luis,28,ES51209508186894218628,TRX_N-00364-31209695,2022-09-07T10:46:50,Bilbao,Basic services,electricity,-40.11,-35056.72
buyer_1,Luis,28,ES51209508186894218628,TRX_N-00365-02559988,2022-09-07T16:25:05,Bilbao,Basic services,internet,-71.1,-35127.82
buyer_1,Luis,28,ES51209508186894218628,TRX_N-00366-18364143,2022-09-10T20:44:44,Bilbao,Expense,gifts,-493.66,-35621.48
buyer_1,Luis,28,ES51209508186894218628,TRX_N-00367-94718406,2022-09-14T11:21:18,Bilbao,Expense,clothing,-190.21,-35811.69
buyer_1,Luis,28,ES51209508186894218628,TRX_N-00368-14351353,2022-09-25T16:22:12,Eibar,Expense,appliances,-639.57,-36451.26
buyer_1,Luis,28,ES51209508186894218628,TRX_N-00369-72648438,2022-09-27T11:32:00,Bilbao,Expense,healthcare,-171.66,-36622.92
buyer_1,Luis,28,ES51209508186894218628,TRX_N-00370-02607010,2022-10-01T10:04:54,Bilbao,transfer,Salary,1388.2,-35234.72
buyer_1,Luis,28,ES51209508186894218628,TRX_N-00371-22165154,2022-10-02T08:24:47,Pasaia,Expense,food,-507.2,-35741.92
buyer_1,Luis,28,ES51209508186894218628,TRX_N-00372-32251192,2022-10-05T12:33:27,Bilbao,Housing,Rent,-1483.81,-37225.73
buyer_1,Luis,28,ES51209508186894218628,TRX_N-00373-48636966,2022-10-05T20:18:44,Bilbao,Basic services,electricity,-97.88,-37323.61
buyer_1,Luis,28,ES51209508186894218628,TRX_N-00374-47674982,2022-10-07T22:49:30,Bilbao,Basic services,gas,-17.82,-37341.43
buyer_1,Luis,28,ES51209508186894218628,TRX_N-00375-20220975,2022-10-16T15:57:33,Bilbao,Expense,transport,-109.79,-37451.22
buyer_1,Luis,28,ES51209508186894218628,TRX_N-00376-78099320,2022-10-18T15:40:39,Bilbao,Expense,education,-949.77,-38400.99
buyer_1,Luis,28,ES51209508186894218628,TRX_N-00377-78158992,2022-10-23T13:48:58,Bilbao,Expense,food,-595.15,-38996.14
buyer_1,Luis,28,ES51209508186894218628,TRX_N-00378-39629255,2022-11-01T20:12:17,Bilbao,transfer,Salary,1388.2,-37607.94
buyer_1,Luis,28,ES51209508186894218628,TRX_N-00379-70513533,2022-11-02T15:57:25,Bilbao,Expense,food,-751.31,-38359.25
buyer_1,Luis,28,ES51209508186894218628,TRX_N-00380-09012228,2022-11-05T11:30:36,Bilbao,Housing,Rent,-1483.81,-39843.06
buyer_1,Luis,28,ES51209508186894218628,TRX_N-00381-12517771,2022-11-05T23:15:51,Bilbao,Basic services,internet,-35.76,-39878.82
buyer_1,Luis,28,ES51209508186894218628,TRX_N-00382-22378048,2022-11-05T13:48:58,Bilbao,Basic services,phone,-46.31,-39925.13
buyer_1,Luis,28,ES51209508186894218628,TRX_N-00383-44978956,2022-11-07T22:53:02,Bilbao,Basic services,electricity,-146.35,-40071.48
buyer_1,Luis,28,ES51209508186894218628,TRX_N-00384-51244445,2022-11-07T08:01:10,Bilbao,Basic services,gas,-23.45,-40094.93
buyer_1,Luis,28,ES51209508186894218628,TRX_N-00385-67248485,2022-12-01T09:59:49,Bilbao,transfer,Salary,1388.2,-38706.73
buyer_1,Luis,28,ES51209508186894218628,TRX_N-00386-53588271,2022-12-01T09:59:49,Bilbao,transfer,Extra Income,138.82,-38567.91
buyer_1,Luis,28,ES51209508186894218628,TRX_N-00387-69715581,2022-12-01T09:59:49,Bilbao,transfer,Bonus,1401.43,-37166.48
buyer_1,Luis,28,ES51209508186894218628,TRX_N-00388-56123614,2022-12-05T08:01:02,Bilbao,Housing,Rent,-1483.81,-38650.29
buyer_1,Luis,28,ES51209508186894218628,TRX_N-00389-47110016,2022-12-05T04:50:47,Bilbao,Basic services,electricity,-75.43,-38725.72
buyer_1,Luis,28,ES51209508186894218628,TRX_N-00390-58934428,2022-12-05T15:42:07,Bilbao,Basic services,phone,-76.53,-38802.25
buyer_1,Luis,28,ES51209508186894218628,TRX_N-00391-27705306,2022-12-06T15:33:51,Bilbao,Basic services,water,-47.96,-38850.21
buyer_1,Luis,28,ES51209508186894218628,TRX_N-00392-15233538,2022-12-06T15:48:56,Bilbao,Basic services,internet,-73.85,-38924.06
buyer_1,Luis,28,ES51209508186894218628,TRX_N-00393-14296840,2022-12-06T16:10:22,Bilbao,Basic services,phone,-65.48,-38989.54
buyer_1,Luis,28,ES51209508186894218628,TRX_N-00394-48240865,2022-12-07T14:40:31,Bilbao,Basic services,electricity,-119.14,-39108.68
buyer_1,Luis,28,ES51209508186894218628,TRX_N-00395-64390140,2022-12-07T06:05:09,Bilbao,Basic services,internet,-44.84,-39153.52
buyer_1,Luis,28,ES51209508186894218628,TRX_N-00396-47824969,2022-12-20T17:28:29,Bilbao,Expense,food,-682.7,-39836.22
buyer_1,Luis,28,ES51209508186894218628,TRX_N-00397-04489980,2022-12-27T02:07:48,Bilbao,Expense,transport,-31.06,-39867.28
buyer_1,Luis,28,ES51209508186894218628,TRX_N-00398-84366351,2023-01-01T11:25:39,Bilbao,transfer,Salary,1388.2,-38479.08
buyer_1,Luis,28,ES51209508186894218628,TRX_N-00399-38629152,2023-01-01T08:01:51,Irun,Expense,healthcare,-377.86,-38856.94
buyer_1,Luis,28,ES51209508186894218628,TRX_N-00400-18292495,2023-01-05T18:20:15,Bilbao,Housing,Rent,-1483.81,-40340.75
buyer_1,Luis,28,ES51209508186894218628,TRX_N-00401-84410693,2023-01-06T19:06:20,Bilbao,Basic services,electricity,-33.71,-40374.46
buyer_1,Luis,28,ES51209508186894218628,TRX_N-00402-67114162,2023-01-06T20:24:22,Bilbao,Basic services,gas,-92.09,-40466.55
buyer_1,Luis,28,ES51209508186894218628,TRX_N-00403-43938104,2023-01-06T14:28:58,Bilbao,Basic services,phone,-24.56,-40491.11
buyer_1,Luis,28,ES51209508186894218628,TRX_N-00404-76416786,2023-01-07T21:14:55,Bilbao,Basic services,phone,-86.09,-40577.2
buyer_1,Luis,28,ES51209508186894218628,TRX_N-00405-99332027,2023-01-17T08:42:34,Bilbao,Expense,food,-489.86,-41067.06
buyer_1,Luis,28,ES51209508186894218628,TRX_N-00406-95365646,2023-01-18T08:39:53,Bilbao,Expense,leisure,-73.85,-41140.91
buyer_1,Luis,28,ES51209508186894218628,TRX_N-00407-62273856,2023-01-18T20:08:49,Bilbao,Expense,education,-185.0,-41325.91
buyer_1,Luis,28,ES51209508186894218628,TRX_N-00408-85345641,2023-01-22T21:50:58,Getxo,Expense,transport,-47.54,-41373.45
buyer_1,Luis,28,ES51209508186894218628,TRX_N-00409-92075156,2023-01-24T13:13:46,Bilbao,Expense,leisure,-53.79,-41427.24
buyer_1,Luis,28,ES51209508186894218628,TRX_N-00410-02719742,2023-02-01T01:18:24,Bilbao,transfer,Salary,1388.2,-40039.04
buyer_1,Luis,28,ES51209508186894218628,TRX_N-00411-50126320,2023-02-01T14:22:03,Bilbao,Expense,gifts,-174.55,-40213.59
buyer_1,Luis,28,ES51209508186894218628,TRX_N-00412-78591288,2023-02-05T08:58:59,Bilbao,Housing,Rent,-1483.81,-41697.4
buyer_1,Luis,28,ES51209508186894218628,TRX_N-00413-13696745,2023-02-05T14:47:49,Bilbao,Basic services,electricity,-97.83,-41795.23
buyer_1,Luis,28,ES51209508186894218628,TRX_N-00414-05648832,2023-02-05T08:56:44,Bilbao,Basic services,internet,-34.05,-41829.28
buyer_1,Luis,28,ES51209508186894218628,TRX_N-00415-73049507,2023-02-06T15:45:17,Bilbao,Basic services,water,-15.25,-41844.53
buyer_1,Luis,28,ES51209508186894218628,TRX_N-00416-14176482,2023-02-06T09:46:55,Bilbao,Basic services,electricity,-40.99,-41885.52
buyer_1,Luis,28,ES51209508186894218628,TRX_N-00417-96880553,2023-02-06T20:36:46,Bilbao,Basic services,internet,-44.02,-41929.54
buyer_1,Luis,28,ES51209508186894218628,TRX_N-00418-82662582,2023-02-07T11:25:05,Bilbao,Basic services,gas,-19.58,-41949.12
buyer_1,Luis,28,ES51209508186894218628,TRX_N-00419-79719316,2023-02-12T17:34:30,Bilbao,Expense,transport,-57.27,-42006.39
buyer_1,Luis,28,ES51209508186894218628,TRX_N-00420-34105279,2023-02-13T13:15:10,Bilbao,Expense,travel,-1503.04,-43509.43
buyer_1,Luis,28,ES51209508186894218628,TRX_N-00421-27472415,2023-02-23T15:12:16,Bilbao,Expense,leisure,-143.56,-43652.99
buyer_1,Luis,28,ES51209508186894218628,TRX_N-00422-28546041,2023-02-25T17:53:32,Bilbao,Expense,transport,-114.54,-43767.53
buyer_1,Luis,28,ES51209508186894218628,TRX_N-00423-02177059,2023-02-27T12:38:18,Bilbao,Expense,leisure,-278.33,-44045.86
buyer_1,Luis,28,ES51209508186894218628,TRX_N-00424-77194311,2023-03-01T19:23:53,Bilbao,transfer,Salary,1388.2,-42657.66
buyer_1,Luis,28,ES51209508186894218628,TRX_N-00425-72233350,2023-03-01T19:23:53,Bilbao,transfer,Extra Income,138.82,-42518.84
buyer_1,Luis,28,ES51209508186894218628,TRX_N-00426-29176400,2023-03-03T17:36:09,Bilbao,Expense,transport,-74.26,-42593.1
buyer_1,Luis,28,ES51209508186894218628,TRX_N-00427-82572301,2023-03-05T15:50:51,Bilbao,Housing,Rent,-1483.81,-44076.91
buyer_1,Luis,28,ES51209508186894218628,TRX_N-00428-13436817,2023-03-05T15:57:15,Bilbao,Basic services,water,-73.66,-44150.57
buyer_1,Luis,28,ES51209508186894218628,TRX_N-00429-26547177,2023-03-05T14:35:36,Bilbao,Basic services,gas,-64.14,-44214.71
buyer_1,Luis,28,ES51209508186894218628,TRX_N-00430-07254310,2023-03-06T17:05:23,Bilbao,Basic services,internet,-63.88,-44278.59
buyer_1,Luis,28,ES51209508186894218628,TRX_N-00431-06510883,2023-03-07T17:42:27,Bilbao,Basic services,water,-10.36,-44288.95
buyer_1,Luis,28,ES51209508186894218628,TRX_N-00432-60398939,2023-03-07T18:05:07,Bilbao,Basic services,electricity,-72.35,-44361.3
buyer_1,Luis,28,ES51209508186894218628,TRX_N-00433-05398549,2023-03-07T13:38:43,Bilbao,Basic services,gas,-29.13,-44390.43
buyer_1,Luis,28,ES51209508186894218628,TRX_N-00434-67265091,2023-03-07T18:35:31,Bilbao,Basic services,internet,-63.02,-44453.45
buyer_1,Luis,28,ES51209508186894218628,TRX_N-00435-26049777,2023-03-07T00:12:47,Bilbao,Basic services,phone,-49.64,-44503.09
buyer_1,Luis,28,ES51209508186894218628,TRX_N-00436-76198638,2023-03-12T10:33:38,Bilbao,Expense,clothing,-131.16,-44634.25
buyer_1,Luis,28,ES51209508186894218628,TRX_N-00437-17337544,2023-03-26T11:54:45,Bilbao,Expense,transport,-162.26,-44796.51
buyer_1,Luis,28,ES51209508186894218628,TRX_N-00438-94685548,2023-03-30T17:09:05,Bilbao,Expense,food,-641.1,-45437.61
buyer_1,Luis,28,ES51209508186894218628,TRX_N-00439-54592463,2023-04-01T13:41:00,Bilbao,transfer,Salary,1388.2,-44049.41
buyer_1,Luis,28,ES51209508186894218628,TRX_N-00440-42389011,2023-04-05T20:56:34,Bilbao,Housing,Rent,-1483.81,-45533.22
buyer_1,Luis,28,ES51209508186894218628,TRX_N-00441-83368432,2023-04-05T11:09:32,Bilbao,Basic services,phone,-68.65,-45601.87
buyer_1,Luis,28,ES51209508186894218628,TRX_N-00442-58879307,2023-04-06T12:38:44,Bilbao,Basic services,gas,-61.64,-45663.51
buyer_1,Luis,28,ES51209508186894218628,TRX_N-00443-75644128,2023-04-06T08:04:44,Bilbao,Expense,food,-737.56,-46401.07
buyer_1,Luis,28,ES51209508186894218628,TRX_N-00444-52161330,2023-04-07T19:05:47,Bilbao,Basic services,water,-12.77,-46413.84
buyer_1,Luis,28,ES51209508186894218628,TRX_N-00445-25112887,2023-04-07T19:41:13,Bilbao,Basic services,phone,-41.46,-46455.3
buyer_1,Luis,28,ES51209508186894218628,TRX_N-00446-48750589,2023-04-08T12:56:47,Bilbao,Expense,appliances,-1018.55,-47473.85
buyer_1,Luis,28,ES51209508186894218628,TRX_N-00447-37028263,2023-04-27T20:43:53,Bilbao,Expense,food,-431.3,-47905.15
buyer_1,Luis,28,ES51209508186894218628,TRX_N-00448-48418972,2023-05-01T03:47:12,Bilbao,transfer,Salary,1388.2,-46516.95
buyer_1,Luis,28,ES51209508186894218628,TRX_N-00449-16701193,2023-05-01T03:47:12,Bilbao,transfer,Extra Income,138.82,-46378.13
buyer_1,Luis,28,ES51209508186894218628,TRX_N-00450-07805705,2023-05-05T14:25:31,Bilbao,Housing,Rent,-1483.81,-47861.94
buyer_1,Luis,28,ES51209508186894218628,TRX_N-00451-08091218,2023-05-06T12:26:32,Bilbao,Basic services,water,-60.18,-47922.12
buyer_1,Luis,28,ES51209508186894218628,TRX_N-00452-82197950,2023-05-06T05:45:32,Bilbao,Basic services,electricity,-99.36,-48021.48
buyer_1,Luis,28,ES51209508186894218628,TRX_N-00453-87141456,2023-05-06T12:21:51,Bilbao,Basic services,internet,-34.26,-48055.74
buyer_1,Luis,28,ES51209508186894218628,TRX_N-00454-14110902,2023-05-06T15:30:43,Bilbao,Basic services,phone,-41.93,-48097.67
buyer_1,Luis,28,ES51209508186894218628,TRX_N-00455-22925438,2023-05-07T14:54:00,Bilbao,Basic services,water,-57.53,-48155.2
buyer_1,Luis,28,ES51209508186894218628,TRX_N-00456-91345654,2023-05-07T09:39:32,Bilbao,Basic services,electricity,-142.97,-48298.17
buyer_1,Luis,28,ES51209508186894218628,TRX_N-00457-40549197,2023-05-07T17:01:02,Bilbao,Basic services,phone,-53.05,-48351.22
buyer_1,Luis,28,ES51209508186894218628,TRX_N-00458-51013020,2023-05-19T07:16:15,Bilbao,Expense,food,-732.79,-49084.01
buyer_1,Luis,28,ES51209508186894218628,TRX_N-00459-74426296,2023-06-01T19:50:45,Bilbao,transfer,Salary,1388.2,-47695.81
buyer_1,Luis,28,ES51209508186894218628,TRX_N-00460-53978038,2023-06-01T19:50:45,Bilbao,transfer,Bonus,1281.43,-46414.38
buyer_1,Luis,28,ES51209508186894218628,TRX_N-00461-46383701,2023-06-01T17:07:53,Galdakao,Expense,leisure,-272.96,-46687.34
buyer_1,Luis,28,ES51209508186894218628,TRX_N-00462-29511770,2023-06-05T12:10:49,Bilbao,Housing,Rent,-1483.81,-48171.15
buyer_1,Luis,28,ES51209508186894218628,TRX_N-00463-48398522,2023-06-05T16:42:02,Bilbao,Basic services,gas,-70.26,-48241.41
buyer_1,Luis,28,ES51209508186894218628,TRX_N-00464-07984383,2023-06-05T14:52:07,Bilbao,Basic services,internet,-79.33,-48320.74
buyer_1,Luis,28,ES51209508186894218628,TRX_N-00465-52465811,2023-06-05T10:14:26,Bilbao,Basic services,phone,-55.97,-48376.71
buyer_1,Luis,28,ES51209508186894218628,TRX_N-00466-67471987,2023-06-06T12:29:50,Bilbao,Basic services,water,-63.03,-48439.74
buyer_1,Luis,28,ES51209508186894218628,TRX_N-00467-06180075,2023-06-06T10:40:10,Bilbao,Basic services,gas,-38.07,-48477.81
buyer_1,Luis,28,ES51209508186894218628,TRX_N-00468-37006068,2023-06-06T18:50:02,Bilbao,Basic services,phone,-87.94,-48565.75
buyer_1,Luis,28,ES51209508186894218628,TRX_N-00469-82745430,2023-06-06T11:54:35,Bilbao,Expense,leisure,-189.67,-48755.42
buyer_1,Luis,28,ES51209508186894218628,TRX_N-00470-15213128,2023-06-07T09:35:09,Bilbao,Basic services,internet,-45.1,-48800.52
buyer_1,Luis,28,ES51209508186894218628,TRX_N-00471-25069986,2023-06-07T20:21:06,Bilbao,Basic services,phone,-44.66,-48845.18
buyer_1,Luis,28,ES51209508186894218628,TRX_N-00472-72962289,2023-06-15T11:15:43,Bilbao,Expense,leisure,-145.94,-48991.12
buyer_1,Luis,28,ES51209508186894218628,TRX_N-00473-62437385,2023-06-20T11:49:21,Bilbao,Expense,leisure,-179.14,-49170.26
buyer_1,Luis,28,ES51209508186894218628,TRX_N-00474-95698316,2023-06-21T10:54:26,Bilbao,Expense,food,-532.6,-49702.86
buyer_1,Luis,28,ES51209508186894218628,TRX_N-00475-24962691,2023-06-27T10:40:56,Bilbao,Expense,food,-213.22,-49916.08
buyer_1,Luis,28,ES51209508186894218628,TRX_N-00476-37564350,2023-07-01T11:55:03,Bilbao,transfer,Salary,1388.2,-48527.88
buyer_1,Luis,28,ES51209508186894218628,TRX_N-00477-46394447,2023-07-01T11:55:03,Bilbao,transfer,Extra Income,138.82,-48389.06
buyer_1,Luis,28,ES51209508186894218628,TRX_N-00478-39889781,2023-07-05T19:02:57,Bilbao,Housing,Rent,-1483.81,-49872.87
buyer_1,Luis,28,ES51209508186894218628,TRX_N-00479-00366959,2023-07-05T19:43:11,Bilbao,Basic services,gas,-71.36,-49944.23
buyer_1,Luis,28,ES51209508186894218628,TRX_N-00480-22148529,2023-07-06T18:45:29,Bilbao,Basic services,internet,-48.39,-49992.62
buyer_1,Luis,28,ES51209508186894218628,TRX_N-00481-81835600,2023-07-06T06:20:20,Salvatierra/Agurain,Expense,transport,-197.08,-50189.7
buyer_1,Luis,28,ES51209508186894218628,TRX_N-00482-77321964,2023-07-07T15:35:30,Bilbao,Expense,repairs,-260.31,-50450.01
buyer_1,Luis,28,ES51209508186894218628,TRX_N-00483-30631873,2023-07-13T11:52:59,Bilbao,Expense,transport,-52.66,-50502.67
buyer_1,Luis,28,ES51209508186894218628,TRX_N-00484-35126883,2023-07-15T09:20:40,Bilbao,Expense,leisure,-81.91,-50584.58
buyer_1,Luis,28,ES51209508186894218628,TRX_N-00485-64051208,2023-07-18T11:28:15,Bilbao,Expense,leisure,-15.51,-50600.09
buyer_1,Luis,28,ES51209508186894218628,TRX_N-00486-97939591,2023-07-23T15:30:56,Bilbao,Expense,clothing,-139.87,-50739.96
buyer_1,Luis,28,ES51209508186894218628,TRX_N-00487-25205493,2023-07-23T19:00:48,Iruña de Oca,Expense,healthcare,-258.87,-50998.83
buyer_1,Luis,28,ES51209508186894218628,TRX_N-00488-15529104,2023-08-01T09:01:34,Bilbao,transfer,Salary,1388.2,-49610.63
buyer_1,Luis,28,ES51209508186894218628,TRX_N-00489-48176403,2023-08-02T15:38:19,Bilbao,Expense,leisure,-181.53,-49792.16
buyer_1,Luis,28,ES51209508186894218628,TRX_N-00490-79683430,2023-08-05T09:51:30,Bilbao,Housing,Rent,-1483.81,-51275.97
buyer_1,Luis,28,ES51209508186894218628,TRX_N-00491-54310822,2023-08-05T12:44:53,Bilbao,Basic services,water,-49.9,-51325.87
buyer_1,Luis,28,ES51209508186894218628,TRX_N-00492-16985549,2023-08-06T18:13:00,Bilbao,Basic services,water,-78.57,-51404.44
buyer_1,Luis,28,ES51209508186894218628,TRX_N-00493-65522408,2023-08-06T18:24:42,Bilbao,Basic services,electricity,-48.43,-51452.87
buyer_1,Luis,28,ES51209508186894218628,TRX_N-00494-20925431,2023-08-07T13:15:26,Bilbao,Basic services,gas,-94.38,-51547.25
buyer_1,Luis,28,ES51209508186894218628,TRX_N-00495-63892893,2023-08-18T14:11:17,Bilbao,Expense,clothing,-388.12,-51935.37
buyer_1,Luis,28,ES51209508186894218628,TRX_N-00496-85312885,2023-08-29T09:14:06,Bilbao,Expense,repairs,-751.3,-52686.67
buyer_1,Luis,28,ES51209508186894218628,TRX_N-00497-69618953,2023-08-30T22:24:52,Bilbao,Expense,transport,-38.35,-52725.02
buyer_1,Luis,28,ES51209508186894218628,TRX_N-00498-89182274,2023-09-01T18:34:06,Bilbao,transfer,Salary,1388.2,-51336.82
buyer_1,Luis,28,ES51209508186894218628,TRX_N-00499-43896860,2023-09-05T09:17:22,Bilbao,Housing,Rent,-1483.81,-52820.63
buyer_1,Luis,28,ES51209508186894218628,TRX_N-00500-97805246,2023-09-05T11:46:19,Bilbao,Basic services,water,-33.17,-52853.8
buyer_1,Luis,28,ES51209508186894218628,TRX_N-00501-32554509,2023-09-05T19:14:17,Bilbao,Basic services,internet,-38.77,-52892.57
buyer_1,Luis,28,ES51209508186894218628,TRX_N-00502-25698366,2023-09-06T16:17:07,Bilbao,Basic services,electricity,-77.14,-52969.71
buyer_1,Luis,28,ES51209508186894218628,TRX_N-00503-00164223,2023-09-06T17:37:12,Bilbao,Basic services,gas,-75.61,-53045.32
buyer_1,Luis,28,ES51209508186894218628,TRX_N-00504-15949677,2023-09-06T08:57:32,Bilbao,Basic services,internet,-65.56,-53110.88
buyer_1,Luis,28,ES51209508186894218628,TRX_N-00505-86458695,2023-09-07T10:54:24,Bilbao,Basic services,water,-18.61,-53129.49
buyer_1,Luis,28,ES51209508186894218628,TRX_N-00506-34972122,2023-09-10T19:28:08,Bilbao,Expense,leisure,-282.77,-53412.26
buyer_1,Luis,28,ES51209508186894218628,TRX_N-00507-54421969,2023-09-15T12:22:57,Bilbao,Expense,clothing,-93.95,-53506.21
buyer_1,Luis,28,ES51209508186894218628,TRX_N-00508-95983841,2023-09-28T11:05:05,Vitoria-Gasteiz,Expense,transport,-171.07,-53677.28
buyer_1,Luis,28,ES51209508186894218628,TRX_N-00509-24738006,2023-10-01T15:28:47,Bilbao,transfer,Salary,1388.2,-52289.08
buyer_1,Luis,28,ES51209508186894218628,TRX_N-00510-17965384,2023-10-01T15:28:47,Bilbao,transfer,Extra Income,138.82,-52150.26
buyer_1,Luis,28,ES51209508186894218628,TRX_N-00511-08644899,2023-10-05T11:58:08,Bilbao,Housing,Rent,-1483.81,-53634.07
buyer_1,Luis,28,ES51209508186894218628,TRX_N-00512-63167736,2023-10-05T09:20:26,Bilbao,Basic services,gas,-21.86,-53655.93
buyer_1,Luis,28,ES51209508186894218628,TRX_N-00513-29639739,2023-10-06T14:44:08,Bilbao,Basic services,water,-78.27,-53734.2
buyer_1,Luis,28,ES51209508186894218628,TRX_N-00514-86936056,2023-10-06T18:58:47,Bilbao,Basic services,electricity,-42.23,-53776.43
buyer_1,Luis,28,ES51209508186894218628,TRX_N-00515-46110579,2023-10-06T08:56:57,Bilbao,Basic services,internet,-69.62,-53846.05
buyer_1,Luis,28,ES51209508186894218628,TRX_N-00516-99120145,2023-10-07T16:30:19,Bilbao,Basic services,phone,-41.1,-53887.15
buyer_1,Luis,28,ES51209508186894218628,TRX_N-00517-94283597,2023-10-27T18:55:49,Bilbao,Expense,repairs,-247.71,-54134.86
buyer_1,Luis,28,ES51209508186894218628,TRX_N-00518-79423009,2023-11-01T18:14:59,Bilbao,transfer,Salary,1388.2,-52746.66
buyer_1,Luis,28,ES51209508186894218628,TRX_N-00519-84250320,2023-11-05T18:23:14,Bilbao,Housing,Rent,-1483.81,-54230.47
buyer_1,Luis,28,ES51209508186894218628,TRX_N-00520-02385840,2023-11-05T17:51:47,Bilbao,Basic services,water,-63.44,-54293.91
buyer_1,Luis,28,ES51209508186894218628,TRX_N-00521-51326512,2023-11-05T06:00:25,Bilbao,Basic services,gas,-17.41,-54311.32
buyer_1,Luis,28,ES51209508186894218628,TRX_N-00522-71190510,2023-11-06T10:15:46,Bilbao,Basic services,electricity,-146.68,-54458.0
buyer_1,Luis,28,ES51209508186894218628,TRX_N-00523-34524801,2023-11-09T12:24:40,Bilbao,Expense,transport,-141.8,-54599.8
buyer_1,Luis,28,ES51209508186894218628,TRX_N-00524-85058858,2023-11-10T11:16:17,Bilbao,Expense,leisure,-42.17,-54641.97
buyer_1,Luis,28,ES51209508186894218628,TRX_N-00525-94515878,2023-11-14T19:16:08,Bermeo,Expense,transport,-171.47,-54813.44
buyer_1,Luis,28,ES51209508186894218628,TRX_N-00526-36158783,2023-11-25T08:53:57,Bilbao,Expense,clothing,-121.8,-54935.24
buyer_1,Luis,28,ES51209508186894218628,TRX_N-00527-16348607,2023-11-30T20:07:08,Bilbao,Expense,food,-178.9,-55114.14
buyer_1,Luis,28,ES51209508186894218628,TRX_N-00528-15944155,2023-12-01T16:48:36,Bilbao,transfer,Salary,1388.2,-53725.94
buyer_1,Luis,28,ES51209508186894218628,TRX_N-00529-76371780,2023-12-01T16:48:36,Bilbao,transfer,Extra Income,138.82,-53587.12
buyer_1,Luis,28,ES51209508186894218628,TRX_N-00530-53346871,2023-12-01T16:48:36,Bilbao,transfer,Bonus,1345.61,-52241.51
buyer_1,Luis,28,ES51209508186894218628,TRX_N-00531-42175232,2023-12-05T15:38:05,Bilbao,Housing,Rent,-1483.81,-53725.32
buyer_1,Luis,28,ES51209508186894218628,TRX_N-00532-95705707,2023-12-05T09:16:21,Bilbao,Basic services,water,-61.75,-53787.07
buyer_1,Luis,28,ES51209508186894218628,TRX_N-00533-87507289,2023-12-06T16:26:06,Bilbao,Basic services,electricity,-29.88,-53816.95
buyer_1,Luis,28,ES51209508186894218628,TRX_N-00534-53274809,2023-12-07T10:16:35,Bilbao,Basic services,electricity,-92.35,-53909.3
buyer_1,Luis,28,ES51209508186894218628,TRX_N-00535-69318256,2023-12-07T04:40:14,Bilbao,Basic services,gas,-49.82,-53959.12
buyer_1,Luis,28,ES51209508186894218628,TRX_N-00536-82117007,2023-12-07T16:56:37,Bilbao,Basic services,phone,-71.55,-54030.67
buyer_1,Luis,28,ES51209508186894218628,TRX_N-00537-95060955,2023-12-26T17:10:53,Oyón-Oion,Expense,leisure,-296.74,-54327.41
buyer_1,Luis,28,ES51209508186894218628,TRX_N-00538-91637902,2023-12-30T17:42:00,Bilbao,Expense,food,-385.82,-54713.23
buyer_1,Luis,28,ES51209508186894218628,TRX_N-00539-49487085,2024-01-01T08:46:00,Bilbao,transfer,Salary,1388.2,-53325.03
buyer_1,Luis,28,ES51209508186894218628,TRX_N-00540-25378369,2024-01-05T17:52:31,Bilbao,Housing,Rent,-1483.81,-54808.84
buyer_1,Luis,28,ES51209508186894218628,TRX_N-00541-48085488,2024-01-05T15:21:46,Bilbao,Basic services,water,-31.45,-54840.29
buyer_1,Luis,28,ES51209508186894218628,TRX_N-00542-37172763,2024-01-06T19:18:08,Bilbao,Basic services,water,-38.38,-54878.67
buyer_1,Luis,28,ES51209508186894218628,TRX_N-00543-52488224,2024-01-06T09:06:29,Bilbao,Basic services,phone,-50.37,-54929.04
buyer_1,Luis,28,ES51209508186894218628,TRX_N-00544-60962610,2024-01-07T15:02:00,Bilbao,Basic services,phone,-50.78,-54979.82
buyer_1,Luis,28,ES51209508186894218628,TRX_N-00545-59635685,2024-01-09T08:27:08,Bilbao,Expense,transport,-151.52,-55131.34
buyer_1,Luis,28,ES51209508186894218628,TRX_N-00546-08114832,2024-02-01T08:20:20,Bilbao,transfer,Salary,1388.2,-53743.14
buyer_1,Luis,28,ES51209508186894218628,TRX_N-00547-12391952,2024-02-01T08:20:20,Bilbao,transfer,Extra Income,138.82,-53604.32
buyer_1,Luis,28,ES51209508186894218628,TRX_N-00548-04998761,2024-02-05T16:50:40,Bilbao,Housing,Rent,-1483.81,-55088.13
buyer_1,Luis,28,ES51209508186894218628,TRX_N-00549-87267258,2024-02-05T18:55:09,Bilbao,Basic services,electricity,-49.84,-55137.97
buyer_1,Luis,28,ES51209508186894218628,TRX_N-00550-06651619,2024-02-05T11:06:13,Bilbao,Basic services,internet,-77.16,-55215.13
buyer_1,Luis,28,ES51209508186894218628,TRX_N-00551-12764383,2024-02-06T15:59:40,Bilbao,Basic services,internet,-79.61,-55294.74
buyer_1,Luis,28,ES51209508186894218628,TRX_N-00552-40570526,2024-02-07T12:30:59,Bilbao,Basic services,water,-70.01,-55364.75
buyer_1,Luis,28,ES51209508186894218628,TRX_N-00553-77054104,2024-02-07T10:45:07,Bilbao,Expense,appliances,-1217.79,-56582.54
buyer_1,Luis,28,ES51209508186894218628,TRX_N-00554-78216265,2024-02-08T12:06:26,Mungia,Expense,clothing,-367.03,-56949.57
buyer_1,Luis,28,ES51209508186894218628,TRX_N-00555-38887132,2024-02-17T12:36:10,Bilbao,Expense,gifts,-451.73,-57401.3
buyer_1,Luis,28,ES51209508186894218628,TRX_N-00556-47407493,2024-02-18T12:26:36,Bilbao,Expense,healthcare,-355.25,-57756.55
buyer_1,Luis,28,ES51209508186894218628,TRX_N-00557-14478615,2024-02-28T17:38:21,Bilbao,Expense,healthcare,-81.38,-57837.93
buyer_1,Luis,28,ES51209508186894218628,TRX_N-00558-36094085,2024-03-01T17:19:38,Bilbao,transfer,Salary,1388.2,-56449.73
buyer_1,Luis,28,ES51209508186894218628,TRX_N-00559-94257319,2024-03-05T10:46:44,Bilbao,Housing,Rent,-1483.81,-57933.54
buyer_1,Luis,28,ES51209508186894218628,TRX_N-00560-66954809,2024-03-05T15:52:50,Bilbao,Basic services,water,-40.93,-57974.47
buyer_1,Luis,28,ES51209508186894218628,TRX_N-00561-72253264,2024-03-05T19:53:27,Bilbao,Basic services,internet,-57.02,-58031.49
buyer_1,Luis,28,ES51209508186894218628,TRX_N-00562-15181910,2024-03-05T18:26:11,Bilbao,Basic services,phone,-44.31,-58075.8
buyer_1,Luis,28,ES51209508186894218628,TRX_N-00563-53667979,2024-03-06T14:31:15,Bilbao,Basic services,electricity,-139.34,-58215.14
buyer_1,Luis,28,ES51209508186894218628,TRX_N-00564-09833218,2024-03-06T11:02:05,Bilbao,Basic services,internet,-68.71,-58283.85
buyer_1,Luis,28,ES51209508186894218628,TRX_N-00565-68385711,2024-03-07T20:59:12,Bilbao,Basic services,water,-46.9,-58330.75
buyer_1,Luis,28,ES51209508186894218628,TRX_N-00566-15981425,2024-03-07T18:56:39,Bilbao,Basic services,electricity,-51.63,-58382.38
buyer_1,Luis,28,ES51209508186894218628,TRX_N-00567-39670597,2024-03-07T14:36:08,Bilbao,Basic services,gas,-25.78,-58408.16
buyer_1,Luis,28,ES51209508186894218628,TRX_N-00568-75685488,2024-03-26T17:21:30,Bilbao,Expense,transport,-58.46,-58466.62
buyer_1,Luis,28,ES51209508186894218628,TRX_N-00569-81983592,2024-03-27T16:06:25,Bilbao,Expense,transport,-185.95,-58652.57
buyer_1,Luis,28,ES51209508186894218628,TRX_N-00570-51464789,2024-03-29T20:18:19,Bilbao,Expense,food,-525.66,-59178.23
buyer_1,Luis,28,ES51209508186894218628,TRX_N-00571-23474142,2024-03-29T22:40:16,Bilbao,Expense,leisure,-281.24,-59459.47
buyer_1,Luis,28,ES51209508186894218628,TRX_N-00572-33427418,2024-04-01T05:11:24,Bilbao,transfer,Salary,1388.2,-58071.27
buyer_1,Luis,28,ES51209508186894218628,TRX_N-00573-29365137,2024-04-01T05:11:24,Bilbao,transfer,Extra Income,138.82,-57932.45
buyer_1,Luis,28,ES51209508186894218628,TRX_N-00574-33213765,2024-04-04T11:13:49,Bilbao,Expense,leisure,-299.51,-58231.96
buyer_1,Luis,28,ES51209508186894218628,TRX_N-00575-09983468,2024-04-05T13:23:44,Bilbao,Housing,Rent,-1483.81,-59715.77
buyer_1,Luis,28,ES51209508186894218628,TRX_N-00576-73660501,2024-04-05T20:05:18,Bilbao,Basic services,electricity,-149.64,-59865.41
buyer_1,Luis,28,ES51209508186894218628,TRX_N-00577-81553423,2024-04-05T10:15:00,Bilbao,Basic services,gas,-79.89,-59945.3
buyer_1,Luis,28,ES51209508186894218628,TRX_N-00578-65519888,2024-04-05T19:25:24,Bilbao,Basic services,phone,-33.89,-59979.19
buyer_1,Luis,28,ES51209508186894218628,TRX_N-00579-43206133,2024-04-06T20:06:55,Bilbao,Basic services,water,-56.12,-60035.31
buyer_1,Luis,28,ES51209508186894218628,TRX_N-00580-17535384,2024-04-07T13:27:06,Bilbao,Basic services,water,-32.58,-60067.89
buyer_1,Luis,28,ES51209508186894218628,TRX_N-00581-68669582,2024-04-28T12:30:31,Bilbao,Expense,leisure,-185.75,-60253.64
buyer_1,Luis,28,ES51209508186894218628,TRX_N-00582-51276393,2024-05-01T22:32:25,Bilbao,transfer,Salary,1388.2,-58865.44
buyer_1,Luis,28,ES51209508186894218628,TRX_N-00583-22767407,2024-05-05T16:46:26,Bilbao,Housing,Rent,-1483.81,-60349.25
buyer_1,Luis,28,ES51209508186894218628,TRX_N-00584-62216493,2024-05-05T18:56:42,Bilbao,Basic services,water,-19.65,-60368.9
buyer_1,Luis,28,ES51209508186894218628,TRX_N-00585-85861625,2024-05-05T13:52:04,Bilbao,Basic services,internet,-60.09,-60428.99
buyer_1,Luis,28,ES51209508186894218628,TRX_N-00586-82460772,2024-05-06T17:26:50,Bilbao,Basic services,water,-44.75,-60473.74
buyer_1,Luis,28,ES51209508186894218628,TRX_N-00587-15431506,2024-05-06T04:45:02,Bilbao,Basic services,internet,-79.85,-60553.59
buyer_1,Luis,28,ES51209508186894218628,TRX_N-00588-84541556,2024-05-07T18:41:20,Bilbao,Basic services,water,-54.84,-60608.43
buyer_1,Luis,28,ES51209508186894218628,TRX_N-00589-09460667,2024-05-07T16:36:48,Bilbao,Basic services,internet,-73.06,-60681.49
buyer_1,Luis,28,ES51209508186894218628,TRX_N-00590-90550068,2024-05-09T21:02:35,Bilbao,Expense,food,-112.59,-60794.08
buyer_1,Luis,28,ES51209508186894218628,TRX_N-00591-41645839,2024-05-11T22:13:22,Bilbao,Expense,healthcare,-331.87,-61125.95
buyer_1,Luis,28,ES51209508186894218628,TRX_N-00592-35432357,2024-05-27T15:43:56,Bilbao,Expense,food,-136.46,-61262.41
buyer_1,Luis,28,ES51209508186894218628,TRX_N-00593-07150390,2024-06-01T17:29:03,Bilbao,transfer,Salary,1388.2,-59874.21
buyer_1,Luis,28,ES51209508186894218628,TRX_N-00594-76417545,2024-06-01T17:29:03,Bilbao,transfer,Extra Income,138.82,-59735.39
buyer_1,Luis,28,ES51209508186894218628,TRX_N-00595-24443101,2024-06-01T17:29:03,Bilbao,transfer,Bonus,1377.04,-58358.35
buyer_1,Luis,28,ES51209508186894218628,TRX_N-00596-58877555,2024-06-05T13:32:06,Bilbao,Housing,Rent,-1483.81,-59842.16
buyer_1,Luis,28,ES51209508186894218628,TRX_N-00597-83773986,2024-06-06T21:10:57,Bilbao,Basic services,phone,-81.99,-59924.15
buyer_1,Luis,28,ES51209508186894218628,TRX_N-00598-59571097,2024-06-07T18:30:09,Bilbao,Basic services,gas,-22.04,-59946.19
buyer_1,Luis,28,ES51209508186894218628,TRX_N-00599-38112312,2024-06-09T23:45:49,Bilbao,Expense,transport,-179.06,-60125.25
buyer_1,Luis,28,ES51209508186894218628,TRX_N-00600-28047786,2024-06-16T17:45:37,Bilbao,Expense,clothing,-234.94,-60360.19
buyer_1,Luis,28,ES51209508186894218628,TRX_N-00601-07874005,2024-06-20T09:34:47,Hernani,Expense,gifts,-148.05,-60508.24
buyer_1,Luis,28,ES51209508186894218628,TRX_N-00602-39090117,2024-06-24T10:56:28,Bilbao,Expense,clothing,-276.21,-60784.45
buyer_1,Luis,28,ES51209508186894218628,TRX_N-00603-42827005,2024-07-01T18:41:57,Bilbao,transfer,Salary,1388.2,-59396.25
buyer_1,Luis,28,ES51209508186894218628,TRX_N-00604-50532498,2024-07-05T13:08:23,Bilbao,Housing,Rent,-1483.81,-60880.06
buyer_1,Luis,28,ES51209508186894218628,TRX_N-00605-61421837,2024-07-05T17:39:45,Erandio,Expense,leisure,-165.16,-61045.22
buyer_1,Luis,28,ES51209508186894218628,TRX_N-00606-71125040,2024-07-06T13:42:50,Bilbao,Basic services,electricity,-118.57,-61163.79
buyer_1,Luis,28,ES51209508186894218628,TRX_N-00607-94352157,2024-07-06T15:23:28,Bilbao,Basic services,gas,-55.52,-61219.31
buyer_1,Luis,28,ES51209508186894218628,TRX_N-00608-32199065,2024-07-06T08:31:00,Bilbao,Basic services,internet,-67.55,-61286.86
buyer_1,Luis,28,ES51209508186894218628,TRX_N-00609-51046238,2024-07-06T15:45:38,Bilbao,Basic services,phone,-38.37,-61325.23
buyer_1,Luis,28,ES51209508186894218628,TRX_N-00610-55854872,2024-07-07T15:18:32,Bilbao,Basic services,water,-67.35,-61392.58
buyer_1,Luis,28,ES51209508186894218628,TRX_N-00611-48847364,2024-07-07T18:11:49,Bilbao,Basic services,internet,-31.22,-61423.8
buyer_1,Luis,28,ES51209508186894218628,TRX_N-00612-57078424,2024-07-07T09:58:33,Bilbao,Basic services,phone,-96.47,-61520.27
buyer_1,Luis,28,ES51209508186894218628,TRX_N-00613-51845539,2024-07-07T11:26:59,Bilbao,Expense,transport,-54.14,-61574.41
buyer_1,Luis,28,ES51209508186894218628,TRX_N-00614-99056746,2024-07-10T18:07:03,Bilbao,Expense,transport,-70.73,-61645.14
buyer_1,Luis,28,ES51209508186894218628,TRX_N-00615-86309917,2024-07-18T14:58:16,Bilbao,Expense,leisure,-32.29,-61677.43
buyer_1,Luis,28,ES51209508186894218628,TRX_N-00616-84513937,2024-07-18T18:46:50,Bilbao,Expense,education,-607.0,-62284.43
buyer_1,Luis,28,ES51209508186894218628,TRX_N-00617-19924755,2024-08-01T12:24:35,Bilbao,transfer,Salary,1388.2,-60896.23
buyer_1,Luis,28,ES51209508186894218628,TRX_N-00618-27677628,2024-08-05T22:32:24,Bilbao,Housing,Rent,-1483.81,-62380.04
buyer_1,Luis,28,ES51209508186894218628,TRX_N-00619-63236547,2024-08-05T16:29:30,Bilbao,Basic services,phone,-41.4,-62421.44
buyer_1,Luis,28,ES51209508186894218628,TRX_N-00620-10065023,2024-08-06T11:15:13,Bilbao,Basic services,gas,-51.25,-62472.69
buyer_1,Luis,28,ES51209508186894218628,TRX_N-00621-52026370,2024-08-07T20:28:00,Bilbao,Basic services,electricity,-83.59,-62556.28
buyer_1,Luis,28,ES51209508186894218628,TRX_N-00622-09181399,2024-08-18T21:20:49,Bilbao,Expense,clothing,-339.37,-62895.65
buyer_1,Luis,28,ES51209508186894218628,TRX_N-00623-26439840,2024-08-28T10:32:10,Bilbao,Expense,transport,-43.9,-62939.55
buyer_1,Luis,28,ES51209508186894218628,TRX_N-00624-72064862,2024-08-31T12:37:39,Bilbao,Expense,food,-724.17,-63663.72
buyer_1,Luis,28,ES51209508186894218628,TRX_N-00625-57762464,2024-09-01T05:26:35,Bilbao,transfer,Salary,1388.2,-62275.52
buyer_1,Luis,28,ES51209508186894218628,TRX_N-00626-03537455,2024-09-01T05:26:35,Bilbao,transfer,Extra Income,138.82,-62136.7
buyer_1,Luis,28,ES51209508186894218628,TRX_N-00627-49116908,2024-09-02T08:30:49,Bilbao,Expense,food,-711.44,-62848.14
buyer_1,Luis,28,ES51209508186894218628,TRX_N-00628-87176712,2024-09-05T17:12:23,Bilbao,Housing,Rent,-1483.81,-64331.95
buyer_1,Luis,28,ES51209508186894218628,TRX_N-00629-68919302,2024-09-05T20:03:38,Bilbao,Basic services,water,-65.46,-64397.41
buyer_1,Luis,28,ES51209508186894218628,TRX_N-00630-71493328,2024-09-05T11:22:49,Bilbao,Basic services,gas,-88.28,-64485.69
buyer_1,Luis,28,ES51209508186894218628,TRX_N-00631-91256771,2024-09-06T08:10:17,Bilbao,Basic services,water,-40.44,-64526.13
buyer_1,Luis,28,ES51209508186894218628,TRX_N-00632-82561133,2024-09-06T23:44:15,Bilbao,Basic services,gas,-54.84,-64580.97
buyer_1,Luis,28,ES51209508186894218628,TRX_N-00633-32974077,2024-09-06T22:04:04,Bilbao,Basic services,internet,-41.08,-64622.05
buyer_1,Luis,28,ES51209508186894218628,TRX_N-00634-97573746,2024-09-07T19:07:22,Bilbao,Basic services,internet,-63.0,-64685.05
buyer_1,Luis,28,ES51209508186894218628,TRX_N-00635-83552557,2024-09-07T12:25:50,Bilbao,Basic services,phone,-65.87,-64750.92
buyer_1,Luis,28,ES51209508186894218628,TRX_N-00636-11600691,2024-09-07T12:09:44,Bilbao,Expense,healthcare,-366.95,-65117.87
buyer_1,Luis,28,ES51209508186894218628,TRX_N-00637-72157766,2024-09-09T17:53:24,Bilbao,Expense,education,-801.07,-65918.94
buyer_1,Luis,28,ES51209508186894218628,TRX_N-00638-18562124,2024-09-13T09:44:58,Bilbao,Expense,education,-486.96,-66405.9
buyer_1,Luis,28,ES51209508186894218628,TRX_N-00639-72942616,2024-09-22T11:38:01,Bilbao,Expense,leisure,-268.21,-66674.11
buyer_1,Luis,28,ES51209508186894218628,TRX_N-00640-50481881,2024-09-26T19:16:05,Bilbao,Expense,healthcare,-348.41,-67022.52
buyer_1,Luis,28,ES51209508186894218628,TRX_N-00641-31766585,2024-10-01T19:04:20,Bilbao,transfer,Salary,1388.2,-65634.32
buyer_1,Luis,28,ES51209508186894218628,TRX_N-00642-11343328,2024-10-05T23:21:58,Bilbao,Housing,Rent,-1483.81,-67118.13
buyer_1,Luis,28,ES51209508186894218628,TRX_N-00643-54571247,2024-10-05T20:17:09,Bilbao,Basic services,electricity,-68.93,-67187.06
buyer_1,Luis,28,ES51209508186894218628,TRX_N-00644-09405011,2024-10-06T14:26:42,Bilbao,Basic services,gas,-75.44,-67262.5
buyer_1,Luis,28,ES51209508186894218628,TRX_N-00645-72811845,2024-10-06T10:03:26,Bilbao,Basic services,phone,-27.15,-67289.65
buyer_1,Luis,28,ES51209508186894218628,TRX_N-00646-62638805,2024-10-07T20:33:53,Bilbao,Basic services,water,-30.36,-67320.01
buyer_1,Luis,28,ES51209508186894218628,TRX_N-00647-80626173,2024-10-08T18:34:34,Bilbao,Expense,healthcare,-310.79,-67630.8
buyer_2,Carmen,40,ES50209585267825676886,TRX_N-00001-57722510,2020-01-01T21:18:12,Zarautz,transfer,Salary,1501.73,3226.22
buyer_2,Carmen,40,ES50209585267825676886,TRX_N-00002-85477198,2020-01-05T22:08:10,Zarautz,Housing,Rent,-490.18,2736.04
buyer_2,Carmen,40,ES50209585267825676886,TRX_N-00003-91031756,2020-01-05T20:19:07,Zarautz,Basic services,water,-45.92,2690.12
buyer_2,Carmen,40,ES50209585267825676886,TRX_N-00004-32640975,2020-01-05T17:14:26,Zarautz,Basic services,electricity,-62.44,2627.68
buyer_2,Carmen,40,ES50209585267825676886,TRX_N-00005-99500213,2020-01-05T13:21:36,Zarautz,Basic services,phone,-53.42,2574.26
buyer_2,Carmen,40,ES50209585267825676886,TRX_N-00006-48353172,2020-01-06T15:13:35,Zarautz,Basic services,electricity,-127.62,2446.64
buyer_2,Carmen,40,ES50209585267825676886,TRX_N-00007-60243732,2020-01-07T14:40:42,Zarautz,Basic services,electricity,-117.96,2328.68
buyer_2,Carmen,40,ES50209585267825676886,TRX_N-00008-33409951,2020-01-13T20:38:41,Zarautz,Expense,gifts,-427.49,1901.19
buyer_2,Carmen,40,ES50209585267825676886,TRX_N-00009-11593182,2020-01-19T15:33:47,Zarautz,Expense,leisure,-245.6,1655.59
buyer_2,Carmen,40,ES50209585267825676886,TRX_N-00010-22444446,2020-02-01T10:01:47,Zarautz,transfer,Salary,1501.73,3157.32
buyer_2,Carmen,40,ES50209585267825676886,TRX_N-00011-33851689,2020-02-01T11:07:40,Santurtzi,Expense,travel,-1163.12,1994.2
buyer_2,Carmen,40,ES50209585267825676886,TRX_N-00012-91398959,2020-02-05T12:19:41,Zarautz,Housing,Rent,-490.18,1504.02
buyer_2,Carmen,40,ES50209585267825676886,TRX_N-00013-02597070,2020-02-05T16:03:16,Zarautz,Basic services,electricity,-145.58,1358.44
buyer_2,Carmen,40,ES50209585267825676886,TRX_N-00014-73001273,2020-02-05T15:21:30,Zarautz,Basic services,phone,-68.47,1289.97
buyer_2,Carmen,40,ES50209585267825676886,TRX_N-00015-89905373,2020-02-05T15:56:24,Zarautz,Expense,transport,-58.05,1231.92
buyer_2,Carmen,40,ES50209585267825676886,TRX_N-00016-09154736,2020-02-07T11:18:48,Zarautz,Basic services,internet,-76.45,1155.47
buyer_2,Carmen,40,ES50209585267825676886,TRX_N-00017-58425171,2020-02-07T10:03:49,Zarautz,Basic services,phone,-70.49,1084.98
buyer_2,Carmen,40,ES50209585267825676886,TRX_N-00018-81961119,2020-02-22T15:27:27,Zarautz,Expense,clothing,-328.06,756.92
buyer_2,Carmen,40,ES50209585267825676886,TRX_N-00019-63155636,2020-02-22T18:02:44,Zarautz,Expense,travel,-1710.71,-953.79
buyer_2,Carmen,40,ES50209585267825676886,TRX_N-00020-74656777,2020-02-29T22:45:18,Zarautz,Expense,appliances,-1672.81,-2626.6
buyer_2,Carmen,40,ES50209585267825676886,TRX_N-00021-76342113,2020-03-01T19:39:58,Zarautz,transfer,Salary,1501.73,-1124.87
buyer_2,Carmen,40,ES50209585267825676886,TRX_N-00022-38991635,2020-03-01T19:39:58,Zarautz,transfer,Extra Income,150.17,-974.7
buyer_2,Carmen,40,ES50209585267825676886,TRX_N-00023-06542691,2020-03-05T10:19:56,Zarautz,Housing,Rent,-490.18,-1464.88
buyer_2,Carmen,40,ES50209585267825676886,TRX_N-00024-02572857,2020-03-05T20:30:18,Zarautz,Basic services,phone,-58.48,-1523.36
buyer_2,Carmen,40,ES50209585267825676886,TRX_N-00025-52792876,2020-03-06T18:05:12,Zarautz,Basic services,electricity,-37.12,-1560.48
buyer_2,Carmen,40,ES50209585267825676886,TRX_N-00026-46035838,2020-03-06T14:10:57,Zarautz,Basic services,gas,-63.86,-1624.34
buyer_2,Carmen,40,ES50209585267825676886,TRX_N-00027-49905203,2020-03-06T09:16:33,Zarautz,Basic services,internet,-69.58,-1693.92
buyer_2,Carmen,40,ES50209585267825676886,TRX_N-00028-79716743,2020-03-06T10:12:38,Zarautz,Expense,leisure,-28.35,-1722.27
buyer_2,Carmen,40,ES50209585267825676886,TRX_N-00029-54082704,2020-03-06T12:35:40,Zarautz,Expense,education,-621.4,-2343.67
buyer_2,Carmen,40,ES50209585267825676886,TRX_N-00030-41581673,2020-03-07T02:31:39,Zarautz,Basic services,water,-35.24,-2378.91
buyer_2,Carmen,40,ES50209585267825676886,TRX_N-00031-07830718,2020-03-07T15:27:19,Zarautz,Basic services,electricity,-60.61,-2439.52
buyer_2,Carmen,40,ES50209585267825676886,TRX_N-00032-82459776,2020-03-07T10:18:47,Zarautz,Basic services,gas,-31.87,-2471.39
buyer_2,Carmen,40,ES50209585267825676886,TRX_N-00033-70889380,2020-03-07T16:36:43,Zarautz,Basic services,internet,-66.89,-2538.28
buyer_2,Carmen,40,ES50209585267825676886,TRX_N-00034-37426366,2020-03-07T14:28:52,Zarautz,Basic services,phone,-91.04,-2629.32
buyer_2,Carmen,40,ES50209585267825676886,TRX_N-00035-64493890,2020-03-10T10:47:11,Zarautz,Expense,healthcare,-183.07,-2812.39
buyer_2,Carmen,40,ES50209585267825676886,TRX_N-00036-48815033,2020-03-12T10:49:07,Zarautz,Expense,food,-599.95,-3412.34
buyer_2,Carmen,40,ES50209585267825676886,TRX_N-00037-60259156,2020-03-16T17:20:31,Zarautz,Expense,travel,-568.34,-3980.68
buyer_2,Carmen,40,ES50209585267825676886,TRX_N-00038-24616015,2020-03-17T05:21:16,Zarautz,Expense,healthcare,-104.51,-4085.19
buyer_2,Carmen,40,ES50209585267825676886,TRX_N-00039-24334724,2020-04-01T10:56:24,Zarautz,transfer,Salary,1501.73,-2583.46
buyer_2,Carmen,40,ES50209585267825676886,TRX_N-00040-98909723,2020-04-05T18:03:31,Zarautz,Housing,Rent,-490.18,-3073.64
buyer_2,Carmen,40,ES50209585267825676886,TRX_N-00041-25033470,2020-04-05T18:27:56,Zarautz,Basic services,gas,-83.25,-3156.89
buyer_2,Carmen,40,ES50209585267825676886,TRX_N-00042-20246107,2020-04-05T15:34:56,Zarautz,Basic services,internet,-66.08,-3222.97
buyer_2,Carmen,40,ES50209585267825676886,TRX_N-00043-07577179,2020-04-06T13:52:09,Zarautz,Basic services,electricity,-89.44,-3312.41
buyer_2,Carmen,40,ES50209585267825676886,TRX_N-00044-31095251,2020-04-07T08:07:48,Zarautz,Basic services,internet,-49.53,-3361.94
buyer_2,Carmen,40,ES50209585267825676886,TRX_N-00045-41726849,2020-04-07T23:20:15,Zarautz,Expense,food,-648.58,-4010.52
buyer_2,Carmen,40,ES50209585267825676886,TRX_N-00046-03318188,2020-04-17T19:32:17,Zarautz,Expense,appliances,-450.25,-4460.77
buyer_2,Carmen,40,ES50209585267825676886,TRX_N-00047-47117619,2020-04-25T09:18:31,Zarautz,Expense,clothing,-173.02,-4633.79
buyer_2,Carmen,40,ES50209585267825676886,TRX_N-00048-70081023,2020-04-27T15:16:38,Zarautz,Expense,transport,-64.83,-4698.62
buyer_2,Carmen,40,ES50209585267825676886,TRX_N-00049-24891529,2020-05-01T09:30:42,Zarautz,transfer,Salary,1501.73,-3196.89
buyer_2,Carmen,40,ES50209585267825676886,TRX_N-00050-55735362,2020-05-05T21:36:24,Zarautz,Housing,Rent,-490.18,-3687.07
buyer_2,Carmen,40,ES50209585267825676886,TRX_N-00051-96979897,2020-05-05T11:50:28,Zarautz,Basic services,electricity,-110.07,-3797.14
buyer_2,Carmen,40,ES50209585267825676886,TRX_N-00052-99833177,2020-05-05T01:28:28,Mungia,Expense,food,-229.77,-4026.91
buyer_2,Carmen,40,ES50209585267825676886,TRX_N-00053-62779092,2020-05-07T01:53:16,Zarautz,Basic services,electricity,-133.92,-4160.83
buyer_2,Carmen,40,ES50209585267825676886,TRX_N-00054-12891528,2020-05-07T08:57:33,Zarautz,Basic services,phone,-32.07,-4192.9
buyer_2,Carmen,40,ES50209585267825676886,TRX_N-00055-89201044,2020-05-17T13:00:57,Zarautz,Expense,food,-392.96,-4585.86
buyer_2,Carmen,40,ES50209585267825676886,TRX_N-00056-92321764,2020-06-01T13:28:42,Zarautz,transfer,Salary,1501.73,-3084.13
buyer_2,Carmen,40,ES50209585267825676886,TRX_N-00057-29025666,2020-06-01T13:28:42,Zarautz,transfer,Extra Income,150.17,-2933.96
buyer_2,Carmen,40,ES50209585267825676886,TRX_N-00058-73769416,2020-06-01T13:28:42,Zarautz,transfer,Bonus,1600.57,-1333.39
buyer_2,Carmen,40,ES50209585267825676886,TRX_N-00059-30048439,2020-06-05T08:33:49,Zarautz,Housing,Rent,-490.18,-1823.57
buyer_2,Carmen,40,ES50209585267825676886,TRX_N-00060-53007842,2020-06-05T17:05:41,Zarautz,Basic services,water,-35.33,-1858.9
buyer_2,Carmen,40,ES50209585267825676886,TRX_N-00061-63801865,2020-06-05T04:12:31,Zarautz,Basic services,internet,-71.21,-1930.11
buyer_2,Carmen,40,ES50209585267825676886,TRX_N-00062-17156115,2020-06-05T17:40:37,Zarautz,Basic services,phone,-23.12,-1953.23
buyer_2,Carmen,40,ES50209585267825676886,TRX_N-00063-72697956,2020-06-06T11:24:40,Zarautz,Basic services,water,-23.47,-1976.7
buyer_2,Carmen,40,ES50209585267825676886,TRX_N-00064-29588290,2020-06-07T20:57:11,Zarautz,Basic services,water,-75.23,-2051.93
buyer_2,Carmen,40,ES50209585267825676886,TRX_N-00065-03362636,2020-06-07T19:01:38,Zarautz,Basic services,electricity,-96.68,-2148.61
buyer_2,Carmen,40,ES50209585267825676886,TRX_N-00066-61385894,2020-06-07T09:42:57,Zarautz,Basic services,gas,-93.45,-2242.06
buyer_2,Carmen,40,ES50209585267825676886,TRX_N-00067-66331584,2020-06-07T18:52:23,Zarautz,Basic services,internet,-44.59,-2286.65
buyer_2,Carmen,40,ES50209585267825676886,TRX_N-00068-80520062,2020-06-21T21:12:19,Zarautz,Expense,food,-688.93,-2975.58
buyer_2,Carmen,40,ES50209585267825676886,TRX_N-00069-81744938,2020-06-25T15:21:43,Zarautz,Expense,transport,-146.14,-3121.72
buyer_2,Carmen,40,ES50209585267825676886,TRX_N-00070-43719620,2020-07-01T11:49:19,Zarautz,transfer,Salary,1501.73,-1619.99
buyer_2,Carmen,40,ES50209585267825676886,TRX_N-00071-70743368,2020-07-03T17:01:09,Zarautz,Expense,travel,-786.34,-2406.33
buyer_2,Carmen,40,ES50209585267825676886,TRX_N-00072-54277233,2020-07-05T20:40:23,Zarautz,Housing,Rent,-490.18,-2896.51
buyer_2,Carmen,40,ES50209585267825676886,TRX_N-00073-06087699,2020-07-05T18:10:19,Zarautz,Basic services,internet,-36.07,-2932.58
buyer_2,Carmen,40,ES50209585267825676886,TRX_N-00074-90567745,2020-07-06T22:29:19,Zarautz,Basic services,water,-13.62,-2946.2
buyer_2,Carmen,40,ES50209585267825676886,TRX_N-00075-73025777,2020-07-06T09:56:47,Zarautz,Basic services,gas,-33.34,-2979.54
buyer_2,Carmen,40,ES50209585267825676886,TRX_N-00076-79452477,2020-07-06T21:18:00,Zarautz,Basic services,internet,-68.02,-3047.56
buyer_2,Carmen,40,ES50209585267825676886,TRX_N-00077-22800096,2020-07-06T20:33:14,Zarautz,Expense,education,-844.62,-3892.18
buyer_2,Carmen,40,ES50209585267825676886,TRX_N-00078-37389716,2020-07-07T19:39:37,Zarautz,Basic services,water,-22.18,-3914.36
buyer_2,Carmen,40,ES50209585267825676886,TRX_N-00079-71993045,2020-07-07T10:37:22,Zarautz,Basic services,internet,-36.43,-3950.79
buyer_2,Carmen,40,ES50209585267825676886,TRX_N-00080-69287816,2020-07-07T16:50:12,Zarautz,Basic services,phone,-40.15,-3990.94
buyer_2,Carmen,40,ES50209585267825676886,TRX_N-00081-90755037,2020-07-08T16:15:08,Zarautz,Expense,food,-460.11,-4451.05
buyer_2,Carmen,40,ES50209585267825676886,TRX_N-00082-32648138,2020-07-10T11:40:28,Zarautz,Expense,clothing,-435.05,-4886.1
buyer_2,Carmen,40,ES50209585267825676886,TRX_N-00083-24009183,2020-07-22T20:56:59,Zarautz,Expense,food,-338.29,-5224.39
buyer_2,Carmen,40,ES50209585267825676886,TRX_N-00084-64977145,2020-07-24T09:28:53,Zarautz,Expense,transport,-132.61,-5357.0
buyer_2,Carmen,40,ES50209585267825676886,TRX_N-00085-14961006,2020-08-01T09:09:44,Zarautz,transfer,Salary,1501.73,-3855.27
buyer_2,Carmen,40,ES50209585267825676886,TRX_N-00086-16548614,2020-08-01T09:09:44,Zarautz,transfer,Extra Income,150.17,-3705.1
buyer_2,Carmen,40,ES50209585267825676886,TRX_N-00087-93032668,2020-08-02T11:23:20,Zarautz,Expense,travel,-1268.06,-4973.16
buyer_2,Carmen,40,ES50209585267825676886,TRX_N-00088-92929036,2020-08-05T12:48:48,Zarautz,Housing,Rent,-490.18,-5463.34
buyer_2,Carmen,40,ES50209585267825676886,TRX_N-00089-13098293,2020-08-05T16:04:28,Zarautz,Basic services,gas,-90.08,-5553.42
buyer_2,Carmen,40,ES50209585267825676886,TRX_N-00090-59932559,2020-08-05T23:23:01,Zarautz,Basic services,internet,-61.58,-5615.0
buyer_2,Carmen,40,ES50209585267825676886,TRX_N-00091-37802148,2020-08-06T18:54:57,Zarautz,Basic services,electricity,-117.64,-5732.64
buyer_2,Carmen,40,ES50209585267825676886,TRX_N-00092-38311906,2020-08-07T08:08:17,Zarautz,Basic services,water,-20.34,-5752.98
buyer_2,Carmen,40,ES50209585267825676886,TRX_N-00093-79670021,2020-08-07T09:25:48,Zarautz,Basic services,electricity,-132.64,-5885.62
buyer_2,Carmen,40,ES50209585267825676886,TRX_N-00094-53886849,2020-08-07T08:22:51,Zarautz,Basic services,phone,-22.68,-5908.3
buyer_2,Carmen,40,ES50209585267825676886,TRX_N-00095-81638971,2020-08-20T17:43:47,Mungia,Expense,food,-459.81,-6368.11
buyer_2,Carmen,40,ES50209585267825676886,TRX_N-00096-33742166,2020-08-22T22:17:33,Zarautz,Expense,clothing,-418.24,-6786.35
buyer_2,Carmen,40,ES50209585267825676886,TRX_N-00097-44940653,2020-08-23T11:13:07,Zarautz,Expense,transport,-123.06,-6909.41
buyer_2,Carmen,40,ES50209585267825676886,TRX_N-00098-69653223,2020-08-30T06:58:45,Zarautz,Expense,food,-521.98,-7431.39
buyer_2,Carmen,40,ES50209585267825676886,TRX_N-00099-61983634,2020-09-01T14:03:47,Zarautz,transfer,Salary,1501.73,-5929.66
buyer_2,Carmen,40,ES50209585267825676886,TRX_N-00100-12566793,2020-09-03T15:02:24,Zarautz,Expense,healthcare,-33.4,-5963.06
buyer_2,Carmen,40,ES50209585267825676886,TRX_N-00101-83802882,2020-09-05T18:14:32,Zarautz,Housing,Rent,-490.18,-6453.24
buyer_2,Carmen,40,ES50209585267825676886,TRX_N-00102-39298980,2020-09-05T17:53:36,Zarautz,Basic services,electricity,-148.71,-6601.95
buyer_2,Carmen,40,ES50209585267825676886,TRX_N-00103-71082548,2020-09-05T11:51:38,Zarautz,Basic services,gas,-19.57,-6621.52
buyer_2,Carmen,40,ES50209585267825676886,TRX_N-00104-39164814,2020-09-06T14:49:01,Zarautz,Basic services,gas,-21.9,-6643.42
buyer_2,Carmen,40,ES50209585267825676886,TRX_N-00105-63522825,2020-09-06T14:13:32,Zarautz,Expense,food,-337.94,-6981.36
buyer_2,Carmen,40,ES50209585267825676886,TRX_N-00106-92354839,2020-09-07T20:00:42,Zarautz,Basic services,electricity,-83.01,-7064.37
buyer_2,Carmen,40,ES50209585267825676886,TRX_N-00107-00045220,2020-09-07T15:18:01,Zarautz,Basic services,gas,-98.58,-7162.95
buyer_2,Carmen,40,ES50209585267825676886,TRX_N-00108-84824273,2020-09-07T09:42:24,Zarautz,Basic services,phone,-60.41,-7223.36
buyer_2,Carmen,40,ES50209585267825676886,TRX_N-00109-69033117,2020-09-08T03:42:23,Zarautz,Expense,food,-682.91,-7906.27
buyer_2,Carmen,40,ES50209585267825676886,TRX_N-00110-38607618,2020-09-14T18:55:03,Zarautz,Expense,leisure,-73.71,-7979.98
buyer_2,Carmen,40,ES50209585267825676886,TRX_N-00111-09344813,2020-09-17T17:31:22,Zarautz,Expense,leisure,-232.04,-8212.02
buyer_2,Carmen,40,ES50209585267825676886,TRX_N-00112-30104786,2020-09-18T17:38:43,Zarautz,Expense,clothing,-116.52,-8328.54
buyer_2,Carmen,40,ES50209585267825676886,TRX_N-00113-65286423,2020-10-01T01:13:26,Zarautz,transfer,Salary,1501.73,-6826.81
buyer_2,Carmen,40,ES50209585267825676886,TRX_N-00114-95536015,2020-10-02T12:20:09,Zarautz,Expense,clothing,-101.72,-6928.53
buyer_2,Carmen,40,ES50209585267825676886,TRX_N-00115-65905271,2020-10-03T02:46:12,Zarautz,Expense,food,-435.17,-7363.7
buyer_2,Carmen,40,ES50209585267825676886,TRX_N-00116-65631475,2020-10-05T14:23:10,Zarautz,Housing,Rent,-490.18,-7853.88
buyer_2,Carmen,40,ES50209585267825676886,TRX_N-00117-07903996,2020-10-05T13:51:16,Zarautz,Basic services,electricity,-78.73,-7932.61
buyer_2,Carmen,40,ES50209585267825676886,TRX_N-00118-15458116,2020-10-05T17:31:51,Zarautz,Basic services,phone,-25.91,-7958.52
buyer_2,Carmen,40,ES50209585267825676886,TRX_N-00119-97511581,2020-10-06T18:24:18,Zarautz,Basic services,electricity,-107.48,-8066.0
buyer_2,Carmen,40,ES50209585267825676886,TRX_N-00120-59812662,2020-10-06T20:39:21,Zarautz,Basic services,internet,-66.11,-8132.11
buyer_2,Carmen,40,ES50209585267825676886,TRX_N-00121-89587847,2020-10-07T04:23:20,Zarautz,Basic services,water,-49.47,-8181.58
buyer_2,Carmen,40,ES50209585267825676886,TRX_N-00122-95103348,2020-10-07T14:00:24,Zarautz,Basic services,internet,-60.78,-8242.36
buyer_2,Carmen,40,ES50209585267825676886,TRX_N-00123-63832625,2020-10-07T10:47:28,Zarautz,Basic services,phone,-63.05,-8305.41
buyer_2,Carmen,40,ES50209585267825676886,TRX_N-00124-38208090,2020-10-07T20:08:07,Zarautz,Expense,food,-681.13,-8986.54
buyer_2,Carmen,40,ES50209585267825676886,TRX_N-00125-38975929,2020-10-09T08:21:50,Basauri,Expense,transport,-66.61,-9053.15
buyer_2,Carmen,40,ES50209585267825676886,TRX_N-00126-60164765,2020-10-17T18:13:33,Zarautz,Expense,food,-748.61,-9801.76
buyer_2,Carmen,40,ES50209585267825676886,TRX_N-00127-92302654,2020-10-21T17:01:33,Zarautz,Expense,repairs,-659.8,-10461.56
buyer_2,Carmen,40,ES50209585267825676886,TRX_N-00128-34291336,2020-11-01T15:18:12,Zarautz,transfer,Salary,1501.73,-8959.83
buyer_2,Carmen,40,ES50209585267825676886,TRX_N-00129-60936142,2020-11-01T15:18:12,Zarautz,transfer,Extra Income,150.17,-8809.66
buyer_2,Carmen,40,ES50209585267825676886,TRX_N-00130-23767441,2020-11-02T02:38:02,Zarautz,Expense,transport,-191.4,-9001.06
buyer_2,Carmen,40,ES50209585267825676886,TRX_N-00131-18317906,2020-11-05T09:46:33,Zarautz,Housing,Rent,-490.18,-9491.24
buyer_2,Carmen,40,ES50209585267825676886,TRX_N-00132-99642434,2020-11-05T08:41:14,Zarautz,Basic services,water,-78.7,-9569.94
buyer_2,Carmen,40,ES50209585267825676886,TRX_N-00133-77515030,2020-11-05T13:55:11,Zarautz,Basic services,electricity,-131.27,-9701.21
buyer_2,Carmen,40,ES50209585267825676886,TRX_N-00134-86030420,2020-11-05T18:46:03,Zarautz,Basic services,phone,-47.29,-9748.5
buyer_2,Carmen,40,ES50209585267825676886,TRX_N-00135-21470196,2020-11-06T18:50:06,Zarautz,Basic services,water,-79.01,-9827.51
buyer_2,Carmen,40,ES50209585267825676886,TRX_N-00136-82991922,2020-11-07T17:32:15,Zarautz,Basic services,phone,-30.17,-9857.68
buyer_2,Carmen,40,ES50209585267825676886,TRX_N-00137-20825921,2020-11-16T12:32:58,Zarautz,Expense,transport,-156.75,-10014.43
buyer_2,Carmen,40,ES50209585267825676886,TRX_N-00138-22118257,2020-11-25T20:48:44,Zarautz,Expense,transport,-165.26,-10179.69
buyer_2,Carmen,40,ES50209585267825676886,TRX_N-00139-94243336,2020-12-01T15:00:57,Zarautz,transfer,Salary,1501.73,-8677.96
buyer_2,Carmen,40,ES50209585267825676886,TRX_N-00140-11353397,2020-12-01T15:00:57,Zarautz,transfer,Bonus,1599.99,-7077.97
buyer_2,Carmen,40,ES50209585267825676886,TRX_N-00141-31075123,2020-12-05T11:47:32,Zarautz,Housing,Rent,-490.18,-7568.15
buyer_2,Carmen,40,ES50209585267825676886,TRX_N-00142-43144056,2020-12-05T12:17:31,Zarautz,Basic services,gas,-64.68,-7632.83
buyer_2,Carmen,40,ES50209585267825676886,TRX_N-00143-03893628,2020-12-05T01:43:40,Zarautz,Basic services,internet,-31.35,-7664.18
buyer_2,Carmen,40,ES50209585267825676886,TRX_N-00144-70104655,2020-12-17T19:23:26,Zarautz,Expense,travel,-2199.89,-9864.07
buyer_2,Carmen,40,ES50209585267825676886,TRX_N-00145-04994795,2021-01-01T14:42:39,Zarautz,transfer,Salary,1501.73,-8362.34
buyer_2,Carmen,40,ES50209585267825676886,TRX_N-00146-43657606,2021-01-01T14:42:39,Zarautz,transfer,Extra Income,150.17,-8212.17
buyer_2,Carmen,40,ES50209585267825676886,TRX_N-00147-95966641,2021-01-05T08:11:13,Zarautz,Housing,Rent,-490.18,-8702.35
buyer_2,Carmen,40,ES50209585267825676886,TRX_N-00148-36756174,2021-01-05T21:15:27,Zarautz,Basic services,electricity,-31.1,-8733.45
buyer_2,Carmen,40,ES50209585267825676886,TRX_N-00149-20046380,2021-01-05T08:30:30,Zarautz,Basic services,gas,-94.14,-8827.59
buyer_2,Carmen,40,ES50209585267825676886,TRX_N-00150-49746527,2021-01-07T14:38:08,Zarautz,Basic services,water,-62.37,-8889.96
buyer_2,Carmen,40,ES50209585267825676886,TRX_N-00151-05824275,2021-01-07T11:03:10,Zarautz,Basic services,electricity,-101.82,-8991.78
buyer_2,Carmen,40,ES50209585267825676886,TRX_N-00152-07397546,2021-01-08T09:47:52,Zarautz,Expense,transport,-142.46,-9134.24
buyer_2,Carmen,40,ES50209585267825676886,TRX_N-00153-26760301,2021-01-13T15:10:57,Portugalete,Expense,transport,-183.88,-9318.12
buyer_2,Carmen,40,ES50209585267825676886,TRX_N-00154-80230391,2021-01-14T08:54:01,Zarautz,Expense,healthcare,-214.86,-9532.98
buyer_2,Carmen,40,ES50209585267825676886,TRX_N-00155-79313277,2021-01-28T13:05:04,Irun,Expense,gifts,-471.78,-10004.76
buyer_2,Carmen,40,ES50209585267825676886,TRX_N-00156-13024719,2021-02-01T16:06:49,Zarautz,transfer,Salary,1501.73,-8503.03
buyer_2,Carmen,40,ES50209585267825676886,TRX_N-00157-82276214,2021-02-01T00:55:50,Zarautz,Expense,food,-185.15,-8688.18
buyer_2,Carmen,40,ES50209585267825676886,TRX_N-00158-92994663,2021-02-02T17:37:54,Eibar,Expense,leisure,-158.53,-8846.71
buyer_2,Carmen,40,ES50209585267825676886,TRX_N-00159-35865857,2021-02-05T09:59:34,Zarautz,Housing,Rent,-490.18,-9336.89
buyer_2,Carmen,40,ES50209585267825676886,TRX_N-00160-03004340,2021-02-05T16:39:55,Zarautz,Basic services,electricity,-78.13,-9415.02
buyer_2,Carmen,40,ES50209585267825676886,TRX_N-00161-79491811,2021-02-06T10:44:57,Zarautz,Basic services,electricity,-123.63,-9538.65
buyer_2,Carmen,40,ES50209585267825676886,TRX_N-00162-66285710,2021-02-07T18:38:48,Zarautz,Basic services,gas,-97.43,-9636.08
buyer_2,Carmen,40,ES50209585267825676886,TRX_N-00163-93861483,2021-02-07T19:46:21,Zarautz,Basic services,phone,-24.97,-9661.05
buyer_2,Carmen,40,ES50209585267825676886,TRX_N-00164-93268060,2021-02-12T16:53:33,Zarautz,Expense,transport,-184.61,-9845.66
buyer_2,Carmen,40,ES50209585267825676886,TRX_N-00165-43734586,2021-02-13T19:02:40,Zarautz,Expense,transport,-150.38,-9996.04
buyer_2,Carmen,40,ES50209585267825676886,TRX_N-00166-83099671,2021-02-13T16:50:46,Zarautz,Expense,leisure,-60.61,-10056.65
buyer_2,Carmen,40,ES50209585267825676886,TRX_N-00167-43741590,2021-02-28T20:03:28,Leioa,Expense,transport,-110.37,-10167.02
buyer_2,Carmen,40,ES50209585267825676886,TRX_N-00168-68409338,2021-03-01T13:46:15,Zarautz,transfer,Salary,1501.73,-8665.29
buyer_2,Carmen,40,ES50209585267825676886,TRX_N-00169-70118389,2021-03-01T13:46:15,Zarautz,transfer,Extra Income,150.17,-8515.12
buyer_2,Carmen,40,ES50209585267825676886,TRX_N-00170-35586530,2021-03-02T20:56:02,Zarautz,Expense,repairs,-315.1,-8830.22
buyer_2,Carmen,40,ES50209585267825676886,TRX_N-00171-27622503,2021-03-03T10:53:59,Zarautz,Expense,leisure,-170.38,-9000.6
buyer_2,Carmen,40,ES50209585267825676886,TRX_N-00172-33582220,2021-03-03T14:07:26,Zarautz,Expense,healthcare,-215.22,-9215.82
buyer_2,Carmen,40,ES50209585267825676886,TRX_N-00173-05505648,2021-03-05T01:14:30,Zarautz,Housing,Rent,-490.18,-9706.0
buyer_2,Carmen,40,ES50209585267825676886,TRX_N-00174-04610463,2021-03-05T18:53:25,Zarautz,Basic services,electricity,-62.22,-9768.22
buyer_2,Carmen,40,ES50209585267825676886,TRX_N-00175-95414851,2021-03-05T22:49:57,Zarautz,Basic services,phone,-20.83,-9789.05
buyer_2,Carmen,40,ES50209585267825676886,TRX_N-00176-13518190,2021-03-07T17:05:49,Zarautz,Basic services,electricity,-23.96,-9813.01
buyer_2,Carmen,40,ES50209585267825676886,TRX_N-00177-88212363,2021-03-07T00:29:05,Zarautz,Basic services,gas,-34.42,-9847.43
buyer_2,Carmen,40,ES50209585267825676886,TRX_N-00178-28539458,2021-03-07T12:47:53,Zarautz,Basic services,phone,-24.59,-9872.02
buyer_2,Carmen,40,ES50209585267825676886,TRX_N-00179-77976254,2021-03-11T02:29:35,Zarautz,Expense,gifts,-95.01,-9967.03
buyer_2,Carmen,40,ES50209585267825676886,TRX_N-00180-73952086,2021-03-20T12:49:25,Zarautz,Expense,healthcare,-41.2,-10008.23
buyer_2,Carmen,40,ES50209585267825676886,TRX_N-00181-38273920,2021-03-21T20:38:05,Zarautz,Expense,gifts,-219.69,-10227.92
buyer_2,Carmen,40,ES50209585267825676886,TRX_N-00182-36543074,2021-03-25T16:09:31,Zarautz,Expense,education,-674.1,-10902.02
buyer_2,Carmen,40,ES50209585267825676886,TRX_N-00183-23481341,2021-03-28T20:01:40,Zarautz,Expense,transport,-56.61,-10958.63
buyer_2,Carmen,40,ES50209585267825676886,TRX_N-00184-38299499,2021-04-01T16:54:56,Zarautz,transfer,Salary,1501.73,-9456.9
buyer_2,Carmen,40,ES50209585267825676886,TRX_N-00185-63245367,2021-04-05T14:11:29,Zarautz,Housing,Rent,-490.18,-9947.08
buyer_2,Carmen,40,ES50209585267825676886,TRX_N-00186-94689635,2021-04-05T12:01:38,Zarautz,Basic services,phone,-69.54,-10016.62
buyer_2,Carmen,40,ES50209585267825676886,TRX_N-00187-98588059,2021-04-06T08:30:48,Zarautz,Basic services,water,-50.65,-10067.27
buyer_2,Carmen,40,ES50209585267825676886,TRX_N-00188-33649415,2021-04-06T01:00:14,Zarautz,Basic services,gas,-77.73,-10145.0
buyer_2,Carmen,40,ES50209585267825676886,TRX_N-00189-60041424,2021-04-06T08:18:29,Zarautz,Basic services,phone,-30.59,-10175.59
buyer_2,Carmen,40,ES50209585267825676886,TRX_N-00190-96150303,2021-04-07T12:47:51,Zarautz,Basic services,water,-78.7,-10254.29
buyer_2,Carmen,40,ES50209585267825676886,TRX_N-00191-73370523,2021-04-07T10:39:24,Zarautz,Basic services,gas,-90.72,-10345.01
buyer_2,Carmen,40,ES50209585267825676886,TRX_N-00192-44702023,2021-04-08T14:19:59,Zarautz,Expense,food,-361.07,-10706.08
buyer_2,Carmen,40,ES50209585267825676886,TRX_N-00193-40191954,2021-04-08T19:26:01,Zarautz,Expense,transport,-70.32,-10776.4
buyer_2,Carmen,40,ES50209585267825676886,TRX_N-00194-75701129,2021-04-08T16:10:29,Zarautz,Expense,education,-728.15,-11504.55
buyer_2,Carmen,40,ES50209585267825676886,TRX_N-00195-40485116,2021-05-01T12:44:31,Zarautz,transfer,Salary,1501.73,-10002.82
buyer_2,Carmen,40,ES50209585267825676886,TRX_N-00196-13511006,2021-05-05T13:29:36,Zarautz,Housing,Rent,-490.18,-10493.0
buyer_2,Carmen,40,ES50209585267825676886,TRX_N-00197-40117213,2021-05-05T17:44:54,Zarautz,Basic services,water,-59.01,-10552.01
buyer_2,Carmen,40,ES50209585267825676886,TRX_N-00198-16846697,2021-05-05T14:41:20,Zarautz,Basic services,phone,-28.36,-10580.37
buyer_2,Carmen,40,ES50209585267825676886,TRX_N-00199-66316878,2021-05-06T16:31:41,Zarautz,Basic services,water,-64.23,-10644.6
buyer_2,Carmen,40,ES50209585267825676886,TRX_N-00200-48976551,2021-05-07T16:58:47,Zarautz,Basic services,water,-64.93,-10709.53
buyer_2,Carmen,40,ES50209585267825676886,TRX_N-00201-80409608,2021-05-07T12:20:10,Zarautz,Basic services,phone,-38.37,-10747.9
buyer_2,Carmen,40,ES50209585267825676886,TRX_N-00202-77530931,2021-05-16T11:53:44,Zarautz,Expense,education,-611.74,-11359.64
buyer_2,Carmen,40,ES50209585267825676886,TRX_N-00203-79198925,2021-05-19T06:43:20,Oyón-Oion,Expense,food,-568.01,-11927.65
buyer_2,Carmen,40,ES50209585267825676886,TRX_N-00204-21285241,2021-05-27T22:00:02,Elciego,Expense,food,-743.56,-12671.21
buyer_2,Carmen,40,ES50209585267825676886,TRX_N-00205-54875854,2021-05-31T18:01:20,Zarautz,Expense,food,-713.0,-13384.21
buyer_2,Carmen,40,ES50209585267825676886,TRX_N-00206-90926332,2021-06-01T10:49:06,Zarautz,transfer,Salary,1501.73,-11882.48
buyer_2,Carmen,40,ES50209585267825676886,TRX_N-00207-75828739,2021-06-01T10:49:06,Zarautz,transfer,Extra Income,150.17,-11732.31
buyer_2,Carmen,40,ES50209585267825676886,TRX_N-00208-10224100,2021-06-01T10:49:06,Zarautz,transfer,Bonus,1591.01,-10141.3
buyer_2,Carmen,40,ES50209585267825676886,TRX_N-00209-00002867,2021-06-05T21:39:27,Zarautz,Housing,Rent,-490.18,-10631.48
buyer_2,Carmen,40,ES50209585267825676886,TRX_N-00210-56524147,2021-06-05T17:37:31,Zarautz,Basic services,electricity,-23.57,-10655.05
buyer_2,Carmen,40,ES50209585267825676886,TRX_N-00211-51524152,2021-06-05T15:48:43,Zarautz,Basic services,phone,-22.25,-10677.3
buyer_2,Carmen,40,ES50209585267825676886,TRX_N-00212-27395477,2021-06-06T20:45:15,Zarautz,Basic services,electricity,-130.13,-10807.43
buyer_2,Carmen,40,ES50209585267825676886,TRX_N-00213-01963051,2021-06-07T17:54:39,Zarautz,Basic services,electricity,-32.41,-10839.84
buyer_2,Carmen,40,ES50209585267825676886,TRX_N-00214-44865308,2021-06-07T19:58:54,Zarautz,Basic services,internet,-32.58,-10872.42
buyer_2,Carmen,40,ES50209585267825676886,TRX_N-00215-15984818,2021-06-07T03:06:47,Zarautz,Basic services,phone,-82.94,-10955.36
buyer_2,Carmen,40,ES50209585267825676886,TRX_N-00216-20207298,2021-06-12T15:09:59,Santurtzi,Expense,transport,-122.52,-11077.88
buyer_2,Carmen,40,ES50209585267825676886,TRX_N-00217-11997700,2021-06-21T15:47:29,Zarautz,Expense,healthcare,-35.64,-11113.52
buyer_2,Carmen,40,ES50209585267825676886,TRX_N-00218-95093517,2021-06-29T15:36:34,Basauri,Expense,leisure,-203.23,-11316.75
buyer_2,Carmen,40,ES50209585267825676886,TRX_N-00219-64695136,2021-07-01T10:43:32,Zarautz,transfer,Salary,1501.73,-9815.02
buyer_2,Carmen,40,ES50209585267825676886,TRX_N-00220-47924033,2021-07-05T16:07:40,Zarautz,Housing,Rent,-490.18,-10305.2
buyer_2,Carmen,40,ES50209585267825676886,TRX_N-00221-81524068,2021-07-05T16:50:26,Zarautz,Basic services,gas,-30.75,-10335.95
buyer_2,Carmen,40,ES50209585267825676886,TRX_N-00222-31309450,2021-07-06T15:46:41,Zarautz,Basic services,internet,-30.71,-10366.66
buyer_2,Carmen,40,ES50209585267825676886,TRX_N-00223-86635085,2021-07-07T08:45:09,Zarautz,Basic services,electricity,-107.12,-10473.78
buyer_2,Carmen,40,ES50209585267825676886,TRX_N-00224-28784182,2021-07-18T18:53:47,Zarautz,Expense,leisure,-15.47,-10489.25
buyer_2,Carmen,40,ES50209585267825676886,TRX_N-00225-39437188,2021-07-27T19:41:39,Zarautz,Expense,food,-791.88,-11281.13
buyer_2,Carmen,40,ES50209585267825676886,TRX_N-00226-37270039,2021-07-28T09:56:13,Zarautz,Expense,food,-126.25,-11407.38
buyer_2,Carmen,40,ES50209585267825676886,TRX_N-00227-18229591,2021-07-28T19:45:31,Irun,Expense,leisure,-158.69,-11566.07
buyer_2,Carmen,40,ES50209585267825676886,TRX_N-00228-70942552,2021-08-01T04:37:51,Zarautz,transfer,Salary,1501.73,-10064.34
buyer_2,Carmen,40,ES50209585267825676886,TRX_N-00229-59928283,2021-08-01T04:37:51,Zarautz,transfer,Extra Income,150.17,-9914.17
buyer_2,Carmen,40,ES50209585267825676886,TRX_N-00230-99639615,2021-08-01T13:34:13,Zarautz,Expense,clothing,-312.62,-10226.79
buyer_2,Carmen,40,ES50209585267825676886,TRX_N-00231-10202815,2021-08-02T15:03:00,Zarautz,Expense,transport,-176.55,-10403.34
buyer_2,Carmen,40,ES50209585267825676886,TRX_N-00232-70325729,2021-08-05T12:29:58,Zarautz,Housing,Rent,-490.18,-10893.52
buyer_2,Carmen,40,ES50209585267825676886,TRX_N-00233-82707967,2021-08-05T14:43:59,Zarautz,Basic services,water,-61.88,-10955.4
buyer_2,Carmen,40,ES50209585267825676886,TRX_N-00234-54572203,2021-08-05T08:58:03,Zarautz,Basic services,phone,-73.56,-11028.96
buyer_2,Carmen,40,ES50209585267825676886,TRX_N-00235-57315181,2021-08-06T19:47:57,Zarautz,Basic services,water,-43.05,-11072.01
buyer_2,Carmen,40,ES50209585267825676886,TRX_N-00236-33655518,2021-08-07T14:47:46,Zarautz,Basic services,electricity,-39.49,-11111.5
buyer_2,Carmen,40,ES50209585267825676886,TRX_N-00237-99646734,2021-08-07T14:38:59,Zarautz,Basic services,gas,-16.47,-11127.97
buyer_2,Carmen,40,ES50209585267825676886,TRX_N-00238-57410762,2021-08-07T19:30:43,Zarautz,Basic services,internet,-74.2,-11202.17
buyer_2,Carmen,40,ES50209585267825676886,TRX_N-00239-47879976,2021-08-11T08:36:19,Elciego,Expense,food,-535.09,-11737.26
buyer_2,Carmen,40,ES50209585267825676886,TRX_N-00240-44511762,2021-09-01T13:09:30,Zarautz,transfer,Salary,1501.73,-10235.53
buyer_2,Carmen,40,ES50209585267825676886,TRX_N-00241-66962332,2021-09-05T11:42:38,Zarautz,Housing,Rent,-490.18,-10725.71
buyer_2,Carmen,40,ES50209585267825676886,TRX_N-00242-59170094,2021-09-05T15:40:36,Zarautz,Basic services,electricity,-122.01,-10847.72
buyer_2,Carmen,40,ES50209585267825676886,TRX_N-00243-92365396,2021-09-06T08:23:26,Zarautz,Basic services,gas,-49.1,-10896.82
buyer_2,Carmen,40,ES50209585267825676886,TRX_N-00244-51031178,2021-09-07T19:18:13,Zarautz,Basic services,water,-76.26,-10973.08
buyer_2,Carmen,40,ES50209585267825676886,TRX_N-00245-21002691,2021-09-07T09:16:13,Zarautz,Basic services,gas,-93.84,-11066.92
buyer_2,Carmen,40,ES50209585267825676886,TRX_N-00246-19078038,2021-09-07T12:42:42,Basauri,Expense,food,-332.39,-11399.31
buyer_2,Carmen,40,ES50209585267825676886,TRX_N-00247-68777062,2021-10-01T09:50:30,Zarautz,transfer,Salary,1501.73,-9897.58
buyer_2,Carmen,40,ES50209585267825676886,TRX_N-00248-52232701,2021-10-01T09:50:30,Zarautz,transfer,Extra Income,150.17,-9747.41
buyer_2,Carmen,40,ES50209585267825676886,TRX_N-00249-09136095,2021-10-05T08:00:48,Zarautz,Housing,Rent,-490.18,-10237.59
buyer_2,Carmen,40,ES50209585267825676886,TRX_N-00250-92542390,2021-10-05T19:04:54,Zarautz,Basic services,water,-49.57,-10287.16
buyer_2,Carmen,40,ES50209585267825676886,TRX_N-00251-01667022,2021-10-05T15:13:18,Zarautz,Basic services,internet,-62.07,-10349.23
buyer_2,Carmen,40,ES50209585267825676886,TRX_N-00252-37030120,2021-10-06T14:56:42,Zarautz,Basic services,water,-23.65,-10372.88
buyer_2,Carmen,40,ES50209585267825676886,TRX_N-00253-33428938,2021-10-06T13:13:18,Zarautz,Basic services,gas,-48.9,-10421.78
buyer_2,Carmen,40,ES50209585267825676886,TRX_N-00254-98157485,2021-10-06T15:18:23,Zarautz,Basic services,internet,-44.42,-10466.2
buyer_2,Carmen,40,ES50209585267825676886,TRX_N-00255-64982934,2021-10-06T08:08:44,Zarautz,Expense,repairs,-990.92,-11457.12
buyer_2,Carmen,40,ES50209585267825676886,TRX_N-00256-07191549,2021-10-07T01:02:23,Zarautz,Basic services,water,-44.18,-11501.3
buyer_2,Carmen,40,ES50209585267825676886,TRX_N-00257-16395365,2021-10-07T16:06:59,Zarautz,Basic services,electricity,-62.78,-11564.08
buyer_2,Carmen,40,ES50209585267825676886,TRX_N-00258-76481564,2021-10-09T23:35:57,Zarautz,Expense,food,-600.86,-12164.94
buyer_2,Carmen,40,ES50209585267825676886,TRX_N-00259-67628527,2021-10-19T11:47:03,Zarautz,Expense,food,-625.92,-12790.86
buyer_2,Carmen,40,ES50209585267825676886,TRX_N-00260-54041137,2021-10-31T10:50:25,Zarautz,Expense,leisure,-253.44,-13044.3
buyer_2,Carmen,40,ES50209585267825676886,TRX_N-00261-80143696,2021-11-01T08:44:20,Zarautz,transfer,Salary,1501.73,-11542.57
buyer_2,Carmen,40,ES50209585267825676886,TRX_N-00262-34220551,2021-11-05T16:36:43,Zarautz,Housing,Rent,-490.18,-12032.75
buyer_2,Carmen,40,ES50209585267825676886,TRX_N-00263-79505720,2021-11-05T18:30:58,Zarautz,Basic services,gas,-89.77,-12122.52
buyer_2,Carmen,40,ES50209585267825676886,TRX_N-00264-88601169,2021-11-05T16:22:42,Zarautz,Basic services,phone,-62.64,-12185.16
buyer_2,Carmen,40,ES50209585267825676886,TRX_N-00265-84859371,2021-11-05T12:16:16,Galdakao,Expense,transport,-36.78,-12221.94
buyer_2,Carmen,40,ES50209585267825676886,TRX_N-00266-67115557,2021-11-06T07:12:05,Zarautz,Basic services,gas,-19.96,-12241.9
buyer_2,Carmen,40,ES50209585267825676886,TRX_N-00267-66684704,2021-11-06T14:28:31,Zarautz,Basic services,phone,-67.15,-12309.05
buyer_2,Carmen,40,ES50209585267825676886,TRX_N-00268-92513052,2021-11-06T14:27:55,Zarautz,Expense,gifts,-78.39,-12387.44
buyer_2,Carmen,40,ES50209585267825676886,TRX_N-00269-21162204,2021-11-07T20:13:08,Zarautz,Basic services,electricity,-116.58,-12504.02
buyer_2,Carmen,40,ES50209585267825676886,TRX_N-00270-60415847,2021-11-07T14:57:34,Zarautz,Basic services,gas,-67.49,-12571.51
buyer_2,Carmen,40,ES50209585267825676886,TRX_N-00271-89939391,2021-11-07T11:06:08,Zarautz,Basic services,internet,-45.95,-12617.46
buyer_2,Carmen,40,ES50209585267825676886,TRX_N-00272-39632742,2021-11-16T10:12:56,Zarautz,Expense,food,-578.54,-13196.0
buyer_2,Carmen,40,ES50209585267825676886,TRX_N-00273-66909477,2021-11-16T14:07:59,Zarautz,Expense,transport,-164.4,-13360.4
buyer_2,Carmen,40,ES50209585267825676886,TRX_N-00274-78143375,2021-11-16T08:22:07,Zarautz,Expense,clothing,-469.59,-13829.99
buyer_2,Carmen,40,ES50209585267825676886,TRX_N-00275-28577528,2021-11-17T16:12:54,Pasaia,Expense,leisure,-33.82,-13863.81
buyer_2,Carmen,40,ES50209585267825676886,TRX_N-00276-70288829,2021-12-01T11:50:33,Zarautz,transfer,Salary,1501.73,-12362.08
buyer_2,Carmen,40,ES50209585267825676886,TRX_N-00277-05922553,2021-12-01T11:50:33,Zarautz,transfer,Extra Income,150.17,-12211.91
buyer_2,Carmen,40,ES50209585267825676886,TRX_N-00278-64758597,2021-12-01T11:50:33,Zarautz,transfer,Bonus,1604.31,-10607.6
buyer_2,Carmen,40,ES50209585267825676886,TRX_N-00279-42955685,2021-12-05T10:23:27,Zarautz,Housing,Rent,-490.18,-11097.78
buyer_2,Carmen,40,ES50209585267825676886,TRX_N-00280-04578229,2021-12-05T14:41:04,Zarautz,Basic services,phone,-82.07,-11179.85
buyer_2,Carmen,40,ES50209585267825676886,TRX_N-00281-12491924,2021-12-06T20:03:20,Zarautz,Basic services,electricity,-49.34,-11229.19
buyer_2,Carmen,40,ES50209585267825676886,TRX_N-00282-12211637,2021-12-06T13:11:34,Zarautz,Basic services,gas,-95.91,-11325.1
buyer_2,Carmen,40,ES50209585267825676886,TRX_N-00283-61446010,2021-12-06T10:56:01,Zarautz,Expense,clothing,-449.52,-11774.62
buyer_2,Carmen,40,ES50209585267825676886,TRX_N-00284-95387972,2021-12-07T15:56:30,Zarautz,Basic services,electricity,-114.69,-11889.31
buyer_2,Carmen,40,ES50209585267825676886,TRX_N-00285-32779175,2021-12-07T10:02:57,Zarautz,Basic services,gas,-92.58,-11981.89
buyer_2,Carmen,40,ES50209585267825676886,TRX_N-00286-79360144,2021-12-09T19:50:52,Iruña de Oca,Expense,transport,-98.29,-12080.18
buyer_2,Carmen,40,ES50209585267825676886,TRX_N-00287-48682926,2021-12-14T20:29:46,Durango,Expense,transport,-180.55,-12260.73
buyer_2,Carmen,40,ES50209585267825676886,TRX_N-00288-45431157,2021-12-25T09:44:50,Zarautz,Expense,clothing,-198.41,-12459.14
buyer_2,Carmen,40,ES50209585267825676886,TRX_N-00289-18530923,2022-01-01T11:38:38,Zarautz,transfer,Salary,1501.73,-10957.41
buyer_2,Carmen,40,ES50209585267825676886,TRX_N-00290-34902376,2022-01-05T03:00:51,Zarautz,Housing,Rent,-490.18,-11447.59
buyer_2,Carmen,40,ES50209585267825676886,TRX_N-00291-52451129,2022-01-05T06:55:09,Zarautz,Basic services,gas,-32.66,-11480.25
buyer_2,Carmen,40,ES50209585267825676886,TRX_N-00292-46332940,2022-01-05T18:56:10,Zarautz,Basic services,internet,-34.64,-11514.89
buyer_2,Carmen,40,ES50209585267825676886,TRX_N-00293-72401483,2022-01-05T18:43:41,Zarautz,Basic services,phone,-46.13,-11561.02
buyer_2,Carmen,40,ES50209585267825676886,TRX_N-00294-61595783,2022-01-06T03:10:07,Zarautz,Basic services,gas,-93.34,-11654.36
buyer_2,Carmen,40,ES50209585267825676886,TRX_N-00295-26934183,2022-01-07T17:07:30,Zarautz,Basic services,gas,-32.47,-11686.83
buyer_2,Carmen,40,ES50209585267825676886,TRX_N-00296-47581425,2022-01-07T08:32:20,Zarautz,Basic services,phone,-29.94,-11716.77
buyer_2,Carmen,40,ES50209585267825676886,TRX_N-00297-33941319,2022-02-01T22:04:10,Zarautz,transfer,Salary,1501.73,-10215.04
buyer_2,Carmen,40,ES50209585267825676886,TRX_N-00298-96123677,2022-02-05T06:43:50,Zarautz,Housing,Rent,-490.18,-10705.22
buyer_2,Carmen,40,ES50209585267825676886,TRX_N-00299-61722174,2022-02-05T10:28:27,Zarautz,Basic services,water,-75.37,-10780.59
buyer_2,Carmen,40,ES50209585267825676886,TRX_N-00300-60720292,2022-02-05T20:15:18,Zarautz,Basic services,phone,-98.93,-10879.52
buyer_2,Carmen,40,ES50209585267825676886,TRX_N-00301-41982068,2022-02-05T16:54:26,Donostia,Expense,leisure,-12.69,-10892.21
buyer_2,Carmen,40,ES50209585267825676886,TRX_N-00302-75135394,2022-02-06T12:56:25,Zarautz,Basic services,internet,-36.22,-10928.43
buyer_2,Carmen,40,ES50209585267825676886,TRX_N-00303-64645354,2022-02-07T11:24:12,Zarautz,Basic services,gas,-61.94,-10990.37
buyer_2,Carmen,40,ES50209585267825676886,TRX_N-00304-58645235,2022-02-18T12:43:09,Zarautz,Expense,leisure,-84.71,-11075.08
buyer_2,Carmen,40,ES50209585267825676886,TRX_N-00305-35703717,2022-02-20T19:25:28,Zarautz,Expense,food,-684.36,-11759.44
buyer_2,Carmen,40,ES50209585267825676886,TRX_N-00306-85966467,2022-02-22T15:20:25,Donostia,Expense,transport,-48.93,-11808.37
buyer_2,Carmen,40,ES50209585267825676886,TRX_N-00307-73133924,2022-02-26T13:13:42,Zarautz,Expense,transport,-41.54,-11849.91
buyer_2,Carmen,40,ES50209585267825676886,TRX_N-00308-45668881,2022-02-28T13:24:11,Zuia,Expense,food,-224.55,-12074.46
buyer_2,Carmen,40,ES50209585267825676886,TRX_N-00309-79223122,2022-03-01T02:50:30,Zarautz,transfer,Salary,1501.73,-10572.73
buyer_2,Carmen,40,ES50209585267825676886,TRX_N-00310-59355215,2022-03-01T02:50:30,Zarautz,transfer,Extra Income,150.17,-10422.56
buyer_2,Carmen,40,ES50209585267825676886,TRX_N-00311-10407015,2022-03-02T13:57:57,Zarautz,Expense,leisure,-101.44,-10524.0
buyer_2,Carmen,40,ES50209585267825676886,TRX_N-00312-19228224,2022-03-03T21:12:10,Zarautz,Expense,transport,-136.42,-10660.42
buyer_2,Carmen,40,ES50209585267825676886,TRX_N-00313-89812103,2022-03-04T11:19:06,Zarautz,Expense,clothing,-376.25,-11036.67
buyer_2,Carmen,40,ES50209585267825676886,TRX_N-00314-33964538,2022-03-05T15:53:01,Zarautz,Housing,Rent,-490.18,-11526.85
buyer_2,Carmen,40,ES50209585267825676886,TRX_N-00315-59845677,2022-03-05T09:25:25,Zarautz,Basic services,water,-20.89,-11547.74
buyer_2,Carmen,40,ES50209585267825676886,TRX_N-00316-77853417,2022-03-05T14:29:21,Zarautz,Basic services,electricity,-59.49,-11607.23
buyer_2,Carmen,40,ES50209585267825676886,TRX_N-00317-31408330,2022-03-05T18:29:04,Zarautz,Basic services,internet,-31.8,-11639.03
buyer_2,Carmen,40,ES50209585267825676886,TRX_N-00318-63273588,2022-03-05T20:50:21,Zarautz,Basic services,phone,-25.74,-11664.77
buyer_2,Carmen,40,ES50209585267825676886,TRX_N-00319-95883109,2022-03-06T08:08:35,Zarautz,Basic services,electricity,-60.64,-11725.41
buyer_2,Carmen,40,ES50209585267825676886,TRX_N-00320-60973219,2022-03-06T10:46:54,Zarautz,Basic services,phone,-72.4,-11797.81
buyer_2,Carmen,40,ES50209585267825676886,TRX_N-00321-88374259,2022-03-10T19:31:18,Zarautz,Expense,food,-730.09,-12527.9
buyer_2,Carmen,40,ES50209585267825676886,TRX_N-00322-37437369,2022-03-18T17:50:53,Zarautz,Expense,travel,-2159.82,-14687.72
buyer_2,Carmen,40,ES50209585267825676886,TRX_N-00323-75418078,2022-04-01T10:34:58,Zarautz,transfer,Salary,1501.73,-13185.99
buyer_2,Carmen,40,ES50209585267825676886,TRX_N-00324-51593096,2022-04-04T09:26:06,Zarautz,Expense,repairs,-863.68,-14049.67
buyer_2,Carmen,40,ES50209585267825676886,TRX_N-00325-55840624,2022-04-05T09:54:06,Zarautz,Housing,Rent,-490.18,-14539.85
buyer_2,Carmen,40,ES50209585267825676886,TRX_N-00326-54422353,2022-04-07T04:03:04,Zarautz,Basic services,electricity,-135.83,-14675.68
buyer_2,Carmen,40,ES50209585267825676886,TRX_N-00327-06947559,2022-04-07T01:21:30,Labastida,Expense,leisure,-33.94,-14709.62
buyer_2,Carmen,40,ES50209585267825676886,TRX_N-00328-49235104,2022-04-22T10:50:17,Zarautz,Expense,gifts,-129.31,-14838.93
buyer_2,Carmen,40,ES50209585267825676886,TRX_N-00329-13827682,2022-04-29T14:25:04,Zarautz,Expense,clothing,-98.18,-14937.11
buyer_2,Carmen,40,ES50209585267825676886,TRX_N-00330-97801648,2022-04-30T09:32:28,Zarautz,Expense,leisure,-297.68,-15234.79
buyer_2,Carmen,40,ES50209585267825676886,TRX_N-00331-64749265,2022-05-01T22:32:16,Zarautz,transfer,Salary,1501.73,-13733.06
buyer_2,Carmen,40,ES50209585267825676886,TRX_N-00332-55924629,2022-05-05T14:31:28,Zarautz,Housing,Rent,-490.18,-14223.24
buyer_2,Carmen,40,ES50209585267825676886,TRX_N-00333-24289123,2022-05-05T20:11:24,Zarautz,Basic services,electricity,-135.41,-14358.65
buyer_2,Carmen,40,ES50209585267825676886,TRX_N-00334-53864999,2022-05-05T14:50:29,Zarautz,Basic services,phone,-68.09,-14426.74
buyer_2,Carmen,40,ES50209585267825676886,TRX_N-00335-96354484,2022-05-05T16:21:32,Zarautz,Expense,repairs,-512.18,-14938.92
buyer_2,Carmen,40,ES50209585267825676886,TRX_N-00336-59555074,2022-05-06T18:49:16,Zarautz,Basic services,electricity,-89.18,-15028.1
buyer_2,Carmen,40,ES50209585267825676886,TRX_N-00337-79105797,2022-05-06T15:12:36,Zarautz,Basic services,internet,-38.93,-15067.03
buyer_2,Carmen,40,ES50209585267825676886,TRX_N-00338-79221684,2022-05-06T08:01:21,Zarautz,Basic services,phone,-46.62,-15113.65
buyer_2,Carmen,40,ES50209585267825676886,TRX_N-00339-21665813,2022-05-07T17:20:38,Zarautz,Basic services,phone,-51.76,-15165.41
buyer_2,Carmen,40,ES50209585267825676886,TRX_N-00340-60264064,2022-05-26T12:19:49,Zarautz,Expense,food,-534.51,-15699.92
buyer_2,Carmen,40,ES50209585267825676886,TRX_N-00341-66303300,2022-05-28T09:45:17,Zarautz,Expense,repairs,-224.88,-15924.8
buyer_2,Carmen,40,ES50209585267825676886,TRX_N-00342-35189909,2022-06-01T08:11:27,Zarautz,transfer,Salary,1501.73,-14423.07
buyer_2,Carmen,40,ES50209585267825676886,TRX_N-00343-94527323,2022-06-01T08:11:27,Zarautz,transfer,Extra Income,150.17,-14272.9
buyer_2,Carmen,40,ES50209585267825676886,TRX_N-00344-59908926,2022-06-01T08:11:27,Zarautz,transfer,Bonus,1389.77,-12883.13
buyer_2,Carmen,40,ES50209585267825676886,TRX_N-00345-70263396,2022-06-01T17:09:24,Zarautz,Expense,clothing,-69.8,-12952.93
buyer_2,Carmen,40,ES50209585267825676886,TRX_N-00346-81143200,2022-06-05T13:02:28,Zarautz,Housing,Rent,-490.18,-13443.11
buyer_2,Carmen,40,ES50209585267825676886,TRX_N-00347-40666445,2022-06-06T16:26:42,Zarautz,Basic services,gas,-68.67,-13511.78
buyer_2,Carmen,40,ES50209585267825676886,TRX_N-00348-44632935,2022-06-06T18:48:27,Zarautz,Basic services,phone,-35.27,-13547.05
buyer_2,Carmen,40,ES50209585267825676886,TRX_N-00349-31471505,2022-06-07T09:08:19,Zarautz,Basic services,water,-69.7,-13616.75
buyer_2,Carmen,40,ES50209585267825676886,TRX_N-00350-48818347,2022-06-13T19:57:57,Zarautz,Expense,transport,-195.63,-13812.38
buyer_2,Carmen,40,ES50209585267825676886,TRX_N-00351-25610987,2022-06-22T09:09:21,Zarautz,Expense,leisure,-66.81,-13879.19
buyer_2,Carmen,40,ES50209585267825676886,TRX_N-00352-02457663,2022-07-01T16:12:47,Zarautz,transfer,Salary,1501.73,-12377.46
buyer_2,Carmen,40,ES50209585267825676886,TRX_N-00353-43850879,2022-07-05T20:30:57,Zarautz,Housing,Rent,-490.18,-12867.64
buyer_2,Carmen,40,ES50209585267825676886,TRX_N-00354-87529615,2022-07-05T17:34:19,Zarautz,Basic services,water,-36.12,-12903.76
buyer_2,Carmen,40,ES50209585267825676886,TRX_N-00355-56438262,2022-07-05T10:31:21,Zarautz,Basic services,phone,-72.76,-12976.52
buyer_2,Carmen,40,ES50209585267825676886,TRX_N-00356-75009172,2022-07-06T11:26:09,Zarautz,Basic services,internet,-58.06,-13034.58
buyer_2,Carmen,40,ES50209585267825676886,TRX_N-00357-48421861,2022-07-07T18:37:55,Zarautz,Basic services,electricity,-69.06,-13103.64
buyer_2,Carmen,40,ES50209585267825676886,TRX_N-00358-97023779,2022-07-15T12:29:49,Zarautz,Expense,leisure,-254.51,-13358.15
buyer_2,Carmen,40,ES50209585267825676886,TRX_N-00359-87577747,2022-07-21T14:10:22,Zuia,Expense,food,-212.84,-13570.99
buyer_2,Carmen,40,ES50209585267825676886,TRX_N-00360-25896509,2022-08-01T11:11:59,Zarautz,transfer,Salary,1501.73,-12069.26
buyer_2,Carmen,40,ES50209585267825676886,TRX_N-00361-48284125,2022-08-01T11:11:59,Zarautz,transfer,Extra Income,150.17,-11919.09
buyer_2,Carmen,40,ES50209585267825676886,TRX_N-00362-23492957,2022-08-05T09:34:32,Zarautz,Housing,Rent,-490.18,-12409.27
buyer_2,Carmen,40,ES50209585267825676886,TRX_N-00363-93820464,2022-08-05T09:35:55,Zarautz,Basic services,electricity,-123.14,-12532.41
buyer_2,Carmen,40,ES50209585267825676886,TRX_N-00364-01242939,2022-08-05T14:43:29,Zarautz,Basic services,phone,-68.66,-12601.07
buyer_2,Carmen,40,ES50209585267825676886,TRX_N-00365-74851140,2022-08-06T17:08:11,Zarautz,Basic services,water,-49.04,-12650.11
buyer_2,Carmen,40,ES50209585267825676886,TRX_N-00366-25295339,2022-08-07T17:13:00,Zarautz,Basic services,internet,-45.4,-12695.51
buyer_2,Carmen,40,ES50209585267825676886,TRX_N-00367-58835095,2022-08-16T18:49:37,Zarautz,Expense,education,-144.52,-12840.03
buyer_2,Carmen,40,ES50209585267825676886,TRX_N-00368-78407688,2022-08-17T20:32:26,Zarautz,Expense,transport,-186.53,-13026.56
buyer_2,Carmen,40,ES50209585267825676886,TRX_N-00369-52115288,2022-08-24T16:09:30,Zarautz,Expense,transport,-175.83,-13202.39
buyer_2,Carmen,40,ES50209585267825676886,TRX_N-00370-90512162,2022-09-01T14:58:46,Zarautz,transfer,Salary,1501.73,-11700.66
buyer_2,Carmen,40,ES50209585267825676886,TRX_N-00371-16547177,2022-09-05T00:40:15,Zarautz,Housing,Rent,-490.18,-12190.84
buyer_2,Carmen,40,ES50209585267825676886,TRX_N-00372-19586763,2022-09-05T11:23:29,Zarautz,Basic services,water,-13.39,-12204.23
buyer_2,Carmen,40,ES50209585267825676886,TRX_N-00373-49586965,2022-09-05T18:14:37,Zarautz,Basic services,gas,-52.32,-12256.55
buyer_2,Carmen,40,ES50209585267825676886,TRX_N-00374-08902416,2022-09-05T00:07:00,Zarautz,Basic services,internet,-60.64,-12317.19
buyer_2,Carmen,40,ES50209585267825676886,TRX_N-00375-83980946,2022-09-05T09:06:40,Zarautz,Basic services,phone,-67.51,-12384.7
buyer_2,Carmen,40,ES50209585267825676886,TRX_N-00376-03256339,2022-09-06T09:51:32,Zarautz,Basic services,electricity,-65.89,-12450.59
buyer_2,Carmen,40,ES50209585267825676886,TRX_N-00377-50096711,2022-09-07T17:37:40,Zarautz,Basic services,internet,-72.25,-12522.84
buyer_2,Carmen,40,ES50209585267825676886,TRX_N-00378-00325719,2022-09-10T10:29:08,Zarautz,Expense,food,-548.54,-13071.38
buyer_2,Carmen,40,ES50209585267825676886,TRX_N-00379-61566813,2022-09-20T12:24:07,Zarautz,Expense,healthcare,-348.69,-13420.07
buyer_2,Carmen,40,ES50209585267825676886,TRX_N-00380-40834789,2022-10-01T10:11:09,Zarautz,transfer,Salary,1501.73,-11918.34
buyer_2,Carmen,40,ES50209585267825676886,TRX_N-00381-86083510,2022-10-01T10:11:09,Zarautz,transfer,Extra Income,150.17,-11768.17
buyer_2,Carmen,40,ES50209585267825676886,TRX_N-00382-02954660,2022-10-02T17:25:08,Zarautz,Expense,food,-604.36,-12372.53
buyer_2,Carmen,40,ES50209585267825676886,TRX_N-00383-46961472,2022-10-05T09:13:12,Zarautz,Housing,Rent,-490.18,-12862.71
buyer_2,Carmen,40,ES50209585267825676886,TRX_N-00384-44921658,2022-10-05T19:56:58,Zarautz,Basic services,water,-68.18,-12930.89
buyer_2,Carmen,40,ES50209585267825676886,TRX_N-00385-27876360,2022-10-05T19:16:57,Zarautz,Basic services,electricity,-75.34,-13006.23
buyer_2,Carmen,40,ES50209585267825676886,TRX_N-00386-03773953,2022-10-05T19:26:23,Zarautz,Basic services,internet,-72.39,-13078.62
buyer_2,Carmen,40,ES50209585267825676886,TRX_N-00387-04356044,2022-10-06T19:14:14,Zarautz,Basic services,electricity,-81.54,-13160.16
buyer_2,Carmen,40,ES50209585267825676886,TRX_N-00388-06071731,2022-10-06T12:53:58,Zarautz,Basic services,phone,-76.9,-13237.06
buyer_2,Carmen,40,ES50209585267825676886,TRX_N-00389-72455553,2022-10-07T23:46:41,Zarautz,Basic services,water,-29.62,-13266.68
buyer_2,Carmen,40,ES50209585267825676886,TRX_N-00390-59562794,2022-10-07T16:01:22,Basauri,Expense,healthcare,-225.67,-13492.35
buyer_2,Carmen,40,ES50209585267825676886,TRX_N-00391-95649338,2022-10-12T15:13:30,Zarautz,Expense,leisure,-159.86,-13652.21
buyer_2,Carmen,40,ES50209585267825676886,TRX_N-00392-14608580,2022-10-18T19:49:19,Zarautz,Expense,healthcare,-171.07,-13823.28
buyer_2,Carmen,40,ES50209585267825676886,TRX_N-00393-85614649,2022-10-19T04:46:35,Santurtzi,Expense,leisure,-130.96,-13954.24
buyer_2,Carmen,40,ES50209585267825676886,TRX_N-00394-91491056,2022-10-21T18:49:58,Zarautz,Expense,healthcare,-363.85,-14318.09
buyer_2,Carmen,40,ES50209585267825676886,TRX_N-00395-75878037,2022-11-01T15:58:02,Zarautz,transfer,Salary,1501.73,-12816.36
buyer_2,Carmen,40,ES50209585267825676886,TRX_N-00396-78059854,2022-11-05T12:30:19,Zarautz,Housing,Rent,-490.18,-13306.54
buyer_2,Carmen,40,ES50209585267825676886,TRX_N-00397-59083329,2022-11-05T20:36:23,Zarautz,Basic services,gas,-55.82,-13362.36
buyer_2,Carmen,40,ES50209585267825676886,TRX_N-00398-55114013,2022-11-06T16:42:40,Zarautz,Basic services,electricity,-115.91,-13478.27
buyer_2,Carmen,40,ES50209585267825676886,TRX_N-00399-03752312,2022-11-06T11:38:29,Zarautz,Basic services,gas,-36.62,-13514.89
buyer_2,Carmen,40,ES50209585267825676886,TRX_N-00400-21265343,2022-11-07T19:55:19,Zarautz,Basic services,gas,-83.58,-13598.47
buyer_2,Carmen,40,ES50209585267825676886,TRX_N-00401-85876950,2022-11-07T15:28:38,Zarautz,Basic services,phone,-82.13,-13680.6
buyer_2,Carmen,40,ES50209585267825676886,TRX_N-00402-36601108,2022-11-07T08:08:17,Zarautz,Expense,clothing,-207.47,-13888.07
buyer_2,Carmen,40,ES50209585267825676886,TRX_N-00403-93624677,2022-11-08T08:37:53,Zarautz,Expense,transport,-67.73,-13955.8
buyer_2,Carmen,40,ES50209585267825676886,TRX_N-00404-59007670,2022-11-14T13:25:12,Zarautz,Expense,food,-698.42,-14654.22
buyer_2,Carmen,40,ES50209585267825676886,TRX_N-00405-82738758,2022-11-16T17:21:17,Zarautz,Expense,healthcare,-93.4,-14747.62
buyer_2,Carmen,40,ES50209585267825676886,TRX_N-00406-12018248,2022-11-22T11:42:06,Zarautz,Expense,food,-593.05,-15340.67
buyer_2,Carmen,40,ES50209585267825676886,TRX_N-00407-06461802,2022-11-22T19:33:53,Bermeo,Expense,transport,-63.75,-15404.42
buyer_2,Carmen,40,ES50209585267825676886,TRX_N-00408-01061570,2022-11-25T15:38:52,Zarautz,Expense,food,-783.15,-16187.57
buyer_2,Carmen,40,ES50209585267825676886,TRX_N-00409-23820824,2022-12-01T08:15:07,Zarautz,transfer,Salary,1501.73,-14685.84
buyer_2,Carmen,40,ES50209585267825676886,TRX_N-00410-09627616,2022-12-01T08:15:07,Zarautz,transfer,Extra Income,150.17,-14535.67
buyer_2,Carmen,40,ES50209585267825676886,TRX_N-00411-62660211,2022-12-01T08:15:07,Zarautz,transfer,Bonus,1379.92,-13155.75
buyer_2,Carmen,40,ES50209585267825676886,TRX_N-00412-67823321,2022-12-05T15:54:10,Zarautz,Housing,Rent,-490.18,-13645.93
buyer_2,Carmen,40,ES50209585267825676886,TRX_N-00413-66831400,2022-12-05T13:06:30,Zarautz,Basic services,electricity,-45.91,-13691.84
buyer_2,Carmen,40,ES50209585267825676886,TRX_N-00414-98996452,2022-12-05T12:43:47,Zarautz,Basic services,gas,-55.93,-13747.77
buyer_2,Carmen,40,ES50209585267825676886,TRX_N-00415-33777144,2022-12-06T22:07:58,Zarautz,Basic services,water,-50.72,-13798.49
buyer_2,Carmen,40,ES50209585267825676886,TRX_N-00416-48035428,2022-12-06T10:13:35,Zarautz,Basic services,gas,-71.82,-13870.31
buyer_2,Carmen,40,ES50209585267825676886,TRX_N-00417-86323696,2022-12-06T13:31:38,Zarautz,Basic services,internet,-37.45,-13907.76
buyer_2,Carmen,40,ES50209585267825676886,TRX_N-00418-71956099,2022-12-06T21:43:04,Zarautz,Basic services,phone,-48.5,-13956.26
buyer_2,Carmen,40,ES50209585267825676886,TRX_N-00419-11203731,2022-12-07T13:48:29,Zarautz,Basic services,gas,-50.1,-14006.36
buyer_2,Carmen,40,ES50209585267825676886,TRX_N-00420-53932422,2022-12-07T08:06:02,Zarautz,Basic services,internet,-78.6,-14084.96
buyer_2,Carmen,40,ES50209585267825676886,TRX_N-00421-25844804,2022-12-23T02:38:48,Zarautz,Expense,food,-177.9,-14262.86
buyer_2,Carmen,40,ES50209585267825676886,TRX_N-00422-24188275,2023-01-01T20:31:47,Zarautz,transfer,Salary,1501.73,-12761.13
buyer_2,Carmen,40,ES50209585267825676886,TRX_N-00423-70579721,2023-01-02T11:31:43,Zarautz,Expense,clothing,-187.32,-12948.45
buyer_2,Carmen,40,ES50209585267825676886,TRX_N-00424-25417522,2023-01-05T08:24:49,Zarautz,Housing,Rent,-490.18,-13438.63
buyer_2,Carmen,40,ES50209585267825676886,TRX_N-00425-01692853,2023-01-06T14:31:28,Zarautz,Basic services,water,-77.08,-13515.71
buyer_2,Carmen,40,ES50209585267825676886,TRX_N-00426-09858217,2023-01-07T17:03:34,Zarautz,Basic services,water,-29.47,-13545.18
buyer_2,Carmen,40,ES50209585267825676886,TRX_N-00427-18501180,2023-01-07T20:43:52,Zarautz,Basic services,phone,-29.93,-13575.11
buyer_2,Carmen,40,ES50209585267825676886,TRX_N-00428-42579083,2023-01-23T14:47:26,Zarautz,Expense,transport,-159.37,-13734.48
buyer_2,Carmen,40,ES50209585267825676886,TRX_N-00429-46028092,2023-01-26T13:53:35,Zarautz,Expense,leisure,-171.23,-13905.71
buyer_2,Carmen,40,ES50209585267825676886,TRX_N-00430-77453103,2023-02-01T19:26:38,Zarautz,transfer,Salary,1501.73,-12403.98
buyer_2,Carmen,40,ES50209585267825676886,TRX_N-00431-16118015,2023-02-01T19:26:38,Zarautz,transfer,Extra Income,150.17,-12253.81
buyer_2,Carmen,40,ES50209585267825676886,TRX_N-00432-75455642,2023-02-05T12:53:42,Zarautz,Housing,Rent,-490.18,-12743.99
buyer_2,Carmen,40,ES50209585267825676886,TRX_N-00433-12609766,2023-02-05T19:51:02,Zarautz,Basic services,electricity,-145.66,-12889.65
buyer_2,Carmen,40,ES50209585267825676886,TRX_N-00434-95737798,2023-02-05T23:11:02,Zarautz,Basic services,phone,-43.5,-12933.15
buyer_2,Carmen,40,ES50209585267825676886,TRX_N-00435-19128347,2023-02-06T17:37:02,Zarautz,Basic services,electricity,-146.71,-13079.86
buyer_2,Carmen,40,ES50209585267825676886,TRX_N-00436-69164470,2023-02-06T23:52:27,Zarautz,Basic services,internet,-78.92,-13158.78
buyer_2,Carmen,40,ES50209585267825676886,TRX_N-00437-68567810,2023-02-07T19:49:17,Zarautz,Basic services,water,-31.42,-13190.2
buyer_2,Carmen,40,ES50209585267825676886,TRX_N-00438-26197675,2023-02-13T22:41:41,Zarautz,Expense,education,-435.09,-13625.29
buyer_2,Carmen,40,ES50209585267825676886,TRX_N-00439-23733365,2023-02-15T23:44:42,Zarautz,Expense,leisure,-252.53,-13877.82
buyer_2,Carmen,40,ES50209585267825676886,TRX_N-00440-10196157,2023-02-17T08:44:10,Zarautz,Expense,healthcare,-191.4,-14069.22
buyer_2,Carmen,40,ES50209585267825676886,TRX_N-00441-75292552,2023-02-26T14:29:28,Alegría-Dulantzi,Expense,clothing,-209.75,-14278.97
buyer_2,Carmen,40,ES50209585267825676886,TRX_N-00442-69893628,2023-03-01T21:40:02,Zarautz,transfer,Salary,1501.73,-12777.24
buyer_2,Carmen,40,ES50209585267825676886,TRX_N-00443-09663207,2023-03-05T10:16:33,Zarautz,Housing,Rent,-490.18,-13267.42
buyer_2,Carmen,40,ES50209585267825676886,TRX_N-00444-34231752,2023-03-05T18:17:04,Zarautz,Basic services,electricity,-113.23,-13380.65
buyer_2,Carmen,40,ES50209585267825676886,TRX_N-00445-06990844,2023-03-05T09:30:24,Zarautz,Basic services,gas,-95.98,-13476.63
buyer_2,Carmen,40,ES50209585267825676886,TRX_N-00446-66842809,2023-03-05T21:00:10,Zarautz,Basic services,internet,-47.55,-13524.18
buyer_2,Carmen,40,ES50209585267825676886,TRX_N-00447-16907697,2023-03-06T21:35:21,Zarautz,Basic services,water,-47.32,-13571.5
buyer_2,Carmen,40,ES50209585267825676886,TRX_N-00448-28668706,2023-03-06T10:21:28,Zarautz,Basic services,gas,-30.72,-13602.22
buyer_2,Carmen,40,ES50209585267825676886,TRX_N-00449-79239250,2023-03-06T20:42:29,Zarautz,Basic services,phone,-24.82,-13627.04
buyer_2,Carmen,40,ES50209585267825676886,TRX_N-00450-16531428,2023-03-07T17:38:13,Zarautz,Basic services,water,-26.13,-13653.17
buyer_2,Carmen,40,ES50209585267825676886,TRX_N-00451-14057403,2023-03-07T16:35:40,Zarautz,Basic services,electricity,-24.81,-13677.98
buyer_2,Carmen,40,ES50209585267825676886,TRX_N-00452-45135370,2023-03-07T20:42:06,Zarautz,Basic services,phone,-77.33,-13755.31
buyer_2,Carmen,40,ES50209585267825676886,TRX_N-00453-65266315,2023-03-23T06:22:35,Zarautz,Expense,gifts,-395.23,-14150.54
buyer_2,Carmen,40,ES50209585267825676886,TRX_N-00454-76073028,2023-03-26T13:46:33,Zarautz,Expense,travel,-735.66,-14886.2
buyer_2,Carmen,40,ES50209585267825676886,TRX_N-00455-90157255,2023-03-30T20:36:41,Lasarte-Oria,Expense,healthcare,-92.11,-14978.31
buyer_2,Carmen,40,ES50209585267825676886,TRX_N-00456-26172174,2023-04-01T13:43:48,Zarautz,transfer,Salary,1501.73,-13476.58
buyer_2,Carmen,40,ES50209585267825676886,TRX_N-00457-29731940,2023-04-01T13:43:48,Zarautz,transfer,Extra Income,150.17,-13326.41
buyer_2,Carmen,40,ES50209585267825676886,TRX_N-00458-28220508,2023-04-02T20:09:34,Zarautz,Expense,transport,-189.75,-13516.16
buyer_2,Carmen,40,ES50209585267825676886,TRX_N-00459-35837415,2023-04-05T19:28:14,Zarautz,Housing,Rent,-490.18,-14006.34
buyer_2,Carmen,40,ES50209585267825676886,TRX_N-00460-31912268,2023-04-06T02:04:27,Zarautz,Basic services,internet,-60.66,-14067.0
buyer_2,Carmen,40,ES50209585267825676886,TRX_N-00461-32127954,2023-04-07T14:53:14,Zarautz,Basic services,water,-59.92,-14126.92
buyer_2,Carmen,40,ES50209585267825676886,TRX_N-00462-70327536,2023-04-07T10:47:23,Zarautz,Expense,leisure,-186.44,-14313.36
buyer_2,Carmen,40,ES50209585267825676886,TRX_N-00463-25879875,2023-04-08T09:41:04,Zarautz,Expense,leisure,-229.01,-14542.37
buyer_2,Carmen,40,ES50209585267825676886,TRX_N-00464-41686679,2023-05-01T11:20:56,Zarautz,transfer,Salary,1501.73,-13040.64
buyer_2,Carmen,40,ES50209585267825676886,TRX_N-00465-83935656,2023-05-04T19:15:50,Alegría-Dulantzi,Expense,food,-211.04,-13251.68
buyer_2,Carmen,40,ES50209585267825676886,TRX_N-00466-36284460,2023-05-04T13:21:51,Zarautz,Expense,repairs,-592.31,-13843.99
buyer_2,Carmen,40,ES50209585267825676886,TRX_N-00467-05987156,2023-05-05T15:34:29,Zarautz,Housing,Rent,-490.18,-14334.17
buyer_2,Carmen,40,ES50209585267825676886,TRX_N-00468-53348254,2023-05-05T06:34:01,Zarautz,Basic services,electricity,-101.99,-14436.16
buyer_2,Carmen,40,ES50209585267825676886,TRX_N-00469-71481830,2023-05-05T18:07:17,Zarautz,Basic services,gas,-97.18,-14533.34
buyer_2,Carmen,40,ES50209585267825676886,TRX_N-00470-00409161,2023-05-06T16:55:54,Zarautz,Basic services,electricity,-25.67,-14559.01
buyer_2,Carmen,40,ES50209585267825676886,TRX_N-00471-88268548,2023-05-06T17:17:11,Zarautz,Basic services,phone,-31.28,-14590.29
buyer_2,Carmen,40,ES50209585267825676886,TRX_N-00472-60725573,2023-05-07T16:08:44,Zarautz,Basic services,water,-25.04,-14615.33
buyer_2,Carmen,40,ES50209585267825676886,TRX_N-00473-42791324,2023-05-07T17:38:53,Zarautz,Basic services,internet,-48.78,-14664.11
buyer_2,Carmen,40,ES50209585267825676886,TRX_N-00474-98315301,2023-05-13T09:25:02,Zarautz,Expense,clothing,-51.16,-14715.27
buyer_2,Carmen,40,ES50209585267825676886,TRX_N-00475-08219875,2023-05-30T06:53:08,Zarautz,Expense,clothing,-480.32,-15195.59
buyer_2,Carmen,40,ES50209585267825676886,TRX_N-00476-34976785,2023-05-31T09:52:07,Zarautz,Expense,transport,-107.4,-15302.99
buyer_2,Carmen,40,ES50209585267825676886,TRX_N-00477-56386732,2023-06-01T11:12:56,Zarautz,transfer,Salary,1501.73,-13801.26
buyer_2,Carmen,40,ES50209585267825676886,TRX_N-00478-80636692,2023-06-01T11:12:56,Zarautz,transfer,Bonus,1357.14,-12444.12
buyer_2,Carmen,40,ES50209585267825676886,TRX_N-00479-51027571,2023-06-02T18:47:56,Zarautz,Expense,transport,-33.59,-12477.71
buyer_2,Carmen,40,ES50209585267825676886,TRX_N-00480-34278438,2023-06-03T01:25:41,Zarautz,Expense,travel,-857.11,-13334.82
buyer_2,Carmen,40,ES50209585267825676886,TRX_N-00481-01474087,2023-06-05T11:48:37,Zarautz,Housing,Rent,-490.18,-13825.0
buyer_2,Carmen,40,ES50209585267825676886,TRX_N-00482-61923338,2023-06-05T14:33:20,Zarautz,Basic services,electricity,-43.29,-13868.29
buyer_2,Carmen,40,ES50209585267825676886,TRX_N-00483-55492645,2023-06-05T09:26:59,Zarautz,Basic services,internet,-48.09,-13916.38
buyer_2,Carmen,40,ES50209585267825676886,TRX_N-00484-13319834,2023-06-05T13:51:45,Zarautz,Basic services,phone,-96.66,-14013.04
buyer_2,Carmen,40,ES50209585267825676886,TRX_N-00485-25586095,2023-06-06T14:24:52,Zarautz,Basic services,water,-41.17,-14054.21
buyer_2,Carmen,40,ES50209585267825676886,TRX_N-00486-16132772,2023-06-06T12:15:03,Zarautz,Basic services,gas,-96.43,-14150.64
buyer_2,Carmen,40,ES50209585267825676886,TRX_N-00487-14961806,2023-06-06T09:09:26,Zarautz,Basic services,internet,-69.5,-14220.14
buyer_2,Carmen,40,ES50209585267825676886,TRX_N-00488-00791123,2023-06-07T18:44:04,Zarautz,Expense,transport,-29.19,-14249.33
buyer_2,Carmen,40,ES50209585267825676886,TRX_N-00489-82952162,2023-06-10T12:25:32,Zarautz,Expense,food,-280.98,-14530.31
buyer_2,Carmen,40,ES50209585267825676886,TRX_N-00490-75568236,2023-06-21T16:48:49,Zarautz,Expense,leisure,-102.03,-14632.34
buyer_2,Carmen,40,ES50209585267825676886,TRX_N-00491-56243133,2023-06-28T18:47:46,Zarautz,Expense,leisure,-154.45,-14786.79
buyer_2,Carmen,40,ES50209585267825676886,TRX_N-00492-29865543,2023-07-01T15:54:57,Zarautz,transfer,Salary,1501.73,-13285.06
buyer_2,Carmen,40,ES50209585267825676886,TRX_N-00493-92375848,2023-07-01T15:54:57,Zarautz,transfer,Extra Income,150.17,-13134.89
buyer_2,Carmen,40,ES50209585267825676886,TRX_N-00494-50159205,2023-07-01T23:22:41,Zarautz,Expense,clothing,-499.7,-13634.59
buyer_2,Carmen,40,ES50209585267825676886,TRX_N-00495-50855699,2023-07-05T22:04:10,Zarautz,Housing,Rent,-490.18,-14124.77
buyer_2,Carmen,40,ES50209585267825676886,TRX_N-00496-76056792,2023-07-05T18:43:27,Zarautz,Basic services,gas,-93.19,-14217.96
buyer_2,Carmen,40,ES50209585267825676886,TRX_N-00497-22659702,2023-07-05T12:16:55,Zarautz,Basic services,phone,-68.57,-14286.53
buyer_2,Carmen,40,ES50209585267825676886,TRX_N-00498-28947257,2023-07-06T11:14:14,Zarautz,Basic services,internet,-37.34,-14323.87
buyer_2,Carmen,40,ES50209585267825676886,TRX_N-00499-83714810,2023-07-06T08:29:42,Labastida,Expense,transport,-182.31,-14506.18
buyer_2,Carmen,40,ES50209585267825676886,TRX_N-00500-27737229,2023-07-07T10:45:23,Zarautz,Basic services,gas,-43.65,-14549.83
buyer_2,Carmen,40,ES50209585267825676886,TRX_N-00501-82453179,2023-07-07T01:47:52,Zarautz,Basic services,phone,-57.16,-14606.99
buyer_2,Carmen,40,ES50209585267825676886,TRX_N-00502-49841153,2023-07-17T23:10:36,Zarautz,Expense,food,-197.1,-14804.09
buyer_2,Carmen,40,ES50209585267825676886,TRX_N-00503-69128869,2023-07-20T19:34:34,Zarautz,Expense,food,-133.02,-14937.11
buyer_2,Carmen,40,ES50209585267825676886,TRX_N-00504-55860204,2023-08-01T16:49:38,Zarautz,transfer,Salary,1501.73,-13435.38
buyer_2,Carmen,40,ES50209585267825676886,TRX_N-00505-43656296,2023-08-01T17:51:44,Zarautz,Expense,healthcare,-351.17,-13786.55
buyer_2,Carmen,40,ES50209585267825676886,TRX_N-00506-07545279,2023-08-05T20:38:43,Zarautz,Housing,Rent,-490.18,-14276.73
buyer_2,Carmen,40,ES50209585267825676886,TRX_N-00507-05394891,2023-08-05T16:43:45,Zarautz,Basic services,electricity,-117.79,-14394.52
buyer_2,Carmen,40,ES50209585267825676886,TRX_N-00508-18320379,2023-08-05T12:01:13,Zarautz,Basic services,gas,-82.35,-14476.87
buyer_2,Carmen,40,ES50209585267825676886,TRX_N-00509-55541140,2023-08-06T19:34:50,Zarautz,Basic services,water,-36.13,-14513.0
buyer_2,Carmen,40,ES50209585267825676886,TRX_N-00510-52848388,2023-08-06T12:02:02,Zarautz,Expense,travel,-1593.75,-16106.75
buyer_2,Carmen,40,ES50209585267825676886,TRX_N-00511-69454209,2023-08-07T17:13:32,Zarautz,Basic services,internet,-65.66,-16172.41
buyer_2,Carmen,40,ES50209585267825676886,TRX_N-00512-96083231,2023-08-07T14:50:18,Zarautz,Basic services,phone,-42.3,-16214.71
buyer_2,Carmen,40,ES50209585267825676886,TRX_N-00513-07051244,2023-08-19T22:23:27,Sopela,Expense,leisure,-12.01,-16226.72
buyer_2,Carmen,40,ES50209585267825676886,TRX_N-00514-63939734,2023-08-23T11:25:23,Zarautz,Expense,food,-623.67,-16850.39
buyer_2,Carmen,40,ES50209585267825676886,TRX_N-00515-14308604,2023-08-29T15:39:38,Zarautz,Expense,education,-473.71,-17324.1
buyer_2,Carmen,40,ES50209585267825676886,TRX_N-00516-33335171,2023-09-01T21:13:41,Zarautz,transfer,Salary,1501.73,-15822.37
buyer_2,Carmen,40,ES50209585267825676886,TRX_N-00517-35071939,2023-09-01T08:20:03,Zarautz,Expense,transport,-20.52,-15842.89
buyer_2,Carmen,40,ES50209585267825676886,TRX_N-00518-15496025,2023-09-05T17:25:03,Zarautz,Housing,Rent,-490.18,-16333.07
buyer_2,Carmen,40,ES50209585267825676886,TRX_N-00519-07549573,2023-09-05T13:18:29,Zarautz,Basic services,electricity,-89.73,-16422.8
buyer_2,Carmen,40,ES50209585267825676886,TRX_N-00520-57328109,2023-09-05T08:45:43,Zarautz,Basic services,phone,-50.86,-16473.66
buyer_2,Carmen,40,ES50209585267825676886,TRX_N-00521-35077630,2023-09-06T23:01:18,Zarautz,Basic services,gas,-16.62,-16490.28
buyer_2,Carmen,40,ES50209585267825676886,TRX_N-00522-88119190,2023-09-07T12:31:02,Zarautz,Basic services,internet,-70.63,-16560.91
buyer_2,Carmen,40,ES50209585267825676886,TRX_N-00523-80315617,2023-09-07T14:41:44,Zarautz,Basic services,phone,-92.68,-16653.59
buyer_2,Carmen,40,ES50209585267825676886,TRX_N-00524-11031184,2023-09-20T19:44:30,Getxo,Expense,transport,-113.15,-16766.74
buyer_2,Carmen,40,ES50209585267825676886,TRX_N-00525-20819072,2023-09-26T19:32:40,Zarautz,Expense,food,-738.04,-17504.78
buyer_2,Carmen,40,ES50209585267825676886,TRX_N-00526-71141452,2023-09-28T18:30:42,Zarautz,Expense,repairs,-132.33,-17637.11
buyer_2,Carmen,40,ES50209585267825676886,TRX_N-00527-21462699,2023-10-01T09:09:29,Zarautz,transfer,Salary,1501.73,-16135.38
buyer_2,Carmen,40,ES50209585267825676886,TRX_N-00528-21615719,2023-10-01T09:09:29,Zarautz,transfer,Extra Income,150.17,-15985.21
buyer_2,Carmen,40,ES50209585267825676886,TRX_N-00529-62283238,2023-10-05T08:40:10,Zarautz,Housing,Rent,-490.18,-16475.39
buyer_2,Carmen,40,ES50209585267825676886,TRX_N-00530-61746839,2023-10-05T04:41:32,Zarautz,Basic services,water,-33.85,-16509.24
buyer_2,Carmen,40,ES50209585267825676886,TRX_N-00531-92630621,2023-10-05T13:35:39,Zarautz,Basic services,gas,-80.48,-16589.72
buyer_2,Carmen,40,ES50209585267825676886,TRX_N-00532-70114309,2023-10-05T17:04:06,Zarautz,Basic services,phone,-95.73,-16685.45
buyer_2,Carmen,40,ES50209585267825676886,TRX_N-00533-73133406,2023-10-06T15:41:41,Zarautz,Basic services,gas,-94.64,-16780.09
buyer_2,Carmen,40,ES50209585267825676886,TRX_N-00534-21287645,2023-10-06T19:52:08,Getxo,Expense,food,-174.17,-16954.26
buyer_2,Carmen,40,ES50209585267825676886,TRX_N-00535-02465694,2023-10-07T09:34:57,Zarautz,Basic services,gas,-35.56,-16989.82
buyer_2,Carmen,40,ES50209585267825676886,TRX_N-00536-48479139,2023-10-18T05:47:11,Zarautz,Expense,leisure,-12.67,-17002.49
buyer_2,Carmen,40,ES50209585267825676886,TRX_N-00537-02278565,2023-11-01T00:40:37,Zarautz,transfer,Salary,1501.73,-15500.76
buyer_2,Carmen,40,ES50209585267825676886,TRX_N-00538-12813776,2023-11-05T12:16:01,Zarautz,Housing,Rent,-490.18,-15990.94
buyer_2,Carmen,40,ES50209585267825676886,TRX_N-00539-55990840,2023-11-06T01:32:44,Zarautz,Basic services,water,-40.61,-16031.55
buyer_2,Carmen,40,ES50209585267825676886,TRX_N-00540-72076031,2023-11-06T10:40:55,Zarautz,Basic services,internet,-51.07,-16082.62
buyer_2,Carmen,40,ES50209585267825676886,TRX_N-00541-95327148,2023-11-07T15:35:57,Zarautz,Basic services,electricity,-98.6,-16181.22
buyer_2,Carmen,40,ES50209585267825676886,TRX_N-00542-37246496,2023-11-07T17:42:00,Zarautz,Basic services,gas,-53.01,-16234.23
buyer_2,Carmen,40,ES50209585267825676886,TRX_N-00543-20601795,2023-11-07T19:45:15,Zarautz,Basic services,internet,-31.68,-16265.91
buyer_2,Carmen,40,ES50209585267825676886,TRX_N-00544-75817976,2023-11-14T08:33:31,Zarautz,Expense,food,-537.33,-16803.24
buyer_2,Carmen,40,ES50209585267825676886,TRX_N-00545-27921473,2023-11-14T16:39:38,Zarautz,Expense,transport,-181.85,-16985.09
buyer_2,Carmen,40,ES50209585267825676886,TRX_N-00546-11803093,2023-11-14T16:38:56,Andoain,Expense,travel,-825.75,-17810.84
buyer_2,Carmen,40,ES50209585267825676886,TRX_N-00547-17021998,2023-11-16T08:33:39,Zarautz,Expense,food,-290.48,-18101.32
buyer_2,Carmen,40,ES50209585267825676886,TRX_N-00548-39308515,2023-11-23T22:32:13,Lasarte-Oria,Expense,transport,-169.39,-18270.71
buyer_2,Carmen,40,ES50209585267825676886,TRX_N-00549-30685005,2023-12-01T09:17:48,Zarautz,transfer,Salary,1501.73,-16768.98
buyer_2,Carmen,40,ES50209585267825676886,TRX_N-00550-89294909,2023-12-01T09:17:48,Zarautz,transfer,Bonus,1419.34,-15349.64
buyer_2,Carmen,40,ES50209585267825676886,TRX_N-00551-82964638,2023-12-05T08:36:37,Zarautz,Housing,Rent,-490.18,-15839.82
buyer_2,Carmen,40,ES50209585267825676886,TRX_N-00552-81952817,2023-12-05T05:08:42,Zarautz,Basic services,gas,-18.72,-15858.54
buyer_2,Carmen,40,ES50209585267825676886,TRX_N-00553-05299097,2023-12-06T14:09:52,Zarautz,Basic services,water,-16.78,-15875.32
buyer_2,Carmen,40,ES50209585267825676886,TRX_N-00554-01567622,2023-12-06T18:27:52,Zarautz,Basic services,electricity,-45.56,-15920.88
buyer_2,Carmen,40,ES50209585267825676886,TRX_N-00555-13583186,2023-12-06T13:31:08,Zarautz,Expense,food,-204.24,-16125.12
buyer_2,Carmen,40,ES50209585267825676886,TRX_N-00556-37926653,2023-12-07T08:04:31,Zarautz,Basic services,phone,-80.6,-16205.72
buyer_2,Carmen,40,ES50209585267825676886,TRX_N-00557-27961109,2023-12-07T17:10:53,Zarautz,Expense,education,-119.69,-16325.41
buyer_2,Carmen,40,ES50209585267825676886,TRX_N-00558-65519938,2023-12-13T00:34:41,Santurtzi,Expense,transport,-35.65,-16361.06
buyer_2,Carmen,40,ES50209585267825676886,TRX_N-00559-32831436,2023-12-17T08:52:05,Basauri,Expense,food,-108.03,-16469.09
buyer_2,Carmen,40,ES50209585267825676886,TRX_N-00560-89492648,2023-12-18T00:35:52,Zarautz,Expense,clothing,-462.73,-16931.82
buyer_2,Carmen,40,ES50209585267825676886,TRX_N-00561-64817725,2023-12-22T10:52:00,Zarautz,Expense,transport,-91.13,-17022.95
buyer_2,Carmen,40,ES50209585267825676886,TRX_N-00562-95135453,2023-12-23T14:12:11,Zarautz,Expense,food,-240.61,-17263.56
buyer_2,Carmen,40,ES50209585267825676886,TRX_N-00563-66230909,2024-01-01T18:19:16,Zarautz,transfer,Salary,1501.73,-15761.83
buyer_2,Carmen,40,ES50209585267825676886,TRX_N-00564-72422162,2024-01-01T18:19:16,Zarautz,transfer,Extra Income,150.17,-15611.66
buyer_2,Carmen,40,ES50209585267825676886,TRX_N-00565-37122386,2024-01-05T08:21:05,Zarautz,Housing,Rent,-490.18,-16101.84
buyer_2,Carmen,40,ES50209585267825676886,TRX_N-00566-49493528,2024-01-05T19:30:23,Zarautz,Basic services,electricity,-106.55,-16208.39
buyer_2,Carmen,40,ES50209585267825676886,TRX_N-00567-19740366,2024-01-05T18:12:18,Zarautz,Expense,leisure,-173.5,-16381.89
buyer_2,Carmen,40,ES50209585267825676886,TRX_N-00568-70206586,2024-01-06T12:29:16,Zarautz,Basic services,water,-31.93,-16413.82
buyer_2,Carmen,40,ES50209585267825676886,TRX_N-00569-82819741,2024-01-06T12:37:07,Zarautz,Basic services,electricity,-33.76,-16447.58
buyer_2,Carmen,40,ES50209585267825676886,TRX_N-00570-78395962,2024-01-07T14:15:45,Zarautz,Basic services,gas,-24.19,-16471.77
buyer_2,Carmen,40,ES50209585267825676886,TRX_N-00571-54339175,2024-01-07T08:14:29,Zarautz,Basic services,internet,-76.14,-16547.91
buyer_2,Carmen,40,ES50209585267825676886,TRX_N-00572-26962088,2024-01-14T18:04:00,Zarautz,Expense,leisure,-33.56,-16581.47
buyer_2,Carmen,40,ES50209585267825676886,TRX_N-00573-86544458,2024-01-19T08:31:29,Zarautz,Expense,gifts,-195.52,-16776.99
buyer_2,Carmen,40,ES50209585267825676886,TRX_N-00574-64949969,2024-01-21T08:18:05,Zarautz,Expense,food,-557.74,-17334.73
buyer_2,Carmen,40,ES50209585267825676886,TRX_N-00575-58107140,2024-01-30T15:22:50,Zarautz,Expense,education,-612.27,-17947.0
buyer_2,Carmen,40,ES50209585267825676886,TRX_N-00576-35733435,2024-02-01T12:13:44,Zarautz,transfer,Salary,1501.73,-16445.27
buyer_2,Carmen,40,ES50209585267825676886,TRX_N-00577-84025515,2024-02-04T09:03:35,Zarautz,Expense,repairs,-597.32,-17042.59
buyer_2,Carmen,40,ES50209585267825676886,TRX_N-00578-12931839,2024-02-05T11:29:56,Zarautz,Housing,Rent,-490.18,-17532.77
buyer_2,Carmen,40,ES50209585267825676886,TRX_N-00579-07942374,2024-02-06T16:40:10,Zarautz,Basic services,water,-29.94,-17562.71
buyer_2,Carmen,40,ES50209585267825676886,TRX_N-00580-97816915,2024-02-07T16:47:40,Zarautz,Basic services,internet,-40.48,-17603.19
buyer_2,Carmen,40,ES50209585267825676886,TRX_N-00581-83053009,2024-02-07T16:31:10,Zarautz,Basic services,phone,-48.21,-17651.4
buyer_2,Carmen,40,ES50209585267825676886,TRX_N-00582-66960564,2024-02-09T09:14:51,Zarautz,Expense,food,-225.29,-17876.69
buyer_2,Carmen,40,ES50209585267825676886,TRX_N-00583-99520656,2024-02-27T20:20:06,Zarautz,Expense,transport,-63.87,-17940.56
buyer_2,Carmen,40,ES50209585267825676886,TRX_N-00584-18760619,2024-03-01T20:40:56,Zarautz,transfer,Salary,1501.73,-16438.83
buyer_2,Carmen,40,ES50209585267825676886,TRX_N-00585-71386929,2024-03-05T02:17:25,Zarautz,Housing,Rent,-490.18,-16929.01
buyer_2,Carmen,40,ES50209585267825676886,TRX_N-00586-22468617,2024-03-05T16:39:53,Zarautz,Basic services,gas,-84.43,-17013.44
buyer_2,Carmen,40,ES50209585267825676886,TRX_N-00587-74556591,2024-03-06T19:32:20,Zarautz,Basic services,phone,-95.25,-17108.69
buyer_2,Carmen,40,ES50209585267825676886,TRX_N-00588-04123204,2024-03-06T09:13:19,Zarautz,Expense,food,-148.77,-17257.46
buyer_2,Carmen,40,ES50209585267825676886,TRX_N-00589-66160187,2024-03-07T16:24:54,Zarautz,Basic services,water,-31.18,-17288.64
buyer_2,Carmen,40,ES50209585267825676886,TRX_N-00590-73842993,2024-03-11T18:02:12,Zarautz,Expense,travel,-476.33,-17764.97
buyer_2,Carmen,40,ES50209585267825676886,TRX_N-00591-71312571,2024-03-14T17:21:33,Zarautz,Expense,transport,-189.27,-17954.24
buyer_2,Carmen,40,ES50209585267825676886,TRX_N-00592-69679626,2024-03-18T20:15:02,Eibar,Expense,clothing,-82.66,-18036.9
buyer_2,Carmen,40,ES50209585267825676886,TRX_N-00593-63775264,2024-03-23T20:32:15,Oyón-Oion,Expense,food,-488.58,-18525.48
buyer_2,Carmen,40,ES50209585267825676886,TRX_N-00594-10338695,2024-03-24T19:04:46,Zarautz,Expense,food,-196.41,-18721.89
buyer_2,Carmen,40,ES50209585267825676886,TRX_N-00595-08960068,2024-03-24T17:42:36,Zarautz,Expense,transport,-193.57,-18915.46
buyer_2,Carmen,40,ES50209585267825676886,TRX_N-00596-57436961,2024-04-01T23:02:20,Zarautz,transfer,Salary,1501.73,-17413.73
buyer_2,Carmen,40,ES50209585267825676886,TRX_N-00597-76046535,2024-04-01T23:02:20,Zarautz,transfer,Extra Income,150.17,-17263.56
buyer_2,Carmen,40,ES50209585267825676886,TRX_N-00598-88219937,2024-04-05T15:11:12,Zarautz,Housing,Rent,-490.18,-17753.74
buyer_2,Carmen,40,ES50209585267825676886,TRX_N-00599-74017381,2024-04-05T09:41:22,Zarautz,Basic services,water,-18.03,-17771.77
buyer_2,Carmen,40,ES50209585267825676886,TRX_N-00600-39510656,2024-04-05T21:28:12,Zarautz,Basic services,electricity,-62.17,-17833.94
buyer_2,Carmen,40,ES50209585267825676886,TRX_N-00601-91159743,2024-04-06T09:42:17,Zarautz,Basic services,electricity,-133.61,-17967.55
buyer_2,Carmen,40,ES50209585267825676886,TRX_N-00602-45790934,2024-04-07T04:08:51,Zarautz,Basic services,water,-25.09,-17992.64
buyer_2,Carmen,40,ES50209585267825676886,TRX_N-00603-47012893,2024-04-07T03:47:43,Zarautz,Basic services,electricity,-25.55,-18018.19
buyer_2,Carmen,40,ES50209585267825676886,TRX_N-00604-79349306,2024-04-10T08:50:31,Zarautz,Expense,leisure,-99.83,-18118.02
buyer_2,Carmen,40,ES50209585267825676886,TRX_N-00605-39553041,2024-04-12T13:17:22,Zarautz,Expense,gifts,-288.15,-18406.17
buyer_2,Carmen,40,ES50209585267825676886,TRX_N-00606-18991932,2024-04-13T14:30:34,Zarautz,Expense,food,-133.95,-18540.12
buyer_2,Carmen,40,ES50209585267825676886,TRX_N-00607-20771649,2024-04-18T14:01:08,Zarautz,Expense,transport,-165.6,-18705.72
buyer_2,Carmen,40,ES50209585267825676886,TRX_N-00608-42474605,2024-04-27T17:56:40,Zarautz,Expense,travel,-1907.62,-20613.34
buyer_2,Carmen,40,ES50209585267825676886,TRX_N-00609-70728318,2024-04-29T16:51:27,Vitoria-Gasteiz,Expense,healthcare,-318.82,-20932.16
buyer_2,Carmen,40,ES50209585267825676886,TRX_N-00610-58511050,2024-05-01T15:46:55,Zarautz,transfer,Salary,1501.73,-19430.43
buyer_2,Carmen,40,ES50209585267825676886,TRX_N-00611-05480393,2024-05-01T21:03:27,Zarautz,Expense,food,-784.58,-20215.01
buyer_2,Carmen,40,ES50209585267825676886,TRX_N-00612-92772624,2024-05-04T03:46:33,Zarautz,Expense,transport,-52.52,-20267.53
buyer_2,Carmen,40,ES50209585267825676886,TRX_N-00613-14390919,2024-05-05T13:14:11,Zarautz,Housing,Rent,-490.18,-20757.71
buyer_2,Carmen,40,ES50209585267825676886,TRX_N-00614-87147698,2024-05-05T15:05:23,Zarautz,Basic services,internet,-41.33,-20799.04
buyer_2,Carmen,40,ES50209585267825676886,TRX_N-00615-56457300,2024-05-06T12:15:25,Zarautz,Basic services,gas,-92.24,-20891.28
buyer_2,Carmen,40,ES50209585267825676886,TRX_N-00616-60111647,2024-05-08T03:46:57,Zarautz,Expense,leisure,-118.24,-21009.52
buyer_2,Carmen,40,ES50209585267825676886,TRX_N-00617-23573849,2024-05-10T14:02:36,Zarautz,Expense,clothing,-412.15,-21421.67
buyer_2,Carmen,40,ES50209585267825676886,TRX_N-00618-54828341,2024-05-13T08:50:58,Zarautz,Expense,food,-332.1,-21753.77
buyer_2,Carmen,40,ES50209585267825676886,TRX_N-00619-83595368,2024-05-29T20:56:14,Portugalete,Expense,repairs,-693.67,-22447.44
buyer_2,Carmen,40,ES50209585267825676886,TRX_N-00620-43542615,2024-06-01T09:47:42,Zarautz,transfer,Salary,1501.73,-20945.71
buyer_2,Carmen,40,ES50209585267825676886,TRX_N-00621-54385158,2024-06-01T09:47:42,Zarautz,transfer,Bonus,1650.05,-19295.66
buyer_2,Carmen,40,ES50209585267825676886,TRX_N-00622-05123073,2024-06-05T09:55:33,Zarautz,Housing,Rent,-490.18,-19785.84
buyer_2,Carmen,40,ES50209585267825676886,TRX_N-00623-75627579,2024-06-06T13:56:19,Zarautz,Basic services,water,-73.54,-19859.38
buyer_2,Carmen,40,ES50209585267825676886,TRX_N-00624-64593820,2024-06-06T11:08:14,Zarautz,Basic services,gas,-83.21,-19942.59
buyer_2,Carmen,40,ES50209585267825676886,TRX_N-00625-89055402,2024-06-16T18:24:43,Zarautz,Expense,healthcare,-280.4,-20222.99
buyer_2,Carmen,40,ES50209585267825676886,TRX_N-00626-83244200,2024-06-17T14:41:15,Zarautz,Expense,leisure,-59.3,-20282.29
buyer_2,Carmen,40,ES50209585267825676886,TRX_N-00627-02004220,2024-06-23T12:06:57,Zarautz,Expense,leisure,-232.8,-20515.09
buyer_2,Carmen,40,ES50209585267825676886,TRX_N-00628-47507611,2024-06-25T18:27:05,Zarautz,Expense,transport,-143.56,-20658.65
buyer_2,Carmen,40,ES50209585267825676886,TRX_N-00629-40004096,2024-07-01T19:03:55,Zarautz,transfer,Salary,1501.73,-19156.92
buyer_2,Carmen,40,ES50209585267825676886,TRX_N-00630-00073439,2024-07-01T19:03:55,Zarautz,transfer,Extra Income,150.17,-19006.75
buyer_2,Carmen,40,ES50209585267825676886,TRX_N-00631-11153937,2024-07-02T12:13:08,Zarautz,Expense,transport,-108.33,-19115.08
buyer_2,Carmen,40,ES50209585267825676886,TRX_N-00632-18772571,2024-07-05T15:28:01,Zarautz,Housing,Rent,-490.18,-19605.26
buyer_2,Carmen,40,ES50209585267825676886,TRX_N-00633-10360843,2024-07-05T10:16:34,Zarautz,Basic services,water,-64.36,-19669.62
buyer_2,Carmen,40,ES50209585267825676886,TRX_N-00634-38970090,2024-07-05T12:01:22,Zarautz,Basic services,gas,-22.09,-19691.71
buyer_2,Carmen,40,ES50209585267825676886,TRX_N-00635-34036538,2024-07-05T21:34:44,Zarautz,Basic services,internet,-49.78,-19741.49
buyer_2,Carmen,40,ES50209585267825676886,TRX_N-00636-46990670,2024-07-06T20:16:26,Zarautz,Basic services,internet,-71.41,-19812.9
buyer_2,Carmen,40,ES50209585267825676886,TRX_N-00637-73179292,2024-07-06T20:06:48,Zarautz,Basic services,phone,-57.6,-19870.5
buyer_2,Carmen,40,ES50209585267825676886,TRX_N-00638-89003039,2024-07-07T11:26:59,Zarautz,Basic services,electricity,-138.3,-20008.8
buyer_2,Carmen,40,ES50209585267825676886,TRX_N-00639-90495113,2024-07-07T08:52:11,Zarautz,Basic services,phone,-86.2,-20095.0
buyer_2,Carmen,40,ES50209585267825676886,TRX_N-00640-75258757,2024-07-29T16:50:44,Zarautz,Expense,food,-336.85,-20431.85
buyer_2,Carmen,40,ES50209585267825676886,TRX_N-00641-36917261,2024-08-01T21:28:25,Zarautz,transfer,Salary,1501.73,-18930.12
buyer_2,Carmen,40,ES50209585267825676886,TRX_N-00642-11804027,2024-08-05T19:14:19,Zarautz,Housing,Rent,-490.18,-19420.3
buyer_2,Carmen,40,ES50209585267825676886,TRX_N-00643-00211567,2024-08-05T10:52:01,Zarautz,Basic services,electricity,-43.44,-19463.74
buyer_2,Carmen,40,ES50209585267825676886,TRX_N-00644-24616790,2024-08-06T08:43:48,Zarautz,Basic services,water,-66.97,-19530.71
buyer_2,Carmen,40,ES50209585267825676886,TRX_N-00645-64618257,2024-08-06T18:29:10,Zarautz,Basic services,gas,-83.2,-19613.91
buyer_2,Carmen,40,ES50209585267825676886,TRX_N-00646-29055636,2024-08-07T17:46:29,Zarautz,Basic services,phone,-54.19,-19668.1
buyer_2,Carmen,40,ES50209585267825676886,TRX_N-00647-21920408,2024-08-07T08:48:52,Zarautz,Expense,healthcare,-348.11,-20016.21
buyer_2,Carmen,40,ES50209585267825676886,TRX_N-00648-74791318,2024-08-13T20:23:29,Salvatierra/Agurain,Expense,clothing,-373.98,-20390.19
buyer_2,Carmen,40,ES50209585267825676886,TRX_N-00649-68176823,2024-08-18T18:58:54,Zarautz,Expense,education,-619.3,-21009.49
buyer_2,Carmen,40,ES50209585267825676886,TRX_N-00650-34559649,2024-08-19T09:43:40,Zarautz,Expense,leisure,-196.48,-21205.97
buyer_2,Carmen,40,ES50209585267825676886,TRX_N-00651-89504379,2024-08-20T09:24:46,Zarautz,Expense,education,-310.18,-21516.15
buyer_2,Carmen,40,ES50209585267825676886,TRX_N-00652-79249414,2024-09-01T16:02:33,Zarautz,transfer,Salary,1501.73,-20014.42
buyer_2,Carmen,40,ES50209585267825676886,TRX_N-00653-10622539,2024-09-01T17:05:27,Zarautz,Expense,clothing,-405.31,-20419.73
buyer_2,Carmen,40,ES50209585267825676886,TRX_N-00654-43965780,2024-09-05T00:35:05,Zarautz,Housing,Rent,-490.18,-20909.91
buyer_2,Carmen,40,ES50209585267825676886,TRX_N-00655-76715300,2024-09-05T10:18:57,Zarautz,Basic services,water,-77.94,-20987.85
buyer_2,Carmen,40,ES50209585267825676886,TRX_N-00656-47244438,2024-09-06T20:12:49,Zarautz,Basic services,phone,-29.75,-21017.6
buyer_2,Carmen,40,ES50209585267825676886,TRX_N-00657-17326505,2024-09-07T08:26:37,Zarautz,Basic services,water,-49.44,-21067.04
buyer_2,Carmen,40,ES50209585267825676886,TRX_N-00658-64633520,2024-09-07T13:19:50,Zarautz,Basic services,electricity,-90.96,-21158.0
buyer_2,Carmen,40,ES50209585267825676886,TRX_N-00659-21008782,2024-09-11T08:42:00,Zarautz,Expense,repairs,-71.09,-21229.09
buyer_2,Carmen,40,ES50209585267825676886,TRX_N-00660-30037449,2024-09-12T13:49:51,Zarautz,Expense,transport,-172.47,-21401.56
buyer_2,Carmen,40,ES50209585267825676886,TRX_N-00661-90395915,2024-09-27T18:34:07,Zarautz,Expense,repairs,-305.47,-21707.03
buyer_2,Carmen,40,ES50209585267825676886,TRX_N-00662-46718290,2024-10-01T11:43:08,Zarautz,transfer,Salary,1501.73,-20205.3
buyer_2,Carmen,40,ES50209585267825676886,TRX_N-00663-23550750,2024-10-01T11:43:08,Zarautz,transfer,Extra Income,150.17,-20055.13
buyer_2,Carmen,40,ES50209585267825676886,TRX_N-00664-14933394,2024-10-01T07:42:13,Zarautz,Expense,food,-742.64,-20797.77
buyer_2,Carmen,40,ES50209585267825676886,TRX_N-00665-17322376,2024-10-05T12:31:08,Zarautz,Housing,Rent,-490.18,-21287.95
buyer_2,Carmen,40,ES50209585267825676886,TRX_N-00666-01388785,2024-10-05T11:43:48,Zarautz,Basic services,gas,-36.22,-21324.17
buyer_2,Carmen,40,ES50209585267825676886,TRX_N-00667-61784621,2024-10-06T09:07:12,Zarautz,Basic services,electricity,-43.74,-21367.91
buyer_2,Carmen,40,ES50209585267825676886,TRX_N-00668-81763575,2024-10-06T18:19:31,Zarautz,Basic services,internet,-67.3,-21435.21
buyer_2,Carmen,40,ES50209585267825676886,TRX_N-00669-99118573,2024-10-06T10:00:09,Zarautz,Basic services,phone,-40.4,-21475.61
buyer_3,Ana,35,ES70209569304834571550,TRX_N-00001-59746608,2020-01-01T22:44:09,Amurrio,transfer,Salary,2322.78,5547.42
buyer_3,Ana,35,ES70209569304834571550,TRX_N-00002-13806681,2020-01-01T22:44:09,Amurrio,transfer,Partner Salary,2016.45,7563.87
buyer_3,Ana,35,ES70209569304834571550,TRX_N-00003-23070645,2020-01-05T18:54:17,Amurrio,Housing,Rent,-742.53,6821.34
buyer_3,Ana,35,ES70209569304834571550,TRX_N-00004-62651221,2020-01-05T08:13:30,Amurrio,Basic services,gas,-58.26,6763.08
buyer_3,Ana,35,ES70209569304834571550,TRX_N-00005-03327544,2020-01-06T18:21:37,Amurrio,Basic services,water,-75.29,6687.79
buyer_3,Ana,35,ES70209569304834571550,TRX_N-00006-41786704,2020-01-06T15:42:09,Amurrio,Basic services,gas,-70.98,6616.81
buyer_3,Ana,35,ES70209569304834571550,TRX_N-00007-06625589,2020-01-06T17:57:18,Amurrio,Basic services,phone,-65.63,6551.18
buyer_3,Ana,35,ES70209569304834571550,TRX_N-00008-87434338,2020-01-07T14:12:08,Amurrio,Basic services,electricity,-115.18,6436.0
buyer_3,Ana,35,ES70209569304834571550,TRX_N-00009-01670912,2020-01-07T08:30:41,Amurrio,Basic services,internet,-78.8,6357.2
buyer_3,Ana,35,ES70209569304834571550,TRX_N-00010-27248823,2020-01-07T15:36:56,Alegría-Dulantzi,Expense,food,-289.26,6067.94
buyer_3,Ana,35,ES70209569304834571550,TRX_N-00011-99339603,2020-01-07T12:33:52,Amurrio,Expense,clothing,-147.34,5920.6
buyer_3,Ana,35,ES70209569304834571550,TRX_N-00012-77832491,2020-02-01T10:41:51,Amurrio,transfer,Salary,2322.78,8243.38
buyer_3,Ana,35,ES70209569304834571550,TRX_N-00013-94174117,2020-02-01T10:41:51,Amurrio,transfer,Partner Salary,2016.45,10259.83
buyer_3,Ana,35,ES70209569304834571550,TRX_N-00014-47784960,2020-02-05T15:05:31,Amurrio,Housing,Rent,-742.53,9517.3
buyer_3,Ana,35,ES70209569304834571550,TRX_N-00015-44255714,2020-02-05T15:30:45,Amurrio,Basic services,internet,-65.22,9452.08
buyer_3,Ana,35,ES70209569304834571550,TRX_N-00016-51420991,2020-02-07T18:39:41,Amurrio,Basic services,internet,-51.21,9400.87
buyer_3,Ana,35,ES70209569304834571550,TRX_N-00017-43180361,2020-02-13T19:00:07,Amurrio,Expense,transport,-199.06,9201.81
buyer_3,Ana,35,ES70209569304834571550,TRX_N-00018-33539767,2020-02-22T15:16:48,Amurrio,Expense,healthcare,-148.23,9053.58
buyer_3,Ana,35,ES70209569304834571550,TRX_N-00019-26400325,2020-03-01T20:40:30,Amurrio,transfer,Salary,2322.78,11376.36
buyer_3,Ana,35,ES70209569304834571550,TRX_N-00020-49514871,2020-03-01T20:40:30,Amurrio,transfer,Partner Salary,2016.45,13392.81
buyer_3,Ana,35,ES70209569304834571550,TRX_N-00021-58885801,2020-03-01T20:40:30,Amurrio,transfer,Extra Income,232.28,13625.09
buyer_3,Ana,35,ES70209569304834571550,TRX_N-00022-23450942,2020-03-05T17:32:22,Amurrio,Housing,Rent,-742.53,12882.56
buyer_3,Ana,35,ES70209569304834571550,TRX_N-00023-40922674,2020-03-05T11:21:25,Amurrio,Basic services,water,-21.92,12860.64
buyer_3,Ana,35,ES70209569304834571550,TRX_N-00024-95002686,2020-03-05T17:16:20,Amurrio,Basic services,electricity,-112.58,12748.06
buyer_3,Ana,35,ES70209569304834571550,TRX_N-00025-56262642,2020-03-05T19:31:07,Amurrio,Basic services,internet,-37.87,12710.19
buyer_3,Ana,35,ES70209569304834571550,TRX_N-00026-21204316,2020-03-06T20:44:53,Amurrio,Basic services,electricity,-56.3,12653.89
buyer_3,Ana,35,ES70209569304834571550,TRX_N-00027-80816049,2020-03-06T19:06:48,Amurrio,Basic services,internet,-45.11,12608.78
buyer_3,Ana,35,ES70209569304834571550,TRX_N-00028-86748621,2020-03-07T13:43:36,Amurrio,Basic services,water,-44.96,12563.82
buyer_3,Ana,35,ES70209569304834571550,TRX_N-00029-30498541,2020-03-07T11:39:20,Amurrio,Basic services,internet,-59.07,12504.75
buyer_3,Ana,35,ES70209569304834571550,TRX_N-00030-67918684,2020-03-20T16:40:43,Galdakao,Expense,travel,-1521.67,10983.08
buyer_3,Ana,35,ES70209569304834571550,TRX_N-00031-09535716,2020-03-23T14:50:08,Amurrio,Expense,transport,-96.74,10886.34
buyer_3,Ana,35,ES70209569304834571550,TRX_N-00032-26562238,2020-03-26T23:25:21,Amurrio,Expense,appliances,-1634.7,9251.64
buyer_3,Ana,35,ES70209569304834571550,TRX_N-00033-67586150,2020-04-01T18:19:35,Amurrio,transfer,Salary,2322.78,11574.42
buyer_3,Ana,35,ES70209569304834571550,TRX_N-00034-30881405,2020-04-01T18:19:35,Amurrio,transfer,Partner Salary,2016.45,13590.87
buyer_3,Ana,35,ES70209569304834571550,TRX_N-00035-96823874,2020-04-01T19:41:32,Amurrio,Expense,transport,-107.98,13482.89
buyer_3,Ana,35,ES70209569304834571550,TRX_N-00036-28284281,2020-04-05T06:13:24,Amurrio,Housing,Rent,-742.53,12740.36
buyer_3,Ana,35,ES70209569304834571550,TRX_N-00037-98192536,2020-04-05T11:39:23,Amurrio,Basic services,gas,-24.29,12716.07
buyer_3,Ana,35,ES70209569304834571550,TRX_N-00038-55574980,2020-04-06T18:27:02,Amurrio,Basic services,electricity,-130.82,12585.25
buyer_3,Ana,35,ES70209569304834571550,TRX_N-00039-24608410,2020-04-06T13:21:55,Amurrio,Expense,clothing,-50.52,12534.73
buyer_3,Ana,35,ES70209569304834571550,TRX_N-00040-13730147,2020-04-07T08:02:28,Amurrio,Basic services,internet,-51.97,12482.76
buyer_3,Ana,35,ES70209569304834571550,TRX_N-00041-10257629,2020-04-21T10:04:43,Amurrio,Expense,transport,-137.35,12345.41
buyer_3,Ana,35,ES70209569304834571550,TRX_N-00042-47906555,2020-04-22T09:37:01,Amurrio,Expense,leisure,-174.58,12170.83
buyer_3,Ana,35,ES70209569304834571550,TRX_N-00043-21690034,2020-04-24T08:57:54,Amurrio,Expense,transport,-133.63,12037.2
buyer_3,Ana,35,ES70209569304834571550,TRX_N-00044-38682865,2020-04-29T20:59:04,Zarautz,Expense,food,-176.82,11860.38
buyer_3,Ana,35,ES70209569304834571550,TRX_N-00045-48493186,2020-05-01T16:24:36,Amurrio,transfer,Salary,2322.78,14183.16
buyer_3,Ana,35,ES70209569304834571550,TRX_N-00046-44068046,2020-05-01T16:24:36,Amurrio,transfer,Partner Salary,2016.45,16199.61
buyer_3,Ana,35,ES70209569304834571550,TRX_N-00047-73928231,2020-05-01T16:24:36,Amurrio,transfer,Extra Income,232.28,16431.89
buyer_3,Ana,35,ES70209569304834571550,TRX_N-00048-00770149,2020-05-04T18:32:35,Amurrio,Expense,healthcare,-372.69,16059.2
buyer_3,Ana,35,ES70209569304834571550,TRX_N-00049-11374319,2020-05-05T19:03:01,Amurrio,Housing,Rent,-742.53,15316.67
buyer_3,Ana,35,ES70209569304834571550,TRX_N-00050-22751767,2020-05-05T13:21:41,Amurrio,Basic services,water,-49.49,15267.18
buyer_3,Ana,35,ES70209569304834571550,TRX_N-00051-85586098,2020-05-05T15:15:11,Amurrio,Basic services,gas,-65.32,15201.86
buyer_3,Ana,35,ES70209569304834571550,TRX_N-00052-87905410,2020-05-05T21:51:22,Amurrio,Basic services,phone,-45.21,15156.65
buyer_3,Ana,35,ES70209569304834571550,TRX_N-00053-07885448,2020-05-07T11:19:40,Amurrio,Basic services,water,-64.77,15091.88
buyer_3,Ana,35,ES70209569304834571550,TRX_N-00054-50614362,2020-05-07T14:03:19,Amurrio,Basic services,electricity,-58.28,15033.6
buyer_3,Ana,35,ES70209569304834571550,TRX_N-00055-90462145,2020-05-07T12:41:52,Amurrio,Basic services,gas,-70.09,14963.51
buyer_3,Ana,35,ES70209569304834571550,TRX_N-00056-05414228,2020-05-11T16:53:45,Amurrio,Expense,food,-571.9,14391.61
buyer_3,Ana,35,ES70209569304834571550,TRX_N-00057-78200760,2020-05-21T19:24:37,Getxo,Expense,transport,-47.98,14343.63
buyer_3,Ana,35,ES70209569304834571550,TRX_N-00058-99498198,2020-05-24T13:11:17,Amurrio,Expense,transport,-70.14,14273.49
buyer_3,Ana,35,ES70209569304834571550,TRX_N-00059-08108463,2020-06-01T09:00:26,Amurrio,transfer,Salary,2322.78,16596.27
buyer_3,Ana,35,ES70209569304834571550,TRX_N-00060-58974060,2020-06-01T09:00:26,Amurrio,transfer,Partner Salary,2016.45,18612.72
buyer_3,Ana,35,ES70209569304834571550,TRX_N-00061-60178453,2020-06-01T09:00:26,Amurrio,transfer,Bonus,2176.43,20789.15
buyer_3,Ana,35,ES70209569304834571550,TRX_N-00062-25881613,2020-06-02T14:46:52,Amurrio,Expense,food,-354.29,20434.86
buyer_3,Ana,35,ES70209569304834571550,TRX_N-00063-28313070,2020-06-05T13:41:27,Amurrio,Housing,Rent,-742.53,19692.33
buyer_3,Ana,35,ES70209569304834571550,TRX_N-00064-75957751,2020-06-05T13:37:49,Amurrio,Basic services,water,-20.74,19671.59
buyer_3,Ana,35,ES70209569304834571550,TRX_N-00065-53616194,2020-06-05T18:58:59,Amurrio,Basic services,electricity,-120.01,19551.58
buyer_3,Ana,35,ES70209569304834571550,TRX_N-00066-31585176,2020-06-06T21:45:53,Amurrio,Basic services,water,-65.4,19486.18
buyer_3,Ana,35,ES70209569304834571550,TRX_N-00067-00869407,2020-06-06T08:39:15,Amurrio,Basic services,electricity,-145.41,19340.77
buyer_3,Ana,35,ES70209569304834571550,TRX_N-00068-14629241,2020-06-06T21:51:41,Amurrio,Basic services,gas,-51.14,19289.63
buyer_3,Ana,35,ES70209569304834571550,TRX_N-00069-18015777,2020-06-07T16:30:31,Amurrio,Basic services,gas,-42.24,19247.39
buyer_3,Ana,35,ES70209569304834571550,TRX_N-00070-24115403,2020-06-07T06:25:47,Amurrio,Basic services,internet,-64.69,19182.7
buyer_3,Ana,35,ES70209569304834571550,TRX_N-00071-42169146,2020-06-21T12:56:30,Amurrio,Expense,transport,-178.17,19004.53
buyer_3,Ana,35,ES70209569304834571550,TRX_N-00072-58771952,2020-07-01T09:17:34,Amurrio,transfer,Salary,2322.78,21327.31
buyer_3,Ana,35,ES70209569304834571550,TRX_N-00073-54903399,2020-07-01T09:17:34,Amurrio,transfer,Partner Salary,2016.45,23343.76
buyer_3,Ana,35,ES70209569304834571550,TRX_N-00074-89491708,2020-07-05T18:53:41,Amurrio,Housing,Rent,-742.53,22601.23
buyer_3,Ana,35,ES70209569304834571550,TRX_N-00075-87173948,2020-07-05T14:06:07,Amurrio,Basic services,electricity,-67.09,22534.14
buyer_3,Ana,35,ES70209569304834571550,TRX_N-00076-75689401,2020-07-06T10:11:04,Amurrio,Basic services,gas,-20.05,22514.09
buyer_3,Ana,35,ES70209569304834571550,TRX_N-00077-43769296,2020-07-06T20:23:25,Amurrio,Basic services,phone,-32.99,22481.1
buyer_3,Ana,35,ES70209569304834571550,TRX_N-00078-65383340,2020-07-15T02:17:54,Amurrio,Expense,food,-624.59,21856.51
buyer_3,Ana,35,ES70209569304834571550,TRX_N-00079-28953688,2020-07-25T08:58:21,Elciego,Expense,transport,-85.46,21771.05
buyer_3,Ana,35,ES70209569304834571550,TRX_N-00080-10583485,2020-08-01T17:10:00,Amurrio,transfer,Salary,2322.78,24093.83
buyer_3,Ana,35,ES70209569304834571550,TRX_N-00081-70853738,2020-08-01T17:10:00,Amurrio,transfer,Partner Salary,2016.45,26110.28
buyer_3,Ana,35,ES70209569304834571550,TRX_N-00082-73691423,2020-08-01T17:10:00,Amurrio,transfer,Extra Income,232.28,26342.56
buyer_3,Ana,35,ES70209569304834571550,TRX_N-00083-03522586,2020-08-05T00:52:39,Amurrio,Housing,Rent,-742.53,25600.03
buyer_3,Ana,35,ES70209569304834571550,TRX_N-00084-07571693,2020-08-05T10:16:43,Amurrio,Basic services,water,-78.7,25521.33
buyer_3,Ana,35,ES70209569304834571550,TRX_N-00085-14832238,2020-08-05T17:34:15,Amurrio,Basic services,gas,-55.68,25465.65
buyer_3,Ana,35,ES70209569304834571550,TRX_N-00086-46425879,2020-08-05T13:04:16,Amurrio,Basic services,internet,-41.01,25424.64
buyer_3,Ana,35,ES70209569304834571550,TRX_N-00087-61884650,2020-08-06T19:38:23,Amurrio,Basic services,water,-24.46,25400.18
buyer_3,Ana,35,ES70209569304834571550,TRX_N-00088-36821020,2020-08-06T05:38:20,Amurrio,Basic services,phone,-55.36,25344.82
buyer_3,Ana,35,ES70209569304834571550,TRX_N-00089-59888367,2020-08-07T15:05:29,Amurrio,Basic services,water,-65.54,25279.28
buyer_3,Ana,35,ES70209569304834571550,TRX_N-00090-59159022,2020-08-16T14:38:11,Basauri,Expense,food,-319.11,24960.17
buyer_3,Ana,35,ES70209569304834571550,TRX_N-00091-82258768,2020-08-23T17:22:36,Barakaldo,Expense,transport,-158.0,24802.17
buyer_3,Ana,35,ES70209569304834571550,TRX_N-00092-78780199,2020-08-29T16:06:56,Eibar,Expense,leisure,-129.55,24672.62
buyer_3,Ana,35,ES70209569304834571550,TRX_N-00093-41751157,2020-09-01T09:00:22,Amurrio,transfer,Salary,2322.78,26995.4
buyer_3,Ana,35,ES70209569304834571550,TRX_N-00094-56774985,2020-09-01T09:00:22,Amurrio,transfer,Partner Salary,2016.45,29011.85
buyer_3,Ana,35,ES70209569304834571550,TRX_N-00095-10434771,2020-09-05T00:40:36,Amurrio,Housing,Rent,-742.53,28269.32
buyer_3,Ana,35,ES70209569304834571550,TRX_N-00096-85334734,2020-09-05T13:34:51,Amurrio,Basic services,water,-46.52,28222.8
buyer_3,Ana,35,ES70209569304834571550,TRX_N-00097-79800798,2020-09-05T21:52:15,Amurrio,Basic services,internet,-31.37,28191.43
buyer_3,Ana,35,ES70209569304834571550,TRX_N-00098-15705558,2020-09-05T17:28:58,Amurrio,Basic services,phone,-76.25,28115.18
buyer_3,Ana,35,ES70209569304834571550,TRX_N-00099-56758081,2020-09-06T03:21:34,Amurrio,Basic services,water,-24.79,28090.39
buyer_3,Ana,35,ES70209569304834571550,TRX_N-00100-98133688,2020-09-06T18:06:10,Amurrio,Basic services,gas,-77.87,28012.52
buyer_3,Ana,35,ES70209569304834571550,TRX_N-00101-95156846,2020-09-06T11:34:48,Amurrio,Basic services,internet,-33.23,27979.29
buyer_3,Ana,35,ES70209569304834571550,TRX_N-00102-77120241,2020-09-07T12:16:05,Amurrio,Basic services,internet,-50.76,27928.53
buyer_3,Ana,35,ES70209569304834571550,TRX_N-00103-88707146,2020-09-16T23:18:52,Errenteria,Expense,food,-662.08,27266.45
buyer_3,Ana,35,ES70209569304834571550,TRX_N-00104-32139551,2020-10-01T10:54:49,Amurrio,transfer,Salary,2322.78,29589.23
buyer_3,Ana,35,ES70209569304834571550,TRX_N-00105-74036491,2020-10-01T10:54:49,Amurrio,transfer,Partner Salary,2016.45,31605.68
buyer_3,Ana,35,ES70209569304834571550,TRX_N-00106-22800439,2020-10-05T20:51:09,Amurrio,Housing,Rent,-742.53,30863.15
buyer_3,Ana,35,ES70209569304834571550,TRX_N-00107-86671607,2020-10-05T12:40:10,Amurrio,Basic services,water,-30.74,30832.41
buyer_3,Ana,35,ES70209569304834571550,TRX_N-00108-42219994,2020-10-05T17:02:43,Amurrio,Basic services,electricity,-90.66,30741.75
buyer_3,Ana,35,ES70209569304834571550,TRX_N-00109-58203381,2020-10-05T14:27:08,Amurrio,Basic services,gas,-88.56,30653.19
buyer_3,Ana,35,ES70209569304834571550,TRX_N-00110-52546132,2020-10-06T10:01:37,Amurrio,Basic services,phone,-61.32,30591.87
buyer_3,Ana,35,ES70209569304834571550,TRX_N-00111-16842807,2020-10-07T02:44:10,Amurrio,Basic services,electricity,-37.52,30554.35
buyer_3,Ana,35,ES70209569304834571550,TRX_N-00112-72170263,2020-10-07T15:43:35,Amurrio,Basic services,phone,-56.52,30497.83
buyer_3,Ana,35,ES70209569304834571550,TRX_N-00113-29402541,2020-10-12T09:24:54,Amurrio,Expense,leisure,-118.94,30378.89
buyer_3,Ana,35,ES70209569304834571550,TRX_N-00114-46283331,2020-10-15T12:30:58,Amurrio,Expense,education,-628.28,29750.61
buyer_3,Ana,35,ES70209569304834571550,TRX_N-00115-20436062,2020-11-01T18:12:04,Amurrio,transfer,Salary,2322.78,32073.39
buyer_3,Ana,35,ES70209569304834571550,TRX_N-00116-14511526,2020-11-01T18:12:04,Amurrio,transfer,Partner Salary,2016.45,34089.84
buyer_3,Ana,35,ES70209569304834571550,TRX_N-00117-72984081,2020-11-01T18:12:04,Amurrio,transfer,Extra Income,232.28,34322.12
buyer_3,Ana,35,ES70209569304834571550,TRX_N-00118-49764635,2020-11-02T09:02:01,Amurrio,Expense,food,-662.73,33659.39
buyer_3,Ana,35,ES70209569304834571550,TRX_N-00119-72359232,2020-11-05T09:30:34,Amurrio,Housing,Rent,-742.53,32916.86
buyer_3,Ana,35,ES70209569304834571550,TRX_N-00120-72885942,2020-11-05T08:39:57,Amurrio,Basic services,water,-28.91,32887.95
buyer_3,Ana,35,ES70209569304834571550,TRX_N-00121-35298844,2020-11-05T12:05:10,Amurrio,Basic services,electricity,-69.22,32818.73
buyer_3,Ana,35,ES70209569304834571550,TRX_N-00122-33086747,2020-11-05T11:34:35,Amurrio,Basic services,gas,-17.44,32801.29
buyer_3,Ana,35,ES70209569304834571550,TRX_N-00123-20088454,2020-11-05T15:00:20,Amurrio,Basic services,internet,-69.94,32731.35
buyer_3,Ana,35,ES70209569304834571550,TRX_N-00124-37105006,2020-11-06T17:28:41,Amurrio,Basic services,internet,-78.63,32652.72
buyer_3,Ana,35,ES70209569304834571550,TRX_N-00125-11399923,2020-11-07T08:22:57,Amurrio,Basic services,gas,-69.25,32583.47
buyer_3,Ana,35,ES70209569304834571550,TRX_N-00126-26500983,2020-11-19T15:12:50,Amurrio,Expense,food,-571.24,32012.23
buyer_3,Ana,35,ES70209569304834571550,TRX_N-00127-69662146,2020-11-27T08:57:54,Amurrio,Expense,clothing,-89.23,31923.0
buyer_3,Ana,35,ES70209569304834571550,TRX_N-00128-13585023,2020-12-01T10:34:34,Amurrio,transfer,Salary,2322.78,34245.78
buyer_3,Ana,35,ES70209569304834571550,TRX_N-00129-17233554,2020-12-01T10:34:34,Amurrio,transfer,Partner Salary,2016.45,36262.23
buyer_3,Ana,35,ES70209569304834571550,TRX_N-00130-41013465,2020-12-01T10:34:34,Amurrio,transfer,Bonus,2093.11,38355.34
buyer_3,Ana,35,ES70209569304834571550,TRX_N-00131-15949303,2020-12-05T07:55:44,Amurrio,Housing,Rent,-742.53,37612.81
buyer_3,Ana,35,ES70209569304834571550,TRX_N-00132-55328397,2020-12-05T14:39:47,Amurrio,Basic services,water,-79.78,37533.03
buyer_3,Ana,35,ES70209569304834571550,TRX_N-00133-22241083,2020-12-05T10:16:51,Amurrio,Basic services,electricity,-79.56,37453.47
buyer_3,Ana,35,ES70209569304834571550,TRX_N-00134-46976018,2020-12-05T13:31:44,Amurrio,Basic services,phone,-30.75,37422.72
buyer_3,Ana,35,ES70209569304834571550,TRX_N-00135-61517163,2020-12-06T18:11:40,Amurrio,Basic services,phone,-65.35,37357.37
buyer_3,Ana,35,ES70209569304834571550,TRX_N-00136-47779965,2020-12-07T20:28:04,Amurrio,Basic services,internet,-38.57,37318.8
buyer_3,Ana,35,ES70209569304834571550,TRX_N-00137-85012348,2020-12-10T15:40:30,Bilbao,Expense,clothing,-240.18,37078.62
buyer_3,Ana,35,ES70209569304834571550,TRX_N-00138-81954587,2020-12-13T08:12:57,Amurrio,Expense,transport,-124.18,36954.44
buyer_3,Ana,35,ES70209569304834571550,TRX_N-00139-76896723,2020-12-24T04:22:24,Amurrio,Expense,gifts,-410.43,36544.01
buyer_3,Ana,35,ES70209569304834571550,TRX_N-00140-54134320,2021-01-01T20:58:04,Amurrio,transfer,Salary,2322.78,38866.79
buyer_3,Ana,35,ES70209569304834571550,TRX_N-00141-92320243,2021-01-01T20:58:04,Amurrio,transfer,Partner Salary,2016.45,40883.24
buyer_3,Ana,35,ES70209569304834571550,TRX_N-00142-20246525,2021-01-05T08:23:01,Amurrio,Housing,Rent,-742.53,40140.71
buyer_3,Ana,35,ES70209569304834571550,TRX_N-00143-50403196,2021-01-05T06:29:40,Amurrio,Basic services,phone,-41.36,40099.35
buyer_3,Ana,35,ES70209569304834571550,TRX_N-00144-70569771,2021-01-06T11:12:56,Amurrio,Expense,transport,-38.11,40061.24
buyer_3,Ana,35,ES70209569304834571550,TRX_N-00145-44583281,2021-01-07T02:01:20,Amurrio,Basic services,internet,-46.08,40015.16
buyer_3,Ana,35,ES70209569304834571550,TRX_N-00146-15902998,2021-01-18T13:12:12,Amurrio,Expense,clothing,-150.67,39864.49
buyer_3,Ana,35,ES70209569304834571550,TRX_N-00147-52425747,2021-01-18T08:29:56,Amurrio,Expense,appliances,-1346.76,38517.73
buyer_3,Ana,35,ES70209569304834571550,TRX_N-00148-96282053,2021-01-24T10:03:34,Amurrio,Expense,food,-198.46,38319.27
buyer_3,Ana,35,ES70209569304834571550,TRX_N-00149-68703516,2021-02-01T16:07:40,Amurrio,transfer,Salary,2322.78,40642.05
buyer_3,Ana,35,ES70209569304834571550,TRX_N-00150-21476088,2021-02-01T16:07:40,Amurrio,transfer,Partner Salary,2016.45,42658.5
buyer_3,Ana,35,ES70209569304834571550,TRX_N-00151-41932581,2021-02-01T16:07:40,Amurrio,transfer,Extra Income,232.28,42890.78
buyer_3,Ana,35,ES70209569304834571550,TRX_N-00152-60294839,2021-02-01T16:26:39,Amurrio,Expense,clothing,-181.31,42709.47
buyer_3,Ana,35,ES70209569304834571550,TRX_N-00153-23969654,2021-02-02T17:10:42,Amurrio,Expense,transport,-199.95,42509.52
buyer_3,Ana,35,ES70209569304834571550,TRX_N-00154-31642805,2021-02-04T10:23:48,Amurrio,Expense,appliances,-1441.13,41068.39
buyer_3,Ana,35,ES70209569304834571550,TRX_N-00155-27477884,2021-02-05T09:01:40,Amurrio,Housing,Rent,-742.53,40325.86
buyer_3,Ana,35,ES70209569304834571550,TRX_N-00156-98098807,2021-02-05T13:30:20,Amurrio,Basic services,internet,-77.54,40248.32
buyer_3,Ana,35,ES70209569304834571550,TRX_N-00157-80025170,2021-02-06T18:45:58,Amurrio,Basic services,water,-37.75,40210.57
buyer_3,Ana,35,ES70209569304834571550,TRX_N-00158-60919204,2021-02-06T18:56:07,Amurrio,Basic services,electricity,-62.34,40148.23
buyer_3,Ana,35,ES70209569304834571550,TRX_N-00159-50567488,2021-02-06T08:43:19,Amurrio,Basic services,internet,-33.67,40114.56
buyer_3,Ana,35,ES70209569304834571550,TRX_N-00160-01845612,2021-02-06T09:34:40,Amurrio,Basic services,phone,-22.36,40092.2
buyer_3,Ana,35,ES70209569304834571550,TRX_N-00161-66639626,2021-02-07T06:40:26,Amurrio,Basic services,water,-22.97,40069.23
buyer_3,Ana,35,ES70209569304834571550,TRX_N-00162-23643701,2021-02-07T16:43:29,Amurrio,Basic services,electricity,-67.12,40002.11
buyer_3,Ana,35,ES70209569304834571550,TRX_N-00163-08167352,2021-02-07T16:10:45,Amurrio,Basic services,internet,-74.66,39927.45
buyer_3,Ana,35,ES70209569304834571550,TRX_N-00164-70122883,2021-02-07T20:42:37,Amurrio,Basic services,phone,-43.67,39883.78
buyer_3,Ana,35,ES70209569304834571550,TRX_N-00165-95079195,2021-02-10T16:56:40,Amurrio,Expense,clothing,-339.34,39544.44
buyer_3,Ana,35,ES70209569304834571550,TRX_N-00166-87453186,2021-02-21T10:31:16,Amurrio,Expense,repairs,-944.38,38600.06
buyer_3,Ana,35,ES70209569304834571550,TRX_N-00167-16518255,2021-02-22T15:52:31,Amurrio,Expense,healthcare,-300.97,38299.09
buyer_3,Ana,35,ES70209569304834571550,TRX_N-00168-66941060,2021-02-27T13:48:37,Bermeo,Expense,transport,-121.86,38177.23
buyer_3,Ana,35,ES70209569304834571550,TRX_N-00169-33441712,2021-03-01T08:02:40,Amurrio,transfer,Salary,2322.78,40500.01
buyer_3,Ana,35,ES70209569304834571550,TRX_N-00170-79359692,2021-03-01T08:02:40,Amurrio,transfer,Partner Salary,2016.45,42516.46
buyer_3,Ana,35,ES70209569304834571550,TRX_N-00171-29743129,2021-03-02T13:29:48,Amurrio,Expense,food,-552.2,41964.26
buyer_3,Ana,35,ES70209569304834571550,TRX_N-00172-81569836,2021-03-05T09:11:53,Amurrio,Housing,Rent,-742.53,41221.73
buyer_3,Ana,35,ES70209569304834571550,TRX_N-00173-27128935,2021-03-05T11:01:39,Amurrio,Basic services,electricity,-66.95,41154.78
buyer_3,Ana,35,ES70209569304834571550,TRX_N-00174-26916822,2021-03-05T13:38:15,Amurrio,Basic services,phone,-44.8,41109.98
buyer_3,Ana,35,ES70209569304834571550,TRX_N-00175-57134646,2021-03-06T17:33:27,Amurrio,Basic services,gas,-94.03,41015.95
buyer_3,Ana,35,ES70209569304834571550,TRX_N-00176-92530107,2021-03-06T17:30:38,Amurrio,Basic services,phone,-64.67,40951.28
buyer_3,Ana,35,ES70209569304834571550,TRX_N-00177-87898510,2021-03-07T07:26:57,Amurrio,Basic services,water,-36.61,40914.67
buyer_3,Ana,35,ES70209569304834571550,TRX_N-00178-85430798,2021-03-07T11:55:00,Amurrio,Basic services,internet,-39.32,40875.35
buyer_3,Ana,35,ES70209569304834571550,TRX_N-00179-50428562,2021-03-12T14:30:35,Amurrio,Expense,food,-736.95,40138.4
buyer_3,Ana,35,ES70209569304834571550,TRX_N-00180-10041771,2021-03-16T09:51:57,Amurrio,Expense,leisure,-24.39,40114.01
buyer_3,Ana,35,ES70209569304834571550,TRX_N-00181-18612336,2021-03-17T13:40:07,Amurrio,Expense,leisure,-232.94,39881.07
buyer_3,Ana,35,ES70209569304834571550,TRX_N-00182-71723325,2021-03-22T09:34:56,Hernani,Expense,gifts,-294.48,39586.59
buyer_3,Ana,35,ES70209569304834571550,TRX_N-00183-46758913,2021-03-25T13:26:36,Amurrio,Expense,repairs,-99.98,39486.61
buyer_3,Ana,35,ES70209569304834571550,TRX_N-00184-81989983,2021-03-29T21:58:28,Amurrio,Expense,healthcare,-290.43,39196.18
buyer_3,Ana,35,ES70209569304834571550,TRX_N-00185-89952482,2021-04-01T20:17:48,Amurrio,transfer,Salary,2322.78,41518.96
buyer_3,Ana,35,ES70209569304834571550,TRX_N-00186-36557679,2021-04-01T20:17:48,Amurrio,transfer,Partner Salary,2016.45,43535.41
buyer_3,Ana,35,ES70209569304834571550,TRX_N-00187-60033589,2021-04-01T20:17:48,Amurrio,transfer,Extra Income,232.28,43767.69
buyer_3,Ana,35,ES70209569304834571550,TRX_N-00188-25137206,2021-04-04T10:05:01,Amurrio,Expense,food,-412.31,43355.38
buyer_3,Ana,35,ES70209569304834571550,TRX_N-00189-80373726,2021-04-05T21:01:58,Amurrio,Housing,Rent,-742.53,42612.85
buyer_3,Ana,35,ES70209569304834571550,TRX_N-00190-85974557,2021-04-05T04:58:32,Amurrio,Basic services,water,-68.78,42544.07
buyer_3,Ana,35,ES70209569304834571550,TRX_N-00191-61216242,2021-04-05T16:11:17,Amurrio,Basic services,phone,-33.23,42510.84
buyer_3,Ana,35,ES70209569304834571550,TRX_N-00192-56732302,2021-04-05T15:26:58,Amurrio,Expense,gifts,-185.98,42324.86
buyer_3,Ana,35,ES70209569304834571550,TRX_N-00193-35437151,2021-04-06T14:38:41,Amurrio,Basic services,electricity,-31.35,42293.51
buyer_3,Ana,35,ES70209569304834571550,TRX_N-00194-03198577,2021-04-06T15:54:34,Amurrio,Basic services,internet,-70.73,42222.78
buyer_3,Ana,35,ES70209569304834571550,TRX_N-00195-78228680,2021-04-06T19:53:40,Amurrio,Basic services,phone,-82.48,42140.3
buyer_3,Ana,35,ES70209569304834571550,TRX_N-00196-69507691,2021-04-07T08:06:52,Amurrio,Basic services,electricity,-68.9,42071.4
buyer_3,Ana,35,ES70209569304834571550,TRX_N-00197-13927278,2021-04-07T11:43:36,Amurrio,Basic services,phone,-77.5,41993.9
buyer_3,Ana,35,ES70209569304834571550,TRX_N-00198-84938879,2021-04-14T22:56:42,Amurrio,Expense,transport,-131.95,41861.95
buyer_3,Ana,35,ES70209569304834571550,TRX_N-00199-86846337,2021-04-15T13:27:29,Amurrio,Expense,healthcare,-153.23,41708.72
buyer_3,Ana,35,ES70209569304834571550,TRX_N-00200-23200398,2021-04-24T12:01:01,Amurrio,Expense,leisure,-171.11,41537.61
buyer_3,Ana,35,ES70209569304834571550,TRX_N-00201-70618737,2021-04-26T20:20:15,Amurrio,Expense,clothing,-408.83,41128.78
buyer_3,Ana,35,ES70209569304834571550,TRX_N-00202-05754069,2021-05-01T21:01:10,Amurrio,transfer,Salary,2322.78,43451.56
buyer_3,Ana,35,ES70209569304834571550,TRX_N-00203-11737431,2021-05-01T21:01:10,Amurrio,transfer,Partner Salary,2016.45,45468.01
buyer_3,Ana,35,ES70209569304834571550,TRX_N-00204-92031746,2021-05-05T09:39:16,Amurrio,Housing,Rent,-742.53,44725.48
buyer_3,Ana,35,ES70209569304834571550,TRX_N-00205-75907471,2021-05-05T13:35:11,Amurrio,Basic services,phone,-83.94,44641.54
buyer_3,Ana,35,ES70209569304834571550,TRX_N-00206-29425061,2021-05-06T14:15:44,Amurrio,Basic services,electricity,-54.26,44587.28
buyer_3,Ana,35,ES70209569304834571550,TRX_N-00207-20144131,2021-05-07T20:07:34,Amurrio,Basic services,internet,-30.23,44557.05
buyer_3,Ana,35,ES70209569304834571550,TRX_N-00208-67693441,2021-05-11T14:39:35,Amurrio,Expense,leisure,-170.13,44386.92
buyer_3,Ana,35,ES70209569304834571550,TRX_N-00209-66919264,2021-05-17T19:36:10,Amurrio,Expense,transport,-193.59,44193.33
buyer_3,Ana,35,ES70209569304834571550,TRX_N-00210-72751982,2021-05-24T09:27:55,Amurrio,Expense,leisure,-58.87,44134.46
buyer_3,Ana,35,ES70209569304834571550,TRX_N-00211-08842855,2021-05-28T08:01:10,Llodio,Expense,transport,-199.02,43935.44
buyer_3,Ana,35,ES70209569304834571550,TRX_N-00212-04049445,2021-05-30T15:28:33,Amurrio,Expense,healthcare,-335.39,43600.05
buyer_3,Ana,35,ES70209569304834571550,TRX_N-00213-30126424,2021-06-01T20:07:31,Amurrio,transfer,Salary,2322.78,45922.83
buyer_3,Ana,35,ES70209569304834571550,TRX_N-00214-07979750,2021-06-01T20:07:31,Amurrio,transfer,Partner Salary,2016.45,47939.28
buyer_3,Ana,35,ES70209569304834571550,TRX_N-00215-17597448,2021-06-01T20:07:31,Amurrio,transfer,Extra Income,232.28,48171.56
buyer_3,Ana,35,ES70209569304834571550,TRX_N-00216-49262818,2021-06-01T20:07:31,Amurrio,transfer,Bonus,2093.3,50264.86
buyer_3,Ana,35,ES70209569304834571550,TRX_N-00217-67894020,2021-06-03T16:32:39,Amurrio,Expense,leisure,-168.96,50095.9
buyer_3,Ana,35,ES70209569304834571550,TRX_N-00218-77686838,2021-06-05T15:29:32,Amurrio,Housing,Rent,-742.53,49353.37
buyer_3,Ana,35,ES70209569304834571550,TRX_N-00219-50206491,2021-06-05T14:03:18,Amurrio,Basic services,gas,-94.56,49258.81
buyer_3,Ana,35,ES70209569304834571550,TRX_N-00220-00759301,2021-06-05T12:17:12,Amurrio,Basic services,internet,-62.65,49196.16
buyer_3,Ana,35,ES70209569304834571550,TRX_N-00221-30249296,2021-06-05T23:04:55,Amurrio,Basic services,phone,-48.06,49148.1
buyer_3,Ana,35,ES70209569304834571550,TRX_N-00222-43649595,2021-06-05T12:22:11,Amurrio,Expense,appliances,-1984.66,47163.44
buyer_3,Ana,35,ES70209569304834571550,TRX_N-00223-53920578,2021-06-06T23:40:56,Amurrio,Basic services,electricity,-91.95,47071.49
buyer_3,Ana,35,ES70209569304834571550,TRX_N-00224-92008985,2021-06-07T18:36:42,Amurrio,Basic services,electricity,-48.02,47023.47
buyer_3,Ana,35,ES70209569304834571550,TRX_N-00225-92620129,2021-06-07T13:28:24,Amurrio,Basic services,gas,-68.11,46955.36
buyer_3,Ana,35,ES70209569304834571550,TRX_N-00226-16804463,2021-06-07T09:44:02,Amurrio,Basic services,phone,-59.51,46895.85
buyer_3,Ana,35,ES70209569304834571550,TRX_N-00227-43719054,2021-06-15T08:23:47,Durango,Expense,clothing,-386.96,46508.89
buyer_3,Ana,35,ES70209569304834571550,TRX_N-00228-01062432,2021-06-28T13:56:29,Amurrio,Expense,leisure,-58.94,46449.95
buyer_3,Ana,35,ES70209569304834571550,TRX_N-00229-42383108,2021-07-01T17:17:36,Amurrio,transfer,Salary,2322.78,48772.73
buyer_3,Ana,35,ES70209569304834571550,TRX_N-00230-04603526,2021-07-01T17:17:36,Amurrio,transfer,Partner Salary,2016.45,50789.18
buyer_3,Ana,35,ES70209569304834571550,TRX_N-00231-00513128,2021-07-05T14:39:11,Amurrio,Housing,Rent,-742.53,50046.65
buyer_3,Ana,35,ES70209569304834571550,TRX_N-00232-40811100,2021-07-05T22:28:58,Amurrio,Basic services,electricity,-97.79,49948.86
buyer_3,Ana,35,ES70209569304834571550,TRX_N-00233-42506602,2021-07-05T16:46:39,Amurrio,Basic services,internet,-55.63,49893.23
buyer_3,Ana,35,ES70209569304834571550,TRX_N-00234-26635248,2021-07-06T15:01:51,Amurrio,Basic services,water,-18.44,49874.79
buyer_3,Ana,35,ES70209569304834571550,TRX_N-00235-98207700,2021-07-06T20:47:24,Amurrio,Basic services,internet,-52.11,49822.68
buyer_3,Ana,35,ES70209569304834571550,TRX_N-00236-54758024,2021-07-07T15:24:40,Amurrio,Basic services,water,-30.37,49792.31
buyer_3,Ana,35,ES70209569304834571550,TRX_N-00237-72409785,2021-07-07T11:01:35,Amurrio,Basic services,gas,-89.81,49702.5
buyer_3,Ana,35,ES70209569304834571550,TRX_N-00238-09092583,2021-07-07T04:49:51,Amurrio,Basic services,internet,-36.48,49666.02
buyer_3,Ana,35,ES70209569304834571550,TRX_N-00239-65853412,2021-07-08T11:36:06,Amurrio,Expense,travel,-790.61,48875.41
buyer_3,Ana,35,ES70209569304834571550,TRX_N-00240-91692859,2021-07-13T23:51:24,Amurrio,Expense,healthcare,-344.3,48531.11
buyer_3,Ana,35,ES70209569304834571550,TRX_N-00241-26281458,2021-08-01T17:47:40,Amurrio,transfer,Salary,2322.78,50853.89
buyer_3,Ana,35,ES70209569304834571550,TRX_N-00242-78026130,2021-08-01T17:47:40,Amurrio,transfer,Partner Salary,2016.45,52870.34
buyer_3,Ana,35,ES70209569304834571550,TRX_N-00243-65909111,2021-08-05T14:44:33,Amurrio,Housing,Rent,-742.53,52127.81
buyer_3,Ana,35,ES70209569304834571550,TRX_N-00244-83104449,2021-08-05T08:27:42,Amurrio,Basic services,phone,-94.23,52033.58
buyer_3,Ana,35,ES70209569304834571550,TRX_N-00245-41368906,2021-08-06T20:49:23,Amurrio,Basic services,electricity,-34.53,51999.05
buyer_3,Ana,35,ES70209569304834571550,TRX_N-00246-54818752,2021-08-06T21:59:22,Amurrio,Basic services,internet,-42.05,51957.0
buyer_3,Ana,35,ES70209569304834571550,TRX_N-00247-26274567,2021-08-06T12:32:38,Amurrio,Basic services,phone,-28.12,51928.88
buyer_3,Ana,35,ES70209569304834571550,TRX_N-00248-09532594,2021-08-07T21:47:39,Amurrio,Basic services,phone,-68.99,51859.89
buyer_3,Ana,35,ES70209569304834571550,TRX_N-00249-05431341,2021-08-08T21:32:37,Amurrio,Expense,food,-491.26,51368.63
buyer_3,Ana,35,ES70209569304834571550,TRX_N-00250-48166960,2021-08-09T20:25:25,Amurrio,Expense,transport,-27.95,51340.68
buyer_3,Ana,35,ES70209569304834571550,TRX_N-00251-94357255,2021-08-14T16:08:42,Amurrio,Expense,transport,-44.22,51296.46
buyer_3,Ana,35,ES70209569304834571550,TRX_N-00252-07213826,2021-08-25T16:23:24,Amurrio,Expense,transport,-180.73,51115.73
buyer_3,Ana,35,ES70209569304834571550,TRX_N-00253-05167566,2021-08-31T11:03:45,Amurrio,Expense,repairs,-94.9,51020.83
buyer_3,Ana,35,ES70209569304834571550,TRX_N-00254-57784281,2021-09-01T20:35:52,Amurrio,transfer,Salary,2322.78,53343.61
buyer_3,Ana,35,ES70209569304834571550,TRX_N-00255-08693516,2021-09-01T20:35:52,Amurrio,transfer,Partner Salary,2016.45,55360.06
buyer_3,Ana,35,ES70209569304834571550,TRX_N-00256-25676392,2021-09-01T20:35:52,Amurrio,transfer,Extra Income,232.28,55592.34
buyer_3,Ana,35,ES70209569304834571550,TRX_N-00257-07191009,2021-09-01T19:32:38,Bermeo,Expense,food,-513.82,55078.52
buyer_3,Ana,35,ES70209569304834571550,TRX_N-00258-99460149,2021-09-05T20:25:58,Amurrio,Housing,Rent,-742.53,54335.99
buyer_3,Ana,35,ES70209569304834571550,TRX_N-00259-43675843,2021-09-05T13:52:11,Amurrio,Basic services,water,-45.7,54290.29
buyer_3,Ana,35,ES70209569304834571550,TRX_N-00260-60988457,2021-09-05T17:40:00,Amurrio,Basic services,electricity,-61.42,54228.87
buyer_3,Ana,35,ES70209569304834571550,TRX_N-00261-35760682,2021-09-05T09:28:01,Amurrio,Basic services,phone,-99.15,54129.72
buyer_3,Ana,35,ES70209569304834571550,TRX_N-00262-87092285,2021-09-06T22:44:55,Amurrio,Basic services,electricity,-52.75,54076.97
buyer_3,Ana,35,ES70209569304834571550,TRX_N-00263-25734769,2021-09-06T12:56:31,Amurrio,Expense,leisure,-245.59,53831.38
buyer_3,Ana,35,ES70209569304834571550,TRX_N-00264-09796369,2021-09-07T16:08:50,Amurrio,Basic services,electricity,-51.32,53780.06
buyer_3,Ana,35,ES70209569304834571550,TRX_N-00265-64947485,2021-09-07T15:30:13,Amurrio,Basic services,gas,-28.7,53751.36
buyer_3,Ana,35,ES70209569304834571550,TRX_N-00266-65404935,2021-09-07T15:20:07,Amurrio,Basic services,internet,-51.37,53699.99
buyer_3,Ana,35,ES70209569304834571550,TRX_N-00267-57579067,2021-09-09T13:45:54,Amurrio,Expense,leisure,-45.36,53654.63
buyer_3,Ana,35,ES70209569304834571550,TRX_N-00268-83954030,2021-09-20T17:26:31,Amurrio,Expense,clothing,-434.49,53220.14
buyer_3,Ana,35,ES70209569304834571550,TRX_N-00269-98996627,2021-10-01T06:36:11,Amurrio,transfer,Salary,2322.78,55542.92
buyer_3,Ana,35,ES70209569304834571550,TRX_N-00270-30073335,2021-10-01T06:36:11,Amurrio,transfer,Partner Salary,2016.45,57559.37
buyer_3,Ana,35,ES70209569304834571550,TRX_N-00271-43302484,2021-10-02T17:01:10,Amurrio,Expense,education,-781.22,56778.15
buyer_3,Ana,35,ES70209569304834571550,TRX_N-00272-99952942,2021-10-05T02:45:18,Amurrio,Housing,Rent,-742.53,56035.62
buyer_3,Ana,35,ES70209569304834571550,TRX_N-00273-79753245,2021-10-05T15:19:14,Amurrio,Basic services,internet,-51.81,55983.81
buyer_3,Ana,35,ES70209569304834571550,TRX_N-00274-59435786,2021-10-05T22:12:54,Alegría-Dulantzi,Expense,gifts,-47.95,55935.86
buyer_3,Ana,35,ES70209569304834571550,TRX_N-00275-75105881,2021-10-06T14:43:33,Amurrio,Basic services,electricity,-55.96,55879.9
buyer_3,Ana,35,ES70209569304834571550,TRX_N-00276-65778429,2021-10-06T08:11:51,Amurrio,Basic services,internet,-53.65,55826.25
buyer_3,Ana,35,ES70209569304834571550,TRX_N-00277-46543521,2021-10-07T00:26:43,Amurrio,Basic services,electricity,-64.72,55761.53
buyer_3,Ana,35,ES70209569304834571550,TRX_N-00278-41322374,2021-10-07T18:30:54,Lasarte-Oria,Expense,gifts,-143.76,55617.77
buyer_3,Ana,35,ES70209569304834571550,TRX_N-00279-25728326,2021-10-16T17:49:18,Amurrio,Expense,food,-553.41,55064.36
buyer_3,Ana,35,ES70209569304834571550,TRX_N-00280-26309811,2021-10-31T19:44:28,Amurrio,Expense,transport,-52.15,55012.21
buyer_3,Ana,35,ES70209569304834571550,TRX_N-00281-36842471,2021-11-01T18:35:28,Amurrio,transfer,Salary,2322.78,57334.99
buyer_3,Ana,35,ES70209569304834571550,TRX_N-00282-14620817,2021-11-01T18:35:28,Amurrio,transfer,Partner Salary,2016.45,59351.44
buyer_3,Ana,35,ES70209569304834571550,TRX_N-00283-86345531,2021-11-01T18:35:28,Amurrio,transfer,Extra Income,232.28,59583.72
buyer_3,Ana,35,ES70209569304834571550,TRX_N-00284-98489023,2021-11-05T07:44:10,Amurrio,Housing,Rent,-742.53,58841.19
buyer_3,Ana,35,ES70209569304834571550,TRX_N-00285-88982820,2021-11-05T21:38:50,Amurrio,Basic services,internet,-54.72,58786.47
buyer_3,Ana,35,ES70209569304834571550,TRX_N-00286-80572487,2021-11-06T21:03:22,Amurrio,Basic services,internet,-71.57,58714.9
buyer_3,Ana,35,ES70209569304834571550,TRX_N-00287-38414919,2021-11-06T10:40:32,Amurrio,Expense,leisure,-193.2,58521.7
buyer_3,Ana,35,ES70209569304834571550,TRX_N-00288-60526808,2021-11-07T20:03:20,Amurrio,Basic services,electricity,-44.36,58477.34
buyer_3,Ana,35,ES70209569304834571550,TRX_N-00289-90997540,2021-11-07T17:01:30,Amurrio,Basic services,phone,-39.4,58437.94
buyer_3,Ana,35,ES70209569304834571550,TRX_N-00290-29999404,2021-11-08T11:34:23,Labastida,Expense,transport,-110.93,58327.01
buyer_3,Ana,35,ES70209569304834571550,TRX_N-00291-33786245,2021-11-12T14:41:18,Amurrio,Expense,food,-655.03,57671.98
buyer_3,Ana,35,ES70209569304834571550,TRX_N-00292-88154437,2021-12-01T08:53:42,Amurrio,transfer,Salary,2322.78,59994.76
buyer_3,Ana,35,ES70209569304834571550,TRX_N-00293-73787378,2021-12-01T08:53:42,Amurrio,transfer,Partner Salary,2016.45,62011.21
buyer_3,Ana,35,ES70209569304834571550,TRX_N-00294-53655878,2021-12-01T08:53:42,Amurrio,transfer,Bonus,2471.89,64483.1
buyer_3,Ana,35,ES70209569304834571550,TRX_N-00295-06076951,2021-12-01T13:44:47,Amurrio,Expense,food,-196.43,64286.67
buyer_3,Ana,35,ES70209569304834571550,TRX_N-00296-92942114,2021-12-02T10:24:58,Amurrio,Expense,transport,-144.84,64141.83
buyer_3,Ana,35,ES70209569304834571550,TRX_N-00297-61237214,2021-12-05T16:50:08,Amurrio,Housing,Rent,-742.53,63399.3
buyer_3,Ana,35,ES70209569304834571550,TRX_N-00298-44702424,2021-12-05T12:34:42,Amurrio,Basic services,gas,-42.62,63356.68
buyer_3,Ana,35,ES70209569304834571550,TRX_N-00299-45991497,2021-12-05T13:00:34,Amurrio,Basic services,internet,-42.17,63314.51
buyer_3,Ana,35,ES70209569304834571550,TRX_N-00300-96834204,2021-12-06T02:19:02,Amurrio,Basic services,internet,-58.28,63256.23
buyer_3,Ana,35,ES70209569304834571550,TRX_N-00301-01768002,2021-12-07T09:34:48,Amurrio,Basic services,water,-31.59,63224.64
buyer_3,Ana,35,ES70209569304834571550,TRX_N-00302-98401959,2021-12-07T10:19:25,Amurrio,Basic services,phone,-51.19,63173.45
buyer_3,Ana,35,ES70209569304834571550,TRX_N-00303-89760961,2021-12-10T14:01:11,Amurrio,Expense,leisure,-39.03,63134.42
buyer_3,Ana,35,ES70209569304834571550,TRX_N-00304-39939952,2021-12-16T18:47:30,Irun,Expense,transport,-155.05,62979.37
buyer_3,Ana,35,ES70209569304834571550,TRX_N-00305-19710621,2021-12-28T23:03:11,Amurrio,Expense,transport,-44.76,62934.61
buyer_3,Ana,35,ES70209569304834571550,TRX_N-00306-40517839,2022-01-01T11:36:51,Amurrio,transfer,Salary,2322.78,65257.39
buyer_3,Ana,35,ES70209569304834571550,TRX_N-00307-01802313,2022-01-01T11:36:51,Amurrio,transfer,Partner Salary,2016.45,67273.84
buyer_3,Ana,35,ES70209569304834571550,TRX_N-00308-70406644,2022-01-05T08:52:54,Amurrio,Housing,Rent,-742.53,66531.31
buyer_3,Ana,35,ES70209569304834571550,TRX_N-00309-46186883,2022-01-05T11:40:23,Amurrio,Basic services,phone,-55.33,66475.98
buyer_3,Ana,35,ES70209569304834571550,TRX_N-00310-08602104,2022-01-06T10:29:57,Sestao,Expense,food,-312.95,66163.03
buyer_3,Ana,35,ES70209569304834571550,TRX_N-00311-01349966,2022-01-06T18:29:03,Amurrio,Expense,gifts,-170.08,65992.95
buyer_3,Ana,35,ES70209569304834571550,TRX_N-00312-22875558,2022-01-07T21:38:24,Amurrio,Basic services,electricity,-91.86,65901.09
buyer_3,Ana,35,ES70209569304834571550,TRX_N-00313-06175606,2022-01-17T11:25:58,Zuia,Expense,leisure,-75.06,65826.03
buyer_3,Ana,35,ES70209569304834571550,TRX_N-00314-99689734,2022-01-29T11:43:56,Amurrio,Expense,food,-348.23,65477.8
buyer_3,Ana,35,ES70209569304834571550,TRX_N-00315-57592107,2022-02-01T14:23:59,Amurrio,transfer,Salary,2322.78,67800.58
buyer_3,Ana,35,ES70209569304834571550,TRX_N-00316-34912334,2022-02-01T14:23:59,Amurrio,transfer,Partner Salary,2016.45,69817.03
buyer_3,Ana,35,ES70209569304834571550,TRX_N-00317-56292704,2022-02-01T14:23:59,Amurrio,transfer,Extra Income,232.28,70049.31
buyer_3,Ana,35,ES70209569304834571550,TRX_N-00318-42225961,2022-02-04T17:37:44,Amurrio,Expense,gifts,-87.42,69961.89
buyer_3,Ana,35,ES70209569304834571550,TRX_N-00319-67256434,2022-02-05T17:12:07,Amurrio,Housing,Rent,-742.53,69219.36
buyer_3,Ana,35,ES70209569304834571550,TRX_N-00320-84922195,2022-02-05T12:36:59,Amurrio,Basic services,electricity,-92.03,69127.33
buyer_3,Ana,35,ES70209569304834571550,TRX_N-00321-14692932,2022-02-06T08:12:12,Amurrio,Basic services,electricity,-74.25,69053.08
buyer_3,Ana,35,ES70209569304834571550,TRX_N-00322-66771011,2022-02-06T16:35:20,Amurrio,Basic services,gas,-71.09,68981.99
buyer_3,Ana,35,ES70209569304834571550,TRX_N-00323-14218678,2022-02-07T18:37:30,Amurrio,Basic services,electricity,-80.57,68901.42
buyer_3,Ana,35,ES70209569304834571550,TRX_N-00324-72751555,2022-02-07T12:47:56,Amurrio,Basic services,gas,-58.84,68842.58
buyer_3,Ana,35,ES70209569304834571550,TRX_N-00325-28421546,2022-02-23T11:01:10,Amurrio,Expense,food,-451.97,68390.61
buyer_3,Ana,35,ES70209569304834571550,TRX_N-00326-62777133,2022-03-01T17:36:12,Amurrio,transfer,Salary,2322.78,70713.39
buyer_3,Ana,35,ES70209569304834571550,TRX_N-00327-44997133,2022-03-01T17:36:12,Amurrio,transfer,Partner Salary,2016.45,72729.84
buyer_3,Ana,35,ES70209569304834571550,TRX_N-00328-96467296,2022-03-05T16:50:14,Amurrio,Housing,Rent,-742.53,71987.31
buyer_3,Ana,35,ES70209569304834571550,TRX_N-00329-44367433,2022-03-05T17:11:26,Amurrio,Basic services,phone,-45.7,71941.61
buyer_3,Ana,35,ES70209569304834571550,TRX_N-00330-82431917,2022-03-06T23:20:02,Amurrio,Basic services,water,-23.94,71917.67
buyer_3,Ana,35,ES70209569304834571550,TRX_N-00331-97547472,2022-03-06T19:44:25,Amurrio,Basic services,gas,-53.04,71864.63
buyer_3,Ana,35,ES70209569304834571550,TRX_N-00332-13262010,2022-03-06T13:06:10,Amurrio,Basic services,internet,-63.23,71801.4
buyer_3,Ana,35,ES70209569304834571550,TRX_N-00333-62795483,2022-03-07T20:49:39,Amurrio,Basic services,gas,-24.5,71776.9
buyer_3,Ana,35,ES70209569304834571550,TRX_N-00334-80454931,2022-03-07T09:16:44,Amurrio,Basic services,internet,-70.28,71706.62
buyer_3,Ana,35,ES70209569304834571550,TRX_N-00335-32903597,2022-03-07T20:02:32,Amurrio,Expense,transport,-184.33,71522.29
buyer_3,Ana,35,ES70209569304834571550,TRX_N-00336-10005353,2022-03-09T20:20:43,Amurrio,Expense,transport,-167.44,71354.85
buyer_3,Ana,35,ES70209569304834571550,TRX_N-00337-90597208,2022-03-11T11:07:40,Amurrio,Expense,clothing,-34.79,71320.06
buyer_3,Ana,35,ES70209569304834571550,TRX_N-00338-66330090,2022-03-12T18:39:42,Leioa,Expense,repairs,-202.79,71117.27
buyer_3,Ana,35,ES70209569304834571550,TRX_N-00339-42440733,2022-03-21T04:04:39,Amurrio,Expense,healthcare,-350.69,70766.58
buyer_3,Ana,35,ES70209569304834571550,TRX_N-00340-27969138,2022-03-22T02:05:06,Amurrio,Expense,leisure,-282.52,70484.06
buyer_3,Ana,35,ES70209569304834571550,TRX_N-00341-89288238,2022-03-23T19:46:07,Zarautz,Expense,food,-781.95,69702.11
buyer_3,Ana,35,ES70209569304834571550,TRX_N-00342-29855745,2022-03-23T11:06:11,Amurrio,Expense,leisure,-111.94,69590.17
buyer_3,Ana,35,ES70209569304834571550,TRX_N-00343-02905501,2022-04-01T15:33:43,Amurrio,transfer,Salary,2322.78,71912.95
buyer_3,Ana,35,ES70209569304834571550,TRX_N-00344-84954706,2022-04-01T15:33:43,Amurrio,transfer,Partner Salary,2016.45,73929.4
buyer_3,Ana,35,ES70209569304834571550,TRX_N-00345-01254013,2022-04-01T22:08:26,Amurrio,Expense,repairs,-268.82,73660.58
buyer_3,Ana,35,ES70209569304834571550,TRX_N-00346-17100499,2022-04-05T14:12:58,Amurrio,Housing,Rent,-742.53,72918.05
buyer_3,Ana,35,ES70209569304834571550,TRX_N-00347-22389335,2022-04-05T20:06:28,Amurrio,Basic services,water,-75.19,72842.86
buyer_3,Ana,35,ES70209569304834571550,TRX_N-00348-36383771,2022-04-05T19:46:54,Amurrio,Basic services,gas,-58.84,72784.02
buyer_3,Ana,35,ES70209569304834571550,TRX_N-00349-83577729,2022-04-06T01:48:14,Amurrio,Basic services,internet,-67.87,72716.15
buyer_3,Ana,35,ES70209569304834571550,TRX_N-00350-92323036,2022-04-07T09:27:39,Amurrio,Basic services,electricity,-134.99,72581.16
buyer_3,Ana,35,ES70209569304834571550,TRX_N-00351-29527876,2022-04-11T17:16:19,Amurrio,Expense,clothing,-270.87,72310.29
buyer_3,Ana,35,ES70209569304834571550,TRX_N-00352-00110983,2022-04-14T20:24:13,Amurrio,Expense,transport,-100.19,72210.1
buyer_3,Ana,35,ES70209569304834571550,TRX_N-00353-07054956,2022-04-15T13:44:09,Amurrio,Expense,appliances,-1922.34,70287.76
buyer_3,Ana,35,ES70209569304834571550,TRX_N-00354-67811671,2022-04-16T10:04:43,Oyón-Oion,Expense,leisure,-70.93,70216.83
buyer_3,Ana,35,ES70209569304834571550,TRX_N-00355-02741319,2022-05-01T18:52:02,Amurrio,transfer,Salary,2322.78,72539.61
buyer_3,Ana,35,ES70209569304834571550,TRX_N-00356-19829643,2022-05-01T18:52:02,Amurrio,transfer,Partner Salary,2016.45,74556.06
buyer_3,Ana,35,ES70209569304834571550,TRX_N-00357-75658140,2022-05-01T18:52:02,Amurrio,transfer,Extra Income,232.28,74788.34
buyer_3,Ana,35,ES70209569304834571550,TRX_N-00358-85594090,2022-05-03T12:19:17,Amurrio,Expense,transport,-95.64,74692.7
buyer_3,Ana,35,ES70209569304834571550,TRX_N-00359-30305999,2022-05-05T21:04:37,Amurrio,Housing,Rent,-742.53,73950.17
buyer_3,Ana,35,ES70209569304834571550,TRX_N-00360-11077081,2022-05-05T09:33:23,Amurrio,Basic services,gas,-25.12,73925.05
buyer_3,Ana,35,ES70209569304834571550,TRX_N-00361-52429866,2022-05-06T15:50:49,Amurrio,Basic services,water,-10.05,73915.0
buyer_3,Ana,35,ES70209569304834571550,TRX_N-00362-14573750,2022-05-06T22:24:13,Amurrio,Basic services,gas,-29.72,73885.28
buyer_3,Ana,35,ES70209569304834571550,TRX_N-00363-79374879,2022-05-07T08:28:22,Amurrio,Basic services,internet,-36.58,73848.7
buyer_3,Ana,35,ES70209569304834571550,TRX_N-00364-66028160,2022-05-11T16:07:48,Berango,Expense,transport,-27.87,73820.83
buyer_3,Ana,35,ES70209569304834571550,TRX_N-00365-53648131,2022-05-27T17:55:30,Galdakao,Expense,food,-346.91,73473.92
buyer_3,Ana,35,ES70209569304834571550,TRX_N-00366-65465918,2022-06-01T18:16:49,Amurrio,transfer,Salary,2322.78,75796.7
buyer_3,Ana,35,ES70209569304834571550,TRX_N-00367-45016273,2022-06-01T18:16:49,Amurrio,transfer,Partner Salary,2016.45,77813.15
buyer_3,Ana,35,ES70209569304834571550,TRX_N-00368-00700185,2022-06-01T18:16:49,Amurrio,transfer,Bonus,2437.9,80251.05
buyer_3,Ana,35,ES70209569304834571550,TRX_N-00369-37920944,2022-06-05T13:43:25,Amurrio,Housing,Rent,-742.53,79508.52
buyer_3,Ana,35,ES70209569304834571550,TRX_N-00370-93348723,2022-06-05T16:55:58,Amurrio,Basic services,water,-73.95,79434.57
buyer_3,Ana,35,ES70209569304834571550,TRX_N-00371-73177414,2022-06-05T06:59:36,Amurrio,Basic services,electricity,-104.37,79330.2
buyer_3,Ana,35,ES70209569304834571550,TRX_N-00372-00426131,2022-06-05T00:12:31,Amurrio,Basic services,gas,-18.08,79312.12
buyer_3,Ana,35,ES70209569304834571550,TRX_N-00373-38076706,2022-06-06T17:26:41,Amurrio,Basic services,water,-55.52,79256.6
buyer_3,Ana,35,ES70209569304834571550,TRX_N-00374-38074344,2022-06-06T15:26:00,Amurrio,Basic services,electricity,-108.86,79147.74
buyer_3,Ana,35,ES70209569304834571550,TRX_N-00375-62836371,2022-06-06T14:05:22,Amurrio,Expense,transport,-190.24,78957.5
buyer_3,Ana,35,ES70209569304834571550,TRX_N-00376-18229908,2022-06-07T09:07:27,Amurrio,Basic services,gas,-64.86,78892.64
buyer_3,Ana,35,ES70209569304834571550,TRX_N-00377-86711997,2022-06-22T15:47:14,Amurrio,Expense,healthcare,-281.87,78610.77
buyer_3,Ana,35,ES70209569304834571550,TRX_N-00378-86639095,2022-06-24T04:00:02,Amurrio,Expense,transport,-32.4,78578.37
buyer_3,Ana,35,ES70209569304834571550,TRX_N-00379-33308041,2022-07-01T19:36:04,Amurrio,transfer,Salary,2322.78,80901.15
buyer_3,Ana,35,ES70209569304834571550,TRX_N-00380-74658945,2022-07-01T19:36:04,Amurrio,transfer,Partner Salary,2016.45,82917.6
buyer_3,Ana,35,ES70209569304834571550,TRX_N-00381-30563186,2022-07-01T09:45:04,Amurrio,Expense,food,-307.73,82609.87
buyer_3,Ana,35,ES70209569304834571550,TRX_N-00382-12400396,2022-07-01T14:29:08,Amurrio,Expense,transport,-163.3,82446.57
buyer_3,Ana,35,ES70209569304834571550,TRX_N-00383-70280914,2022-07-05T18:35:31,Amurrio,Housing,Rent,-742.53,81704.04
buyer_3,Ana,35,ES70209569304834571550,TRX_N-00384-22851692,2022-07-05T15:13:30,Amurrio,Basic services,electricity,-115.69,81588.35
buyer_3,Ana,35,ES70209569304834571550,TRX_N-00385-22099242,2022-07-05T11:55:31,Amurrio,Basic services,gas,-51.0,81537.35
buyer_3,Ana,35,ES70209569304834571550,TRX_N-00386-39508525,2022-07-05T11:32:38,Amurrio,Basic services,internet,-48.32,81489.03
buyer_3,Ana,35,ES70209569304834571550,TRX_N-00387-14326492,2022-07-06T02:56:07,Amurrio,Basic services,electricity,-68.65,81420.38
buyer_3,Ana,35,ES70209569304834571550,TRX_N-00388-88319608,2022-07-07T14:30:14,Amurrio,Basic services,gas,-68.6,81351.78
buyer_3,Ana,35,ES70209569304834571550,TRX_N-00389-05638181,2022-07-07T09:39:41,Amurrio,Basic services,phone,-49.85,81301.93
buyer_3,Ana,35,ES70209569304834571550,TRX_N-00390-58106123,2022-08-01T04:12:27,Amurrio,transfer,Salary,2322.78,83624.71
buyer_3,Ana,35,ES70209569304834571550,TRX_N-00391-38145541,2022-08-01T04:12:27,Amurrio,transfer,Partner Salary,2016.45,85641.16
buyer_3,Ana,35,ES70209569304834571550,TRX_N-00392-66057030,2022-08-01T04:12:27,Amurrio,transfer,Extra Income,232.28,85873.44
buyer_3,Ana,35,ES70209569304834571550,TRX_N-00393-55239183,2022-08-03T11:14:40,Amurrio,Expense,transport,-81.12,85792.32
buyer_3,Ana,35,ES70209569304834571550,TRX_N-00394-45703800,2022-08-05T21:12:42,Amurrio,Housing,Rent,-742.53,85049.79
buyer_3,Ana,35,ES70209569304834571550,TRX_N-00395-14849896,2022-08-05T20:05:55,Amurrio,Basic services,internet,-57.07,84992.72
buyer_3,Ana,35,ES70209569304834571550,TRX_N-00396-30523172,2022-08-05T06:35:56,Amurrio,Basic services,phone,-71.81,84920.91
buyer_3,Ana,35,ES70209569304834571550,TRX_N-00397-33924002,2022-08-06T08:53:34,Amurrio,Basic services,electricity,-92.86,84828.05
buyer_3,Ana,35,ES70209569304834571550,TRX_N-00398-91327618,2022-08-06T18:13:01,Amurrio,Basic services,internet,-30.41,84797.64
buyer_3,Ana,35,ES70209569304834571550,TRX_N-00399-74120270,2022-08-06T20:56:59,Amurrio,Basic services,phone,-40.54,84757.1
buyer_3,Ana,35,ES70209569304834571550,TRX_N-00400-23975308,2022-08-13T10:04:08,Amurrio,Expense,healthcare,-367.89,84389.21
buyer_3,Ana,35,ES70209569304834571550,TRX_N-00401-26018632,2022-08-16T14:18:44,Amurrio,Expense,transport,-165.68,84223.53
buyer_3,Ana,35,ES70209569304834571550,TRX_N-00402-98659723,2022-09-01T18:18:48,Amurrio,transfer,Salary,2322.78,86546.31
buyer_3,Ana,35,ES70209569304834571550,TRX_N-00403-07251740,2022-09-01T18:18:48,Amurrio,transfer,Partner Salary,2016.45,88562.76
buyer_3,Ana,35,ES70209569304834571550,TRX_N-00404-51200850,2022-09-04T14:09:57,Amurrio,Expense,education,-266.74,88296.02
buyer_3,Ana,35,ES70209569304834571550,TRX_N-00405-25926180,2022-09-05T10:01:05,Amurrio,Housing,Rent,-742.53,87553.49
buyer_3,Ana,35,ES70209569304834571550,TRX_N-00406-44995394,2022-09-05T16:38:37,Amurrio,Basic services,gas,-70.62,87482.87
buyer_3,Ana,35,ES70209569304834571550,TRX_N-00407-80521352,2022-09-06T12:03:02,Amurrio,Basic services,phone,-62.91,87419.96
buyer_3,Ana,35,ES70209569304834571550,TRX_N-00408-89892577,2022-09-07T12:42:55,Amurrio,Basic services,gas,-75.96,87344.0
buyer_3,Ana,35,ES70209569304834571550,TRX_N-00409-05070690,2022-09-07T13:36:17,Amurrio,Basic services,internet,-58.09,87285.91
buyer_3,Ana,35,ES70209569304834571550,TRX_N-00410-88894319,2022-09-27T09:45:11,Amurrio,Expense,travel,-655.16,86630.75
buyer_3,Ana,35,ES70209569304834571550,TRX_N-00411-61033504,2022-09-28T11:49:13,Amurrio,Expense,healthcare,-89.35,86541.4
buyer_3,Ana,35,ES70209569304834571550,TRX_N-00412-69195087,2022-09-30T11:51:10,Amurrio,Expense,food,-683.74,85857.66
buyer_3,Ana,35,ES70209569304834571550,TRX_N-00413-19092212,2022-10-01T16:46:27,Amurrio,transfer,Salary,2322.78,88180.44
buyer_3,Ana,35,ES70209569304834571550,TRX_N-00414-19469911,2022-10-01T16:46:27,Amurrio,transfer,Partner Salary,2016.45,90196.89
buyer_3,Ana,35,ES70209569304834571550,TRX_N-00415-75304482,2022-10-01T16:46:27,Amurrio,transfer,Extra Income,232.28,90429.17
buyer_3,Ana,35,ES70209569304834571550,TRX_N-00416-39975307,2022-10-01T07:56:39,Leioa,Expense,transport,-58.18,90370.99
buyer_3,Ana,35,ES70209569304834571550,TRX_N-00417-92506958,2022-10-02T03:59:06,Amurrio,Expense,clothing,-176.42,90194.57
buyer_3,Ana,35,ES70209569304834571550,TRX_N-00418-17704756,2022-10-05T13:45:28,Amurrio,Housing,Rent,-742.53,89452.04
buyer_3,Ana,35,ES70209569304834571550,TRX_N-00419-11322358,2022-10-05T13:41:40,Amurrio,Basic services,gas,-41.19,89410.85
buyer_3,Ana,35,ES70209569304834571550,TRX_N-00420-50567213,2022-10-05T08:38:52,Amurrio,Basic services,internet,-75.1,89335.75
buyer_3,Ana,35,ES70209569304834571550,TRX_N-00421-75536283,2022-10-05T13:00:02,Amurrio,Basic services,phone,-61.07,89274.68
buyer_3,Ana,35,ES70209569304834571550,TRX_N-00422-45755334,2022-10-06T13:48:47,Amurrio,Basic services,water,-35.97,89238.71
buyer_3,Ana,35,ES70209569304834571550,TRX_N-00423-63217666,2022-10-06T19:31:19,Amurrio,Basic services,phone,-95.09,89143.62
buyer_3,Ana,35,ES70209569304834571550,TRX_N-00424-00070690,2022-10-07T21:57:21,Amurrio,Basic services,water,-21.53,89122.09
buyer_3,Ana,35,ES70209569304834571550,TRX_N-00425-19828347,2022-10-07T15:07:14,Amurrio,Basic services,internet,-59.76,89062.33
buyer_3,Ana,35,ES70209569304834571550,TRX_N-00426-40101935,2022-10-09T15:50:41,Amurrio,Expense,transport,-28.52,89033.81
buyer_3,Ana,35,ES70209569304834571550,TRX_N-00427-53073954,2022-10-09T11:50:57,Amurrio,Expense,leisure,-107.83,88925.98
buyer_3,Ana,35,ES70209569304834571550,TRX_N-00428-90359839,2022-10-10T13:31:47,Amurrio,Expense,healthcare,-42.19,88883.79
buyer_3,Ana,35,ES70209569304834571550,TRX_N-00429-78735820,2022-10-12T12:12:57,Amurrio,Expense,food,-613.42,88270.37
buyer_3,Ana,35,ES70209569304834571550,TRX_N-00430-85286983,2022-10-19T16:00:43,Amurrio,Expense,food,-796.01,87474.36
buyer_3,Ana,35,ES70209569304834571550,TRX_N-00431-97152082,2022-10-21T09:05:59,Amurrio,Expense,transport,-55.39,87418.97
buyer_3,Ana,35,ES70209569304834571550,TRX_N-00432-91073155,2022-10-28T17:56:13,Arrasate,Expense,leisure,-160.78,87258.19
buyer_3,Ana,35,ES70209569304834571550,TRX_N-00433-22122910,2022-10-31T19:35:18,Amurrio,Expense,transport,-102.59,87155.6
buyer_3,Ana,35,ES70209569304834571550,TRX_N-00434-40621044,2022-11-01T13:25:29,Amurrio,transfer,Salary,2322.78,89478.38
buyer_3,Ana,35,ES70209569304834571550,TRX_N-00435-41095083,2022-11-01T13:25:29,Amurrio,transfer,Partner Salary,2016.45,91494.83
buyer_3,Ana,35,ES70209569304834571550,TRX_N-00436-91327972,2022-11-05T10:29:34,Amurrio,Housing,Rent,-742.53,90752.3
buyer_3,Ana,35,ES70209569304834571550,TRX_N-00437-11465781,2022-11-05T18:55:49,Amurrio,Basic services,water,-47.04,90705.26
buyer_3,Ana,35,ES70209569304834571550,TRX_N-00438-54938473,2022-11-05T09:20:58,Amurrio,Basic services,electricity,-50.64,90654.62
buyer_3,Ana,35,ES70209569304834571550,TRX_N-00439-53354037,2022-11-05T07:54:33,Amurrio,Basic services,internet,-65.0,90589.62
buyer_3,Ana,35,ES70209569304834571550,TRX_N-00440-78330898,2022-11-05T16:40:50,Hernani,Expense,leisure,-187.86,90401.76
buyer_3,Ana,35,ES70209569304834571550,TRX_N-00441-71140096,2022-11-06T10:50:27,Amurrio,Basic services,electricity,-143.29,90258.47
buyer_3,Ana,35,ES70209569304834571550,TRX_N-00442-56008919,2022-11-06T08:53:54,Amurrio,Basic services,gas,-55.73,90202.74
buyer_3,Ana,35,ES70209569304834571550,TRX_N-00443-20940813,2022-11-07T22:20:09,Amurrio,Basic services,electricity,-122.42,90080.32
buyer_3,Ana,35,ES70209569304834571550,TRX_N-00444-64274534,2022-11-07T13:11:32,Amurrio,Basic services,gas,-95.95,89984.37
buyer_3,Ana,35,ES70209569304834571550,TRX_N-00445-39435060,2022-11-07T18:24:15,Amurrio,Basic services,internet,-35.62,89948.75
buyer_3,Ana,35,ES70209569304834571550,TRX_N-00446-48394976,2022-11-16T17:58:03,Zarautz,Expense,transport,-58.43,89890.32
buyer_3,Ana,35,ES70209569304834571550,TRX_N-00447-80093571,2022-12-01T15:41:44,Amurrio,transfer,Salary,2322.78,92213.1
buyer_3,Ana,35,ES70209569304834571550,TRX_N-00448-99992300,2022-12-01T15:41:44,Amurrio,transfer,Partner Salary,2016.45,94229.55
buyer_3,Ana,35,ES70209569304834571550,TRX_N-00449-14555289,2022-12-01T15:41:44,Amurrio,transfer,Extra Income,232.28,94461.83
buyer_3,Ana,35,ES70209569304834571550,TRX_N-00450-08735875,2022-12-01T15:41:44,Amurrio,transfer,Bonus,2244.16,96705.99
buyer_3,Ana,35,ES70209569304834571550,TRX_N-00451-72282293,2022-12-05T15:43:31,Amurrio,Housing,Rent,-742.53,95963.46
buyer_3,Ana,35,ES70209569304834571550,TRX_N-00452-81811107,2022-12-05T08:39:48,Amurrio,Basic services,gas,-53.48,95909.98
buyer_3,Ana,35,ES70209569304834571550,TRX_N-00453-36358318,2022-12-05T02:00:00,Amurrio,Basic services,phone,-32.83,95877.15
buyer_3,Ana,35,ES70209569304834571550,TRX_N-00454-23385033,2022-12-06T13:53:08,Amurrio,Basic services,water,-28.12,95849.03
buyer_3,Ana,35,ES70209569304834571550,TRX_N-00455-49906669,2022-12-06T12:16:50,Amurrio,Basic services,internet,-78.31,95770.72
buyer_3,Ana,35,ES70209569304834571550,TRX_N-00456-15063126,2022-12-06T10:46:36,Amurrio,Basic services,phone,-29.03,95741.69
buyer_3,Ana,35,ES70209569304834571550,TRX_N-00457-19427500,2022-12-07T07:50:29,Amurrio,Basic services,water,-16.98,95724.71
buyer_3,Ana,35,ES70209569304834571550,TRX_N-00458-10031408,2022-12-07T23:54:34,Amurrio,Basic services,electricity,-92.92,95631.79
buyer_3,Ana,35,ES70209569304834571550,TRX_N-00459-35182312,2022-12-07T19:44:13,Amurrio,Basic services,gas,-18.51,95613.28
buyer_3,Ana,35,ES70209569304834571550,TRX_N-00460-19790487,2022-12-21T23:14:01,Amurrio,Expense,food,-456.62,95156.66
buyer_3,Ana,35,ES70209569304834571550,TRX_N-00461-31283143,2022-12-29T13:51:10,Amurrio,Expense,transport,-79.47,95077.19
buyer_3,Ana,35,ES70209569304834571550,TRX_N-00462-49591319,2023-01-01T18:46:18,Amurrio,transfer,Salary,2322.78,97399.97
buyer_3,Ana,35,ES70209569304834571550,TRX_N-00463-15937666,2023-01-01T18:46:18,Amurrio,transfer,Partner Salary,2016.45,99416.42
buyer_3,Ana,35,ES70209569304834571550,TRX_N-00464-82314450,2023-01-05T08:39:38,Amurrio,Housing,Rent,-742.53,98673.89
buyer_3,Ana,35,ES70209569304834571550,TRX_N-00465-97966699,2023-01-05T14:15:25,Amurrio,Basic services,water,-14.73,98659.16
buyer_3,Ana,35,ES70209569304834571550,TRX_N-00466-11260001,2023-01-07T13:25:56,Amurrio,Basic services,phone,-88.65,98570.51
buyer_3,Ana,35,ES70209569304834571550,TRX_N-00467-23873555,2023-01-12T16:32:51,Amurrio,Expense,transport,-192.1,98378.41
buyer_3,Ana,35,ES70209569304834571550,TRX_N-00468-92127825,2023-01-25T17:38:54,Amurrio,Expense,healthcare,-367.08,98011.33
buyer_3,Ana,35,ES70209569304834571550,TRX_N-00469-15251029,2023-02-01T18:34:22,Amurrio,transfer,Salary,2322.78,100334.11
buyer_3,Ana,35,ES70209569304834571550,TRX_N-00470-04118542,2023-02-01T18:34:22,Amurrio,transfer,Partner Salary,2016.45,102350.56
buyer_3,Ana,35,ES70209569304834571550,TRX_N-00471-20784388,2023-02-01T18:34:22,Amurrio,transfer,Extra Income,232.28,102582.84
buyer_3,Ana,35,ES70209569304834571550,TRX_N-00472-97144782,2023-02-03T03:47:38,Amurrio,Expense,food,-622.0,101960.84
buyer_3,Ana,35,ES70209569304834571550,TRX_N-00473-43856642,2023-02-05T13:07:34,Amurrio,Housing,Rent,-742.53,101218.31
buyer_3,Ana,35,ES70209569304834571550,TRX_N-00474-17023955,2023-02-05T10:08:03,Amurrio,Basic services,water,-61.11,101157.2
buyer_3,Ana,35,ES70209569304834571550,TRX_N-00475-35642518,2023-02-05T15:41:50,Amurrio,Basic services,electricity,-126.02,101031.18
buyer_3,Ana,35,ES70209569304834571550,TRX_N-00476-98823422,2023-02-06T11:18:44,Amurrio,Basic services,electricity,-129.75,100901.43
buyer_3,Ana,35,ES70209569304834571550,TRX_N-00477-73952019,2023-02-07T19:43:59,Amurrio,Basic services,gas,-63.01,100838.42
buyer_3,Ana,35,ES70209569304834571550,TRX_N-00478-12758496,2023-02-07T11:05:13,Amurrio,Basic services,internet,-52.42,100786.0
buyer_3,Ana,35,ES70209569304834571550,TRX_N-00479-65413722,2023-03-01T09:10:19,Amurrio,transfer,Salary,2322.78,103108.78
buyer_3,Ana,35,ES70209569304834571550,TRX_N-00480-60735674,2023-03-01T09:10:19,Amurrio,transfer,Partner Salary,2016.45,105125.23
buyer_3,Ana,35,ES70209569304834571550,TRX_N-00481-78729665,2023-03-05T09:14:30,Amurrio,Housing,Rent,-742.53,104382.7
buyer_3,Ana,35,ES70209569304834571550,TRX_N-00482-28860995,2023-03-05T15:58:30,Amurrio,Basic services,electricity,-26.1,104356.6
buyer_3,Ana,35,ES70209569304834571550,TRX_N-00483-49502480,2023-03-05T15:40:58,Amurrio,Basic services,gas,-41.26,104315.34
buyer_3,Ana,35,ES70209569304834571550,TRX_N-00484-57170640,2023-03-06T14:29:56,Amurrio,Basic services,gas,-48.78,104266.56
buyer_3,Ana,35,ES70209569304834571550,TRX_N-00485-24415701,2023-03-06T18:12:42,Amurrio,Basic services,phone,-38.47,104228.09
buyer_3,Ana,35,ES70209569304834571550,TRX_N-00486-86217743,2023-03-07T17:39:37,Amurrio,Basic services,water,-44.9,104183.19
buyer_3,Ana,35,ES70209569304834571550,TRX_N-00487-79351435,2023-03-07T15:01:59,Amurrio,Basic services,electricity,-106.84,104076.35
buyer_3,Ana,35,ES70209569304834571550,TRX_N-00488-06081267,2023-03-23T15:40:55,Amurrio,Expense,food,-458.62,103617.73
buyer_3,Ana,35,ES70209569304834571550,TRX_N-00489-24099324,2023-03-30T14:41:21,Amurrio,Expense,leisure,-147.69,103470.04
buyer_3,Ana,35,ES70209569304834571550,TRX_N-00490-19124330,2023-03-31T12:06:19,Amurrio,Expense,transport,-179.04,103291.0
buyer_3,Ana,35,ES70209569304834571550,TRX_N-00491-35392341,2023-04-01T09:33:57,Amurrio,transfer,Salary,2322.78,105613.78
buyer_3,Ana,35,ES70209569304834571550,TRX_N-00492-05112124,2023-04-01T09:33:57,Amurrio,transfer,Partner Salary,2016.45,107630.23
buyer_3,Ana,35,ES70209569304834571550,TRX_N-00493-24301625,2023-04-01T09:33:57,Amurrio,transfer,Extra Income,232.28,107862.51
buyer_3,Ana,35,ES70209569304834571550,TRX_N-00494-25997205,2023-04-05T11:13:40,Amurrio,Housing,Rent,-742.53,107119.98
buyer_3,Ana,35,ES70209569304834571550,TRX_N-00495-31296534,2023-04-05T08:09:33,Amurrio,Basic services,electricity,-121.16,106998.82
buyer_3,Ana,35,ES70209569304834571550,TRX_N-00496-25896954,2023-04-07T10:43:00,Amurrio,Basic services,water,-39.83,106958.99
buyer_3,Ana,35,ES70209569304834571550,TRX_N-00497-73840017,2023-04-07T16:44:08,Amurrio,Basic services,electricity,-75.75,106883.24
buyer_3,Ana,35,ES70209569304834571550,TRX_N-00498-35038511,2023-04-08T07:10:57,Amurrio,Expense,food,-263.92,106619.32
buyer_3,Ana,35,ES70209569304834571550,TRX_N-00499-43647323,2023-04-10T22:15:42,Basauri,Expense,education,-358.88,106260.44
buyer_3,Ana,35,ES70209569304834571550,TRX_N-00500-46714730,2023-04-25T19:57:35,Amurrio,Expense,transport,-191.84,106068.6
buyer_3,Ana,35,ES70209569304834571550,TRX_N-00501-36059641,2023-05-01T08:26:48,Amurrio,transfer,Salary,2322.78,108391.38
buyer_3,Ana,35,ES70209569304834571550,TRX_N-00502-17429256,2023-05-01T08:26:48,Amurrio,transfer,Partner Salary,2016.45,110407.83
buyer_3,Ana,35,ES70209569304834571550,TRX_N-00503-84791847,2023-05-05T12:30:22,Amurrio,Housing,Rent,-742.53,109665.3
buyer_3,Ana,35,ES70209569304834571550,TRX_N-00504-08132067,2023-05-05T15:23:43,Amurrio,Basic services,electricity,-92.65,109572.65
buyer_3,Ana,35,ES70209569304834571550,TRX_N-00505-56993052,2023-05-06T14:38:03,Amurrio,Basic services,electricity,-84.14,109488.51
buyer_3,Ana,35,ES70209569304834571550,TRX_N-00506-60533187,2023-05-07T20:31:21,Amurrio,Basic services,electricity,-70.03,109418.48
buyer_3,Ana,35,ES70209569304834571550,TRX_N-00507-20710277,2023-05-07T13:35:02,Amurrio,Basic services,gas,-30.28,109388.2
buyer_3,Ana,35,ES70209569304834571550,TRX_N-00508-94234272,2023-05-07T21:19:10,Amurrio,Basic services,internet,-60.15,109328.05
buyer_3,Ana,35,ES70209569304834571550,TRX_N-00509-67535759,2023-05-08T09:17:54,Salvatierra/Agurain,Expense,gifts,-184.72,109143.33
buyer_3,Ana,35,ES70209569304834571550,TRX_N-00510-59836489,2023-05-09T13:08:44,Amurrio,Expense,education,-627.09,108516.24
buyer_3,Ana,35,ES70209569304834571550,TRX_N-00511-29160511,2023-05-10T19:41:36,Hernani,Expense,food,-477.78,108038.46
buyer_3,Ana,35,ES70209569304834571550,TRX_N-00512-41647436,2023-05-10T16:50:26,Galdakao,Expense,leisure,-152.58,107885.88
buyer_3,Ana,35,ES70209569304834571550,TRX_N-00513-26113096,2023-05-21T17:29:59,Amurrio,Expense,healthcare,-225.25,107660.63
buyer_3,Ana,35,ES70209569304834571550,TRX_N-00514-99759322,2023-05-24T09:57:08,Amurrio,Expense,repairs,-771.44,106889.19
buyer_3,Ana,35,ES70209569304834571550,TRX_N-00515-35678140,2023-05-25T15:51:18,Amurrio,Expense,leisure,-34.22,106854.97
buyer_3,Ana,35,ES70209569304834571550,TRX_N-00516-87810421,2023-05-26T08:21:15,Amurrio,Expense,leisure,-49.51,106805.46
buyer_3,Ana,35,ES70209569304834571550,TRX_N-00517-99743260,2023-06-01T18:38:47,Amurrio,transfer,Salary,2322.78,109128.24
buyer_3,Ana,35,ES70209569304834571550,TRX_N-00518-44671340,2023-06-01T18:38:47,Amurrio,transfer,Partner Salary,2016.45,111144.69
buyer_3,Ana,35,ES70209569304834571550,TRX_N-00519-56165282,2023-06-01T18:38:47,Amurrio,transfer,Extra Income,232.28,111376.97
buyer_3,Ana,35,ES70209569304834571550,TRX_N-00520-15386158,2023-06-01T18:38:47,Amurrio,transfer,Bonus,2149.8,113526.77
buyer_3,Ana,35,ES70209569304834571550,TRX_N-00521-78702933,2023-06-01T13:57:56,Amurrio,Expense,education,-783.6,112743.17
buyer_3,Ana,35,ES70209569304834571550,TRX_N-00522-44295988,2023-06-02T11:23:00,Amurrio,Expense,appliances,-111.26,112631.91
buyer_3,Ana,35,ES70209569304834571550,TRX_N-00523-39132362,2023-06-05T05:42:28,Amurrio,Housing,Rent,-742.53,111889.38
buyer_3,Ana,35,ES70209569304834571550,TRX_N-00524-42570119,2023-06-05T13:14:20,Amurrio,Basic services,water,-39.24,111850.14
buyer_3,Ana,35,ES70209569304834571550,TRX_N-00525-82799037,2023-06-05T15:51:32,Amurrio,Basic services,internet,-31.22,111818.92
buyer_3,Ana,35,ES70209569304834571550,TRX_N-00526-44420834,2023-06-06T20:53:36,Amurrio,Basic services,electricity,-105.87,111713.05
buyer_3,Ana,35,ES70209569304834571550,TRX_N-00527-42819175,2023-06-06T08:12:27,Amurrio,Basic services,internet,-74.12,111638.93
buyer_3,Ana,35,ES70209569304834571550,TRX_N-00528-32067281,2023-06-07T09:13:56,Amurrio,Basic services,electricity,-69.23,111569.7
buyer_3,Ana,35,ES70209569304834571550,TRX_N-00529-80627429,2023-06-07T08:13:32,Amurrio,Expense,leisure,-223.07,111346.63
buyer_3,Ana,35,ES70209569304834571550,TRX_N-00530-04696076,2023-06-08T16:08:37,Amurrio,Expense,food,-754.56,110592.07
buyer_3,Ana,35,ES70209569304834571550,TRX_N-00531-46340441,2023-06-22T21:21:22,Amurrio,Expense,food,-708.37,109883.7
buyer_3,Ana,35,ES70209569304834571550,TRX_N-00532-74991581,2023-07-01T22:33:16,Amurrio,transfer,Salary,2322.78,112206.48
buyer_3,Ana,35,ES70209569304834571550,TRX_N-00533-63842984,2023-07-01T22:33:16,Amurrio,transfer,Partner Salary,2016.45,114222.93
buyer_3,Ana,35,ES70209569304834571550,TRX_N-00534-29711262,2023-07-05T20:23:01,Amurrio,Housing,Rent,-742.53,113480.4
buyer_3,Ana,35,ES70209569304834571550,TRX_N-00535-28672655,2023-07-05T08:39:30,Amurrio,Basic services,water,-68.74,113411.66
buyer_3,Ana,35,ES70209569304834571550,TRX_N-00536-69929784,2023-07-05T19:29:20,Amurrio,Basic services,electricity,-99.8,113311.86
buyer_3,Ana,35,ES70209569304834571550,TRX_N-00537-26332665,2023-07-06T20:01:03,Amurrio,Basic services,water,-30.21,113281.65
buyer_3,Ana,35,ES70209569304834571550,TRX_N-00538-70888075,2023-07-06T11:34:10,Amurrio,Basic services,gas,-59.83,113221.82
buyer_3,Ana,35,ES70209569304834571550,TRX_N-00539-66350430,2023-07-07T04:29:13,Amurrio,Basic services,gas,-63.85,113157.97
buyer_3,Ana,35,ES70209569304834571550,TRX_N-00540-26652369,2023-07-07T19:15:21,Amurrio,Basic services,internet,-47.1,113110.87
buyer_3,Ana,35,ES70209569304834571550,TRX_N-00541-96450543,2023-07-07T16:22:33,Amurrio,Basic services,phone,-56.11,113054.76
buyer_3,Ana,35,ES70209569304834571550,TRX_N-00542-88039971,2023-07-07T11:00:42,Amurrio,Expense,transport,-81.17,112973.59
buyer_3,Ana,35,ES70209569304834571550,TRX_N-00543-59020939,2023-07-11T13:03:27,Amurrio,Expense,leisure,-77.9,112895.69
buyer_3,Ana,35,ES70209569304834571550,TRX_N-00544-12299349,2023-07-12T22:25:57,Labastida,Expense,leisure,-77.77,112817.92
buyer_3,Ana,35,ES70209569304834571550,TRX_N-00545-69641674,2023-07-15T12:20:32,Sopela,Expense,clothing,-338.01,112479.91
buyer_3,Ana,35,ES70209569304834571550,TRX_N-00546-54244473,2023-07-25T09:15:07,Amurrio,Expense,leisure,-197.85,112282.06
buyer_3,Ana,35,ES70209569304834571550,TRX_N-00547-27014970,2023-08-01T11:50:24,Amurrio,transfer,Salary,2322.78,114604.84
buyer_3,Ana,35,ES70209569304834571550,TRX_N-00548-47214500,2023-08-01T11:50:24,Amurrio,transfer,Partner Salary,2016.45,116621.29
buyer_3,Ana,35,ES70209569304834571550,TRX_N-00549-25587819,2023-08-05T14:01:05,Amurrio,Housing,Rent,-742.53,115878.76
buyer_3,Ana,35,ES70209569304834571550,TRX_N-00550-17531416,2023-08-05T21:23:03,Amurrio,Basic services,electricity,-32.9,115845.86
buyer_3,Ana,35,ES70209569304834571550,TRX_N-00551-12149409,2023-08-05T12:36:40,Amurrio,Basic services,gas,-58.31,115787.55
buyer_3,Ana,35,ES70209569304834571550,TRX_N-00552-67746421,2023-08-06T19:17:45,Amurrio,Basic services,water,-73.98,115713.57
buyer_3,Ana,35,ES70209569304834571550,TRX_N-00553-73673804,2023-08-06T08:37:57,Amurrio,Basic services,electricity,-74.4,115639.17
buyer_3,Ana,35,ES70209569304834571550,TRX_N-00554-44387346,2023-08-06T21:44:23,Amurrio,Basic services,gas,-16.88,115622.29
buyer_3,Ana,35,ES70209569304834571550,TRX_N-00555-38626271,2023-08-06T14:24:04,Amurrio,Basic services,internet,-33.57,115588.72
buyer_3,Ana,35,ES70209569304834571550,TRX_N-00556-04326341,2023-08-06T19:43:32,Amurrio,Basic services,phone,-56.64,115532.08
buyer_3,Ana,35,ES70209569304834571550,TRX_N-00557-00451292,2023-08-07T12:56:07,Amurrio,Basic services,phone,-95.4,115436.68
buyer_3,Ana,35,ES70209569304834571550,TRX_N-00558-05024269,2023-08-07T17:01:56,Amurrio,Expense,healthcare,-235.75,115200.93
buyer_3,Ana,35,ES70209569304834571550,TRX_N-00559-27641828,2023-08-10T10:18:48,Amurrio,Expense,repairs,-566.8,114634.13
buyer_3,Ana,35,ES70209569304834571550,TRX_N-00560-39404000,2023-08-14T11:55:33,Amurrio,Expense,leisure,-87.85,114546.28
buyer_3,Ana,35,ES70209569304834571550,TRX_N-00561-19720239,2023-08-20T16:08:01,Amurrio,Expense,transport,-147.56,114398.72
buyer_3,Ana,35,ES70209569304834571550,TRX_N-00562-96120753,2023-08-23T12:10:16,Berango,Expense,food,-516.25,113882.47
buyer_3,Ana,35,ES70209569304834571550,TRX_N-00563-07519044,2023-09-01T06:38:43,Amurrio,transfer,Salary,2322.78,116205.25
buyer_3,Ana,35,ES70209569304834571550,TRX_N-00564-74720347,2023-09-01T06:38:43,Amurrio,transfer,Partner Salary,2016.45,118221.7
buyer_3,Ana,35,ES70209569304834571550,TRX_N-00565-49654074,2023-09-01T06:38:43,Amurrio,transfer,Extra Income,232.28,118453.98
buyer_3,Ana,35,ES70209569304834571550,TRX_N-00566-90514281,2023-09-05T14:18:48,Amurrio,Housing,Rent,-742.53,117711.45
buyer_3,Ana,35,ES70209569304834571550,TRX_N-00567-66627658,2023-09-05T13:17:50,Amurrio,Basic services,gas,-77.74,117633.71
buyer_3,Ana,35,ES70209569304834571550,TRX_N-00568-68546268,2023-09-06T14:01:15,Amurrio,Basic services,gas,-59.87,117573.84
buyer_3,Ana,35,ES70209569304834571550,TRX_N-00569-18085621,2023-09-07T20:47:17,Amurrio,Basic services,phone,-93.69,117480.15
buyer_3,Ana,35,ES70209569304834571550,TRX_N-00570-52696945,2023-10-01T13:27:24,Amurrio,transfer,Salary,2322.78,119802.93
buyer_3,Ana,35,ES70209569304834571550,TRX_N-00571-75396785,2023-10-01T13:27:24,Amurrio,transfer,Partner Salary,2016.45,121819.38
buyer_3,Ana,35,ES70209569304834571550,TRX_N-00572-42972840,2023-10-05T19:12:11,Amurrio,Housing,Rent,-742.53,121076.85
buyer_3,Ana,35,ES70209569304834571550,TRX_N-00573-84220682,2023-10-05T16:23:20,Amurrio,Basic services,electricity,-27.54,121049.31
buyer_3,Ana,35,ES70209569304834571550,TRX_N-00574-99995391,2023-10-05T17:05:38,Amurrio,Basic services,gas,-93.55,120955.76
buyer_3,Ana,35,ES70209569304834571550,TRX_N-00575-25519752,2023-10-05T23:58:23,Amurrio,Basic services,internet,-44.34,120911.42
buyer_3,Ana,35,ES70209569304834571550,TRX_N-00576-12852241,2023-10-06T11:38:39,Amurrio,Basic services,water,-17.75,120893.67
buyer_3,Ana,35,ES70209569304834571550,TRX_N-00577-27431515,2023-10-06T09:02:16,Amurrio,Basic services,phone,-83.23,120810.44
buyer_3,Ana,35,ES70209569304834571550,TRX_N-00578-00567669,2023-10-07T10:44:04,Amurrio,Basic services,water,-53.68,120756.76
buyer_3,Ana,35,ES70209569304834571550,TRX_N-00579-66621730,2023-10-07T16:18:55,Amurrio,Basic services,internet,-38.47,120718.29
buyer_3,Ana,35,ES70209569304834571550,TRX_N-00580-88803673,2023-10-23T11:17:53,Amurrio,Expense,healthcare,-356.17,120362.12
buyer_3,Ana,35,ES70209569304834571550,TRX_N-00581-82047841,2023-10-28T08:15:09,Hernani,Expense,gifts,-103.93,120258.19
buyer_3,Ana,35,ES70209569304834571550,TRX_N-00582-90867577,2023-10-30T20:55:00,Irun,Expense,clothing,-241.82,120016.37
buyer_3,Ana,35,ES70209569304834571550,TRX_N-00583-99716136,2023-11-01T09:20:33,Amurrio,transfer,Salary,2322.78,122339.15
buyer_3,Ana,35,ES70209569304834571550,TRX_N-00584-84662675,2023-11-01T09:20:33,Amurrio,transfer,Partner Salary,2016.45,124355.6
buyer_3,Ana,35,ES70209569304834571550,TRX_N-00585-68642591,2023-11-05T21:19:44,Amurrio,Housing,Rent,-742.53,123613.07
buyer_3,Ana,35,ES70209569304834571550,TRX_N-00586-34233457,2023-11-05T16:31:20,Amurrio,Basic services,electricity,-76.93,123536.14
buyer_3,Ana,35,ES70209569304834571550,TRX_N-00587-68310449,2023-11-05T22:35:03,Amurrio,Basic services,gas,-95.7,123440.44
buyer_3,Ana,35,ES70209569304834571550,TRX_N-00588-49844930,2023-11-06T15:43:47,Amurrio,Basic services,water,-38.43,123402.01
buyer_3,Ana,35,ES70209569304834571550,TRX_N-00589-21793605,2023-11-06T16:26:42,Amurrio,Basic services,gas,-19.31,123382.7
buyer_3,Ana,35,ES70209569304834571550,TRX_N-00590-54857347,2023-11-06T14:43:15,Amurrio,Basic services,phone,-37.3,123345.4
buyer_3,Ana,35,ES70209569304834571550,TRX_N-00591-41246137,2023-11-07T03:13:26,Amurrio,Basic services,water,-73.5,123271.9
buyer_3,Ana,35,ES70209569304834571550,TRX_N-00592-50100038,2023-11-07T12:48:20,Amurrio,Basic services,gas,-28.81,123243.09
buyer_3,Ana,35,ES70209569304834571550,TRX_N-00593-81396755,2023-11-17T09:45:45,Amurrio,Expense,food,-410.24,122832.85
buyer_3,Ana,35,ES70209569304834571550,TRX_N-00594-51113735,2023-11-19T09:32:38,Amurrio,Expense,food,-130.45,122702.4
buyer_3,Ana,35,ES70209569304834571550,TRX_N-00595-94396491,2023-12-01T21:01:13,Amurrio,transfer,Salary,2322.78,125025.18
buyer_3,Ana,35,ES70209569304834571550,TRX_N-00596-33270517,2023-12-01T21:01:13,Amurrio,transfer,Partner Salary,2016.45,127041.63
buyer_3,Ana,35,ES70209569304834571550,TRX_N-00597-73758079,2023-12-01T21:01:13,Amurrio,transfer,Extra Income,232.28,127273.91
buyer_3,Ana,35,ES70209569304834571550,TRX_N-00598-94100483,2023-12-01T21:01:13,Amurrio,transfer,Bonus,2388.56,129662.47
buyer_3,Ana,35,ES70209569304834571550,TRX_N-00599-51756325,2023-12-05T15:42:30,Amurrio,Housing,Rent,-742.53,128919.94
buyer_3,Ana,35,ES70209569304834571550,TRX_N-00600-49120680,2023-12-05T18:48:31,Amurrio,Basic services,water,-19.88,128900.06
buyer_3,Ana,35,ES70209569304834571550,TRX_N-00601-58193992,2023-12-05T21:07:47,Amurrio,Basic services,electricity,-93.99,128806.07
buyer_3,Ana,35,ES70209569304834571550,TRX_N-00602-42838036,2023-12-05T21:42:47,Amurrio,Basic services,gas,-69.6,128736.47
buyer_3,Ana,35,ES70209569304834571550,TRX_N-00603-19374109,2023-12-05T11:31:32,Amurrio,Basic services,phone,-62.82,128673.65
buyer_3,Ana,35,ES70209569304834571550,TRX_N-00604-78258113,2023-12-07T18:49:19,Amurrio,Basic services,gas,-47.7,128625.95
buyer_3,Ana,35,ES70209569304834571550,TRX_N-00605-39656506,2023-12-13T11:32:08,Amurrio,Expense,clothing,-246.25,128379.7
buyer_3,Ana,35,ES70209569304834571550,TRX_N-00606-16035568,2023-12-15T13:04:36,Amurrio,Expense,education,-766.33,127613.37
buyer_3,Ana,35,ES70209569304834571550,TRX_N-00607-43518108,2024-01-01T03:25:42,Amurrio,transfer,Salary,2322.78,129936.15
buyer_3,Ana,35,ES70209569304834571550,TRX_N-00608-49652168,2024-01-01T03:25:42,Amurrio,transfer,Partner Salary,2016.45,131952.6
buyer_3,Ana,35,ES70209569304834571550,TRX_N-00609-70824907,2024-01-05T10:31:59,Amurrio,Housing,Rent,-742.53,131210.07
buyer_3,Ana,35,ES70209569304834571550,TRX_N-00610-72233514,2024-01-05T09:17:32,Amurrio,Basic services,water,-15.26,131194.81
buyer_3,Ana,35,ES70209569304834571550,TRX_N-00611-33916086,2024-01-05T19:13:05,Amurrio,Basic services,gas,-18.05,131176.76
buyer_3,Ana,35,ES70209569304834571550,TRX_N-00612-94527281,2024-01-06T20:26:11,Amurrio,Basic services,water,-21.18,131155.58
buyer_3,Ana,35,ES70209569304834571550,TRX_N-00613-04069400,2024-01-06T12:46:52,Amurrio,Basic services,gas,-75.32,131080.26
buyer_3,Ana,35,ES70209569304834571550,TRX_N-00614-96295264,2024-01-06T17:42:24,Amurrio,Basic services,internet,-76.44,131003.82
buyer_3,Ana,35,ES70209569304834571550,TRX_N-00615-05013923,2024-01-07T22:51:15,Amurrio,Basic services,phone,-78.47,130925.35
buyer_3,Ana,35,ES70209569304834571550,TRX_N-00616-37827265,2024-01-13T02:47:52,Amurrio,Expense,food,-632.91,130292.44
buyer_3,Ana,35,ES70209569304834571550,TRX_N-00617-42197784,2024-01-21T14:52:34,Portugalete,Expense,healthcare,-303.79,129988.65
buyer_3,Ana,35,ES70209569304834571550,TRX_N-00618-68852855,2024-01-28T17:03:58,Amurrio,Expense,transport,-75.05,129913.6
buyer_3,Ana,35,ES70209569304834571550,TRX_N-00619-20466955,2024-01-29T17:12:34,Amurrio,Expense,food,-146.94,129766.66
buyer_3,Ana,35,ES70209569304834571550,TRX_N-00620-15042719,2024-01-30T08:11:08,Amurrio,Expense,clothing,-270.79,129495.87
buyer_3,Ana,35,ES70209569304834571550,TRX_N-00621-79383963,2024-02-01T12:01:01,Amurrio,transfer,Salary,2322.78,131818.65
buyer_3,Ana,35,ES70209569304834571550,TRX_N-00622-88562285,2024-02-01T12:01:01,Amurrio,transfer,Partner Salary,2016.45,133835.1
buyer_3,Ana,35,ES70209569304834571550,TRX_N-00623-56095573,2024-02-05T14:58:40,Amurrio,Housing,Rent,-742.53,133092.57
buyer_3,Ana,35,ES70209569304834571550,TRX_N-00624-71189780,2024-02-05T17:28:52,Amurrio,Basic services,electricity,-38.69,133053.88
buyer_3,Ana,35,ES70209569304834571550,TRX_N-00625-63681956,2024-02-05T08:18:39,Amurrio,Basic services,gas,-20.85,133033.03
buyer_3,Ana,35,ES70209569304834571550,TRX_N-00626-24850203,2024-02-05T20:13:04,Amurrio,Basic services,internet,-56.17,132976.86
buyer_3,Ana,35,ES70209569304834571550,TRX_N-00627-53435694,2024-02-06T13:48:23,Amurrio,Basic services,gas,-30.08,132946.78
buyer_3,Ana,35,ES70209569304834571550,TRX_N-00628-85515542,2024-02-06T09:11:19,Amurrio,Expense,food,-668.53,132278.25
buyer_3,Ana,35,ES70209569304834571550,TRX_N-00629-20455280,2024-02-07T19:55:51,Amurrio,Basic services,water,-76.64,132201.61
buyer_3,Ana,35,ES70209569304834571550,TRX_N-00630-27674556,2024-02-07T23:22:20,Amurrio,Basic services,electricity,-93.91,132107.7
buyer_3,Ana,35,ES70209569304834571550,TRX_N-00631-40166098,2024-02-10T06:24:17,Amurrio,Expense,food,-303.31,131804.39
buyer_3,Ana,35,ES70209569304834571550,TRX_N-00632-38489158,2024-02-14T18:53:33,Amurrio,Expense,food,-357.74,131446.65
buyer_3,Ana,35,ES70209569304834571550,TRX_N-00633-68213769,2024-02-22T19:14:41,Eibar,Expense,repairs,-363.48,131083.17
buyer_3,Ana,35,ES70209569304834571550,TRX_N-00634-42011323,2024-02-24T19:15:25,Arrasate,Expense,food,-303.43,130779.74
buyer_3,Ana,35,ES70209569304834571550,TRX_N-00635-02123689,2024-02-26T22:47:53,Zarautz,Expense,gifts,-61.7,130718.04
buyer_3,Ana,35,ES70209569304834571550,TRX_N-00636-14612618,2024-03-01T02:05:44,Amurrio,transfer,Salary,2322.78,133040.82
buyer_3,Ana,35,ES70209569304834571550,TRX_N-00637-23569385,2024-03-01T02:05:44,Amurrio,transfer,Partner Salary,2016.45,135057.27
buyer_3,Ana,35,ES70209569304834571550,TRX_N-00638-19716063,2024-03-01T02:05:44,Amurrio,transfer,Extra Income,232.28,135289.55
buyer_3,Ana,35,ES70209569304834571550,TRX_N-00639-57851311,2024-03-03T20:39:37,Amurrio,Expense,education,-433.28,134856.27
buyer_3,Ana,35,ES70209569304834571550,TRX_N-00640-22943905,2024-03-04T20:10:44,Amurrio,Expense,leisure,-204.05,134652.22
buyer_3,Ana,35,ES70209569304834571550,TRX_N-00641-88515864,2024-03-05T00:53:49,Amurrio,Housing,Rent,-742.53,133909.69
buyer_3,Ana,35,ES70209569304834571550,TRX_N-00642-96041426,2024-03-05T17:55:10,Amurrio,Basic services,gas,-45.0,133864.69
buyer_3,Ana,35,ES70209569304834571550,TRX_N-00643-27564760,2024-03-06T04:37:13,Amurrio,Basic services,water,-62.61,133802.08
buyer_3,Ana,35,ES70209569304834571550,TRX_N-00644-73011764,2024-03-06T08:53:13,Amurrio,Basic services,gas,-38.07,133764.01
buyer_3,Ana,35,ES70209569304834571550,TRX_N-00645-35611231,2024-03-06T19:06:49,Amurrio,Basic services,phone,-98.26,133665.75
buyer_3,Ana,35,ES70209569304834571550,TRX_N-00646-08610952,2024-03-07T13:03:48,Amurrio,Basic services,water,-55.77,133609.98
buyer_3,Ana,35,ES70209569304834571550,TRX_N-00647-54602128,2024-03-07T08:59:56,Amurrio,Basic services,gas,-61.45,133548.53
buyer_3,Ana,35,ES70209569304834571550,TRX_N-00648-01013162,2024-03-07T10:43:07,Amurrio,Basic services,phone,-50.61,133497.92
buyer_3,Ana,35,ES70209569304834571550,TRX_N-00649-17812764,2024-03-21T09:28:41,Amurrio,Expense,food,-650.07,132847.85
buyer_3,Ana,35,ES70209569304834571550,TRX_N-00650-08335989,2024-03-28T19:08:08,Amurrio,Expense,healthcare,-379.3,132468.55
buyer_3,Ana,35,ES70209569304834571550,TRX_N-00651-94754451,2024-04-01T02:13:48,Amurrio,transfer,Salary,2322.78,134791.33
buyer_3,Ana,35,ES70209569304834571550,TRX_N-00652-27175238,2024-04-01T02:13:48,Amurrio,transfer,Partner Salary,2016.45,136807.78
buyer_3,Ana,35,ES70209569304834571550,TRX_N-00653-91512275,2024-04-05T00:10:38,Amurrio,Housing,Rent,-742.53,136065.25
buyer_3,Ana,35,ES70209569304834571550,TRX_N-00654-86395484,2024-04-05T20:20:44,Amurrio,Basic services,internet,-64.96,136000.29
buyer_3,Ana,35,ES70209569304834571550,TRX_N-00655-96383280,2024-04-05T14:14:41,Amurrio,Basic services,phone,-54.58,135945.71
buyer_3,Ana,35,ES70209569304834571550,TRX_N-00656-30311317,2024-04-06T11:09:53,Amurrio,Basic services,gas,-94.41,135851.3
buyer_3,Ana,35,ES70209569304834571550,TRX_N-00657-36407707,2024-04-09T12:25:49,Amurrio,Expense,leisure,-138.35,135712.95
buyer_3,Ana,35,ES70209569304834571550,TRX_N-00658-80191951,2024-04-09T14:58:55,Portugalete,Expense,clothing,-65.73,135647.22
buyer_3,Ana,35,ES70209569304834571550,TRX_N-00659-85239870,2024-05-01T15:15:37,Amurrio,transfer,Salary,2322.78,137970.0
buyer_3,Ana,35,ES70209569304834571550,TRX_N-00660-33936278,2024-05-01T15:15:37,Amurrio,transfer,Partner Salary,2016.45,139986.45
buyer_3,Ana,35,ES70209569304834571550,TRX_N-00661-53976332,2024-05-01T15:15:37,Amurrio,transfer,Extra Income,232.28,140218.73
buyer_3,Ana,35,ES70209569304834571550,TRX_N-00662-60954553,2024-05-03T20:38:41,Amurrio,Expense,leisure,-257.03,139961.7
buyer_3,Ana,35,ES70209569304834571550,TRX_N-00663-96843426,2024-05-05T10:25:31,Amurrio,Housing,Rent,-742.53,139219.17
buyer_3,Ana,35,ES70209569304834571550,TRX_N-00664-84703198,2024-05-05T07:25:28,Amurrio,Basic services,phone,-69.85,139149.32
buyer_3,Ana,35,ES70209569304834571550,TRX_N-00665-15821319,2024-05-06T10:58:51,Amurrio,Basic services,gas,-67.55,139081.77
buyer_3,Ana,35,ES70209569304834571550,TRX_N-00666-24719141,2024-05-06T20:14:17,Amurrio,Expense,clothing,-64.31,139017.46
buyer_3,Ana,35,ES70209569304834571550,TRX_N-00667-83453227,2024-05-07T18:44:16,Amurrio,Basic services,gas,-37.65,138979.81
buyer_3,Ana,35,ES70209569304834571550,TRX_N-00668-43809853,2024-05-07T18:21:22,Amurrio,Basic services,internet,-57.33,138922.48
buyer_3,Ana,35,ES70209569304834571550,TRX_N-00669-99890033,2024-05-07T08:48:59,Amurrio,Expense,transport,-130.86,138791.62
buyer_3,Ana,35,ES70209569304834571550,TRX_N-00670-39787970,2024-05-09T08:12:16,Amurrio,Expense,food,-192.8,138598.82
buyer_3,Ana,35,ES70209569304834571550,TRX_N-00671-41921783,2024-05-22T15:18:23,Amurrio,Expense,travel,-1391.91,137206.91
buyer_3,Ana,35,ES70209569304834571550,TRX_N-00672-32541417,2024-05-24T02:52:57,Amurrio,Expense,leisure,-116.43,137090.48
buyer_3,Ana,35,ES70209569304834571550,TRX_N-00673-46652796,2024-05-25T11:52:59,Amurrio,Expense,education,-852.26,136238.22
buyer_3,Ana,35,ES70209569304834571550,TRX_N-00674-72893827,2024-06-01T16:25:20,Amurrio,transfer,Salary,2322.78,138561.0
buyer_3,Ana,35,ES70209569304834571550,TRX_N-00675-52536593,2024-06-01T16:25:20,Amurrio,transfer,Partner Salary,2016.45,140577.45
buyer_3,Ana,35,ES70209569304834571550,TRX_N-00676-62701214,2024-06-01T16:25:20,Amurrio,transfer,Bonus,2381.31,142958.76
buyer_3,Ana,35,ES70209569304834571550,TRX_N-00677-40873487,2024-06-05T20:03:51,Amurrio,Housing,Rent,-742.53,142216.23
buyer_3,Ana,35,ES70209569304834571550,TRX_N-00678-06232270,2024-06-05T19:26:55,Amurrio,Basic services,gas,-67.89,142148.34
buyer_3,Ana,35,ES70209569304834571550,TRX_N-00679-70464657,2024-06-05T17:39:38,Amurrio,Basic services,phone,-49.99,142098.35
buyer_3,Ana,35,ES70209569304834571550,TRX_N-00680-80654468,2024-06-05T11:45:52,Amurrio,Expense,transport,-108.81,141989.54
buyer_3,Ana,35,ES70209569304834571550,TRX_N-00681-86206624,2024-06-06T22:30:23,Amurrio,Basic services,electricity,-96.08,141893.46
buyer_3,Ana,35,ES70209569304834571550,TRX_N-00682-94714706,2024-06-06T18:06:38,Amurrio,Basic services,gas,-93.8,141799.66
buyer_3,Ana,35,ES70209569304834571550,TRX_N-00683-78288560,2024-06-16T11:43:45,Amurrio,Expense,transport,-86.91,141712.75
buyer_3,Ana,35,ES70209569304834571550,TRX_N-00684-33168187,2024-06-17T16:08:07,Amurrio,Expense,food,-507.37,141205.38
buyer_3,Ana,35,ES70209569304834571550,TRX_N-00685-98446995,2024-06-19T14:06:36,Durango,Expense,repairs,-375.27,140830.11
buyer_3,Ana,35,ES70209569304834571550,TRX_N-00686-25688750,2024-07-01T15:17:46,Amurrio,transfer,Salary,2322.78,143152.89
buyer_3,Ana,35,ES70209569304834571550,TRX_N-00687-34523281,2024-07-01T15:17:46,Amurrio,transfer,Partner Salary,2016.45,145169.34
buyer_3,Ana,35,ES70209569304834571550,TRX_N-00688-79406225,2024-07-04T20:40:53,Oyón-Oion,Expense,food,-673.38,144495.96
buyer_3,Ana,35,ES70209569304834571550,TRX_N-00689-80781771,2024-07-05T16:49:59,Amurrio,Housing,Rent,-742.53,143753.43
buyer_3,Ana,35,ES70209569304834571550,TRX_N-00690-13130367,2024-07-05T11:33:14,Amurrio,Basic services,phone,-82.22,143671.21
buyer_3,Ana,35,ES70209569304834571550,TRX_N-00691-45710813,2024-07-05T11:02:06,Amurrio,Expense,clothing,-297.83,143373.38
buyer_3,Ana,35,ES70209569304834571550,TRX_N-00692-11304197,2024-07-05T17:10:54,Amurrio,Expense,gifts,-223.11,143150.27
buyer_3,Ana,35,ES70209569304834571550,TRX_N-00693-39848155,2024-07-06T13:30:45,Amurrio,Basic services,internet,-78.24,143072.03
buyer_3,Ana,35,ES70209569304834571550,TRX_N-00694-54822447,2024-07-06T15:39:27,Amurrio,Expense,food,-128.72,142943.31
buyer_3,Ana,35,ES70209569304834571550,TRX_N-00695-25583314,2024-07-07T23:45:43,Amurrio,Basic services,gas,-75.4,142867.91
buyer_3,Ana,35,ES70209569304834571550,TRX_N-00696-84221612,2024-07-09T11:33:07,Amurrio,Expense,food,-378.58,142489.33
buyer_3,Ana,35,ES70209569304834571550,TRX_N-00697-25495855,2024-07-30T17:04:16,Amurrio,Expense,food,-349.15,142140.18
buyer_3,Ana,35,ES70209569304834571550,TRX_N-00698-14230877,2024-08-01T14:40:29,Amurrio,transfer,Salary,2322.78,144462.96
buyer_3,Ana,35,ES70209569304834571550,TRX_N-00699-49849360,2024-08-01T14:40:29,Amurrio,transfer,Partner Salary,2016.45,146479.41
buyer_3,Ana,35,ES70209569304834571550,TRX_N-00700-20459114,2024-08-01T14:40:29,Amurrio,transfer,Extra Income,232.28,146711.69
buyer_3,Ana,35,ES70209569304834571550,TRX_N-00701-84737189,2024-08-05T16:34:26,Amurrio,Housing,Rent,-742.53,145969.16
buyer_3,Ana,35,ES70209569304834571550,TRX_N-00702-38286116,2024-08-05T15:36:47,Amurrio,Basic services,phone,-25.36,145943.8
buyer_3,Ana,35,ES70209569304834571550,TRX_N-00703-64254915,2024-08-05T13:43:56,Amurrio,Expense,transport,-161.22,145782.58
buyer_3,Ana,35,ES70209569304834571550,TRX_N-00704-42941435,2024-08-06T02:36:21,Amurrio,Basic services,electricity,-121.47,145661.11
buyer_3,Ana,35,ES70209569304834571550,TRX_N-00705-60474226,2024-08-06T14:12:38,Amurrio,Basic services,internet,-68.23,145592.88
buyer_3,Ana,35,ES70209569304834571550,TRX_N-00706-08048728,2024-08-06T09:19:05,Amurrio,Expense,food,-212.73,145380.15
buyer_3,Ana,35,ES70209569304834571550,TRX_N-00707-57505027,2024-08-09T20:55:18,Amurrio,Expense,clothing,-158.21,145221.94
buyer_3,Ana,35,ES70209569304834571550,TRX_N-00708-36255645,2024-08-18T17:24:23,Amurrio,Expense,transport,-70.42,145151.52
buyer_3,Ana,35,ES70209569304834571550,TRX_N-00709-78098790,2024-08-20T10:07:48,Elciego,Expense,leisure,-181.39,144970.13
buyer_3,Ana,35,ES70209569304834571550,TRX_N-00710-58551040,2024-08-24T16:45:26,Erandio,Expense,clothing,-61.77,144908.36
buyer_3,Ana,35,ES70209569304834571550,TRX_N-00711-13714874,2024-08-25T12:12:06,Amurrio,Expense,leisure,-31.92,144876.44
buyer_3,Ana,35,ES70209569304834571550,TRX_N-00712-81912092,2024-09-01T15:55:42,Amurrio,transfer,Salary,2322.78,147199.22
buyer_3,Ana,35,ES70209569304834571550,TRX_N-00713-40437899,2024-09-01T15:55:42,Amurrio,transfer,Partner Salary,2016.45,149215.67
buyer_3,Ana,35,ES70209569304834571550,TRX_N-00714-31923913,2024-09-05T17:51:33,Amurrio,Housing,Rent,-742.53,148473.14
buyer_3,Ana,35,ES70209569304834571550,TRX_N-00715-59444500,2024-09-05T17:21:45,Amurrio,Basic services,water,-22.8,148450.34
buyer_3,Ana,35,ES70209569304834571550,TRX_N-00716-54023454,2024-09-05T23:01:26,Amurrio,Basic services,electricity,-80.14,148370.2
buyer_3,Ana,35,ES70209569304834571550,TRX_N-00717-59879767,2024-09-06T19:56:52,Amurrio,Basic services,electricity,-92.62,148277.58
buyer_3,Ana,35,ES70209569304834571550,TRX_N-00718-93057593,2024-09-06T23:04:23,Amurrio,Basic services,gas,-26.5,148251.08
buyer_3,Ana,35,ES70209569304834571550,TRX_N-00719-67914678,2024-09-07T10:07:25,Amurrio,Basic services,water,-78.46,148172.62
buyer_3,Ana,35,ES70209569304834571550,TRX_N-00720-57543137,2024-09-07T14:35:46,Amurrio,Basic services,phone,-86.24,148086.38
buyer_3,Ana,35,ES70209569304834571550,TRX_N-00721-38474966,2024-09-08T23:26:14,Amurrio,Expense,leisure,-129.26,147957.12
buyer_3,Ana,35,ES70209569304834571550,TRX_N-00722-45399046,2024-09-09T19:05:52,Berango,Expense,repairs,-703.39,147253.73
buyer_3,Ana,35,ES70209569304834571550,TRX_N-00723-52511367,2024-10-01T20:09:49,Amurrio,transfer,Salary,2322.78,149576.51
buyer_3,Ana,35,ES70209569304834571550,TRX_N-00724-86518507,2024-10-01T20:09:49,Amurrio,transfer,Partner Salary,2016.45,151592.96
buyer_3,Ana,35,ES70209569304834571550,TRX_N-00725-37340261,2024-10-01T20:09:49,Amurrio,transfer,Extra Income,232.28,151825.24
buyer_3,Ana,35,ES70209569304834571550,TRX_N-00726-74538708,2024-10-02T11:11:30,Zarautz,Expense,food,-555.28,151269.96
buyer_3,Ana,35,ES70209569304834571550,TRX_N-00727-63881207,2024-10-05T18:51:59,Amurrio,Housing,Rent,-742.53,150527.43
buyer_3,Ana,35,ES70209569304834571550,TRX_N-00728-21576214,2024-10-05T13:50:37,Amurrio,Basic services,internet,-38.2,150489.23
buyer_3,Ana,35,ES70209569304834571550,TRX_N-00729-59917218,2024-10-06T03:29:03,Amurrio,Basic services,water,-19.42,150469.81
buyer_3,Ana,35,ES70209569304834571550,TRX_N-00730-44700548,2024-10-07T20:28:04,Amurrio,Basic services,gas,-90.32,150379.49
buyer_3,Ana,35,ES70209569304834571550,TRX_N-00731-34237788,2024-10-07T17:37:01,Amurrio,Basic services,internet,-32.35,150347.14
buyer_3,Ana,35,ES70209569304834571550,TRX_N-00732-30031067,2024-10-07T09:04:07,Amurrio,Basic services,phone,-86.09,150261.05
buyer_4,Jorge,50,ES27209566457215897586,TRX_N-00001-79961766,2020-01-01T10:13:43,Galdakao,transfer,Salary,2656.62,9277.39
buyer_4,Jorge,50,ES27209566457215897586,TRX_N-00002-69075564,2020-01-01T10:13:43,Galdakao,transfer,Partner Salary,2885.84,12163.23
buyer_4,Jorge,50,ES27209566457215897586,TRX_N-00003-07868663,2020-01-05T20:03:10,Galdakao,Housing,Mortgage,-444.74,11718.49
buyer_4,Jorge,50,ES27209566457215897586,TRX_N-00004-23337327,2020-01-05T20:20:21,Galdakao,Basic services,water,-22.22,11696.27
buyer_4,Jorge,50,ES27209566457215897586,TRX_N-00005-93736432,2020-01-06T11:44:24,Galdakao,Basic services,electricity,-34.14,11662.13
buyer_4,Jorge,50,ES27209566457215897586,TRX_N-00006-06328908,2020-01-07T17:24:15,Galdakao,Basic services,internet,-37.27,11624.86
buyer_4,Jorge,50,ES27209566457215897586,TRX_N-00007-83483506,2020-01-07T10:06:03,Galdakao,Basic services,phone,-52.44,11572.42
buyer_4,Jorge,50,ES27209566457215897586,TRX_N-00008-88917522,2020-01-13T19:57:07,Galdakao,Expense,transport,-54.14,11518.28
buyer_4,Jorge,50,ES27209566457215897586,TRX_N-00009-51722981,2020-02-01T08:10:32,Galdakao,transfer,Salary,2656.62,14174.9
buyer_4,Jorge,50,ES27209566457215897586,TRX_N-00010-08744604,2020-02-01T08:10:32,Galdakao,transfer,Partner Salary,2885.84,17060.74
buyer_4,Jorge,50,ES27209566457215897586,TRX_N-00011-02071426,2020-02-04T11:37:28,Basauri,Expense,transport,-131.02,16929.72
buyer_4,Jorge,50,ES27209566457215897586,TRX_N-00012-48114600,2020-02-04T20:12:10,Galdakao,Expense,travel,-1295.47,15634.25
buyer_4,Jorge,50,ES27209566457215897586,TRX_N-00013-74138378,2020-02-05T11:43:06,Galdakao,Housing,Mortgage,-444.74,15189.51
buyer_4,Jorge,50,ES27209566457215897586,TRX_N-00014-85938843,2020-02-05T02:41:13,Galdakao,Basic services,water,-18.01,15171.5
buyer_4,Jorge,50,ES27209566457215897586,TRX_N-00015-08049649,2020-02-06T19:58:04,Galdakao,Basic services,internet,-51.29,15120.21
buyer_4,Jorge,50,ES27209566457215897586,TRX_N-00016-80814848,2020-02-06T10:28:47,Galdakao,Basic services,phone,-33.14,15087.07
buyer_4,Jorge,50,ES27209566457215897586,TRX_N-00017-30584296,2020-02-06T10:33:39,Galdakao,Expense,clothing,-230.13,14856.94
buyer_4,Jorge,50,ES27209566457215897586,TRX_N-00018-80704442,2020-02-07T16:58:44,Galdakao,Basic services,gas,-56.11,14800.83
buyer_4,Jorge,50,ES27209566457215897586,TRX_N-00019-51527765,2020-02-07T03:57:09,Galdakao,Basic services,phone,-22.49,14778.34
buyer_4,Jorge,50,ES27209566457215897586,TRX_N-00020-35182565,2020-02-18T17:14:53,Galdakao,Expense,transport,-197.92,14580.42
buyer_4,Jorge,50,ES27209566457215897586,TRX_N-00021-31716400,2020-02-26T12:13:02,Galdakao,Expense,healthcare,-338.76,14241.66
buyer_4,Jorge,50,ES27209566457215897586,TRX_N-00022-32625666,2020-02-28T07:42:55,Galdakao,Expense,clothing,-203.66,14038.0
buyer_4,Jorge,50,ES27209566457215897586,TRX_N-00023-55016303,2020-02-29T06:07:23,Galdakao,Expense,leisure,-95.43,13942.57
buyer_4,Jorge,50,ES27209566457215897586,TRX_N-00024-33453641,2020-03-01T12:36:31,Galdakao,transfer,Salary,2656.62,16599.19
buyer_4,Jorge,50,ES27209566457215897586,TRX_N-00025-61354204,2020-03-01T12:36:31,Galdakao,transfer,Partner Salary,2885.84,19485.03
buyer_4,Jorge,50,ES27209566457215897586,TRX_N-00026-45341356,2020-03-01T12:36:31,Galdakao,transfer,Extra Income,265.66,19750.69
buyer_4,Jorge,50,ES27209566457215897586,TRX_N-00027-03430112,2020-03-02T19:12:14,Galdakao,Expense,leisure,-170.35,19580.34
buyer_4,Jorge,50,ES27209566457215897586,TRX_N-00028-29687727,2020-03-05T20:16:43,Galdakao,Housing,Mortgage,-444.74,19135.6
buyer_4,Jorge,50,ES27209566457215897586,TRX_N-00029-22676097,2020-03-05T07:48:07,Galdakao,Basic services,internet,-72.83,19062.77
buyer_4,Jorge,50,ES27209566457215897586,TRX_N-00030-12955420,2020-03-07T14:43:33,Galdakao,Basic services,internet,-45.37,19017.4
buyer_4,Jorge,50,ES27209566457215897586,TRX_N-00031-07795385,2020-03-07T18:47:28,Galdakao,Expense,food,-526.7,18490.7
buyer_4,Jorge,50,ES27209566457215897586,TRX_N-00032-12576255,2020-03-19T17:07:46,Zarautz,Expense,gifts,-56.41,18434.29
buyer_4,Jorge,50,ES27209566457215897586,TRX_N-00033-69400658,2020-03-23T11:13:26,Galdakao,Expense,food,-467.9,17966.39
buyer_4,Jorge,50,ES27209566457215897586,TRX_N-00034-75111285,2020-03-27T23:10:06,Galdakao,Expense,clothing,-159.87,17806.52
buyer_4,Jorge,50,ES27209566457215897586,TRX_N-00035-63750831,2020-03-29T03:16:47,Galdakao,Expense,transport,-100.38,17706.14
buyer_4,Jorge,50,ES27209566457215897586,TRX_N-00036-50091405,2020-04-01T13:03:20,Galdakao,transfer,Salary,2656.62,20362.76
buyer_4,Jorge,50,ES27209566457215897586,TRX_N-00037-40349666,2020-04-01T13:03:20,Galdakao,transfer,Partner Salary,2885.84,23248.6
buyer_4,Jorge,50,ES27209566457215897586,TRX_N-00038-65829579,2020-04-05T14:13:14,Galdakao,Housing,Mortgage,-444.74,22803.86
buyer_4,Jorge,50,ES27209566457215897586,TRX_N-00039-50678922,2020-04-05T10:58:11,Galdakao,Basic services,electricity,-136.95,22666.91
buyer_4,Jorge,50,ES27209566457215897586,TRX_N-00040-47264679,2020-04-05T09:03:28,Galdakao,Basic services,gas,-31.65,22635.26
buyer_4,Jorge,50,ES27209566457215897586,TRX_N-00041-13853516,2020-04-05T09:08:30,Galdakao,Basic services,phone,-29.3,22605.96
buyer_4,Jorge,50,ES27209566457215897586,TRX_N-00042-18078252,2020-04-06T08:47:42,Galdakao,Basic services,water,-73.05,22532.91
buyer_4,Jorge,50,ES27209566457215897586,TRX_N-00043-83232501,2020-04-06T04:09:08,Galdakao,Basic services,electricity,-131.16,22401.75
buyer_4,Jorge,50,ES27209566457215897586,TRX_N-00044-62081260,2020-04-10T20:52:40,Galdakao,Expense,transport,-189.33,22212.42
buyer_4,Jorge,50,ES27209566457215897586,TRX_N-00045-76811652,2020-04-11T17:32:08,Galdakao,Expense,education,-263.6,21948.82
buyer_4,Jorge,50,ES27209566457215897586,TRX_N-00046-99186763,2020-04-13T20:16:41,Durango,Expense,transport,-192.42,21756.4
buyer_4,Jorge,50,ES27209566457215897586,TRX_N-00047-50832913,2020-04-19T15:30:19,Galdakao,Expense,education,-619.9,21136.5
buyer_4,Jorge,50,ES27209566457215897586,TRX_N-00048-38472450,2020-05-01T15:54:07,Galdakao,transfer,Salary,2656.62,23793.12
buyer_4,Jorge,50,ES27209566457215897586,TRX_N-00049-89733941,2020-05-01T15:54:07,Galdakao,transfer,Partner Salary,2885.84,26678.96
buyer_4,Jorge,50,ES27209566457215897586,TRX_N-00050-06316805,2020-05-01T15:54:07,Galdakao,transfer,Extra Income,265.66,26944.62
buyer_4,Jorge,50,ES27209566457215897586,TRX_N-00051-54753142,2020-05-05T12:34:50,Galdakao,Housing,Mortgage,-444.74,26499.88
buyer_4,Jorge,50,ES27209566457215897586,TRX_N-00052-50460361,2020-05-05T14:21:25,Galdakao,Basic services,electricity,-111.28,26388.6
buyer_4,Jorge,50,ES27209566457215897586,TRX_N-00053-58960842,2020-05-05T09:46:11,Galdakao,Basic services,phone,-95.24,26293.36
buyer_4,Jorge,50,ES27209566457215897586,TRX_N-00054-89807367,2020-05-06T03:48:41,Galdakao,Basic services,water,-77.43,26215.93
buyer_4,Jorge,50,ES27209566457215897586,TRX_N-00055-06038996,2020-05-08T13:10:22,Sestao,Expense,food,-731.58,25484.35
buyer_4,Jorge,50,ES27209566457215897586,TRX_N-00056-41429039,2020-05-13T10:59:20,Galdakao,Expense,food,-765.06,24719.29
buyer_4,Jorge,50,ES27209566457215897586,TRX_N-00057-56480743,2020-05-29T11:15:56,Galdakao,Expense,food,-102.14,24617.15
buyer_4,Jorge,50,ES27209566457215897586,TRX_N-00058-06221096,2020-06-01T04:47:30,Galdakao,transfer,Salary,2656.62,27273.77
buyer_4,Jorge,50,ES27209566457215897586,TRX_N-00059-22392686,2020-06-01T04:47:30,Galdakao,transfer,Partner Salary,2885.84,30159.61
buyer_4,Jorge,50,ES27209566457215897586,TRX_N-00060-44526065,2020-06-01T04:47:30,Galdakao,transfer,Bonus,2731.12,32890.73
buyer_4,Jorge,50,ES27209566457215897586,TRX_N-00061-78887665,2020-06-05T12:36:16,Galdakao,Housing,Mortgage,-444.74,32445.99
buyer_4,Jorge,50,ES27209566457215897586,TRX_N-00062-45096144,2020-06-05T10:27:47,Galdakao,Basic services,water,-40.25,32405.74
buyer_4,Jorge,50,ES27209566457215897586,TRX_N-00063-33227323,2020-06-06T18:56:27,Galdakao,Basic services,internet,-33.38,32372.36
buyer_4,Jorge,50,ES27209566457215897586,TRX_N-00064-02737489,2020-06-07T18:37:17,Galdakao,Basic services,gas,-44.17,32328.19
buyer_4,Jorge,50,ES27209566457215897586,TRX_N-00065-22928856,2020-06-07T11:40:28,Galdakao,Basic services,phone,-74.73,32253.46
buyer_4,Jorge,50,ES27209566457215897586,TRX_N-00066-49972042,2020-06-07T19:12:10,Galdakao,Expense,food,-522.32,31731.14
buyer_4,Jorge,50,ES27209566457215897586,TRX_N-00067-06783579,2020-06-14T08:24:47,Galdakao,Expense,education,-410.76,31320.38
buyer_4,Jorge,50,ES27209566457215897586,TRX_N-00068-34100070,2020-06-21T11:24:23,Galdakao,Expense,food,-505.17,30815.21
buyer_4,Jorge,50,ES27209566457215897586,TRX_N-00069-95114843,2020-06-24T15:43:55,Galdakao,Expense,food,-665.72,30149.49
buyer_4,Jorge,50,ES27209566457215897586,TRX_N-00070-82170549,2020-07-01T09:01:46,Galdakao,transfer,Salary,2656.62,32806.11
buyer_4,Jorge,50,ES27209566457215897586,TRX_N-00071-79181675,2020-07-01T09:01:46,Galdakao,transfer,Partner Salary,2885.84,35691.95
buyer_4,Jorge,50,ES27209566457215897586,TRX_N-00072-47898740,2020-07-01T09:01:46,Galdakao,transfer,Extra Income,265.66,35957.61
buyer_4,Jorge,50,ES27209566457215897586,TRX_N-00073-88357367,2020-07-05T09:22:55,Galdakao,Housing,Mortgage,-444.74,35512.87
buyer_4,Jorge,50,ES27209566457215897586,TRX_N-00074-32961906,2020-07-05T20:21:23,Galdakao,Basic services,water,-55.55,35457.32
buyer_4,Jorge,50,ES27209566457215897586,TRX_N-00075-80148954,2020-07-06T14:36:31,Galdakao,Basic services,electricity,-87.66,35369.66
buyer_4,Jorge,50,ES27209566457215897586,TRX_N-00076-88632495,2020-07-06T16:22:15,Galdakao,Basic services,phone,-57.19,35312.47
buyer_4,Jorge,50,ES27209566457215897586,TRX_N-00077-60749106,2020-07-09T01:58:51,Galdakao,Expense,leisure,-124.09,35188.38
buyer_4,Jorge,50,ES27209566457215897586,TRX_N-00078-47654983,2020-07-11T12:22:00,Galdakao,Expense,gifts,-138.7,35049.68
buyer_4,Jorge,50,ES27209566457215897586,TRX_N-00079-51007441,2020-07-21T02:07:46,Galdakao,Expense,transport,-188.83,34860.85
buyer_4,Jorge,50,ES27209566457215897586,TRX_N-00080-51063388,2020-07-21T17:37:10,Galdakao,Expense,leisure,-198.65,34662.2
buyer_4,Jorge,50,ES27209566457215897586,TRX_N-00081-47339087,2020-07-29T08:42:04,Galdakao,Expense,food,-706.1,33956.1
buyer_4,Jorge,50,ES27209566457215897586,TRX_N-00082-19734861,2020-08-01T15:32:21,Galdakao,transfer,Salary,2656.62,36612.72
buyer_4,Jorge,50,ES27209566457215897586,TRX_N-00083-28787285,2020-08-01T15:32:21,Galdakao,transfer,Partner Salary,2885.84,39498.56
buyer_4,Jorge,50,ES27209566457215897586,TRX_N-00084-54838692,2020-08-01T14:44:48,Bermeo,Expense,leisure,-261.5,39237.06
buyer_4,Jorge,50,ES27209566457215897586,TRX_N-00085-97296756,2020-08-02T19:45:37,Galdakao,Expense,transport,-91.7,39145.36
buyer_4,Jorge,50,ES27209566457215897586,TRX_N-00086-01450255,2020-08-05T09:14:14,Galdakao,Housing,Mortgage,-444.74,38700.62
buyer_4,Jorge,50,ES27209566457215897586,TRX_N-00087-48038645,2020-08-05T20:06:47,Galdakao,Basic services,electricity,-102.95,38597.67
buyer_4,Jorge,50,ES27209566457215897586,TRX_N-00088-53146383,2020-08-05T15:30:43,Galdakao,Basic services,phone,-65.07,38532.6
buyer_4,Jorge,50,ES27209566457215897586,TRX_N-00089-62739118,2020-08-06T08:56:44,Galdakao,Basic services,water,-33.64,38498.96
buyer_4,Jorge,50,ES27209566457215897586,TRX_N-00090-14792509,2020-08-06T17:49:45,Galdakao,Basic services,gas,-50.18,38448.78
buyer_4,Jorge,50,ES27209566457215897586,TRX_N-00091-23737958,2020-08-07T13:54:43,Galdakao,Basic services,gas,-83.14,38365.64
buyer_4,Jorge,50,ES27209566457215897586,TRX_N-00092-82356882,2020-08-07T12:09:55,Galdakao,Basic services,phone,-82.59,38283.05
buyer_4,Jorge,50,ES27209566457215897586,TRX_N-00093-99351392,2020-08-09T08:38:08,Galdakao,Expense,leisure,-265.2,38017.85
buyer_4,Jorge,50,ES27209566457215897586,TRX_N-00094-57391107,2020-08-11T19:46:23,Zarautz,Expense,transport,-170.08,37847.77
buyer_4,Jorge,50,ES27209566457215897586,TRX_N-00095-68543642,2020-08-16T18:26:01,Irun,Expense,food,-496.59,37351.18
buyer_4,Jorge,50,ES27209566457215897586,TRX_N-00096-38607802,2020-08-23T06:23:39,Galdakao,Expense,transport,-38.8,37312.38
buyer_4,Jorge,50,ES27209566457215897586,TRX_N-00097-91433805,2020-08-23T22:56:10,Leioa,Expense,healthcare,-41.3,37271.08
buyer_4,Jorge,50,ES27209566457215897586,TRX_N-00098-14882763,2020-08-27T17:28:02,Galdakao,Expense,food,-412.82,36858.26
buyer_4,Jorge,50,ES27209566457215897586,TRX_N-00099-02434815,2020-09-01T17:27:00,Galdakao,transfer,Salary,2656.62,39514.88
buyer_4,Jorge,50,ES27209566457215897586,TRX_N-00100-24480859,2020-09-01T17:27:00,Galdakao,transfer,Partner Salary,2885.84,42400.72
buyer_4,Jorge,50,ES27209566457215897586,TRX_N-00101-68395170,2020-09-05T14:04:27,Galdakao,Housing,Mortgage,-444.74,41955.98
buyer_4,Jorge,50,ES27209566457215897586,TRX_N-00102-96964786,2020-09-05T11:15:56,Galdakao,Basic services,internet,-61.31,41894.67
buyer_4,Jorge,50,ES27209566457215897586,TRX_N-00103-88724421,2020-09-06T12:40:39,Galdakao,Basic services,gas,-70.48,41824.19
buyer_4,Jorge,50,ES27209566457215897586,TRX_N-00104-34138501,2020-09-06T15:47:36,Galdakao,Basic services,internet,-72.01,41752.18
buyer_4,Jorge,50,ES27209566457215897586,TRX_N-00105-37391198,2020-09-06T00:11:08,Galdakao,Expense,food,-440.31,41311.87
buyer_4,Jorge,50,ES27209566457215897586,TRX_N-00106-04590014,2020-09-07T14:26:37,Galdakao,Basic services,electricity,-90.24,41221.63
buyer_4,Jorge,50,ES27209566457215897586,TRX_N-00107-03134375,2020-09-07T10:33:04,Galdakao,Basic services,gas,-91.97,41129.66
buyer_4,Jorge,50,ES27209566457215897586,TRX_N-00108-39015664,2020-09-07T19:06:05,Galdakao,Basic services,internet,-52.67,41076.99
buyer_4,Jorge,50,ES27209566457215897586,TRX_N-00109-15988312,2020-09-18T11:06:51,Galdakao,Expense,leisure,-60.37,41016.62
buyer_4,Jorge,50,ES27209566457215897586,TRX_N-00110-53622272,2020-09-25T19:11:28,Galdakao,Expense,food,-562.4,40454.22
buyer_4,Jorge,50,ES27209566457215897586,TRX_N-00111-38134282,2020-09-25T09:08:59,Galdakao,Expense,leisure,-292.86,40161.36
buyer_4,Jorge,50,ES27209566457215897586,TRX_N-00112-15143783,2020-10-01T20:35:45,Galdakao,transfer,Salary,2656.62,42817.98
buyer_4,Jorge,50,ES27209566457215897586,TRX_N-00113-09436623,2020-10-01T20:35:45,Galdakao,transfer,Partner Salary,2885.84,45703.82
buyer_4,Jorge,50,ES27209566457215897586,TRX_N-00114-12498409,2020-10-01T20:35:45,Galdakao,transfer,Extra Income,265.66,45969.48
buyer_4,Jorge,50,ES27209566457215897586,TRX_N-00115-07771102,2020-10-03T11:49:20,Galdakao,Expense,food,-316.73,45652.75
buyer_4,Jorge,50,ES27209566457215897586,TRX_N-00116-10197381,2020-10-03T11:19:28,Galdakao,Expense,transport,-62.04,45590.71
buyer_4,Jorge,50,ES27209566457215897586,TRX_N-00117-49693533,2020-10-05T05:19:17,Galdakao,Housing,Mortgage,-444.74,45145.97
buyer_4,Jorge,50,ES27209566457215897586,TRX_N-00118-90661173,2020-10-05T04:37:56,Galdakao,Basic services,water,-59.17,45086.8
buyer_4,Jorge,50,ES27209566457215897586,TRX_N-00119-35360060,2020-10-06T19:55:24,Galdakao,Basic services,electricity,-28.86,45057.94
buyer_4,Jorge,50,ES27209566457215897586,TRX_N-00120-80811934,2020-10-06T19:56:30,Galdakao,Basic services,internet,-54.31,45003.63
buyer_4,Jorge,50,ES27209566457215897586,TRX_N-00121-72073983,2020-10-07T13:36:12,Galdakao,Basic services,water,-19.0,44984.63
buyer_4,Jorge,50,ES27209566457215897586,TRX_N-00122-22223290,2020-10-07T10:35:08,Galdakao,Basic services,electricity,-73.47,44911.16
buyer_4,Jorge,50,ES27209566457215897586,TRX_N-00123-30435919,2020-10-07T19:55:22,Galdakao,Basic services,phone,-70.3,44840.86
buyer_4,Jorge,50,ES27209566457215897586,TRX_N-00124-57403474,2020-10-10T13:31:13,Getxo,Expense,healthcare,-338.28,44502.58
buyer_4,Jorge,50,ES27209566457215897586,TRX_N-00125-63357260,2020-11-01T10:24:45,Galdakao,transfer,Salary,2656.62,47159.2
buyer_4,Jorge,50,ES27209566457215897586,TRX_N-00126-73237394,2020-11-01T10:24:45,Galdakao,transfer,Partner Salary,2885.84,50045.04
buyer_4,Jorge,50,ES27209566457215897586,TRX_N-00127-32976209,2020-11-03T10:59:09,Galdakao,Expense,transport,-154.87,49890.17
buyer_4,Jorge,50,ES27209566457215897586,TRX_N-00128-75127350,2020-11-05T15:19:13,Galdakao,Housing,Mortgage,-444.74,49445.43
buyer_4,Jorge,50,ES27209566457215897586,TRX_N-00129-79398477,2020-11-05T17:28:23,Galdakao,Basic services,water,-70.86,49374.57
buyer_4,Jorge,50,ES27209566457215897586,TRX_N-00130-67298270,2020-11-05T13:21:55,Galdakao,Basic services,electricity,-56.88,49317.69
buyer_4,Jorge,50,ES27209566457215897586,TRX_N-00131-43668106,2020-11-05T13:50:57,Galdakao,Basic services,gas,-98.99,49218.7
buyer_4,Jorge,50,ES27209566457215897586,TRX_N-00132-60430676,2020-11-06T19:32:22,Galdakao,Basic services,water,-70.55,49148.15
buyer_4,Jorge,50,ES27209566457215897586,TRX_N-00133-19906032,2020-11-06T20:18:39,Galdakao,Basic services,phone,-35.99,49112.16
buyer_4,Jorge,50,ES27209566457215897586,TRX_N-00134-05949145,2020-11-07T15:38:13,Galdakao,Basic services,water,-40.71,49071.45
buyer_4,Jorge,50,ES27209566457215897586,TRX_N-00135-76399723,2020-11-07T19:16:42,Galdakao,Basic services,electricity,-132.08,48939.37
buyer_4,Jorge,50,ES27209566457215897586,TRX_N-00136-54858913,2020-11-07T14:55:15,Galdakao,Basic services,internet,-48.5,48890.87
buyer_4,Jorge,50,ES27209566457215897586,TRX_N-00137-44434366,2020-11-08T14:16:04,Galdakao,Expense,leisure,-28.61,48862.26
buyer_4,Jorge,50,ES27209566457215897586,TRX_N-00138-82970344,2020-11-10T14:10:15,Galdakao,Expense,healthcare,-274.52,48587.74
buyer_4,Jorge,50,ES27209566457215897586,TRX_N-00139-05867346,2020-12-01T18:25:06,Galdakao,transfer,Salary,2656.62,51244.36
buyer_4,Jorge,50,ES27209566457215897586,TRX_N-00140-73528867,2020-12-01T18:25:06,Galdakao,transfer,Partner Salary,2885.84,54130.2
buyer_4,Jorge,50,ES27209566457215897586,TRX_N-00141-02379549,2020-12-01T18:25:06,Galdakao,transfer,Extra Income,265.66,54395.86
buyer_4,Jorge,50,ES27209566457215897586,TRX_N-00142-39855916,2020-12-01T18:25:06,Galdakao,transfer,Bonus,2894.73,57290.59
buyer_4,Jorge,50,ES27209566457215897586,TRX_N-00143-85221506,2020-12-05T21:12:57,Galdakao,Housing,Mortgage,-444.74,56845.85
buyer_4,Jorge,50,ES27209566457215897586,TRX_N-00144-23666654,2020-12-05T21:56:11,Galdakao,Basic services,gas,-99.32,56746.53
buyer_4,Jorge,50,ES27209566457215897586,TRX_N-00145-44933639,2020-12-06T11:48:09,Galdakao,Basic services,internet,-79.12,56667.41
buyer_4,Jorge,50,ES27209566457215897586,TRX_N-00146-44753054,2020-12-06T12:03:58,Galdakao,Basic services,phone,-41.03,56626.38
buyer_4,Jorge,50,ES27209566457215897586,TRX_N-00147-89051940,2020-12-07T17:23:04,Galdakao,Basic services,water,-17.69,56608.69
buyer_4,Jorge,50,ES27209566457215897586,TRX_N-00148-54790043,2020-12-07T10:34:16,Galdakao,Basic services,electricity,-78.11,56530.58
buyer_4,Jorge,50,ES27209566457215897586,TRX_N-00149-08951334,2020-12-07T19:25:31,Galdakao,Basic services,phone,-52.55,56478.03
buyer_4,Jorge,50,ES27209566457215897586,TRX_N-00150-18619979,2020-12-14T16:22:18,Alegría-Dulantzi,Expense,transport,-117.45,56360.58
buyer_4,Jorge,50,ES27209566457215897586,TRX_N-00151-72905200,2020-12-15T16:46:47,Amurrio,Expense,transport,-156.0,56204.58
buyer_4,Jorge,50,ES27209566457215897586,TRX_N-00152-14452351,2020-12-23T19:38:20,Galdakao,Expense,transport,-112.75,56091.83
buyer_4,Jorge,50,ES27209566457215897586,TRX_N-00153-10498987,2020-12-26T21:41:48,Galdakao,Expense,food,-502.95,55588.88
buyer_4,Jorge,50,ES27209566457215897586,TRX_N-00154-32348035,2021-01-01T14:08:11,Galdakao,transfer,Salary,2656.62,58245.5
buyer_4,Jorge,50,ES27209566457215897586,TRX_N-00155-62346773,2021-01-01T14:08:11,Galdakao,transfer,Partner Salary,2885.84,61131.34
buyer_4,Jorge,50,ES27209566457215897586,TRX_N-00156-26658990,2021-01-04T19:27:45,Galdakao,Expense,transport,-93.94,61037.4
buyer_4,Jorge,50,ES27209566457215897586,TRX_N-00157-72896619,2021-01-05T23:39:16,Galdakao,Housing,Mortgage,-444.74,60592.66
buyer_4,Jorge,50,ES27209566457215897586,TRX_N-00158-58181477,2021-01-05T09:28:34,Galdakao,Basic services,gas,-93.4,60499.26
buyer_4,Jorge,50,ES27209566457215897586,TRX_N-00159-46944011,2021-01-06T15:30:34,Galdakao,Basic services,water,-57.31,60441.95
buyer_4,Jorge,50,ES27209566457215897586,TRX_N-00160-99146866,2021-01-06T13:17:07,Galdakao,Basic services,gas,-65.87,60376.08
buyer_4,Jorge,50,ES27209566457215897586,TRX_N-00161-45461840,2021-01-12T20:20:23,Galdakao,Expense,repairs,-158.05,60218.03
buyer_4,Jorge,50,ES27209566457215897586,TRX_N-00162-90038965,2021-02-01T17:59:48,Galdakao,transfer,Salary,2656.62,62874.65
buyer_4,Jorge,50,ES27209566457215897586,TRX_N-00163-58841791,2021-02-01T17:59:48,Galdakao,transfer,Partner Salary,2885.84,65760.49
buyer_4,Jorge,50,ES27209566457215897586,TRX_N-00164-11991705,2021-02-05T16:17:16,Galdakao,Housing,Mortgage,-444.74,65315.75
buyer_4,Jorge,50,ES27209566457215897586,TRX_N-00165-10797357,2021-02-06T14:03:42,Galdakao,Basic services,gas,-98.18,65217.57
buyer_4,Jorge,50,ES27209566457215897586,TRX_N-00166-86175368,2021-02-06T10:43:43,Galdakao,Basic services,internet,-62.14,65155.43
buyer_4,Jorge,50,ES27209566457215897586,TRX_N-00167-45965758,2021-02-07T19:59:27,Galdakao,Basic services,water,-58.33,65097.1
buyer_4,Jorge,50,ES27209566457215897586,TRX_N-00168-74216590,2021-02-07T09:58:16,Galdakao,Basic services,electricity,-96.77,65000.33
buyer_4,Jorge,50,ES27209566457215897586,TRX_N-00169-75749074,2021-02-07T16:34:12,Galdakao,Basic services,internet,-41.55,64958.78
buyer_4,Jorge,50,ES27209566457215897586,TRX_N-00170-31502787,2021-02-07T09:54:22,Galdakao,Basic services,phone,-60.87,64897.91
buyer_4,Jorge,50,ES27209566457215897586,TRX_N-00171-41769955,2021-02-20T10:12:33,Galdakao,Expense,leisure,-106.82,64791.09
buyer_4,Jorge,50,ES27209566457215897586,TRX_N-00172-10581410,2021-03-01T12:55:07,Galdakao,transfer,Salary,2656.62,67447.71
buyer_4,Jorge,50,ES27209566457215897586,TRX_N-00173-46386791,2021-03-01T12:55:07,Galdakao,transfer,Partner Salary,2885.84,70333.55
buyer_4,Jorge,50,ES27209566457215897586,TRX_N-00174-50136972,2021-03-01T12:55:07,Galdakao,transfer,Extra Income,265.66,70599.21
buyer_4,Jorge,50,ES27209566457215897586,TRX_N-00175-31488020,2021-03-03T14:41:46,Bilbao,Expense,gifts,-48.17,70551.04
buyer_4,Jorge,50,ES27209566457215897586,TRX_N-00176-72523142,2021-03-05T15:37:03,Galdakao,Housing,Mortgage,-444.74,70106.3
buyer_4,Jorge,50,ES27209566457215897586,TRX_N-00177-63145833,2021-03-06T16:49:31,Galdakao,Basic services,water,-64.93,70041.37
buyer_4,Jorge,50,ES27209566457215897586,TRX_N-00178-80806591,2021-03-06T14:57:57,Galdakao,Basic services,phone,-65.21,69976.16
buyer_4,Jorge,50,ES27209566457215897586,TRX_N-00179-54504587,2021-03-07T16:31:22,Galdakao,Basic services,phone,-30.83,69945.33
buyer_4,Jorge,50,ES27209566457215897586,TRX_N-00180-81115986,2021-03-07T22:20:20,Galdakao,Expense,education,-129.25,69816.08
buyer_4,Jorge,50,ES27209566457215897586,TRX_N-00181-49523688,2021-03-11T22:38:07,Galdakao,Expense,travel,-1824.35,67991.73
buyer_4,Jorge,50,ES27209566457215897586,TRX_N-00182-21848519,2021-03-18T22:24:03,Galdakao,Expense,transport,-85.42,67906.31
buyer_4,Jorge,50,ES27209566457215897586,TRX_N-00183-69992925,2021-04-01T21:49:45,Galdakao,transfer,Salary,2656.62,70562.93
buyer_4,Jorge,50,ES27209566457215897586,TRX_N-00184-83796834,2021-04-01T21:49:45,Galdakao,transfer,Partner Salary,2885.84,73448.77
buyer_4,Jorge,50,ES27209566457215897586,TRX_N-00185-87002231,2021-04-05T11:52:58,Galdakao,Housing,Mortgage,-444.74,73004.03
buyer_4,Jorge,50,ES27209566457215897586,TRX_N-00186-64538359,2021-04-05T15:14:23,Galdakao,Basic services,electricity,-94.5,72909.53
buyer_4,Jorge,50,ES27209566457215897586,TRX_N-00187-43219505,2021-04-05T08:36:24,Galdakao,Basic services,gas,-88.64,72820.89
buyer_4,Jorge,50,ES27209566457215897586,TRX_N-00188-32814098,2021-04-05T15:18:58,Galdakao,Basic services,internet,-72.78,72748.11
buyer_4,Jorge,50,ES27209566457215897586,TRX_N-00189-74387480,2021-04-05T19:00:25,Galdakao,Expense,repairs,-949.03,71799.08
buyer_4,Jorge,50,ES27209566457215897586,TRX_N-00190-55905463,2021-04-06T08:56:00,Galdakao,Basic services,internet,-44.14,71754.94
buyer_4,Jorge,50,ES27209566457215897586,TRX_N-00191-78721927,2021-04-06T16:33:03,Galdakao,Basic services,phone,-46.18,71708.76
buyer_4,Jorge,50,ES27209566457215897586,TRX_N-00192-88048842,2021-04-24T13:32:43,Galdakao,Expense,leisure,-114.15,71594.61
buyer_4,Jorge,50,ES27209566457215897586,TRX_N-00193-53415468,2021-04-30T12:50:00,Galdakao,Expense,clothing,-138.76,71455.85
buyer_4,Jorge,50,ES27209566457215897586,TRX_N-00194-03363458,2021-05-01T14:05:27,Galdakao,transfer,Salary,2656.62,74112.47
buyer_4,Jorge,50,ES27209566457215897586,TRX_N-00195-91076644,2021-05-01T14:05:27,Galdakao,transfer,Partner Salary,2885.84,76998.31
buyer_4,Jorge,50,ES27209566457215897586,TRX_N-00196-64051637,2021-05-01T14:05:27,Galdakao,transfer,Extra Income,265.66,77263.97
buyer_4,Jorge,50,ES27209566457215897586,TRX_N-00197-59072526,2021-05-05T21:06:07,Galdakao,Housing,Mortgage,-444.74,76819.23
buyer_4,Jorge,50,ES27209566457215897586,TRX_N-00198-30728538,2021-05-05T18:56:17,Galdakao,Basic services,water,-38.54,76780.69
buyer_4,Jorge,50,ES27209566457215897586,TRX_N-00199-01765089,2021-05-05T10:20:45,Galdakao,Basic services,internet,-49.03,76731.66
buyer_4,Jorge,50,ES27209566457215897586,TRX_N-00200-28924637,2021-05-06T13:40:10,Galdakao,Basic services,electricity,-84.8,76646.86
buyer_4,Jorge,50,ES27209566457215897586,TRX_N-00201-49190254,2021-05-06T18:56:10,Galdakao,Basic services,gas,-20.87,76625.99
buyer_4,Jorge,50,ES27209566457215897586,TRX_N-00202-39557339,2021-05-06T13:08:54,Galdakao,Basic services,internet,-64.74,76561.25
buyer_4,Jorge,50,ES27209566457215897586,TRX_N-00203-89453322,2021-05-07T23:17:33,Galdakao,Basic services,water,-28.17,76533.08
buyer_4,Jorge,50,ES27209566457215897586,TRX_N-00204-14110957,2021-05-07T19:04:42,Galdakao,Basic services,internet,-54.3,76478.78
buyer_4,Jorge,50,ES27209566457215897586,TRX_N-00205-23567709,2021-05-17T17:06:55,Galdakao,Expense,clothing,-104.35,76374.43
buyer_4,Jorge,50,ES27209566457215897586,TRX_N-00206-23818550,2021-06-01T10:39:23,Galdakao,transfer,Salary,2656.62,79031.05
buyer_4,Jorge,50,ES27209566457215897586,TRX_N-00207-86625538,2021-06-01T10:39:23,Galdakao,transfer,Partner Salary,2885.84,81916.89
buyer_4,Jorge,50,ES27209566457215897586,TRX_N-00208-73776168,2021-06-01T10:39:23,Galdakao,transfer,Bonus,2902.88,84819.77
buyer_4,Jorge,50,ES27209566457215897586,TRX_N-00209-98928960,2021-06-02T05:16:11,Galdakao,Expense,transport,-195.42,84624.35
buyer_4,Jorge,50,ES27209566457215897586,TRX_N-00210-42195851,2021-06-05T22:24:52,Galdakao,Housing,Mortgage,-444.74,84179.61
buyer_4,Jorge,50,ES27209566457215897586,TRX_N-00211-59601655,2021-06-06T08:02:41,Galdakao,Basic services,water,-47.83,84131.78
buyer_4,Jorge,50,ES27209566457215897586,TRX_N-00212-92077060,2021-06-06T14:57:24,Galdakao,Basic services,electricity,-113.55,84018.23
buyer_4,Jorge,50,ES27209566457215897586,TRX_N-00213-52401077,2021-06-06T11:06:38,Galdakao,Basic services,gas,-35.61,83982.62
buyer_4,Jorge,50,ES27209566457215897586,TRX_N-00214-92407286,2021-06-06T17:35:24,Galdakao,Basic services,internet,-65.92,83916.7
buyer_4,Jorge,50,ES27209566457215897586,TRX_N-00215-08757340,2021-06-07T11:02:33,Galdakao,Basic services,gas,-45.17,83871.53
buyer_4,Jorge,50,ES27209566457215897586,TRX_N-00216-36766187,2021-06-10T10:37:17,Galdakao,Expense,transport,-115.01,83756.52
buyer_4,Jorge,50,ES27209566457215897586,TRX_N-00217-08984315,2021-06-30T19:10:16,Galdakao,Expense,clothing,-460.78,83295.74
buyer_4,Jorge,50,ES27209566457215897586,TRX_N-00218-00773015,2021-07-01T00:55:35,Galdakao,transfer,Salary,2656.62,85952.36
buyer_4,Jorge,50,ES27209566457215897586,TRX_N-00219-35595843,2021-07-01T00:55:35,Galdakao,transfer,Partner Salary,2885.84,88838.2
buyer_4,Jorge,50,ES27209566457215897586,TRX_N-00220-78267419,2021-07-01T00:55:35,Galdakao,transfer,Extra Income,265.66,89103.86
buyer_4,Jorge,50,ES27209566457215897586,TRX_N-00221-74070774,2021-07-05T20:40:17,Galdakao,Housing,Mortgage,-444.74,88659.12
buyer_4,Jorge,50,ES27209566457215897586,TRX_N-00222-55928830,2021-07-05T11:56:54,Galdakao,Basic services,water,-57.19,88601.93
buyer_4,Jorge,50,ES27209566457215897586,TRX_N-00223-67971081,2021-07-05T14:21:09,Galdakao,Basic services,electricity,-82.87,88519.06
buyer_4,Jorge,50,ES27209566457215897586,TRX_N-00224-12816227,2021-07-05T09:21:43,Galdakao,Basic services,gas,-99.01,88420.05
buyer_4,Jorge,50,ES27209566457215897586,TRX_N-00225-91377424,2021-07-05T12:12:08,Galdakao,Basic services,internet,-70.19,88349.86
buyer_4,Jorge,50,ES27209566457215897586,TRX_N-00226-77866762,2021-07-05T13:10:58,Galdakao,Basic services,phone,-47.91,88301.95
buyer_4,Jorge,50,ES27209566457215897586,TRX_N-00227-08307868,2021-07-06T16:34:25,Galdakao,Basic services,water,-59.97,88241.98
buyer_4,Jorge,50,ES27209566457215897586,TRX_N-00228-91266988,2021-07-06T14:11:31,Galdakao,Basic services,gas,-65.31,88176.67
buyer_4,Jorge,50,ES27209566457215897586,TRX_N-00229-08934585,2021-07-06T10:46:58,Galdakao,Basic services,phone,-64.29,88112.38
buyer_4,Jorge,50,ES27209566457215897586,TRX_N-00230-34406256,2021-07-07T21:17:16,Galdakao,Basic services,internet,-37.98,88074.4
buyer_4,Jorge,50,ES27209566457215897586,TRX_N-00231-63628182,2021-07-07T14:37:10,Galdakao,Basic services,phone,-87.91,87986.49
buyer_4,Jorge,50,ES27209566457215897586,TRX_N-00232-89245295,2021-07-20T19:55:35,Galdakao,Expense,education,-559.23,87427.26
buyer_4,Jorge,50,ES27209566457215897586,TRX_N-00233-08805215,2021-08-01T14:45:16,Galdakao,transfer,Salary,2656.62,90083.88
buyer_4,Jorge,50,ES27209566457215897586,TRX_N-00234-75242134,2021-08-01T14:45:16,Galdakao,transfer,Partner Salary,2885.84,92969.72
buyer_4,Jorge,50,ES27209566457215897586,TRX_N-00235-63379838,2021-08-05T08:41:34,Galdakao,Housing,Mortgage,-444.74,92524.98
buyer_4,Jorge,50,ES27209566457215897586,TRX_N-00236-90555428,2021-08-05T12:55:52,Galdakao,Basic services,electricity,-87.25,92437.73
buyer_4,Jorge,50,ES27209566457215897586,TRX_N-00237-81670031,2021-08-05T14:46:43,Galdakao,Basic services,gas,-92.26,92345.47
buyer_4,Jorge,50,ES27209566457215897586,TRX_N-00238-03961607,2021-08-05T16:57:28,Galdakao,Basic services,internet,-32.25,92313.22
buyer_4,Jorge,50,ES27209566457215897586,TRX_N-00239-96510964,2021-08-05T14:58:54,Galdakao,Basic services,phone,-20.99,92292.23
buyer_4,Jorge,50,ES27209566457215897586,TRX_N-00240-09322304,2021-08-06T14:28:40,Galdakao,Expense,travel,-987.46,91304.77
buyer_4,Jorge,50,ES27209566457215897586,TRX_N-00241-23010988,2021-08-07T10:33:33,Galdakao,Basic services,water,-56.76,91248.01
buyer_4,Jorge,50,ES27209566457215897586,TRX_N-00242-63748402,2021-08-07T22:58:12,Galdakao,Basic services,electricity,-62.84,91185.17
buyer_4,Jorge,50,ES27209566457215897586,TRX_N-00243-58350031,2021-08-07T18:43:48,Galdakao,Basic services,internet,-62.58,91122.59
buyer_4,Jorge,50,ES27209566457215897586,TRX_N-00244-91734949,2021-08-07T19:41:21,Galdakao,Basic services,phone,-48.83,91073.76
buyer_4,Jorge,50,ES27209566457215897586,TRX_N-00245-67561957,2021-08-20T09:59:31,Portugalete,Expense,leisure,-102.92,90970.84
buyer_4,Jorge,50,ES27209566457215897586,TRX_N-00246-09118033,2021-08-21T20:33:18,Galdakao,Expense,leisure,-223.35,90747.49
buyer_4,Jorge,50,ES27209566457215897586,TRX_N-00247-57163980,2021-09-01T19:26:57,Galdakao,transfer,Salary,2656.62,93404.11
buyer_4,Jorge,50,ES27209566457215897586,TRX_N-00248-86643519,2021-09-01T19:26:57,Galdakao,transfer,Partner Salary,2885.84,96289.95
buyer_4,Jorge,50,ES27209566457215897586,TRX_N-00249-44855290,2021-09-01T19:26:57,Galdakao,transfer,Extra Income,265.66,96555.61
buyer_4,Jorge,50,ES27209566457215897586,TRX_N-00250-76921037,2021-09-01T22:24:21,Galdakao,Expense,food,-408.19,96147.42
buyer_4,Jorge,50,ES27209566457215897586,TRX_N-00251-33863100,2021-09-05T03:50:46,Galdakao,Housing,Mortgage,-444.74,95702.68
buyer_4,Jorge,50,ES27209566457215897586,TRX_N-00252-19703405,2021-09-05T09:30:46,Galdakao,Basic services,electricity,-72.47,95630.21
buyer_4,Jorge,50,ES27209566457215897586,TRX_N-00253-27758839,2021-09-06T11:11:21,Galdakao,Expense,clothing,-280.78,95349.43
buyer_4,Jorge,50,ES27209566457215897586,TRX_N-00254-28726287,2021-09-19T10:10:49,Galdakao,Expense,transport,-52.87,95296.56
buyer_4,Jorge,50,ES27209566457215897586,TRX_N-00255-35392385,2021-09-20T16:49:32,Salvatierra/Agurain,Expense,leisure,-244.34,95052.22
buyer_4,Jorge,50,ES27209566457215897586,TRX_N-00256-40801759,2021-10-01T09:53:07,Galdakao,transfer,Salary,2656.62,97708.84
buyer_4,Jorge,50,ES27209566457215897586,TRX_N-00257-99723767,2021-10-01T09:53:07,Galdakao,transfer,Partner Salary,2885.84,100594.68
buyer_4,Jorge,50,ES27209566457215897586,TRX_N-00258-58498875,2021-10-02T11:22:19,Galdakao,Expense,food,-426.3,100168.38
buyer_4,Jorge,50,ES27209566457215897586,TRX_N-00259-84142529,2021-10-05T12:03:28,Galdakao,Housing,Mortgage,-444.74,99723.64
buyer_4,Jorge,50,ES27209566457215897586,TRX_N-00260-74235984,2021-10-05T19:03:23,Galdakao,Basic services,water,-17.9,99705.74
buyer_4,Jorge,50,ES27209566457215897586,TRX_N-00261-68299057,2021-10-05T09:11:22,Galdakao,Basic services,internet,-58.26,99647.48
buyer_4,Jorge,50,ES27209566457215897586,TRX_N-00262-74592356,2021-10-06T19:29:42,Galdakao,Basic services,electricity,-134.54,99512.94
buyer_4,Jorge,50,ES27209566457215897586,TRX_N-00263-41736473,2021-10-07T21:01:09,Galdakao,Basic services,phone,-86.57,99426.37
buyer_4,Jorge,50,ES27209566457215897586,TRX_N-00264-47600306,2021-10-11T21:19:17,Galdakao,Expense,transport,-51.09,99375.28
buyer_4,Jorge,50,ES27209566457215897586,TRX_N-00265-74440523,2021-10-30T08:22:14,Galdakao,Expense,leisure,-108.87,99266.41
buyer_4,Jorge,50,ES27209566457215897586,TRX_N-00266-38348972,2021-10-31T13:06:13,Galdakao,Expense,clothing,-412.79,98853.62
buyer_4,Jorge,50,ES27209566457215897586,TRX_N-00267-78759682,2021-11-01T10:20:33,Galdakao,transfer,Salary,2656.62,101510.24
buyer_4,Jorge,50,ES27209566457215897586,TRX_N-00268-55516576,2021-11-01T10:20:33,Galdakao,transfer,Partner Salary,2885.84,104396.08
buyer_4,Jorge,50,ES27209566457215897586,TRX_N-00269-49785909,2021-11-01T10:20:33,Galdakao,transfer,Extra Income,265.66,104661.74
buyer_4,Jorge,50,ES27209566457215897586,TRX_N-00270-81410336,2021-11-05T09:01:39,Galdakao,Housing,Mortgage,-444.74,104217.0
buyer_4,Jorge,50,ES27209566457215897586,TRX_N-00271-16317654,2021-11-06T15:01:57,Galdakao,Basic services,water,-65.67,104151.33
buyer_4,Jorge,50,ES27209566457215897586,TRX_N-00272-28610021,2021-11-07T18:48:56,Galdakao,Basic services,water,-14.31,104137.02
buyer_4,Jorge,50,ES27209566457215897586,TRX_N-00273-75991306,2021-11-07T20:55:39,Galdakao,Basic services,electricity,-120.72,104016.3
buyer_4,Jorge,50,ES27209566457215897586,TRX_N-00274-06731642,2021-11-07T21:02:19,Galdakao,Basic services,gas,-77.9,103938.4
buyer_4,Jorge,50,ES27209566457215897586,TRX_N-00275-06543304,2021-11-07T10:41:52,Galdakao,Basic services,internet,-61.97,103876.43
buyer_4,Jorge,50,ES27209566457215897586,TRX_N-00276-90019099,2021-11-29T11:35:02,Galdakao,Expense,transport,-193.81,103682.62
buyer_4,Jorge,50,ES27209566457215897586,TRX_N-00277-19115489,2021-12-01T16:37:55,Galdakao,transfer,Salary,2656.62,106339.24
buyer_4,Jorge,50,ES27209566457215897586,TRX_N-00278-76213954,2021-12-01T16:37:55,Galdakao,transfer,Partner Salary,2885.84,109225.08
buyer_4,Jorge,50,ES27209566457215897586,TRX_N-00279-45933214,2021-12-01T16:37:55,Galdakao,transfer,Bonus,2647.01,111872.09
buyer_4,Jorge,50,ES27209566457215897586,TRX_N-00280-80008012,2021-12-02T09:58:53,Galdakao,Expense,transport,-108.08,111764.01
buyer_4,Jorge,50,ES27209566457215897586,TRX_N-00281-78936728,2021-12-05T18:44:09,Galdakao,Housing,Mortgage,-444.74,111319.27
buyer_4,Jorge,50,ES27209566457215897586,TRX_N-00282-34605195,2021-12-05T16:36:38,Galdakao,Basic services,electricity,-120.32,111198.95
buyer_4,Jorge,50,ES27209566457215897586,TRX_N-00283-47311796,2021-12-05T17:24:58,Galdakao,Basic services,internet,-62.72,111136.23
buyer_4,Jorge,50,ES27209566457215897586,TRX_N-00284-81640021,2021-12-05T09:48:54,Galdakao,Basic services,phone,-86.12,111050.11
buyer_4,Jorge,50,ES27209566457215897586,TRX_N-00285-56004782,2021-12-06T12:43:24,Galdakao,Basic services,phone,-88.42,110961.69
buyer_4,Jorge,50,ES27209566457215897586,TRX_N-00286-28445074,2021-12-07T23:22:24,Galdakao,Basic services,electricity,-121.61,110840.08
buyer_4,Jorge,50,ES27209566457215897586,TRX_N-00287-90479469,2021-12-07T14:16:53,Galdakao,Basic services,phone,-98.95,110741.13
buyer_4,Jorge,50,ES27209566457215897586,TRX_N-00288-96564853,2021-12-10T15:50:23,Leioa,Expense,leisure,-171.61,110569.52
buyer_4,Jorge,50,ES27209566457215897586,TRX_N-00289-77316356,2021-12-15T10:16:03,Galdakao,Expense,leisure,-223.68,110345.84
buyer_4,Jorge,50,ES27209566457215897586,TRX_N-00290-33247637,2021-12-17T13:54:16,Galdakao,Expense,transport,-148.32,110197.52
buyer_4,Jorge,50,ES27209566457215897586,TRX_N-00291-78438782,2021-12-29T22:10:21,Galdakao,Expense,healthcare,-248.5,109949.02
buyer_4,Jorge,50,ES27209566457215897586,TRX_N-00292-59836521,2022-01-01T22:51:29,Galdakao,transfer,Salary,2656.62,112605.64
buyer_4,Jorge,50,ES27209566457215897586,TRX_N-00293-27605961,2022-01-01T22:51:29,Galdakao,transfer,Partner Salary,2885.84,115491.48
buyer_4,Jorge,50,ES27209566457215897586,TRX_N-00294-72750431,2022-01-05T18:38:39,Galdakao,Housing,Mortgage,-444.74,115046.74
buyer_4,Jorge,50,ES27209566457215897586,TRX_N-00295-42318529,2022-01-06T14:27:00,Galdakao,Expense,transport,-46.44,115000.3
buyer_4,Jorge,50,ES27209566457215897586,TRX_N-00296-85881517,2022-01-07T17:34:33,Galdakao,Basic services,gas,-97.48,114902.82
buyer_4,Jorge,50,ES27209566457215897586,TRX_N-00297-52565826,2022-01-07T18:04:36,Galdakao,Basic services,phone,-36.24,114866.58
buyer_4,Jorge,50,ES27209566457215897586,TRX_N-00298-20379189,2022-01-11T21:30:15,Galdakao,Expense,healthcare,-209.95,114656.63
buyer_4,Jorge,50,ES27209566457215897586,TRX_N-00299-69685856,2022-01-23T19:12:37,Galdakao,Expense,transport,-137.34,114519.29
buyer_4,Jorge,50,ES27209566457215897586,TRX_N-00300-53222485,2022-01-25T19:51:04,Galdakao,Expense,food,-454.57,114064.72
buyer_4,Jorge,50,ES27209566457215897586,TRX_N-00301-02445928,2022-02-01T08:20:29,Galdakao,transfer,Salary,2656.62,116721.34
buyer_4,Jorge,50,ES27209566457215897586,TRX_N-00302-49110629,2022-02-01T08:20:29,Galdakao,transfer,Partner Salary,2885.84,119607.18
buyer_4,Jorge,50,ES27209566457215897586,TRX_N-00303-35503736,2022-02-01T08:20:29,Galdakao,transfer,Extra Income,265.66,119872.84
buyer_4,Jorge,50,ES27209566457215897586,TRX_N-00304-58895758,2022-02-02T22:33:33,Galdakao,Expense,food,-674.9,119197.94
buyer_4,Jorge,50,ES27209566457215897586,TRX_N-00305-99981995,2022-02-05T08:41:11,Galdakao,Housing,Mortgage,-444.74,118753.2
buyer_4,Jorge,50,ES27209566457215897586,TRX_N-00306-29175300,2022-02-05T11:25:38,Galdakao,Basic services,internet,-53.18,118700.02
buyer_4,Jorge,50,ES27209566457215897586,TRX_N-00307-54079992,2022-02-06T13:55:37,Galdakao,Basic services,phone,-32.72,118667.3
buyer_4,Jorge,50,ES27209566457215897586,TRX_N-00308-24216942,2022-02-07T05:26:17,Galdakao,Basic services,electricity,-38.4,118628.9
buyer_4,Jorge,50,ES27209566457215897586,TRX_N-00309-78444531,2022-02-07T13:35:39,Galdakao,Basic services,internet,-72.73,118556.17
buyer_4,Jorge,50,ES27209566457215897586,TRX_N-00310-68687285,2022-02-07T13:35:10,Galdakao,Basic services,phone,-24.11,118532.06
buyer_4,Jorge,50,ES27209566457215897586,TRX_N-00311-46559481,2022-02-21T08:37:00,Galdakao,Expense,food,-600.25,117931.81
buyer_4,Jorge,50,ES27209566457215897586,TRX_N-00312-24249558,2022-02-24T20:42:12,Galdakao,Expense,clothing,-477.8,117454.01
buyer_4,Jorge,50,ES27209566457215897586,TRX_N-00313-60816886,2022-03-01T20:25:02,Galdakao,transfer,Salary,2656.62,120110.63
buyer_4,Jorge,50,ES27209566457215897586,TRX_N-00314-44524860,2022-03-01T20:25:02,Galdakao,transfer,Partner Salary,2885.84,122996.47
buyer_4,Jorge,50,ES27209566457215897586,TRX_N-00315-04084663,2022-03-05T15:19:58,Galdakao,Housing,Mortgage,-444.74,122551.73
buyer_4,Jorge,50,ES27209566457215897586,TRX_N-00316-95973205,2022-03-05T17:01:27,Galdakao,Basic services,water,-28.46,122523.27
buyer_4,Jorge,50,ES27209566457215897586,TRX_N-00317-11684259,2022-03-05T08:04:04,Galdakao,Basic services,gas,-74.56,122448.71
buyer_4,Jorge,50,ES27209566457215897586,TRX_N-00318-56232138,2022-03-05T16:48:10,Galdakao,Expense,food,-445.07,122003.64
buyer_4,Jorge,50,ES27209566457215897586,TRX_N-00319-95991683,2022-03-05T03:43:12,Basauri,Expense,transport,-79.04,121924.6
buyer_4,Jorge,50,ES27209566457215897586,TRX_N-00320-33479531,2022-03-06T16:15:08,Galdakao,Basic services,gas,-38.39,121886.21
buyer_4,Jorge,50,ES27209566457215897586,TRX_N-00321-83351789,2022-03-07T15:38:23,Galdakao,Basic services,water,-27.14,121859.07
buyer_4,Jorge,50,ES27209566457215897586,TRX_N-00322-28114264,2022-03-11T11:30:26,Galdakao,Expense,transport,-54.96,121804.11
buyer_4,Jorge,50,ES27209566457215897586,TRX_N-00323-58806740,2022-03-21T14:49:06,Galdakao,Expense,transport,-24.84,121779.27
buyer_4,Jorge,50,ES27209566457215897586,TRX_N-00324-61561517,2022-03-22T18:28:09,Galdakao,Expense,leisure,-44.37,121734.9
buyer_4,Jorge,50,ES27209566457215897586,TRX_N-00325-37251741,2022-03-22T13:06:06,Irun,Expense,healthcare,-99.73,121635.17
buyer_4,Jorge,50,ES27209566457215897586,TRX_N-00326-38177824,2022-04-01T16:40:54,Galdakao,transfer,Salary,2656.62,124291.79
buyer_4,Jorge,50,ES27209566457215897586,TRX_N-00327-66111253,2022-04-01T16:40:54,Galdakao,transfer,Partner Salary,2885.84,127177.63
buyer_4,Jorge,50,ES27209566457215897586,TRX_N-00328-70499494,2022-04-01T16:40:54,Galdakao,transfer,Extra Income,265.66,127443.29
buyer_4,Jorge,50,ES27209566457215897586,TRX_N-00329-41668767,2022-04-05T10:48:57,Galdakao,Housing,Mortgage,-444.74,126998.55
buyer_4,Jorge,50,ES27209566457215897586,TRX_N-00330-60243338,2022-04-05T07:43:19,Galdakao,Basic services,electricity,-26.33,126972.22
buyer_4,Jorge,50,ES27209566457215897586,TRX_N-00331-80869513,2022-04-06T18:47:52,Galdakao,Basic services,phone,-97.36,126874.86
buyer_4,Jorge,50,ES27209566457215897586,TRX_N-00332-62271838,2022-04-06T19:13:35,Galdakao,Expense,leisure,-68.82,126806.04
buyer_4,Jorge,50,ES27209566457215897586,TRX_N-00333-83400277,2022-04-13T10:06:21,Galdakao,Expense,leisure,-137.36,126668.68
buyer_4,Jorge,50,ES27209566457215897586,TRX_N-00334-23996082,2022-04-14T14:14:50,Galdakao,Expense,education,-426.04,126242.64
buyer_4,Jorge,50,ES27209566457215897586,TRX_N-00335-17295342,2022-04-19T18:03:17,Galdakao,Expense,repairs,-55.15,126187.49
buyer_4,Jorge,50,ES27209566457215897586,TRX_N-00336-79355589,2022-04-22T16:23:06,Galdakao,Expense,transport,-65.18,126122.31
buyer_4,Jorge,50,ES27209566457215897586,TRX_N-00337-97997745,2022-04-26T20:03:38,Alegría-Dulantzi,Expense,food,-368.51,125753.8
buyer_4,Jorge,50,ES27209566457215897586,TRX_N-00338-00179027,2022-05-01T17:04:04,Galdakao,transfer,Salary,2656.62,128410.42
buyer_4,Jorge,50,ES27209566457215897586,TRX_N-00339-43482881,2022-05-01T17:04:04,Galdakao,transfer,Partner Salary,2885.84,131296.26
buyer_4,Jorge,50,ES27209566457215897586,TRX_N-00340-41566352,2022-05-05T16:26:20,Galdakao,Housing,Mortgage,-444.74,130851.52
buyer_4,Jorge,50,ES27209566457215897586,TRX_N-00341-44504540,2022-05-05T16:22:24,Galdakao,Basic services,water,-74.18,130777.34
buyer_4,Jorge,50,ES27209566457215897586,TRX_N-00342-15626181,2022-05-05T11:00:41,Galdakao,Basic services,phone,-36.77,130740.57
buyer_4,Jorge,50,ES27209566457215897586,TRX_N-00343-82476130,2022-05-06T08:10:39,Galdakao,Basic services,gas,-19.3,130721.27
buyer_4,Jorge,50,ES27209566457215897586,TRX_N-00344-89436494,2022-05-07T09:13:42,Galdakao,Basic services,gas,-71.84,130649.43
buyer_4,Jorge,50,ES27209566457215897586,TRX_N-00345-22452118,2022-05-07T19:27:46,Galdakao,Basic services,phone,-59.82,130589.61
buyer_4,Jorge,50,ES27209566457215897586,TRX_N-00346-88606625,2022-05-14T11:19:25,Galdakao,Expense,healthcare,-364.48,130225.13
buyer_4,Jorge,50,ES27209566457215897586,TRX_N-00347-59945785,2022-05-18T17:15:41,Galdakao,Expense,transport,-153.47,130071.66
buyer_4,Jorge,50,ES27209566457215897586,TRX_N-00348-09113396,2022-05-19T08:16:25,Galdakao,Expense,food,-666.31,129405.35
buyer_4,Jorge,50,ES27209566457215897586,TRX_N-00349-69236501,2022-05-22T18:18:31,Galdakao,Expense,food,-751.52,128653.83
buyer_4,Jorge,50,ES27209566457215897586,TRX_N-00350-68258772,2022-05-25T11:18:38,Galdakao,Expense,clothing,-372.36,128281.47
buyer_4,Jorge,50,ES27209566457215897586,TRX_N-00351-43202672,2022-06-01T11:59:18,Galdakao,transfer,Salary,2656.62,130938.09
buyer_4,Jorge,50,ES27209566457215897586,TRX_N-00352-15101877,2022-06-01T11:59:18,Galdakao,transfer,Partner Salary,2885.84,133823.93
buyer_4,Jorge,50,ES27209566457215897586,TRX_N-00353-85263515,2022-06-01T11:59:18,Galdakao,transfer,Extra Income,265.66,134089.59
buyer_4,Jorge,50,ES27209566457215897586,TRX_N-00354-71726175,2022-06-01T11:59:18,Galdakao,transfer,Bonus,2567.46,136657.05
buyer_4,Jorge,50,ES27209566457215897586,TRX_N-00355-90661811,2022-06-05T18:35:54,Galdakao,Housing,Mortgage,-444.74,136212.31
buyer_4,Jorge,50,ES27209566457215897586,TRX_N-00356-02007631,2022-06-05T07:02:57,Galdakao,Basic services,electricity,-100.69,136111.62
buyer_4,Jorge,50,ES27209566457215897586,TRX_N-00357-01147690,2022-06-05T15:52:53,Galdakao,Basic services,gas,-50.14,136061.48
buyer_4,Jorge,50,ES27209566457215897586,TRX_N-00358-37501428,2022-06-05T19:08:13,Galdakao,Basic services,phone,-87.2,135974.28
buyer_4,Jorge,50,ES27209566457215897586,TRX_N-00359-79216680,2022-06-06T10:27:42,Galdakao,Basic services,electricity,-38.7,135935.58
buyer_4,Jorge,50,ES27209566457215897586,TRX_N-00360-55083481,2022-06-06T11:05:43,Galdakao,Basic services,internet,-32.03,135903.55
buyer_4,Jorge,50,ES27209566457215897586,TRX_N-00361-72383583,2022-06-07T20:42:14,Galdakao,Basic services,internet,-72.15,135831.4
buyer_4,Jorge,50,ES27209566457215897586,TRX_N-00362-65748558,2022-06-09T17:03:09,Galdakao,Expense,food,-291.34,135540.06
buyer_4,Jorge,50,ES27209566457215897586,TRX_N-00363-43588363,2022-06-16T09:02:50,Pasaia,Expense,food,-163.59,135376.47
buyer_4,Jorge,50,ES27209566457215897586,TRX_N-00364-49290612,2022-06-18T23:11:40,Galdakao,Expense,education,-432.91,134943.56
buyer_4,Jorge,50,ES27209566457215897586,TRX_N-00365-50335267,2022-06-21T09:44:56,Galdakao,Expense,clothing,-264.0,134679.56
buyer_4,Jorge,50,ES27209566457215897586,TRX_N-00366-35595402,2022-07-01T15:46:43,Galdakao,transfer,Salary,2656.62,137336.18
buyer_4,Jorge,50,ES27209566457215897586,TRX_N-00367-65971939,2022-07-01T15:46:43,Galdakao,transfer,Partner Salary,2885.84,140222.02
buyer_4,Jorge,50,ES27209566457215897586,TRX_N-00368-94318563,2022-07-05T10:49:46,Galdakao,Housing,Mortgage,-444.74,139777.28
buyer_4,Jorge,50,ES27209566457215897586,TRX_N-00369-52315054,2022-07-06T18:53:20,Galdakao,Basic services,electricity,-58.26,139719.02
buyer_4,Jorge,50,ES27209566457215897586,TRX_N-00370-82858972,2022-07-06T12:02:09,Galdakao,Basic services,gas,-28.24,139690.78
buyer_4,Jorge,50,ES27209566457215897586,TRX_N-00371-08712302,2022-07-07T20:48:07,Galdakao,Basic services,water,-11.91,139678.87
buyer_4,Jorge,50,ES27209566457215897586,TRX_N-00372-26773183,2022-07-07T16:30:31,Galdakao,Basic services,gas,-91.65,139587.22
buyer_4,Jorge,50,ES27209566457215897586,TRX_N-00373-30042385,2022-07-07T11:18:21,Galdakao,Basic services,internet,-56.66,139530.56
buyer_4,Jorge,50,ES27209566457215897586,TRX_N-00374-22207453,2022-07-18T09:43:48,Galdakao,Expense,food,-196.58,139333.98
buyer_4,Jorge,50,ES27209566457215897586,TRX_N-00375-19505470,2022-08-01T10:30:37,Galdakao,transfer,Salary,2656.62,141990.6
buyer_4,Jorge,50,ES27209566457215897586,TRX_N-00376-18514748,2022-08-01T10:30:37,Galdakao,transfer,Partner Salary,2885.84,144876.44
buyer_4,Jorge,50,ES27209566457215897586,TRX_N-00377-34924777,2022-08-02T19:51:21,Galdakao,Expense,healthcare,-244.76,144631.68
buyer_4,Jorge,50,ES27209566457215897586,TRX_N-00378-85491066,2022-08-04T06:32:15,Galdakao,Expense,food,-110.07,144521.61
buyer_4,Jorge,50,ES27209566457215897586,TRX_N-00379-10884467,2022-08-05T15:03:16,Galdakao,Housing,Mortgage,-444.74,144076.87
buyer_4,Jorge,50,ES27209566457215897586,TRX_N-00380-98478041,2022-08-05T23:11:27,Galdakao,Basic services,gas,-98.19,143978.68
buyer_4,Jorge,50,ES27209566457215897586,TRX_N-00381-96493727,2022-08-05T16:11:57,Galdakao,Basic services,internet,-56.25,143922.43
buyer_4,Jorge,50,ES27209566457215897586,TRX_N-00382-51390256,2022-08-05T14:30:36,Galdakao,Basic services,phone,-39.74,143882.69
buyer_4,Jorge,50,ES27209566457215897586,TRX_N-00383-84057339,2022-08-05T21:50:32,Galdakao,Expense,transport,-191.16,143691.53
buyer_4,Jorge,50,ES27209566457215897586,TRX_N-00384-05456282,2022-08-07T04:20:07,Galdakao,Basic services,electricity,-48.72,143642.81
buyer_4,Jorge,50,ES27209566457215897586,TRX_N-00385-52156210,2022-08-07T16:43:56,Galdakao,Basic services,phone,-67.28,143575.53
buyer_4,Jorge,50,ES27209566457215897586,TRX_N-00386-35598002,2022-08-07T19:18:00,Irun,Expense,food,-432.64,143142.89
buyer_4,Jorge,50,ES27209566457215897586,TRX_N-00387-78627105,2022-08-08T13:55:25,Galdakao,Expense,food,-572.44,142570.45
buyer_4,Jorge,50,ES27209566457215897586,TRX_N-00388-11078429,2022-09-01T14:58:13,Galdakao,transfer,Salary,2656.62,145227.07
buyer_4,Jorge,50,ES27209566457215897586,TRX_N-00389-88689793,2022-09-01T14:58:13,Galdakao,transfer,Partner Salary,2885.84,148112.91
buyer_4,Jorge,50,ES27209566457215897586,TRX_N-00390-49515668,2022-09-01T14:58:13,Galdakao,transfer,Extra Income,265.66,148378.57
buyer_4,Jorge,50,ES27209566457215897586,TRX_N-00391-02990917,2022-09-02T18:00:04,Galdakao,Expense,food,-607.51,147771.06
buyer_4,Jorge,50,ES27209566457215897586,TRX_N-00392-88304004,2022-09-05T10:35:17,Galdakao,Housing,Mortgage,-444.74,147326.32
buyer_4,Jorge,50,ES27209566457215897586,TRX_N-00393-96208383,2022-09-05T13:03:29,Galdakao,Basic services,water,-67.79,147258.53
buyer_4,Jorge,50,ES27209566457215897586,TRX_N-00394-20625854,2022-09-11T20:08:04,Galdakao,Expense,transport,-93.49,147165.04
buyer_4,Jorge,50,ES27209566457215897586,TRX_N-00395-65750061,2022-10-01T16:17:50,Galdakao,transfer,Salary,2656.62,149821.66
buyer_4,Jorge,50,ES27209566457215897586,TRX_N-00396-85627959,2022-10-01T16:17:50,Galdakao,transfer,Partner Salary,2885.84,152707.5
buyer_4,Jorge,50,ES27209566457215897586,TRX_N-00397-89943567,2022-10-05T17:57:04,Galdakao,Housing,Mortgage,-444.74,152262.76
buyer_4,Jorge,50,ES27209566457215897586,TRX_N-00398-77664822,2022-10-05T19:12:51,Galdakao,Basic services,electricity,-72.62,152190.14
buyer_4,Jorge,50,ES27209566457215897586,TRX_N-00399-74276043,2022-10-05T16:16:38,Galdakao,Basic services,internet,-72.4,152117.74
buyer_4,Jorge,50,ES27209566457215897586,TRX_N-00400-93690340,2022-10-06T06:27:29,Galdakao,Basic services,internet,-46.06,152071.68
buyer_4,Jorge,50,ES27209566457215897586,TRX_N-00401-81038873,2022-10-06T17:21:16,Galdakao,Basic services,phone,-98.25,151973.43
buyer_4,Jorge,50,ES27209566457215897586,TRX_N-00402-87653694,2022-10-07T10:58:14,Galdakao,Basic services,electricity,-73.53,151899.9
buyer_4,Jorge,50,ES27209566457215897586,TRX_N-00403-47041640,2022-10-21T15:01:13,Galdakao,Expense,leisure,-35.22,151864.68
buyer_4,Jorge,50,ES27209566457215897586,TRX_N-00404-69160497,2022-11-01T19:04:55,Galdakao,transfer,Salary,2656.62,154521.3
buyer_4,Jorge,50,ES27209566457215897586,TRX_N-00405-34668979,2022-11-01T19:04:55,Galdakao,transfer,Partner Salary,2885.84,157407.14
buyer_4,Jorge,50,ES27209566457215897586,TRX_N-00406-54501695,2022-11-02T16:11:52,Hondarribia,Expense,gifts,-66.83,157340.31
buyer_4,Jorge,50,ES27209566457215897586,TRX_N-00407-66470937,2022-11-05T16:21:15,Galdakao,Housing,Mortgage,-444.74,156895.57
buyer_4,Jorge,50,ES27209566457215897586,TRX_N-00408-01198852,2022-11-05T11:04:59,Galdakao,Basic services,electricity,-105.26,156790.31
buyer_4,Jorge,50,ES27209566457215897586,TRX_N-00409-46241491,2022-11-06T08:11:07,Galdakao,Basic services,water,-46.51,156743.8
buyer_4,Jorge,50,ES27209566457215897586,TRX_N-00410-96677133,2022-11-06T22:12:33,Galdakao,Basic services,electricity,-40.55,156703.25
buyer_4,Jorge,50,ES27209566457215897586,TRX_N-00411-65561605,2022-11-06T11:48:34,Galdakao,Basic services,gas,-42.95,156660.3
buyer_4,Jorge,50,ES27209566457215897586,TRX_N-00412-77488485,2022-11-06T08:46:31,Galdakao,Basic services,internet,-36.5,156623.8
buyer_4,Jorge,50,ES27209566457215897586,TRX_N-00413-58613566,2022-11-07T18:48:22,Galdakao,Basic services,water,-67.1,156556.7
buyer_4,Jorge,50,ES27209566457215897586,TRX_N-00414-54760173,2022-11-07T18:27:38,Galdakao,Basic services,electricity,-121.36,156435.34
buyer_4,Jorge,50,ES27209566457215897586,TRX_N-00415-15155767,2022-11-08T16:37:19,Lasarte-Oria,Expense,food,-175.88,156259.46
buyer_4,Jorge,50,ES27209566457215897586,TRX_N-00416-10976192,2022-11-08T10:51:47,Galdakao,Expense,healthcare,-139.53,156119.93
buyer_4,Jorge,50,ES27209566457215897586,TRX_N-00417-70704734,2022-11-20T16:17:14,Galdakao,Expense,food,-206.15,155913.78
buyer_4,Jorge,50,ES27209566457215897586,TRX_N-00418-18359607,2022-11-21T18:08:43,Galdakao,Expense,leisure,-234.67,155679.11
buyer_4,Jorge,50,ES27209566457215897586,TRX_N-00419-10839472,2022-11-30T11:52:37,Berango,Expense,leisure,-146.07,155533.04
buyer_4,Jorge,50,ES27209566457215897586,TRX_N-00420-50947159,2022-12-01T18:09:17,Galdakao,transfer,Salary,2656.62,158189.66
buyer_4,Jorge,50,ES27209566457215897586,TRX_N-00421-33437548,2022-12-01T18:09:17,Galdakao,transfer,Partner Salary,2885.84,161075.5
buyer_4,Jorge,50,ES27209566457215897586,TRX_N-00422-47767739,2022-12-01T18:09:17,Galdakao,transfer,Extra Income,265.66,161341.16
buyer_4,Jorge,50,ES27209566457215897586,TRX_N-00423-70459420,2022-12-01T18:09:17,Galdakao,transfer,Bonus,2423.4,163764.56
buyer_4,Jorge,50,ES27209566457215897586,TRX_N-00424-29559781,2022-12-05T16:50:01,Galdakao,Housing,Mortgage,-444.74,163319.82
buyer_4,Jorge,50,ES27209566457215897586,TRX_N-00425-27504008,2022-12-05T08:48:39,Galdakao,Basic services,water,-55.42,163264.4
buyer_4,Jorge,50,ES27209566457215897586,TRX_N-00426-81989632,2022-12-05T02:00:13,Galdakao,Basic services,internet,-57.16,163207.24
buyer_4,Jorge,50,ES27209566457215897586,TRX_N-00427-14000001,2022-12-05T23:07:21,Galdakao,Basic services,phone,-27.5,163179.74
buyer_4,Jorge,50,ES27209566457215897586,TRX_N-00428-05663929,2022-12-06T17:47:53,Galdakao,Basic services,internet,-43.04,163136.7
buyer_4,Jorge,50,ES27209566457215897586,TRX_N-00429-09917994,2022-12-07T09:27:27,Galdakao,Basic services,water,-62.34,163074.36
buyer_4,Jorge,50,ES27209566457215897586,TRX_N-00430-03789281,2022-12-07T18:56:59,Galdakao,Basic services,gas,-80.88,162993.48
buyer_4,Jorge,50,ES27209566457215897586,TRX_N-00431-22265949,2022-12-07T19:00:01,Galdakao,Basic services,internet,-48.71,162944.77
buyer_4,Jorge,50,ES27209566457215897586,TRX_N-00432-61040767,2022-12-16T13:44:43,Galdakao,Expense,transport,-85.87,162858.9
buyer_4,Jorge,50,ES27209566457215897586,TRX_N-00433-86190919,2022-12-17T12:39:08,Galdakao,Expense,transport,-35.2,162823.7
buyer_4,Jorge,50,ES27209566457215897586,TRX_N-00434-55164492,2023-01-01T20:47:53,Galdakao,transfer,Salary,2656.62,165480.32
buyer_4,Jorge,50,ES27209566457215897586,TRX_N-00435-57275214,2023-01-01T20:47:53,Galdakao,transfer,Partner Salary,2885.84,168366.16
buyer_4,Jorge,50,ES27209566457215897586,TRX_N-00436-93041705,2023-01-05T19:26:35,Galdakao,Housing,Mortgage,-444.74,167921.42
buyer_4,Jorge,50,ES27209566457215897586,TRX_N-00437-39567148,2023-01-05T15:44:05,Galdakao,Basic services,phone,-49.86,167871.56
buyer_4,Jorge,50,ES27209566457215897586,TRX_N-00438-05952641,2023-01-06T09:25:20,Galdakao,Basic services,electricity,-61.67,167809.89
buyer_4,Jorge,50,ES27209566457215897586,TRX_N-00439-41787046,2023-01-07T20:45:09,Galdakao,Basic services,electricity,-127.62,167682.27
buyer_4,Jorge,50,ES27209566457215897586,TRX_N-00440-58508741,2023-01-07T19:08:12,Galdakao,Basic services,phone,-96.5,167585.77
buyer_4,Jorge,50,ES27209566457215897586,TRX_N-00441-72109310,2023-01-20T12:47:13,Galdakao,Expense,transport,-175.39,167410.38
buyer_4,Jorge,50,ES27209566457215897586,TRX_N-00442-58432129,2023-01-25T15:14:24,Galdakao,Expense,leisure,-171.8,167238.58
buyer_4,Jorge,50,ES27209566457215897586,TRX_N-00443-55850304,2023-01-29T19:39:08,Sopela,Expense,leisure,-104.61,167133.97
buyer_4,Jorge,50,ES27209566457215897586,TRX_N-00444-46611721,2023-02-01T02:42:01,Galdakao,transfer,Salary,2656.62,169790.59
buyer_4,Jorge,50,ES27209566457215897586,TRX_N-00445-43216805,2023-02-01T02:42:01,Galdakao,transfer,Partner Salary,2885.84,172676.43
buyer_4,Jorge,50,ES27209566457215897586,TRX_N-00446-53953071,2023-02-01T02:42:01,Galdakao,transfer,Extra Income,265.66,172942.09
buyer_4,Jorge,50,ES27209566457215897586,TRX_N-00447-43799558,2023-02-04T20:40:14,Galdakao,Expense,repairs,-991.32,171950.77
buyer_4,Jorge,50,ES27209566457215897586,TRX_N-00448-11584241,2023-02-05T10:25:03,Galdakao,Housing,Mortgage,-444.74,171506.03
buyer_4,Jorge,50,ES27209566457215897586,TRX_N-00449-08596669,2023-02-05T22:47:30,Galdakao,Basic services,electricity,-88.4,171417.63
buyer_4,Jorge,50,ES27209566457215897586,TRX_N-00450-79671853,2023-02-05T11:58:04,Galdakao,Basic services,gas,-47.3,171370.33
buyer_4,Jorge,50,ES27209566457215897586,TRX_N-00451-56086901,2023-02-05T17:26:47,Galdakao,Basic services,internet,-58.21,171312.12
buyer_4,Jorge,50,ES27209566457215897586,TRX_N-00452-98063336,2023-02-06T23:12:00,Galdakao,Basic services,electricity,-149.01,171163.11
buyer_4,Jorge,50,ES27209566457215897586,TRX_N-00453-62497599,2023-02-06T13:54:01,Galdakao,Expense,food,-299.4,170863.71
buyer_4,Jorge,50,ES27209566457215897586,TRX_N-00454-05996920,2023-02-07T21:17:33,Galdakao,Basic services,water,-31.82,170831.89
buyer_4,Jorge,50,ES27209566457215897586,TRX_N-00455-87699500,2023-02-07T21:25:14,Galdakao,Basic services,phone,-33.5,170798.39
buyer_4,Jorge,50,ES27209566457215897586,TRX_N-00456-69332179,2023-02-17T10:24:04,Galdakao,Expense,repairs,-489.9,170308.49
buyer_4,Jorge,50,ES27209566457215897586,TRX_N-00457-89113964,2023-02-24T14:59:12,Llodio,Expense,food,-229.15,170079.34
buyer_4,Jorge,50,ES27209566457215897586,TRX_N-00458-95436505,2023-03-01T18:25:25,Galdakao,transfer,Salary,2656.62,172735.96
buyer_4,Jorge,50,ES27209566457215897586,TRX_N-00459-32017989,2023-03-01T18:25:25,Galdakao,transfer,Partner Salary,2885.84,175621.8
buyer_4,Jorge,50,ES27209566457215897586,TRX_N-00460-38696401,2023-03-05T14:06:39,Galdakao,Housing,Mortgage,-444.74,175177.06
buyer_4,Jorge,50,ES27209566457215897586,TRX_N-00461-20515754,2023-03-05T19:56:24,Galdakao,Basic services,phone,-81.22,175095.84
buyer_4,Jorge,50,ES27209566457215897586,TRX_N-00462-74547356,2023-03-06T20:50:30,Galdakao,Basic services,electricity,-21.83,175074.01
buyer_4,Jorge,50,ES27209566457215897586,TRX_N-00463-42930802,2023-03-16T18:28:48,Galdakao,Expense,transport,-180.36,174893.65
buyer_4,Jorge,50,ES27209566457215897586,TRX_N-00464-92567402,2023-03-25T20:18:29,Galdakao,Expense,healthcare,-88.82,174804.83
buyer_4,Jorge,50,ES27209566457215897586,TRX_N-00465-41482686,2023-04-01T15:45:29,Galdakao,transfer,Salary,2656.62,177461.45
buyer_4,Jorge,50,ES27209566457215897586,TRX_N-00466-30016932,2023-04-01T15:45:29,Galdakao,transfer,Partner Salary,2885.84,180347.29
buyer_4,Jorge,50,ES27209566457215897586,TRX_N-00467-37691755,2023-04-01T15:45:29,Galdakao,transfer,Extra Income,265.66,180612.95
buyer_4,Jorge,50,ES27209566457215897586,TRX_N-00468-81995062,2023-04-05T18:58:06,Galdakao,Housing,Mortgage,-444.74,180168.21
buyer_4,Jorge,50,ES27209566457215897586,TRX_N-00469-50841991,2023-04-05T19:44:11,Galdakao,Basic services,electricity,-81.32,180086.89
buyer_4,Jorge,50,ES27209566457215897586,TRX_N-00470-85828516,2023-04-05T11:33:08,Galdakao,Basic services,internet,-77.0,180009.89
buyer_4,Jorge,50,ES27209566457215897586,TRX_N-00471-78458865,2023-04-05T11:12:05,Galdakao,Basic services,phone,-84.9,179924.99
buyer_4,Jorge,50,ES27209566457215897586,TRX_N-00472-65688330,2023-04-07T11:08:39,Galdakao,Basic services,gas,-30.53,179894.46
buyer_4,Jorge,50,ES27209566457215897586,TRX_N-00473-15037850,2023-04-24T13:33:23,Galdakao,Expense,food,-130.91,179763.55
buyer_4,Jorge,50,ES27209566457215897586,TRX_N-00474-43238059,2023-05-01T11:04:52,Galdakao,transfer,Salary,2656.62,182420.17
buyer_4,Jorge,50,ES27209566457215897586,TRX_N-00475-53662946,2023-05-01T11:04:52,Galdakao,transfer,Partner Salary,2885.84,185306.01
buyer_4,Jorge,50,ES27209566457215897586,TRX_N-00476-73150625,2023-05-05T13:08:49,Galdakao,Housing,Mortgage,-444.74,184861.27
buyer_4,Jorge,50,ES27209566457215897586,TRX_N-00477-30739631,2023-05-05T16:40:00,Sopela,Expense,food,-461.03,184400.24
buyer_4,Jorge,50,ES27209566457215897586,TRX_N-00478-08391459,2023-05-06T19:56:47,Galdakao,Basic services,water,-17.1,184383.14
buyer_4,Jorge,50,ES27209566457215897586,TRX_N-00479-19042348,2023-05-06T13:10:15,Galdakao,Basic services,gas,-16.68,184366.46
buyer_4,Jorge,50,ES27209566457215897586,TRX_N-00480-38688142,2023-05-06T18:04:12,Galdakao,Expense,food,-752.9,183613.56
buyer_4,Jorge,50,ES27209566457215897586,TRX_N-00481-26513383,2023-05-07T10:06:32,Galdakao,Basic services,water,-39.72,183573.84
buyer_4,Jorge,50,ES27209566457215897586,TRX_N-00482-60702187,2023-05-07T12:59:35,Galdakao,Basic services,phone,-91.52,183482.32
buyer_4,Jorge,50,ES27209566457215897586,TRX_N-00483-16138259,2023-05-23T18:01:47,Amurrio,Expense,leisure,-255.44,183226.88
buyer_4,Jorge,50,ES27209566457215897586,TRX_N-00484-14312037,2023-05-24T11:49:18,Galdakao,Expense,transport,-175.91,183050.97
buyer_4,Jorge,50,ES27209566457215897586,TRX_N-00485-69229028,2023-06-01T19:47:41,Galdakao,transfer,Salary,2656.62,185707.59
buyer_4,Jorge,50,ES27209566457215897586,TRX_N-00486-01045142,2023-06-01T19:47:41,Galdakao,transfer,Partner Salary,2885.84,188593.43
buyer_4,Jorge,50,ES27209566457215897586,TRX_N-00487-63246006,2023-06-01T19:47:41,Galdakao,transfer,Bonus,2537.45,191130.88
buyer_4,Jorge,50,ES27209566457215897586,TRX_N-00488-16685782,2023-06-02T11:03:04,Galdakao,Expense,leisure,-48.36,191082.52
buyer_4,Jorge,50,ES27209566457215897586,TRX_N-00489-73727119,2023-06-05T08:20:26,Galdakao,Housing,Mortgage,-444.74,190637.78
buyer_4,Jorge,50,ES27209566457215897586,TRX_N-00490-85783377,2023-06-05T07:30:08,Galdakao,Basic services,gas,-52.96,190584.82
buyer_4,Jorge,50,ES27209566457215897586,TRX_N-00491-53555029,2023-06-06T22:07:59,Galdakao,Basic services,gas,-17.87,190566.95
buyer_4,Jorge,50,ES27209566457215897586,TRX_N-00492-42958781,2023-06-06T21:41:24,Galdakao,Basic services,internet,-76.72,190490.23
buyer_4,Jorge,50,ES27209566457215897586,TRX_N-00493-35627940,2023-06-06T11:59:51,Galdakao,Basic services,phone,-71.0,190419.23
buyer_4,Jorge,50,ES27209566457215897586,TRX_N-00494-38379102,2023-06-07T09:41:05,Galdakao,Basic services,internet,-34.26,190384.97
buyer_4,Jorge,50,ES27209566457215897586,TRX_N-00495-76822490,2023-06-08T15:02:04,Galdakao,Expense,gifts,-329.61,190055.36
buyer_4,Jorge,50,ES27209566457215897586,TRX_N-00496-13719405,2023-06-11T17:23:04,Galdakao,Expense,clothing,-364.15,189691.21
buyer_4,Jorge,50,ES27209566457215897586,TRX_N-00497-27073300,2023-06-14T10:15:37,Galdakao,Expense,repairs,-658.22,189032.99
buyer_4,Jorge,50,ES27209566457215897586,TRX_N-00498-13935390,2023-07-01T17:04:24,Galdakao,transfer,Salary,2656.62,191689.61
buyer_4,Jorge,50,ES27209566457215897586,TRX_N-00499-58396926,2023-07-01T17:04:24,Galdakao,transfer,Partner Salary,2885.84,194575.45
buyer_4,Jorge,50,ES27209566457215897586,TRX_N-00500-28715077,2023-07-01T17:04:24,Galdakao,transfer,Extra Income,265.66,194841.11
buyer_4,Jorge,50,ES27209566457215897586,TRX_N-00501-40301262,2023-07-01T00:53:47,Galdakao,Expense,leisure,-123.6,194717.51
buyer_4,Jorge,50,ES27209566457215897586,TRX_N-00502-63386664,2023-07-05T06:27:54,Galdakao,Housing,Mortgage,-444.74,194272.77
buyer_4,Jorge,50,ES27209566457215897586,TRX_N-00503-79410368,2023-07-05T12:06:38,Galdakao,Basic services,electricity,-70.01,194202.76
buyer_4,Jorge,50,ES27209566457215897586,TRX_N-00504-37104875,2023-07-05T19:36:25,Galdakao,Basic services,phone,-34.66,194168.1
buyer_4,Jorge,50,ES27209566457215897586,TRX_N-00505-06909298,2023-07-06T20:19:25,Galdakao,Basic services,phone,-45.43,194122.67
buyer_4,Jorge,50,ES27209566457215897586,TRX_N-00506-28642383,2023-07-07T09:29:33,Galdakao,Basic services,water,-39.66,194083.01
buyer_4,Jorge,50,ES27209566457215897586,TRX_N-00507-53936247,2023-07-07T16:51:17,Galdakao,Basic services,gas,-41.2,194041.81
buyer_4,Jorge,50,ES27209566457215897586,TRX_N-00508-52959476,2023-07-12T16:29:46,Galdakao,Expense,transport,-55.85,193985.96
buyer_4,Jorge,50,ES27209566457215897586,TRX_N-00509-93470235,2023-07-18T13:16:55,Galdakao,Expense,clothing,-434.56,193551.4
buyer_4,Jorge,50,ES27209566457215897586,TRX_N-00510-48046351,2023-07-24T09:07:07,Galdakao,Expense,gifts,-431.46,193119.94
buyer_4,Jorge,50,ES27209566457215897586,TRX_N-00511-30498451,2023-07-25T09:59:39,Galdakao,Expense,clothing,-402.82,192717.12
buyer_4,Jorge,50,ES27209566457215897586,TRX_N-00512-17874527,2023-08-01T13:53:22,Galdakao,transfer,Salary,2656.62,195373.74
buyer_4,Jorge,50,ES27209566457215897586,TRX_N-00513-97127658,2023-08-01T13:53:22,Galdakao,transfer,Partner Salary,2885.84,198259.58
buyer_4,Jorge,50,ES27209566457215897586,TRX_N-00514-12069200,2023-08-03T21:42:42,Galdakao,Expense,gifts,-299.59,197959.99
buyer_4,Jorge,50,ES27209566457215897586,TRX_N-00515-35202090,2023-08-05T20:26:32,Galdakao,Housing,Mortgage,-444.74,197515.25
buyer_4,Jorge,50,ES27209566457215897586,TRX_N-00516-61813441,2023-08-06T14:33:17,Galdakao,Basic services,electricity,-89.83,197425.42
buyer_4,Jorge,50,ES27209566457215897586,TRX_N-00517-30225627,2023-08-06T10:29:35,Galdakao,Basic services,gas,-49.84,197375.58
buyer_4,Jorge,50,ES27209566457215897586,TRX_N-00518-47943853,2023-08-07T11:57:33,Galdakao,Basic services,electricity,-55.66,197319.92
buyer_4,Jorge,50,ES27209566457215897586,TRX_N-00519-31079247,2023-08-07T06:32:43,Galdakao,Basic services,gas,-90.79,197229.13
buyer_4,Jorge,50,ES27209566457215897586,TRX_N-00520-00116343,2023-08-07T14:58:30,Galdakao,Expense,leisure,-103.2,197125.93
buyer_4,Jorge,50,ES27209566457215897586,TRX_N-00521-78800163,2023-09-01T10:23:31,Galdakao,transfer,Salary,2656.62,199782.55
buyer_4,Jorge,50,ES27209566457215897586,TRX_N-00522-31818309,2023-09-01T10:23:31,Galdakao,transfer,Partner Salary,2885.84,202668.39
buyer_4,Jorge,50,ES27209566457215897586,TRX_N-00523-71608340,2023-09-01T18:10:27,Galdakao,Expense,food,-535.72,202132.67
buyer_4,Jorge,50,ES27209566457215897586,TRX_N-00524-00922105,2023-09-05T14:10:17,Galdakao,Housing,Mortgage,-444.74,201687.93
buyer_4,Jorge,50,ES27209566457215897586,TRX_N-00525-86824544,2023-09-05T17:00:41,Galdakao,Basic services,water,-58.33,201629.6
buyer_4,Jorge,50,ES27209566457215897586,TRX_N-00526-52148272,2023-09-05T16:14:07,Galdakao,Basic services,internet,-41.82,201587.78
buyer_4,Jorge,50,ES27209566457215897586,TRX_N-00527-31353834,2023-09-07T20:50:10,Galdakao,Basic services,electricity,-112.8,201474.98
buyer_4,Jorge,50,ES27209566457215897586,TRX_N-00528-39559470,2023-09-07T22:48:24,Galdakao,Expense,gifts,-251.09,201223.89
buyer_4,Jorge,50,ES27209566457215897586,TRX_N-00529-00712738,2023-09-10T16:14:57,Galdakao,Expense,food,-193.47,201030.42
buyer_4,Jorge,50,ES27209566457215897586,TRX_N-00530-94256189,2023-09-11T17:48:28,Galdakao,Expense,transport,-82.82,200947.6
buyer_4,Jorge,50,ES27209566457215897586,TRX_N-00531-49443012,2023-09-15T17:06:29,Galdakao,Expense,transport,-168.02,200779.58
buyer_4,Jorge,50,ES27209566457215897586,TRX_N-00532-41097816,2023-09-27T08:59:23,Galdakao,Expense,clothing,-68.49,200711.09
buyer_4,Jorge,50,ES27209566457215897586,TRX_N-00533-25528449,2023-10-01T09:37:29,Galdakao,transfer,Salary,2656.62,203367.71
buyer_4,Jorge,50,ES27209566457215897586,TRX_N-00534-87029691,2023-10-01T09:37:29,Galdakao,transfer,Partner Salary,2885.84,206253.55
buyer_4,Jorge,50,ES27209566457215897586,TRX_N-00535-37641999,2023-10-01T09:37:29,Galdakao,transfer,Extra Income,265.66,206519.21
buyer_4,Jorge,50,ES27209566457215897586,TRX_N-00536-62482747,2023-10-05T19:26:08,Galdakao,Housing,Mortgage,-444.74,206074.47
buyer_4,Jorge,50,ES27209566457215897586,TRX_N-00537-79119270,2023-10-06T11:12:57,Lasarte-Oria,Expense,transport,-77.15,205997.32
buyer_4,Jorge,50,ES27209566457215897586,TRX_N-00538-71674277,2023-10-07T19:39:02,Galdakao,Basic services,water,-54.64,205942.68
buyer_4,Jorge,50,ES27209566457215897586,TRX_N-00539-22138497,2023-10-07T19:12:59,Galdakao,Basic services,electricity,-85.63,205857.05
buyer_4,Jorge,50,ES27209566457215897586,TRX_N-00540-49724291,2023-10-07T17:14:06,Galdakao,Basic services,phone,-91.38,205765.67
buyer_4,Jorge,50,ES27209566457215897586,TRX_N-00541-97888039,2023-10-20T14:46:46,Galdakao,Expense,food,-371.85,205393.82
buyer_4,Jorge,50,ES27209566457215897586,TRX_N-00542-90847224,2023-10-26T17:55:08,Galdakao,Expense,transport,-177.29,205216.53
buyer_4,Jorge,50,ES27209566457215897586,TRX_N-00543-59111586,2023-10-26T19:25:20,Galdakao,Expense,repairs,-111.21,205105.32
buyer_4,Jorge,50,ES27209566457215897586,TRX_N-00544-05039705,2023-10-28T16:27:33,Galdakao,Expense,transport,-75.57,205029.75
buyer_4,Jorge,50,ES27209566457215897586,TRX_N-00545-26621236,2023-11-01T16:09:03,Galdakao,transfer,Salary,2656.62,207686.37
buyer_4,Jorge,50,ES27209566457215897586,TRX_N-00546-41150193,2023-11-01T16:09:03,Galdakao,transfer,Partner Salary,2885.84,210572.21
buyer_4,Jorge,50,ES27209566457215897586,TRX_N-00547-33802593,2023-11-05T20:57:23,Galdakao,Housing,Mortgage,-444.74,210127.47
buyer_4,Jorge,50,ES27209566457215897586,TRX_N-00548-06506659,2023-11-05T09:29:13,Galdakao,Basic services,water,-65.23,210062.24
buyer_4,Jorge,50,ES27209566457215897586,TRX_N-00549-38166201,2023-11-05T01:27:30,Galdakao,Basic services,electricity,-133.99,209928.25
buyer_4,Jorge,50,ES27209566457215897586,TRX_N-00550-68152080,2023-11-05T19:55:43,Galdakao,Basic services,gas,-59.43,209868.82
buyer_4,Jorge,50,ES27209566457215897586,TRX_N-00551-03728802,2023-11-05T20:37:39,Galdakao,Basic services,phone,-84.19,209784.63
buyer_4,Jorge,50,ES27209566457215897586,TRX_N-00552-91058096,2023-11-06T11:52:46,Galdakao,Basic services,electricity,-121.92,209662.71
buyer_4,Jorge,50,ES27209566457215897586,TRX_N-00553-56972604,2023-11-06T15:30:30,Galdakao,Basic services,phone,-34.33,209628.38
buyer_4,Jorge,50,ES27209566457215897586,TRX_N-00554-20333386,2023-11-07T17:24:31,Galdakao,Basic services,electricity,-49.61,209578.77
buyer_4,Jorge,50,ES27209566457215897586,TRX_N-00555-67724289,2023-12-01T10:03:24,Galdakao,transfer,Salary,2656.62,212235.39
buyer_4,Jorge,50,ES27209566457215897586,TRX_N-00556-69311609,2023-12-01T10:03:24,Galdakao,transfer,Partner Salary,2885.84,215121.23
buyer_4,Jorge,50,ES27209566457215897586,TRX_N-00557-65102193,2023-12-01T10:03:24,Galdakao,transfer,Extra Income,265.66,215386.89
buyer_4,Jorge,50,ES27209566457215897586,TRX_N-00558-82049066,2023-12-01T10:03:24,Galdakao,transfer,Bonus,2400.33,217787.22
buyer_4,Jorge,50,ES27209566457215897586,TRX_N-00559-21409575,2023-12-05T15:58:35,Galdakao,Housing,Mortgage,-444.74,217342.48
buyer_4,Jorge,50,ES27209566457215897586,TRX_N-00560-60833634,2023-12-05T20:34:22,Galdakao,Basic services,electricity,-72.86,217269.62
buyer_4,Jorge,50,ES27209566457215897586,TRX_N-00561-56323400,2023-12-05T14:03:34,Galdakao,Basic services,internet,-34.56,217235.06
buyer_4,Jorge,50,ES27209566457215897586,TRX_N-00562-55685734,2023-12-06T09:29:21,Galdakao,Basic services,water,-57.87,217177.19
buyer_4,Jorge,50,ES27209566457215897586,TRX_N-00563-85209140,2023-12-07T18:49:33,Galdakao,Basic services,electricity,-69.78,217107.41
buyer_4,Jorge,50,ES27209566457215897586,TRX_N-00564-04333786,2023-12-07T19:14:26,Galdakao,Basic services,gas,-53.16,217054.25
buyer_4,Jorge,50,ES27209566457215897586,TRX_N-00565-92683320,2023-12-07T15:55:28,Galdakao,Basic services,phone,-83.68,216970.57
buyer_4,Jorge,50,ES27209566457215897586,TRX_N-00566-55144114,2023-12-26T08:12:21,Galdakao,Expense,food,-624.98,216345.59
buyer_4,Jorge,50,ES27209566457215897586,TRX_N-00567-58358990,2023-12-30T19:00:38,Galdakao,Expense,clothing,-107.6,216237.99
buyer_4,Jorge,50,ES27209566457215897586,TRX_N-00568-63976284,2024-01-01T16:30:48,Galdakao,transfer,Salary,2656.62,218894.61
buyer_4,Jorge,50,ES27209566457215897586,TRX_N-00569-17326225,2024-01-01T16:30:48,Galdakao,transfer,Partner Salary,2885.84,221780.45
buyer_4,Jorge,50,ES27209566457215897586,TRX_N-00570-30840673,2024-01-05T18:45:08,Galdakao,Housing,Mortgage,-444.74,221335.71
buyer_4,Jorge,50,ES27209566457215897586,TRX_N-00571-71680040,2024-01-05T17:07:16,Galdakao,Basic services,water,-57.27,221278.44
buyer_4,Jorge,50,ES27209566457215897586,TRX_N-00572-49389487,2024-01-05T17:51:08,Galdakao,Basic services,phone,-72.75,221205.69
buyer_4,Jorge,50,ES27209566457215897586,TRX_N-00573-56352635,2024-01-06T23:19:08,Galdakao,Basic services,gas,-21.28,221184.41
buyer_4,Jorge,50,ES27209566457215897586,TRX_N-00574-21070665,2024-01-07T15:00:32,Galdakao,Basic services,electricity,-49.83,221134.58
buyer_4,Jorge,50,ES27209566457215897586,TRX_N-00575-54696883,2024-01-07T11:18:12,Galdakao,Basic services,internet,-45.18,221089.4
buyer_4,Jorge,50,ES27209566457215897586,TRX_N-00576-12667154,2024-01-07T18:26:48,Galdakao,Basic services,phone,-31.82,221057.58
buyer_4,Jorge,50,ES27209566457215897586,TRX_N-00577-84742207,2024-01-09T05:42:10,Galdakao,Expense,leisure,-150.23,220907.35
buyer_4,Jorge,50,ES27209566457215897586,TRX_N-00578-10363503,2024-01-29T07:33:10,Galdakao,Expense,food,-488.94,220418.41
buyer_4,Jorge,50,ES27209566457215897586,TRX_N-00579-56307995,2024-01-29T11:57:41,Galdakao,Expense,healthcare,-111.6,220306.81
buyer_4,Jorge,50,ES27209566457215897586,TRX_N-00580-25758537,2024-02-01T11:43:07,Galdakao,transfer,Salary,2656.62,222963.43
buyer_4,Jorge,50,ES27209566457215897586,TRX_N-00581-81797479,2024-02-01T11:43:07,Galdakao,transfer,Partner Salary,2885.84,225849.27
buyer_4,Jorge,50,ES27209566457215897586,TRX_N-00582-47865521,2024-02-01T11:43:07,Galdakao,transfer,Extra Income,265.66,226114.93
buyer_4,Jorge,50,ES27209566457215897586,TRX_N-00583-24976975,2024-02-05T20:53:15,Galdakao,Housing,Mortgage,-444.74,225670.19
buyer_4,Jorge,50,ES27209566457215897586,TRX_N-00584-00316537,2024-02-06T11:49:34,Galdakao,Basic services,water,-78.7,225591.49
buyer_4,Jorge,50,ES27209566457215897586,TRX_N-00585-88143980,2024-02-06T04:55:17,Galdakao,Basic services,electricity,-140.72,225450.77
buyer_4,Jorge,50,ES27209566457215897586,TRX_N-00586-17946194,2024-02-06T23:31:14,Galdakao,Basic services,phone,-38.37,225412.4
buyer_4,Jorge,50,ES27209566457215897586,TRX_N-00587-34793992,2024-02-07T15:55:00,Galdakao,Basic services,water,-47.27,225365.13
buyer_4,Jorge,50,ES27209566457215897586,TRX_N-00588-57570018,2024-02-07T20:27:16,Galdakao,Basic services,gas,-73.2,225291.93
buyer_4,Jorge,50,ES27209566457215897586,TRX_N-00589-43359551,2024-02-12T22:42:25,Pasaia,Expense,education,-308.97,224982.96
buyer_4,Jorge,50,ES27209566457215897586,TRX_N-00590-38802164,2024-02-28T11:22:31,Galdakao,Expense,leisure,-36.72,224946.24
buyer_4,Jorge,50,ES27209566457215897586,TRX_N-00591-75605262,2024-03-01T16:38:18,Galdakao,transfer,Salary,2656.62,227602.86
buyer_4,Jorge,50,ES27209566457215897586,TRX_N-00592-20423174,2024-03-01T16:38:18,Galdakao,transfer,Partner Salary,2885.84,230488.7
buyer_4,Jorge,50,ES27209566457215897586,TRX_N-00593-61396743,2024-03-05T22:18:38,Galdakao,Housing,Mortgage,-444.74,230043.96
buyer_4,Jorge,50,ES27209566457215897586,TRX_N-00594-51863746,2024-03-05T13:46:42,Galdakao,Basic services,water,-79.78,229964.18
buyer_4,Jorge,50,ES27209566457215897586,TRX_N-00595-28093010,2024-03-05T11:56:58,Galdakao,Basic services,electricity,-39.07,229925.11
buyer_4,Jorge,50,ES27209566457215897586,TRX_N-00596-99938492,2024-03-05T13:43:14,Galdakao,Basic services,internet,-70.35,229854.76
buyer_4,Jorge,50,ES27209566457215897586,TRX_N-00597-49589468,2024-03-06T02:55:46,Galdakao,Basic services,gas,-24.32,229830.44
buyer_4,Jorge,50,ES27209566457215897586,TRX_N-00598-95406353,2024-03-06T08:30:17,Galdakao,Basic services,internet,-74.47,229755.97
buyer_4,Jorge,50,ES27209566457215897586,TRX_N-00599-59595739,2024-03-07T17:58:13,Galdakao,Basic services,water,-23.08,229732.89
buyer_4,Jorge,50,ES27209566457215897586,TRX_N-00600-28322913,2024-04-01T09:12:08,Galdakao,transfer,Salary,2656.62,232389.51
buyer_4,Jorge,50,ES27209566457215897586,TRX_N-00601-27856057,2024-04-01T09:12:08,Galdakao,transfer,Partner Salary,2885.84,235275.35
buyer_4,Jorge,50,ES27209566457215897586,TRX_N-00602-39351668,2024-04-01T09:12:08,Galdakao,transfer,Extra Income,265.66,235541.01
buyer_4,Jorge,50,ES27209566457215897586,TRX_N-00603-16088431,2024-04-01T15:14:03,Galdakao,Expense,gifts,-149.22,235391.79
buyer_4,Jorge,50,ES27209566457215897586,TRX_N-00604-73841236,2024-04-05T00:00:30,Galdakao,Housing,Mortgage,-444.74,234947.05
buyer_4,Jorge,50,ES27209566457215897586,TRX_N-00605-03233184,2024-04-05T08:10:03,Galdakao,Basic services,gas,-48.88,234898.17
buyer_4,Jorge,50,ES27209566457215897586,TRX_N-00606-73747725,2024-04-06T13:58:07,Galdakao,Basic services,water,-38.01,234860.16
buyer_4,Jorge,50,ES27209566457215897586,TRX_N-00607-83816599,2024-04-06T09:51:39,Galdakao,Basic services,electricity,-54.46,234805.7
buyer_4,Jorge,50,ES27209566457215897586,TRX_N-00608-43082144,2024-04-07T13:15:39,Galdakao,Expense,travel,-1051.15,233754.55
buyer_4,Jorge,50,ES27209566457215897586,TRX_N-00609-50781859,2024-04-09T15:57:20,Galdakao,Expense,healthcare,-374.22,233380.33
buyer_4,Jorge,50,ES27209566457215897586,TRX_N-00610-89036964,2024-04-27T15:58:11,Galdakao,Expense,food,-562.71,232817.62
buyer_4,Jorge,50,ES27209566457215897586,TRX_N-00611-52737984,2024-04-29T20:07:05,Galdakao,Expense,transport,-24.21,232793.41
buyer_4,Jorge,50,ES27209566457215897586,TRX_N-00612-38488133,2024-05-01T09:10:48,Galdakao,transfer,Salary,2656.62,235450.03
buyer_4,Jorge,50,ES27209566457215897586,TRX_N-00613-00607116,2024-05-01T09:10:48,Galdakao,transfer,Partner Salary,2885.84,238335.87
buyer_4,Jorge,50,ES27209566457215897586,TRX_N-00614-17911503,2024-05-05T14:02:34,Galdakao,Housing,Mortgage,-444.74,237891.13
buyer_4,Jorge,50,ES27209566457215897586,TRX_N-00615-74357156,2024-05-05T13:36:17,Galdakao,Basic services,water,-33.57,237857.56
buyer_4,Jorge,50,ES27209566457215897586,TRX_N-00616-19063300,2024-05-05T15:00:49,Galdakao,Basic services,gas,-92.16,237765.4
buyer_4,Jorge,50,ES27209566457215897586,TRX_N-00617-65947483,2024-05-06T23:27:03,Galdakao,Basic services,gas,-48.87,237716.53
buyer_4,Jorge,50,ES27209566457215897586,TRX_N-00618-56394109,2024-05-06T16:17:06,Galdakao,Basic services,internet,-61.54,237654.99
buyer_4,Jorge,50,ES27209566457215897586,TRX_N-00619-66301463,2024-05-07T23:17:42,Galdakao,Basic services,water,-66.11,237588.88
buyer_4,Jorge,50,ES27209566457215897586,TRX_N-00620-75825606,2024-05-07T08:01:59,Galdakao,Basic services,electricity,-91.28,237497.6
buyer_4,Jorge,50,ES27209566457215897586,TRX_N-00621-69633975,2024-05-07T22:03:49,Galdakao,Basic services,phone,-78.08,237419.52
buyer_4,Jorge,50,ES27209566457215897586,TRX_N-00622-45358143,2024-05-11T10:43:11,Galdakao,Expense,travel,-1373.18,236046.34
buyer_4,Jorge,50,ES27209566457215897586,TRX_N-00623-71883216,2024-05-12T22:38:27,Galdakao,Expense,transport,-179.13,235867.21
buyer_4,Jorge,50,ES27209566457215897586,TRX_N-00624-84888487,2024-06-01T21:50:38,Galdakao,transfer,Salary,2656.62,238523.83
buyer_4,Jorge,50,ES27209566457215897586,TRX_N-00625-88870669,2024-06-01T21:50:38,Galdakao,transfer,Partner Salary,2885.84,241409.67
buyer_4,Jorge,50,ES27209566457215897586,TRX_N-00626-19580353,2024-06-01T21:50:38,Galdakao,transfer,Bonus,2827.06,244236.73
buyer_4,Jorge,50,ES27209566457215897586,TRX_N-00627-94530056,2024-06-05T15:11:10,Galdakao,Housing,Mortgage,-444.74,243791.99
buyer_4,Jorge,50,ES27209566457215897586,TRX_N-00628-91806954,2024-06-05T11:08:30,Galdakao,Basic services,gas,-35.6,243756.39
buyer_4,Jorge,50,ES27209566457215897586,TRX_N-00629-24834125,2024-06-05T20:07:24,Galdakao,Basic services,internet,-42.06,243714.33
buyer_4,Jorge,50,ES27209566457215897586,TRX_N-00630-08574528,2024-06-06T12:04:14,Galdakao,Basic services,electricity,-23.76,243690.57
buyer_4,Jorge,50,ES27209566457215897586,TRX_N-00631-62547348,2024-06-06T11:25:56,Galdakao,Basic services,gas,-35.44,243655.13
buyer_4,Jorge,50,ES27209566457215897586,TRX_N-00632-36992392,2024-06-07T19:39:55,Galdakao,Basic services,electricity,-104.25,243550.88
buyer_4,Jorge,50,ES27209566457215897586,TRX_N-00633-01773631,2024-06-09T17:50:20,Galdakao,Expense,clothing,-36.04,243514.84
buyer_4,Jorge,50,ES27209566457215897586,TRX_N-00634-31368595,2024-06-10T15:49:29,Galdakao,Expense,food,-391.87,243122.97
buyer_4,Jorge,50,ES27209566457215897586,TRX_N-00635-28251868,2024-06-15T16:56:43,Galdakao,Expense,transport,-133.28,242989.69
buyer_4,Jorge,50,ES27209566457215897586,TRX_N-00636-12778119,2024-06-19T10:18:11,Galdakao,Expense,transport,-199.72,242789.97
buyer_4,Jorge,50,ES27209566457215897586,TRX_N-00637-13122107,2024-06-28T13:54:18,Galdakao,Expense,food,-149.13,242640.84
buyer_4,Jorge,50,ES27209566457215897586,TRX_N-00638-69700835,2024-07-01T00:00:53,Galdakao,transfer,Salary,2656.62,245297.46
buyer_4,Jorge,50,ES27209566457215897586,TRX_N-00639-89151286,2024-07-01T00:00:53,Galdakao,transfer,Partner Salary,2885.84,248183.3
buyer_4,Jorge,50,ES27209566457215897586,TRX_N-00640-87771906,2024-07-01T00:00:53,Galdakao,transfer,Extra Income,265.66,248448.96
buyer_4,Jorge,50,ES27209566457215897586,TRX_N-00641-86934055,2024-07-04T18:29:53,Bilbao,Expense,food,-340.14,248108.82
buyer_4,Jorge,50,ES27209566457215897586,TRX_N-00642-86517811,2024-07-04T17:32:24,Galdakao,Expense,education,-828.17,247280.65
buyer_4,Jorge,50,ES27209566457215897586,TRX_N-00643-18067526,2024-07-05T10:51:03,Galdakao,Housing,Mortgage,-444.74,246835.91
buyer_4,Jorge,50,ES27209566457215897586,TRX_N-00644-96688727,2024-07-05T14:37:29,Galdakao,Basic services,water,-29.93,246805.98
buyer_4,Jorge,50,ES27209566457215897586,TRX_N-00645-19941222,2024-07-05T20:46:08,Galdakao,Basic services,electricity,-138.73,246667.25
buyer_4,Jorge,50,ES27209566457215897586,TRX_N-00646-78410684,2024-07-05T18:37:02,Galdakao,Basic services,internet,-38.91,246628.34
buyer_4,Jorge,50,ES27209566457215897586,TRX_N-00647-55578760,2024-07-06T20:33:13,Galdakao,Basic services,water,-62.28,246566.06
buyer_4,Jorge,50,ES27209566457215897586,TRX_N-00648-66381870,2024-07-06T19:42:09,Galdakao,Basic services,internet,-76.02,246490.04
buyer_4,Jorge,50,ES27209566457215897586,TRX_N-00649-71853130,2024-07-07T06:35:56,Galdakao,Basic services,gas,-37.5,246452.54
buyer_4,Jorge,50,ES27209566457215897586,TRX_N-00650-43686780,2024-07-07T23:24:21,Galdakao,Basic services,phone,-75.96,246376.58
buyer_4,Jorge,50,ES27209566457215897586,TRX_N-00651-19444211,2024-07-09T10:10:39,Galdakao,Expense,healthcare,-60.28,246316.3
buyer_4,Jorge,50,ES27209566457215897586,TRX_N-00652-50510253,2024-07-12T16:43:25,Donostia,Expense,transport,-39.68,246276.62
buyer_4,Jorge,50,ES27209566457215897586,TRX_N-00653-52056384,2024-07-26T12:52:06,Galdakao,Expense,food,-445.44,245831.18
buyer_4,Jorge,50,ES27209566457215897586,TRX_N-00654-51543243,2024-07-29T18:18:30,Galdakao,Expense,appliances,-323.02,245508.16
buyer_4,Jorge,50,ES27209566457215897586,TRX_N-00655-20263744,2024-08-01T17:15:29,Galdakao,transfer,Salary,2656.62,248164.78
buyer_4,Jorge,50,ES27209566457215897586,TRX_N-00656-94215649,2024-08-01T17:15:29,Galdakao,transfer,Partner Salary,2885.84,251050.62
buyer_4,Jorge,50,ES27209566457215897586,TRX_N-00657-61639255,2024-08-05T12:41:51,Galdakao,Housing,Mortgage,-444.74,250605.88
buyer_4,Jorge,50,ES27209566457215897586,TRX_N-00658-03343208,2024-08-06T13:09:50,Galdakao,Basic services,water,-77.69,250528.19
buyer_4,Jorge,50,ES27209566457215897586,TRX_N-00659-05455372,2024-08-06T13:25:01,Galdakao,Basic services,electricity,-128.45,250399.74
buyer_4,Jorge,50,ES27209566457215897586,TRX_N-00660-50450017,2024-08-06T10:42:20,Galdakao,Basic services,internet,-79.54,250320.2
buyer_4,Jorge,50,ES27209566457215897586,TRX_N-00661-79349137,2024-08-06T09:37:36,Galdakao,Basic services,phone,-77.54,250242.66
buyer_4,Jorge,50,ES27209566457215897586,TRX_N-00662-28629261,2024-08-07T10:24:58,Galdakao,Basic services,gas,-41.86,250200.8
buyer_4,Jorge,50,ES27209566457215897586,TRX_N-00663-48164176,2024-08-07T19:06:46,Galdakao,Basic services,phone,-63.02,250137.78
buyer_4,Jorge,50,ES27209566457215897586,TRX_N-00664-90872082,2024-08-11T15:11:58,Galdakao,Expense,transport,-62.77,250075.01
buyer_4,Jorge,50,ES27209566457215897586,TRX_N-00665-18789780,2024-08-12T15:54:13,Galdakao,Expense,clothing,-408.85,249666.16
buyer_4,Jorge,50,ES27209566457215897586,TRX_N-00666-44439837,2024-08-18T17:07:23,Galdakao,Expense,food,-363.34,249302.82
buyer_4,Jorge,50,ES27209566457215897586,TRX_N-00667-07491394,2024-08-20T13:46:44,Galdakao,Expense,leisure,-249.6,249053.22
buyer_4,Jorge,50,ES27209566457215897586,TRX_N-00668-19205637,2024-08-30T10:33:02,Galdakao,Expense,leisure,-59.97,248993.25
buyer_4,Jorge,50,ES27209566457215897586,TRX_N-00669-08919077,2024-09-01T20:29:22,Galdakao,transfer,Salary,2656.62,251649.87
buyer_4,Jorge,50,ES27209566457215897586,TRX_N-00670-04649058,2024-09-01T20:29:22,Galdakao,transfer,Partner Salary,2885.84,254535.71
buyer_4,Jorge,50,ES27209566457215897586,TRX_N-00671-50468454,2024-09-01T20:29:22,Galdakao,transfer,Extra Income,265.66,254801.37
buyer_4,Jorge,50,ES27209566457215897586,TRX_N-00672-21491188,2024-09-03T15:03:05,Galdakao,Expense,transport,-188.61,254612.76
buyer_4,Jorge,50,ES27209566457215897586,TRX_N-00673-36876789,2024-09-05T12:44:37,Galdakao,Housing,Mortgage,-444.74,254168.02
buyer_4,Jorge,50,ES27209566457215897586,TRX_N-00674-73279342,2024-09-06T11:58:05,Galdakao,Basic services,water,-75.3,254092.72
buyer_4,Jorge,50,ES27209566457215897586,TRX_N-00675-76899283,2024-09-06T01:58:13,Galdakao,Basic services,phone,-38.47,254054.25
buyer_4,Jorge,50,ES27209566457215897586,TRX_N-00676-20655656,2024-09-06T22:29:50,Galdakao,Expense,food,-781.88,253272.37
buyer_4,Jorge,50,ES27209566457215897586,TRX_N-00677-94419310,2024-09-07T16:12:14,Galdakao,Basic services,gas,-19.84,253252.53
buyer_4,Jorge,50,ES27209566457215897586,TRX_N-00678-33554911,2024-09-07T23:15:45,Galdakao,Basic services,internet,-58.45,253194.08
buyer_4,Jorge,50,ES27209566457215897586,TRX_N-00679-22307953,2024-09-09T13:13:44,Portugalete,Expense,leisure,-31.01,253163.07
buyer_4,Jorge,50,ES27209566457215897586,TRX_N-00680-06498622,2024-10-01T16:24:45,Galdakao,transfer,Salary,2656.62,255819.69
buyer_4,Jorge,50,ES27209566457215897586,TRX_N-00681-31952119,2024-10-01T16:24:45,Galdakao,transfer,Partner Salary,2885.84,258705.53
buyer_4,Jorge,50,ES27209566457215897586,TRX_N-00682-14689416,2024-10-03T09:36:19,Galdakao,Expense,healthcare,-217.42,258488.11
buyer_4,Jorge,50,ES27209566457215897586,TRX_N-00683-88853991,2024-10-04T09:58:47,Galdakao,Expense,food,-110.68,258377.43
buyer_4,Jorge,50,ES27209566457215897586,TRX_N-00684-77800327,2024-10-05T13:08:39,Galdakao,Housing,Mortgage,-444.74,257932.69
buyer_4,Jorge,50,ES27209566457215897586,TRX_N-00685-83645621,2024-10-05T10:53:18,Galdakao,Basic services,gas,-48.0,257884.69
buyer_4,Jorge,50,ES27209566457215897586,TRX_N-00686-77742864,2024-10-05T16:42:38,Galdakao,Basic services,internet,-55.87,257828.82
buyer_4,Jorge,50,ES27209566457215897586,TRX_N-00687-11167206,2024-10-06T03:16:56,Galdakao,Basic services,water,-28.72,257800.1
buyer_4,Jorge,50,ES27209566457215897586,TRX_N-00688-32930908,2024-10-06T17:20:23,Galdakao,Basic services,electricity,-22.52,257777.58
buyer_4,Jorge,50,ES27209566457215897586,TRX_N-00689-01313618,2024-10-06T20:18:19,Galdakao,Basic services,internet,-52.25,257725.33
buyer_4,Jorge,50,ES27209566457215897586,TRX_N-00690-34947159,2024-10-07T15:59:20,Galdakao,Basic services,water,-37.64,257687.69
buyer_5,Sara,30,ES84209531498650565944,TRX_N-00001-97426366,2020-01-01T16:36:02,Donostia,transfer,Salary,3350.9,18061.28
buyer_5,Sara,30,ES84209531498650565944,TRX_N-00002-67819996,2020-01-01T16:36:02,Donostia,transfer,Partner Salary,3238.0,21299.28
buyer_5,Sara,30,ES84209531498650565944,TRX_N-00003-11108892,2020-01-01T16:14:53,Donostia,Expense,food,-486.04,20813.24
buyer_5,Sara,30,ES84209531498650565944,TRX_N-00004-17439242,2020-01-05T21:07:45,Donostia,Housing,Mortgage,-1160.88,19652.36
buyer_5,Sara,30,ES84209531498650565944,TRX_N-00005-86672922,2020-01-05T22:33:22,Donostia,Basic services,gas,-71.95,19580.41
buyer_5,Sara,30,ES84209531498650565944,TRX_N-00006-17564682,2020-01-06T16:43:56,Donostia,Basic services,phone,-79.43,19500.98
buyer_5,Sara,30,ES84209531498650565944,TRX_N-00007-18887977,2020-01-07T13:23:22,Donostia,Basic services,phone,-32.29,19468.69
buyer_5,Sara,30,ES84209531498650565944,TRX_N-00008-46715143,2020-01-14T18:46:51,Sestao,Expense,food,-377.64,19091.05
buyer_5,Sara,30,ES84209531498650565944,TRX_N-00009-38762168,2020-01-19T12:56:20,Donostia,Expense,food,-793.02,18298.03
buyer_5,Sara,30,ES84209531498650565944,TRX_N-00010-27974558,2020-01-29T22:13:44,Donostia,Expense,leisure,-123.83,18174.2
buyer_5,Sara,30,ES84209531498650565944,TRX_N-00011-93026924,2020-01-31T18:40:22,Donostia,Expense,food,-568.6,17605.6
buyer_5,Sara,30,ES84209531498650565944,TRX_N-00012-34225756,2020-02-01T12:51:04,Donostia,transfer,Salary,3350.9,20956.5
buyer_5,Sara,30,ES84209531498650565944,TRX_N-00013-53452143,2020-02-01T12:51:04,Donostia,transfer,Partner Salary,3238.0,24194.5
buyer_5,Sara,30,ES84209531498650565944,TRX_N-00014-42852086,2020-02-05T10:56:11,Donostia,Housing,Mortgage,-1160.88,23033.62
buyer_5,Sara,30,ES84209531498650565944,TRX_N-00015-28219592,2020-02-05T19:36:56,Donostia,Basic services,electricity,-26.38,23007.24
buyer_5,Sara,30,ES84209531498650565944,TRX_N-00016-45427842,2020-02-05T08:35:27,Donostia,Basic services,phone,-23.61,22983.63
buyer_5,Sara,30,ES84209531498650565944,TRX_N-00017-72167413,2020-02-06T20:20:53,Donostia,Basic services,water,-53.73,22929.9
buyer_5,Sara,30,ES84209531498650565944,TRX_N-00018-40141446,2020-02-06T05:05:45,Donostia,Basic services,internet,-44.01,22885.89
buyer_5,Sara,30,ES84209531498650565944,TRX_N-00019-36334692,2020-02-07T12:03:54,Donostia,Basic services,electricity,-51.45,22834.44
buyer_5,Sara,30,ES84209531498650565944,TRX_N-00020-57813362,2020-02-07T14:44:16,Donostia,Basic services,gas,-88.28,22746.16
buyer_5,Sara,30,ES84209531498650565944,TRX_N-00021-10375509,2020-02-11T17:16:29,Donostia,Expense,healthcare,-312.51,22433.65
buyer_5,Sara,30,ES84209531498650565944,TRX_N-00022-15618830,2020-02-13T17:43:51,Donostia,Expense,education,-366.3,22067.35
buyer_5,Sara,30,ES84209531498650565944,TRX_N-00023-42392442,2020-02-14T13:20:42,Llodio,Expense,food,-639.71,21427.64
buyer_5,Sara,30,ES84209531498650565944,TRX_N-00024-63315007,2020-02-19T16:22:36,Zuia,Expense,healthcare,-132.34,21295.3
buyer_5,Sara,30,ES84209531498650565944,TRX_N-00025-48716115,2020-02-25T20:07:31,Donostia,Expense,transport,-63.92,21231.38
buyer_5,Sara,30,ES84209531498650565944,TRX_N-00026-12439591,2020-02-28T13:59:40,Donostia,Expense,food,-369.36,20862.02
buyer_5,Sara,30,ES84209531498650565944,TRX_N-00027-58615356,2020-03-01T23:31:30,Donostia,transfer,Salary,3350.9,24212.92
buyer_5,Sara,30,ES84209531498650565944,TRX_N-00028-18141921,2020-03-01T23:31:30,Donostia,transfer,Partner Salary,3238.0,27450.92
buyer_5,Sara,30,ES84209531498650565944,TRX_N-00029-66526457,2020-03-01T23:31:30,Donostia,transfer,Extra Income,335.09,27786.01
buyer_5,Sara,30,ES84209531498650565944,TRX_N-00030-64599461,2020-03-02T19:06:46,Donostia,Expense,transport,-129.37,27656.64
buyer_5,Sara,30,ES84209531498650565944,TRX_N-00031-32441466,2020-03-03T15:16:37,Donostia,Expense,transport,-152.2,27504.44
buyer_5,Sara,30,ES84209531498650565944,TRX_N-00032-57167017,2020-03-04T10:06:26,Donostia,Expense,leisure,-116.48,27387.96
buyer_5,Sara,30,ES84209531498650565944,TRX_N-00033-46531647,2020-03-05T14:44:22,Donostia,Housing,Mortgage,-1160.88,26227.08
buyer_5,Sara,30,ES84209531498650565944,TRX_N-00034-97865537,2020-03-05T10:43:23,Donostia,Basic services,water,-68.09,26158.99
buyer_5,Sara,30,ES84209531498650565944,TRX_N-00035-07847484,2020-03-05T21:46:18,Donostia,Basic services,electricity,-88.38,26070.61
buyer_5,Sara,30,ES84209531498650565944,TRX_N-00036-81305309,2020-03-05T01:40:34,Donostia,Basic services,internet,-73.45,25997.16
buyer_5,Sara,30,ES84209531498650565944,TRX_N-00037-02459240,2020-03-06T00:45:56,Donostia,Basic services,gas,-59.92,25937.24
buyer_5,Sara,30,ES84209531498650565944,TRX_N-00038-54076932,2020-03-06T10:20:21,Donostia,Basic services,internet,-46.55,25890.69
buyer_5,Sara,30,ES84209531498650565944,TRX_N-00039-35916947,2020-03-07T12:05:07,Donostia,Basic services,phone,-53.28,25837.41
buyer_5,Sara,30,ES84209531498650565944,TRX_N-00040-53248640,2020-03-10T16:47:56,Donostia,Expense,leisure,-238.68,25598.73
buyer_5,Sara,30,ES84209531498650565944,TRX_N-00041-00161879,2020-03-11T12:55:35,Donostia,Expense,food,-693.94,24904.79
buyer_5,Sara,30,ES84209531498650565944,TRX_N-00042-89828825,2020-03-18T13:54:41,Donostia,Expense,clothing,-489.82,24414.97
buyer_5,Sara,30,ES84209531498650565944,TRX_N-00043-45842751,2020-03-23T17:40:22,Donostia,Expense,leisure,-137.32,24277.65
buyer_5,Sara,30,ES84209531498650565944,TRX_N-00044-40056920,2020-04-01T16:11:35,Donostia,transfer,Salary,3350.9,27628.55
buyer_5,Sara,30,ES84209531498650565944,TRX_N-00045-94235178,2020-04-01T16:11:35,Donostia,transfer,Partner Salary,3238.0,30866.55
buyer_5,Sara,30,ES84209531498650565944,TRX_N-00046-48869544,2020-04-05T01:42:56,Donostia,Housing,Mortgage,-1160.88,29705.67
buyer_5,Sara,30,ES84209531498650565944,TRX_N-00047-97440343,2020-04-05T09:47:03,Donostia,Basic services,gas,-76.31,29629.36
buyer_5,Sara,30,ES84209531498650565944,TRX_N-00048-54864815,2020-04-05T20:04:52,Donostia,Basic services,internet,-77.88,29551.48
buyer_5,Sara,30,ES84209531498650565944,TRX_N-00049-94862601,2020-04-05T08:11:05,Donostia,Basic services,phone,-52.3,29499.18
buyer_5,Sara,30,ES84209531498650565944,TRX_N-00050-93756853,2020-04-05T16:56:09,Hondarribia,Expense,education,-653.55,28845.63
buyer_5,Sara,30,ES84209531498650565944,TRX_N-00051-00449603,2020-04-07T08:38:15,Donostia,Basic services,electricity,-97.92,28747.71
buyer_5,Sara,30,ES84209531498650565944,TRX_N-00052-70907673,2020-04-07T18:38:35,Donostia,Basic services,gas,-29.97,28717.74
buyer_5,Sara,30,ES84209531498650565944,TRX_N-00053-93451940,2020-04-12T05:17:07,Sopela,Expense,education,-419.29,28298.45
buyer_5,Sara,30,ES84209531498650565944,TRX_N-00054-22453013,2020-04-13T15:11:03,Donostia,Expense,transport,-127.88,28170.57
buyer_5,Sara,30,ES84209531498650565944,TRX_N-00055-65387277,2020-04-20T17:01:58,Zarautz,Expense,transport,-171.71,27998.86
buyer_5,Sara,30,ES84209531498650565944,TRX_N-00056-68736880,2020-05-01T20:04:54,Donostia,transfer,Salary,3350.9,31349.76
buyer_5,Sara,30,ES84209531498650565944,TRX_N-00057-44529388,2020-05-01T20:04:54,Donostia,transfer,Partner Salary,3238.0,34587.76
buyer_5,Sara,30,ES84209531498650565944,TRX_N-00058-79268378,2020-05-01T20:04:54,Donostia,transfer,Extra Income,335.09,34922.85
buyer_5,Sara,30,ES84209531498650565944,TRX_N-00059-31042236,2020-05-05T11:07:05,Donostia,Housing,Mortgage,-1160.88,33761.97
buyer_5,Sara,30,ES84209531498650565944,TRX_N-00060-17264873,2020-05-05T14:34:28,Donostia,Basic services,electricity,-58.23,33703.74
buyer_5,Sara,30,ES84209531498650565944,TRX_N-00061-21396423,2020-05-05T18:38:32,Donostia,Basic services,gas,-75.87,33627.87
buyer_5,Sara,30,ES84209531498650565944,TRX_N-00062-73971360,2020-05-05T15:13:29,Donostia,Basic services,internet,-32.39,33595.48
buyer_5,Sara,30,ES84209531498650565944,TRX_N-00063-70594774,2020-05-05T16:15:45,Donostia,Basic services,phone,-33.67,33561.81
buyer_5,Sara,30,ES84209531498650565944,TRX_N-00064-13929498,2020-05-05T10:21:32,Donostia,Expense,transport,-64.53,33497.28
buyer_5,Sara,30,ES84209531498650565944,TRX_N-00065-64181028,2020-05-06T17:20:41,Donostia,Basic services,electricity,-93.05,33404.23
buyer_5,Sara,30,ES84209531498650565944,TRX_N-00066-35101952,2020-05-06T19:21:53,Donostia,Basic services,phone,-68.21,33336.02
buyer_5,Sara,30,ES84209531498650565944,TRX_N-00067-23573438,2020-05-07T16:45:51,Donostia,Basic services,electricity,-103.21,33232.81
buyer_5,Sara,30,ES84209531498650565944,TRX_N-00068-43077837,2020-05-07T12:50:46,Donostia,Basic services,gas,-69.3,33163.51
buyer_5,Sara,30,ES84209531498650565944,TRX_N-00069-52247411,2020-05-07T14:32:39,Donostia,Basic services,phone,-38.41,33125.1
buyer_5,Sara,30,ES84209531498650565944,TRX_N-00070-81080813,2020-05-08T08:44:39,Donostia,Expense,clothing,-400.51,32724.59
buyer_5,Sara,30,ES84209531498650565944,TRX_N-00071-16518790,2020-05-15T19:55:05,Donostia,Expense,clothing,-275.69,32448.9
buyer_5,Sara,30,ES84209531498650565944,TRX_N-00072-85519906,2020-05-16T12:45:48,Donostia,Expense,healthcare,-270.76,32178.14
buyer_5,Sara,30,ES84209531498650565944,TRX_N-00073-12151729,2020-05-19T11:39:13,Donostia,Expense,food,-558.05,31620.09
buyer_5,Sara,30,ES84209531498650565944,TRX_N-00074-47990854,2020-05-20T16:10:52,Donostia,Expense,clothing,-470.27,31149.82
buyer_5,Sara,30,ES84209531498650565944,TRX_N-00075-57244451,2020-05-22T17:14:41,Donostia,Expense,food,-232.25,30917.57
buyer_5,Sara,30,ES84209531498650565944,TRX_N-00076-11093631,2020-05-26T15:36:17,Donostia,Expense,leisure,-62.08,30855.49
buyer_5,Sara,30,ES84209531498650565944,TRX_N-00077-79960796,2020-05-31T09:49:50,Donostia,Expense,leisure,-75.61,30779.88
buyer_5,Sara,30,ES84209531498650565944,TRX_N-00078-52014804,2020-06-01T23:19:14,Donostia,transfer,Salary,3350.9,34130.78
buyer_5,Sara,30,ES84209531498650565944,TRX_N-00079-20811455,2020-06-01T23:19:14,Donostia,transfer,Partner Salary,3238.0,37368.78
buyer_5,Sara,30,ES84209531498650565944,TRX_N-00080-48284700,2020-06-01T23:19:14,Donostia,transfer,Bonus,3108.16,40476.94
buyer_5,Sara,30,ES84209531498650565944,TRX_N-00081-64347608,2020-06-05T15:04:52,Donostia,Housing,Mortgage,-1160.88,39316.06
buyer_5,Sara,30,ES84209531498650565944,TRX_N-00082-01585882,2020-06-05T09:47:45,Donostia,Basic services,internet,-41.64,39274.42
buyer_5,Sara,30,ES84209531498650565944,TRX_N-00083-75605614,2020-06-05T15:45:09,Donostia,Basic services,phone,-53.68,39220.74
buyer_5,Sara,30,ES84209531498650565944,TRX_N-00084-10544401,2020-06-06T12:38:04,Donostia,Basic services,internet,-67.21,39153.53
buyer_5,Sara,30,ES84209531498650565944,TRX_N-00085-73401990,2020-06-07T11:29:42,Donostia,Basic services,phone,-97.45,39056.08
buyer_5,Sara,30,ES84209531498650565944,TRX_N-00086-82175375,2020-06-10T08:16:59,Sopela,Expense,healthcare,-250.46,38805.62
buyer_5,Sara,30,ES84209531498650565944,TRX_N-00087-85724385,2020-06-10T20:14:48,Donostia,Expense,gifts,-149.95,38655.67
buyer_5,Sara,30,ES84209531498650565944,TRX_N-00088-06850120,2020-06-19T05:02:45,Donostia,Expense,gifts,-498.01,38157.66
buyer_5,Sara,30,ES84209531498650565944,TRX_N-00089-43691054,2020-06-26T15:15:29,Donostia,Expense,repairs,-143.11,38014.55
buyer_5,Sara,30,ES84209531498650565944,TRX_N-00090-53670624,2020-07-01T12:03:00,Donostia,transfer,Salary,3350.9,41365.45
buyer_5,Sara,30,ES84209531498650565944,TRX_N-00091-24558378,2020-07-01T12:03:00,Donostia,transfer,Partner Salary,3238.0,44603.45
buyer_5,Sara,30,ES84209531498650565944,TRX_N-00092-61858082,2020-07-05T11:30:21,Donostia,Housing,Mortgage,-1160.88,43442.57
buyer_5,Sara,30,ES84209531498650565944,TRX_N-00093-83593842,2020-07-06T14:22:55,Donostia,Basic services,phone,-80.11,43362.46
buyer_5,Sara,30,ES84209531498650565944,TRX_N-00094-93475845,2020-07-07T12:20:21,Donostia,Basic services,water,-31.11,43331.35
buyer_5,Sara,30,ES84209531498650565944,TRX_N-00095-60922149,2020-07-14T20:17:36,Alegría-Dulantzi,Expense,clothing,-487.09,42844.26
buyer_5,Sara,30,ES84209531498650565944,TRX_N-00096-36361489,2020-07-14T16:18:02,Donostia,Expense,repairs,-432.57,42411.69
buyer_5,Sara,30,ES84209531498650565944,TRX_N-00097-77519619,2020-07-31T16:09:39,Donostia,Expense,transport,-90.14,42321.55
buyer_5,Sara,30,ES84209531498650565944,TRX_N-00098-01982077,2020-08-01T22:12:19,Donostia,transfer,Salary,3350.9,45672.45
buyer_5,Sara,30,ES84209531498650565944,TRX_N-00099-87035830,2020-08-01T22:12:19,Donostia,transfer,Partner Salary,3238.0,48910.45
buyer_5,Sara,30,ES84209531498650565944,TRX_N-00100-94871304,2020-08-01T22:12:19,Donostia,transfer,Extra Income,335.09,49245.54
buyer_5,Sara,30,ES84209531498650565944,TRX_N-00101-79260160,2020-08-05T09:29:23,Donostia,Housing,Mortgage,-1160.88,48084.66
buyer_5,Sara,30,ES84209531498650565944,TRX_N-00102-21381343,2020-08-05T14:59:03,Donostia,Basic services,internet,-31.16,48053.5
buyer_5,Sara,30,ES84209531498650565944,TRX_N-00103-00067964,2020-08-05T17:19:00,Donostia,Basic services,phone,-90.55,47962.95
buyer_5,Sara,30,ES84209531498650565944,TRX_N-00104-81298859,2020-08-06T00:29:22,Donostia,Basic services,water,-77.58,47885.37
buyer_5,Sara,30,ES84209531498650565944,TRX_N-00105-93880325,2020-08-07T13:26:57,Donostia,Basic services,water,-35.64,47849.73
buyer_5,Sara,30,ES84209531498650565944,TRX_N-00106-88484486,2020-08-07T09:56:43,Donostia,Basic services,gas,-47.0,47802.73
buyer_5,Sara,30,ES84209531498650565944,TRX_N-00107-52755110,2020-08-07T09:55:34,Donostia,Expense,healthcare,-103.68,47699.05
buyer_5,Sara,30,ES84209531498650565944,TRX_N-00108-67240611,2020-08-11T15:40:58,Alegría-Dulantzi,Expense,leisure,-179.52,47519.53
buyer_5,Sara,30,ES84209531498650565944,TRX_N-00109-32569563,2020-08-22T08:38:03,Erandio,Expense,clothing,-155.23,47364.3
buyer_5,Sara,30,ES84209531498650565944,TRX_N-00110-58933854,2020-08-23T20:59:38,Donostia,Expense,leisure,-37.47,47326.83
buyer_5,Sara,30,ES84209531498650565944,TRX_N-00111-16208244,2020-08-26T08:53:41,Donostia,Expense,food,-181.34,47145.49
buyer_5,Sara,30,ES84209531498650565944,TRX_N-00112-50888446,2020-08-27T17:24:09,Hernani,Expense,transport,-120.98,47024.51
buyer_5,Sara,30,ES84209531498650565944,TRX_N-00113-90575685,2020-08-27T20:46:44,Donostia,Expense,clothing,-355.16,46669.35
buyer_5,Sara,30,ES84209531498650565944,TRX_N-00114-38711444,2020-09-01T08:32:33,Donostia,transfer,Salary,3350.9,50020.25
buyer_5,Sara,30,ES84209531498650565944,TRX_N-00115-03174262,2020-09-01T08:32:33,Donostia,transfer,Partner Salary,3238.0,53258.25
buyer_5,Sara,30,ES84209531498650565944,TRX_N-00116-46088783,2020-09-05T16:18:30,Donostia,Housing,Mortgage,-1160.88,52097.37
buyer_5,Sara,30,ES84209531498650565944,TRX_N-00117-53806361,2020-09-07T11:30:25,Donostia,Basic services,gas,-95.51,52001.86
buyer_5,Sara,30,ES84209531498650565944,TRX_N-00118-81045044,2020-09-14T18:07:00,Donostia,Expense,leisure,-266.19,51735.67
buyer_5,Sara,30,ES84209531498650565944,TRX_N-00119-67866677,2020-09-19T14:56:44,Donostia,Expense,food,-388.99,51346.68
buyer_5,Sara,30,ES84209531498650565944,TRX_N-00120-50091157,2020-10-01T17:07:09,Donostia,transfer,Salary,3350.9,54697.58
buyer_5,Sara,30,ES84209531498650565944,TRX_N-00121-83993047,2020-10-01T17:07:09,Donostia,transfer,Partner Salary,3238.0,57935.58
buyer_5,Sara,30,ES84209531498650565944,TRX_N-00122-76140113,2020-10-01T17:07:09,Donostia,transfer,Extra Income,335.09,58270.67
buyer_5,Sara,30,ES84209531498650565944,TRX_N-00123-00542749,2020-10-01T15:44:05,Donostia,Expense,food,-694.86,57575.81
buyer_5,Sara,30,ES84209531498650565944,TRX_N-00124-98311425,2020-10-05T12:59:26,Donostia,Housing,Mortgage,-1160.88,56414.93
buyer_5,Sara,30,ES84209531498650565944,TRX_N-00125-03838698,2020-10-06T08:39:50,Donostia,Basic services,gas,-40.67,56374.26
buyer_5,Sara,30,ES84209531498650565944,TRX_N-00126-42594859,2020-10-06T12:07:15,Donostia,Basic services,internet,-78.54,56295.72
buyer_5,Sara,30,ES84209531498650565944,TRX_N-00127-10732687,2020-10-07T17:11:43,Donostia,Basic services,electricity,-67.93,56227.79
buyer_5,Sara,30,ES84209531498650565944,TRX_N-00128-20443151,2020-10-07T19:00:37,Donostia,Basic services,phone,-76.47,56151.32
buyer_5,Sara,30,ES84209531498650565944,TRX_N-00129-95607889,2020-10-14T09:59:32,Arrasate,Expense,education,-443.31,55708.01
buyer_5,Sara,30,ES84209531498650565944,TRX_N-00130-65265567,2020-10-24T09:04:15,Donostia,Expense,leisure,-277.93,55430.08
buyer_5,Sara,30,ES84209531498650565944,TRX_N-00131-63248463,2020-11-01T13:34:21,Donostia,transfer,Salary,3350.9,58780.98
buyer_5,Sara,30,ES84209531498650565944,TRX_N-00132-08780257,2020-11-01T13:34:21,Donostia,transfer,Partner Salary,3238.0,62018.98
buyer_5,Sara,30,ES84209531498650565944,TRX_N-00133-64989084,2020-11-05T13:18:49,Donostia,Housing,Mortgage,-1160.88,60858.1
buyer_5,Sara,30,ES84209531498650565944,TRX_N-00134-97950104,2020-11-05T12:12:00,Donostia,Basic services,water,-12.52,60845.58
buyer_5,Sara,30,ES84209531498650565944,TRX_N-00135-87203342,2020-11-05T16:42:44,Donostia,Basic services,internet,-48.51,60797.07
buyer_5,Sara,30,ES84209531498650565944,TRX_N-00136-76674037,2020-11-05T13:20:27,Donostia,Basic services,phone,-95.41,60701.66
buyer_5,Sara,30,ES84209531498650565944,TRX_N-00137-88303141,2020-11-06T20:36:19,Donostia,Basic services,electricity,-85.86,60615.8
buyer_5,Sara,30,ES84209531498650565944,TRX_N-00138-36459267,2020-11-06T13:03:37,Donostia,Basic services,gas,-15.73,60600.07
buyer_5,Sara,30,ES84209531498650565944,TRX_N-00139-49993117,2020-11-06T20:44:35,Llodio,Expense,clothing,-486.52,60113.55
buyer_5,Sara,30,ES84209531498650565944,TRX_N-00140-12664380,2020-11-06T14:02:21,Donostia,Expense,gifts,-433.01,59680.54
buyer_5,Sara,30,ES84209531498650565944,TRX_N-00141-15449360,2020-11-08T20:17:15,Donostia,Expense,education,-93.2,59587.34
buyer_5,Sara,30,ES84209531498650565944,TRX_N-00142-57219953,2020-11-09T17:40:54,Sestao,Expense,food,-599.02,58988.32
buyer_5,Sara,30,ES84209531498650565944,TRX_N-00143-19119289,2020-11-18T10:57:11,Donostia,Expense,food,-265.75,58722.57
buyer_5,Sara,30,ES84209531498650565944,TRX_N-00144-51549179,2020-11-18T11:23:18,Donostia,Expense,leisure,-282.6,58439.97
buyer_5,Sara,30,ES84209531498650565944,TRX_N-00145-45430377,2020-11-25T16:00:37,Donostia,Expense,leisure,-178.21,58261.76
buyer_5,Sara,30,ES84209531498650565944,TRX_N-00146-84617650,2020-12-01T13:36:07,Donostia,transfer,Salary,3350.9,61612.66
buyer_5,Sara,30,ES84209531498650565944,TRX_N-00147-92955228,2020-12-01T13:36:07,Donostia,transfer,Partner Salary,3238.0,64850.66
buyer_5,Sara,30,ES84209531498650565944,TRX_N-00148-09485377,2020-12-01T13:36:07,Donostia,transfer,Bonus,3305.62,68156.28
buyer_5,Sara,30,ES84209531498650565944,TRX_N-00149-35925349,2020-12-03T02:04:35,Donostia,Expense,education,-950.52,67205.76
buyer_5,Sara,30,ES84209531498650565944,TRX_N-00150-48762099,2020-12-05T01:10:31,Donostia,Housing,Mortgage,-1160.88,66044.88
buyer_5,Sara,30,ES84209531498650565944,TRX_N-00151-50804468,2020-12-05T11:10:55,Donostia,Basic services,gas,-51.44,65993.44
buyer_5,Sara,30,ES84209531498650565944,TRX_N-00152-22424868,2020-12-05T08:04:40,Donostia,Basic services,internet,-63.76,65929.68
buyer_5,Sara,30,ES84209531498650565944,TRX_N-00153-09337870,2020-12-06T15:11:12,Donostia,Basic services,electricity,-74.31,65855.37
buyer_5,Sara,30,ES84209531498650565944,TRX_N-00154-63097258,2020-12-06T17:55:41,Donostia,Basic services,phone,-69.22,65786.15
buyer_5,Sara,30,ES84209531498650565944,TRX_N-00155-79866585,2020-12-07T07:27:59,Donostia,Basic services,water,-73.45,65712.7
buyer_5,Sara,30,ES84209531498650565944,TRX_N-00156-14706225,2020-12-08T11:04:31,Donostia,Expense,leisure,-225.82,65486.88
buyer_5,Sara,30,ES84209531498650565944,TRX_N-00157-45935856,2020-12-20T20:02:53,Sestao,Expense,transport,-173.41,65313.47
buyer_5,Sara,30,ES84209531498650565944,TRX_N-00158-46749631,2020-12-30T08:50:59,Portugalete,Expense,education,-603.16,64710.31
buyer_5,Sara,30,ES84209531498650565944,TRX_N-00159-05927009,2021-01-01T11:14:36,Donostia,transfer,Salary,3350.9,68061.21
buyer_5,Sara,30,ES84209531498650565944,TRX_N-00160-22872824,2021-01-01T11:14:36,Donostia,transfer,Partner Salary,3238.0,71299.21
buyer_5,Sara,30,ES84209531498650565944,TRX_N-00161-67750340,2021-01-01T11:14:36,Donostia,transfer,Extra Income,335.09,71634.3
buyer_5,Sara,30,ES84209531498650565944,TRX_N-00162-73423669,2021-01-05T13:57:45,Donostia,Housing,Mortgage,-1160.88,70473.42
buyer_5,Sara,30,ES84209531498650565944,TRX_N-00163-28854156,2021-01-05T11:56:09,Donostia,Basic services,gas,-82.62,70390.8
buyer_5,Sara,30,ES84209531498650565944,TRX_N-00164-82567636,2021-01-05T17:11:00,Donostia,Basic services,phone,-49.79,70341.01
buyer_5,Sara,30,ES84209531498650565944,TRX_N-00165-76485716,2021-01-06T03:10:10,Donostia,Basic services,water,-45.96,70295.05
buyer_5,Sara,30,ES84209531498650565944,TRX_N-00166-18957799,2021-01-06T09:07:48,Donostia,Basic services,electricity,-70.74,70224.31
buyer_5,Sara,30,ES84209531498650565944,TRX_N-00167-32320765,2021-01-06T16:01:34,Donostia,Basic services,internet,-76.62,70147.69
buyer_5,Sara,30,ES84209531498650565944,TRX_N-00168-95371428,2021-01-06T21:25:14,Donostia,Basic services,phone,-96.23,70051.46
buyer_5,Sara,30,ES84209531498650565944,TRX_N-00169-00829258,2021-01-06T16:34:54,Donostia,Expense,clothing,-400.67,69650.79
buyer_5,Sara,30,ES84209531498650565944,TRX_N-00170-60738913,2021-01-07T21:57:30,Donostia,Basic services,gas,-32.78,69618.01
buyer_5,Sara,30,ES84209531498650565944,TRX_N-00171-35621722,2021-01-07T10:14:39,Donostia,Basic services,internet,-72.99,69545.02
buyer_5,Sara,30,ES84209531498650565944,TRX_N-00172-14123994,2021-01-17T20:44:45,Donostia,Expense,food,-106.8,69438.22
buyer_5,Sara,30,ES84209531498650565944,TRX_N-00173-26449864,2021-01-27T18:27:59,Donostia,Expense,repairs,-846.68,68591.54
buyer_5,Sara,30,ES84209531498650565944,TRX_N-00174-33458169,2021-02-01T15:52:22,Donostia,transfer,Salary,3350.9,71942.44
buyer_5,Sara,30,ES84209531498650565944,TRX_N-00175-09107000,2021-02-01T15:52:22,Donostia,transfer,Partner Salary,3238.0,75180.44
buyer_5,Sara,30,ES84209531498650565944,TRX_N-00176-18663186,2021-02-01T17:57:57,Donostia,Expense,gifts,-390.49,74789.95
buyer_5,Sara,30,ES84209531498650565944,TRX_N-00177-53527584,2021-02-05T03:01:54,Donostia,Housing,Mortgage,-1160.88,73629.07
buyer_5,Sara,30,ES84209531498650565944,TRX_N-00178-14766265,2021-02-05T16:06:24,Donostia,Basic services,phone,-74.7,73554.37
buyer_5,Sara,30,ES84209531498650565944,TRX_N-00179-91788123,2021-02-06T13:34:43,Donostia,Basic services,electricity,-100.43,73453.94
buyer_5,Sara,30,ES84209531498650565944,TRX_N-00180-60316841,2021-02-06T11:06:31,Donostia,Expense,transport,-96.01,73357.93
buyer_5,Sara,30,ES84209531498650565944,TRX_N-00181-42201827,2021-02-06T00:12:08,Donostia,Expense,repairs,-868.75,72489.18
buyer_5,Sara,30,ES84209531498650565944,TRX_N-00182-79764585,2021-02-07T10:33:52,Donostia,Basic services,water,-34.5,72454.68
buyer_5,Sara,30,ES84209531498650565944,TRX_N-00183-03673148,2021-02-07T20:45:37,Donostia,Basic services,electricity,-43.49,72411.19
buyer_5,Sara,30,ES84209531498650565944,TRX_N-00184-78009978,2021-02-08T09:43:17,Donostia,Expense,education,-979.55,71431.64
buyer_5,Sara,30,ES84209531498650565944,TRX_N-00185-09990456,2021-03-01T00:23:08,Donostia,transfer,Salary,3350.9,74782.54
buyer_5,Sara,30,ES84209531498650565944,TRX_N-00186-04110790,2021-03-01T00:23:08,Donostia,transfer,Partner Salary,3238.0,78020.54
buyer_5,Sara,30,ES84209531498650565944,TRX_N-00187-67828877,2021-03-05T09:36:34,Donostia,Housing,Mortgage,-1160.88,76859.66
buyer_5,Sara,30,ES84209531498650565944,TRX_N-00188-87156068,2021-03-05T12:57:32,Donostia,Basic services,water,-36.35,76823.31
buyer_5,Sara,30,ES84209531498650565944,TRX_N-00189-53747076,2021-03-07T16:55:44,Donostia,Basic services,water,-59.33,76763.98
buyer_5,Sara,30,ES84209531498650565944,TRX_N-00190-76165645,2021-03-07T13:23:56,Donostia,Basic services,gas,-73.33,76690.65
buyer_5,Sara,30,ES84209531498650565944,TRX_N-00191-49442354,2021-03-07T19:24:44,Donostia,Basic services,internet,-55.77,76634.88
buyer_5,Sara,30,ES84209531498650565944,TRX_N-00192-39249555,2021-04-01T15:37:09,Donostia,transfer,Salary,3350.9,79985.78
buyer_5,Sara,30,ES84209531498650565944,TRX_N-00193-42086327,2021-04-01T15:37:09,Donostia,transfer,Partner Salary,3238.0,83223.78
buyer_5,Sara,30,ES84209531498650565944,TRX_N-00194-62571835,2021-04-01T15:37:09,Donostia,transfer,Extra Income,335.09,83558.87
buyer_5,Sara,30,ES84209531498650565944,TRX_N-00195-18451753,2021-04-01T15:26:11,Donostia,Expense,repairs,-892.15,82666.72
buyer_5,Sara,30,ES84209531498650565944,TRX_N-00196-78337152,2021-04-05T16:39:54,Donostia,Housing,Mortgage,-1160.88,81505.84
buyer_5,Sara,30,ES84209531498650565944,TRX_N-00197-42908540,2021-04-06T09:55:01,Donostia,Basic services,electricity,-132.42,81373.42
buyer_5,Sara,30,ES84209531498650565944,TRX_N-00198-67810774,2021-04-06T08:53:12,Donostia,Basic services,internet,-59.9,81313.52
buyer_5,Sara,30,ES84209531498650565944,TRX_N-00199-18269250,2021-04-07T17:55:44,Donostia,Basic services,phone,-70.79,81242.73
buyer_5,Sara,30,ES84209531498650565944,TRX_N-00200-74447962,2021-04-08T14:47:06,Donostia,Expense,food,-364.71,80878.02
buyer_5,Sara,30,ES84209531498650565944,TRX_N-00201-14092151,2021-04-08T22:11:03,Donostia,Expense,transport,-93.29,80784.73
buyer_5,Sara,30,ES84209531498650565944,TRX_N-00202-10971563,2021-04-25T10:11:17,Donostia,Expense,leisure,-88.89,80695.84
buyer_5,Sara,30,ES84209531498650565944,TRX_N-00203-66021349,2021-04-26T16:53:09,Labastida,Expense,transport,-75.94,80619.9
buyer_5,Sara,30,ES84209531498650565944,TRX_N-00204-95441637,2021-05-01T08:11:53,Donostia,transfer,Salary,3350.9,83970.8
buyer_5,Sara,30,ES84209531498650565944,TRX_N-00205-07406652,2021-05-01T08:11:53,Donostia,transfer,Partner Salary,3238.0,87208.8
buyer_5,Sara,30,ES84209531498650565944,TRX_N-00206-67297032,2021-05-03T05:19:40,Donostia,Expense,education,-795.42,86413.38
buyer_5,Sara,30,ES84209531498650565944,TRX_N-00207-90753062,2021-05-05T18:44:11,Donostia,Housing,Mortgage,-1160.88,85252.5
buyer_5,Sara,30,ES84209531498650565944,TRX_N-00208-48038850,2021-05-05T19:43:27,Donostia,Basic services,electricity,-45.06,85207.44
buyer_5,Sara,30,ES84209531498650565944,TRX_N-00209-77669223,2021-05-05T10:01:35,Donostia,Basic services,internet,-43.95,85163.49
buyer_5,Sara,30,ES84209531498650565944,TRX_N-00210-14755338,2021-05-05T15:51:20,Donostia,Expense,travel,-2945.63,82217.86
buyer_5,Sara,30,ES84209531498650565944,TRX_N-00211-99846722,2021-05-06T21:57:39,Donostia,Basic services,internet,-79.06,82138.8
buyer_5,Sara,30,ES84209531498650565944,TRX_N-00212-61100809,2021-05-07T22:47:43,Donostia,Basic services,internet,-30.65,82108.15
buyer_5,Sara,30,ES84209531498650565944,TRX_N-00213-24965722,2021-05-27T23:27:00,Oyón-Oion,Expense,food,-316.97,81791.18
buyer_5,Sara,30,ES84209531498650565944,TRX_N-00214-14975069,2021-05-30T08:29:53,Donostia,Expense,gifts,-277.76,81513.42
buyer_5,Sara,30,ES84209531498650565944,TRX_N-00215-69187085,2021-06-01T10:37:27,Donostia,transfer,Salary,3350.9,84864.32
buyer_5,Sara,30,ES84209531498650565944,TRX_N-00216-25098615,2021-06-01T10:37:27,Donostia,transfer,Partner Salary,3238.0,88102.32
buyer_5,Sara,30,ES84209531498650565944,TRX_N-00217-93245440,2021-06-01T10:37:27,Donostia,transfer,Bonus,3347.01,91449.33
buyer_5,Sara,30,ES84209531498650565944,TRX_N-00218-87066364,2021-06-05T14:18:30,Donostia,Housing,Mortgage,-1160.88,90288.45
buyer_5,Sara,30,ES84209531498650565944,TRX_N-00219-65494160,2021-06-05T09:29:01,Donostia,Basic services,electricity,-109.26,90179.19
buyer_5,Sara,30,ES84209531498650565944,TRX_N-00220-13528164,2021-06-06T13:31:07,Donostia,Basic services,water,-73.4,90105.79
buyer_5,Sara,30,ES84209531498650565944,TRX_N-00221-04890979,2021-06-06T10:56:26,Donostia,Basic services,internet,-43.5,90062.29
buyer_5,Sara,30,ES84209531498650565944,TRX_N-00222-93461732,2021-06-07T12:33:33,Donostia,Basic services,water,-42.67,90019.62
buyer_5,Sara,30,ES84209531498650565944,TRX_N-00223-28521347,2021-06-07T11:49:42,Donostia,Basic services,electricity,-141.41,89878.21
buyer_5,Sara,30,ES84209531498650565944,TRX_N-00224-81137111,2021-06-07T17:25:25,Donostia,Basic services,gas,-53.8,89824.41
buyer_5,Sara,30,ES84209531498650565944,TRX_N-00225-59015359,2021-06-07T18:54:42,Donostia,Basic services,internet,-47.32,89777.09
buyer_5,Sara,30,ES84209531498650565944,TRX_N-00226-33187999,2021-06-07T20:08:27,Donostia,Basic services,phone,-72.94,89704.15
buyer_5,Sara,30,ES84209531498650565944,TRX_N-00227-37348067,2021-06-07T17:00:30,Donostia,Expense,leisure,-220.24,89483.91
buyer_5,Sara,30,ES84209531498650565944,TRX_N-00228-63731530,2021-06-09T08:34:12,Donostia,Expense,transport,-194.69,89289.22
buyer_5,Sara,30,ES84209531498650565944,TRX_N-00229-10576331,2021-06-10T20:04:32,Donostia,Expense,food,-660.24,88628.98
buyer_5,Sara,30,ES84209531498650565944,TRX_N-00230-08736236,2021-07-01T15:49:37,Donostia,transfer,Salary,3350.9,91979.88
buyer_5,Sara,30,ES84209531498650565944,TRX_N-00231-76441432,2021-07-01T15:49:37,Donostia,transfer,Partner Salary,3238.0,95217.88
buyer_5,Sara,30,ES84209531498650565944,TRX_N-00232-00031201,2021-07-01T15:49:37,Donostia,transfer,Extra Income,335.09,95552.97
buyer_5,Sara,30,ES84209531498650565944,TRX_N-00233-69144037,2021-07-01T11:23:01,Donostia,Expense,leisure,-26.99,95525.98
buyer_5,Sara,30,ES84209531498650565944,TRX_N-00234-62649104,2021-07-05T11:52:06,Donostia,Housing,Mortgage,-1160.88,94365.1
buyer_5,Sara,30,ES84209531498650565944,TRX_N-00235-49539876,2021-07-05T12:28:55,Donostia,Basic services,gas,-24.58,94340.52
buyer_5,Sara,30,ES84209531498650565944,TRX_N-00236-60418665,2021-07-05T20:57:32,Donostia,Basic services,internet,-50.99,94289.53
buyer_5,Sara,30,ES84209531498650565944,TRX_N-00237-66366402,2021-07-06T19:51:49,Donostia,Basic services,water,-43.74,94245.79
buyer_5,Sara,30,ES84209531498650565944,TRX_N-00238-18387171,2021-07-06T17:39:24,Durango,Expense,food,-231.47,94014.32
buyer_5,Sara,30,ES84209531498650565944,TRX_N-00239-36652070,2021-07-07T10:04:22,Donostia,Basic services,water,-49.13,93965.19
buyer_5,Sara,30,ES84209531498650565944,TRX_N-00240-11538823,2021-07-08T18:45:26,Donostia,Expense,transport,-141.79,93823.4
buyer_5,Sara,30,ES84209531498650565944,TRX_N-00241-02419502,2021-07-19T10:16:22,Donostia,Expense,gifts,-468.57,93354.83
buyer_5,Sara,30,ES84209531498650565944,TRX_N-00242-40918536,2021-07-24T13:08:26,Donostia,Expense,leisure,-55.35,93299.48
buyer_5,Sara,30,ES84209531498650565944,TRX_N-00243-55578409,2021-08-01T13:42:47,Donostia,transfer,Salary,3350.9,96650.38
buyer_5,Sara,30,ES84209531498650565944,TRX_N-00244-65908489,2021-08-01T13:42:47,Donostia,transfer,Partner Salary,3238.0,99888.38
buyer_5,Sara,30,ES84209531498650565944,TRX_N-00245-62187701,2021-08-04T14:25:32,Donostia,Expense,transport,-75.39,99812.99
buyer_5,Sara,30,ES84209531498650565944,TRX_N-00246-52765791,2021-08-05T23:01:43,Donostia,Housing,Mortgage,-1160.88,98652.11
buyer_5,Sara,30,ES84209531498650565944,TRX_N-00247-72240225,2021-08-05T08:22:34,Donostia,Basic services,electricity,-119.22,98532.89
buyer_5,Sara,30,ES84209531498650565944,TRX_N-00248-32327548,2021-08-05T19:56:24,Donostia,Basic services,phone,-58.9,98473.99
buyer_5,Sara,30,ES84209531498650565944,TRX_N-00249-18643613,2021-08-06T14:11:10,Donostia,Basic services,electricity,-31.16,98442.83
buyer_5,Sara,30,ES84209531498650565944,TRX_N-00250-97450061,2021-08-06T14:57:06,Donostia,Basic services,gas,-79.04,98363.79
buyer_5,Sara,30,ES84209531498650565944,TRX_N-00251-61376831,2021-08-07T22:55:25,Donostia,Basic services,internet,-48.82,98314.97
buyer_5,Sara,30,ES84209531498650565944,TRX_N-00252-97415790,2021-08-17T09:27:16,Donostia,Expense,food,-112.97,98202.0
buyer_5,Sara,30,ES84209531498650565944,TRX_N-00253-17051217,2021-08-21T20:38:04,Donostia,Expense,education,-967.52,97234.48
buyer_5,Sara,30,ES84209531498650565944,TRX_N-00254-27187949,2021-09-01T20:12:18,Donostia,transfer,Salary,3350.9,100585.38
buyer_5,Sara,30,ES84209531498650565944,TRX_N-00255-35373146,2021-09-01T20:12:18,Donostia,transfer,Partner Salary,3238.0,103823.38
buyer_5,Sara,30,ES84209531498650565944,TRX_N-00256-16826687,2021-09-01T20:12:18,Donostia,transfer,Extra Income,335.09,104158.47
buyer_5,Sara,30,ES84209531498650565944,TRX_N-00257-46108771,2021-09-04T14:35:33,Donostia,Expense,food,-471.14,103687.33
buyer_5,Sara,30,ES84209531498650565944,TRX_N-00258-74017832,2021-09-05T05:07:02,Donostia,Housing,Mortgage,-1160.88,102526.45
buyer_5,Sara,30,ES84209531498650565944,TRX_N-00259-04177273,2021-09-05T15:03:17,Donostia,Basic services,water,-24.21,102502.24
buyer_5,Sara,30,ES84209531498650565944,TRX_N-00260-86499284,2021-09-06T10:50:17,Donostia,Basic services,internet,-38.07,102464.17
buyer_5,Sara,30,ES84209531498650565944,TRX_N-00261-16800563,2021-09-07T08:34:22,Donostia,Basic services,gas,-99.44,102364.73
buyer_5,Sara,30,ES84209531498650565944,TRX_N-00262-38155272,2021-09-07T16:11:04,Donostia,Basic services,phone,-22.32,102342.41
buyer_5,Sara,30,ES84209531498650565944,TRX_N-00263-69058256,2021-09-22T13:47:04,Donostia,Expense,leisure,-86.33,102256.08
buyer_5,Sara,30,ES84209531498650565944,TRX_N-00264-98478509,2021-09-25T18:24:50,Donostia,Expense,education,-628.4,101627.68
buyer_5,Sara,30,ES84209531498650565944,TRX_N-00265-79793829,2021-10-01T17:39:27,Donostia,transfer,Salary,3350.9,104978.58
buyer_5,Sara,30,ES84209531498650565944,TRX_N-00266-09007518,2021-10-01T17:39:27,Donostia,transfer,Partner Salary,3238.0,108216.58
buyer_5,Sara,30,ES84209531498650565944,TRX_N-00267-41848171,2021-10-04T08:57:48,Donostia,Expense,leisure,-228.29,107988.29
buyer_5,Sara,30,ES84209531498650565944,TRX_N-00268-52606443,2021-10-05T11:02:44,Donostia,Housing,Mortgage,-1160.88,106827.41
buyer_5,Sara,30,ES84209531498650565944,TRX_N-00269-45233064,2021-10-05T01:42:21,Donostia,Basic services,internet,-31.45,106795.96
buyer_5,Sara,30,ES84209531498650565944,TRX_N-00270-07625285,2021-10-06T20:59:14,Donostia,Basic services,phone,-66.62,106729.34
buyer_5,Sara,30,ES84209531498650565944,TRX_N-00271-06481877,2021-10-07T08:20:43,Donostia,Basic services,water,-51.79,106677.55
buyer_5,Sara,30,ES84209531498650565944,TRX_N-00272-53156304,2021-10-07T15:18:49,Donostia,Basic services,phone,-42.83,106634.72
buyer_5,Sara,30,ES84209531498650565944,TRX_N-00273-64921144,2021-10-07T13:34:43,Donostia,Expense,education,-793.37,105841.35
buyer_5,Sara,30,ES84209531498650565944,TRX_N-00274-76163252,2021-10-16T14:45:20,Donostia,Expense,leisure,-86.29,105755.06
buyer_5,Sara,30,ES84209531498650565944,TRX_N-00275-71378502,2021-11-01T08:16:34,Donostia,transfer,Salary,3350.9,109105.96
buyer_5,Sara,30,ES84209531498650565944,TRX_N-00276-37815470,2021-11-01T08:16:34,Donostia,transfer,Partner Salary,3238.0,112343.96
buyer_5,Sara,30,ES84209531498650565944,TRX_N-00277-24041899,2021-11-05T18:06:51,Donostia,Housing,Mortgage,-1160.88,111183.08
buyer_5,Sara,30,ES84209531498650565944,TRX_N-00278-38136630,2021-11-05T20:41:00,Donostia,Basic services,water,-14.2,111168.88
buyer_5,Sara,30,ES84209531498650565944,TRX_N-00279-94755218,2021-11-12T20:27:15,Arrasate,Expense,food,-301.27,110867.61
buyer_5,Sara,30,ES84209531498650565944,TRX_N-00280-31315265,2021-11-19T19:33:10,Donostia,Expense,leisure,-32.09,110835.52
buyer_5,Sara,30,ES84209531498650565944,TRX_N-00281-94369995,2021-11-19T20:30:08,Donostia,Expense,healthcare,-109.88,110725.64
buyer_5,Sara,30,ES84209531498650565944,TRX_N-00282-70254650,2021-11-29T10:55:56,Donostia,Expense,food,-591.47,110134.17
buyer_5,Sara,30,ES84209531498650565944,TRX_N-00283-65258323,2021-11-30T09:01:01,Donostia,Expense,transport,-138.81,109995.36
buyer_5,Sara,30,ES84209531498650565944,TRX_N-00284-27749857,2021-12-01T19:40:44,Donostia,transfer,Salary,3350.9,113346.26
buyer_5,Sara,30,ES84209531498650565944,TRX_N-00285-96465520,2021-12-01T19:40:44,Donostia,transfer,Partner Salary,3238.0,116584.26
buyer_5,Sara,30,ES84209531498650565944,TRX_N-00286-05296707,2021-12-01T19:40:44,Donostia,transfer,Extra Income,335.09,116919.35
buyer_5,Sara,30,ES84209531498650565944,TRX_N-00287-94274763,2021-12-01T19:40:44,Donostia,transfer,Bonus,3497.55,120416.9
buyer_5,Sara,30,ES84209531498650565944,TRX_N-00288-71935589,2021-12-03T11:56:49,Donostia,Expense,transport,-38.53,120378.37
buyer_5,Sara,30,ES84209531498650565944,TRX_N-00289-32173611,2021-12-05T08:36:57,Donostia,Housing,Mortgage,-1160.88,119217.49
buyer_5,Sara,30,ES84209531498650565944,TRX_N-00290-69526916,2021-12-05T21:45:12,Donostia,Basic services,water,-74.21,119143.28
buyer_5,Sara,30,ES84209531498650565944,TRX_N-00291-14294122,2021-12-05T13:55:05,Donostia,Basic services,electricity,-148.4,118994.88
buyer_5,Sara,30,ES84209531498650565944,TRX_N-00292-79990431,2021-12-05T16:00:39,Donostia,Basic services,gas,-46.04,118948.84
buyer_5,Sara,30,ES84209531498650565944,TRX_N-00293-29857869,2021-12-07T10:48:31,Donostia,Expense,food,-154.09,118794.75
buyer_5,Sara,30,ES84209531498650565944,TRX_N-00294-65428909,2021-12-21T12:23:29,Donostia,Expense,transport,-103.57,118691.18
buyer_5,Sara,30,ES84209531498650565944,TRX_N-00295-99754129,2021-12-22T19:20:37,Donostia,Expense,gifts,-181.08,118510.1
buyer_5,Sara,30,ES84209531498650565944,TRX_N-00296-52149271,2022-01-01T16:08:07,Donostia,transfer,Salary,3350.9,121861.0
buyer_5,Sara,30,ES84209531498650565944,TRX_N-00297-05784023,2022-01-01T16:08:07,Donostia,transfer,Partner Salary,3238.0,125099.0
buyer_5,Sara,30,ES84209531498650565944,TRX_N-00298-84505825,2022-01-05T19:09:34,Donostia,Housing,Mortgage,-1160.88,123938.12
buyer_5,Sara,30,ES84209531498650565944,TRX_N-00299-36987458,2022-01-05T18:30:09,Donostia,Basic services,water,-60.81,123877.31
buyer_5,Sara,30,ES84209531498650565944,TRX_N-00300-58625767,2022-01-05T17:07:31,Donostia,Basic services,electricity,-129.14,123748.17
buyer_5,Sara,30,ES84209531498650565944,TRX_N-00301-87585592,2022-01-05T20:33:09,Donostia,Basic services,gas,-81.6,123666.57
buyer_5,Sara,30,ES84209531498650565944,TRX_N-00302-61222379,2022-01-06T15:07:00,Donostia,Basic services,water,-33.03,123633.54
buyer_5,Sara,30,ES84209531498650565944,TRX_N-00303-40025629,2022-01-06T11:27:15,Donostia,Basic services,gas,-57.13,123576.41
buyer_5,Sara,30,ES84209531498650565944,TRX_N-00304-50285034,2022-01-06T17:09:35,Donostia,Basic services,internet,-75.89,123500.52
buyer_5,Sara,30,ES84209531498650565944,TRX_N-00305-15865328,2022-01-07T19:57:00,Donostia,Basic services,internet,-38.6,123461.92
buyer_5,Sara,30,ES84209531498650565944,TRX_N-00306-23913617,2022-01-21T10:01:20,Donostia,Expense,leisure,-195.27,123266.65
buyer_5,Sara,30,ES84209531498650565944,TRX_N-00307-43470794,2022-02-01T18:09:24,Donostia,transfer,Salary,3350.9,126617.55
buyer_5,Sara,30,ES84209531498650565944,TRX_N-00308-06314212,2022-02-01T18:09:24,Donostia,transfer,Partner Salary,3238.0,129855.55
buyer_5,Sara,30,ES84209531498650565944,TRX_N-00309-07915836,2022-02-05T14:07:55,Donostia,Housing,Mortgage,-1160.88,128694.67
buyer_5,Sara,30,ES84209531498650565944,TRX_N-00310-61708097,2022-02-06T09:32:20,Donostia,Basic services,gas,-29.94,128664.73
buyer_5,Sara,30,ES84209531498650565944,TRX_N-00311-83305351,2022-02-07T03:35:03,Donostia,Basic services,internet,-77.28,128587.45
buyer_5,Sara,30,ES84209531498650565944,TRX_N-00312-15684863,2022-02-07T07:55:50,Donostia,Basic services,phone,-89.8,128497.65
buyer_5,Sara,30,ES84209531498650565944,TRX_N-00313-62163767,2022-02-20T20:02:14,Donostia,Expense,gifts,-242.38,128255.27
buyer_5,Sara,30,ES84209531498650565944,TRX_N-00314-44222367,2022-02-25T02:40:52,Donostia,Expense,gifts,-256.41,127998.86
buyer_5,Sara,30,ES84209531498650565944,TRX_N-00315-39590194,2022-03-01T20:54:38,Donostia,transfer,Salary,3350.9,131349.76
buyer_5,Sara,30,ES84209531498650565944,TRX_N-00316-54373347,2022-03-01T20:54:38,Donostia,transfer,Partner Salary,3238.0,134587.76
buyer_5,Sara,30,ES84209531498650565944,TRX_N-00317-13961375,2022-03-01T20:54:38,Donostia,transfer,Extra Income,335.09,134922.85
buyer_5,Sara,30,ES84209531498650565944,TRX_N-00318-70665145,2022-03-02T05:58:51,Errenteria,Expense,gifts,-381.36,134541.49
buyer_5,Sara,30,ES84209531498650565944,TRX_N-00319-60276787,2022-03-05T10:49:10,Donostia,Housing,Mortgage,-1160.88,133380.61
buyer_5,Sara,30,ES84209531498650565944,TRX_N-00320-22816077,2022-03-05T17:55:54,Donostia,Basic services,water,-21.53,133359.08
buyer_5,Sara,30,ES84209531498650565944,TRX_N-00321-14222277,2022-03-05T12:16:26,Donostia,Basic services,internet,-52.39,133306.69
buyer_5,Sara,30,ES84209531498650565944,TRX_N-00322-79445582,2022-03-06T02:51:18,Donostia,Basic services,water,-45.77,133260.92
buyer_5,Sara,30,ES84209531498650565944,TRX_N-00323-66152119,2022-03-06T18:58:53,Donostia,Basic services,gas,-59.49,133201.43
buyer_5,Sara,30,ES84209531498650565944,TRX_N-00324-40049410,2022-03-07T17:39:38,Donostia,Expense,transport,-165.85,133035.58
buyer_5,Sara,30,ES84209531498650565944,TRX_N-00325-25775276,2022-03-08T13:34:17,Donostia,Expense,leisure,-223.12,132812.46
buyer_5,Sara,30,ES84209531498650565944,TRX_N-00326-03126927,2022-03-09T09:22:59,Donostia,Expense,food,-425.74,132386.72
buyer_5,Sara,30,ES84209531498650565944,TRX_N-00327-99594063,2022-04-01T08:46:41,Donostia,transfer,Salary,3350.9,135737.62
buyer_5,Sara,30,ES84209531498650565944,TRX_N-00328-62135012,2022-04-01T08:46:41,Donostia,transfer,Partner Salary,3238.0,138975.62
buyer_5,Sara,30,ES84209531498650565944,TRX_N-00329-47596249,2022-04-01T09:11:41,Donostia,Expense,clothing,-478.38,138497.24
buyer_5,Sara,30,ES84209531498650565944,TRX_N-00330-88825562,2022-04-02T13:09:21,Donostia,Expense,education,-362.15,138135.09
buyer_5,Sara,30,ES84209531498650565944,TRX_N-00331-38872827,2022-04-05T12:22:02,Donostia,Housing,Mortgage,-1160.88,136974.21
buyer_5,Sara,30,ES84209531498650565944,TRX_N-00332-47217088,2022-04-05T08:17:41,Donostia,Basic services,gas,-81.91,136892.3
buyer_5,Sara,30,ES84209531498650565944,TRX_N-00333-42383882,2022-04-06T13:09:21,Donostia,Basic services,internet,-56.64,136835.66
buyer_5,Sara,30,ES84209531498650565944,TRX_N-00334-02959714,2022-04-06T16:39:12,Donostia,Basic services,phone,-31.91,136803.75
buyer_5,Sara,30,ES84209531498650565944,TRX_N-00335-89532684,2022-04-06T23:11:35,Donostia,Expense,food,-445.36,136358.39
buyer_5,Sara,30,ES84209531498650565944,TRX_N-00336-88903166,2022-04-10T15:37:12,Donostia,Expense,leisure,-129.39,136229.0
buyer_5,Sara,30,ES84209531498650565944,TRX_N-00337-70990289,2022-04-10T15:21:30,Donostia,Expense,education,-246.14,135982.86
buyer_5,Sara,30,ES84209531498650565944,TRX_N-00338-38741847,2022-04-11T19:39:42,Barakaldo,Expense,food,-514.7,135468.16
buyer_5,Sara,30,ES84209531498650565944,TRX_N-00339-67701437,2022-04-24T07:10:51,Donostia,Expense,transport,-125.48,135342.68
buyer_5,Sara,30,ES84209531498650565944,TRX_N-00340-70231998,2022-04-30T11:12:22,Donostia,Expense,transport,-160.77,135181.91
buyer_5,Sara,30,ES84209531498650565944,TRX_N-00341-48937818,2022-05-01T10:11:50,Donostia,transfer,Salary,3350.9,138532.81
buyer_5,Sara,30,ES84209531498650565944,TRX_N-00342-54926646,2022-05-01T10:11:50,Donostia,transfer,Partner Salary,3238.0,141770.81
buyer_5,Sara,30,ES84209531498650565944,TRX_N-00343-44764737,2022-05-01T10:11:50,Donostia,transfer,Extra Income,335.09,142105.9
buyer_5,Sara,30,ES84209531498650565944,TRX_N-00344-94530307,2022-05-05T19:13:42,Donostia,Housing,Mortgage,-1160.88,140945.02
buyer_5,Sara,30,ES84209531498650565944,TRX_N-00345-52695859,2022-05-06T18:35:34,Donostia,Basic services,electricity,-104.28,140840.74
buyer_5,Sara,30,ES84209531498650565944,TRX_N-00346-57961454,2022-05-07T21:26:32,Donostia,Basic services,electricity,-127.82,140712.92
buyer_5,Sara,30,ES84209531498650565944,TRX_N-00347-55967098,2022-05-07T13:06:13,Donostia,Basic services,internet,-73.7,140639.22
buyer_5,Sara,30,ES84209531498650565944,TRX_N-00348-66221634,2022-05-07T11:42:06,Donostia,Basic services,phone,-71.13,140568.09
buyer_5,Sara,30,ES84209531498650565944,TRX_N-00349-18764169,2022-05-14T00:58:14,Salvatierra/Agurain,Expense,food,-420.24,140147.85
buyer_5,Sara,30,ES84209531498650565944,TRX_N-00350-66959463,2022-05-20T14:44:28,Donostia,Expense,leisure,-251.39,139896.46
buyer_5,Sara,30,ES84209531498650565944,TRX_N-00351-59470929,2022-05-27T17:31:10,Donostia,Expense,food,-136.32,139760.14
buyer_5,Sara,30,ES84209531498650565944,TRX_N-00352-16073422,2022-06-01T13:49:05,Donostia,transfer,Salary,3350.9,143111.04
buyer_5,Sara,30,ES84209531498650565944,TRX_N-00353-38648189,2022-06-01T13:49:05,Donostia,transfer,Partner Salary,3238.0,146349.04
buyer_5,Sara,30,ES84209531498650565944,TRX_N-00354-79241070,2022-06-01T13:49:05,Donostia,transfer,Bonus,3548.0,149897.04
buyer_5,Sara,30,ES84209531498650565944,TRX_N-00355-95651350,2022-06-05T20:02:55,Donostia,Housing,Mortgage,-1160.88,148736.16
buyer_5,Sara,30,ES84209531498650565944,TRX_N-00356-77452750,2022-06-05T23:34:21,Donostia,Basic services,internet,-41.72,148694.44
buyer_5,Sara,30,ES84209531498650565944,TRX_N-00357-94251067,2022-06-06T20:23:56,Donostia,Basic services,internet,-62.19,148632.25
buyer_5,Sara,30,ES84209531498650565944,TRX_N-00358-69722351,2022-06-06T17:13:10,Donostia,Basic services,phone,-79.88,148552.37
buyer_5,Sara,30,ES84209531498650565944,TRX_N-00359-40231855,2022-06-07T11:09:11,Donostia,Basic services,phone,-46.53,148505.84
buyer_5,Sara,30,ES84209531498650565944,TRX_N-00360-83909230,2022-06-30T11:18:33,Donostia,Expense,clothing,-347.81,148158.03
buyer_5,Sara,30,ES84209531498650565944,TRX_N-00361-32433164,2022-07-01T13:30:19,Donostia,transfer,Salary,3350.9,151508.93
buyer_5,Sara,30,ES84209531498650565944,TRX_N-00362-59306094,2022-07-01T13:30:19,Donostia,transfer,Partner Salary,3238.0,154746.93
buyer_5,Sara,30,ES84209531498650565944,TRX_N-00363-52371895,2022-07-05T20:29:10,Donostia,Housing,Mortgage,-1160.88,153586.05
buyer_5,Sara,30,ES84209531498650565944,TRX_N-00364-19287664,2022-07-05T10:04:14,Donostia,Basic services,water,-62.1,153523.95
buyer_5,Sara,30,ES84209531498650565944,TRX_N-00365-44653235,2022-07-05T13:56:23,Donostia,Basic services,internet,-77.87,153446.08
buyer_5,Sara,30,ES84209531498650565944,TRX_N-00366-01311994,2022-07-06T21:05:57,Donostia,Basic services,internet,-65.53,153380.55
buyer_5,Sara,30,ES84209531498650565944,TRX_N-00367-06035150,2022-07-06T16:05:51,Donostia,Basic services,phone,-95.46,153285.09
buyer_5,Sara,30,ES84209531498650565944,TRX_N-00368-26255001,2022-07-07T03:46:19,Donostia,Basic services,water,-53.09,153232.0
buyer_5,Sara,30,ES84209531498650565944,TRX_N-00369-21668766,2022-07-12T12:16:34,Portugalete,Expense,food,-612.11,152619.89
buyer_5,Sara,30,ES84209531498650565944,TRX_N-00370-45894696,2022-07-14T14:43:08,Donostia,Expense,clothing,-95.33,152524.56
buyer_5,Sara,30,ES84209531498650565944,TRX_N-00371-55848353,2022-07-25T17:54:54,Donostia,Expense,food,-175.07,152349.49
buyer_5,Sara,30,ES84209531498650565944,TRX_N-00372-42415996,2022-07-28T08:33:50,Donostia,Expense,healthcare,-241.8,152107.69
buyer_5,Sara,30,ES84209531498650565944,TRX_N-00373-31862168,2022-08-01T00:12:30,Donostia,transfer,Salary,3350.9,155458.59
buyer_5,Sara,30,ES84209531498650565944,TRX_N-00374-05708650,2022-08-01T00:12:30,Donostia,transfer,Partner Salary,3238.0,158696.59
buyer_5,Sara,30,ES84209531498650565944,TRX_N-00375-55488676,2022-08-01T00:12:30,Donostia,transfer,Extra Income,335.09,159031.68
buyer_5,Sara,30,ES84209531498650565944,TRX_N-00376-77596069,2022-08-05T17:23:05,Donostia,Housing,Mortgage,-1160.88,157870.8
buyer_5,Sara,30,ES84209531498650565944,TRX_N-00377-15824249,2022-08-05T14:22:59,Donostia,Basic services,gas,-35.34,157835.46
buyer_5,Sara,30,ES84209531498650565944,TRX_N-00378-75286629,2022-08-06T07:30:40,Donostia,Basic services,water,-59.89,157775.57
buyer_5,Sara,30,ES84209531498650565944,TRX_N-00379-46998748,2022-08-06T19:54:59,Donostia,Basic services,gas,-74.29,157701.28
buyer_5,Sara,30,ES84209531498650565944,TRX_N-00380-93840807,2022-08-06T12:21:12,Donostia,Basic services,internet,-62.3,157638.98
buyer_5,Sara,30,ES84209531498650565944,TRX_N-00381-84762810,2022-08-06T11:59:11,Donostia,Basic services,phone,-78.11,157560.87
buyer_5,Sara,30,ES84209531498650565944,TRX_N-00382-69573527,2022-08-07T16:58:24,Donostia,Basic services,internet,-76.41,157484.46
buyer_5,Sara,30,ES84209531498650565944,TRX_N-00383-42521676,2022-08-07T16:16:44,Donostia,Basic services,phone,-37.46,157447.0
buyer_5,Sara,30,ES84209531498650565944,TRX_N-00384-29642479,2022-08-11T19:01:08,Donostia,Expense,leisure,-263.06,157183.94
buyer_5,Sara,30,ES84209531498650565944,TRX_N-00385-89417430,2022-08-13T08:02:48,Donostia,Expense,food,-692.79,156491.15
buyer_5,Sara,30,ES84209531498650565944,TRX_N-00386-30562390,2022-09-01T20:55:17,Donostia,transfer,Salary,3350.9,159842.05
buyer_5,Sara,30,ES84209531498650565944,TRX_N-00387-27495991,2022-09-01T20:55:17,Donostia,transfer,Partner Salary,3238.0,163080.05
buyer_5,Sara,30,ES84209531498650565944,TRX_N-00388-65312524,2022-09-05T18:04:51,Donostia,Housing,Mortgage,-1160.88,161919.17
buyer_5,Sara,30,ES84209531498650565944,TRX_N-00389-78398672,2022-09-05T13:05:24,Donostia,Basic services,gas,-46.03,161873.14
buyer_5,Sara,30,ES84209531498650565944,TRX_N-00390-32072043,2022-09-05T12:16:30,Donostia,Basic services,phone,-72.99,161800.15
buyer_5,Sara,30,ES84209531498650565944,TRX_N-00391-54155282,2022-09-06T03:38:44,Donostia,Expense,food,-427.03,161373.12
buyer_5,Sara,30,ES84209531498650565944,TRX_N-00392-79594083,2022-09-07T10:20:01,Donostia,Basic services,gas,-21.83,161351.29
buyer_5,Sara,30,ES84209531498650565944,TRX_N-00393-43840556,2022-09-07T11:58:59,Donostia,Basic services,internet,-65.09,161286.2
buyer_5,Sara,30,ES84209531498650565944,TRX_N-00394-90864872,2022-09-07T08:59:59,Donostia,Basic services,phone,-51.89,161234.31
buyer_5,Sara,30,ES84209531498650565944,TRX_N-00395-33754801,2022-09-13T10:09:34,Donostia,Expense,leisure,-173.69,161060.62
buyer_5,Sara,30,ES84209531498650565944,TRX_N-00396-25294947,2022-09-19T20:19:14,Donostia,Expense,leisure,-169.86,160890.76
buyer_5,Sara,30,ES84209531498650565944,TRX_N-00397-81831269,2022-09-29T09:35:17,Donostia,Expense,transport,-27.22,160863.54
buyer_5,Sara,30,ES84209531498650565944,TRX_N-00398-65437167,2022-09-29T11:13:47,Donostia,Expense,leisure,-140.9,160722.64
buyer_5,Sara,30,ES84209531498650565944,TRX_N-00399-94455741,2022-09-30T08:07:52,Donostia,Expense,transport,-67.42,160655.22
buyer_5,Sara,30,ES84209531498650565944,TRX_N-00400-71752710,2022-10-01T21:09:09,Donostia,transfer,Salary,3350.9,164006.12
buyer_5,Sara,30,ES84209531498650565944,TRX_N-00401-55524304,2022-10-01T21:09:09,Donostia,transfer,Partner Salary,3238.0,167244.12
buyer_5,Sara,30,ES84209531498650565944,TRX_N-00402-83497001,2022-10-01T21:09:09,Donostia,transfer,Extra Income,335.09,167579.21
buyer_5,Sara,30,ES84209531498650565944,TRX_N-00403-65079482,2022-10-05T08:48:34,Donostia,Housing,Mortgage,-1160.88,166418.33
buyer_5,Sara,30,ES84209531498650565944,TRX_N-00404-85266165,2022-10-05T14:32:01,Donostia,Basic services,water,-74.44,166343.89
buyer_5,Sara,30,ES84209531498650565944,TRX_N-00405-14932189,2022-10-05T17:36:33,Donostia,Basic services,electricity,-83.73,166260.16
buyer_5,Sara,30,ES84209531498650565944,TRX_N-00406-49228783,2022-10-05T10:12:19,Donostia,Basic services,phone,-74.01,166186.15
buyer_5,Sara,30,ES84209531498650565944,TRX_N-00407-38260369,2022-10-06T18:41:56,Donostia,Basic services,water,-56.37,166129.78
buyer_5,Sara,30,ES84209531498650565944,TRX_N-00408-25320697,2022-10-06T08:09:46,Donostia,Basic services,gas,-36.68,166093.1
buyer_5,Sara,30,ES84209531498650565944,TRX_N-00409-36019286,2022-10-06T19:51:26,Donostia,Basic services,phone,-94.64,165998.46
buyer_5,Sara,30,ES84209531498650565944,TRX_N-00410-15849892,2022-10-17T10:56:17,Donostia,Expense,food,-413.09,165585.37
buyer_5,Sara,30,ES84209531498650565944,TRX_N-00411-33219901,2022-11-01T12:59:45,Donostia,transfer,Salary,3350.9,168936.27
buyer_5,Sara,30,ES84209531498650565944,TRX_N-00412-29840140,2022-11-01T12:59:45,Donostia,transfer,Partner Salary,3238.0,172174.27
buyer_5,Sara,30,ES84209531498650565944,TRX_N-00413-89331605,2022-11-01T17:01:18,Donostia,Expense,food,-752.57,171421.7
buyer_5,Sara,30,ES84209531498650565944,TRX_N-00414-54560916,2022-11-05T12:43:27,Donostia,Housing,Mortgage,-1160.88,170260.82
buyer_5,Sara,30,ES84209531498650565944,TRX_N-00415-95155270,2022-11-05T18:38:22,Donostia,Basic services,internet,-63.21,170197.61
buyer_5,Sara,30,ES84209531498650565944,TRX_N-00416-07567815,2022-11-05T11:37:31,Donostia,Basic services,phone,-93.39,170104.22
buyer_5,Sara,30,ES84209531498650565944,TRX_N-00417-79126856,2022-11-06T22:52:12,Donostia,Basic services,gas,-24.23,170079.99
buyer_5,Sara,30,ES84209531498650565944,TRX_N-00418-51524901,2022-11-07T16:57:09,Donostia,Basic services,water,-79.01,170000.98
buyer_5,Sara,30,ES84209531498650565944,TRX_N-00419-20652606,2022-11-07T12:50:21,Donostia,Basic services,internet,-79.65,169921.33
buyer_5,Sara,30,ES84209531498650565944,TRX_N-00420-98200887,2022-11-12T13:23:08,Donostia,Expense,transport,-44.35,169876.98
buyer_5,Sara,30,ES84209531498650565944,TRX_N-00421-15621376,2022-11-14T13:38:06,Donostia,Expense,transport,-129.73,169747.25
buyer_5,Sara,30,ES84209531498650565944,TRX_N-00422-33956024,2022-11-24T13:20:15,Getxo,Expense,transport,-102.09,169645.16
buyer_5,Sara,30,ES84209531498650565944,TRX_N-00423-82809736,2022-11-26T10:20:24,Bermeo,Expense,transport,-126.24,169518.92
buyer_5,Sara,30,ES84209531498650565944,TRX_N-00424-10837540,2022-12-01T11:23:22,Donostia,transfer,Salary,3350.9,172869.82
buyer_5,Sara,30,ES84209531498650565944,TRX_N-00425-24068981,2022-12-01T11:23:22,Donostia,transfer,Partner Salary,3238.0,176107.82
buyer_5,Sara,30,ES84209531498650565944,TRX_N-00426-04683744,2022-12-01T11:23:22,Donostia,transfer,Extra Income,335.09,176442.91
buyer_5,Sara,30,ES84209531498650565944,TRX_N-00427-31407436,2022-12-01T11:23:22,Donostia,transfer,Bonus,3091.08,179533.99
buyer_5,Sara,30,ES84209531498650565944,TRX_N-00428-01132541,2022-12-02T12:32:51,Donostia,Expense,leisure,-138.98,179395.01
buyer_5,Sara,30,ES84209531498650565944,TRX_N-00429-63870197,2022-12-02T19:39:55,Donostia,Expense,gifts,-244.03,179150.98
buyer_5,Sara,30,ES84209531498650565944,TRX_N-00430-09421477,2022-12-05T17:05:30,Donostia,Housing,Mortgage,-1160.88,177990.1
buyer_5,Sara,30,ES84209531498650565944,TRX_N-00431-43582151,2022-12-05T15:31:08,Donostia,Basic services,gas,-57.02,177933.08
buyer_5,Sara,30,ES84209531498650565944,TRX_N-00432-89651226,2022-12-05T17:07:11,Donostia,Basic services,internet,-39.97,177893.11
buyer_5,Sara,30,ES84209531498650565944,TRX_N-00433-41606901,2022-12-06T14:16:43,Donostia,Basic services,electricity,-24.5,177868.61
buyer_5,Sara,30,ES84209531498650565944,TRX_N-00434-24448108,2022-12-06T14:50:49,Donostia,Basic services,gas,-46.17,177822.44
buyer_5,Sara,30,ES84209531498650565944,TRX_N-00435-42366763,2022-12-06T12:03:41,Donostia,Basic services,phone,-83.39,177739.05
buyer_5,Sara,30,ES84209531498650565944,TRX_N-00436-10684462,2022-12-13T15:34:55,Donostia,Expense,food,-385.81,177353.24
buyer_5,Sara,30,ES84209531498650565944,TRX_N-00437-04663032,2022-12-31T15:36:59,Donostia,Expense,leisure,-117.92,177235.32
buyer_5,Sara,30,ES84209531498650565944,TRX_N-00438-75707931,2023-01-01T18:51:36,Donostia,transfer,Salary,3350.9,180586.22
buyer_5,Sara,30,ES84209531498650565944,TRX_N-00439-62956504,2023-01-01T18:51:36,Donostia,transfer,Partner Salary,3238.0,183824.22
buyer_5,Sara,30,ES84209531498650565944,TRX_N-00440-02820808,2023-01-03T20:01:19,Portugalete,Expense,leisure,-183.47,183640.75
buyer_5,Sara,30,ES84209531498650565944,TRX_N-00441-06712053,2023-01-05T18:27:31,Donostia,Housing,Mortgage,-1160.88,182479.87
buyer_5,Sara,30,ES84209531498650565944,TRX_N-00442-80473667,2023-01-05T15:50:48,Donostia,Basic services,internet,-67.12,182412.75
buyer_5,Sara,30,ES84209531498650565944,TRX_N-00443-60246373,2023-01-06T17:42:45,Donostia,Basic services,electricity,-72.65,182340.1
buyer_5,Sara,30,ES84209531498650565944,TRX_N-00444-33864039,2023-01-06T08:45:16,Donostia,Basic services,gas,-70.41,182269.69
buyer_5,Sara,30,ES84209531498650565944,TRX_N-00445-85462861,2023-01-06T15:05:53,Donostia,Basic services,internet,-35.36,182234.33
buyer_5,Sara,30,ES84209531498650565944,TRX_N-00446-26534299,2023-01-06T14:23:10,Donostia,Basic services,phone,-69.13,182165.2
buyer_5,Sara,30,ES84209531498650565944,TRX_N-00447-60614729,2023-01-07T21:11:31,Donostia,Basic services,gas,-78.98,182086.22
buyer_5,Sara,30,ES84209531498650565944,TRX_N-00448-32341419,2023-01-11T17:18:02,Durango,Expense,food,-658.74,181427.48
buyer_5,Sara,30,ES84209531498650565944,TRX_N-00449-19439183,2023-01-15T12:30:43,Galdakao,Expense,food,-314.71,181112.77
buyer_5,Sara,30,ES84209531498650565944,TRX_N-00450-50618894,2023-02-01T11:23:51,Donostia,transfer,Salary,3350.9,184463.67
buyer_5,Sara,30,ES84209531498650565944,TRX_N-00451-26754825,2023-02-01T11:23:51,Donostia,transfer,Partner Salary,3238.0,187701.67
buyer_5,Sara,30,ES84209531498650565944,TRX_N-00452-94245674,2023-02-01T10:06:24,Donostia,Expense,food,-328.2,187373.47
buyer_5,Sara,30,ES84209531498650565944,TRX_N-00453-07874869,2023-02-05T21:59:47,Donostia,Housing,Mortgage,-1160.88,186212.59
buyer_5,Sara,30,ES84209531498650565944,TRX_N-00454-25636597,2023-02-05T18:42:42,Donostia,Basic services,water,-52.55,186160.04
buyer_5,Sara,30,ES84209531498650565944,TRX_N-00455-85998381,2023-02-05T09:39:23,Donostia,Basic services,gas,-93.64,186066.4
buyer_5,Sara,30,ES84209531498650565944,TRX_N-00456-87723975,2023-02-06T14:10:00,Donostia,Basic services,electricity,-84.36,185982.04
buyer_5,Sara,30,ES84209531498650565944,TRX_N-00457-44803485,2023-02-07T16:08:13,Donostia,Basic services,water,-29.98,185952.06
buyer_5,Sara,30,ES84209531498650565944,TRX_N-00458-69477503,2023-02-07T13:59:17,Donostia,Basic services,gas,-78.2,185873.86
buyer_5,Sara,30,ES84209531498650565944,TRX_N-00459-28615925,2023-02-10T17:19:18,Donostia,Expense,healthcare,-23.81,185850.05
buyer_5,Sara,30,ES84209531498650565944,TRX_N-00460-01423785,2023-02-17T11:53:04,Donostia,Expense,food,-598.17,185251.88
buyer_5,Sara,30,ES84209531498650565944,TRX_N-00461-58127771,2023-03-01T20:35:47,Donostia,transfer,Salary,3350.9,188602.78
buyer_5,Sara,30,ES84209531498650565944,TRX_N-00462-59899797,2023-03-01T20:35:47,Donostia,transfer,Partner Salary,3238.0,191840.78
buyer_5,Sara,30,ES84209531498650565944,TRX_N-00463-93941375,2023-03-01T20:35:47,Donostia,transfer,Extra Income,335.09,192175.87
buyer_5,Sara,30,ES84209531498650565944,TRX_N-00464-25620774,2023-03-05T16:05:54,Donostia,Housing,Mortgage,-1160.88,191014.99
buyer_5,Sara,30,ES84209531498650565944,TRX_N-00465-70700840,2023-03-05T19:39:51,Donostia,Basic services,electricity,-109.51,190905.48
buyer_5,Sara,30,ES84209531498650565944,TRX_N-00466-39299789,2023-03-06T17:25:00,Donostia,Basic services,internet,-61.24,190844.24
buyer_5,Sara,30,ES84209531498650565944,TRX_N-00467-19184128,2023-03-07T12:14:18,Donostia,Basic services,electricity,-119.98,190724.26
buyer_5,Sara,30,ES84209531498650565944,TRX_N-00468-67104888,2023-03-07T08:53:22,Donostia,Basic services,internet,-45.19,190679.07
buyer_5,Sara,30,ES84209531498650565944,TRX_N-00469-69789915,2023-03-07T14:37:38,Donostia,Basic services,phone,-50.62,190628.45
buyer_5,Sara,30,ES84209531498650565944,TRX_N-00470-59509012,2023-03-11T17:04:01,Donostia,Expense,leisure,-18.95,190609.5
buyer_5,Sara,30,ES84209531498650565944,TRX_N-00471-23999387,2023-03-13T09:21:49,Donostia,Expense,gifts,-483.82,190125.68
buyer_5,Sara,30,ES84209531498650565944,TRX_N-00472-12189517,2023-03-18T16:10:45,Donostia,Expense,clothing,-277.85,189847.83
buyer_5,Sara,30,ES84209531498650565944,TRX_N-00473-25948465,2023-03-26T08:51:12,Donostia,Expense,gifts,-161.89,189685.94
buyer_5,Sara,30,ES84209531498650565944,TRX_N-00474-93645843,2023-04-01T10:35:29,Donostia,transfer,Salary,3350.9,193036.84
buyer_5,Sara,30,ES84209531498650565944,TRX_N-00475-42032733,2023-04-01T10:35:29,Donostia,transfer,Partner Salary,3238.0,196274.84
buyer_5,Sara,30,ES84209531498650565944,TRX_N-00476-76413496,2023-04-05T23:20:39,Donostia,Housing,Mortgage,-1160.88,195113.96
buyer_5,Sara,30,ES84209531498650565944,TRX_N-00477-31097329,2023-04-05T16:00:54,Donostia,Basic services,gas,-35.01,195078.95
buyer_5,Sara,30,ES84209531498650565944,TRX_N-00478-38317757,2023-04-06T19:38:17,Donostia,Basic services,water,-25.67,195053.28
buyer_5,Sara,30,ES84209531498650565944,TRX_N-00479-68136144,2023-04-06T15:06:22,Donostia,Basic services,electricity,-143.57,194909.71
buyer_5,Sara,30,ES84209531498650565944,TRX_N-00480-32116093,2023-04-06T15:24:20,Donostia,Basic services,phone,-95.52,194814.19
buyer_5,Sara,30,ES84209531498650565944,TRX_N-00481-92813597,2023-04-07T09:21:04,Donostia,Basic services,electricity,-76.57,194737.62
buyer_5,Sara,30,ES84209531498650565944,TRX_N-00482-77738004,2023-04-07T14:50:57,Donostia,Basic services,phone,-60.95,194676.67
buyer_5,Sara,30,ES84209531498650565944,TRX_N-00483-89633584,2023-04-09T17:35:39,Donostia,Expense,leisure,-180.65,194496.02
buyer_5,Sara,30,ES84209531498650565944,TRX_N-00484-92238399,2023-04-15T14:51:12,Donostia,Expense,leisure,-136.81,194359.21
buyer_5,Sara,30,ES84209531498650565944,TRX_N-00485-63410364,2023-04-20T11:21:08,Donostia,Expense,food,-493.06,193866.15
buyer_5,Sara,30,ES84209531498650565944,TRX_N-00486-30079653,2023-04-26T12:15:43,Donostia,Expense,leisure,-111.27,193754.88
buyer_5,Sara,30,ES84209531498650565944,TRX_N-00487-44535850,2023-05-01T11:23:22,Donostia,transfer,Salary,3350.9,197105.78
buyer_5,Sara,30,ES84209531498650565944,TRX_N-00488-93590277,2023-05-01T11:23:22,Donostia,transfer,Partner Salary,3238.0,200343.78
buyer_5,Sara,30,ES84209531498650565944,TRX_N-00489-14023850,2023-05-01T11:23:22,Donostia,transfer,Extra Income,335.09,200678.87
buyer_5,Sara,30,ES84209531498650565944,TRX_N-00490-44295321,2023-05-05T22:08:59,Donostia,Housing,Mortgage,-1160.88,199517.99
buyer_5,Sara,30,ES84209531498650565944,TRX_N-00491-48642459,2023-05-05T09:20:28,Donostia,Basic services,gas,-60.31,199457.68
buyer_5,Sara,30,ES84209531498650565944,TRX_N-00492-90924507,2023-05-06T08:19:44,Donostia,Basic services,water,-55.4,199402.28
buyer_5,Sara,30,ES84209531498650565944,TRX_N-00493-77531550,2023-05-06T19:06:56,Donostia,Basic services,phone,-56.72,199345.56
buyer_5,Sara,30,ES84209531498650565944,TRX_N-00494-43357743,2023-05-07T08:40:41,Donostia,Basic services,phone,-56.86,199288.7
buyer_5,Sara,30,ES84209531498650565944,TRX_N-00495-13571808,2023-06-01T09:34:25,Donostia,transfer,Salary,3350.9,202639.6
buyer_5,Sara,30,ES84209531498650565944,TRX_N-00496-32067445,2023-06-01T09:34:25,Donostia,transfer,Partner Salary,3238.0,205877.6
buyer_5,Sara,30,ES84209531498650565944,TRX_N-00497-90997932,2023-06-01T09:34:25,Donostia,transfer,Bonus,3625.35,209502.95
buyer_5,Sara,30,ES84209531498650565944,TRX_N-00498-95941585,2023-06-05T08:47:05,Donostia,Housing,Mortgage,-1160.88,208342.07
buyer_5,Sara,30,ES84209531498650565944,TRX_N-00499-69925945,2023-06-05T19:50:22,Donostia,Basic services,phone,-54.08,208287.99
buyer_5,Sara,30,ES84209531498650565944,TRX_N-00500-75506414,2023-06-06T19:15:20,Donostia,Basic services,gas,-86.01,208201.98
buyer_5,Sara,30,ES84209531498650565944,TRX_N-00501-31634945,2023-06-06T19:13:02,Donostia,Basic services,phone,-83.4,208118.58
buyer_5,Sara,30,ES84209531498650565944,TRX_N-00502-75621263,2023-06-06T15:27:38,Donostia,Expense,leisure,-223.57,207895.01
buyer_5,Sara,30,ES84209531498650565944,TRX_N-00503-87038537,2023-06-07T10:54:39,Donostia,Basic services,electricity,-34.56,207860.45
buyer_5,Sara,30,ES84209531498650565944,TRX_N-00504-34944009,2023-06-07T08:03:33,Donostia,Basic services,gas,-72.37,207788.08
buyer_5,Sara,30,ES84209531498650565944,TRX_N-00505-91358021,2023-06-18T20:52:20,Donostia,Expense,food,-406.14,207381.94
buyer_5,Sara,30,ES84209531498650565944,TRX_N-00506-21718902,2023-06-21T23:49:50,Irun,Expense,clothing,-346.32,207035.62
buyer_5,Sara,30,ES84209531498650565944,TRX_N-00507-69448856,2023-06-22T01:44:04,Vitoria-Gasteiz,Expense,transport,-144.3,206891.32
buyer_5,Sara,30,ES84209531498650565944,TRX_N-00508-52321316,2023-07-01T08:36:58,Donostia,transfer,Salary,3350.9,210242.22
buyer_5,Sara,30,ES84209531498650565944,TRX_N-00509-50070350,2023-07-01T08:36:58,Donostia,transfer,Partner Salary,3238.0,213480.22
buyer_5,Sara,30,ES84209531498650565944,TRX_N-00510-17443066,2023-07-01T05:31:19,Donostia,Expense,leisure,-34.08,213446.14
buyer_5,Sara,30,ES84209531498650565944,TRX_N-00511-89169751,2023-07-05T17:38:24,Donostia,Housing,Mortgage,-1160.88,212285.26
buyer_5,Sara,30,ES84209531498650565944,TRX_N-00512-38830396,2023-07-05T14:55:17,Donostia,Basic services,gas,-35.8,212249.46
buyer_5,Sara,30,ES84209531498650565944,TRX_N-00513-70349153,2023-07-05T13:51:15,Donostia,Basic services,internet,-39.95,212209.51
buyer_5,Sara,30,ES84209531498650565944,TRX_N-00514-18923067,2023-07-06T09:54:26,Donostia,Basic services,water,-74.85,212134.66
buyer_5,Sara,30,ES84209531498650565944,TRX_N-00515-82184588,2023-07-06T14:34:45,Donostia,Basic services,electricity,-66.12,212068.54
buyer_5,Sara,30,ES84209531498650565944,TRX_N-00516-57185010,2023-07-06T16:06:53,Donostia,Basic services,gas,-16.24,212052.3
buyer_5,Sara,30,ES84209531498650565944,TRX_N-00517-09058204,2023-07-07T19:14:46,Donostia,Basic services,phone,-84.15,211968.15
buyer_5,Sara,30,ES84209531498650565944,TRX_N-00518-08689203,2023-07-14T06:11:23,Donostia,Expense,transport,-54.41,211913.74
buyer_5,Sara,30,ES84209531498650565944,TRX_N-00519-74936659,2023-07-15T15:28:24,Donostia,Expense,leisure,-184.84,211728.9
buyer_5,Sara,30,ES84209531498650565944,TRX_N-00520-47681033,2023-07-18T13:09:14,Donostia,Expense,food,-285.42,211443.48
buyer_5,Sara,30,ES84209531498650565944,TRX_N-00521-29659087,2023-07-23T21:59:23,Donostia,Expense,clothing,-118.35,211325.13
buyer_5,Sara,30,ES84209531498650565944,TRX_N-00522-06658685,2023-08-01T19:42:55,Donostia,transfer,Salary,3350.9,214676.03
buyer_5,Sara,30,ES84209531498650565944,TRX_N-00523-55321514,2023-08-01T19:42:55,Donostia,transfer,Partner Salary,3238.0,217914.03
buyer_5,Sara,30,ES84209531498650565944,TRX_N-00524-40662880,2023-08-01T19:42:55,Donostia,transfer,Extra Income,335.09,218249.12
buyer_5,Sara,30,ES84209531498650565944,TRX_N-00525-75036000,2023-08-05T12:49:35,Donostia,Housing,Mortgage,-1160.88,217088.24
buyer_5,Sara,30,ES84209531498650565944,TRX_N-00526-77847412,2023-08-05T21:49:34,Donostia,Basic services,electricity,-33.47,217054.77
buyer_5,Sara,30,ES84209531498650565944,TRX_N-00527-29240689,2023-08-05T00:26:01,Donostia,Basic services,gas,-31.33,217023.44
buyer_5,Sara,30,ES84209531498650565944,TRX_N-00528-87837947,2023-08-05T16:31:47,Donostia,Basic services,phone,-61.27,216962.17
buyer_5,Sara,30,ES84209531498650565944,TRX_N-00529-12833760,2023-08-06T20:25:25,Donostia,Basic services,gas,-23.07,216939.1
buyer_5,Sara,30,ES84209531498650565944,TRX_N-00530-22896759,2023-08-08T09:21:54,Donostia,Expense,food,-279.16,216659.94
buyer_5,Sara,30,ES84209531498650565944,TRX_N-00531-96318692,2023-08-19T14:34:06,Donostia,Expense,leisure,-118.39,216541.55
buyer_5,Sara,30,ES84209531498650565944,TRX_N-00532-72657328,2023-08-21T19:16:03,Donostia,Expense,repairs,-100.66,216440.89
buyer_5,Sara,30,ES84209531498650565944,TRX_N-00533-71535716,2023-09-01T15:07:48,Donostia,transfer,Salary,3350.9,219791.79
buyer_5,Sara,30,ES84209531498650565944,TRX_N-00534-50532569,2023-09-01T15:07:48,Donostia,transfer,Partner Salary,3238.0,223029.79
buyer_5,Sara,30,ES84209531498650565944,TRX_N-00535-72371275,2023-09-02T17:27:05,Donostia,Expense,clothing,-387.73,222642.06
buyer_5,Sara,30,ES84209531498650565944,TRX_N-00536-44683870,2023-09-05T11:47:06,Donostia,Housing,Mortgage,-1160.88,221481.18
buyer_5,Sara,30,ES84209531498650565944,TRX_N-00537-43838423,2023-09-06T10:16:26,Donostia,Basic services,electricity,-134.01,221347.17
buyer_5,Sara,30,ES84209531498650565944,TRX_N-00538-25400229,2023-09-06T09:46:47,Donostia,Basic services,phone,-46.81,221300.36
buyer_5,Sara,30,ES84209531498650565944,TRX_N-00539-09743315,2023-09-07T17:21:39,Donostia,Basic services,water,-13.81,221286.55
buyer_5,Sara,30,ES84209531498650565944,TRX_N-00540-70601824,2023-09-20T00:03:07,Galdakao,Expense,education,-784.79,220501.76
buyer_5,Sara,30,ES84209531498650565944,TRX_N-00541-50100841,2023-09-25T15:01:22,Basauri,Expense,healthcare,-159.66,220342.1
buyer_5,Sara,30,ES84209531498650565944,TRX_N-00542-37652749,2023-09-28T10:53:27,Donostia,Expense,food,-358.56,219983.54
buyer_5,Sara,30,ES84209531498650565944,TRX_N-00543-08991302,2023-10-01T10:12:09,Donostia,transfer,Salary,3350.9,223334.44
buyer_5,Sara,30,ES84209531498650565944,TRX_N-00544-04037455,2023-10-01T10:12:09,Donostia,transfer,Partner Salary,3238.0,226572.44
buyer_5,Sara,30,ES84209531498650565944,TRX_N-00545-72961949,2023-10-01T10:12:09,Donostia,transfer,Extra Income,335.09,226907.53
buyer_5,Sara,30,ES84209531498650565944,TRX_N-00546-56112221,2023-10-05T06:22:59,Donostia,Housing,Mortgage,-1160.88,225746.65
buyer_5,Sara,30,ES84209531498650565944,TRX_N-00547-05189980,2023-10-05T15:26:25,Donostia,Basic services,gas,-91.94,225654.71
buyer_5,Sara,30,ES84209531498650565944,TRX_N-00548-98972073,2023-10-07T18:03:07,Donostia,Basic services,water,-73.3,225581.41
buyer_5,Sara,30,ES84209531498650565944,TRX_N-00549-20726042,2023-10-07T18:00:39,Donostia,Basic services,electricity,-38.84,225542.57
buyer_5,Sara,30,ES84209531498650565944,TRX_N-00550-41653679,2023-10-10T12:56:53,Donostia,Expense,clothing,-474.84,225067.73
buyer_5,Sara,30,ES84209531498650565944,TRX_N-00551-94454097,2023-10-31T21:31:52,Donostia,Expense,transport,-88.8,224978.93
buyer_5,Sara,30,ES84209531498650565944,TRX_N-00552-54660620,2023-11-01T08:38:19,Donostia,transfer,Salary,3350.9,228329.83
buyer_5,Sara,30,ES84209531498650565944,TRX_N-00553-59484797,2023-11-01T08:38:19,Donostia,transfer,Partner Salary,3238.0,231567.83
buyer_5,Sara,30,ES84209531498650565944,TRX_N-00554-30038796,2023-11-05T22:41:54,Donostia,Housing,Mortgage,-1160.88,230406.95
buyer_5,Sara,30,ES84209531498650565944,TRX_N-00555-52385947,2023-11-06T10:02:02,Donostia,Basic services,gas,-24.64,230382.31
buyer_5,Sara,30,ES84209531498650565944,TRX_N-00556-55539766,2023-11-06T20:28:31,Donostia,Basic services,internet,-58.25,230324.06
buyer_5,Sara,30,ES84209531498650565944,TRX_N-00557-64413090,2023-11-07T18:27:11,Donostia,Basic services,water,-35.75,230288.31
buyer_5,Sara,30,ES84209531498650565944,TRX_N-00558-37167673,2023-11-21T15:54:25,Donostia,Expense,leisure,-145.61,230142.7
buyer_5,Sara,30,ES84209531498650565944,TRX_N-00559-30524931,2023-11-23T20:06:07,Donostia,Expense,transport,-85.94,230056.76
buyer_5,Sara,30,ES84209531498650565944,TRX_N-00560-43106868,2023-11-25T14:25:07,Donostia,Expense,education,-182.82,229873.94
buyer_5,Sara,30,ES84209531498650565944,TRX_N-00561-47024245,2023-12-01T10:10:42,Donostia,transfer,Salary,3350.9,233224.84
buyer_5,Sara,30,ES84209531498650565944,TRX_N-00562-14512348,2023-12-01T10:10:42,Donostia,transfer,Partner Salary,3238.0,236462.84
buyer_5,Sara,30,ES84209531498650565944,TRX_N-00563-22725112,2023-12-01T10:10:42,Donostia,transfer,Extra Income,335.09,236797.93
buyer_5,Sara,30,ES84209531498650565944,TRX_N-00564-03301687,2023-12-01T10:10:42,Donostia,transfer,Bonus,3401.11,240199.04
buyer_5,Sara,30,ES84209531498650565944,TRX_N-00565-30039441,2023-12-05T23:53:41,Donostia,Housing,Mortgage,-1160.88,239038.16
buyer_5,Sara,30,ES84209531498650565944,TRX_N-00566-63935500,2023-12-06T18:03:19,Donostia,Basic services,phone,-51.55,238986.61
buyer_5,Sara,30,ES84209531498650565944,TRX_N-00567-33200663,2023-12-07T09:09:28,Donostia,Basic services,water,-24.08,238962.53
buyer_5,Sara,30,ES84209531498650565944,TRX_N-00568-37408933,2023-12-07T11:57:13,Donostia,Basic services,electricity,-50.78,238911.75
buyer_5,Sara,30,ES84209531498650565944,TRX_N-00569-80866131,2023-12-07T15:57:28,Donostia,Expense,education,-666.14,238245.61
buyer_5,Sara,30,ES84209531498650565944,TRX_N-00570-28084434,2023-12-09T09:40:28,Elciego,Expense,food,-359.97,237885.64
buyer_5,Sara,30,ES84209531498650565944,TRX_N-00571-94613966,2023-12-25T10:54:13,Donostia,Expense,transport,-39.52,237846.12
buyer_5,Sara,30,ES84209531498650565944,TRX_N-00572-89602256,2024-01-01T16:55:30,Donostia,transfer,Salary,3350.9,241197.02
buyer_5,Sara,30,ES84209531498650565944,TRX_N-00573-20038242,2024-01-01T16:55:30,Donostia,transfer,Partner Salary,3238.0,244435.02
buyer_5,Sara,30,ES84209531498650565944,TRX_N-00574-20578569,2024-01-02T15:53:02,Donostia,Expense,food,-459.12,243975.9
buyer_5,Sara,30,ES84209531498650565944,TRX_N-00575-57308143,2024-01-05T11:41:15,Donostia,Housing,Mortgage,-1160.88,242815.02
buyer_5,Sara,30,ES84209531498650565944,TRX_N-00576-17183098,2024-01-05T08:22:48,Donostia,Basic services,water,-30.97,242784.05
buyer_5,Sara,30,ES84209531498650565944,TRX_N-00577-66352267,2024-01-05T11:24:44,Donostia,Basic services,gas,-58.76,242725.29
buyer_5,Sara,30,ES84209531498650565944,TRX_N-00578-88603375,2024-01-06T13:41:04,Donostia,Basic services,electricity,-112.69,242612.6
buyer_5,Sara,30,ES84209531498650565944,TRX_N-00579-77142372,2024-01-06T12:53:35,Donostia,Basic services,phone,-98.76,242513.84
buyer_5,Sara,30,ES84209531498650565944,TRX_N-00580-40326132,2024-01-07T13:25:15,Donostia,Basic services,gas,-15.6,242498.24
buyer_5,Sara,30,ES84209531498650565944,TRX_N-00581-15079480,2024-01-18T18:02:29,Donostia,Expense,gifts,-81.8,242416.44
buyer_5,Sara,30,ES84209531498650565944,TRX_N-00582-28504535,2024-01-24T13:34:04,Alegría-Dulantzi,Expense,leisure,-207.08,242209.36
buyer_5,Sara,30,ES84209531498650565944,TRX_N-00583-87396640,2024-01-25T11:06:53,Irun,Expense,leisure,-74.2,242135.16
buyer_5,Sara,30,ES84209531498650565944,TRX_N-00584-38183263,2024-02-01T15:11:58,Donostia,transfer,Salary,3350.9,245486.06
buyer_5,Sara,30,ES84209531498650565944,TRX_N-00585-28468823,2024-02-01T15:11:58,Donostia,transfer,Partner Salary,3238.0,248724.06
buyer_5,Sara,30,ES84209531498650565944,TRX_N-00586-60642243,2024-02-05T18:23:18,Donostia,Housing,Mortgage,-1160.88,247563.18
buyer_5,Sara,30,ES84209531498650565944,TRX_N-00587-91033451,2024-02-05T15:13:31,Donostia,Basic services,internet,-79.39,247483.79
buyer_5,Sara,30,ES84209531498650565944,TRX_N-00588-82226800,2024-02-05T13:09:23,Donostia,Basic services,phone,-38.85,247444.94
buyer_5,Sara,30,ES84209531498650565944,TRX_N-00589-42443315,2024-02-06T12:59:55,Donostia,Basic services,water,-18.15,247426.79
buyer_5,Sara,30,ES84209531498650565944,TRX_N-00590-85000021,2024-02-06T13:13:38,Donostia,Basic services,phone,-25.45,247401.34
buyer_5,Sara,30,ES84209531498650565944,TRX_N-00591-83286732,2024-02-09T16:29:57,Donostia,Expense,transport,-59.86,247341.48
buyer_5,Sara,30,ES84209531498650565944,TRX_N-00592-98297802,2024-02-14T22:36:11,Donostia,Expense,leisure,-229.51,247111.97
buyer_5,Sara,30,ES84209531498650565944,TRX_N-00593-98635280,2024-02-16T15:13:48,Donostia,Expense,food,-389.24,246722.73
buyer_5,Sara,30,ES84209531498650565944,TRX_N-00594-48132575,2024-02-16T19:37:33,Donostia,Expense,transport,-28.94,246693.79
buyer_5,Sara,30,ES84209531498650565944,TRX_N-00595-38384285,2024-02-22T13:24:40,Donostia,Expense,transport,-185.45,246508.34
buyer_5,Sara,30,ES84209531498650565944,TRX_N-00596-43297018,2024-03-01T18:17:37,Donostia,transfer,Salary,3350.9,249859.24
buyer_5,Sara,30,ES84209531498650565944,TRX_N-00597-26702832,2024-03-01T18:17:37,Donostia,transfer,Partner Salary,3238.0,253097.24
buyer_5,Sara,30,ES84209531498650565944,TRX_N-00598-23740648,2024-03-01T18:17:37,Donostia,transfer,Extra Income,335.09,253432.33
buyer_5,Sara,30,ES84209531498650565944,TRX_N-00599-74254210,2024-03-05T09:33:07,Donostia,Housing,Mortgage,-1160.88,252271.45
buyer_5,Sara,30,ES84209531498650565944,TRX_N-00600-40360234,2024-03-05T01:35:45,Donostia,Basic services,internet,-57.26,252214.19
buyer_5,Sara,30,ES84209531498650565944,TRX_N-00601-85554150,2024-03-05T18:24:15,Donostia,Basic services,phone,-86.9,252127.29
buyer_5,Sara,30,ES84209531498650565944,TRX_N-00602-99732415,2024-03-06T16:30:23,Donostia,Basic services,water,-68.08,252059.21
buyer_5,Sara,30,ES84209531498650565944,TRX_N-00603-38256736,2024-03-06T09:06:04,Donostia,Basic services,phone,-38.31,252020.9
buyer_5,Sara,30,ES84209531498650565944,TRX_N-00604-60633281,2024-03-06T20:22:01,Donostia,Expense,healthcare,-214.19,251806.71
buyer_5,Sara,30,ES84209531498650565944,TRX_N-00605-53640345,2024-03-07T12:56:13,Donostia,Basic services,gas,-41.71,251765.0
buyer_5,Sara,30,ES84209531498650565944,TRX_N-00606-03670314,2024-04-01T13:55:45,Donostia,transfer,Salary,3350.9,255115.9
buyer_5,Sara,30,ES84209531498650565944,TRX_N-00607-06606693,2024-04-01T13:55:45,Donostia,transfer,Partner Salary,3238.0,258353.9
buyer_5,Sara,30,ES84209531498650565944,TRX_N-00608-93130527,2024-04-02T16:18:36,Donostia,Expense,food,-640.78,257713.12
buyer_5,Sara,30,ES84209531498650565944,TRX_N-00609-32153005,2024-04-05T20:02:30,Donostia,Housing,Mortgage,-1160.88,256552.24
buyer_5,Sara,30,ES84209531498650565944,TRX_N-00610-10415291,2024-04-05T18:20:17,Donostia,Basic services,electricity,-123.64,256428.6
buyer_5,Sara,30,ES84209531498650565944,TRX_N-00611-24745203,2024-04-05T20:25:01,Donostia,Basic services,gas,-21.74,256406.86
buyer_5,Sara,30,ES84209531498650565944,TRX_N-00612-82152346,2024-04-05T10:38:21,Donostia,Basic services,internet,-34.12,256372.74
buyer_5,Sara,30,ES84209531498650565944,TRX_N-00613-10164779,2024-04-05T09:30:03,Donostia,Basic services,phone,-51.09,256321.65
buyer_5,Sara,30,ES84209531498650565944,TRX_N-00614-68739489,2024-04-06T04:42:58,Donostia,Basic services,internet,-51.08,256270.57
buyer_5,Sara,30,ES84209531498650565944,TRX_N-00615-61069156,2024-04-07T18:22:22,Donostia,Basic services,electricity,-48.8,256221.77
buyer_5,Sara,30,ES84209531498650565944,TRX_N-00616-68969522,2024-04-09T17:53:36,Donostia,Expense,transport,-97.32,256124.45
buyer_5,Sara,30,ES84209531498650565944,TRX_N-00617-59747256,2024-04-12T16:31:16,Donostia,Expense,gifts,-278.14,255846.31
buyer_5,Sara,30,ES84209531498650565944,TRX_N-00618-53437289,2024-04-18T12:56:50,Donostia,Expense,transport,-40.2,255806.11
buyer_5,Sara,30,ES84209531498650565944,TRX_N-00619-73584100,2024-04-25T08:50:04,Donostia,Expense,food,-411.69,255394.42
buyer_5,Sara,30,ES84209531498650565944,TRX_N-00620-15582513,2024-04-29T14:20:34,Arrasate,Expense,food,-773.81,254620.61
buyer_5,Sara,30,ES84209531498650565944,TRX_N-00621-36776274,2024-05-01T13:36:22,Donostia,transfer,Salary,3350.9,257971.51
buyer_5,Sara,30,ES84209531498650565944,TRX_N-00622-41218761,2024-05-01T13:36:22,Donostia,transfer,Partner Salary,3238.0,261209.51
buyer_5,Sara,30,ES84209531498650565944,TRX_N-00623-62016348,2024-05-01T13:36:22,Donostia,transfer,Extra Income,335.09,261544.6
buyer_5,Sara,30,ES84209531498650565944,TRX_N-00624-05731725,2024-05-05T02:17:54,Donostia,Housing,Mortgage,-1160.88,260383.72
buyer_5,Sara,30,ES84209531498650565944,TRX_N-00625-45620237,2024-05-05T10:38:07,Donostia,Basic services,water,-55.32,260328.4
buyer_5,Sara,30,ES84209531498650565944,TRX_N-00626-79256566,2024-05-05T23:07:17,Donostia,Basic services,phone,-50.88,260277.52
buyer_5,Sara,30,ES84209531498650565944,TRX_N-00627-38472730,2024-05-06T17:48:43,Donostia,Basic services,water,-21.92,260255.6
buyer_5,Sara,30,ES84209531498650565944,TRX_N-00628-59893977,2024-05-06T15:45:06,Donostia,Basic services,gas,-35.97,260219.63
buyer_5,Sara,30,ES84209531498650565944,TRX_N-00629-75552821,2024-05-06T19:09:05,Donostia,Basic services,internet,-61.39,260158.24
buyer_5,Sara,30,ES84209531498650565944,TRX_N-00630-50539274,2024-05-10T17:29:28,Barakaldo,Expense,clothing,-438.92,259719.32
buyer_5,Sara,30,ES84209531498650565944,TRX_N-00631-46002616,2024-05-21T14:14:15,Donostia,Expense,transport,-33.37,259685.95
buyer_5,Sara,30,ES84209531498650565944,TRX_N-00632-75421383,2024-06-01T12:56:51,Donostia,transfer,Salary,3350.9,263036.85
buyer_5,Sara,30,ES84209531498650565944,TRX_N-00633-24747765,2024-06-01T12:56:51,Donostia,transfer,Partner Salary,3238.0,266274.85
buyer_5,Sara,30,ES84209531498650565944,TRX_N-00634-87830818,2024-06-01T12:56:51,Donostia,transfer,Bonus,3132.0,269406.85
buyer_5,Sara,30,ES84209531498650565944,TRX_N-00635-96548360,2024-06-05T16:12:40,Donostia,Housing,Mortgage,-1160.88,268245.97
buyer_5,Sara,30,ES84209531498650565944,TRX_N-00636-69084569,2024-06-05T13:49:46,Donostia,Basic services,electricity,-80.11,268165.86
buyer_5,Sara,30,ES84209531498650565944,TRX_N-00637-00701391,2024-06-05T17:44:24,Donostia,Basic services,gas,-41.78,268124.08
buyer_5,Sara,30,ES84209531498650565944,TRX_N-00638-38123408,2024-06-06T19:59:49,Donostia,Basic services,water,-69.48,268054.6
buyer_5,Sara,30,ES84209531498650565944,TRX_N-00639-11808808,2024-06-07T19:02:00,Donostia,Basic services,electricity,-86.12,267968.48
buyer_5,Sara,30,ES84209531498650565944,TRX_N-00640-67128298,2024-06-07T12:14:52,Donostia,Basic services,internet,-44.38,267924.1
buyer_5,Sara,30,ES84209531498650565944,TRX_N-00641-78262968,2024-06-07T19:14:43,Donostia,Basic services,phone,-55.0,267869.1
buyer_5,Sara,30,ES84209531498650565944,TRX_N-00642-45290857,2024-06-11T18:33:59,Donostia,Expense,clothing,-193.77,267675.33
buyer_5,Sara,30,ES84209531498650565944,TRX_N-00643-52038766,2024-06-22T15:37:32,Donostia,Expense,leisure,-35.89,267639.44
buyer_5,Sara,30,ES84209531498650565944,TRX_N-00644-60288858,2024-07-01T16:34:03,Donostia,transfer,Salary,3350.9,270990.34
buyer_5,Sara,30,ES84209531498650565944,TRX_N-00645-63204603,2024-07-01T16:34:03,Donostia,transfer,Partner Salary,3238.0,274228.34
buyer_5,Sara,30,ES84209531498650565944,TRX_N-00646-61321685,2024-07-05T09:57:06,Donostia,Housing,Mortgage,-1160.88,273067.46
buyer_5,Sara,30,ES84209531498650565944,TRX_N-00647-55613518,2024-07-05T10:37:42,Zarautz,Expense,education,-359.23,272708.23
buyer_5,Sara,30,ES84209531498650565944,TRX_N-00648-12321018,2024-07-06T11:06:46,Donostia,Basic services,water,-47.18,272661.05
buyer_5,Sara,30,ES84209531498650565944,TRX_N-00649-57093202,2024-07-06T10:57:26,Donostia,Basic services,gas,-95.41,272565.64
buyer_5,Sara,30,ES84209531498650565944,TRX_N-00650-19981024,2024-07-06T18:01:50,Donostia,Basic services,internet,-56.92,272508.72
buyer_5,Sara,30,ES84209531498650565944,TRX_N-00651-23442985,2024-07-07T13:33:02,Donostia,Basic services,gas,-35.01,272473.71
buyer_5,Sara,30,ES84209531498650565944,TRX_N-00652-70688562,2024-07-07T15:55:15,Donostia,Basic services,internet,-66.4,272407.31
buyer_5,Sara,30,ES84209531498650565944,TRX_N-00653-76736835,2024-07-07T17:24:16,Donostia,Basic services,phone,-68.11,272339.2
buyer_5,Sara,30,ES84209531498650565944,TRX_N-00654-45205217,2024-07-14T14:49:05,Donostia,Expense,food,-407.05,271932.15
buyer_5,Sara,30,ES84209531498650565944,TRX_N-00655-45564540,2024-07-17T20:31:26,Donostia,Expense,clothing,-456.01,271476.14
buyer_5,Sara,30,ES84209531498650565944,TRX_N-00656-43975366,2024-07-22T23:24:45,Donostia,Expense,transport,-151.09,271325.05
buyer_5,Sara,30,ES84209531498650565944,TRX_N-00657-43136258,2024-07-27T14:45:34,Donostia,Expense,gifts,-450.84,270874.21
buyer_5,Sara,30,ES84209531498650565944,TRX_N-00658-79806763,2024-08-01T16:17:26,Donostia,transfer,Salary,3350.9,274225.11
buyer_5,Sara,30,ES84209531498650565944,TRX_N-00659-80987010,2024-08-01T16:17:26,Donostia,transfer,Partner Salary,3238.0,277463.11
buyer_5,Sara,30,ES84209531498650565944,TRX_N-00660-72230700,2024-08-01T16:17:26,Donostia,transfer,Extra Income,335.09,277798.2
buyer_5,Sara,30,ES84209531498650565944,TRX_N-00661-70330474,2024-08-05T17:17:40,Donostia,Housing,Mortgage,-1160.88,276637.32
buyer_5,Sara,30,ES84209531498650565944,TRX_N-00662-52493629,2024-08-05T19:01:43,Donostia,Basic services,water,-63.14,276574.18
buyer_5,Sara,30,ES84209531498650565944,TRX_N-00663-18569339,2024-08-05T16:37:50,Donostia,Basic services,gas,-91.44,276482.74
buyer_5,Sara,30,ES84209531498650565944,TRX_N-00664-89330050,2024-08-05T14:32:18,Donostia,Basic services,internet,-62.25,276420.49
buyer_5,Sara,30,ES84209531498650565944,TRX_N-00665-60176932,2024-08-06T15:43:32,Donostia,Basic services,electricity,-79.4,276341.09
buyer_5,Sara,30,ES84209531498650565944,TRX_N-00666-38011054,2024-08-07T17:56:30,Donostia,Basic services,gas,-37.68,276303.41
buyer_5,Sara,30,ES84209531498650565944,TRX_N-00667-24277442,2024-08-07T10:28:08,Donostia,Basic services,internet,-66.38,276237.03
buyer_5,Sara,30,ES84209531498650565944,TRX_N-00668-17273415,2024-08-07T16:46:58,Donostia,Basic services,phone,-97.48,276139.55
buyer_5,Sara,30,ES84209531498650565944,TRX_N-00669-57818255,2024-08-10T16:12:47,Alegría-Dulantzi,Expense,healthcare,-201.6,275937.95
buyer_5,Sara,30,ES84209531498650565944,TRX_N-00670-50856303,2024-08-11T21:48:53,Elciego,Expense,gifts,-204.2,275733.75
buyer_5,Sara,30,ES84209531498650565944,TRX_N-00671-44998775,2024-08-24T19:53:54,Donostia,Expense,transport,-91.53,275642.22
buyer_5,Sara,30,ES84209531498650565944,TRX_N-00672-59001517,2024-09-01T18:23:13,Donostia,transfer,Salary,3350.9,278993.12
buyer_5,Sara,30,ES84209531498650565944,TRX_N-00673-55729599,2024-09-01T18:23:13,Donostia,transfer,Partner Salary,3238.0,282231.12
buyer_5,Sara,30,ES84209531498650565944,TRX_N-00674-81639089,2024-09-03T20:05:33,Donostia,Expense,food,-166.71,282064.41
buyer_5,Sara,30,ES84209531498650565944,TRX_N-00675-55029610,2024-09-03T14:03:53,Donostia,Expense,leisure,-186.4,281878.01
buyer_5,Sara,30,ES84209531498650565944,TRX_N-00676-49435499,2024-09-05T11:26:42,Donostia,Housing,Mortgage,-1160.88,280717.13
buyer_5,Sara,30,ES84209531498650565944,TRX_N-00677-76815478,2024-09-05T13:16:20,Donostia,Basic services,electricity,-61.27,280655.86
buyer_5,Sara,30,ES84209531498650565944,TRX_N-00678-51903199,2024-09-06T17:49:37,Donostia,Basic services,water,-13.36,280642.5
buyer_5,Sara,30,ES84209531498650565944,TRX_N-00679-34217770,2024-09-06T15:26:11,Donostia,Basic services,gas,-98.71,280543.79
buyer_5,Sara,30,ES84209531498650565944,TRX_N-00680-98453042,2024-09-06T18:32:52,Donostia,Basic services,phone,-85.43,280458.36
buyer_5,Sara,30,ES84209531498650565944,TRX_N-00681-12553581,2024-09-07T16:20:20,Donostia,Basic services,electricity,-68.85,280389.51
buyer_5,Sara,30,ES84209531498650565944,TRX_N-00682-58680027,2024-09-07T01:02:19,Donostia,Basic services,internet,-30.43,280359.08
buyer_5,Sara,30,ES84209531498650565944,TRX_N-00683-62866311,2024-09-07T10:03:34,Donostia,Basic services,phone,-87.16,280271.92
buyer_5,Sara,30,ES84209531498650565944,TRX_N-00684-82948909,2024-09-10T23:44:41,Donostia,Expense,gifts,-358.55,279913.37
buyer_5,Sara,30,ES84209531498650565944,TRX_N-00685-29268559,2024-09-20T23:00:52,Donostia,Expense,repairs,-836.91,279076.46
buyer_5,Sara,30,ES84209531498650565944,TRX_N-00686-80029595,2024-10-01T22:31:22,Donostia,transfer,Salary,3350.9,282427.36
buyer_5,Sara,30,ES84209531498650565944,TRX_N-00687-81842393,2024-10-01T22:31:22,Donostia,transfer,Partner Salary,3238.0,285665.36
buyer_5,Sara,30,ES84209531498650565944,TRX_N-00688-26954612,2024-10-01T22:31:22,Donostia,transfer,Extra Income,335.09,286000.45
buyer_5,Sara,30,ES84209531498650565944,TRX_N-00689-73707816,2024-10-02T11:33:43,Bermeo,Expense,healthcare,-96.69,285903.76
buyer_5,Sara,30,ES84209531498650565944,TRX_N-00690-99944669,2024-10-05T17:13:57,Donostia,Housing,Mortgage,-1160.88,284742.88
buyer_5,Sara,30,ES84209531498650565944,TRX_N-00691-36446364,2024-10-05T17:13:54,Donostia,Basic services,water,-76.34,284666.54
buyer_5,Sara,30,ES84209531498650565944,TRX_N-00692-40349003,2024-10-05T09:32:55,Donostia,Basic services,electricity,-64.32,284602.22
buyer_5,Sara,30,ES84209531498650565944,TRX_N-00693-89607217,2024-10-06T10:17:25,Donostia,Basic services,water,-76.24,284525.98
buyer_5,Sara,30,ES84209531498650565944,TRX_N-00694-62718665,2024-10-06T21:16:27,Donostia,Basic services,internet,-45.02,284480.96
buyer_5,Sara,30,ES84209531498650565944,TRX_N-00695-35799272,2024-10-06T08:15:39,Donostia,Basic services,phone,-28.01,284452.95
buyer_5,Sara,30,ES84209531498650565944,TRX_N-00696-68555172,2024-10-07T10:21:36,Donostia,Basic services,gas,-29.51,284423.44
buyer_6,Manuel,45,ES79209522434513654615,TRX_N-00001-94632628,2020-01-01T19:05:47,Vitoria-Gasteiz,transfer,Salary,1463.83,2183.81
buyer_6,Manuel,45,ES79209522434513654615,TRX_N-00002-92798715,2020-01-05T11:25:58,Vitoria-Gasteiz,Housing,Rent,-911.35,1272.46
buyer_6,Manuel,45,ES79209522434513654615,TRX_N-00003-26366454,2020-01-05T18:06:53,Vitoria-Gasteiz,Basic services,phone,-63.56,1208.9
buyer_6,Manuel,45,ES79209522434513654615,TRX_N-00004-44370039,2020-01-06T17:41:33,Vitoria-Gasteiz,Basic services,gas,-35.2,1173.7
buyer_6,Manuel,45,ES79209522434513654615,TRX_N-00005-74306047,2020-01-07T09:06:21,Vitoria-Gasteiz,Basic services,gas,-78.31,1095.39
buyer_6,Manuel,45,ES79209522434513654615,TRX_N-00006-92539840,2020-01-07T14:44:03,Vitoria-Gasteiz,Basic services,internet,-70.39,1025.0
buyer_6,Manuel,45,ES79209522434513654615,TRX_N-00007-59238357,2020-01-23T23:07:04,Durango,Expense,gifts,-498.69,526.31
buyer_6,Manuel,45,ES79209522434513654615,TRX_N-00008-85850118,2020-01-29T13:43:21,Vitoria-Gasteiz,Expense,transport,-103.65,422.66
buyer_6,Manuel,45,ES79209522434513654615,TRX_N-00009-59397784,2020-02-01T16:43:02,Vitoria-Gasteiz,transfer,Salary,1463.83,1886.49
buyer_6,Manuel,45,ES79209522434513654615,TRX_N-00010-99694949,2020-02-01T16:43:02,Vitoria-Gasteiz,transfer,Extra Income,146.38,2032.87
buyer_6,Manuel,45,ES79209522434513654615,TRX_N-00011-11425124,2020-02-04T12:39:21,Vitoria-Gasteiz,Expense,food,-560.94,1471.93
buyer_6,Manuel,45,ES79209522434513654615,TRX_N-00012-66237568,2020-02-05T08:53:47,Vitoria-Gasteiz,Housing,Rent,-911.35,560.58
buyer_6,Manuel,45,ES79209522434513654615,TRX_N-00013-94250325,2020-02-05T20:04:46,Vitoria-Gasteiz,Basic services,water,-79.16,481.42
buyer_6,Manuel,45,ES79209522434513654615,TRX_N-00014-26488821,2020-02-05T06:39:47,Vitoria-Gasteiz,Basic services,electricity,-109.64,371.78
buyer_6,Manuel,45,ES79209522434513654615,TRX_N-00015-56460633,2020-02-05T20:04:11,Vitoria-Gasteiz,Basic services,internet,-76.78,295.0
buyer_6,Manuel,45,ES79209522434513654615,TRX_N-00016-06806579,2020-02-06T04:53:43,Vitoria-Gasteiz,Basic services,water,-53.79,241.21
buyer_6,Manuel,45,ES79209522434513654615,TRX_N-00017-91878846,2020-02-06T14:59:29,Vitoria-Gasteiz,Basic services,gas,-83.24,157.97
buyer_6,Manuel,45,ES79209522434513654615,TRX_N-00018-83768758,2020-02-06T14:23:04,Vitoria-Gasteiz,Basic services,internet,-68.85,89.12
buyer_6,Manuel,45,ES79209522434513654615,TRX_N-00019-49667376,2020-02-06T17:33:19,Vitoria-Gasteiz,Basic services,phone,-39.93,49.19
buyer_6,Manuel,45,ES79209522434513654615,TRX_N-00020-37590918,2020-02-07T13:03:46,Vitoria-Gasteiz,Basic services,water,-47.81,1.38
buyer_6,Manuel,45,ES79209522434513654615,TRX_N-00021-45319677,2020-02-12T21:47:48,Vitoria-Gasteiz,Expense,repairs,-85.97,-84.59
buyer_6,Manuel,45,ES79209522434513654615,TRX_N-00022-89742136,2020-02-21T22:25:10,Galdakao,Expense,transport,-25.29,-109.88
buyer_6,Manuel,45,ES79209522434513654615,TRX_N-00023-01055332,2020-03-01T16:52:48,Vitoria-Gasteiz,transfer,Salary,1463.83,1353.95
buyer_6,Manuel,45,ES79209522434513654615,TRX_N-00024-04307424,2020-03-03T15:26:21,Vitoria-Gasteiz,Expense,leisure,-182.65,1171.3
buyer_6,Manuel,45,ES79209522434513654615,TRX_N-00025-87536567,2020-03-05T17:36:02,Vitoria-Gasteiz,Housing,Rent,-911.35,259.95
buyer_6,Manuel,45,ES79209522434513654615,TRX_N-00026-74580483,2020-03-05T17:42:12,Vitoria-Gasteiz,Basic services,water,-15.07,244.88
buyer_6,Manuel,45,ES79209522434513654615,TRX_N-00027-09826386,2020-03-05T08:20:12,Vitoria-Gasteiz,Basic services,internet,-51.54,193.34
buyer_6,Manuel,45,ES79209522434513654615,TRX_N-00028-73826728,2020-03-06T08:51:15,Vitoria-Gasteiz,Basic services,gas,-24.31,169.03
buyer_6,Manuel,45,ES79209522434513654615,TRX_N-00029-58667435,2020-03-06T00:54:31,Vitoria-Gasteiz,Basic services,internet,-65.3,103.73
buyer_6,Manuel,45,ES79209522434513654615,TRX_N-00030-32587546,2020-03-07T06:21:27,Vitoria-Gasteiz,Basic services,water,-43.72,60.01
buyer_6,Manuel,45,ES79209522434513654615,TRX_N-00031-68870086,2020-03-08T10:49:32,Vitoria-Gasteiz,Expense,transport,-188.33,-128.32
buyer_6,Manuel,45,ES79209522434513654615,TRX_N-00032-23348789,2020-03-09T10:34:13,Zarautz,Expense,leisure,-37.69,-166.01
buyer_6,Manuel,45,ES79209522434513654615,TRX_N-00033-62054866,2020-03-25T19:59:39,Eibar,Expense,transport,-169.25,-335.26
buyer_6,Manuel,45,ES79209522434513654615,TRX_N-00034-35613401,2020-04-01T13:40:29,Vitoria-Gasteiz,transfer,Salary,1463.83,1128.57
buyer_6,Manuel,45,ES79209522434513654615,TRX_N-00035-77812165,2020-04-05T19:28:37,Vitoria-Gasteiz,Housing,Rent,-911.35,217.22
buyer_6,Manuel,45,ES79209522434513654615,TRX_N-00036-54358590,2020-04-05T16:28:12,Vitoria-Gasteiz,Basic services,phone,-20.56,196.66
buyer_6,Manuel,45,ES79209522434513654615,TRX_N-00037-92570122,2020-04-06T11:44:10,Vitoria-Gasteiz,Basic services,internet,-36.31,160.35
buyer_6,Manuel,45,ES79209522434513654615,TRX_N-00038-68601592,2020-04-09T18:07:09,Vitoria-Gasteiz,Expense,gifts,-123.84,36.51
buyer_6,Manuel,45,ES79209522434513654615,TRX_N-00039-88571400,2020-04-13T05:52:53,Vitoria-Gasteiz,Expense,transport,-176.51,-140.0
buyer_6,Manuel,45,ES79209522434513654615,TRX_N-00040-79250841,2020-05-01T11:49:42,Vitoria-Gasteiz,transfer,Salary,1463.83,1323.83
buyer_6,Manuel,45,ES79209522434513654615,TRX_N-00041-30058097,2020-05-01T11:49:42,Vitoria-Gasteiz,transfer,Extra Income,146.38,1470.21
buyer_6,Manuel,45,ES79209522434513654615,TRX_N-00042-62265736,2020-05-05T16:54:43,Vitoria-Gasteiz,Housing,Rent,-911.35,558.86
buyer_6,Manuel,45,ES79209522434513654615,TRX_N-00043-90222418,2020-05-05T18:57:00,Vitoria-Gasteiz,Basic services,water,-27.51,531.35
buyer_6,Manuel,45,ES79209522434513654615,TRX_N-00044-94483107,2020-05-05T09:48:44,Vitoria-Gasteiz,Basic services,internet,-41.9,489.45
buyer_6,Manuel,45,ES79209522434513654615,TRX_N-00045-72629441,2020-05-06T13:09:19,Vitoria-Gasteiz,Basic services,water,-60.71,428.74
buyer_6,Manuel,45,ES79209522434513654615,TRX_N-00046-83941500,2020-05-06T14:29:57,Vitoria-Gasteiz,Basic services,internet,-44.67,384.07
buyer_6,Manuel,45,ES79209522434513654615,TRX_N-00047-46785130,2020-05-06T12:34:46,Vitoria-Gasteiz,Expense,clothing,-399.82,-15.75
buyer_6,Manuel,45,ES79209522434513654615,TRX_N-00048-15246541,2020-05-07T12:13:24,Vitoria-Gasteiz,Basic services,electricity,-120.47,-136.22
buyer_6,Manuel,45,ES79209522434513654615,TRX_N-00049-37106185,2020-05-07T20:12:10,Vitoria-Gasteiz,Basic services,gas,-18.57,-154.79
buyer_6,Manuel,45,ES79209522434513654615,TRX_N-00050-74592318,2020-05-12T19:19:43,Vitoria-Gasteiz,Expense,leisure,-74.53,-229.32
buyer_6,Manuel,45,ES79209522434513654615,TRX_N-00051-58426230,2020-05-29T03:07:42,Vitoria-Gasteiz,Expense,healthcare,-40.64,-269.96
buyer_6,Manuel,45,ES79209522434513654615,TRX_N-00052-49178768,2020-06-01T01:41:27,Vitoria-Gasteiz,transfer,Salary,1463.83,1193.87
buyer_6,Manuel,45,ES79209522434513654615,TRX_N-00053-75680420,2020-06-01T01:41:27,Vitoria-Gasteiz,transfer,Bonus,1332.72,2526.59
buyer_6,Manuel,45,ES79209522434513654615,TRX_N-00054-19176586,2020-06-05T12:15:14,Vitoria-Gasteiz,Housing,Rent,-911.35,1615.24
buyer_6,Manuel,45,ES79209522434513654615,TRX_N-00055-42745458,2020-06-05T17:11:22,Vitoria-Gasteiz,Basic services,phone,-26.05,1589.19
buyer_6,Manuel,45,ES79209522434513654615,TRX_N-00056-71594958,2020-06-06T18:36:32,Vitoria-Gasteiz,Basic services,phone,-50.12,1539.07
buyer_6,Manuel,45,ES79209522434513654615,TRX_N-00057-43176118,2020-06-07T23:02:39,Vitoria-Gasteiz,Basic services,internet,-32.59,1506.48
buyer_6,Manuel,45,ES79209522434513654615,TRX_N-00058-69585772,2020-06-07T18:58:38,Vitoria-Gasteiz,Basic services,phone,-37.14,1469.34
buyer_6,Manuel,45,ES79209522434513654615,TRX_N-00059-96927502,2020-06-10T16:11:40,Vitoria-Gasteiz,Expense,clothing,-91.99,1377.35
buyer_6,Manuel,45,ES79209522434513654615,TRX_N-00060-28740718,2020-06-12T14:51:34,Vitoria-Gasteiz,Expense,clothing,-388.03,989.32
buyer_6,Manuel,45,ES79209522434513654615,TRX_N-00061-67169327,2020-06-24T09:10:49,Vitoria-Gasteiz,Expense,transport,-80.0,909.32
buyer_6,Manuel,45,ES79209522434513654615,TRX_N-00062-03886935,2020-06-29T09:10:22,Vitoria-Gasteiz,Expense,food,-513.32,396.0
buyer_6,Manuel,45,ES79209522434513654615,TRX_N-00063-08649078,2020-07-01T18:31:52,Vitoria-Gasteiz,transfer,Salary,1463.83,1859.83
buyer_6,Manuel,45,ES79209522434513654615,TRX_N-00064-90397563,2020-07-05T16:55:44,Vitoria-Gasteiz,Housing,Rent,-911.35,948.48
buyer_6,Manuel,45,ES79209522434513654615,TRX_N-00065-36787183,2020-07-05T12:13:39,Vitoria-Gasteiz,Basic services,water,-31.55,916.93
buyer_6,Manuel,45,ES79209522434513654615,TRX_N-00066-08068398,2020-07-05T05:09:40,Vitoria-Gasteiz,Basic services,internet,-55.72,861.21
buyer_6,Manuel,45,ES79209522434513654615,TRX_N-00067-05330772,2020-07-05T10:15:04,Vitoria-Gasteiz,Basic services,phone,-90.19,771.02
buyer_6,Manuel,45,ES79209522434513654615,TRX_N-00068-92734477,2020-07-06T15:54:24,Vitoria-Gasteiz,Basic services,internet,-73.61,697.41
buyer_6,Manuel,45,ES79209522434513654615,TRX_N-00069-30172533,2020-07-06T18:03:21,Vitoria-Gasteiz,Basic services,phone,-39.15,658.26
buyer_6,Manuel,45,ES79209522434513654615,TRX_N-00070-62221286,2020-07-06T11:52:33,Hondarribia,Expense,transport,-187.23,471.03
buyer_6,Manuel,45,ES79209522434513654615,TRX_N-00071-08780229,2020-07-06T18:35:09,Vitoria-Gasteiz,Expense,education,-611.42,-140.39
buyer_6,Manuel,45,ES79209522434513654615,TRX_N-00072-71794751,2020-07-07T18:52:48,Vitoria-Gasteiz,Basic services,internet,-46.51,-186.9
buyer_6,Manuel,45,ES79209522434513654615,TRX_N-00073-69852697,2020-07-07T11:59:24,Vitoria-Gasteiz,Basic services,phone,-39.2,-226.1
buyer_6,Manuel,45,ES79209522434513654615,TRX_N-00074-45686311,2020-07-07T15:00:35,Vitoria-Gasteiz,Expense,leisure,-207.34,-433.44
buyer_6,Manuel,45,ES79209522434513654615,TRX_N-00075-18102435,2020-07-09T18:21:40,Erandio,Expense,travel,-1299.91,-1733.35
buyer_6,Manuel,45,ES79209522434513654615,TRX_N-00076-61376682,2020-07-10T09:33:54,Vitoria-Gasteiz,Expense,transport,-137.32,-1870.67
buyer_6,Manuel,45,ES79209522434513654615,TRX_N-00077-52401068,2020-07-17T19:10:36,Bermeo,Expense,clothing,-470.03,-2340.7
buyer_6,Manuel,45,ES79209522434513654615,TRX_N-00078-76566073,2020-07-21T10:34:53,Irun,Expense,clothing,-267.61,-2608.31
buyer_6,Manuel,45,ES79209522434513654615,TRX_N-00079-28114109,2020-08-01T06:26:05,Vitoria-Gasteiz,transfer,Salary,1463.83,-1144.48
buyer_6,Manuel,45,ES79209522434513654615,TRX_N-00080-59185099,2020-08-01T06:26:05,Vitoria-Gasteiz,transfer,Extra Income,146.38,-998.1
buyer_6,Manuel,45,ES79209522434513654615,TRX_N-00081-29774808,2020-08-02T08:59:39,Vitoria-Gasteiz,Expense,leisure,-179.75,-1177.85
buyer_6,Manuel,45,ES79209522434513654615,TRX_N-00082-78885808,2020-08-05T01:34:24,Vitoria-Gasteiz,Housing,Rent,-911.35,-2089.2
buyer_6,Manuel,45,ES79209522434513654615,TRX_N-00083-54129241,2020-08-05T12:42:04,Vitoria-Gasteiz,Basic services,gas,-88.33,-2177.53
buyer_6,Manuel,45,ES79209522434513654615,TRX_N-00084-97921415,2020-08-05T16:46:37,Vitoria-Gasteiz,Basic services,internet,-52.98,-2230.51
buyer_6,Manuel,45,ES79209522434513654615,TRX_N-00085-54859983,2020-08-06T20:31:16,Vitoria-Gasteiz,Basic services,phone,-21.08,-2251.59
buyer_6,Manuel,45,ES79209522434513654615,TRX_N-00086-35021097,2020-08-07T12:43:57,Vitoria-Gasteiz,Basic services,gas,-42.05,-2293.64
buyer_6,Manuel,45,ES79209522434513654615,TRX_N-00087-03451252,2020-08-26T14:45:36,Vitoria-Gasteiz,Expense,healthcare,-106.93,-2400.57
buyer_6,Manuel,45,ES79209522434513654615,TRX_N-00088-15435896,2020-08-31T10:10:32,Vitoria-Gasteiz,Expense,food,-664.74,-3065.31
buyer_6,Manuel,45,ES79209522434513654615,TRX_N-00089-83015160,2020-09-01T11:59:42,Vitoria-Gasteiz,transfer,Salary,1463.83,-1601.48
buyer_6,Manuel,45,ES79209522434513654615,TRX_N-00090-46517823,2020-09-03T11:57:50,Vitoria-Gasteiz,Expense,food,-476.04,-2077.52
buyer_6,Manuel,45,ES79209522434513654615,TRX_N-00091-58678590,2020-09-05T17:03:17,Vitoria-Gasteiz,Housing,Rent,-911.35,-2988.87
buyer_6,Manuel,45,ES79209522434513654615,TRX_N-00092-33831041,2020-09-05T17:51:06,Vitoria-Gasteiz,Basic services,water,-49.54,-3038.41
buyer_6,Manuel,45,ES79209522434513654615,TRX_N-00093-28942370,2020-09-05T15:00:14,Vitoria-Gasteiz,Basic services,electricity,-71.53,-3109.94
buyer_6,Manuel,45,ES79209522434513654615,TRX_N-00094-63235531,2020-09-05T13:31:05,Vitoria-Gasteiz,Basic services,gas,-92.23,-3202.17
buyer_6,Manuel,45,ES79209522434513654615,TRX_N-00095-25570252,2020-09-06T20:07:07,Vitoria-Gasteiz,Basic services,internet,-43.2,-3245.37
buyer_6,Manuel,45,ES79209522434513654615,TRX_N-00096-32316310,2020-09-07T21:10:33,Vitoria-Gasteiz,Basic services,gas,-19.69,-3265.06
buyer_6,Manuel,45,ES79209522434513654615,TRX_N-00097-59931928,2020-09-07T22:38:32,Vitoria-Gasteiz,Basic services,internet,-48.07,-3313.13
buyer_6,Manuel,45,ES79209522434513654615,TRX_N-00098-45188161,2020-09-17T15:20:57,Portugalete,Expense,education,-729.69,-4042.82
buyer_6,Manuel,45,ES79209522434513654615,TRX_N-00099-31298834,2020-09-20T12:49:03,Vitoria-Gasteiz,Expense,appliances,-177.18,-4220.0
buyer_6,Manuel,45,ES79209522434513654615,TRX_N-00100-41384876,2020-09-23T15:24:36,Vitoria-Gasteiz,Expense,food,-542.81,-4762.81
buyer_6,Manuel,45,ES79209522434513654615,TRX_N-00101-64126967,2020-09-24T22:30:42,Vitoria-Gasteiz,Expense,food,-227.19,-4990.0
buyer_6,Manuel,45,ES79209522434513654615,TRX_N-00102-61771254,2020-10-01T14:19:05,Vitoria-Gasteiz,transfer,Salary,1463.83,-3526.17
buyer_6,Manuel,45,ES79209522434513654615,TRX_N-00103-25043083,2020-10-01T10:26:17,Vitoria-Gasteiz,Expense,leisure,-236.53,-3762.7
buyer_6,Manuel,45,ES79209522434513654615,TRX_N-00104-44473662,2020-10-05T04:32:51,Vitoria-Gasteiz,Housing,Rent,-911.35,-4674.05
buyer_6,Manuel,45,ES79209522434513654615,TRX_N-00105-29502641,2020-10-05T15:52:37,Vitoria-Gasteiz,Basic services,water,-48.48,-4722.53
buyer_6,Manuel,45,ES79209522434513654615,TRX_N-00106-46125432,2020-10-05T10:37:31,Vitoria-Gasteiz,Basic services,electricity,-50.56,-4773.09
buyer_6,Manuel,45,ES79209522434513654615,TRX_N-00107-97524687,2020-10-05T00:15:35,Vitoria-Gasteiz,Basic services,internet,-66.13,-4839.22
buyer_6,Manuel,45,ES79209522434513654615,TRX_N-00108-11210392,2020-10-06T16:58:17,Vitoria-Gasteiz,Basic services,water,-78.81,-4918.03
buyer_6,Manuel,45,ES79209522434513654615,TRX_N-00109-76049598,2020-10-06T08:45:01,Vitoria-Gasteiz,Expense,gifts,-148.57,-5066.6
buyer_6,Manuel,45,ES79209522434513654615,TRX_N-00110-96617229,2020-10-07T20:15:04,Vitoria-Gasteiz,Basic services,water,-68.66,-5135.26
buyer_6,Manuel,45,ES79209522434513654615,TRX_N-00111-81270667,2020-10-07T14:52:29,Vitoria-Gasteiz,Basic services,gas,-96.39,-5231.65
buyer_6,Manuel,45,ES79209522434513654615,TRX_N-00112-72745283,2020-10-14T12:49:24,Vitoria-Gasteiz,Expense,healthcare,-201.46,-5433.11
buyer_6,Manuel,45,ES79209522434513654615,TRX_N-00113-98633382,2020-11-01T18:39:26,Vitoria-Gasteiz,transfer,Salary,1463.83,-3969.28
buyer_6,Manuel,45,ES79209522434513654615,TRX_N-00114-46370231,2020-11-01T18:39:26,Vitoria-Gasteiz,transfer,Extra Income,146.38,-3822.9
buyer_6,Manuel,45,ES79209522434513654615,TRX_N-00115-81082024,2020-11-05T08:34:54,Vitoria-Gasteiz,Housing,Rent,-911.35,-4734.25
buyer_6,Manuel,45,ES79209522434513654615,TRX_N-00116-13493666,2020-11-05T22:10:17,Vitoria-Gasteiz,Basic services,gas,-56.74,-4790.99
buyer_6,Manuel,45,ES79209522434513654615,TRX_N-00117-40761140,2020-11-05T01:39:14,Vitoria-Gasteiz,Basic services,phone,-26.31,-4817.3
buyer_6,Manuel,45,ES79209522434513654615,TRX_N-00118-95592383,2020-11-06T13:36:33,Vitoria-Gasteiz,Basic services,water,-48.12,-4865.42
buyer_6,Manuel,45,ES79209522434513654615,TRX_N-00119-55684045,2020-11-06T08:53:21,Vitoria-Gasteiz,Basic services,phone,-82.5,-4947.92
buyer_6,Manuel,45,ES79209522434513654615,TRX_N-00120-14772705,2020-11-07T14:55:11,Vitoria-Gasteiz,Basic services,water,-13.04,-4960.96
buyer_6,Manuel,45,ES79209522434513654615,TRX_N-00121-66895057,2020-11-07T16:51:45,Vitoria-Gasteiz,Basic services,gas,-23.06,-4984.02
buyer_6,Manuel,45,ES79209522434513654615,TRX_N-00122-18427888,2020-11-07T17:16:49,Vitoria-Gasteiz,Basic services,internet,-39.46,-5023.48
buyer_6,Manuel,45,ES79209522434513654615,TRX_N-00123-44547259,2020-11-18T02:28:30,Andoain,Expense,leisure,-165.72,-5189.2
buyer_6,Manuel,45,ES79209522434513654615,TRX_N-00124-77176690,2020-11-22T20:52:22,Vitoria-Gasteiz,Expense,leisure,-17.81,-5207.01
buyer_6,Manuel,45,ES79209522434513654615,TRX_N-00125-99567788,2020-11-25T16:05:32,Vitoria-Gasteiz,Expense,transport,-76.46,-5283.47
buyer_6,Manuel,45,ES79209522434513654615,TRX_N-00126-71985594,2020-11-26T14:03:21,Vitoria-Gasteiz,Expense,education,-104.71,-5388.18
buyer_6,Manuel,45,ES79209522434513654615,TRX_N-00127-28265930,2020-11-28T16:55:53,Vitoria-Gasteiz,Expense,food,-167.95,-5556.13
buyer_6,Manuel,45,ES79209522434513654615,TRX_N-00128-25187417,2020-12-01T10:23:17,Vitoria-Gasteiz,transfer,Salary,1463.83,-4092.3
buyer_6,Manuel,45,ES79209522434513654615,TRX_N-00129-75960775,2020-12-01T10:23:17,Vitoria-Gasteiz,transfer,Bonus,1536.92,-2555.38
buyer_6,Manuel,45,ES79209522434513654615,TRX_N-00130-18778287,2020-12-05T17:46:30,Vitoria-Gasteiz,Housing,Rent,-911.35,-3466.73
buyer_6,Manuel,45,ES79209522434513654615,TRX_N-00131-84857383,2020-12-05T16:53:51,Vitoria-Gasteiz,Basic services,water,-43.64,-3510.37
buyer_6,Manuel,45,ES79209522434513654615,TRX_N-00132-55170319,2020-12-05T18:33:57,Vitoria-Gasteiz,Basic services,internet,-55.63,-3566.0
buyer_6,Manuel,45,ES79209522434513654615,TRX_N-00133-59413468,2020-12-06T18:14:07,Vitoria-Gasteiz,Basic services,internet,-76.13,-3642.13
buyer_6,Manuel,45,ES79209522434513654615,TRX_N-00134-91172514,2020-12-06T12:52:32,Vitoria-Gasteiz,Basic services,phone,-57.12,-3699.25
buyer_6,Manuel,45,ES79209522434513654615,TRX_N-00135-71757556,2020-12-07T18:33:07,Vitoria-Gasteiz,Basic services,gas,-90.05,-3789.3
buyer_6,Manuel,45,ES79209522434513654615,TRX_N-00136-86358368,2020-12-07T20:26:29,Vitoria-Gasteiz,Basic services,internet,-72.68,-3861.98
buyer_6,Manuel,45,ES79209522434513654615,TRX_N-00137-93732646,2020-12-07T20:47:24,Vitoria-Gasteiz,Basic services,phone,-44.21,-3906.19
buyer_6,Manuel,45,ES79209522434513654615,TRX_N-00138-30376487,2020-12-13T08:11:44,Vitoria-Gasteiz,Expense,transport,-28.45,-3934.64
buyer_6,Manuel,45,ES79209522434513654615,TRX_N-00139-35115709,2020-12-23T08:57:51,Iruña de Oca,Expense,gifts,-60.68,-3995.32
buyer_6,Manuel,45,ES79209522434513654615,TRX_N-00140-64686452,2020-12-28T13:28:07,Vitoria-Gasteiz,Expense,food,-363.52,-4358.84
buyer_6,Manuel,45,ES79209522434513654615,TRX_N-00141-83506394,2020-12-29T09:35:53,Vitoria-Gasteiz,Expense,clothing,-335.06,-4693.9
buyer_6,Manuel,45,ES79209522434513654615,TRX_N-00142-89584437,2021-01-01T23:07:56,Vitoria-Gasteiz,transfer,Salary,1463.83,-3230.07
buyer_6,Manuel,45,ES79209522434513654615,TRX_N-00143-77811875,2021-01-05T17:00:15,Vitoria-Gasteiz,Housing,Rent,-911.35,-4141.42
buyer_6,Manuel,45,ES79209522434513654615,TRX_N-00144-11330373,2021-01-06T13:20:35,Vitoria-Gasteiz,Basic services,gas,-23.3,-4164.72
buyer_6,Manuel,45,ES79209522434513654615,TRX_N-00145-75870090,2021-01-06T11:10:11,Vitoria-Gasteiz,Basic services,internet,-63.18,-4227.9
buyer_6,Manuel,45,ES79209522434513654615,TRX_N-00146-69140778,2021-01-06T17:06:02,Bilbao,Expense,healthcare,-182.79,-4410.69
buyer_6,Manuel,45,ES79209522434513654615,TRX_N-00147-14818643,2021-01-07T11:12:24,Vitoria-Gasteiz,Basic services,water,-26.55,-4437.24
buyer_6,Manuel,45,ES79209522434513654615,TRX_N-00148-99553625,2021-01-07T16:51:04,Vitoria-Gasteiz,Basic services,internet,-37.56,-4474.8
buyer_6,Manuel,45,ES79209522434513654615,TRX_N-00149-69653252,2021-01-07T10:47:23,Vitoria-Gasteiz,Basic services,phone,-44.7,-4519.5
buyer_6,Manuel,45,ES79209522434513654615,TRX_N-00150-55465352,2021-01-09T22:06:14,Vitoria-Gasteiz,Expense,food,-391.68,-4911.18
buyer_6,Manuel,45,ES79209522434513654615,TRX_N-00151-60194120,2021-01-17T11:32:35,Eibar,Expense,healthcare,-119.32,-5030.5
buyer_6,Manuel,45,ES79209522434513654615,TRX_N-00152-02190605,2021-01-17T19:43:36,Vitoria-Gasteiz,Expense,gifts,-445.55,-5476.05
buyer_6,Manuel,45,ES79209522434513654615,TRX_N-00153-66877415,2021-02-01T19:35:11,Vitoria-Gasteiz,transfer,Salary,1463.83,-4012.22
buyer_6,Manuel,45,ES79209522434513654615,TRX_N-00154-22815006,2021-02-01T19:35:11,Vitoria-Gasteiz,transfer,Extra Income,146.38,-3865.84
buyer_6,Manuel,45,ES79209522434513654615,TRX_N-00155-03777683,2021-02-05T12:45:18,Vitoria-Gasteiz,Housing,Rent,-911.35,-4777.19
buyer_6,Manuel,45,ES79209522434513654615,TRX_N-00156-70333796,2021-02-06T17:33:22,Vitoria-Gasteiz,Basic services,electricity,-57.28,-4834.47
buyer_6,Manuel,45,ES79209522434513654615,TRX_N-00157-00864908,2021-02-06T00:53:00,Vitoria-Gasteiz,Basic services,gas,-43.16,-4877.63
buyer_6,Manuel,45,ES79209522434513654615,TRX_N-00158-94844475,2021-02-06T17:32:22,Vitoria-Gasteiz,Basic services,internet,-47.11,-4924.74
buyer_6,Manuel,45,ES79209522434513654615,TRX_N-00159-61791511,2021-02-06T16:16:44,Vitoria-Gasteiz,Basic services,phone,-88.62,-5013.36
buyer_6,Manuel,45,ES79209522434513654615,TRX_N-00160-48239819,2021-02-07T19:43:51,Vitoria-Gasteiz,Basic services,gas,-59.48,-5072.84
buyer_6,Manuel,45,ES79209522434513654615,TRX_N-00161-48424617,2021-02-07T11:42:08,Vitoria-Gasteiz,Basic services,phone,-35.3,-5108.14
buyer_6,Manuel,45,ES79209522434513654615,TRX_N-00162-48633426,2021-02-09T09:25:36,Vitoria-Gasteiz,Expense,transport,-190.23,-5298.37
buyer_6,Manuel,45,ES79209522434513654615,TRX_N-00163-44711541,2021-02-23T14:49:12,Vitoria-Gasteiz,Expense,healthcare,-320.12,-5618.49
buyer_6,Manuel,45,ES79209522434513654615,TRX_N-00164-30065361,2021-02-24T07:36:41,Vitoria-Gasteiz,Expense,healthcare,-314.62,-5933.11
buyer_6,Manuel,45,ES79209522434513654615,TRX_N-00165-47194928,2021-03-01T05:15:26,Vitoria-Gasteiz,transfer,Salary,1463.83,-4469.28
buyer_6,Manuel,45,ES79209522434513654615,TRX_N-00166-19403951,2021-03-05T08:43:27,Vitoria-Gasteiz,Housing,Rent,-911.35,-5380.63
buyer_6,Manuel,45,ES79209522434513654615,TRX_N-00167-37192329,2021-03-05T13:52:25,Vitoria-Gasteiz,Basic services,electricity,-98.66,-5479.29
buyer_6,Manuel,45,ES79209522434513654615,TRX_N-00168-83415168,2021-03-06T20:32:15,Vitoria-Gasteiz,Basic services,water,-37.21,-5516.5
buyer_6,Manuel,45,ES79209522434513654615,TRX_N-00169-28389223,2021-03-06T21:01:16,Vitoria-Gasteiz,Basic services,electricity,-149.47,-5665.97
buyer_6,Manuel,45,ES79209522434513654615,TRX_N-00170-12139948,2021-03-06T13:37:03,Vitoria-Gasteiz,Basic services,internet,-71.81,-5737.78
buyer_6,Manuel,45,ES79209522434513654615,TRX_N-00171-53552051,2021-03-06T17:36:27,Vitoria-Gasteiz,Basic services,phone,-35.83,-5773.61
buyer_6,Manuel,45,ES79209522434513654615,TRX_N-00172-74504684,2021-03-07T13:56:16,Vitoria-Gasteiz,Basic services,water,-16.31,-5789.92
buyer_6,Manuel,45,ES79209522434513654615,TRX_N-00173-74300285,2021-03-07T12:11:12,Vitoria-Gasteiz,Basic services,electricity,-54.59,-5844.51
buyer_6,Manuel,45,ES79209522434513654615,TRX_N-00174-43691154,2021-03-07T15:57:57,Vitoria-Gasteiz,Basic services,gas,-39.44,-5883.95
buyer_6,Manuel,45,ES79209522434513654615,TRX_N-00175-83888072,2021-03-19T11:16:13,Vitoria-Gasteiz,Expense,leisure,-260.27,-6144.22
buyer_6,Manuel,45,ES79209522434513654615,TRX_N-00176-43891790,2021-03-21T17:10:28,Vitoria-Gasteiz,Expense,food,-208.45,-6352.67
buyer_6,Manuel,45,ES79209522434513654615,TRX_N-00177-23311158,2021-03-28T09:05:24,Arrasate,Expense,food,-134.31,-6486.98
buyer_6,Manuel,45,ES79209522434513654615,TRX_N-00178-64033110,2021-04-01T10:27:17,Vitoria-Gasteiz,transfer,Salary,1463.83,-5023.15
buyer_6,Manuel,45,ES79209522434513654615,TRX_N-00179-14087187,2021-04-01T10:27:17,Vitoria-Gasteiz,transfer,Extra Income,146.38,-4876.77
buyer_6,Manuel,45,ES79209522434513654615,TRX_N-00180-25531417,2021-04-03T18:49:53,Vitoria-Gasteiz,Expense,food,-460.64,-5337.41
buyer_6,Manuel,45,ES79209522434513654615,TRX_N-00181-92676357,2021-04-05T17:18:11,Vitoria-Gasteiz,Housing,Rent,-911.35,-6248.76
buyer_6,Manuel,45,ES79209522434513654615,TRX_N-00182-69230738,2021-04-05T21:08:12,Vitoria-Gasteiz,Basic services,electricity,-51.87,-6300.63
buyer_6,Manuel,45,ES79209522434513654615,TRX_N-00183-14387611,2021-04-06T03:17:36,Vitoria-Gasteiz,Basic services,water,-21.74,-6322.37
buyer_6,Manuel,45,ES79209522434513654615,TRX_N-00184-78664494,2021-04-06T14:24:24,Vitoria-Gasteiz,Basic services,electricity,-131.46,-6453.83
buyer_6,Manuel,45,ES79209522434513654615,TRX_N-00185-70594763,2021-04-07T14:27:47,Vitoria-Gasteiz,Basic services,gas,-54.73,-6508.56
buyer_6,Manuel,45,ES79209522434513654615,TRX_N-00186-88786438,2021-05-01T16:31:59,Vitoria-Gasteiz,transfer,Salary,1463.83,-5044.73
buyer_6,Manuel,45,ES79209522434513654615,TRX_N-00187-18220750,2021-05-01T18:55:14,Vitoria-Gasteiz,Expense,transport,-185.26,-5229.99
buyer_6,Manuel,45,ES79209522434513654615,TRX_N-00188-45340524,2021-05-03T10:20:06,Vitoria-Gasteiz,Expense,food,-410.93,-5640.92
buyer_6,Manuel,45,ES79209522434513654615,TRX_N-00189-57953249,2021-05-05T21:52:21,Vitoria-Gasteiz,Housing,Rent,-911.35,-6552.27
buyer_6,Manuel,45,ES79209522434513654615,TRX_N-00190-36938802,2021-05-05T14:35:43,Vitoria-Gasteiz,Basic services,water,-61.19,-6613.46
buyer_6,Manuel,45,ES79209522434513654615,TRX_N-00191-51657909,2021-05-06T12:42:45,Vitoria-Gasteiz,Basic services,electricity,-35.48,-6648.94
buyer_6,Manuel,45,ES79209522434513654615,TRX_N-00192-95800843,2021-05-06T11:48:45,Vitoria-Gasteiz,Basic services,internet,-70.92,-6719.86
buyer_6,Manuel,45,ES79209522434513654615,TRX_N-00193-65804070,2021-05-06T11:19:05,Vitoria-Gasteiz,Expense,repairs,-431.36,-7151.22
buyer_6,Manuel,45,ES79209522434513654615,TRX_N-00194-70828609,2021-05-07T13:23:22,Vitoria-Gasteiz,Basic services,water,-25.56,-7176.78
buyer_6,Manuel,45,ES79209522434513654615,TRX_N-00195-70241384,2021-05-08T17:06:31,Vitoria-Gasteiz,Expense,food,-687.31,-7864.09
buyer_6,Manuel,45,ES79209522434513654615,TRX_N-00196-13879733,2021-05-13T18:20:56,Vitoria-Gasteiz,Expense,food,-162.96,-8027.05
buyer_6,Manuel,45,ES79209522434513654615,TRX_N-00197-63948106,2021-05-14T15:07:20,Vitoria-Gasteiz,Expense,food,-262.59,-8289.64
buyer_6,Manuel,45,ES79209522434513654615,TRX_N-00198-89638826,2021-05-14T23:08:54,Vitoria-Gasteiz,Expense,clothing,-466.57,-8756.21
buyer_6,Manuel,45,ES79209522434513654615,TRX_N-00199-94618972,2021-05-23T19:00:30,Vitoria-Gasteiz,Expense,food,-334.44,-9090.65
buyer_6,Manuel,45,ES79209522434513654615,TRX_N-00200-21059869,2021-05-26T10:08:49,Vitoria-Gasteiz,Expense,healthcare,-154.73,-9245.38
buyer_6,Manuel,45,ES79209522434513654615,TRX_N-00201-87212272,2021-06-01T19:03:47,Vitoria-Gasteiz,transfer,Salary,1463.83,-7781.55
buyer_6,Manuel,45,ES79209522434513654615,TRX_N-00202-32458345,2021-06-01T19:03:47,Vitoria-Gasteiz,transfer,Extra Income,146.38,-7635.17
buyer_6,Manuel,45,ES79209522434513654615,TRX_N-00203-04406218,2021-06-01T19:03:47,Vitoria-Gasteiz,transfer,Bonus,1528.3,-6106.87
buyer_6,Manuel,45,ES79209522434513654615,TRX_N-00204-57646098,2021-06-05T15:36:21,Vitoria-Gasteiz,Housing,Rent,-911.35,-7018.22
buyer_6,Manuel,45,ES79209522434513654615,TRX_N-00205-28458926,2021-06-05T13:04:33,Vitoria-Gasteiz,Basic services,electricity,-110.76,-7128.98
buyer_6,Manuel,45,ES79209522434513654615,TRX_N-00206-97945029,2021-06-06T17:47:06,Vitoria-Gasteiz,Basic services,water,-16.83,-7145.81
buyer_6,Manuel,45,ES79209522434513654615,TRX_N-00207-52746207,2021-06-07T17:06:04,Vitoria-Gasteiz,Basic services,internet,-56.52,-7202.33
buyer_6,Manuel,45,ES79209522434513654615,TRX_N-00208-83772172,2021-06-11T16:00:06,Vitoria-Gasteiz,Expense,healthcare,-394.77,-7597.1
buyer_6,Manuel,45,ES79209522434513654615,TRX_N-00209-31050678,2021-06-13T13:41:07,Vitoria-Gasteiz,Expense,leisure,-296.69,-7893.79
buyer_6,Manuel,45,ES79209522434513654615,TRX_N-00210-75129402,2021-06-24T21:10:54,Vitoria-Gasteiz,Expense,leisure,-254.02,-8147.81
buyer_6,Manuel,45,ES79209522434513654615,TRX_N-00211-98652703,2021-06-24T08:06:31,Vitoria-Gasteiz,Expense,repairs,-626.74,-8774.55
buyer_6,Manuel,45,ES79209522434513654615,TRX_N-00212-19741471,2021-07-01T08:59:16,Vitoria-Gasteiz,transfer,Salary,1463.83,-7310.72
buyer_6,Manuel,45,ES79209522434513654615,TRX_N-00213-10366717,2021-07-03T10:56:45,Vitoria-Gasteiz,Expense,leisure,-273.18,-7583.9
buyer_6,Manuel,45,ES79209522434513654615,TRX_N-00214-07658332,2021-07-05T13:18:39,Vitoria-Gasteiz,Housing,Rent,-911.35,-8495.25
buyer_6,Manuel,45,ES79209522434513654615,TRX_N-00215-25931296,2021-07-05T08:29:48,Vitoria-Gasteiz,Basic services,water,-32.2,-8527.45
buyer_6,Manuel,45,ES79209522434513654615,TRX_N-00216-37330429,2021-07-05T13:08:56,Vitoria-Gasteiz,Basic services,internet,-40.1,-8567.55
buyer_6,Manuel,45,ES79209522434513654615,TRX_N-00217-26020122,2021-07-06T15:22:12,Vitoria-Gasteiz,Basic services,water,-12.31,-8579.86
buyer_6,Manuel,45,ES79209522434513654615,TRX_N-00218-50430950,2021-07-06T12:20:06,Vitoria-Gasteiz,Basic services,internet,-52.66,-8632.52
buyer_6,Manuel,45,ES79209522434513654615,TRX_N-00219-08421155,2021-07-07T21:31:09,Vitoria-Gasteiz,Basic services,water,-15.45,-8647.97
buyer_6,Manuel,45,ES79209522434513654615,TRX_N-00220-74540338,2021-07-07T18:05:29,Vitoria-Gasteiz,Basic services,gas,-56.41,-8704.38
buyer_6,Manuel,45,ES79209522434513654615,TRX_N-00221-64454817,2021-07-07T19:06:26,Vitoria-Gasteiz,Basic services,internet,-31.87,-8736.25
buyer_6,Manuel,45,ES79209522434513654615,TRX_N-00222-21561798,2021-07-23T12:07:46,Vitoria-Gasteiz,Expense,clothing,-414.84,-9151.09
buyer_6,Manuel,45,ES79209522434513654615,TRX_N-00223-38885992,2021-07-26T19:12:44,Oyón-Oion,Expense,transport,-95.93,-9247.02
buyer_6,Manuel,45,ES79209522434513654615,TRX_N-00224-39313028,2021-07-31T20:55:41,Arrasate,Expense,healthcare,-263.37,-9510.39
buyer_6,Manuel,45,ES79209522434513654615,TRX_N-00225-67951399,2021-08-01T10:11:51,Vitoria-Gasteiz,transfer,Salary,1463.83,-8046.56
buyer_6,Manuel,45,ES79209522434513654615,TRX_N-00226-61796552,2021-08-05T08:01:34,Vitoria-Gasteiz,Housing,Rent,-911.35,-8957.91
buyer_6,Manuel,45,ES79209522434513654615,TRX_N-00227-48006410,2021-08-05T11:37:26,Vitoria-Gasteiz,Basic services,electricity,-71.7,-9029.61
buyer_6,Manuel,45,ES79209522434513654615,TRX_N-00228-55712453,2021-08-05T17:13:06,Vitoria-Gasteiz,Basic services,gas,-75.63,-9105.24
buyer_6,Manuel,45,ES79209522434513654615,TRX_N-00229-55696929,2021-08-05T14:27:46,Vitoria-Gasteiz,Basic services,internet,-68.27,-9173.51
buyer_6,Manuel,45,ES79209522434513654615,TRX_N-00230-02068123,2021-08-07T15:13:31,Vitoria-Gasteiz,Basic services,water,-15.93,-9189.44
buyer_6,Manuel,45,ES79209522434513654615,TRX_N-00231-35527712,2021-08-07T09:39:00,Vitoria-Gasteiz,Basic services,electricity,-74.22,-9263.66
buyer_6,Manuel,45,ES79209522434513654615,TRX_N-00232-27691905,2021-08-07T14:02:12,Vitoria-Gasteiz,Expense,leisure,-268.13,-9531.79
buyer_6,Manuel,45,ES79209522434513654615,TRX_N-00233-91673955,2021-08-09T09:36:17,Vitoria-Gasteiz,Expense,food,-662.1,-10193.89
buyer_6,Manuel,45,ES79209522434513654615,TRX_N-00234-35818021,2021-08-28T19:07:37,Vitoria-Gasteiz,Expense,education,-741.15,-10935.04
buyer_6,Manuel,45,ES79209522434513654615,TRX_N-00235-49558134,2021-08-31T08:44:09,Vitoria-Gasteiz,Expense,gifts,-235.52,-11170.56
buyer_6,Manuel,45,ES79209522434513654615,TRX_N-00236-43382861,2021-09-01T11:06:29,Vitoria-Gasteiz,transfer,Salary,1463.83,-9706.73
buyer_6,Manuel,45,ES79209522434513654615,TRX_N-00237-57885743,2021-09-01T11:06:29,Vitoria-Gasteiz,transfer,Extra Income,146.38,-9560.35
buyer_6,Manuel,45,ES79209522434513654615,TRX_N-00238-39295405,2021-09-03T19:51:47,Vitoria-Gasteiz,Expense,clothing,-355.44,-9915.79
buyer_6,Manuel,45,ES79209522434513654615,TRX_N-00239-35165368,2021-09-05T12:52:22,Vitoria-Gasteiz,Housing,Rent,-911.35,-10827.14
buyer_6,Manuel,45,ES79209522434513654615,TRX_N-00240-55752176,2021-09-05T12:39:23,Vitoria-Gasteiz,Basic services,water,-65.26,-10892.4
buyer_6,Manuel,45,ES79209522434513654615,TRX_N-00241-97401820,2021-09-05T11:59:42,Vitoria-Gasteiz,Basic services,electricity,-71.38,-10963.78
buyer_6,Manuel,45,ES79209522434513654615,TRX_N-00242-45174145,2021-09-05T19:52:33,Vitoria-Gasteiz,Basic services,gas,-79.53,-11043.31
buyer_6,Manuel,45,ES79209522434513654615,TRX_N-00243-34635883,2021-09-06T19:29:51,Vitoria-Gasteiz,Basic services,gas,-98.24,-11141.55
buyer_6,Manuel,45,ES79209522434513654615,TRX_N-00244-79971632,2021-09-06T18:13:24,Vitoria-Gasteiz,Basic services,phone,-57.98,-11199.53
buyer_6,Manuel,45,ES79209522434513654615,TRX_N-00245-19745380,2021-09-07T11:15:44,Vitoria-Gasteiz,Basic services,internet,-31.7,-11231.23
buyer_6,Manuel,45,ES79209522434513654615,TRX_N-00246-46380174,2021-10-01T09:34:10,Vitoria-Gasteiz,transfer,Salary,1463.83,-9767.4
buyer_6,Manuel,45,ES79209522434513654615,TRX_N-00247-50046591,2021-10-05T11:14:19,Vitoria-Gasteiz,Housing,Rent,-911.35,-10678.75
buyer_6,Manuel,45,ES79209522434513654615,TRX_N-00248-22942232,2021-10-05T10:31:32,Vitoria-Gasteiz,Basic services,water,-71.46,-10750.21
buyer_6,Manuel,45,ES79209522434513654615,TRX_N-00249-59879889,2021-10-05T13:42:32,Vitoria-Gasteiz,Basic services,gas,-44.69,-10794.9
buyer_6,Manuel,45,ES79209522434513654615,TRX_N-00250-07920715,2021-10-05T22:02:49,Vitoria-Gasteiz,Expense,clothing,-432.65,-11227.55
buyer_6,Manuel,45,ES79209522434513654615,TRX_N-00251-21380454,2021-10-06T11:16:37,Vitoria-Gasteiz,Basic services,electricity,-40.09,-11267.64
buyer_6,Manuel,45,ES79209522434513654615,TRX_N-00252-52455259,2021-10-06T11:24:48,Vitoria-Gasteiz,Basic services,gas,-21.41,-11289.05
buyer_6,Manuel,45,ES79209522434513654615,TRX_N-00253-30286118,2021-10-06T16:01:49,Vitoria-Gasteiz,Basic services,internet,-51.04,-11340.09
buyer_6,Manuel,45,ES79209522434513654615,TRX_N-00254-29459512,2021-10-07T16:54:42,Vitoria-Gasteiz,Basic services,water,-62.7,-11402.79
buyer_6,Manuel,45,ES79209522434513654615,TRX_N-00255-55139403,2021-10-07T14:57:26,Vitoria-Gasteiz,Basic services,electricity,-105.3,-11508.09
buyer_6,Manuel,45,ES79209522434513654615,TRX_N-00256-51474136,2021-10-07T16:40:06,Vitoria-Gasteiz,Basic services,gas,-34.75,-11542.84
buyer_6,Manuel,45,ES79209522434513654615,TRX_N-00257-32068870,2021-10-10T15:29:21,Vitoria-Gasteiz,Expense,leisure,-272.08,-11814.92
buyer_6,Manuel,45,ES79209522434513654615,TRX_N-00258-59125031,2021-10-19T10:37:51,Vitoria-Gasteiz,Expense,food,-346.25,-12161.17
buyer_6,Manuel,45,ES79209522434513654615,TRX_N-00259-54352011,2021-10-22T20:42:27,Vitoria-Gasteiz,Expense,food,-519.71,-12680.88
buyer_6,Manuel,45,ES79209522434513654615,TRX_N-00260-34592904,2021-10-26T20:15:59,Vitoria-Gasteiz,Expense,appliances,-829.82,-13510.7
buyer_6,Manuel,45,ES79209522434513654615,TRX_N-00261-40978603,2021-11-01T17:25:29,Vitoria-Gasteiz,transfer,Salary,1463.83,-12046.87
buyer_6,Manuel,45,ES79209522434513654615,TRX_N-00262-42491806,2021-11-01T17:25:29,Vitoria-Gasteiz,transfer,Extra Income,146.38,-11900.49
buyer_6,Manuel,45,ES79209522434513654615,TRX_N-00263-71991650,2021-11-05T07:58:49,Vitoria-Gasteiz,Housing,Rent,-911.35,-12811.84
buyer_6,Manuel,45,ES79209522434513654615,TRX_N-00264-78046530,2021-11-05T01:29:21,Vitoria-Gasteiz,Basic services,water,-55.67,-12867.51
buyer_6,Manuel,45,ES79209522434513654615,TRX_N-00265-68972878,2021-11-05T14:13:11,Vitoria-Gasteiz,Basic services,electricity,-64.12,-12931.63
buyer_6,Manuel,45,ES79209522434513654615,TRX_N-00266-61812259,2021-11-05T12:04:31,Vitoria-Gasteiz,Basic services,gas,-82.88,-13014.51
buyer_6,Manuel,45,ES79209522434513654615,TRX_N-00267-36295445,2021-11-05T19:06:59,Vitoria-Gasteiz,Basic services,internet,-69.79,-13084.3
buyer_6,Manuel,45,ES79209522434513654615,TRX_N-00268-17275522,2021-11-06T11:27:47,Vitoria-Gasteiz,Basic services,water,-46.92,-13131.22
buyer_6,Manuel,45,ES79209522434513654615,TRX_N-00269-53396069,2021-11-06T18:48:51,Vitoria-Gasteiz,Basic services,gas,-66.57,-13197.79
buyer_6,Manuel,45,ES79209522434513654615,TRX_N-00270-91888651,2021-11-06T17:19:23,Vitoria-Gasteiz,Basic services,phone,-62.33,-13260.12
buyer_6,Manuel,45,ES79209522434513654615,TRX_N-00271-20489534,2021-11-11T12:22:49,Vitoria-Gasteiz,Expense,transport,-58.06,-13318.18
buyer_6,Manuel,45,ES79209522434513654615,TRX_N-00272-95421483,2021-11-19T14:39:31,Vitoria-Gasteiz,Expense,leisure,-89.66,-13407.84
buyer_6,Manuel,45,ES79209522434513654615,TRX_N-00273-33674979,2021-11-21T11:25:51,Vitoria-Gasteiz,Expense,transport,-29.18,-13437.02
buyer_6,Manuel,45,ES79209522434513654615,TRX_N-00274-74781591,2021-11-29T12:07:28,Santurtzi,Expense,leisure,-249.79,-13686.81
buyer_6,Manuel,45,ES79209522434513654615,TRX_N-00275-30352453,2021-12-01T00:39:39,Vitoria-Gasteiz,transfer,Salary,1463.83,-12222.98
buyer_6,Manuel,45,ES79209522434513654615,TRX_N-00276-67965842,2021-12-01T00:39:39,Vitoria-Gasteiz,transfer,Bonus,1572.97,-10650.01
buyer_6,Manuel,45,ES79209522434513654615,TRX_N-00277-92820641,2021-12-05T07:45:56,Vitoria-Gasteiz,Housing,Rent,-911.35,-11561.36
buyer_6,Manuel,45,ES79209522434513654615,TRX_N-00278-44610540,2021-12-05T12:01:47,Vitoria-Gasteiz,Basic services,gas,-76.07,-11637.43
buyer_6,Manuel,45,ES79209522434513654615,TRX_N-00279-93361296,2021-12-05T19:52:44,Vitoria-Gasteiz,Basic services,phone,-89.88,-11727.31
buyer_6,Manuel,45,ES79209522434513654615,TRX_N-00280-56893942,2021-12-06T17:04:13,Vitoria-Gasteiz,Basic services,electricity,-75.39,-11802.7
buyer_6,Manuel,45,ES79209522434513654615,TRX_N-00281-37952933,2021-12-07T13:46:23,Vitoria-Gasteiz,Basic services,electricity,-80.65,-11883.35
buyer_6,Manuel,45,ES79209522434513654615,TRX_N-00282-28995494,2021-12-07T20:47:59,Vitoria-Gasteiz,Basic services,gas,-81.62,-11964.97
buyer_6,Manuel,45,ES79209522434513654615,TRX_N-00283-11488418,2021-12-18T11:52:12,Vitoria-Gasteiz,Expense,transport,-176.91,-12141.88
buyer_6,Manuel,45,ES79209522434513654615,TRX_N-00284-79729214,2021-12-22T16:38:50,Vitoria-Gasteiz,Expense,transport,-139.62,-12281.5
buyer_6,Manuel,45,ES79209522434513654615,TRX_N-00285-03163113,2022-01-01T20:51:42,Vitoria-Gasteiz,transfer,Salary,1463.83,-10817.67
buyer_6,Manuel,45,ES79209522434513654615,TRX_N-00286-82526633,2022-01-05T09:39:26,Vitoria-Gasteiz,Housing,Rent,-911.35,-11729.02
buyer_6,Manuel,45,ES79209522434513654615,TRX_N-00287-90032449,2022-01-05T08:26:10,Vitoria-Gasteiz,Basic services,gas,-18.4,-11747.42
buyer_6,Manuel,45,ES79209522434513654615,TRX_N-00288-45054177,2022-02-01T19:40:36,Vitoria-Gasteiz,transfer,Salary,1463.83,-10283.59
buyer_6,Manuel,45,ES79209522434513654615,TRX_N-00289-14751191,2022-02-01T19:40:36,Vitoria-Gasteiz,transfer,Extra Income,146.38,-10137.21
buyer_6,Manuel,45,ES79209522434513654615,TRX_N-00290-87423556,2022-02-05T18:26:53,Vitoria-Gasteiz,Housing,Rent,-911.35,-11048.56
buyer_6,Manuel,45,ES79209522434513654615,TRX_N-00291-93318069,2022-02-07T20:45:42,Vitoria-Gasteiz,Basic services,electricity,-100.69,-11149.25
buyer_6,Manuel,45,ES79209522434513654615,TRX_N-00292-30513045,2022-02-07T22:18:37,Vitoria-Gasteiz,Basic services,gas,-58.62,-11207.87
buyer_6,Manuel,45,ES79209522434513654615,TRX_N-00293-22869756,2022-02-17T09:55:34,Vitoria-Gasteiz,Expense,food,-575.42,-11783.29
buyer_6,Manuel,45,ES79209522434513654615,TRX_N-00294-89457092,2022-02-20T02:42:01,Vitoria-Gasteiz,Expense,gifts,-115.53,-11898.82
buyer_6,Manuel,45,ES79209522434513654615,TRX_N-00295-38792921,2022-02-27T12:36:03,Vitoria-Gasteiz,Expense,gifts,-222.56,-12121.38
buyer_6,Manuel,45,ES79209522434513654615,TRX_N-00296-86006249,2022-03-01T19:39:13,Vitoria-Gasteiz,transfer,Salary,1463.83,-10657.55
buyer_6,Manuel,45,ES79209522434513654615,TRX_N-00297-38411880,2022-03-05T19:05:19,Vitoria-Gasteiz,Housing,Rent,-911.35,-11568.9
buyer_6,Manuel,45,ES79209522434513654615,TRX_N-00298-38022205,2022-03-05T14:36:51,Vitoria-Gasteiz,Basic services,water,-61.97,-11630.87
buyer_6,Manuel,45,ES79209522434513654615,TRX_N-00299-09885486,2022-03-06T13:07:13,Vitoria-Gasteiz,Basic services,phone,-44.94,-11675.81
buyer_6,Manuel,45,ES79209522434513654615,TRX_N-00300-44322197,2022-03-09T17:20:17,Vitoria-Gasteiz,Expense,clothing,-45.18,-11720.99
buyer_6,Manuel,45,ES79209522434513654615,TRX_N-00301-83074149,2022-03-24T17:34:46,Vitoria-Gasteiz,Expense,food,-523.98,-12244.97
buyer_6,Manuel,45,ES79209522434513654615,TRX_N-00302-62764193,2022-03-31T16:55:51,Lasarte-Oria,Expense,repairs,-971.95,-13216.92
buyer_6,Manuel,45,ES79209522434513654615,TRX_N-00303-93459221,2022-04-01T18:07:56,Vitoria-Gasteiz,transfer,Salary,1463.83,-11753.09
buyer_6,Manuel,45,ES79209522434513654615,TRX_N-00304-48643281,2022-04-05T20:23:34,Vitoria-Gasteiz,Housing,Rent,-911.35,-12664.44
buyer_6,Manuel,45,ES79209522434513654615,TRX_N-00305-75405149,2022-04-05T01:05:59,Vitoria-Gasteiz,Basic services,electricity,-93.31,-12757.75
buyer_6,Manuel,45,ES79209522434513654615,TRX_N-00306-30854299,2022-04-05T14:09:10,Vitoria-Gasteiz,Basic services,gas,-72.65,-12830.4
buyer_6,Manuel,45,ES79209522434513654615,TRX_N-00307-91745196,2022-04-05T13:12:31,Vitoria-Gasteiz,Basic services,internet,-33.62,-12864.02
buyer_6,Manuel,45,ES79209522434513654615,TRX_N-00308-16503602,2022-04-07T18:47:11,Vitoria-Gasteiz,Basic services,water,-28.51,-12892.53
buyer_6,Manuel,45,ES79209522434513654615,TRX_N-00309-06199077,2022-04-07T13:03:56,Vitoria-Gasteiz,Basic services,electricity,-47.33,-12939.86
buyer_6,Manuel,45,ES79209522434513654615,TRX_N-00310-34958024,2022-04-07T02:23:29,Vitoria-Gasteiz,Basic services,gas,-37.27,-12977.13
buyer_6,Manuel,45,ES79209522434513654615,TRX_N-00311-26264327,2022-04-07T20:08:54,Vitoria-Gasteiz,Basic services,phone,-98.92,-13076.05
buyer_6,Manuel,45,ES79209522434513654615,TRX_N-00312-27722007,2022-04-09T13:48:40,Vitoria-Gasteiz,Expense,transport,-73.24,-13149.29
buyer_6,Manuel,45,ES79209522434513654615,TRX_N-00313-70434860,2022-04-13T16:16:43,Vitoria-Gasteiz,Expense,gifts,-327.97,-13477.26
buyer_6,Manuel,45,ES79209522434513654615,TRX_N-00314-84282045,2022-04-21T19:43:27,Vitoria-Gasteiz,Expense,gifts,-26.09,-13503.35
buyer_6,Manuel,45,ES79209522434513654615,TRX_N-00315-30202894,2022-04-26T19:51:14,Vitoria-Gasteiz,Expense,clothing,-396.56,-13899.91
buyer_6,Manuel,45,ES79209522434513654615,TRX_N-00316-56534207,2022-04-28T13:57:17,Zuia,Expense,food,-414.86,-14314.77
buyer_6,Manuel,45,ES79209522434513654615,TRX_N-00317-76313770,2022-05-01T14:42:42,Vitoria-Gasteiz,transfer,Salary,1463.83,-12850.94
buyer_6,Manuel,45,ES79209522434513654615,TRX_N-00318-47817314,2022-05-01T14:42:42,Vitoria-Gasteiz,transfer,Extra Income,146.38,-12704.56
buyer_6,Manuel,45,ES79209522434513654615,TRX_N-00319-08950035,2022-05-05T18:09:50,Vitoria-Gasteiz,Housing,Rent,-911.35,-13615.91
buyer_6,Manuel,45,ES79209522434513654615,TRX_N-00320-98996949,2022-05-05T17:01:44,Vitoria-Gasteiz,Basic services,water,-43.48,-13659.39
buyer_6,Manuel,45,ES79209522434513654615,TRX_N-00321-31898650,2022-05-05T14:24:12,Vitoria-Gasteiz,Basic services,electricity,-95.49,-13754.88
buyer_6,Manuel,45,ES79209522434513654615,TRX_N-00322-10043877,2022-05-06T11:10:47,Vitoria-Gasteiz,Basic services,water,-13.16,-13768.04
buyer_6,Manuel,45,ES79209522434513654615,TRX_N-00323-11982779,2022-05-06T20:39:03,Vitoria-Gasteiz,Basic services,electricity,-77.5,-13845.54
buyer_6,Manuel,45,ES79209522434513654615,TRX_N-00324-27152668,2022-05-06T12:29:48,Vitoria-Gasteiz,Basic services,phone,-76.08,-13921.62
buyer_6,Manuel,45,ES79209522434513654615,TRX_N-00325-09334535,2022-05-07T17:38:42,Vitoria-Gasteiz,Basic services,gas,-43.2,-13964.82
buyer_6,Manuel,45,ES79209522434513654615,TRX_N-00326-18961727,2022-05-31T14:52:36,Vitoria-Gasteiz,Expense,food,-351.91,-14316.73
buyer_6,Manuel,45,ES79209522434513654615,TRX_N-00327-17801817,2022-06-01T21:05:00,Vitoria-Gasteiz,transfer,Salary,1463.83,-12852.9
buyer_6,Manuel,45,ES79209522434513654615,TRX_N-00328-04888641,2022-06-01T21:05:00,Vitoria-Gasteiz,transfer,Bonus,1511.16,-11341.74
buyer_6,Manuel,45,ES79209522434513654615,TRX_N-00329-19608519,2022-06-05T11:22:01,Vitoria-Gasteiz,Housing,Rent,-911.35,-12253.09
buyer_6,Manuel,45,ES79209522434513654615,TRX_N-00330-91698533,2022-06-05T15:34:57,Vitoria-Gasteiz,Basic services,electricity,-140.98,-12394.07
buyer_6,Manuel,45,ES79209522434513654615,TRX_N-00331-08083322,2022-06-05T15:09:06,Vitoria-Gasteiz,Basic services,internet,-50.54,-12444.61
buyer_6,Manuel,45,ES79209522434513654615,TRX_N-00332-37799659,2022-06-05T06:05:47,Vitoria-Gasteiz,Basic services,phone,-56.44,-12501.05
buyer_6,Manuel,45,ES79209522434513654615,TRX_N-00333-97577637,2022-06-06T08:31:26,Vitoria-Gasteiz,Expense,education,-329.74,-12830.79
buyer_6,Manuel,45,ES79209522434513654615,TRX_N-00334-62015354,2022-06-07T18:25:16,Vitoria-Gasteiz,Basic services,gas,-18.84,-12849.63
buyer_6,Manuel,45,ES79209522434513654615,TRX_N-00335-06770880,2022-06-07T18:53:25,Vitoria-Gasteiz,Expense,food,-284.56,-13134.19
buyer_6,Manuel,45,ES79209522434513654615,TRX_N-00336-27656935,2022-06-18T04:11:36,Vitoria-Gasteiz,Expense,food,-334.57,-13468.76
buyer_6,Manuel,45,ES79209522434513654615,TRX_N-00337-93290676,2022-06-24T14:34:39,Donostia,Expense,leisure,-107.04,-13575.8
buyer_6,Manuel,45,ES79209522434513654615,TRX_N-00338-95577118,2022-06-29T20:35:54,Vitoria-Gasteiz,Expense,transport,-85.13,-13660.93
buyer_6,Manuel,45,ES79209522434513654615,TRX_N-00339-52454666,2022-07-01T22:47:05,Vitoria-Gasteiz,transfer,Salary,1463.83,-12197.1
buyer_6,Manuel,45,ES79209522434513654615,TRX_N-00340-15124258,2022-07-01T22:47:05,Vitoria-Gasteiz,transfer,Extra Income,146.38,-12050.72
buyer_6,Manuel,45,ES79209522434513654615,TRX_N-00341-87859520,2022-07-05T09:24:23,Vitoria-Gasteiz,Housing,Rent,-911.35,-12962.07
buyer_6,Manuel,45,ES79209522434513654615,TRX_N-00342-23422690,2022-07-05T00:43:39,Vitoria-Gasteiz,Basic services,water,-17.39,-12979.46
buyer_6,Manuel,45,ES79209522434513654615,TRX_N-00343-48586402,2022-07-05T13:39:52,Vitoria-Gasteiz,Basic services,electricity,-77.69,-13057.15
buyer_6,Manuel,45,ES79209522434513654615,TRX_N-00344-97893250,2022-07-05T22:57:12,Vitoria-Gasteiz,Basic services,phone,-44.78,-13101.93
buyer_6,Manuel,45,ES79209522434513654615,TRX_N-00345-75535218,2022-07-05T06:32:42,Vitoria-Gasteiz,Expense,leisure,-48.77,-13150.7
buyer_6,Manuel,45,ES79209522434513654615,TRX_N-00346-83099932,2022-07-07T12:46:31,Vitoria-Gasteiz,Basic services,water,-40.72,-13191.42
buyer_6,Manuel,45,ES79209522434513654615,TRX_N-00347-85479786,2022-07-24T21:50:59,Vitoria-Gasteiz,Expense,clothing,-360.36,-13551.78
buyer_6,Manuel,45,ES79209522434513654615,TRX_N-00348-05859710,2022-07-30T12:07:20,Vitoria-Gasteiz,Expense,food,-596.01,-14147.79
buyer_6,Manuel,45,ES79209522434513654615,TRX_N-00349-32945402,2022-08-01T16:36:10,Vitoria-Gasteiz,transfer,Salary,1463.83,-12683.96
buyer_6,Manuel,45,ES79209522434513654615,TRX_N-00350-90165605,2022-08-03T15:03:30,Vitoria-Gasteiz,Expense,leisure,-275.48,-12959.44
buyer_6,Manuel,45,ES79209522434513654615,TRX_N-00351-02613217,2022-08-05T14:04:37,Vitoria-Gasteiz,Housing,Rent,-911.35,-13870.79
buyer_6,Manuel,45,ES79209522434513654615,TRX_N-00352-73917156,2022-08-05T13:08:56,Vitoria-Gasteiz,Basic services,water,-21.37,-13892.16
buyer_6,Manuel,45,ES79209522434513654615,TRX_N-00353-52885859,2022-08-05T14:55:21,Vitoria-Gasteiz,Basic services,electricity,-92.1,-13984.26
buyer_6,Manuel,45,ES79209522434513654615,TRX_N-00354-78014835,2022-08-05T17:52:27,Vitoria-Gasteiz,Basic services,internet,-46.49,-14030.75
buyer_6,Manuel,45,ES79209522434513654615,TRX_N-00355-44441277,2022-08-06T08:35:28,Vitoria-Gasteiz,Basic services,water,-31.84,-14062.59
buyer_6,Manuel,45,ES79209522434513654615,TRX_N-00356-79724089,2022-08-07T18:54:23,Vitoria-Gasteiz,Basic services,water,-11.98,-14074.57
buyer_6,Manuel,45,ES79209522434513654615,TRX_N-00357-90175216,2022-08-07T05:15:21,Vitoria-Gasteiz,Basic services,electricity,-128.38,-14202.95
buyer_6,Manuel,45,ES79209522434513654615,TRX_N-00358-52572053,2022-08-07T09:25:33,Vitoria-Gasteiz,Basic services,phone,-38.43,-14241.38
buyer_6,Manuel,45,ES79209522434513654615,TRX_N-00359-35787936,2022-09-01T20:40:03,Vitoria-Gasteiz,transfer,Salary,1463.83,-12777.55
buyer_6,Manuel,45,ES79209522434513654615,TRX_N-00360-45368042,2022-09-05T16:25:47,Vitoria-Gasteiz,Housing,Rent,-911.35,-13688.9
buyer_6,Manuel,45,ES79209522434513654615,TRX_N-00361-16021272,2022-09-05T19:02:38,Vitoria-Gasteiz,Basic services,electricity,-104.19,-13793.09
buyer_6,Manuel,45,ES79209522434513654615,TRX_N-00362-01818242,2022-09-05T19:16:06,Vitoria-Gasteiz,Basic services,internet,-56.04,-13849.13
buyer_6,Manuel,45,ES79209522434513654615,TRX_N-00363-37875964,2022-09-06T07:34:39,Vitoria-Gasteiz,Basic services,gas,-89.42,-13938.55
buyer_6,Manuel,45,ES79209522434513654615,TRX_N-00364-47502982,2022-09-07T10:25:41,Vitoria-Gasteiz,Basic services,water,-72.35,-14010.9
buyer_6,Manuel,45,ES79209522434513654615,TRX_N-00365-56412333,2022-09-07T13:29:56,Vitoria-Gasteiz,Basic services,gas,-25.49,-14036.39
buyer_6,Manuel,45,ES79209522434513654615,TRX_N-00366-78307207,2022-09-29T17:15:01,Elciego,Expense,transport,-60.15,-14096.54
buyer_6,Manuel,45,ES79209522434513654615,TRX_N-00367-12620745,2022-10-01T13:31:33,Vitoria-Gasteiz,transfer,Salary,1463.83,-12632.71
buyer_6,Manuel,45,ES79209522434513654615,TRX_N-00368-51970656,2022-10-01T13:31:33,Vitoria-Gasteiz,transfer,Extra Income,146.38,-12486.33
buyer_6,Manuel,45,ES79209522434513654615,TRX_N-00369-13312975,2022-10-01T10:25:53,Vitoria-Gasteiz,Expense,clothing,-149.11,-12635.44
buyer_6,Manuel,45,ES79209522434513654615,TRX_N-00370-18217305,2022-10-05T09:37:33,Vitoria-Gasteiz,Housing,Rent,-911.35,-13546.79
buyer_6,Manuel,45,ES79209522434513654615,TRX_N-00371-12389454,2022-10-05T06:41:40,Vitoria-Gasteiz,Basic services,water,-46.64,-13593.43
buyer_6,Manuel,45,ES79209522434513654615,TRX_N-00372-27753424,2022-10-05T10:31:08,Vitoria-Gasteiz,Basic services,gas,-39.35,-13632.78
buyer_6,Manuel,45,ES79209522434513654615,TRX_N-00373-10930547,2022-10-05T10:04:54,Vitoria-Gasteiz,Basic services,internet,-52.49,-13685.27
buyer_6,Manuel,45,ES79209522434513654615,TRX_N-00374-17388356,2022-10-05T20:54:28,Vitoria-Gasteiz,Expense,food,-321.17,-14006.44
buyer_6,Manuel,45,ES79209522434513654615,TRX_N-00375-30028022,2022-10-07T20:27:39,Vitoria-Gasteiz,Basic services,water,-75.07,-14081.51
buyer_6,Manuel,45,ES79209522434513654615,TRX_N-00376-65252867,2022-10-07T20:37:21,Vitoria-Gasteiz,Basic services,gas,-36.97,-14118.48
buyer_6,Manuel,45,ES79209522434513654615,TRX_N-00377-91928730,2022-10-07T11:35:41,Vitoria-Gasteiz,Basic services,phone,-88.75,-14207.23
buyer_6,Manuel,45,ES79209522434513654615,TRX_N-00378-88098960,2022-10-09T13:35:01,Vitoria-Gasteiz,Expense,transport,-153.61,-14360.84
buyer_6,Manuel,45,ES79209522434513654615,TRX_N-00379-67912840,2022-10-28T10:14:19,Vitoria-Gasteiz,Expense,healthcare,-327.84,-14688.68
buyer_6,Manuel,45,ES79209522434513654615,TRX_N-00380-51113386,2022-10-30T14:57:23,Vitoria-Gasteiz,Expense,gifts,-269.62,-14958.3
buyer_6,Manuel,45,ES79209522434513654615,TRX_N-00381-23761367,2022-11-01T19:57:28,Vitoria-Gasteiz,transfer,Salary,1463.83,-13494.47
buyer_6,Manuel,45,ES79209522434513654615,TRX_N-00382-89910380,2022-11-05T11:59:14,Vitoria-Gasteiz,Housing,Rent,-911.35,-14405.82
buyer_6,Manuel,45,ES79209522434513654615,TRX_N-00383-68216236,2022-11-05T20:34:01,Vitoria-Gasteiz,Basic services,water,-53.9,-14459.72
buyer_6,Manuel,45,ES79209522434513654615,TRX_N-00384-85386268,2022-11-05T20:22:25,Vitoria-Gasteiz,Basic services,phone,-82.53,-14542.25
buyer_6,Manuel,45,ES79209522434513654615,TRX_N-00385-56601144,2022-11-05T03:13:54,Vitoria-Gasteiz,Expense,transport,-41.74,-14583.99
buyer_6,Manuel,45,ES79209522434513654615,TRX_N-00386-01476032,2022-11-06T05:44:20,Vitoria-Gasteiz,Basic services,electricity,-59.65,-14643.64
buyer_6,Manuel,45,ES79209522434513654615,TRX_N-00387-95681560,2022-11-07T18:07:29,Vitoria-Gasteiz,Basic services,gas,-81.98,-14725.62
buyer_6,Manuel,45,ES79209522434513654615,TRX_N-00388-11387818,2022-11-07T10:03:32,Vitoria-Gasteiz,Basic services,phone,-83.88,-14809.5
buyer_6,Manuel,45,ES79209522434513654615,TRX_N-00389-31755409,2022-11-22T15:19:34,Irun,Expense,appliances,-1634.36,-16443.86
buyer_6,Manuel,45,ES79209522434513654615,TRX_N-00390-89702103,2022-12-01T06:36:34,Vitoria-Gasteiz,transfer,Salary,1463.83,-14980.03
buyer_6,Manuel,45,ES79209522434513654615,TRX_N-00391-82920363,2022-12-01T06:36:34,Vitoria-Gasteiz,transfer,Extra Income,146.38,-14833.65
buyer_6,Manuel,45,ES79209522434513654615,TRX_N-00392-90725897,2022-12-01T06:36:34,Vitoria-Gasteiz,transfer,Bonus,1346.09,-13487.56
buyer_6,Manuel,45,ES79209522434513654615,TRX_N-00393-98489972,2022-12-01T23:15:12,Vitoria-Gasteiz,Expense,leisure,-183.4,-13670.96
buyer_6,Manuel,45,ES79209522434513654615,TRX_N-00394-62860759,2022-12-05T09:54:41,Vitoria-Gasteiz,Housing,Rent,-911.35,-14582.31
buyer_6,Manuel,45,ES79209522434513654615,TRX_N-00395-07721963,2022-12-05T18:33:05,Vitoria-Gasteiz,Basic services,water,-47.61,-14629.92
buyer_6,Manuel,45,ES79209522434513654615,TRX_N-00396-65713320,2022-12-06T20:31:27,Vitoria-Gasteiz,Basic services,phone,-96.03,-14725.95
buyer_6,Manuel,45,ES79209522434513654615,TRX_N-00397-96274406,2022-12-07T09:12:46,Vitoria-Gasteiz,Basic services,water,-78.34,-14804.29
buyer_6,Manuel,45,ES79209522434513654615,TRX_N-00398-93013290,2022-12-07T09:30:56,Vitoria-Gasteiz,Basic services,electricity,-126.86,-14931.15
buyer_6,Manuel,45,ES79209522434513654615,TRX_N-00399-55904971,2022-12-07T11:28:31,Vitoria-Gasteiz,Basic services,gas,-92.96,-15024.11
buyer_6,Manuel,45,ES79209522434513654615,TRX_N-00400-81563251,2022-12-07T09:52:16,Vitoria-Gasteiz,Basic services,internet,-46.75,-15070.86
buyer_6,Manuel,45,ES79209522434513654615,TRX_N-00401-67873764,2022-12-09T12:42:41,Vitoria-Gasteiz,Expense,healthcare,-277.91,-15348.77
buyer_6,Manuel,45,ES79209522434513654615,TRX_N-00402-12382123,2022-12-18T10:13:20,Vitoria-Gasteiz,Expense,clothing,-385.05,-15733.82
buyer_6,Manuel,45,ES79209522434513654615,TRX_N-00403-96260778,2022-12-21T13:35:39,Vitoria-Gasteiz,Expense,food,-782.74,-16516.56
buyer_6,Manuel,45,ES79209522434513654615,TRX_N-00404-20163533,2022-12-28T18:03:29,Vitoria-Gasteiz,Expense,food,-574.88,-17091.44
buyer_6,Manuel,45,ES79209522434513654615,TRX_N-00405-47131221,2023-01-01T13:56:26,Vitoria-Gasteiz,transfer,Salary,1463.83,-15627.61
buyer_6,Manuel,45,ES79209522434513654615,TRX_N-00406-36522586,2023-01-05T10:22:29,Vitoria-Gasteiz,Housing,Rent,-911.35,-16538.96
buyer_6,Manuel,45,ES79209522434513654615,TRX_N-00407-52627478,2023-01-05T17:17:14,Vitoria-Gasteiz,Basic services,gas,-65.36,-16604.32
buyer_6,Manuel,45,ES79209522434513654615,TRX_N-00408-51326489,2023-01-06T22:54:09,Vitoria-Gasteiz,Basic services,internet,-41.26,-16645.58
buyer_6,Manuel,45,ES79209522434513654615,TRX_N-00409-43584754,2023-01-07T11:59:57,Vitoria-Gasteiz,Basic services,electricity,-43.88,-16689.46
buyer_6,Manuel,45,ES79209522434513654615,TRX_N-00410-94017163,2023-01-08T12:02:29,Vitoria-Gasteiz,Expense,food,-695.91,-17385.37
buyer_6,Manuel,45,ES79209522434513654615,TRX_N-00411-63411813,2023-01-09T18:44:29,Vitoria-Gasteiz,Expense,food,-688.9,-18074.27
buyer_6,Manuel,45,ES79209522434513654615,TRX_N-00412-21321754,2023-01-18T16:41:44,Vitoria-Gasteiz,Expense,transport,-82.65,-18156.92
buyer_6,Manuel,45,ES79209522434513654615,TRX_N-00413-09709885,2023-01-29T08:43:19,Vitoria-Gasteiz,Expense,leisure,-55.97,-18212.89
buyer_6,Manuel,45,ES79209522434513654615,TRX_N-00414-86733718,2023-02-01T12:18:10,Vitoria-Gasteiz,transfer,Salary,1463.83,-16749.06
buyer_6,Manuel,45,ES79209522434513654615,TRX_N-00415-31706405,2023-02-05T20:56:48,Vitoria-Gasteiz,Housing,Rent,-911.35,-17660.41
buyer_6,Manuel,45,ES79209522434513654615,TRX_N-00416-91968768,2023-02-05T20:34:47,Vitoria-Gasteiz,Basic services,phone,-44.04,-17704.45
buyer_6,Manuel,45,ES79209522434513654615,TRX_N-00417-72058768,2023-02-06T08:05:51,Vitoria-Gasteiz,Basic services,internet,-67.76,-17772.21
buyer_6,Manuel,45,ES79209522434513654615,TRX_N-00418-13145258,2023-02-13T08:12:22,Vitoria-Gasteiz,Expense,leisure,-202.73,-17974.94
buyer_6,Manuel,45,ES79209522434513654615,TRX_N-00419-40055478,2023-02-22T16:13:33,Vitoria-Gasteiz,Expense,transport,-164.19,-18139.13
buyer_6,Manuel,45,ES79209522434513654615,TRX_N-00420-21746616,2023-03-01T17:22:44,Vitoria-Gasteiz,transfer,Salary,1463.83,-16675.3
buyer_6,Manuel,45,ES79209522434513654615,TRX_N-00421-88783654,2023-03-01T17:22:44,Vitoria-Gasteiz,transfer,Extra Income,146.38,-16528.92
buyer_6,Manuel,45,ES79209522434513654615,TRX_N-00422-29141498,2023-03-05T23:13:22,Vitoria-Gasteiz,Housing,Rent,-911.35,-17440.27
buyer_6,Manuel,45,ES79209522434513654615,TRX_N-00423-39567444,2023-03-05T22:30:46,Vitoria-Gasteiz,Basic services,gas,-72.05,-17512.32
buyer_6,Manuel,45,ES79209522434513654615,TRX_N-00424-87363186,2023-03-05T01:30:22,Vitoria-Gasteiz,Expense,appliances,-1126.15,-18638.47
buyer_6,Manuel,45,ES79209522434513654615,TRX_N-00425-76601483,2023-03-06T19:59:49,Vitoria-Gasteiz,Basic services,water,-61.25,-18699.72
buyer_6,Manuel,45,ES79209522434513654615,TRX_N-00426-62071720,2023-03-06T10:34:54,Vitoria-Gasteiz,Basic services,internet,-53.75,-18753.47
buyer_6,Manuel,45,ES79209522434513654615,TRX_N-00427-75407822,2023-03-07T15:47:58,Vitoria-Gasteiz,Basic services,water,-60.34,-18813.81
buyer_6,Manuel,45,ES79209522434513654615,TRX_N-00428-30718149,2023-03-07T20:13:38,Vitoria-Gasteiz,Basic services,gas,-57.33,-18871.14
buyer_6,Manuel,45,ES79209522434513654615,TRX_N-00429-67906432,2023-04-01T14:45:45,Vitoria-Gasteiz,transfer,Salary,1463.83,-17407.31
buyer_6,Manuel,45,ES79209522434513654615,TRX_N-00430-79224712,2023-04-02T12:24:51,Vitoria-Gasteiz,Expense,leisure,-295.54,-17702.85
buyer_6,Manuel,45,ES79209522434513654615,TRX_N-00431-77150957,2023-04-05T14:14:44,Vitoria-Gasteiz,Housing,Rent,-911.35,-18614.2
buyer_6,Manuel,45,ES79209522434513654615,TRX_N-00432-34788281,2023-04-05T13:54:55,Vitoria-Gasteiz,Basic services,gas,-93.0,-18707.2
buyer_6,Manuel,45,ES79209522434513654615,TRX_N-00433-96628360,2023-04-06T09:58:31,Vitoria-Gasteiz,Basic services,water,-25.06,-18732.26
buyer_6,Manuel,45,ES79209522434513654615,TRX_N-00434-16287862,2023-04-06T15:55:45,Vitoria-Gasteiz,Basic services,phone,-80.45,-18812.71
buyer_6,Manuel,45,ES79209522434513654615,TRX_N-00435-58342893,2023-04-07T23:40:18,Vitoria-Gasteiz,Basic services,water,-32.17,-18844.88
buyer_6,Manuel,45,ES79209522434513654615,TRX_N-00436-94983847,2023-04-07T17:45:57,Vitoria-Gasteiz,Basic services,electricity,-106.53,-18951.41
buyer_6,Manuel,45,ES79209522434513654615,TRX_N-00437-82235895,2023-04-07T15:20:11,Vitoria-Gasteiz,Basic services,phone,-75.95,-19027.36
buyer_6,Manuel,45,ES79209522434513654615,TRX_N-00438-19654676,2023-04-21T10:34:58,Hondarribia,Expense,education,-261.81,-19289.17
buyer_6,Manuel,45,ES79209522434513654615,TRX_N-00439-42889903,2023-04-23T09:27:03,Lasarte-Oria,Expense,food,-501.82,-19790.99
buyer_6,Manuel,45,ES79209522434513654615,TRX_N-00440-56135944,2023-04-29T08:14:27,Vitoria-Gasteiz,Expense,transport,-147.88,-19938.87
buyer_6,Manuel,45,ES79209522434513654615,TRX_N-00441-25288951,2023-05-01T11:39:56,Vitoria-Gasteiz,transfer,Salary,1463.83,-18475.04
buyer_6,Manuel,45,ES79209522434513654615,TRX_N-00442-88442828,2023-05-01T11:39:56,Vitoria-Gasteiz,transfer,Extra Income,146.38,-18328.66
buyer_6,Manuel,45,ES79209522434513654615,TRX_N-00443-33430278,2023-05-01T10:55:01,Vitoria-Gasteiz,Expense,transport,-110.35,-18439.01
buyer_6,Manuel,45,ES79209522434513654615,TRX_N-00444-21676727,2023-05-05T11:39:28,Vitoria-Gasteiz,Housing,Rent,-911.35,-19350.36
buyer_6,Manuel,45,ES79209522434513654615,TRX_N-00445-39071369,2023-05-05T17:25:18,Vitoria-Gasteiz,Basic services,water,-79.73,-19430.09
buyer_6,Manuel,45,ES79209522434513654615,TRX_N-00446-10261548,2023-05-05T10:21:36,Vitoria-Gasteiz,Basic services,internet,-67.76,-19497.85
buyer_6,Manuel,45,ES79209522434513654615,TRX_N-00447-58004631,2023-05-06T09:26:29,Vitoria-Gasteiz,Basic services,electricity,-121.04,-19618.89
buyer_6,Manuel,45,ES79209522434513654615,TRX_N-00448-49837842,2023-05-06T09:06:09,Vitoria-Gasteiz,Basic services,gas,-37.33,-19656.22
buyer_6,Manuel,45,ES79209522434513654615,TRX_N-00449-95568400,2023-05-06T23:11:53,Vitoria-Gasteiz,Basic services,phone,-32.08,-19688.3
buyer_6,Manuel,45,ES79209522434513654615,TRX_N-00450-96209447,2023-05-07T15:06:42,Vitoria-Gasteiz,Basic services,gas,-19.55,-19707.85
buyer_6,Manuel,45,ES79209522434513654615,TRX_N-00451-62460995,2023-05-14T10:10:08,Vitoria-Gasteiz,Expense,transport,-133.1,-19840.95
buyer_6,Manuel,45,ES79209522434513654615,TRX_N-00452-42583754,2023-05-16T10:26:14,Vitoria-Gasteiz,Expense,healthcare,-342.85,-20183.8
buyer_6,Manuel,45,ES79209522434513654615,TRX_N-00453-22207722,2023-05-19T15:19:45,Vitoria-Gasteiz,Expense,transport,-50.69,-20234.49
buyer_6,Manuel,45,ES79209522434513654615,TRX_N-00454-51386860,2023-05-20T13:32:19,Vitoria-Gasteiz,Expense,healthcare,-346.58,-20581.07
buyer_6,Manuel,45,ES79209522434513654615,TRX_N-00455-57091775,2023-06-01T19:30:00,Vitoria-Gasteiz,transfer,Salary,1463.83,-19117.24
buyer_6,Manuel,45,ES79209522434513654615,TRX_N-00456-01551613,2023-06-01T19:30:00,Vitoria-Gasteiz,transfer,Bonus,1512.95,-17604.29
buyer_6,Manuel,45,ES79209522434513654615,TRX_N-00457-23320868,2023-06-04T19:42:02,Vitoria-Gasteiz,Expense,leisure,-159.49,-17763.78
buyer_6,Manuel,45,ES79209522434513654615,TRX_N-00458-21556140,2023-06-05T11:08:17,Vitoria-Gasteiz,Housing,Rent,-911.35,-18675.13
buyer_6,Manuel,45,ES79209522434513654615,TRX_N-00459-48121465,2023-06-05T15:31:13,Vitoria-Gasteiz,Basic services,electricity,-144.48,-18819.61
buyer_6,Manuel,45,ES79209522434513654615,TRX_N-00460-76930483,2023-06-05T15:06:12,Vitoria-Gasteiz,Basic services,gas,-54.0,-18873.61
buyer_6,Manuel,45,ES79209522434513654615,TRX_N-00461-77056978,2023-06-05T08:57:30,Vitoria-Gasteiz,Basic services,phone,-21.58,-18895.19
buyer_6,Manuel,45,ES79209522434513654615,TRX_N-00462-67719633,2023-06-06T12:12:13,Vitoria-Gasteiz,Basic services,gas,-79.21,-18974.4
buyer_6,Manuel,45,ES79209522434513654615,TRX_N-00463-21300140,2023-06-06T18:44:44,Vitoria-Gasteiz,Basic services,internet,-30.52,-19004.92
buyer_6,Manuel,45,ES79209522434513654615,TRX_N-00464-99750261,2023-06-07T17:03:31,Vitoria-Gasteiz,Basic services,gas,-74.05,-19078.97
buyer_6,Manuel,45,ES79209522434513654615,TRX_N-00465-06425765,2023-06-07T20:29:15,Vitoria-Gasteiz,Basic services,phone,-20.88,-19099.85
buyer_6,Manuel,45,ES79209522434513654615,TRX_N-00466-42611330,2023-06-14T03:02:54,Sopela,Expense,healthcare,-125.08,-19224.93
buyer_6,Manuel,45,ES79209522434513654615,TRX_N-00467-71065776,2023-06-17T12:34:22,Vitoria-Gasteiz,Expense,transport,-82.11,-19307.04
buyer_6,Manuel,45,ES79209522434513654615,TRX_N-00468-10987944,2023-06-25T16:00:29,Vitoria-Gasteiz,Expense,healthcare,-45.93,-19352.97
buyer_6,Manuel,45,ES79209522434513654615,TRX_N-00469-26062887,2023-07-01T14:28:45,Vitoria-Gasteiz,transfer,Salary,1463.83,-17889.14
buyer_6,Manuel,45,ES79209522434513654615,TRX_N-00470-30773617,2023-07-01T14:28:45,Vitoria-Gasteiz,transfer,Extra Income,146.38,-17742.76
buyer_6,Manuel,45,ES79209522434513654615,TRX_N-00471-26824772,2023-07-05T15:39:12,Vitoria-Gasteiz,Housing,Rent,-911.35,-18654.11
buyer_6,Manuel,45,ES79209522434513654615,TRX_N-00472-59725703,2023-07-05T18:56:31,Vitoria-Gasteiz,Basic services,gas,-64.12,-18718.23
buyer_6,Manuel,45,ES79209522434513654615,TRX_N-00473-77535201,2023-07-05T10:32:01,Vitoria-Gasteiz,Basic services,internet,-41.29,-18759.52
buyer_6,Manuel,45,ES79209522434513654615,TRX_N-00474-93118936,2023-07-05T11:38:26,Vitoria-Gasteiz,Expense,leisure,-161.3,-18920.82
buyer_6,Manuel,45,ES79209522434513654615,TRX_N-00475-63944147,2023-07-06T09:40:48,Vitoria-Gasteiz,Basic services,phone,-65.85,-18986.67
buyer_6,Manuel,45,ES79209522434513654615,TRX_N-00476-75503214,2023-07-07T16:44:13,Vitoria-Gasteiz,Expense,transport,-132.31,-19118.98
buyer_6,Manuel,45,ES79209522434513654615,TRX_N-00477-76963366,2023-07-19T08:21:24,Vitoria-Gasteiz,Expense,transport,-39.04,-19158.02
buyer_6,Manuel,45,ES79209522434513654615,TRX_N-00478-28830273,2023-07-29T13:53:18,Sestao,Expense,education,-167.56,-19325.58
buyer_6,Manuel,45,ES79209522434513654615,TRX_N-00479-07720455,2023-08-01T16:01:37,Vitoria-Gasteiz,transfer,Salary,1463.83,-17861.75
buyer_6,Manuel,45,ES79209522434513654615,TRX_N-00480-39276029,2023-08-01T12:13:23,Vitoria-Gasteiz,Expense,healthcare,-352.76,-18214.51
buyer_6,Manuel,45,ES79209522434513654615,TRX_N-00481-17208984,2023-08-05T12:16:55,Vitoria-Gasteiz,Housing,Rent,-911.35,-19125.86
buyer_6,Manuel,45,ES79209522434513654615,TRX_N-00482-88864268,2023-08-06T15:35:20,Vitoria-Gasteiz,Basic services,phone,-99.66,-19225.52
buyer_6,Manuel,45,ES79209522434513654615,TRX_N-00483-48768656,2023-08-07T17:55:06,Vitoria-Gasteiz,Basic services,gas,-82.53,-19308.05
buyer_6,Manuel,45,ES79209522434513654615,TRX_N-00484-22926983,2023-08-16T13:40:51,Vitoria-Gasteiz,Expense,transport,-74.13,-19382.18
buyer_6,Manuel,45,ES79209522434513654615,TRX_N-00485-70264855,2023-08-29T13:30:20,Vitoria-Gasteiz,Expense,clothing,-421.58,-19803.76
buyer_6,Manuel,45,ES79209522434513654615,TRX_N-00486-55065247,2023-09-01T16:53:54,Vitoria-Gasteiz,transfer,Salary,1463.83,-18339.93
buyer_6,Manuel,45,ES79209522434513654615,TRX_N-00487-66514325,2023-09-01T16:53:54,Vitoria-Gasteiz,transfer,Extra Income,146.38,-18193.55
buyer_6,Manuel,45,ES79209522434513654615,TRX_N-00488-64497994,2023-09-01T20:58:23,Vitoria-Gasteiz,Expense,transport,-146.89,-18340.44
buyer_6,Manuel,45,ES79209522434513654615,TRX_N-00489-09123131,2023-09-04T11:57:27,Vitoria-Gasteiz,Expense,leisure,-90.09,-18430.53
buyer_6,Manuel,45,ES79209522434513654615,TRX_N-00490-27985986,2023-09-05T11:52:44,Vitoria-Gasteiz,Housing,Rent,-911.35,-19341.88
buyer_6,Manuel,45,ES79209522434513654615,TRX_N-00491-64440866,2023-09-05T08:56:40,Vitoria-Gasteiz,Basic services,water,-21.78,-19363.66
buyer_6,Manuel,45,ES79209522434513654615,TRX_N-00492-03617653,2023-09-05T19:40:55,Vitoria-Gasteiz,Basic services,phone,-53.06,-19416.72
buyer_6,Manuel,45,ES79209522434513654615,TRX_N-00493-66612399,2023-09-06T03:46:13,Vitoria-Gasteiz,Basic services,electricity,-54.33,-19471.05
buyer_6,Manuel,45,ES79209522434513654615,TRX_N-00494-22303164,2023-09-06T19:28:58,Vitoria-Gasteiz,Basic services,phone,-44.38,-19515.43
buyer_6,Manuel,45,ES79209522434513654615,TRX_N-00495-04482155,2023-09-07T14:24:07,Vitoria-Gasteiz,Basic services,water,-24.17,-19539.6
buyer_6,Manuel,45,ES79209522434513654615,TRX_N-00496-99372713,2023-09-21T13:52:39,Vitoria-Gasteiz,Expense,food,-320.88,-19860.48
buyer_6,Manuel,45,ES79209522434513654615,TRX_N-00497-42143858,2023-09-25T17:20:14,Vitoria-Gasteiz,Expense,food,-593.59,-20454.07
buyer_6,Manuel,45,ES79209522434513654615,TRX_N-00498-45447076,2023-09-26T17:01:00,Vitoria-Gasteiz,Expense,food,-364.7,-20818.77
buyer_6,Manuel,45,ES79209522434513654615,TRX_N-00499-64276757,2023-09-30T18:04:54,Vitoria-Gasteiz,Expense,education,-812.95,-21631.72
buyer_6,Manuel,45,ES79209522434513654615,TRX_N-00500-79437945,2023-10-01T15:04:51,Vitoria-Gasteiz,transfer,Salary,1463.83,-20167.89
buyer_6,Manuel,45,ES79209522434513654615,TRX_N-00501-34411395,2023-10-01T11:54:47,Vitoria-Gasteiz,Expense,clothing,-315.62,-20483.51
buyer_6,Manuel,45,ES79209522434513654615,TRX_N-00502-36910399,2023-10-05T16:41:46,Vitoria-Gasteiz,Housing,Rent,-911.35,-21394.86
buyer_6,Manuel,45,ES79209522434513654615,TRX_N-00503-84725147,2023-10-05T12:55:39,Vitoria-Gasteiz,Basic services,water,-53.48,-21448.34
buyer_6,Manuel,45,ES79209522434513654615,TRX_N-00504-05431518,2023-10-05T14:39:42,Vitoria-Gasteiz,Basic services,phone,-41.62,-21489.96
buyer_6,Manuel,45,ES79209522434513654615,TRX_N-00505-27397159,2023-10-06T13:15:42,Vitoria-Gasteiz,Basic services,water,-48.51,-21538.47
buyer_6,Manuel,45,ES79209522434513654615,TRX_N-00506-86142208,2023-10-06T05:55:42,Vitoria-Gasteiz,Basic services,electricity,-55.18,-21593.65
buyer_6,Manuel,45,ES79209522434513654615,TRX_N-00507-49214852,2023-10-06T20:39:55,Vitoria-Gasteiz,Basic services,internet,-53.97,-21647.62
buyer_6,Manuel,45,ES79209522434513654615,TRX_N-00508-95521225,2023-10-07T22:19:59,Vitoria-Gasteiz,Basic services,electricity,-36.07,-21683.69
buyer_6,Manuel,45,ES79209522434513654615,TRX_N-00509-16071069,2023-10-08T14:48:57,Vitoria-Gasteiz,Expense,travel,-1444.39,-23128.08
buyer_6,Manuel,45,ES79209522434513654615,TRX_N-00510-64456193,2023-10-23T11:51:06,Vitoria-Gasteiz,Expense,transport,-67.18,-23195.26
buyer_6,Manuel,45,ES79209522434513654615,TRX_N-00511-90654837,2023-10-24T23:55:37,Vitoria-Gasteiz,Expense,education,-757.97,-23953.23
buyer_6,Manuel,45,ES79209522434513654615,TRX_N-00512-88930697,2023-10-27T14:18:15,Vitoria-Gasteiz,Expense,healthcare,-317.3,-24270.53
buyer_6,Manuel,45,ES79209522434513654615,TRX_N-00513-85478591,2023-11-01T17:55:32,Vitoria-Gasteiz,transfer,Salary,1463.83,-22806.7
buyer_6,Manuel,45,ES79209522434513654615,TRX_N-00514-74804633,2023-11-01T17:55:32,Vitoria-Gasteiz,transfer,Extra Income,146.38,-22660.32
buyer_6,Manuel,45,ES79209522434513654615,TRX_N-00515-53918769,2023-11-02T11:23:06,Vitoria-Gasteiz,Expense,food,-485.41,-23145.73
buyer_6,Manuel,45,ES79209522434513654615,TRX_N-00516-70225394,2023-11-05T08:05:13,Vitoria-Gasteiz,Housing,Rent,-911.35,-24057.08
buyer_6,Manuel,45,ES79209522434513654615,TRX_N-00517-82268788,2023-11-05T17:25:21,Vitoria-Gasteiz,Basic services,water,-55.97,-24113.05
buyer_6,Manuel,45,ES79209522434513654615,TRX_N-00518-43705387,2023-11-05T15:14:00,Vitoria-Gasteiz,Basic services,gas,-17.18,-24130.23
buyer_6,Manuel,45,ES79209522434513654615,TRX_N-00519-78078680,2023-11-06T19:05:24,Vitoria-Gasteiz,Basic services,water,-67.66,-24197.89
buyer_6,Manuel,45,ES79209522434513654615,TRX_N-00520-36908785,2023-11-07T15:14:27,Vitoria-Gasteiz,Basic services,water,-56.89,-24254.78
buyer_6,Manuel,45,ES79209522434513654615,TRX_N-00521-10604339,2023-11-23T16:10:51,Irun,Expense,food,-465.02,-24719.8
buyer_6,Manuel,45,ES79209522434513654615,TRX_N-00522-25563710,2023-12-01T16:56:59,Vitoria-Gasteiz,transfer,Salary,1463.83,-23255.97
buyer_6,Manuel,45,ES79209522434513654615,TRX_N-00523-09736151,2023-12-01T16:56:59,Vitoria-Gasteiz,transfer,Bonus,1595.99,-21659.98
buyer_6,Manuel,45,ES79209522434513654615,TRX_N-00524-31109538,2023-12-04T09:15:36,Vitoria-Gasteiz,Expense,gifts,-34.98,-21694.96
buyer_6,Manuel,45,ES79209522434513654615,TRX_N-00525-31853992,2023-12-05T09:40:18,Vitoria-Gasteiz,Housing,Rent,-911.35,-22606.31
buyer_6,Manuel,45,ES79209522434513654615,TRX_N-00526-19638901,2023-12-05T12:54:02,Vitoria-Gasteiz,Basic services,electricity,-30.18,-22636.49
buyer_6,Manuel,45,ES79209522434513654615,TRX_N-00527-80383801,2023-12-05T05:51:50,Vitoria-Gasteiz,Basic services,internet,-49.0,-22685.49
buyer_6,Manuel,45,ES79209522434513654615,TRX_N-00528-99798117,2023-12-05T14:00:54,Vitoria-Gasteiz,Basic services,phone,-66.46,-22751.95
buyer_6,Manuel,45,ES79209522434513654615,TRX_N-00529-29962257,2023-12-06T08:57:48,Vitoria-Gasteiz,Basic services,electricity,-68.18,-22820.13
buyer_6,Manuel,45,ES79209522434513654615,TRX_N-00530-36002296,2023-12-06T09:01:14,Vitoria-Gasteiz,Expense,food,-515.48,-23335.61
buyer_6,Manuel,45,ES79209522434513654615,TRX_N-00531-19376264,2023-12-07T13:46:07,Vitoria-Gasteiz,Basic services,internet,-47.06,-23382.67
buyer_6,Manuel,45,ES79209522434513654615,TRX_N-00532-78212695,2023-12-24T23:10:02,Vitoria-Gasteiz,Expense,transport,-21.87,-23404.54
buyer_6,Manuel,45,ES79209522434513654615,TRX_N-00533-25595846,2023-12-26T15:05:49,Vitoria-Gasteiz,Expense,clothing,-311.97,-23716.51
buyer_6,Manuel,45,ES79209522434513654615,TRX_N-00534-15668876,2024-01-01T18:21:23,Vitoria-Gasteiz,transfer,Salary,1463.83,-22252.68
buyer_6,Manuel,45,ES79209522434513654615,TRX_N-00535-08068504,2024-01-01T18:21:23,Vitoria-Gasteiz,transfer,Extra Income,146.38,-22106.3
buyer_6,Manuel,45,ES79209522434513654615,TRX_N-00536-14268428,2024-01-04T15:17:14,Vitoria-Gasteiz,Expense,repairs,-647.49,-22753.79
buyer_6,Manuel,45,ES79209522434513654615,TRX_N-00537-74606210,2024-01-05T23:22:29,Vitoria-Gasteiz,Housing,Rent,-911.35,-23665.14
buyer_6,Manuel,45,ES79209522434513654615,TRX_N-00538-36594581,2024-01-05T14:31:38,Vitoria-Gasteiz,Basic services,water,-75.42,-23740.56
buyer_6,Manuel,45,ES79209522434513654615,TRX_N-00539-36274631,2024-01-05T09:23:37,Vitoria-Gasteiz,Basic services,internet,-64.94,-23805.5
buyer_6,Manuel,45,ES79209522434513654615,TRX_N-00540-15446359,2024-01-05T12:19:36,Vitoria-Gasteiz,Basic services,phone,-20.84,-23826.34
buyer_6,Manuel,45,ES79209522434513654615,TRX_N-00541-07721918,2024-01-06T12:46:08,Vitoria-Gasteiz,Basic services,internet,-70.63,-23896.97
buyer_6,Manuel,45,ES79209522434513654615,TRX_N-00542-25849307,2024-01-06T17:09:10,Mungia,Expense,transport,-46.91,-23943.88
buyer_6,Manuel,45,ES79209522434513654615,TRX_N-00543-13780529,2024-01-07T16:44:25,Vitoria-Gasteiz,Basic services,internet,-78.94,-24022.82
buyer_6,Manuel,45,ES79209522434513654615,TRX_N-00544-62881463,2024-01-13T12:05:13,Vitoria-Gasteiz,Expense,food,-693.69,-24716.51
buyer_6,Manuel,45,ES79209522434513654615,TRX_N-00545-73349893,2024-01-20T09:44:28,Llodio,Expense,clothing,-482.19,-25198.7
buyer_6,Manuel,45,ES79209522434513654615,TRX_N-00546-68288842,2024-01-28T20:41:52,Vitoria-Gasteiz,Expense,transport,-31.17,-25229.87
buyer_6,Manuel,45,ES79209522434513654615,TRX_N-00547-33124564,2024-02-01T21:47:45,Vitoria-Gasteiz,transfer,Salary,1463.83,-23766.04
buyer_6,Manuel,45,ES79209522434513654615,TRX_N-00548-77927087,2024-02-05T17:45:44,Vitoria-Gasteiz,Housing,Rent,-911.35,-24677.39
buyer_6,Manuel,45,ES79209522434513654615,TRX_N-00549-19461764,2024-02-05T12:49:33,Vitoria-Gasteiz,Basic services,internet,-75.95,-24753.34
buyer_6,Manuel,45,ES79209522434513654615,TRX_N-00550-64866891,2024-02-05T08:37:11,Vitoria-Gasteiz,Basic services,phone,-41.81,-24795.15
buyer_6,Manuel,45,ES79209522434513654615,TRX_N-00551-57083182,2024-02-07T13:33:30,Vitoria-Gasteiz,Basic services,electricity,-136.04,-24931.19
buyer_6,Manuel,45,ES79209522434513654615,TRX_N-00552-10160501,2024-02-07T09:39:36,Vitoria-Gasteiz,Basic services,internet,-50.3,-24981.49
buyer_6,Manuel,45,ES79209522434513654615,TRX_N-00553-53032300,2024-02-13T21:04:46,Vitoria-Gasteiz,Expense,food,-792.67,-25774.16
buyer_6,Manuel,45,ES79209522434513654615,TRX_N-00554-55361166,2024-02-14T09:47:10,Vitoria-Gasteiz,Expense,food,-178.88,-25953.04
buyer_6,Manuel,45,ES79209522434513654615,TRX_N-00555-59482480,2024-02-16T19:26:05,Vitoria-Gasteiz,Expense,transport,-172.89,-26125.93
buyer_6,Manuel,45,ES79209522434513654615,TRX_N-00556-00319957,2024-02-29T20:04:03,Vitoria-Gasteiz,Expense,repairs,-984.86,-27110.79
buyer_6,Manuel,45,ES79209522434513654615,TRX_N-00557-99798762,2024-03-01T16:11:48,Vitoria-Gasteiz,transfer,Salary,1463.83,-25646.96
buyer_6,Manuel,45,ES79209522434513654615,TRX_N-00558-71318999,2024-03-05T15:51:44,Vitoria-Gasteiz,Housing,Rent,-911.35,-26558.31
buyer_6,Manuel,45,ES79209522434513654615,TRX_N-00559-48821132,2024-03-05T09:59:30,Vitoria-Gasteiz,Basic services,phone,-84.18,-26642.49
buyer_6,Manuel,45,ES79209522434513654615,TRX_N-00560-17553761,2024-03-06T14:03:44,Vitoria-Gasteiz,Basic services,electricity,-147.84,-26790.33
buyer_6,Manuel,45,ES79209522434513654615,TRX_N-00561-48908204,2024-03-06T19:28:19,Vitoria-Gasteiz,Basic services,internet,-60.14,-26850.47
buyer_6,Manuel,45,ES79209522434513654615,TRX_N-00562-70670855,2024-03-06T20:29:36,Vitoria-Gasteiz,Expense,food,-147.21,-26997.68
buyer_6,Manuel,45,ES79209522434513654615,TRX_N-00563-73585756,2024-03-06T20:19:05,Vitoria-Gasteiz,Expense,transport,-140.1,-27137.78
buyer_6,Manuel,45,ES79209522434513654615,TRX_N-00564-59240191,2024-03-07T10:45:23,Vitoria-Gasteiz,Basic services,water,-18.37,-27156.15
buyer_6,Manuel,45,ES79209522434513654615,TRX_N-00565-19856143,2024-03-07T04:41:31,Vitoria-Gasteiz,Basic services,electricity,-148.39,-27304.54
buyer_6,Manuel,45,ES79209522434513654615,TRX_N-00566-24865341,2024-03-12T17:19:15,Vitoria-Gasteiz,Expense,gifts,-65.81,-27370.35
buyer_6,Manuel,45,ES79209522434513654615,TRX_N-00567-18843999,2024-03-14T10:20:12,Vitoria-Gasteiz,Expense,leisure,-209.89,-27580.24
buyer_6,Manuel,45,ES79209522434513654615,TRX_N-00568-59599462,2024-03-14T21:30:02,Vitoria-Gasteiz,Expense,clothing,-426.94,-28007.18
buyer_6,Manuel,45,ES79209522434513654615,TRX_N-00569-96937256,2024-03-17T11:40:06,Vitoria-Gasteiz,Expense,repairs,-577.19,-28584.37
buyer_6,Manuel,45,ES79209522434513654615,TRX_N-00570-31419838,2024-03-18T20:36:52,Vitoria-Gasteiz,Expense,clothing,-401.57,-28985.94
buyer_6,Manuel,45,ES79209522434513654615,TRX_N-00571-12361670,2024-03-25T18:33:00,Vitoria-Gasteiz,Expense,healthcare,-237.1,-29223.04
buyer_6,Manuel,45,ES79209522434513654615,TRX_N-00572-85349563,2024-04-01T12:52:12,Vitoria-Gasteiz,transfer,Salary,1463.83,-27759.21
buyer_6,Manuel,45,ES79209522434513654615,TRX_N-00573-24176117,2024-04-01T12:52:12,Vitoria-Gasteiz,transfer,Extra Income,146.38,-27612.83
buyer_6,Manuel,45,ES79209522434513654615,TRX_N-00574-95600492,2024-04-04T19:32:00,Vitoria-Gasteiz,Expense,appliances,-1645.81,-29258.64
buyer_6,Manuel,45,ES79209522434513654615,TRX_N-00575-96292407,2024-04-05T11:52:37,Vitoria-Gasteiz,Housing,Rent,-911.35,-30169.99
buyer_6,Manuel,45,ES79209522434513654615,TRX_N-00576-06985058,2024-04-05T15:20:11,Vitoria-Gasteiz,Basic services,water,-32.05,-30202.04
buyer_6,Manuel,45,ES79209522434513654615,TRX_N-00577-98394213,2024-04-05T09:37:38,Vitoria-Gasteiz,Basic services,gas,-46.66,-30248.7
buyer_6,Manuel,45,ES79209522434513654615,TRX_N-00578-76988180,2024-04-05T11:15:45,Vitoria-Gasteiz,Basic services,phone,-91.02,-30339.72
buyer_6,Manuel,45,ES79209522434513654615,TRX_N-00579-16206842,2024-04-06T23:48:43,Vitoria-Gasteiz,Basic services,electricity,-109.47,-30449.19
buyer_6,Manuel,45,ES79209522434513654615,TRX_N-00580-06106640,2024-04-06T17:24:18,Vitoria-Gasteiz,Basic services,phone,-71.31,-30520.5
buyer_6,Manuel,45,ES79209522434513654615,TRX_N-00581-47262919,2024-04-07T14:29:36,Vitoria-Gasteiz,Basic services,electricity,-57.48,-30577.98
buyer_6,Manuel,45,ES79209522434513654615,TRX_N-00582-09222896,2024-04-10T17:47:57,Llodio,Expense,healthcare,-25.83,-30603.81
buyer_6,Manuel,45,ES79209522434513654615,TRX_N-00583-22129430,2024-04-18T13:20:52,Vitoria-Gasteiz,Expense,food,-638.01,-31241.82
buyer_6,Manuel,45,ES79209522434513654615,TRX_N-00584-88775504,2024-04-18T12:18:35,Getxo,Expense,clothing,-76.35,-31318.17
buyer_6,Manuel,45,ES79209522434513654615,TRX_N-00585-53623758,2024-05-01T12:46:58,Vitoria-Gasteiz,transfer,Salary,1463.83,-29854.34
buyer_6,Manuel,45,ES79209522434513654615,TRX_N-00586-32339447,2024-05-05T17:21:50,Vitoria-Gasteiz,Housing,Rent,-911.35,-30765.69
buyer_6,Manuel,45,ES79209522434513654615,TRX_N-00587-50570530,2024-05-05T15:56:45,Vitoria-Gasteiz,Basic services,electricity,-72.77,-30838.46
buyer_6,Manuel,45,ES79209522434513654615,TRX_N-00588-02744066,2024-05-05T11:47:25,Vitoria-Gasteiz,Basic services,gas,-34.0,-30872.46
buyer_6,Manuel,45,ES79209522434513654615,TRX_N-00589-90996820,2024-05-05T22:06:49,Vitoria-Gasteiz,Basic services,internet,-76.22,-30948.68
buyer_6,Manuel,45,ES79209522434513654615,TRX_N-00590-61693777,2024-05-05T16:25:26,Vitoria-Gasteiz,Expense,food,-532.27,-31480.95
buyer_6,Manuel,45,ES79209522434513654615,TRX_N-00591-26770484,2024-05-06T10:52:37,Vitoria-Gasteiz,Basic services,water,-47.2,-31528.15
buyer_6,Manuel,45,ES79209522434513654615,TRX_N-00592-83772731,2024-05-06T19:33:25,Vitoria-Gasteiz,Basic services,electricity,-71.22,-31599.37
buyer_6,Manuel,45,ES79209522434513654615,TRX_N-00593-87576342,2024-05-06T19:45:08,Vitoria-Gasteiz,Basic services,gas,-67.36,-31666.73
buyer_6,Manuel,45,ES79209522434513654615,TRX_N-00594-23922997,2024-05-06T12:03:20,Vitoria-Gasteiz,Basic services,internet,-41.96,-31708.69
buyer_6,Manuel,45,ES79209522434513654615,TRX_N-00595-49306208,2024-05-07T08:21:15,Vitoria-Gasteiz,Basic services,internet,-40.38,-31749.07
buyer_6,Manuel,45,ES79209522434513654615,TRX_N-00596-29875353,2024-05-08T07:25:52,Vitoria-Gasteiz,Expense,transport,-42.01,-31791.08
buyer_6,Manuel,45,ES79209522434513654615,TRX_N-00597-59392382,2024-05-21T19:11:07,Vitoria-Gasteiz,Expense,transport,-199.26,-31990.34
buyer_6,Manuel,45,ES79209522434513654615,TRX_N-00598-11341351,2024-05-23T15:24:24,Vitoria-Gasteiz,Expense,gifts,-69.38,-32059.72
buyer_6,Manuel,45,ES79209522434513654615,TRX_N-00599-96667896,2024-05-25T10:29:55,Vitoria-Gasteiz,Expense,transport,-100.83,-32160.55
buyer_6,Manuel,45,ES79209522434513654615,TRX_N-00600-68805147,2024-06-01T13:59:17,Vitoria-Gasteiz,transfer,Salary,1463.83,-30696.72
buyer_6,Manuel,45,ES79209522434513654615,TRX_N-00601-63713577,2024-06-01T13:59:17,Vitoria-Gasteiz,transfer,Extra Income,146.38,-30550.34
buyer_6,Manuel,45,ES79209522434513654615,TRX_N-00602-73371707,2024-06-01T13:59:17,Vitoria-Gasteiz,transfer,Bonus,1527.64,-29022.7
buyer_6,Manuel,45,ES79209522434513654615,TRX_N-00603-20460392,2024-06-05T15:59:15,Vitoria-Gasteiz,Housing,Rent,-911.35,-29934.05
buyer_6,Manuel,45,ES79209522434513654615,TRX_N-00604-38543713,2024-06-05T15:00:24,Vitoria-Gasteiz,Basic services,water,-63.13,-29997.18
buyer_6,Manuel,45,ES79209522434513654615,TRX_N-00605-57152819,2024-06-05T13:35:20,Vitoria-Gasteiz,Basic services,phone,-41.62,-30038.8
buyer_6,Manuel,45,ES79209522434513654615,TRX_N-00606-72703475,2024-06-06T13:41:47,Vitoria-Gasteiz,Basic services,electricity,-55.81,-30094.61
buyer_6,Manuel,45,ES79209522434513654615,TRX_N-00607-82190523,2024-06-06T15:49:39,Vitoria-Gasteiz,Basic services,phone,-64.78,-30159.39
buyer_6,Manuel,45,ES79209522434513654615,TRX_N-00608-76762199,2024-06-06T18:59:28,Arrasate,Expense,food,-792.32,-30951.71
buyer_6,Manuel,45,ES79209522434513654615,TRX_N-00609-26317883,2024-06-07T16:28:58,Vitoria-Gasteiz,Expense,leisure,-267.35,-31219.06
buyer_6,Manuel,45,ES79209522434513654615,TRX_N-00610-75152924,2024-06-17T18:36:58,Vitoria-Gasteiz,Expense,transport,-77.41,-31296.47
buyer_6,Manuel,45,ES79209522434513654615,TRX_N-00611-49507559,2024-06-18T08:09:40,Vitoria-Gasteiz,Expense,gifts,-487.4,-31783.87
buyer_6,Manuel,45,ES79209522434513654615,TRX_N-00612-46379550,2024-06-21T12:53:17,Vitoria-Gasteiz,Expense,food,-542.92,-32326.79
buyer_6,Manuel,45,ES79209522434513654615,TRX_N-00613-71149905,2024-06-29T20:35:25,Vitoria-Gasteiz,Expense,food,-486.77,-32813.56
buyer_6,Manuel,45,ES79209522434513654615,TRX_N-00614-28151159,2024-07-01T01:43:38,Vitoria-Gasteiz,transfer,Salary,1463.83,-31349.73
buyer_6,Manuel,45,ES79209522434513654615,TRX_N-00615-33297458,2024-07-05T18:15:12,Vitoria-Gasteiz,Housing,Rent,-911.35,-32261.08
buyer_6,Manuel,45,ES79209522434513654615,TRX_N-00616-31298678,2024-07-05T12:36:58,Vitoria-Gasteiz,Basic services,internet,-68.56,-32329.64
buyer_6,Manuel,45,ES79209522434513654615,TRX_N-00617-19476994,2024-07-06T18:17:02,Vitoria-Gasteiz,Basic services,gas,-76.93,-32406.57
buyer_6,Manuel,45,ES79209522434513654615,TRX_N-00618-30089272,2024-07-07T14:07:53,Vitoria-Gasteiz,Basic services,internet,-71.37,-32477.94
buyer_6,Manuel,45,ES79209522434513654615,TRX_N-00619-48968168,2024-07-07T17:16:03,Vitoria-Gasteiz,Expense,transport,-130.69,-32608.63
buyer_6,Manuel,45,ES79209522434513654615,TRX_N-00620-89642866,2024-07-22T15:12:35,Vitoria-Gasteiz,Expense,clothing,-494.27,-33102.9
buyer_6,Manuel,45,ES79209522434513654615,TRX_N-00621-62352062,2024-07-29T20:53:56,Vitoria-Gasteiz,Expense,appliances,-914.89,-34017.79
buyer_6,Manuel,45,ES79209522434513654615,TRX_N-00622-59486301,2024-08-01T08:00:42,Vitoria-Gasteiz,transfer,Salary,1463.83,-32553.96
buyer_6,Manuel,45,ES79209522434513654615,TRX_N-00623-70965073,2024-08-05T05:32:19,Vitoria-Gasteiz,Housing,Rent,-911.35,-33465.31
buyer_6,Manuel,45,ES79209522434513654615,TRX_N-00624-55650542,2024-08-05T19:06:52,Vitoria-Gasteiz,Basic services,water,-36.55,-33501.86
buyer_6,Manuel,45,ES79209522434513654615,TRX_N-00625-95328381,2024-08-06T20:10:23,Vitoria-Gasteiz,Basic services,water,-50.71,-33552.57
buyer_6,Manuel,45,ES79209522434513654615,TRX_N-00626-42072837,2024-08-06T19:06:52,Vitoria-Gasteiz,Basic services,electricity,-21.47,-33574.04
buyer_6,Manuel,45,ES79209522434513654615,TRX_N-00627-61958148,2024-08-16T12:48:25,Vitoria-Gasteiz,Expense,transport,-78.66,-33652.7
buyer_6,Manuel,45,ES79209522434513654615,TRX_N-00628-90806239,2024-08-24T08:18:51,Vitoria-Gasteiz,Expense,food,-606.85,-34259.55
buyer_6,Manuel,45,ES79209522434513654615,TRX_N-00629-65467779,2024-09-01T13:52:36,Vitoria-Gasteiz,transfer,Salary,1463.83,-32795.72
buyer_6,Manuel,45,ES79209522434513654615,TRX_N-00630-08573020,2024-09-01T13:52:36,Vitoria-Gasteiz,transfer,Extra Income,146.38,-32649.34
buyer_6,Manuel,45,ES79209522434513654615,TRX_N-00631-34681337,2024-09-05T09:38:48,Vitoria-Gasteiz,Housing,Rent,-911.35,-33560.69
buyer_6,Manuel,45,ES79209522434513654615,TRX_N-00632-38940394,2024-09-05T19:21:42,Vitoria-Gasteiz,Basic services,electricity,-58.61,-33619.3
buyer_6,Manuel,45,ES79209522434513654615,TRX_N-00633-72302537,2024-09-05T19:27:17,Vitoria-Gasteiz,Basic services,phone,-49.71,-33669.01
buyer_6,Manuel,45,ES79209522434513654615,TRX_N-00634-11467505,2024-09-06T15:19:40,Vitoria-Gasteiz,Basic services,water,-44.31,-33713.32
buyer_6,Manuel,45,ES79209522434513654615,TRX_N-00635-48493070,2024-09-06T00:37:33,Vitoria-Gasteiz,Expense,food,-148.96,-33862.28
buyer_6,Manuel,45,ES79209522434513654615,TRX_N-00636-10600134,2024-09-07T13:25:46,Vitoria-Gasteiz,Basic services,water,-16.58,-33878.86
buyer_6,Manuel,45,ES79209522434513654615,TRX_N-00637-51438475,2024-09-09T13:19:40,Vitoria-Gasteiz,Expense,education,-380.06,-34258.92
buyer_6,Manuel,45,ES79209522434513654615,TRX_N-00638-68834456,2024-09-15T12:42:37,Vitoria-Gasteiz,Expense,transport,-168.94,-34427.86
buyer_6,Manuel,45,ES79209522434513654615,TRX_N-00639-92744874,2024-09-19T14:20:11,Vitoria-Gasteiz,Expense,healthcare,-282.75,-34710.61
buyer_6,Manuel,45,ES79209522434513654615,TRX_N-00640-03337525,2024-10-01T20:14:00,Vitoria-Gasteiz,transfer,Salary,1463.83,-33246.78
buyer_6,Manuel,45,ES79209522434513654615,TRX_N-00641-71018640,2024-10-05T12:16:06,Vitoria-Gasteiz,Housing,Rent,-911.35,-34158.13
buyer_6,Manuel,45,ES79209522434513654615,TRX_N-00642-58074348,2024-10-05T09:17:28,Vitoria-Gasteiz,Basic services,phone,-67.56,-34225.69
buyer_7,María,56,ES44209539382171952129,TRX_N-00001-81728648,2020-01-01T22:52:00,Portugalete,transfer,Salary,3324.96,13455.01
buyer_7,María,56,ES44209539382171952129,TRX_N-00002-84939131,2020-01-01T22:52:00,Portugalete,transfer,Partner Salary,3441.05,16896.06
buyer_7,María,56,ES44209539382171952129,TRX_N-00003-72274661,2020-01-05T11:38:43,Portugalete,Housing,Mortgage,-553.82,16342.24
buyer_7,María,56,ES44209539382171952129,TRX_N-00004-57974067,2020-01-05T12:52:12,Portugalete,Basic services,water,-57.09,16285.15
buyer_7,María,56,ES44209539382171952129,TRX_N-00005-44746843,2020-01-07T11:32:45,Portugalete,Basic services,electricity,-88.91,16196.24
buyer_7,María,56,ES44209539382171952129,TRX_N-00006-51762094,2020-01-07T23:04:11,Galdakao,Expense,clothing,-153.99,16042.25
buyer_7,María,56,ES44209539382171952129,TRX_N-00007-69706309,2020-01-18T11:24:35,Portugalete,Expense,food,-509.33,15532.92
buyer_7,María,56,ES44209539382171952129,TRX_N-00008-46404279,2020-01-21T18:07:38,Getxo,Expense,food,-121.84,15411.08
buyer_7,María,56,ES44209539382171952129,TRX_N-00009-18131491,2020-01-23T17:03:46,Elciego,Expense,clothing,-185.11,15225.97
buyer_7,María,56,ES44209539382171952129,TRX_N-00010-29975347,2020-02-01T12:38:23,Portugalete,transfer,Salary,3324.96,18550.93
buyer_7,María,56,ES44209539382171952129,TRX_N-00011-36483870,2020-02-01T12:38:23,Portugalete,transfer,Partner Salary,3441.05,21991.98
buyer_7,María,56,ES44209539382171952129,TRX_N-00012-86414182,2020-02-01T12:38:23,Portugalete,transfer,Extra Income,332.5,22324.48
buyer_7,María,56,ES44209539382171952129,TRX_N-00013-69744351,2020-02-05T17:44:15,Portugalete,Housing,Mortgage,-553.82,21770.66
buyer_7,María,56,ES44209539382171952129,TRX_N-00014-83319282,2020-02-05T14:42:24,Portugalete,Basic services,internet,-61.73,21708.93
buyer_7,María,56,ES44209539382171952129,TRX_N-00015-62756999,2020-02-05T07:11:37,Portugalete,Basic services,phone,-30.24,21678.69
buyer_7,María,56,ES44209539382171952129,TRX_N-00016-02008071,2020-02-05T14:21:23,Portugalete,Expense,food,-619.31,21059.38
buyer_7,María,56,ES44209539382171952129,TRX_N-00017-64193801,2020-02-05T13:09:07,Errenteria,Expense,gifts,-266.13,20793.25
buyer_7,María,56,ES44209539382171952129,TRX_N-00018-61886624,2020-02-06T11:09:21,Portugalete,Basic services,phone,-31.57,20761.68
buyer_7,María,56,ES44209539382171952129,TRX_N-00019-92603598,2020-02-07T14:16:19,Portugalete,Basic services,phone,-32.3,20729.38
buyer_7,María,56,ES44209539382171952129,TRX_N-00020-84378284,2020-02-08T18:48:00,Portugalete,Expense,clothing,-472.89,20256.49
buyer_7,María,56,ES44209539382171952129,TRX_N-00021-62119517,2020-02-11T17:20:41,Portugalete,Expense,transport,-88.93,20167.56
buyer_7,María,56,ES44209539382171952129,TRX_N-00022-41664936,2020-02-14T17:18:17,Portugalete,Expense,leisure,-250.33,19917.23
buyer_7,María,56,ES44209539382171952129,TRX_N-00023-18605133,2020-02-15T22:02:04,Portugalete,Expense,healthcare,-343.13,19574.1
buyer_7,María,56,ES44209539382171952129,TRX_N-00024-67118694,2020-02-22T10:22:55,Portugalete,Expense,education,-76.71,19497.39
buyer_7,María,56,ES44209539382171952129,TRX_N-00025-02222866,2020-03-01T12:04:13,Portugalete,transfer,Salary,3324.96,22822.35
buyer_7,María,56,ES44209539382171952129,TRX_N-00026-00672592,2020-03-01T12:04:13,Portugalete,transfer,Partner Salary,3441.05,26263.4
buyer_7,María,56,ES44209539382171952129,TRX_N-00027-26143945,2020-03-01T14:07:56,Portugalete,Expense,food,-306.95,25956.45
buyer_7,María,56,ES44209539382171952129,TRX_N-00028-10264676,2020-03-02T21:45:31,Portugalete,Expense,food,-245.05,25711.4
buyer_7,María,56,ES44209539382171952129,TRX_N-00029-21592598,2020-03-03T15:27:34,Portugalete,Expense,leisure,-246.42,25464.98
buyer_7,María,56,ES44209539382171952129,TRX_N-00030-90264476,2020-03-05T10:49:56,Portugalete,Housing,Mortgage,-553.82,24911.16
buyer_7,María,56,ES44209539382171952129,TRX_N-00031-00063258,2020-03-05T09:06:00,Portugalete,Basic services,water,-28.1,24883.06
buyer_7,María,56,ES44209539382171952129,TRX_N-00032-49372782,2020-03-06T11:57:11,Portugalete,Basic services,gas,-87.15,24795.91
buyer_7,María,56,ES44209539382171952129,TRX_N-00033-20565541,2020-03-07T22:10:50,Portugalete,Basic services,gas,-59.77,24736.14
buyer_7,María,56,ES44209539382171952129,TRX_N-00034-34178458,2020-03-07T01:52:47,Portugalete,Basic services,internet,-68.32,24667.82
buyer_7,María,56,ES44209539382171952129,TRX_N-00035-19930017,2020-03-07T13:26:22,Portugalete,Basic services,phone,-80.97,24586.85
buyer_7,María,56,ES44209539382171952129,TRX_N-00036-31792296,2020-04-01T13:00:31,Portugalete,transfer,Salary,3324.96,27911.81
buyer_7,María,56,ES44209539382171952129,TRX_N-00037-91041203,2020-04-01T13:00:31,Portugalete,transfer,Partner Salary,3441.05,31352.86
buyer_7,María,56,ES44209539382171952129,TRX_N-00038-75204108,2020-04-01T13:00:31,Portugalete,transfer,Extra Income,332.5,31685.36
buyer_7,María,56,ES44209539382171952129,TRX_N-00039-03523234,2020-04-05T14:54:32,Portugalete,Housing,Mortgage,-553.82,31131.54
buyer_7,María,56,ES44209539382171952129,TRX_N-00040-45705491,2020-04-05T10:12:45,Portugalete,Basic services,electricity,-23.9,31107.64
buyer_7,María,56,ES44209539382171952129,TRX_N-00041-54926492,2020-04-05T09:00:53,Portugalete,Basic services,internet,-39.37,31068.27
buyer_7,María,56,ES44209539382171952129,TRX_N-00042-48001152,2020-04-05T13:53:19,Portugalete,Basic services,phone,-76.01,30992.26
buyer_7,María,56,ES44209539382171952129,TRX_N-00043-72605184,2020-04-06T16:19:13,Portugalete,Basic services,water,-44.45,30947.81
buyer_7,María,56,ES44209539382171952129,TRX_N-00044-85910647,2020-04-07T19:10:56,Portugalete,Basic services,water,-16.65,30931.16
buyer_7,María,56,ES44209539382171952129,TRX_N-00045-34209467,2020-04-07T20:46:06,Portugalete,Basic services,electricity,-104.13,30827.03
buyer_7,María,56,ES44209539382171952129,TRX_N-00046-02850755,2020-04-07T15:27:37,Portugalete,Basic services,internet,-77.0,30750.03
buyer_7,María,56,ES44209539382171952129,TRX_N-00047-10892032,2020-04-26T15:47:34,Portugalete,Expense,food,-401.56,30348.47
buyer_7,María,56,ES44209539382171952129,TRX_N-00048-33387283,2020-04-27T18:35:18,Portugalete,Expense,food,-646.6,29701.87
buyer_7,María,56,ES44209539382171952129,TRX_N-00049-67451242,2020-04-27T07:38:36,Portugalete,Expense,transport,-49.08,29652.79
buyer_7,María,56,ES44209539382171952129,TRX_N-00050-23339954,2020-05-01T13:12:05,Portugalete,transfer,Salary,3324.96,32977.75
buyer_7,María,56,ES44209539382171952129,TRX_N-00051-25673949,2020-05-01T13:12:05,Portugalete,transfer,Partner Salary,3441.05,36418.8
buyer_7,María,56,ES44209539382171952129,TRX_N-00052-48575586,2020-05-04T11:59:07,Portugalete,Expense,transport,-172.72,36246.08
buyer_7,María,56,ES44209539382171952129,TRX_N-00053-38843771,2020-05-05T11:56:24,Portugalete,Housing,Mortgage,-553.82,35692.26
buyer_7,María,56,ES44209539382171952129,TRX_N-00054-21353739,2020-05-05T22:56:44,Portugalete,Basic services,gas,-60.13,35632.13
buyer_7,María,56,ES44209539382171952129,TRX_N-00055-81795027,2020-05-05T10:31:33,Portugalete,Basic services,phone,-20.56,35611.57
buyer_7,María,56,ES44209539382171952129,TRX_N-00056-20278621,2020-05-07T18:59:35,Portugalete,Basic services,water,-51.21,35560.36
buyer_7,María,56,ES44209539382171952129,TRX_N-00057-84260906,2020-05-07T22:15:36,Portugalete,Basic services,electricity,-86.8,35473.56
buyer_7,María,56,ES44209539382171952129,TRX_N-00058-46604020,2020-05-17T19:32:41,Portugalete,Expense,transport,-115.56,35358.0
buyer_7,María,56,ES44209539382171952129,TRX_N-00059-04681331,2020-05-21T22:24:17,Portugalete,Expense,education,-551.52,34806.48
buyer_7,María,56,ES44209539382171952129,TRX_N-00060-87057619,2020-05-21T14:10:29,Portugalete,Expense,appliances,-1039.1,33767.38
buyer_7,María,56,ES44209539382171952129,TRX_N-00061-97565656,2020-05-28T13:46:33,Portugalete,Expense,food,-261.55,33505.83
buyer_7,María,56,ES44209539382171952129,TRX_N-00062-46563632,2020-06-01T04:32:02,Portugalete,transfer,Salary,3324.96,36830.79
buyer_7,María,56,ES44209539382171952129,TRX_N-00063-29039736,2020-06-01T04:32:02,Portugalete,transfer,Partner Salary,3441.05,40271.84
buyer_7,María,56,ES44209539382171952129,TRX_N-00064-57997350,2020-06-01T04:32:02,Portugalete,transfer,Extra Income,332.5,40604.34
buyer_7,María,56,ES44209539382171952129,TRX_N-00065-52851056,2020-06-01T04:32:02,Portugalete,transfer,Bonus,3467.83,44072.17
buyer_7,María,56,ES44209539382171952129,TRX_N-00066-55312473,2020-06-04T02:46:03,Portugalete,Expense,food,-532.74,43539.43
buyer_7,María,56,ES44209539382171952129,TRX_N-00067-63753390,2020-06-04T18:58:19,Portugalete,Expense,healthcare,-133.4,43406.03
buyer_7,María,56,ES44209539382171952129,TRX_N-00068-64080274,2020-06-05T20:05:05,Portugalete,Housing,Mortgage,-553.82,42852.21
buyer_7,María,56,ES44209539382171952129,TRX_N-00069-16730411,2020-06-05T18:10:16,Portugalete,Basic services,gas,-99.18,42753.03
buyer_7,María,56,ES44209539382171952129,TRX_N-00070-06296704,2020-06-05T14:54:52,Portugalete,Basic services,phone,-43.76,42709.27
buyer_7,María,56,ES44209539382171952129,TRX_N-00071-90682003,2020-06-07T12:18:18,Portugalete,Basic services,internet,-69.2,42640.07
buyer_7,María,56,ES44209539382171952129,TRX_N-00072-55250296,2020-06-08T16:22:58,Portugalete,Expense,healthcare,-350.08,42289.99
buyer_7,María,56,ES44209539382171952129,TRX_N-00073-71908522,2020-06-13T16:47:57,Portugalete,Expense,healthcare,-101.54,42188.45
buyer_7,María,56,ES44209539382171952129,TRX_N-00074-13905592,2020-06-17T13:20:39,Portugalete,Expense,leisure,-221.22,41967.23
buyer_7,María,56,ES44209539382171952129,TRX_N-00075-79317170,2020-06-29T23:29:13,Portugalete,Expense,food,-300.88,41666.35
buyer_7,María,56,ES44209539382171952129,TRX_N-00076-04033192,2020-06-30T13:22:01,Portugalete,Expense,clothing,-260.81,41405.54
buyer_7,María,56,ES44209539382171952129,TRX_N-00077-19970419,2020-07-01T15:52:57,Portugalete,transfer,Salary,3324.96,44730.5
buyer_7,María,56,ES44209539382171952129,TRX_N-00078-53913003,2020-07-01T15:52:57,Portugalete,transfer,Partner Salary,3441.05,48171.55
buyer_7,María,56,ES44209539382171952129,TRX_N-00079-20240049,2020-07-02T10:03:04,Hondarribia,Expense,food,-607.21,47564.34
buyer_7,María,56,ES44209539382171952129,TRX_N-00080-82702799,2020-07-05T11:37:40,Portugalete,Housing,Mortgage,-553.82,47010.52
buyer_7,María,56,ES44209539382171952129,TRX_N-00081-30448057,2020-07-05T11:52:17,Portugalete,Basic services,electricity,-86.59,46923.93
buyer_7,María,56,ES44209539382171952129,TRX_N-00082-04123371,2020-07-05T09:31:07,Portugalete,Basic services,gas,-15.53,46908.4
buyer_7,María,56,ES44209539382171952129,TRX_N-00083-31282324,2020-07-05T17:48:32,Portugalete,Basic services,internet,-72.19,46836.21
buyer_7,María,56,ES44209539382171952129,TRX_N-00084-93104024,2020-07-07T12:17:14,Portugalete,Basic services,internet,-58.49,46777.72
buyer_7,María,56,ES44209539382171952129,TRX_N-00085-23389634,2020-07-08T11:29:13,Portugalete,Expense,transport,-82.75,46694.97
buyer_7,María,56,ES44209539382171952129,TRX_N-00086-61016142,2020-07-18T11:24:43,Oyón-Oion,Expense,clothing,-325.31,46369.66
buyer_7,María,56,ES44209539382171952129,TRX_N-00087-26059398,2020-08-01T03:26:32,Portugalete,transfer,Salary,3324.96,49694.62
buyer_7,María,56,ES44209539382171952129,TRX_N-00088-15921116,2020-08-01T03:26:32,Portugalete,transfer,Partner Salary,3441.05,53135.67
buyer_7,María,56,ES44209539382171952129,TRX_N-00089-37709610,2020-08-01T03:26:32,Portugalete,transfer,Extra Income,332.5,53468.17
buyer_7,María,56,ES44209539382171952129,TRX_N-00090-43454927,2020-08-05T06:17:47,Portugalete,Housing,Mortgage,-553.82,52914.35
buyer_7,María,56,ES44209539382171952129,TRX_N-00091-81590838,2020-08-05T16:31:20,Portugalete,Basic services,gas,-27.28,52887.07
buyer_7,María,56,ES44209539382171952129,TRX_N-00092-27045208,2020-08-05T17:02:39,Portugalete,Basic services,phone,-39.45,52847.62
buyer_7,María,56,ES44209539382171952129,TRX_N-00093-02603360,2020-08-06T20:19:27,Portugalete,Basic services,gas,-28.22,52819.4
buyer_7,María,56,ES44209539382171952129,TRX_N-00094-84888051,2020-08-06T16:59:15,Portugalete,Basic services,internet,-48.84,52770.56
buyer_7,María,56,ES44209539382171952129,TRX_N-00095-73508436,2020-08-06T10:52:11,Portugalete,Basic services,phone,-35.54,52735.02
buyer_7,María,56,ES44209539382171952129,TRX_N-00096-87174267,2020-08-07T16:18:28,Portugalete,Basic services,gas,-56.13,52678.89
buyer_7,María,56,ES44209539382171952129,TRX_N-00097-63304957,2020-08-07T06:02:53,Portugalete,Basic services,internet,-38.07,52640.82
buyer_7,María,56,ES44209539382171952129,TRX_N-00098-87721749,2020-08-07T14:07:53,Portugalete,Basic services,phone,-65.63,52575.19
buyer_7,María,56,ES44209539382171952129,TRX_N-00099-33965788,2020-08-09T11:22:30,Portugalete,Expense,leisure,-179.9,52395.29
buyer_7,María,56,ES44209539382171952129,TRX_N-00100-20179096,2020-08-13T20:13:12,Portugalete,Expense,transport,-37.08,52358.21
buyer_7,María,56,ES44209539382171952129,TRX_N-00101-82861831,2020-09-01T09:18:36,Portugalete,transfer,Salary,3324.96,55683.17
buyer_7,María,56,ES44209539382171952129,TRX_N-00102-97507169,2020-09-01T09:18:36,Portugalete,transfer,Partner Salary,3441.05,59124.22
buyer_7,María,56,ES44209539382171952129,TRX_N-00103-75241046,2020-09-01T10:14:14,Eibar,Expense,transport,-134.67,58989.55
buyer_7,María,56,ES44209539382171952129,TRX_N-00104-92389521,2020-09-02T16:19:09,Portugalete,Expense,food,-712.43,58277.12
buyer_7,María,56,ES44209539382171952129,TRX_N-00105-17613755,2020-09-05T20:41:42,Portugalete,Housing,Mortgage,-553.82,57723.3
buyer_7,María,56,ES44209539382171952129,TRX_N-00106-78863229,2020-09-05T09:04:16,Portugalete,Basic services,electricity,-135.57,57587.73
buyer_7,María,56,ES44209539382171952129,TRX_N-00107-08521284,2020-09-05T10:49:10,Portugalete,Basic services,internet,-70.35,57517.38
buyer_7,María,56,ES44209539382171952129,TRX_N-00108-98959207,2020-09-05T11:08:22,Portugalete,Basic services,phone,-71.51,57445.87
buyer_7,María,56,ES44209539382171952129,TRX_N-00109-48744848,2020-09-06T12:37:44,Portugalete,Basic services,gas,-18.54,57427.33
buyer_7,María,56,ES44209539382171952129,TRX_N-00110-51381982,2020-09-06T17:17:07,Portugalete,Basic services,internet,-64.05,57363.28
buyer_7,María,56,ES44209539382171952129,TRX_N-00111-88983748,2020-09-08T11:02:01,Portugalete,Expense,food,-548.77,56814.51
buyer_7,María,56,ES44209539382171952129,TRX_N-00112-21297321,2020-09-11T10:53:38,Portugalete,Expense,leisure,-187.9,56626.61
buyer_7,María,56,ES44209539382171952129,TRX_N-00113-99089136,2020-09-18T10:55:47,Portugalete,Expense,transport,-112.1,56514.51
buyer_7,María,56,ES44209539382171952129,TRX_N-00114-22923588,2020-09-20T20:08:25,Portugalete,Expense,transport,-131.78,56382.73
buyer_7,María,56,ES44209539382171952129,TRX_N-00115-92076626,2020-10-01T15:03:26,Portugalete,transfer,Salary,3324.96,59707.69
buyer_7,María,56,ES44209539382171952129,TRX_N-00116-41057341,2020-10-01T15:03:26,Portugalete,transfer,Partner Salary,3441.05,63148.74
buyer_7,María,56,ES44209539382171952129,TRX_N-00117-10759783,2020-10-01T15:03:26,Portugalete,transfer,Extra Income,332.5,63481.24
buyer_7,María,56,ES44209539382171952129,TRX_N-00118-24824976,2020-10-05T06:09:15,Portugalete,Housing,Mortgage,-553.82,62927.42
buyer_7,María,56,ES44209539382171952129,TRX_N-00119-38197781,2020-10-05T10:28:13,Portugalete,Basic services,internet,-48.82,62878.6
buyer_7,María,56,ES44209539382171952129,TRX_N-00120-46894461,2020-10-06T15:49:14,Portugalete,Basic services,water,-48.45,62830.15
buyer_7,María,56,ES44209539382171952129,TRX_N-00121-96115438,2020-10-06T17:56:03,Portugalete,Basic services,electricity,-110.36,62719.79
buyer_7,María,56,ES44209539382171952129,TRX_N-00122-11670649,2020-10-06T14:17:42,Lasarte-Oria,Expense,clothing,-309.54,62410.25
buyer_7,María,56,ES44209539382171952129,TRX_N-00123-13878051,2020-10-07T18:59:45,Portugalete,Basic services,phone,-91.92,62318.33
buyer_7,María,56,ES44209539382171952129,TRX_N-00124-74416137,2020-10-15T15:49:14,Portugalete,Expense,clothing,-474.97,61843.36
buyer_7,María,56,ES44209539382171952129,TRX_N-00125-87168827,2020-11-01T21:16:36,Portugalete,transfer,Salary,3324.96,65168.32
buyer_7,María,56,ES44209539382171952129,TRX_N-00126-22331035,2020-11-01T21:16:36,Portugalete,transfer,Partner Salary,3441.05,68609.37
buyer_7,María,56,ES44209539382171952129,TRX_N-00127-05273727,2020-11-05T09:50:47,Portugalete,Housing,Mortgage,-553.82,68055.55
buyer_7,María,56,ES44209539382171952129,TRX_N-00128-89409471,2020-11-05T14:23:24,Portugalete,Basic services,water,-22.12,68033.43
buyer_7,María,56,ES44209539382171952129,TRX_N-00129-99073091,2020-11-05T21:39:44,Portugalete,Basic services,gas,-87.07,67946.36
buyer_7,María,56,ES44209539382171952129,TRX_N-00130-24961247,2020-11-05T07:43:33,Portugalete,Basic services,internet,-38.01,67908.35
buyer_7,María,56,ES44209539382171952129,TRX_N-00131-54973915,2020-11-06T16:17:43,Portugalete,Basic services,internet,-50.81,67857.54
buyer_7,María,56,ES44209539382171952129,TRX_N-00132-29805313,2020-11-07T20:03:23,Portugalete,Basic services,water,-52.44,67805.1
buyer_7,María,56,ES44209539382171952129,TRX_N-00133-52646344,2020-11-07T12:54:47,Portugalete,Basic services,electricity,-36.96,67768.14
buyer_7,María,56,ES44209539382171952129,TRX_N-00134-98535109,2020-11-07T17:26:29,Portugalete,Basic services,internet,-54.24,67713.9
buyer_7,María,56,ES44209539382171952129,TRX_N-00135-10248313,2020-11-07T19:28:56,Portugalete,Expense,food,-692.7,67021.2
buyer_7,María,56,ES44209539382171952129,TRX_N-00136-18081857,2020-11-08T13:43:45,Portugalete,Expense,leisure,-20.7,67000.5
buyer_7,María,56,ES44209539382171952129,TRX_N-00137-63993785,2020-11-12T00:41:21,Portugalete,Expense,transport,-59.48,66941.02
buyer_7,María,56,ES44209539382171952129,TRX_N-00138-86934110,2020-12-01T20:38:43,Portugalete,transfer,Salary,3324.96,70265.98
buyer_7,María,56,ES44209539382171952129,TRX_N-00139-57130646,2020-12-01T20:38:43,Portugalete,transfer,Partner Salary,3441.05,73707.03
buyer_7,María,56,ES44209539382171952129,TRX_N-00140-88218801,2020-12-01T20:38:43,Portugalete,transfer,Extra Income,332.5,74039.53
buyer_7,María,56,ES44209539382171952129,TRX_N-00141-28313091,2020-12-01T20:38:43,Portugalete,transfer,Bonus,3242.65,77282.18
buyer_7,María,56,ES44209539382171952129,TRX_N-00142-88787388,2020-12-05T20:34:09,Portugalete,Housing,Mortgage,-553.82,76728.36
buyer_7,María,56,ES44209539382171952129,TRX_N-00143-76896256,2020-12-05T17:37:43,Portugalete,Basic services,electricity,-148.06,76580.3
buyer_7,María,56,ES44209539382171952129,TRX_N-00144-99150704,2020-12-05T17:18:40,Portugalete,Basic services,internet,-54.62,76525.68
buyer_7,María,56,ES44209539382171952129,TRX_N-00145-04321908,2020-12-05T03:31:21,Portugalete,Basic services,phone,-75.27,76450.41
buyer_7,María,56,ES44209539382171952129,TRX_N-00146-51276280,2020-12-06T08:00:06,Portugalete,Basic services,electricity,-104.41,76346.0
buyer_7,María,56,ES44209539382171952129,TRX_N-00147-96596908,2020-12-07T21:55:12,Portugalete,Basic services,electricity,-33.34,76312.66
buyer_7,María,56,ES44209539382171952129,TRX_N-00148-06273496,2020-12-07T22:55:35,Portugalete,Basic services,phone,-52.72,76259.94
buyer_7,María,56,ES44209539382171952129,TRX_N-00149-74727302,2021-01-01T18:11:57,Portugalete,transfer,Salary,3324.96,79584.9
buyer_7,María,56,ES44209539382171952129,TRX_N-00150-86795106,2021-01-01T18:11:57,Portugalete,transfer,Partner Salary,3441.05,83025.95
buyer_7,María,56,ES44209539382171952129,TRX_N-00151-92424779,2021-01-01T11:57:56,Portugalete,Expense,appliances,-1578.54,81447.41
buyer_7,María,56,ES44209539382171952129,TRX_N-00152-36485054,2021-01-05T08:03:54,Portugalete,Housing,Mortgage,-553.82,80893.59
buyer_7,María,56,ES44209539382171952129,TRX_N-00153-28406112,2021-01-05T18:39:30,Portugalete,Basic services,electricity,-105.32,80788.27
buyer_7,María,56,ES44209539382171952129,TRX_N-00154-26220020,2021-01-06T08:37:14,Portugalete,Basic services,water,-33.72,80754.55
buyer_7,María,56,ES44209539382171952129,TRX_N-00155-82019206,2021-01-06T08:22:57,Portugalete,Basic services,phone,-30.55,80724.0
buyer_7,María,56,ES44209539382171952129,TRX_N-00156-03922590,2021-01-07T08:01:34,Portugalete,Basic services,water,-77.56,80646.44
buyer_7,María,56,ES44209539382171952129,TRX_N-00157-72089502,2021-01-07T17:56:17,Portugalete,Basic services,gas,-33.52,80612.92
buyer_7,María,56,ES44209539382171952129,TRX_N-00158-99612356,2021-01-07T14:24:43,Portugalete,Expense,leisure,-181.13,80431.79
buyer_7,María,56,ES44209539382171952129,TRX_N-00159-11832465,2021-01-13T19:17:12,Lasarte-Oria,Expense,healthcare,-292.03,80139.76
buyer_7,María,56,ES44209539382171952129,TRX_N-00160-68210536,2021-01-15T08:13:54,Portugalete,Expense,food,-171.81,79967.95
buyer_7,María,56,ES44209539382171952129,TRX_N-00161-08881578,2021-01-25T20:28:19,Portugalete,Expense,education,-123.54,79844.41
buyer_7,María,56,ES44209539382171952129,TRX_N-00162-11960695,2021-01-31T22:37:42,Llodio,Expense,food,-598.92,79245.49
buyer_7,María,56,ES44209539382171952129,TRX_N-00163-22587777,2021-02-01T10:28:09,Portugalete,transfer,Salary,3324.96,82570.45
buyer_7,María,56,ES44209539382171952129,TRX_N-00164-82405167,2021-02-01T10:28:09,Portugalete,transfer,Partner Salary,3441.05,86011.5
buyer_7,María,56,ES44209539382171952129,TRX_N-00165-31782708,2021-02-01T10:28:09,Portugalete,transfer,Extra Income,332.5,86344.0
buyer_7,María,56,ES44209539382171952129,TRX_N-00166-04180270,2021-02-05T13:50:39,Portugalete,Housing,Mortgage,-553.82,85790.18
buyer_7,María,56,ES44209539382171952129,TRX_N-00167-08888303,2021-02-05T17:51:16,Portugalete,Basic services,water,-55.22,85734.96
buyer_7,María,56,ES44209539382171952129,TRX_N-00168-37132317,2021-02-05T13:57:04,Portugalete,Expense,food,-599.66,85135.3
buyer_7,María,56,ES44209539382171952129,TRX_N-00169-66958623,2021-02-05T17:04:47,Portugalete,Expense,education,-397.51,84737.79
buyer_7,María,56,ES44209539382171952129,TRX_N-00170-53108968,2021-02-06T17:22:44,Portugalete,Basic services,internet,-75.73,84662.06
buyer_7,María,56,ES44209539382171952129,TRX_N-00171-51961769,2021-02-06T04:18:45,Portugalete,Basic services,phone,-51.98,84610.08
buyer_7,María,56,ES44209539382171952129,TRX_N-00172-16685328,2021-02-07T09:36:03,Portugalete,Basic services,electricity,-21.91,84588.17
buyer_7,María,56,ES44209539382171952129,TRX_N-00173-29145781,2021-02-07T10:35:49,Erandio,Expense,transport,-30.47,84557.7
buyer_7,María,56,ES44209539382171952129,TRX_N-00174-47648271,2021-02-13T09:41:49,Arrasate,Expense,leisure,-205.46,84352.24
buyer_7,María,56,ES44209539382171952129,TRX_N-00175-81943285,2021-03-01T13:53:25,Portugalete,transfer,Salary,3324.96,87677.2
buyer_7,María,56,ES44209539382171952129,TRX_N-00176-03365379,2021-03-01T13:53:25,Portugalete,transfer,Partner Salary,3441.05,91118.25
buyer_7,María,56,ES44209539382171952129,TRX_N-00177-15434157,2021-03-01T11:36:45,Portugalete,Expense,repairs,-382.95,90735.3
buyer_7,María,56,ES44209539382171952129,TRX_N-00178-13697097,2021-03-02T12:14:42,Portugalete,Expense,transport,-151.18,90584.12
buyer_7,María,56,ES44209539382171952129,TRX_N-00179-15977441,2021-03-04T16:38:00,Portugalete,Expense,food,-178.08,90406.04
buyer_7,María,56,ES44209539382171952129,TRX_N-00180-31774044,2021-03-05T14:24:22,Portugalete,Housing,Mortgage,-553.82,89852.22
buyer_7,María,56,ES44209539382171952129,TRX_N-00181-85173779,2021-03-05T19:04:03,Portugalete,Basic services,gas,-99.02,89753.2
buyer_7,María,56,ES44209539382171952129,TRX_N-00182-66863980,2021-03-06T08:57:18,Portugalete,Basic services,electricity,-118.7,89634.5
buyer_7,María,56,ES44209539382171952129,TRX_N-00183-23426294,2021-03-07T17:12:42,Portugalete,Basic services,phone,-42.72,89591.78
buyer_7,María,56,ES44209539382171952129,TRX_N-00184-80971128,2021-03-19T12:34:02,Portugalete,Expense,repairs,-649.24,88942.54
buyer_7,María,56,ES44209539382171952129,TRX_N-00185-71613851,2021-03-28T15:14:56,Santurtzi,Expense,clothing,-259.67,88682.87
buyer_7,María,56,ES44209539382171952129,TRX_N-00186-53283031,2021-04-01T17:18:48,Portugalete,transfer,Salary,3324.96,92007.83
buyer_7,María,56,ES44209539382171952129,TRX_N-00187-26603024,2021-04-01T17:18:48,Portugalete,transfer,Partner Salary,3441.05,95448.88
buyer_7,María,56,ES44209539382171952129,TRX_N-00188-47953786,2021-04-01T17:18:48,Portugalete,transfer,Extra Income,332.5,95781.38
buyer_7,María,56,ES44209539382171952129,TRX_N-00189-24726968,2021-04-05T02:18:51,Portugalete,Housing,Mortgage,-553.82,95227.56
buyer_7,María,56,ES44209539382171952129,TRX_N-00190-79783362,2021-04-05T18:14:03,Portugalete,Basic services,gas,-53.14,95174.42
buyer_7,María,56,ES44209539382171952129,TRX_N-00191-37261020,2021-04-06T15:35:16,Portugalete,Basic services,water,-29.51,95144.91
buyer_7,María,56,ES44209539382171952129,TRX_N-00192-97961328,2021-04-06T23:05:48,Portugalete,Basic services,gas,-80.51,95064.4
buyer_7,María,56,ES44209539382171952129,TRX_N-00193-92720238,2021-04-06T10:27:13,Portugalete,Basic services,internet,-41.73,95022.67
buyer_7,María,56,ES44209539382171952129,TRX_N-00194-48216617,2021-04-19T08:00:18,Portugalete,Expense,transport,-117.91,94904.76
buyer_7,María,56,ES44209539382171952129,TRX_N-00195-72358502,2021-04-21T12:39:50,Labastida,Expense,repairs,-994.8,93909.96
buyer_7,María,56,ES44209539382171952129,TRX_N-00196-54932839,2021-04-25T02:27:50,Errenteria,Expense,travel,-2505.55,91404.41
buyer_7,María,56,ES44209539382171952129,TRX_N-00197-05182519,2021-05-01T03:20:07,Portugalete,transfer,Salary,3324.96,94729.37
buyer_7,María,56,ES44209539382171952129,TRX_N-00198-53536867,2021-05-01T03:20:07,Portugalete,transfer,Partner Salary,3441.05,98170.42
buyer_7,María,56,ES44209539382171952129,TRX_N-00199-19305350,2021-05-01T11:50:00,Portugalete,Expense,gifts,-33.7,98136.72
buyer_7,María,56,ES44209539382171952129,TRX_N-00200-34456009,2021-05-02T22:39:03,Errenteria,Expense,food,-607.46,97529.26
buyer_7,María,56,ES44209539382171952129,TRX_N-00201-60935110,2021-05-05T19:29:02,Portugalete,Housing,Mortgage,-553.82,96975.44
buyer_7,María,56,ES44209539382171952129,TRX_N-00202-98778669,2021-05-05T08:37:15,Portugalete,Basic services,gas,-42.78,96932.66
buyer_7,María,56,ES44209539382171952129,TRX_N-00203-09753380,2021-05-06T19:37:28,Portugalete,Basic services,water,-17.79,96914.87
buyer_7,María,56,ES44209539382171952129,TRX_N-00204-01991778,2021-05-06T18:44:58,Portugalete,Basic services,gas,-19.22,96895.65
buyer_7,María,56,ES44209539382171952129,TRX_N-00205-36702719,2021-05-22T15:37:03,Portugalete,Expense,transport,-52.49,96843.16
buyer_7,María,56,ES44209539382171952129,TRX_N-00206-45815261,2021-05-25T13:08:40,Portugalete,Expense,transport,-123.31,96719.85
buyer_7,María,56,ES44209539382171952129,TRX_N-00207-76517611,2021-05-26T12:46:25,Portugalete,Expense,food,-511.48,96208.37
buyer_7,María,56,ES44209539382171952129,TRX_N-00208-04668462,2021-05-26T11:54:42,Donostia,Expense,transport,-171.57,96036.8
buyer_7,María,56,ES44209539382171952129,TRX_N-00209-80945398,2021-05-30T22:06:49,Portugalete,Expense,clothing,-172.76,95864.04
buyer_7,María,56,ES44209539382171952129,TRX_N-00210-71309412,2021-06-01T13:01:35,Portugalete,transfer,Salary,3324.96,99189.0
buyer_7,María,56,ES44209539382171952129,TRX_N-00211-23650096,2021-06-01T13:01:35,Portugalete,transfer,Partner Salary,3441.05,102630.05
buyer_7,María,56,ES44209539382171952129,TRX_N-00212-45219171,2021-06-01T13:01:35,Portugalete,transfer,Extra Income,332.5,102962.55
buyer_7,María,56,ES44209539382171952129,TRX_N-00213-15666707,2021-06-01T13:01:35,Portugalete,transfer,Bonus,3315.66,106278.21
buyer_7,María,56,ES44209539382171952129,TRX_N-00214-14365047,2021-06-04T10:35:18,Amurrio,Expense,transport,-28.0,106250.21
buyer_7,María,56,ES44209539382171952129,TRX_N-00215-47567318,2021-06-05T18:54:15,Portugalete,Housing,Mortgage,-553.82,105696.39
buyer_7,María,56,ES44209539382171952129,TRX_N-00216-42141112,2021-06-06T16:17:04,Portugalete,Basic services,water,-23.39,105673.0
buyer_7,María,56,ES44209539382171952129,TRX_N-00217-97834663,2021-06-06T14:52:12,Portugalete,Basic services,electricity,-95.9,105577.1
buyer_7,María,56,ES44209539382171952129,TRX_N-00218-13710750,2021-06-07T17:18:38,Portugalete,Basic services,water,-65.98,105511.12
buyer_7,María,56,ES44209539382171952129,TRX_N-00219-40180243,2021-06-08T13:06:31,Portugalete,Expense,transport,-128.79,105382.33
buyer_7,María,56,ES44209539382171952129,TRX_N-00220-99024577,2021-06-26T20:06:10,Portugalete,Expense,healthcare,-178.78,105203.55
buyer_7,María,56,ES44209539382171952129,TRX_N-00221-04473211,2021-07-01T16:18:52,Portugalete,transfer,Salary,3324.96,108528.51
buyer_7,María,56,ES44209539382171952129,TRX_N-00222-94024128,2021-07-01T16:18:52,Portugalete,transfer,Partner Salary,3441.05,111969.56
buyer_7,María,56,ES44209539382171952129,TRX_N-00223-72639310,2021-07-05T20:25:17,Portugalete,Housing,Mortgage,-553.82,111415.74
buyer_7,María,56,ES44209539382171952129,TRX_N-00224-70872577,2021-07-05T11:49:38,Portugalete,Basic services,electricity,-120.69,111295.05
buyer_7,María,56,ES44209539382171952129,TRX_N-00225-78222188,2021-07-05T13:36:11,Portugalete,Basic services,internet,-54.09,111240.96
buyer_7,María,56,ES44209539382171952129,TRX_N-00226-75733303,2021-07-05T17:50:09,Portugalete,Expense,clothing,-53.21,111187.75
buyer_7,María,56,ES44209539382171952129,TRX_N-00227-88263696,2021-07-06T08:38:21,Portugalete,Basic services,electricity,-99.69,111088.06
buyer_7,María,56,ES44209539382171952129,TRX_N-00228-43794669,2021-07-07T13:02:04,Portugalete,Basic services,gas,-15.14,111072.92
buyer_7,María,56,ES44209539382171952129,TRX_N-00229-77783844,2021-07-07T19:50:14,Portugalete,Basic services,phone,-32.38,111040.54
buyer_7,María,56,ES44209539382171952129,TRX_N-00230-92289090,2021-07-19T03:38:09,Portugalete,Expense,leisure,-116.21,110924.33
buyer_7,María,56,ES44209539382171952129,TRX_N-00231-21632964,2021-07-22T20:52:48,Portugalete,Expense,leisure,-250.72,110673.61
buyer_7,María,56,ES44209539382171952129,TRX_N-00232-81190974,2021-07-29T10:06:48,Portugalete,Expense,food,-264.3,110409.31
buyer_7,María,56,ES44209539382171952129,TRX_N-00233-69180461,2021-08-01T20:22:19,Portugalete,transfer,Salary,3324.96,113734.27
buyer_7,María,56,ES44209539382171952129,TRX_N-00234-00735931,2021-08-01T20:22:19,Portugalete,transfer,Partner Salary,3441.05,117175.32
buyer_7,María,56,ES44209539382171952129,TRX_N-00235-48908008,2021-08-01T20:22:19,Portugalete,transfer,Extra Income,332.5,117507.82
buyer_7,María,56,ES44209539382171952129,TRX_N-00236-12891728,2021-08-05T08:00:03,Portugalete,Housing,Mortgage,-553.82,116954.0
buyer_7,María,56,ES44209539382171952129,TRX_N-00237-92169249,2021-08-05T15:53:30,Portugalete,Basic services,water,-35.95,116918.05
buyer_7,María,56,ES44209539382171952129,TRX_N-00238-07525852,2021-08-05T08:25:09,Portugalete,Basic services,gas,-97.8,116820.25
buyer_7,María,56,ES44209539382171952129,TRX_N-00239-65529027,2021-08-05T08:41:01,Portugalete,Basic services,internet,-40.24,116780.01
buyer_7,María,56,ES44209539382171952129,TRX_N-00240-04226458,2021-08-07T14:21:32,Portugalete,Basic services,electricity,-108.64,116671.37
buyer_7,María,56,ES44209539382171952129,TRX_N-00241-38796066,2021-08-22T10:03:23,Portugalete,Expense,food,-562.9,116108.47
buyer_7,María,56,ES44209539382171952129,TRX_N-00242-52132295,2021-08-23T09:07:29,Portugalete,Expense,appliances,-1974.15,114134.32
buyer_7,María,56,ES44209539382171952129,TRX_N-00243-00142798,2021-09-01T01:17:04,Portugalete,transfer,Salary,3324.96,117459.28
buyer_7,María,56,ES44209539382171952129,TRX_N-00244-12037902,2021-09-01T01:17:04,Portugalete,transfer,Partner Salary,3441.05,120900.33
buyer_7,María,56,ES44209539382171952129,TRX_N-00245-89095303,2021-09-05T18:42:24,Portugalete,Housing,Mortgage,-553.82,120346.51
buyer_7,María,56,ES44209539382171952129,TRX_N-00246-58104817,2021-09-05T14:25:29,Portugalete,Basic services,gas,-72.77,120273.74
buyer_7,María,56,ES44209539382171952129,TRX_N-00247-65438046,2021-09-05T12:25:19,Portugalete,Basic services,phone,-34.61,120239.13
buyer_7,María,56,ES44209539382171952129,TRX_N-00248-50266477,2021-09-06T23:10:04,Portugalete,Basic services,water,-40.84,120198.29
buyer_7,María,56,ES44209539382171952129,TRX_N-00249-90450478,2021-09-06T06:32:33,Portugalete,Basic services,electricity,-103.77,120094.52
buyer_7,María,56,ES44209539382171952129,TRX_N-00250-79995000,2021-09-07T17:28:51,Portugalete,Basic services,electricity,-135.98,119958.54
buyer_7,María,56,ES44209539382171952129,TRX_N-00251-79141151,2021-09-07T14:20:25,Portugalete,Basic services,gas,-72.1,119886.44
buyer_7,María,56,ES44209539382171952129,TRX_N-00252-79738764,2021-10-01T19:32:05,Portugalete,transfer,Salary,3324.96,123211.4
buyer_7,María,56,ES44209539382171952129,TRX_N-00253-84518924,2021-10-01T19:32:05,Portugalete,transfer,Partner Salary,3441.05,126652.45
buyer_7,María,56,ES44209539382171952129,TRX_N-00254-03137252,2021-10-05T18:36:27,Portugalete,Housing,Mortgage,-553.82,126098.63
buyer_7,María,56,ES44209539382171952129,TRX_N-00255-11430803,2021-10-07T15:44:20,Portugalete,Basic services,phone,-65.3,126033.33
buyer_7,María,56,ES44209539382171952129,TRX_N-00256-03524677,2021-11-01T20:36:10,Portugalete,transfer,Salary,3324.96,129358.29
buyer_7,María,56,ES44209539382171952129,TRX_N-00257-22874627,2021-11-01T20:36:10,Portugalete,transfer,Partner Salary,3441.05,132799.34
buyer_7,María,56,ES44209539382171952129,TRX_N-00258-00855826,2021-11-01T20:36:10,Portugalete,transfer,Extra Income,332.5,133131.84
buyer_7,María,56,ES44209539382171952129,TRX_N-00259-47949760,2021-11-05T19:17:07,Portugalete,Housing,Mortgage,-553.82,132578.02
buyer_7,María,56,ES44209539382171952129,TRX_N-00260-80338778,2021-11-05T18:14:14,Portugalete,Basic services,phone,-33.0,132545.02
buyer_7,María,56,ES44209539382171952129,TRX_N-00261-49064931,2021-11-06T20:45:19,Portugalete,Basic services,electricity,-108.45,132436.57
buyer_7,María,56,ES44209539382171952129,TRX_N-00262-92687078,2021-11-06T15:42:46,Portugalete,Basic services,gas,-21.12,132415.45
buyer_7,María,56,ES44209539382171952129,TRX_N-00263-86088946,2021-11-06T17:27:59,Portugalete,Basic services,internet,-77.34,132338.11
buyer_7,María,56,ES44209539382171952129,TRX_N-00264-08246587,2021-11-06T13:50:16,Portugalete,Basic services,phone,-51.4,132286.71
buyer_7,María,56,ES44209539382171952129,TRX_N-00265-25103996,2021-11-07T12:28:29,Portugalete,Basic services,internet,-50.62,132236.09
buyer_7,María,56,ES44209539382171952129,TRX_N-00266-57770559,2021-11-09T15:36:14,Portugalete,Expense,healthcare,-230.94,132005.15
buyer_7,María,56,ES44209539382171952129,TRX_N-00267-96796392,2021-11-16T15:17:39,Portugalete,Expense,food,-418.2,131586.95
buyer_7,María,56,ES44209539382171952129,TRX_N-00268-71247539,2021-11-24T02:31:17,Lasarte-Oria,Expense,healthcare,-59.0,131527.95
buyer_7,María,56,ES44209539382171952129,TRX_N-00269-75850020,2021-12-01T20:33:40,Portugalete,transfer,Salary,3324.96,134852.91
buyer_7,María,56,ES44209539382171952129,TRX_N-00270-73897835,2021-12-01T20:33:40,Portugalete,transfer,Partner Salary,3441.05,138293.96
buyer_7,María,56,ES44209539382171952129,TRX_N-00271-63194288,2021-12-01T20:33:40,Portugalete,transfer,Bonus,3373.3,141667.26
buyer_7,María,56,ES44209539382171952129,TRX_N-00272-69437109,2021-12-02T15:56:54,Portugalete,Expense,clothing,-200.21,141467.05
buyer_7,María,56,ES44209539382171952129,TRX_N-00273-38358325,2021-12-05T17:22:26,Portugalete,Housing,Mortgage,-553.82,140913.23
buyer_7,María,56,ES44209539382171952129,TRX_N-00274-43558147,2021-12-05T16:34:09,Portugalete,Basic services,electricity,-105.14,140808.09
buyer_7,María,56,ES44209539382171952129,TRX_N-00275-08470275,2021-12-05T20:04:13,Portugalete,Basic services,internet,-77.44,140730.65
buyer_7,María,56,ES44209539382171952129,TRX_N-00276-61705692,2021-12-06T22:11:07,Portugalete,Basic services,water,-30.88,140699.77
buyer_7,María,56,ES44209539382171952129,TRX_N-00277-05792828,2021-12-06T10:05:57,Portugalete,Basic services,phone,-51.6,140648.17
buyer_7,María,56,ES44209539382171952129,TRX_N-00278-11187530,2021-12-07T05:33:00,Portugalete,Basic services,phone,-21.06,140627.11
buyer_7,María,56,ES44209539382171952129,TRX_N-00279-37626142,2021-12-07T12:39:50,Berango,Expense,leisure,-280.55,140346.56
buyer_7,María,56,ES44209539382171952129,TRX_N-00280-75747606,2021-12-10T19:32:00,Portugalete,Expense,clothing,-147.22,140199.34
buyer_7,María,56,ES44209539382171952129,TRX_N-00281-27247173,2021-12-21T09:14:10,Iruña de Oca,Expense,food,-395.06,139804.28
buyer_7,María,56,ES44209539382171952129,TRX_N-00282-02670283,2021-12-26T16:09:08,Portugalete,Expense,leisure,-52.08,139752.2
buyer_7,María,56,ES44209539382171952129,TRX_N-00283-98656379,2021-12-28T09:45:00,Portugalete,Expense,transport,-127.86,139624.34
buyer_7,María,56,ES44209539382171952129,TRX_N-00284-64974640,2021-12-30T18:25:43,Portugalete,Expense,food,-757.21,138867.13
buyer_7,María,56,ES44209539382171952129,TRX_N-00285-01769982,2022-01-01T13:06:35,Portugalete,transfer,Salary,3324.96,142192.09
buyer_7,María,56,ES44209539382171952129,TRX_N-00286-49451625,2022-01-01T13:06:35,Portugalete,transfer,Partner Salary,3441.05,145633.14
buyer_7,María,56,ES44209539382171952129,TRX_N-00287-01555343,2022-01-01T13:06:35,Portugalete,transfer,Extra Income,332.5,145965.64
buyer_7,María,56,ES44209539382171952129,TRX_N-00288-43745473,2022-01-04T13:30:57,Portugalete,Expense,transport,-131.63,145834.01
buyer_7,María,56,ES44209539382171952129,TRX_N-00289-25508681,2022-01-05T00:32:43,Portugalete,Housing,Mortgage,-553.82,145280.19
buyer_7,María,56,ES44209539382171952129,TRX_N-00290-70950378,2022-01-05T10:22:12,Portugalete,Basic services,gas,-25.41,145254.78
buyer_7,María,56,ES44209539382171952129,TRX_N-00291-92327718,2022-01-05T16:53:40,Portugalete,Basic services,phone,-44.26,145210.52
buyer_7,María,56,ES44209539382171952129,TRX_N-00292-38991942,2022-01-05T19:15:46,Portugalete,Expense,clothing,-152.2,145058.32
buyer_7,María,56,ES44209539382171952129,TRX_N-00293-35670845,2022-01-07T22:53:20,Portugalete,Basic services,electricity,-75.51,144982.81
buyer_7,María,56,ES44209539382171952129,TRX_N-00294-44271012,2022-01-07T18:53:42,Portugalete,Basic services,internet,-35.52,144947.29
buyer_7,María,56,ES44209539382171952129,TRX_N-00295-73140043,2022-01-07T08:44:54,Portugalete,Basic services,phone,-82.75,144864.54
buyer_7,María,56,ES44209539382171952129,TRX_N-00296-83933665,2022-01-20T12:28:15,Portugalete,Expense,healthcare,-223.39,144641.15
buyer_7,María,56,ES44209539382171952129,TRX_N-00297-45129717,2022-01-27T16:49:44,Portugalete,Expense,education,-912.76,143728.39
buyer_7,María,56,ES44209539382171952129,TRX_N-00298-93412486,2022-02-01T17:02:50,Portugalete,transfer,Salary,3324.96,147053.35
buyer_7,María,56,ES44209539382171952129,TRX_N-00299-64862662,2022-02-01T17:02:50,Portugalete,transfer,Partner Salary,3441.05,150494.4
buyer_7,María,56,ES44209539382171952129,TRX_N-00300-13186580,2022-02-05T15:23:04,Portugalete,Housing,Mortgage,-553.82,149940.58
buyer_7,María,56,ES44209539382171952129,TRX_N-00301-87830375,2022-02-05T17:55:53,Portugalete,Basic services,water,-45.66,149894.92
buyer_7,María,56,ES44209539382171952129,TRX_N-00302-79072523,2022-02-05T10:01:57,Portugalete,Basic services,electricity,-54.68,149840.24
buyer_7,María,56,ES44209539382171952129,TRX_N-00303-92839295,2022-02-05T09:40:49,Portugalete,Basic services,gas,-81.92,149758.32
buyer_7,María,56,ES44209539382171952129,TRX_N-00304-67719092,2022-02-05T15:56:13,Portugalete,Basic services,phone,-38.47,149719.85
buyer_7,María,56,ES44209539382171952129,TRX_N-00305-58959800,2022-02-06T12:40:37,Portugalete,Basic services,water,-39.81,149680.04
buyer_7,María,56,ES44209539382171952129,TRX_N-00306-63454438,2022-02-06T16:48:31,Portugalete,Basic services,phone,-25.76,149654.28
buyer_7,María,56,ES44209539382171952129,TRX_N-00307-64845846,2022-02-07T08:27:41,Portugalete,Basic services,internet,-32.5,149621.78
buyer_7,María,56,ES44209539382171952129,TRX_N-00308-21924231,2022-02-26T09:06:56,Portugalete,Expense,food,-352.97,149268.81
buyer_7,María,56,ES44209539382171952129,TRX_N-00309-56767378,2022-03-01T08:14:47,Portugalete,transfer,Salary,3324.96,152593.77
buyer_7,María,56,ES44209539382171952129,TRX_N-00310-12757353,2022-03-01T08:14:47,Portugalete,transfer,Partner Salary,3441.05,156034.82
buyer_7,María,56,ES44209539382171952129,TRX_N-00311-13668785,2022-03-01T08:14:47,Portugalete,transfer,Extra Income,332.5,156367.32
buyer_7,María,56,ES44209539382171952129,TRX_N-00312-75953106,2022-03-05T19:39:12,Portugalete,Housing,Mortgage,-553.82,155813.5
buyer_7,María,56,ES44209539382171952129,TRX_N-00313-69376113,2022-03-05T16:46:09,Portugalete,Basic services,internet,-74.63,155738.87
buyer_7,María,56,ES44209539382171952129,TRX_N-00314-80116238,2022-03-05T11:23:22,Portugalete,Basic services,phone,-49.32,155689.55
buyer_7,María,56,ES44209539382171952129,TRX_N-00315-95454249,2022-03-06T16:24:15,Portugalete,Basic services,gas,-17.89,155671.66
buyer_7,María,56,ES44209539382171952129,TRX_N-00316-11239972,2022-03-06T17:32:35,Portugalete,Basic services,internet,-34.13,155637.53
buyer_7,María,56,ES44209539382171952129,TRX_N-00317-14493128,2022-03-07T15:07:44,Portugalete,Basic services,internet,-31.13,155606.4
buyer_7,María,56,ES44209539382171952129,TRX_N-00318-09819410,2022-03-07T09:36:20,Portugalete,Basic services,phone,-31.65,155574.75
buyer_7,María,56,ES44209539382171952129,TRX_N-00319-39899844,2022-03-07T23:00:29,Portugalete,Expense,travel,-1247.22,154327.53
buyer_7,María,56,ES44209539382171952129,TRX_N-00320-27104266,2022-03-23T15:27:25,Portugalete,Expense,clothing,-336.33,153991.2
buyer_7,María,56,ES44209539382171952129,TRX_N-00321-16759022,2022-03-30T21:47:36,Portugalete,Expense,transport,-83.71,153907.49
buyer_7,María,56,ES44209539382171952129,TRX_N-00322-23235349,2022-03-30T11:47:47,Portugalete,Expense,clothing,-342.15,153565.34
buyer_7,María,56,ES44209539382171952129,TRX_N-00323-85736124,2022-04-01T17:41:51,Portugalete,transfer,Salary,3324.96,156890.3
buyer_7,María,56,ES44209539382171952129,TRX_N-00324-73474816,2022-04-01T17:41:51,Portugalete,transfer,Partner Salary,3441.05,160331.35
buyer_7,María,56,ES44209539382171952129,TRX_N-00325-09050420,2022-04-05T14:53:12,Portugalete,Housing,Mortgage,-553.82,159777.53
buyer_7,María,56,ES44209539382171952129,TRX_N-00326-31564213,2022-04-05T11:44:27,Portugalete,Basic services,electricity,-99.76,159677.77
buyer_7,María,56,ES44209539382171952129,TRX_N-00327-66436357,2022-04-06T15:21:28,Portugalete,Basic services,phone,-31.75,159646.02
buyer_7,María,56,ES44209539382171952129,TRX_N-00328-91370470,2022-04-07T15:59:22,Portugalete,Basic services,gas,-50.58,159595.44
buyer_7,María,56,ES44209539382171952129,TRX_N-00329-36567453,2022-04-21T04:44:41,Portugalete,Expense,education,-475.67,159119.77
buyer_7,María,56,ES44209539382171952129,TRX_N-00330-33445920,2022-05-01T11:48:03,Portugalete,transfer,Salary,3324.96,162444.73
buyer_7,María,56,ES44209539382171952129,TRX_N-00331-45655318,2022-05-01T11:48:03,Portugalete,transfer,Partner Salary,3441.05,165885.78
buyer_7,María,56,ES44209539382171952129,TRX_N-00332-78638155,2022-05-04T15:47:04,Portugalete,Expense,food,-497.51,165388.27
buyer_7,María,56,ES44209539382171952129,TRX_N-00333-86627842,2022-05-05T12:39:59,Portugalete,Housing,Mortgage,-553.82,164834.45
buyer_7,María,56,ES44209539382171952129,TRX_N-00334-00815771,2022-05-05T18:10:27,Portugalete,Basic services,gas,-18.09,164816.36
buyer_7,María,56,ES44209539382171952129,TRX_N-00335-59582691,2022-05-06T11:31:48,Portugalete,Basic services,water,-11.84,164804.52
buyer_7,María,56,ES44209539382171952129,TRX_N-00336-82393434,2022-05-06T16:01:34,Portugalete,Basic services,electricity,-69.6,164734.92
buyer_7,María,56,ES44209539382171952129,TRX_N-00337-44156847,2022-05-07T15:46:50,Portugalete,Basic services,phone,-87.78,164647.14
buyer_7,María,56,ES44209539382171952129,TRX_N-00338-47572270,2022-05-08T23:58:01,Portugalete,Expense,gifts,-343.15,164303.99
buyer_7,María,56,ES44209539382171952129,TRX_N-00339-95136169,2022-05-10T11:35:17,Hondarribia,Expense,gifts,-85.84,164218.15
buyer_7,María,56,ES44209539382171952129,TRX_N-00340-00104967,2022-05-12T20:26:06,Galdakao,Expense,leisure,-264.72,163953.43
buyer_7,María,56,ES44209539382171952129,TRX_N-00341-26855609,2022-05-25T02:47:21,Portugalete,Expense,food,-528.47,163424.96
buyer_7,María,56,ES44209539382171952129,TRX_N-00342-42082073,2022-05-25T12:44:13,Portugalete,Expense,travel,-2577.37,160847.59
buyer_7,María,56,ES44209539382171952129,TRX_N-00343-80752632,2022-06-01T13:41:59,Portugalete,transfer,Salary,3324.96,164172.55
buyer_7,María,56,ES44209539382171952129,TRX_N-00344-62842648,2022-06-01T13:41:59,Portugalete,transfer,Partner Salary,3441.05,167613.6
buyer_7,María,56,ES44209539382171952129,TRX_N-00345-06359696,2022-06-01T13:41:59,Portugalete,transfer,Extra Income,332.5,167946.1
buyer_7,María,56,ES44209539382171952129,TRX_N-00346-06705831,2022-06-01T13:41:59,Portugalete,transfer,Bonus,3075.09,171021.19
buyer_7,María,56,ES44209539382171952129,TRX_N-00347-93557627,2022-06-01T15:16:18,Portugalete,Expense,transport,-167.17,170854.02
buyer_7,María,56,ES44209539382171952129,TRX_N-00348-20962317,2022-06-05T07:14:16,Portugalete,Housing,Mortgage,-553.82,170300.2
buyer_7,María,56,ES44209539382171952129,TRX_N-00349-32750855,2022-06-05T13:46:51,Portugalete,Basic services,water,-22.07,170278.13
buyer_7,María,56,ES44209539382171952129,TRX_N-00350-66392771,2022-06-06T10:19:09,Portugalete,Basic services,electricity,-55.77,170222.36
buyer_7,María,56,ES44209539382171952129,TRX_N-00351-61193778,2022-06-06T20:39:41,Portugalete,Basic services,phone,-98.78,170123.58
buyer_7,María,56,ES44209539382171952129,TRX_N-00352-76750269,2022-06-07T12:26:19,Portugalete,Basic services,gas,-75.81,170047.77
buyer_7,María,56,ES44209539382171952129,TRX_N-00353-17496467,2022-06-07T20:35:29,Portugalete,Basic services,internet,-36.16,170011.61
buyer_7,María,56,ES44209539382171952129,TRX_N-00354-00740090,2022-06-07T20:22:58,Portugalete,Basic services,phone,-73.31,169938.3
buyer_7,María,56,ES44209539382171952129,TRX_N-00355-94894299,2022-06-08T23:34:16,Portugalete,Expense,clothing,-42.02,169896.28
buyer_7,María,56,ES44209539382171952129,TRX_N-00356-59992006,2022-06-25T12:31:30,Iruña de Oca,Expense,leisure,-196.35,169699.93
buyer_7,María,56,ES44209539382171952129,TRX_N-00357-25558672,2022-07-01T17:09:30,Portugalete,transfer,Salary,3324.96,173024.89
buyer_7,María,56,ES44209539382171952129,TRX_N-00358-08309939,2022-07-01T17:09:30,Portugalete,transfer,Partner Salary,3441.05,176465.94
buyer_7,María,56,ES44209539382171952129,TRX_N-00359-64555810,2022-07-04T09:03:46,Portugalete,Expense,repairs,-380.8,176085.14
buyer_7,María,56,ES44209539382171952129,TRX_N-00360-12264073,2022-07-05T16:58:28,Portugalete,Housing,Mortgage,-553.82,175531.32
buyer_7,María,56,ES44209539382171952129,TRX_N-00361-50575836,2022-07-05T14:39:43,Portugalete,Basic services,electricity,-126.57,175404.75
buyer_7,María,56,ES44209539382171952129,TRX_N-00362-98618889,2022-07-05T22:08:42,Portugalete,Basic services,internet,-42.08,175362.67
buyer_7,María,56,ES44209539382171952129,TRX_N-00363-37527021,2022-07-05T01:35:47,Portugalete,Expense,healthcare,-351.76,175010.91
buyer_7,María,56,ES44209539382171952129,TRX_N-00364-38663389,2022-07-06T16:40:44,Portugalete,Basic services,water,-46.46,174964.45
buyer_7,María,56,ES44209539382171952129,TRX_N-00365-62209332,2022-07-07T04:14:18,Portugalete,Basic services,water,-42.67,174921.78
buyer_7,María,56,ES44209539382171952129,TRX_N-00366-14598299,2022-07-07T15:39:36,Portugalete,Basic services,electricity,-29.73,174892.05
buyer_7,María,56,ES44209539382171952129,TRX_N-00367-31982922,2022-07-07T05:12:26,Portugalete,Basic services,phone,-81.35,174810.7
buyer_7,María,56,ES44209539382171952129,TRX_N-00368-36906854,2022-07-20T15:24:54,Portugalete,Expense,leisure,-11.62,174799.08
buyer_7,María,56,ES44209539382171952129,TRX_N-00369-87043235,2022-07-27T13:52:48,Portugalete,Expense,transport,-193.54,174605.54
buyer_7,María,56,ES44209539382171952129,TRX_N-00370-27189191,2022-08-01T11:13:50,Portugalete,transfer,Salary,3324.96,177930.5
buyer_7,María,56,ES44209539382171952129,TRX_N-00371-36614824,2022-08-01T11:13:50,Portugalete,transfer,Partner Salary,3441.05,181371.55
buyer_7,María,56,ES44209539382171952129,TRX_N-00372-69635326,2022-08-01T19:09:00,Portugalete,Expense,healthcare,-288.24,181083.31
buyer_7,María,56,ES44209539382171952129,TRX_N-00373-04277287,2022-08-04T18:48:08,Portugalete,Expense,clothing,-31.96,181051.35
buyer_7,María,56,ES44209539382171952129,TRX_N-00374-64940720,2022-08-05T01:08:46,Portugalete,Housing,Mortgage,-553.82,180497.53
buyer_7,María,56,ES44209539382171952129,TRX_N-00375-72080743,2022-08-05T19:28:06,Portugalete,Basic services,water,-68.88,180428.65
buyer_7,María,56,ES44209539382171952129,TRX_N-00376-43333354,2022-08-05T08:02:07,Portugalete,Basic services,electricity,-24.71,180403.94
buyer_7,María,56,ES44209539382171952129,TRX_N-00377-02081233,2022-08-05T07:44:36,Portugalete,Basic services,phone,-40.44,180363.5
buyer_7,María,56,ES44209539382171952129,TRX_N-00378-87528561,2022-08-06T19:54:39,Portugalete,Basic services,gas,-24.78,180338.72
buyer_7,María,56,ES44209539382171952129,TRX_N-00379-13884663,2022-08-13T13:27:38,Portugalete,Expense,transport,-173.03,180165.69
buyer_7,María,56,ES44209539382171952129,TRX_N-00380-03128713,2022-08-15T20:31:40,Portugalete,Expense,appliances,-343.68,179822.01
buyer_7,María,56,ES44209539382171952129,TRX_N-00381-69787906,2022-08-30T21:19:37,Portugalete,Expense,food,-509.64,179312.37
buyer_7,María,56,ES44209539382171952129,TRX_N-00382-65882212,2022-09-01T17:09:03,Portugalete,transfer,Salary,3324.96,182637.33
buyer_7,María,56,ES44209539382171952129,TRX_N-00383-62158860,2022-09-01T17:09:03,Portugalete,transfer,Partner Salary,3441.05,186078.38
buyer_7,María,56,ES44209539382171952129,TRX_N-00384-02913149,2022-09-01T17:09:03,Portugalete,transfer,Extra Income,332.5,186410.88
buyer_7,María,56,ES44209539382171952129,TRX_N-00385-35415090,2022-09-05T09:13:43,Portugalete,Housing,Mortgage,-553.82,185857.06
buyer_7,María,56,ES44209539382171952129,TRX_N-00386-19066716,2022-09-05T20:06:20,Portugalete,Basic services,water,-34.68,185822.38
buyer_7,María,56,ES44209539382171952129,TRX_N-00387-36445790,2022-09-05T06:03:54,Portugalete,Basic services,internet,-46.89,185775.49
buyer_7,María,56,ES44209539382171952129,TRX_N-00388-32028869,2022-09-07T16:14:15,Portugalete,Basic services,water,-56.81,185718.68
buyer_7,María,56,ES44209539382171952129,TRX_N-00389-48198985,2022-09-07T09:11:26,Portugalete,Basic services,phone,-57.02,185661.66
buyer_7,María,56,ES44209539382171952129,TRX_N-00390-48783592,2022-09-07T09:41:36,Portugalete,Expense,repairs,-282.07,185379.59
buyer_7,María,56,ES44209539382171952129,TRX_N-00391-04522839,2022-09-15T13:02:40,Santurtzi,Expense,transport,-125.11,185254.48
buyer_7,María,56,ES44209539382171952129,TRX_N-00392-19535174,2022-09-20T08:08:31,Portugalete,Expense,clothing,-396.27,184858.21
buyer_7,María,56,ES44209539382171952129,TRX_N-00393-96844905,2022-10-01T14:22:29,Portugalete,transfer,Salary,3324.96,188183.17
buyer_7,María,56,ES44209539382171952129,TRX_N-00394-79740826,2022-10-01T14:22:29,Portugalete,transfer,Partner Salary,3441.05,191624.22
buyer_7,María,56,ES44209539382171952129,TRX_N-00395-85719994,2022-10-05T17:05:34,Portugalete,Housing,Mortgage,-553.82,191070.4
buyer_7,María,56,ES44209539382171952129,TRX_N-00396-77895770,2022-10-05T10:33:46,Portugalete,Basic services,electricity,-91.57,190978.83
buyer_7,María,56,ES44209539382171952129,TRX_N-00397-91580064,2022-10-07T16:49:18,Portugalete,Basic services,electricity,-139.0,190839.83
buyer_7,María,56,ES44209539382171952129,TRX_N-00398-82963927,2022-10-07T09:10:22,Portugalete,Basic services,gas,-37.39,190802.44
buyer_7,María,56,ES44209539382171952129,TRX_N-00399-13688698,2022-10-17T16:24:59,Portugalete,Expense,clothing,-497.57,190304.87
buyer_7,María,56,ES44209539382171952129,TRX_N-00400-82894590,2022-10-28T04:07:24,Portugalete,Expense,leisure,-65.37,190239.5
buyer_7,María,56,ES44209539382171952129,TRX_N-00401-31829127,2022-10-30T16:56:13,Portugalete,Expense,travel,-1921.49,188318.01
buyer_7,María,56,ES44209539382171952129,TRX_N-00402-40905031,2022-10-31T23:55:43,Elciego,Expense,clothing,-400.5,187917.51
buyer_7,María,56,ES44209539382171952129,TRX_N-00403-07891671,2022-11-01T16:06:16,Portugalete,transfer,Salary,3324.96,191242.47
buyer_7,María,56,ES44209539382171952129,TRX_N-00404-92857743,2022-11-01T16:06:16,Portugalete,transfer,Partner Salary,3441.05,194683.52
buyer_7,María,56,ES44209539382171952129,TRX_N-00405-16579689,2022-11-05T19:37:40,Portugalete,Housing,Mortgage,-553.82,194129.7
buyer_7,María,56,ES44209539382171952129,TRX_N-00406-79582046,2022-11-05T08:25:19,Portugalete,Basic services,gas,-34.91,194094.79
buyer_7,María,56,ES44209539382171952129,TRX_N-00407-56736074,2022-11-05T19:16:39,Portugalete,Basic services,internet,-71.46,194023.33
buyer_7,María,56,ES44209539382171952129,TRX_N-00408-65515009,2022-11-06T19:51:29,Portugalete,Basic services,electricity,-38.72,193984.61
buyer_7,María,56,ES44209539382171952129,TRX_N-00409-79681698,2022-11-06T09:27:16,Portugalete,Basic services,phone,-91.38,193893.23
buyer_7,María,56,ES44209539382171952129,TRX_N-00410-38794206,2022-11-07T09:23:22,Portugalete,Basic services,water,-48.32,193844.91
buyer_7,María,56,ES44209539382171952129,TRX_N-00411-31842671,2022-11-07T14:25:35,Portugalete,Basic services,electricity,-88.93,193755.98
buyer_7,María,56,ES44209539382171952129,TRX_N-00412-11128002,2022-12-01T19:52:20,Portugalete,transfer,Salary,3324.96,197080.94
buyer_7,María,56,ES44209539382171952129,TRX_N-00413-66126373,2022-12-01T19:52:20,Portugalete,transfer,Partner Salary,3441.05,200521.99
buyer_7,María,56,ES44209539382171952129,TRX_N-00414-94183574,2022-12-01T19:52:20,Portugalete,transfer,Extra Income,332.5,200854.49
buyer_7,María,56,ES44209539382171952129,TRX_N-00415-93334061,2022-12-01T19:52:20,Portugalete,transfer,Bonus,3005.81,203860.3
buyer_7,María,56,ES44209539382171952129,TRX_N-00416-61656950,2022-12-03T14:40:22,Portugalete,Expense,healthcare,-274.59,203585.71
buyer_7,María,56,ES44209539382171952129,TRX_N-00417-15587795,2022-12-05T09:10:03,Portugalete,Housing,Mortgage,-553.82,203031.89
buyer_7,María,56,ES44209539382171952129,TRX_N-00418-14459497,2022-12-05T09:31:45,Portugalete,Basic services,water,-74.76,202957.13
buyer_7,María,56,ES44209539382171952129,TRX_N-00419-67282143,2022-12-05T11:06:35,Portugalete,Basic services,internet,-35.83,202921.3
buyer_7,María,56,ES44209539382171952129,TRX_N-00420-48348477,2022-12-05T19:34:37,Portugalete,Basic services,phone,-70.8,202850.5
buyer_7,María,56,ES44209539382171952129,TRX_N-00421-70081050,2022-12-06T04:26:23,Portugalete,Basic services,gas,-90.42,202760.08
buyer_7,María,56,ES44209539382171952129,TRX_N-00422-13068932,2022-12-06T09:54:35,Portugalete,Basic services,phone,-37.48,202722.6
buyer_7,María,56,ES44209539382171952129,TRX_N-00423-97873165,2022-12-06T20:46:51,Portugalete,Expense,education,-408.03,202314.57
buyer_7,María,56,ES44209539382171952129,TRX_N-00424-47672891,2022-12-07T07:03:57,Portugalete,Basic services,internet,-66.69,202247.88
buyer_7,María,56,ES44209539382171952129,TRX_N-00425-38456450,2022-12-10T23:30:17,Portugalete,Expense,transport,-144.53,202103.35
buyer_7,María,56,ES44209539382171952129,TRX_N-00426-52408421,2022-12-14T02:47:51,Portugalete,Expense,leisure,-131.91,201971.44
buyer_7,María,56,ES44209539382171952129,TRX_N-00427-85957507,2022-12-18T08:09:23,Portugalete,Expense,education,-630.91,201340.53
buyer_7,María,56,ES44209539382171952129,TRX_N-00428-14101306,2022-12-20T14:08:15,Portugalete,Expense,food,-158.0,201182.53
buyer_7,María,56,ES44209539382171952129,TRX_N-00429-03606983,2022-12-20T09:59:18,Portugalete,Expense,healthcare,-298.08,200884.45
buyer_7,María,56,ES44209539382171952129,TRX_N-00430-11320835,2023-01-01T18:25:13,Portugalete,transfer,Salary,3324.96,204209.41
buyer_7,María,56,ES44209539382171952129,TRX_N-00431-10377892,2023-01-01T18:25:13,Portugalete,transfer,Partner Salary,3441.05,207650.46
buyer_7,María,56,ES44209539382171952129,TRX_N-00432-49064233,2023-01-03T12:23:17,Portugalete,Expense,healthcare,-169.47,207480.99
buyer_7,María,56,ES44209539382171952129,TRX_N-00433-80930162,2023-01-04T14:51:41,Portugalete,Expense,leisure,-134.51,207346.48
buyer_7,María,56,ES44209539382171952129,TRX_N-00434-36991612,2023-01-04T18:57:57,Portugalete,Expense,clothing,-312.57,207033.91
buyer_7,María,56,ES44209539382171952129,TRX_N-00435-26656516,2023-01-05T19:10:34,Portugalete,Housing,Mortgage,-553.82,206480.09
buyer_7,María,56,ES44209539382171952129,TRX_N-00436-07791787,2023-01-05T23:54:20,Portugalete,Basic services,gas,-34.67,206445.42
buyer_7,María,56,ES44209539382171952129,TRX_N-00437-03961690,2023-01-06T14:08:44,Portugalete,Basic services,electricity,-84.43,206360.99
buyer_7,María,56,ES44209539382171952129,TRX_N-00438-54613037,2023-01-06T10:18:04,Portugalete,Basic services,internet,-78.93,206282.06
buyer_7,María,56,ES44209539382171952129,TRX_N-00439-43565487,2023-01-07T09:00:38,Portugalete,Basic services,gas,-38.79,206243.27
buyer_7,María,56,ES44209539382171952129,TRX_N-00440-93740344,2023-01-07T11:05:29,Portugalete,Basic services,phone,-54.9,206188.37
buyer_7,María,56,ES44209539382171952129,TRX_N-00441-96764107,2023-01-17T15:01:49,Portugalete,Expense,gifts,-252.82,205935.55
buyer_7,María,56,ES44209539382171952129,TRX_N-00442-55833379,2023-01-24T08:13:17,Portugalete,Expense,healthcare,-29.22,205906.33
buyer_7,María,56,ES44209539382171952129,TRX_N-00443-29753453,2023-01-26T09:03:26,Portugalete,Expense,food,-620.65,205285.68
buyer_7,María,56,ES44209539382171952129,TRX_N-00444-68942800,2023-01-29T19:32:17,Lasarte-Oria,Expense,transport,-70.87,205214.81
buyer_7,María,56,ES44209539382171952129,TRX_N-00445-98040744,2023-01-29T18:30:28,Portugalete,Expense,leisure,-28.16,205186.65
buyer_7,María,56,ES44209539382171952129,TRX_N-00446-03752263,2023-01-30T15:29:43,Portugalete,Expense,food,-722.06,204464.59
buyer_7,María,56,ES44209539382171952129,TRX_N-00447-86838879,2023-02-01T16:48:07,Portugalete,transfer,Salary,3324.96,207789.55
buyer_7,María,56,ES44209539382171952129,TRX_N-00448-52268738,2023-02-01T16:48:07,Portugalete,transfer,Partner Salary,3441.05,211230.6
buyer_7,María,56,ES44209539382171952129,TRX_N-00449-30136073,2023-02-05T11:33:02,Portugalete,Housing,Mortgage,-553.82,210676.78
buyer_7,María,56,ES44209539382171952129,TRX_N-00450-04395188,2023-02-06T14:50:09,Portugalete,Basic services,water,-45.0,210631.78
buyer_7,María,56,ES44209539382171952129,TRX_N-00451-24837976,2023-02-06T19:01:35,Portugalete,Basic services,gas,-54.17,210577.61
buyer_7,María,56,ES44209539382171952129,TRX_N-00452-70521165,2023-02-07T16:39:26,Portugalete,Basic services,water,-23.73,210553.88
buyer_7,María,56,ES44209539382171952129,TRX_N-00453-95760482,2023-02-07T06:58:01,Portugalete,Basic services,gas,-77.35,210476.53
buyer_7,María,56,ES44209539382171952129,TRX_N-00454-45838379,2023-02-07T12:46:02,Portugalete,Basic services,internet,-35.47,210441.06
buyer_7,María,56,ES44209539382171952129,TRX_N-00455-52161804,2023-02-07T12:02:40,Portugalete,Expense,education,-761.36,209679.7
buyer_7,María,56,ES44209539382171952129,TRX_N-00456-75502764,2023-02-09T19:21:31,Berango,Expense,leisure,-82.06,209597.64
buyer_7,María,56,ES44209539382171952129,TRX_N-00457-15225449,2023-02-11T15:39:51,Berango,Expense,leisure,-244.77,209352.87
buyer_7,María,56,ES44209539382171952129,TRX_N-00458-12466266,2023-02-27T19:25:45,Portugalete,Expense,leisure,-279.28,209073.59
buyer_7,María,56,ES44209539382171952129,TRX_N-00459-59557562,2023-03-01T12:35:49,Portugalete,transfer,Salary,3324.96,212398.55
buyer_7,María,56,ES44209539382171952129,TRX_N-00460-13452789,2023-03-01T12:35:49,Portugalete,transfer,Partner Salary,3441.05,215839.6
buyer_7,María,56,ES44209539382171952129,TRX_N-00461-35908947,2023-03-01T12:35:49,Portugalete,transfer,Extra Income,332.5,216172.1
buyer_7,María,56,ES44209539382171952129,TRX_N-00462-11939703,2023-03-05T17:44:36,Portugalete,Housing,Mortgage,-553.82,215618.28
buyer_7,María,56,ES44209539382171952129,TRX_N-00463-06593833,2023-03-05T08:07:43,Portugalete,Basic services,electricity,-77.04,215541.24
buyer_7,María,56,ES44209539382171952129,TRX_N-00464-23282607,2023-03-05T16:00:24,Portugalete,Basic services,gas,-18.53,215522.71
buyer_7,María,56,ES44209539382171952129,TRX_N-00465-52264212,2023-03-05T04:51:07,Portugalete,Basic services,phone,-23.11,215499.6
buyer_7,María,56,ES44209539382171952129,TRX_N-00466-10810666,2023-03-06T05:31:39,Portugalete,Basic services,electricity,-126.05,215373.55
buyer_7,María,56,ES44209539382171952129,TRX_N-00467-72864141,2023-03-06T18:04:37,Portugalete,Basic services,gas,-89.85,215283.7
buyer_7,María,56,ES44209539382171952129,TRX_N-00468-21810006,2023-03-07T11:57:11,Portugalete,Basic services,water,-36.1,215247.6
buyer_7,María,56,ES44209539382171952129,TRX_N-00469-72996121,2023-03-07T22:34:12,Portugalete,Basic services,gas,-17.16,215230.44
buyer_7,María,56,ES44209539382171952129,TRX_N-00470-96197445,2023-03-07T19:41:59,Portugalete,Basic services,phone,-91.27,215139.17
buyer_7,María,56,ES44209539382171952129,TRX_N-00471-14070767,2023-03-08T16:53:13,Portugalete,Expense,healthcare,-164.97,214974.2
buyer_7,María,56,ES44209539382171952129,TRX_N-00472-51869976,2023-03-11T10:28:41,Basauri,Expense,food,-450.86,214523.34
buyer_7,María,56,ES44209539382171952129,TRX_N-00473-09289633,2023-03-14T13:32:07,Portugalete,Expense,repairs,-536.29,213987.05
buyer_7,María,56,ES44209539382171952129,TRX_N-00474-82358141,2023-03-24T00:57:27,Portugalete,Expense,repairs,-491.68,213495.37
buyer_7,María,56,ES44209539382171952129,TRX_N-00475-44506700,2023-03-31T19:08:51,Portugalete,Expense,food,-138.66,213356.71
buyer_7,María,56,ES44209539382171952129,TRX_N-00476-31731924,2023-04-01T19:35:13,Portugalete,transfer,Salary,3324.96,216681.67
buyer_7,María,56,ES44209539382171952129,TRX_N-00477-44740891,2023-04-01T19:35:13,Portugalete,transfer,Partner Salary,3441.05,220122.72
buyer_7,María,56,ES44209539382171952129,TRX_N-00478-14910161,2023-04-03T13:16:20,Mungia,Expense,repairs,-335.43,219787.29
buyer_7,María,56,ES44209539382171952129,TRX_N-00479-76056533,2023-04-04T18:58:36,Portugalete,Expense,food,-626.77,219160.52
buyer_7,María,56,ES44209539382171952129,TRX_N-00480-19746995,2023-04-05T10:08:49,Portugalete,Housing,Mortgage,-553.82,218606.7
buyer_7,María,56,ES44209539382171952129,TRX_N-00481-85142428,2023-04-05T17:06:30,Portugalete,Basic services,electricity,-121.03,218485.67
buyer_7,María,56,ES44209539382171952129,TRX_N-00482-15826133,2023-04-06T08:14:20,Portugalete,Basic services,water,-64.54,218421.13
buyer_7,María,56,ES44209539382171952129,TRX_N-00483-03800951,2023-04-07T11:15:01,Portugalete,Basic services,internet,-44.1,218377.03
buyer_7,María,56,ES44209539382171952129,TRX_N-00484-46090198,2023-04-23T21:57:29,Portugalete,Expense,transport,-116.21,218260.82
buyer_7,María,56,ES44209539382171952129,TRX_N-00485-95656001,2023-04-27T18:17:33,Errenteria,Expense,education,-835.23,217425.59
buyer_7,María,56,ES44209539382171952129,TRX_N-00486-15169790,2023-05-01T04:01:02,Portugalete,transfer,Salary,3324.96,220750.55
buyer_7,María,56,ES44209539382171952129,TRX_N-00487-93992579,2023-05-01T04:01:02,Portugalete,transfer,Partner Salary,3441.05,224191.6
buyer_7,María,56,ES44209539382171952129,TRX_N-00488-43610148,2023-05-01T04:01:02,Portugalete,transfer,Extra Income,332.5,224524.1
buyer_7,María,56,ES44209539382171952129,TRX_N-00489-97394095,2023-05-05T08:34:59,Portugalete,Housing,Mortgage,-553.82,223970.28
buyer_7,María,56,ES44209539382171952129,TRX_N-00490-37457676,2023-05-05T08:28:38,Portugalete,Basic services,internet,-48.24,223922.04
buyer_7,María,56,ES44209539382171952129,TRX_N-00491-84139283,2023-05-06T15:18:35,Portugalete,Basic services,electricity,-59.84,223862.2
buyer_7,María,56,ES44209539382171952129,TRX_N-00492-08125368,2023-05-06T12:35:44,Portugalete,Basic services,gas,-30.79,223831.41
buyer_7,María,56,ES44209539382171952129,TRX_N-00493-39874321,2023-05-07T10:26:56,Portugalete,Basic services,gas,-78.2,223753.21
buyer_7,María,56,ES44209539382171952129,TRX_N-00494-89892600,2023-05-07T22:25:00,Portugalete,Basic services,phone,-22.37,223730.84
buyer_7,María,56,ES44209539382171952129,TRX_N-00495-20351156,2023-05-26T13:23:36,Portugalete,Expense,transport,-104.7,223626.14
buyer_7,María,56,ES44209539382171952129,TRX_N-00496-97939755,2023-05-26T14:35:27,Portugalete,Expense,healthcare,-292.03,223334.11
buyer_7,María,56,ES44209539382171952129,TRX_N-00497-54457035,2023-06-01T10:35:33,Portugalete,transfer,Salary,3324.96,226659.07
buyer_7,María,56,ES44209539382171952129,TRX_N-00498-50429601,2023-06-01T10:35:33,Portugalete,transfer,Partner Salary,3441.05,230100.12
buyer_7,María,56,ES44209539382171952129,TRX_N-00499-42535937,2023-06-01T10:35:33,Portugalete,transfer,Bonus,3541.42,233641.54
buyer_7,María,56,ES44209539382171952129,TRX_N-00500-82682339,2023-06-02T17:43:50,Santurtzi,Expense,healthcare,-239.53,233402.01
buyer_7,María,56,ES44209539382171952129,TRX_N-00501-61214695,2023-06-05T08:53:08,Portugalete,Housing,Mortgage,-553.82,232848.19
buyer_7,María,56,ES44209539382171952129,TRX_N-00502-23405208,2023-06-05T16:45:07,Portugalete,Basic services,electricity,-61.66,232786.53
buyer_7,María,56,ES44209539382171952129,TRX_N-00503-55289885,2023-06-07T10:48:49,Portugalete,Basic services,water,-42.63,232743.9
buyer_7,María,56,ES44209539382171952129,TRX_N-00504-12586620,2023-06-07T20:57:01,Portugalete,Expense,education,-926.14,231817.76
buyer_7,María,56,ES44209539382171952129,TRX_N-00505-92952578,2023-06-16T20:26:29,Leioa,Expense,transport,-45.06,231772.7
buyer_7,María,56,ES44209539382171952129,TRX_N-00506-65413310,2023-07-01T14:49:44,Portugalete,transfer,Salary,3324.96,235097.66
buyer_7,María,56,ES44209539382171952129,TRX_N-00507-32572483,2023-07-01T14:49:44,Portugalete,transfer,Partner Salary,3441.05,238538.71
buyer_7,María,56,ES44209539382171952129,TRX_N-00508-97813956,2023-07-01T20:38:26,Portugalete,Expense,clothing,-58.64,238480.07
buyer_7,María,56,ES44209539382171952129,TRX_N-00509-11550174,2023-07-05T18:35:52,Portugalete,Housing,Mortgage,-553.82,237926.25
buyer_7,María,56,ES44209539382171952129,TRX_N-00510-59500318,2023-07-05T19:06:34,Portugalete,Basic services,water,-60.63,237865.62
buyer_7,María,56,ES44209539382171952129,TRX_N-00511-16614404,2023-07-07T18:29:32,Portugalete,Basic services,water,-15.18,237850.44
buyer_7,María,56,ES44209539382171952129,TRX_N-00512-42589362,2023-07-07T10:32:53,Portugalete,Basic services,internet,-46.07,237804.37
buyer_7,María,56,ES44209539382171952129,TRX_N-00513-65187422,2023-07-09T15:14:56,Pasaia,Expense,food,-266.11,237538.26
buyer_7,María,56,ES44209539382171952129,TRX_N-00514-36684268,2023-07-10T17:41:29,Portugalete,Expense,food,-382.12,237156.14
buyer_7,María,56,ES44209539382171952129,TRX_N-00515-10393472,2023-07-11T17:44:04,Portugalete,Expense,transport,-22.74,237133.4
buyer_7,María,56,ES44209539382171952129,TRX_N-00516-23674984,2023-08-01T19:26:25,Portugalete,transfer,Salary,3324.96,240458.36
buyer_7,María,56,ES44209539382171952129,TRX_N-00517-17346220,2023-08-01T19:26:25,Portugalete,transfer,Partner Salary,3441.05,243899.41
buyer_7,María,56,ES44209539382171952129,TRX_N-00518-17680075,2023-08-01T19:26:25,Portugalete,transfer,Extra Income,332.5,244231.91
buyer_7,María,56,ES44209539382171952129,TRX_N-00519-95510712,2023-08-05T11:50:15,Portugalete,Housing,Mortgage,-553.82,243678.09
buyer_7,María,56,ES44209539382171952129,TRX_N-00520-54542950,2023-08-06T18:38:57,Portugalete,Basic services,water,-39.43,243638.66
buyer_7,María,56,ES44209539382171952129,TRX_N-00521-35288925,2023-08-06T19:25:01,Portugalete,Basic services,electricity,-64.92,243573.74
buyer_7,María,56,ES44209539382171952129,TRX_N-00522-95179420,2023-08-06T10:23:15,Portugalete,Basic services,internet,-49.29,243524.45
buyer_7,María,56,ES44209539382171952129,TRX_N-00523-87133192,2023-08-06T14:15:32,Portugalete,Basic services,phone,-56.07,243468.38
buyer_7,María,56,ES44209539382171952129,TRX_N-00524-10491869,2023-08-07T17:25:39,Portugalete,Basic services,water,-76.73,243391.65
buyer_7,María,56,ES44209539382171952129,TRX_N-00525-02413650,2023-08-07T12:52:49,Portugalete,Basic services,electricity,-43.03,243348.62
buyer_7,María,56,ES44209539382171952129,TRX_N-00526-68433301,2023-08-11T10:14:46,Portugalete,Expense,transport,-94.7,243253.92
buyer_7,María,56,ES44209539382171952129,TRX_N-00527-87503871,2023-08-11T08:51:43,Portugalete,Expense,education,-559.39,242694.53
buyer_7,María,56,ES44209539382171952129,TRX_N-00528-33653149,2023-08-18T13:38:30,Hondarribia,Expense,food,-446.34,242248.19
buyer_7,María,56,ES44209539382171952129,TRX_N-00529-99603279,2023-09-01T07:42:21,Portugalete,transfer,Salary,3324.96,245573.15
buyer_7,María,56,ES44209539382171952129,TRX_N-00530-97734365,2023-09-01T07:42:21,Portugalete,transfer,Partner Salary,3441.05,249014.2
buyer_7,María,56,ES44209539382171952129,TRX_N-00531-05218242,2023-09-05T11:06:25,Portugalete,Housing,Mortgage,-553.82,248460.38
buyer_7,María,56,ES44209539382171952129,TRX_N-00532-81947878,2023-09-06T16:12:47,Portugalete,Basic services,internet,-60.38,248400.0
buyer_7,María,56,ES44209539382171952129,TRX_N-00533-33687487,2023-09-06T20:23:57,Portugalete,Basic services,phone,-32.87,248367.13
buyer_7,María,56,ES44209539382171952129,TRX_N-00534-39422364,2023-09-07T18:38:09,Portugalete,Basic services,water,-25.0,248342.13
buyer_7,María,56,ES44209539382171952129,TRX_N-00535-04933956,2023-09-07T21:49:36,Portugalete,Basic services,electricity,-117.16,248224.97
buyer_7,María,56,ES44209539382171952129,TRX_N-00536-34623490,2023-09-07T15:31:48,Portugalete,Expense,transport,-90.98,248133.99
buyer_7,María,56,ES44209539382171952129,TRX_N-00537-30943928,2023-09-10T15:14:42,Portugalete,Expense,education,-570.61,247563.38
buyer_7,María,56,ES44209539382171952129,TRX_N-00538-67046306,2023-09-28T15:01:08,Portugalete,Expense,food,-632.45,246930.93
buyer_7,María,56,ES44209539382171952129,TRX_N-00539-87682265,2023-10-01T13:50:52,Portugalete,transfer,Salary,3324.96,250255.89
buyer_7,María,56,ES44209539382171952129,TRX_N-00540-64072411,2023-10-01T13:50:52,Portugalete,transfer,Partner Salary,3441.05,253696.94
buyer_7,María,56,ES44209539382171952129,TRX_N-00541-61570598,2023-10-02T08:59:54,Portugalete,Expense,healthcare,-396.07,253300.87
buyer_7,María,56,ES44209539382171952129,TRX_N-00542-79503256,2023-10-05T19:25:02,Portugalete,Housing,Mortgage,-553.82,252747.05
buyer_7,María,56,ES44209539382171952129,TRX_N-00543-42859965,2023-10-05T11:54:35,Portugalete,Basic services,gas,-46.68,252700.37
buyer_7,María,56,ES44209539382171952129,TRX_N-00544-79373597,2023-10-05T08:10:06,Portugalete,Basic services,internet,-35.15,252665.22
buyer_7,María,56,ES44209539382171952129,TRX_N-00545-79706850,2023-10-07T22:18:18,Portugalete,Basic services,water,-64.19,252601.03
buyer_7,María,56,ES44209539382171952129,TRX_N-00546-86048487,2023-10-07T10:30:30,Portugalete,Basic services,electricity,-67.57,252533.46
buyer_7,María,56,ES44209539382171952129,TRX_N-00547-92053104,2023-10-07T05:58:32,Portugalete,Basic services,gas,-39.44,252494.02
buyer_7,María,56,ES44209539382171952129,TRX_N-00548-76645454,2023-10-24T17:55:29,Zuia,Expense,travel,-269.19,252224.83
buyer_7,María,56,ES44209539382171952129,TRX_N-00549-31359594,2023-11-01T19:20:58,Portugalete,transfer,Salary,3324.96,255549.79
buyer_7,María,56,ES44209539382171952129,TRX_N-00550-94826512,2023-11-01T19:20:58,Portugalete,transfer,Partner Salary,3441.05,258990.84
buyer_7,María,56,ES44209539382171952129,TRX_N-00551-98798594,2023-11-01T19:20:58,Portugalete,transfer,Extra Income,332.5,259323.34
buyer_7,María,56,ES44209539382171952129,TRX_N-00552-54926293,2023-11-01T22:18:13,Portugalete,Expense,food,-712.98,258610.36
buyer_7,María,56,ES44209539382171952129,TRX_N-00553-75569498,2023-11-02T09:17:06,Portugalete,Expense,clothing,-460.06,258150.3
buyer_7,María,56,ES44209539382171952129,TRX_N-00554-33989343,2023-11-05T16:03:43,Portugalete,Housing,Mortgage,-553.82,257596.48
buyer_7,María,56,ES44209539382171952129,TRX_N-00555-56046471,2023-11-06T22:12:40,Portugalete,Basic services,water,-79.27,257517.21
buyer_7,María,56,ES44209539382171952129,TRX_N-00556-89971764,2023-11-07T18:33:38,Portugalete,Basic services,electricity,-45.85,257471.36
buyer_7,María,56,ES44209539382171952129,TRX_N-00557-99767871,2023-11-07T23:42:39,Portugalete,Basic services,internet,-79.49,257391.87
buyer_7,María,56,ES44209539382171952129,TRX_N-00558-33465684,2023-11-07T21:58:57,Portugalete,Basic services,phone,-59.68,257332.19
buyer_7,María,56,ES44209539382171952129,TRX_N-00559-02279407,2023-11-13T23:11:32,Portugalete,Expense,gifts,-283.23,257048.96
buyer_7,María,56,ES44209539382171952129,TRX_N-00560-71472266,2023-11-18T19:35:39,Portugalete,Expense,transport,-32.64,257016.32
buyer_7,María,56,ES44209539382171952129,TRX_N-00561-42164108,2023-12-01T23:41:29,Portugalete,transfer,Salary,3324.96,260341.28
buyer_7,María,56,ES44209539382171952129,TRX_N-00562-45107674,2023-12-01T23:41:29,Portugalete,transfer,Partner Salary,3441.05,263782.33
buyer_7,María,56,ES44209539382171952129,TRX_N-00563-29235675,2023-12-01T23:41:29,Portugalete,transfer,Bonus,3203.7,266986.03
buyer_7,María,56,ES44209539382171952129,TRX_N-00564-06485394,2023-12-02T12:39:08,Portugalete,Expense,food,-680.21,266305.82
buyer_7,María,56,ES44209539382171952129,TRX_N-00565-59023301,2023-12-05T17:39:46,Portugalete,Housing,Mortgage,-553.82,265752.0
buyer_7,María,56,ES44209539382171952129,TRX_N-00566-92634896,2023-12-05T20:20:04,Portugalete,Basic services,water,-52.91,265699.09
buyer_7,María,56,ES44209539382171952129,TRX_N-00567-43070972,2023-12-05T16:53:52,Portugalete,Basic services,gas,-58.57,265640.52
buyer_7,María,56,ES44209539382171952129,TRX_N-00568-44326839,2023-12-05T23:34:40,Portugalete,Basic services,internet,-31.05,265609.47
buyer_7,María,56,ES44209539382171952129,TRX_N-00569-72242481,2023-12-06T11:16:41,Portugalete,Basic services,phone,-33.39,265576.08
buyer_7,María,56,ES44209539382171952129,TRX_N-00570-73415867,2023-12-07T15:11:14,Portugalete,Basic services,gas,-85.06,265491.02
buyer_7,María,56,ES44209539382171952129,TRX_N-00571-91061068,2023-12-15T17:28:25,Portugalete,Expense,food,-393.85,265097.17
buyer_7,María,56,ES44209539382171952129,TRX_N-00572-94193580,2023-12-21T19:05:30,Portugalete,Expense,transport,-126.12,264971.05
buyer_7,María,56,ES44209539382171952129,TRX_N-00573-97700548,2023-12-21T16:39:08,Portugalete,Expense,education,-370.44,264600.61
buyer_7,María,56,ES44209539382171952129,TRX_N-00574-13632669,2023-12-23T09:32:04,Portugalete,Expense,transport,-125.08,264475.53
buyer_7,María,56,ES44209539382171952129,TRX_N-00575-99838321,2023-12-23T12:14:50,Salvatierra/Agurain,Expense,healthcare,-68.83,264406.7
buyer_7,María,56,ES44209539382171952129,TRX_N-00576-22632363,2024-01-01T10:22:40,Portugalete,transfer,Salary,3324.96,267731.66
buyer_7,María,56,ES44209539382171952129,TRX_N-00577-11320924,2024-01-01T10:22:40,Portugalete,transfer,Partner Salary,3441.05,271172.71
buyer_7,María,56,ES44209539382171952129,TRX_N-00578-99298129,2024-01-05T13:49:28,Portugalete,Housing,Mortgage,-553.82,270618.89
buyer_7,María,56,ES44209539382171952129,TRX_N-00579-46540578,2024-01-05T18:45:39,Portugalete,Basic services,water,-21.0,270597.89
buyer_7,María,56,ES44209539382171952129,TRX_N-00580-98059151,2024-01-05T16:04:27,Portugalete,Basic services,electricity,-42.76,270555.13
buyer_7,María,56,ES44209539382171952129,TRX_N-00581-06710470,2024-01-05T19:44:23,Portugalete,Basic services,phone,-24.0,270531.13
buyer_7,María,56,ES44209539382171952129,TRX_N-00582-35350788,2024-01-06T20:13:14,Portugalete,Basic services,internet,-75.09,270456.04
buyer_7,María,56,ES44209539382171952129,TRX_N-00583-47797380,2024-01-06T15:56:55,Portugalete,Expense,food,-570.16,269885.88
buyer_7,María,56,ES44209539382171952129,TRX_N-00584-77871017,2024-01-07T20:58:21,Portugalete,Basic services,water,-35.57,269850.31
buyer_7,María,56,ES44209539382171952129,TRX_N-00585-00048979,2024-01-07T09:58:51,Portugalete,Expense,healthcare,-153.57,269696.74
buyer_7,María,56,ES44209539382171952129,TRX_N-00586-84317223,2024-01-12T15:56:48,Zarautz,Expense,food,-507.39,269189.35
buyer_7,María,56,ES44209539382171952129,TRX_N-00587-58017279,2024-01-16T08:01:03,Berango,Expense,leisure,-217.07,268972.28
buyer_7,María,56,ES44209539382171952129,TRX_N-00588-09271633,2024-01-28T15:15:28,Portugalete,Expense,transport,-135.76,268836.52
buyer_7,María,56,ES44209539382171952129,TRX_N-00589-93391779,2024-02-01T12:27:48,Portugalete,transfer,Salary,3324.96,272161.48
buyer_7,María,56,ES44209539382171952129,TRX_N-00590-57086932,2024-02-01T12:27:48,Portugalete,transfer,Partner Salary,3441.05,275602.53
buyer_7,María,56,ES44209539382171952129,TRX_N-00591-81402460,2024-02-01T12:27:48,Portugalete,transfer,Extra Income,332.5,275935.03
buyer_7,María,56,ES44209539382171952129,TRX_N-00592-24299080,2024-02-05T17:05:00,Portugalete,Housing,Mortgage,-553.82,275381.21
buyer_7,María,56,ES44209539382171952129,TRX_N-00593-91920671,2024-02-05T19:03:58,Portugalete,Basic services,water,-42.45,275338.76
buyer_7,María,56,ES44209539382171952129,TRX_N-00594-90294982,2024-02-06T13:30:59,Portugalete,Basic services,phone,-71.65,275267.11
buyer_7,María,56,ES44209539382171952129,TRX_N-00595-82663380,2024-02-07T11:54:15,Portugalete,Basic services,internet,-69.31,275197.8
buyer_7,María,56,ES44209539382171952129,TRX_N-00596-13181868,2024-02-07T15:07:38,Portugalete,Basic services,phone,-78.17,275119.63
buyer_7,María,56,ES44209539382171952129,TRX_N-00597-96141027,2024-02-10T18:23:31,Portugalete,Expense,healthcare,-335.49,274784.14
buyer_7,María,56,ES44209539382171952129,TRX_N-00598-20644355,2024-02-12T09:32:12,Portugalete,Expense,food,-336.9,274447.24
buyer_7,María,56,ES44209539382171952129,TRX_N-00599-62211932,2024-02-13T15:31:08,Portugalete,Expense,leisure,-161.01,274286.23
buyer_7,María,56,ES44209539382171952129,TRX_N-00600-23879940,2024-03-01T08:17:05,Portugalete,transfer,Salary,3324.96,277611.19
buyer_7,María,56,ES44209539382171952129,TRX_N-00601-26253233,2024-03-01T08:17:05,Portugalete,transfer,Partner Salary,3441.05,281052.24
buyer_7,María,56,ES44209539382171952129,TRX_N-00602-96465168,2024-03-05T08:51:04,Portugalete,Housing,Mortgage,-553.82,280498.42
buyer_7,María,56,ES44209539382171952129,TRX_N-00603-56372057,2024-03-05T18:53:39,Portugalete,Basic services,electricity,-79.21,280419.21
buyer_7,María,56,ES44209539382171952129,TRX_N-00604-36609493,2024-03-05T11:58:54,Portugalete,Basic services,phone,-55.54,280363.67
buyer_7,María,56,ES44209539382171952129,TRX_N-00605-62339080,2024-03-06T14:01:02,Portugalete,Basic services,water,-73.53,280290.14
buyer_7,María,56,ES44209539382171952129,TRX_N-00606-78102593,2024-03-06T18:30:35,Portugalete,Basic services,gas,-37.74,280252.4
buyer_7,María,56,ES44209539382171952129,TRX_N-00607-95142270,2024-03-07T23:35:45,Portugalete,Basic services,water,-75.79,280176.61
buyer_7,María,56,ES44209539382171952129,TRX_N-00608-99102951,2024-03-07T09:51:17,Portugalete,Basic services,electricity,-108.39,280068.22
buyer_7,María,56,ES44209539382171952129,TRX_N-00609-60537232,2024-03-08T12:23:02,Portugalete,Expense,food,-737.77,279330.45
buyer_7,María,56,ES44209539382171952129,TRX_N-00610-50641717,2024-03-10T08:04:49,Sopela,Expense,food,-768.2,278562.25
buyer_7,María,56,ES44209539382171952129,TRX_N-00611-29035587,2024-03-24T10:34:33,Portugalete,Expense,transport,-127.62,278434.63
buyer_7,María,56,ES44209539382171952129,TRX_N-00612-07943842,2024-04-01T09:57:08,Portugalete,transfer,Salary,3324.96,281759.59
buyer_7,María,56,ES44209539382171952129,TRX_N-00613-13318130,2024-04-01T09:57:08,Portugalete,transfer,Partner Salary,3441.05,285200.64
buyer_7,María,56,ES44209539382171952129,TRX_N-00614-36528529,2024-04-01T09:57:08,Portugalete,transfer,Extra Income,332.5,285533.14
buyer_7,María,56,ES44209539382171952129,TRX_N-00615-66564837,2024-04-05T07:50:42,Portugalete,Housing,Mortgage,-553.82,284979.32
buyer_7,María,56,ES44209539382171952129,TRX_N-00616-57400807,2024-04-05T13:56:55,Portugalete,Basic services,internet,-72.68,284906.64
buyer_7,María,56,ES44209539382171952129,TRX_N-00617-04512084,2024-04-06T15:22:54,Portugalete,Basic services,gas,-53.95,284852.69
buyer_7,María,56,ES44209539382171952129,TRX_N-00618-42855821,2024-04-06T20:30:27,Portugalete,Basic services,phone,-27.57,284825.12
buyer_7,María,56,ES44209539382171952129,TRX_N-00619-86846524,2024-04-07T14:29:44,Portugalete,Basic services,gas,-64.97,284760.15
buyer_7,María,56,ES44209539382171952129,TRX_N-00620-03983700,2024-04-08T20:08:01,Portugalete,Expense,transport,-59.29,284700.86
buyer_7,María,56,ES44209539382171952129,TRX_N-00621-16840719,2024-04-15T20:21:32,Portugalete,Expense,clothing,-418.65,284282.21
buyer_7,María,56,ES44209539382171952129,TRX_N-00622-11132018,2024-04-17T15:50:20,Portugalete,Expense,healthcare,-111.99,284170.22
buyer_7,María,56,ES44209539382171952129,TRX_N-00623-14603096,2024-04-20T12:47:29,Portugalete,Expense,healthcare,-317.96,283852.26
buyer_7,María,56,ES44209539382171952129,TRX_N-00624-61425093,2024-04-22T17:12:34,Portugalete,Expense,healthcare,-139.51,283712.75
buyer_7,María,56,ES44209539382171952129,TRX_N-00625-73436125,2024-04-24T08:48:50,Portugalete,Expense,leisure,-29.7,283683.05
buyer_7,María,56,ES44209539382171952129,TRX_N-00626-14603132,2024-04-25T12:37:25,Portugalete,Expense,food,-382.93,283300.12
buyer_7,María,56,ES44209539382171952129,TRX_N-00627-25567760,2024-05-01T11:29:39,Portugalete,transfer,Salary,3324.96,286625.08
buyer_7,María,56,ES44209539382171952129,TRX_N-00628-26310158,2024-05-01T11:29:39,Portugalete,transfer,Partner Salary,3441.05,290066.13
buyer_7,María,56,ES44209539382171952129,TRX_N-00629-01366304,2024-05-04T14:24:50,Portugalete,Expense,transport,-31.18,290034.95
buyer_7,María,56,ES44209539382171952129,TRX_N-00630-96232704,2024-05-05T14:55:24,Portugalete,Housing,Mortgage,-553.82,289481.13
buyer_7,María,56,ES44209539382171952129,TRX_N-00631-94508436,2024-05-05T03:29:24,Portugalete,Basic services,electricity,-24.84,289456.29
buyer_7,María,56,ES44209539382171952129,TRX_N-00632-48241703,2024-05-05T19:41:17,Portugalete,Basic services,phone,-77.14,289379.15
buyer_7,María,56,ES44209539382171952129,TRX_N-00633-75094407,2024-05-05T17:48:41,Portugalete,Expense,travel,-1601.68,287777.47
buyer_7,María,56,ES44209539382171952129,TRX_N-00634-58125865,2024-05-06T15:41:08,Portugalete,Basic services,water,-76.19,287701.28
buyer_7,María,56,ES44209539382171952129,TRX_N-00635-09676956,2024-05-06T22:21:04,Portugalete,Basic services,electricity,-125.76,287575.52
buyer_7,María,56,ES44209539382171952129,TRX_N-00636-77165623,2024-05-07T18:39:35,Portugalete,Basic services,phone,-36.32,287539.2
buyer_7,María,56,ES44209539382171952129,TRX_N-00637-62244792,2024-05-07T23:59:02,Portugalete,Expense,clothing,-366.77,287172.43
buyer_7,María,56,ES44209539382171952129,TRX_N-00638-29011383,2024-05-21T18:55:19,Portugalete,Expense,transport,-130.96,287041.47
buyer_7,María,56,ES44209539382171952129,TRX_N-00639-61085873,2024-05-21T09:19:40,Hondarribia,Expense,repairs,-50.97,286990.5
buyer_7,María,56,ES44209539382171952129,TRX_N-00640-75070548,2024-05-25T10:34:26,Portugalete,Expense,clothing,-397.69,286592.81
buyer_7,María,56,ES44209539382171952129,TRX_N-00641-14560143,2024-06-01T12:50:49,Portugalete,transfer,Salary,3324.96,289917.77
buyer_7,María,56,ES44209539382171952129,TRX_N-00642-05171094,2024-06-01T12:50:49,Portugalete,transfer,Partner Salary,3441.05,293358.82
buyer_7,María,56,ES44209539382171952129,TRX_N-00643-62367923,2024-06-01T12:50:49,Portugalete,transfer,Bonus,3292.07,296650.89
buyer_7,María,56,ES44209539382171952129,TRX_N-00644-13232816,2024-06-04T01:57:27,Portugalete,Expense,repairs,-789.22,295861.67
buyer_7,María,56,ES44209539382171952129,TRX_N-00645-14257942,2024-06-05T16:57:56,Portugalete,Housing,Mortgage,-553.82,295307.85
buyer_7,María,56,ES44209539382171952129,TRX_N-00646-21074006,2024-06-05T10:06:59,Portugalete,Basic services,water,-17.17,295290.68
buyer_7,María,56,ES44209539382171952129,TRX_N-00647-90453813,2024-06-05T14:21:58,Portugalete,Basic services,electricity,-42.29,295248.39
buyer_7,María,56,ES44209539382171952129,TRX_N-00648-32732203,2024-06-05T16:03:00,Portugalete,Basic services,internet,-60.63,295187.76
buyer_7,María,56,ES44209539382171952129,TRX_N-00649-48597152,2024-06-06T14:42:38,Portugalete,Basic services,water,-20.74,295167.02
buyer_7,María,56,ES44209539382171952129,TRX_N-00650-35262680,2024-06-06T11:52:58,Portugalete,Basic services,electricity,-62.54,295104.48
buyer_7,María,56,ES44209539382171952129,TRX_N-00651-94361250,2024-06-06T17:24:31,Portugalete,Basic services,gas,-36.15,295068.33
buyer_7,María,56,ES44209539382171952129,TRX_N-00652-76599588,2024-06-06T13:08:45,Portugalete,Basic services,internet,-36.24,295032.09
buyer_7,María,56,ES44209539382171952129,TRX_N-00653-39196332,2024-06-06T20:23:42,Portugalete,Basic services,phone,-65.76,294966.33
buyer_7,María,56,ES44209539382171952129,TRX_N-00654-25348839,2024-06-07T09:04:36,Portugalete,Basic services,electricity,-104.88,294861.45
buyer_7,María,56,ES44209539382171952129,TRX_N-00655-03561816,2024-06-07T13:30:24,Portugalete,Basic services,internet,-44.73,294816.72
buyer_7,María,56,ES44209539382171952129,TRX_N-00656-70531050,2024-06-07T11:49:06,Portugalete,Basic services,phone,-73.7,294743.02
buyer_7,María,56,ES44209539382171952129,TRX_N-00657-56694695,2024-06-21T12:21:37,Portugalete,Expense,clothing,-248.87,294494.15
buyer_7,María,56,ES44209539382171952129,TRX_N-00658-32410499,2024-07-01T17:42:42,Portugalete,transfer,Salary,3324.96,297819.11
buyer_7,María,56,ES44209539382171952129,TRX_N-00659-47255300,2024-07-01T17:42:42,Portugalete,transfer,Partner Salary,3441.05,301260.16
buyer_7,María,56,ES44209539382171952129,TRX_N-00660-26263381,2024-07-01T17:42:42,Portugalete,transfer,Extra Income,332.5,301592.66
buyer_7,María,56,ES44209539382171952129,TRX_N-00661-58461230,2024-07-05T16:34:34,Portugalete,Housing,Mortgage,-553.82,301038.84
buyer_7,María,56,ES44209539382171952129,TRX_N-00662-24914185,2024-07-05T20:43:00,Portugalete,Basic services,phone,-64.79,300974.05
buyer_7,María,56,ES44209539382171952129,TRX_N-00663-05638512,2024-07-07T14:29:07,Portugalete,Basic services,water,-41.18,300932.87
buyer_7,María,56,ES44209539382171952129,TRX_N-00664-28864494,2024-07-07T10:43:53,Portugalete,Basic services,gas,-86.53,300846.34
buyer_7,María,56,ES44209539382171952129,TRX_N-00665-74475650,2024-07-07T12:06:53,Portugalete,Basic services,phone,-22.8,300823.54
buyer_7,María,56,ES44209539382171952129,TRX_N-00666-91070391,2024-07-18T20:44:56,Pasaia,Expense,leisure,-166.86,300656.68
buyer_7,María,56,ES44209539382171952129,TRX_N-00667-91268078,2024-07-31T09:33:36,Portugalete,Expense,transport,-37.14,300619.54
buyer_7,María,56,ES44209539382171952129,TRX_N-00668-00064724,2024-08-01T14:28:33,Portugalete,transfer,Salary,3324.96,303944.5
buyer_7,María,56,ES44209539382171952129,TRX_N-00669-09248643,2024-08-01T14:28:33,Portugalete,transfer,Partner Salary,3441.05,307385.55
buyer_7,María,56,ES44209539382171952129,TRX_N-00670-02918342,2024-08-03T18:24:58,Portugalete,Expense,transport,-43.61,307341.94
buyer_7,María,56,ES44209539382171952129,TRX_N-00671-37076008,2024-08-05T05:19:23,Portugalete,Housing,Mortgage,-553.82,306788.12
buyer_7,María,56,ES44209539382171952129,TRX_N-00672-55495272,2024-08-05T11:19:24,Portugalete,Basic services,electricity,-94.73,306693.39
buyer_7,María,56,ES44209539382171952129,TRX_N-00673-34524208,2024-08-06T09:09:30,Portugalete,Basic services,internet,-42.16,306651.23
buyer_7,María,56,ES44209539382171952129,TRX_N-00674-29160658,2024-08-06T22:52:23,Portugalete,Basic services,phone,-72.27,306578.96
buyer_7,María,56,ES44209539382171952129,TRX_N-00675-43154086,2024-08-07T20:55:05,Portugalete,Basic services,phone,-92.3,306486.66
buyer_7,María,56,ES44209539382171952129,TRX_N-00676-10735950,2024-08-19T09:26:16,Portugalete,Expense,clothing,-251.89,306234.77
buyer_7,María,56,ES44209539382171952129,TRX_N-00677-62723967,2024-08-20T13:04:18,Portugalete,Expense,clothing,-95.27,306139.5
buyer_7,María,56,ES44209539382171952129,TRX_N-00678-63098761,2024-09-01T12:42:39,Portugalete,transfer,Salary,3324.96,309464.46
buyer_7,María,56,ES44209539382171952129,TRX_N-00679-43586484,2024-09-01T12:42:39,Portugalete,transfer,Partner Salary,3441.05,312905.51
buyer_7,María,56,ES44209539382171952129,TRX_N-00680-16108099,2024-09-05T14:31:31,Portugalete,Housing,Mortgage,-553.82,312351.69
buyer_7,María,56,ES44209539382171952129,TRX_N-00681-72994044,2024-09-06T14:00:23,Portugalete,Basic services,water,-29.9,312321.79
buyer_7,María,56,ES44209539382171952129,TRX_N-00682-00342487,2024-09-06T19:01:39,Portugalete,Basic services,phone,-58.83,312262.96
buyer_7,María,56,ES44209539382171952129,TRX_N-00683-08171358,2024-09-07T08:51:29,Portugalete,Basic services,electricity,-104.11,312158.85
buyer_7,María,56,ES44209539382171952129,TRX_N-00684-51354283,2024-09-07T15:48:44,Portugalete,Basic services,gas,-71.48,312087.37
buyer_7,María,56,ES44209539382171952129,TRX_N-00685-64538393,2024-09-07T17:46:28,Portugalete,Basic services,internet,-67.61,312019.76
buyer_7,María,56,ES44209539382171952129,TRX_N-00686-33176351,2024-09-18T17:30:58,Eibar,Expense,food,-527.12,311492.64
buyer_7,María,56,ES44209539382171952129,TRX_N-00687-78771062,2024-10-01T18:42:49,Portugalete,transfer,Salary,3324.96,314817.6
buyer_7,María,56,ES44209539382171952129,TRX_N-00688-83611331,2024-10-01T18:42:49,Portugalete,transfer,Partner Salary,3441.05,318258.65
buyer_7,María,56,ES44209539382171952129,TRX_N-00689-80193210,2024-10-01T18:42:49,Portugalete,transfer,Extra Income,332.5,318591.15
buyer_7,María,56,ES44209539382171952129,TRX_N-00690-56368930,2024-10-05T14:57:58,Portugalete,Housing,Mortgage,-553.82,318037.33
buyer_7,María,56,ES44209539382171952129,TRX_N-00691-20720381,2024-10-05T03:51:06,Portugalete,Basic services,water,-33.43,318003.9
buyer_7,María,56,ES44209539382171952129,TRX_N-00692-29424442,2024-10-05T13:21:54,Portugalete,Basic services,gas,-27.92,317975.98
buyer_7,María,56,ES44209539382171952129,TRX_N-00693-84318244,2024-10-06T15:34:09,Portugalete,Basic services,electricity,-53.85,317922.13
buyer_7,María,56,ES44209539382171952129,TRX_N-00694-35065458,2024-10-06T09:54:13,Portugalete,Basic services,gas,-38.21,317883.92
buyer_7,María,56,ES44209539382171952129,TRX_N-00695-07266606,2024-10-06T11:43:49,Portugalete,Basic services,phone,-55.1,317828.82
buyer_7,María,56,ES44209539382171952129,TRX_N-00696-58682597,2024-10-07T01:58:56,Portugalete,Basic services,electricity,-137.9,317690.92
buyer_7,María,56,ES44209539382171952129,TRX_N-00697-65605100,2024-10-07T13:25:04,Portugalete,Basic services,gas,-83.93,317606.99
buyer_7,María,56,ES44209539382171952129,TRX_N-00698-20405245,2024-10-07T11:27:59,Portugalete,Basic services,internet,-73.65,317533.34
buyer_7,María,56,ES44209539382171952129,TRX_N-00699-22919133,2024-10-07T13:49:34,Portugalete,Basic services,phone,-77.12,317456.22
buyer_8,Antonio,45,ES71209515561182359610,TRX_N-00001-32659355,2020-01-01T13:12:24,Labastida,transfer,Salary,2009.66,3561.99
buyer_8,Antonio,45,ES71209515561182359610,TRX_N-00002-03386726,2020-01-03T15:03:28,Labastida,Expense,transport,-39.82,3522.17
buyer_8,Antonio,45,ES71209515561182359610,TRX_N-00003-90742438,2020-01-05T00:45:04,Labastida,Housing,Mortgage,-943.56,2578.61
buyer_8,Antonio,45,ES71209515561182359610,TRX_N-00004-52165063,2020-01-05T20:44:49,Labastida,Basic services,water,-49.02,2529.59
buyer_8,Antonio,45,ES71209515561182359610,TRX_N-00005-12152077,2020-01-06T10:22:13,Labastida,Basic services,electricity,-68.59,2461.0
buyer_8,Antonio,45,ES71209515561182359610,TRX_N-00006-21525718,2020-01-06T14:25:45,Labastida,Basic services,internet,-36.09,2424.91
buyer_8,Antonio,45,ES71209515561182359610,TRX_N-00007-70135290,2020-01-06T10:43:51,Labastida,Basic services,phone,-85.87,2339.04
buyer_8,Antonio,45,ES71209515561182359610,TRX_N-00008-80238094,2020-01-07T20:35:19,Labastida,Basic services,electricity,-77.65,2261.39
buyer_8,Antonio,45,ES71209515561182359610,TRX_N-00009-26103526,2020-01-07T08:45:19,Labastida,Basic services,gas,-86.11,2175.28
buyer_8,Antonio,45,ES71209515561182359610,TRX_N-00010-10131407,2020-01-12T16:47:49,Labastida,Expense,transport,-100.16,2075.12
buyer_8,Antonio,45,ES71209515561182359610,TRX_N-00011-24005970,2020-02-01T07:43:50,Labastida,transfer,Salary,2009.66,4084.78
buyer_8,Antonio,45,ES71209515561182359610,TRX_N-00012-46637181,2020-02-01T18:32:15,Labastida,Expense,gifts,-241.51,3843.27
buyer_8,Antonio,45,ES71209515561182359610,TRX_N-00013-07617479,2020-02-05T14:08:35,Labastida,Housing,Mortgage,-943.56,2899.71
buyer_8,Antonio,45,ES71209515561182359610,TRX_N-00014-53008943,2020-02-05T16:54:11,Labastida,Basic services,water,-63.9,2835.81
buyer_8,Antonio,45,ES71209515561182359610,TRX_N-00015-83838673,2020-02-05T18:29:05,Labastida,Expense,leisure,-25.73,2810.08
buyer_8,Antonio,45,ES71209515561182359610,TRX_N-00016-07155741,2020-02-06T00:56:09,Labastida,Basic services,water,-66.62,2743.46
buyer_8,Antonio,45,ES71209515561182359610,TRX_N-00017-64919142,2020-02-06T08:33:35,Labastida,Basic services,gas,-23.79,2719.67
buyer_8,Antonio,45,ES71209515561182359610,TRX_N-00018-53089973,2020-02-06T19:33:16,Labastida,Basic services,internet,-71.36,2648.31
buyer_8,Antonio,45,ES71209515561182359610,TRX_N-00019-80577145,2020-02-10T15:26:40,Labastida,Expense,gifts,-498.6,2149.71
buyer_8,Antonio,45,ES71209515561182359610,TRX_N-00020-97728298,2020-02-19T08:53:53,Labastida,Expense,food,-279.25,1870.46
buyer_8,Antonio,45,ES71209515561182359610,TRX_N-00021-63624414,2020-02-19T23:27:51,Alegría-Dulantzi,Expense,leisure,-63.69,1806.77
buyer_8,Antonio,45,ES71209515561182359610,TRX_N-00022-06380607,2020-02-27T23:27:29,Labastida,Expense,transport,-134.58,1672.19
buyer_8,Antonio,45,ES71209515561182359610,TRX_N-00023-43932352,2020-02-29T19:50:02,Labastida,Expense,transport,-94.52,1577.67
buyer_8,Antonio,45,ES71209515561182359610,TRX_N-00024-05270960,2020-03-01T16:52:16,Labastida,transfer,Salary,2009.66,3587.33
buyer_8,Antonio,45,ES71209515561182359610,TRX_N-00025-48956887,2020-03-01T16:52:16,Labastida,transfer,Extra Income,200.97,3788.3
buyer_8,Antonio,45,ES71209515561182359610,TRX_N-00026-71211044,2020-03-05T21:26:31,Labastida,Housing,Mortgage,-943.56,2844.74
buyer_8,Antonio,45,ES71209515561182359610,TRX_N-00027-71734205,2020-03-05T14:14:35,Labastida,Basic services,water,-13.81,2830.93
buyer_8,Antonio,45,ES71209515561182359610,TRX_N-00028-01002610,2020-03-05T20:26:39,Labastida,Basic services,electricity,-90.31,2740.62
buyer_8,Antonio,45,ES71209515561182359610,TRX_N-00029-49170502,2020-03-05T10:07:46,Labastida,Basic services,phone,-23.21,2717.41
buyer_8,Antonio,45,ES71209515561182359610,TRX_N-00030-02290085,2020-03-06T14:32:26,Labastida,Basic services,gas,-65.84,2651.57
buyer_8,Antonio,45,ES71209515561182359610,TRX_N-00031-47597343,2020-03-06T17:57:18,Labastida,Basic services,phone,-31.08,2620.49
buyer_8,Antonio,45,ES71209515561182359610,TRX_N-00032-71864531,2020-03-10T15:00:35,Bermeo,Expense,transport,-77.44,2543.05
buyer_8,Antonio,45,ES71209515561182359610,TRX_N-00033-82489867,2020-03-11T09:15:19,Iruña de Oca,Expense,gifts,-486.95,2056.1
buyer_8,Antonio,45,ES71209515561182359610,TRX_N-00034-08233230,2020-04-01T13:59:59,Labastida,transfer,Salary,2009.66,4065.76
buyer_8,Antonio,45,ES71209515561182359610,TRX_N-00035-75688937,2020-04-02T09:34:34,Labastida,Expense,food,-581.8,3483.96
buyer_8,Antonio,45,ES71209515561182359610,TRX_N-00036-86818659,2020-04-05T15:22:21,Labastida,Housing,Mortgage,-943.56,2540.4
buyer_8,Antonio,45,ES71209515561182359610,TRX_N-00037-91928955,2020-04-05T15:07:59,Labastida,Basic services,phone,-61.73,2478.67
buyer_8,Antonio,45,ES71209515561182359610,TRX_N-00038-18508168,2020-04-06T05:09:25,Labastida,Basic services,electricity,-50.16,2428.51
buyer_8,Antonio,45,ES71209515561182359610,TRX_N-00039-16938439,2020-04-06T08:22:49,Labastida,Basic services,internet,-44.45,2384.06
buyer_8,Antonio,45,ES71209515561182359610,TRX_N-00040-14900220,2020-04-07T10:27:31,Labastida,Basic services,electricity,-38.99,2345.07
buyer_8,Antonio,45,ES71209515561182359610,TRX_N-00041-89080910,2020-04-07T19:55:10,Labastida,Basic services,gas,-22.31,2322.76
buyer_8,Antonio,45,ES71209515561182359610,TRX_N-00042-79615789,2020-04-07T10:00:05,Labastida,Basic services,internet,-60.76,2262.0
buyer_8,Antonio,45,ES71209515561182359610,TRX_N-00043-83585842,2020-04-08T15:06:05,Labastida,Expense,transport,-126.99,2135.01
buyer_8,Antonio,45,ES71209515561182359610,TRX_N-00044-48561591,2020-04-10T05:32:39,Berango,Expense,clothing,-498.12,1636.89
buyer_8,Antonio,45,ES71209515561182359610,TRX_N-00045-44568121,2020-04-16T08:47:15,Labastida,Expense,repairs,-112.72,1524.17
buyer_8,Antonio,45,ES71209515561182359610,TRX_N-00046-22310331,2020-04-24T22:38:35,Barakaldo,Expense,transport,-65.88,1458.29
buyer_8,Antonio,45,ES71209515561182359610,TRX_N-00047-50777457,2020-05-01T00:20:40,Labastida,transfer,Salary,2009.66,3467.95
buyer_8,Antonio,45,ES71209515561182359610,TRX_N-00048-90974688,2020-05-01T00:20:40,Labastida,transfer,Extra Income,200.97,3668.92
buyer_8,Antonio,45,ES71209515561182359610,TRX_N-00049-12394475,2020-05-04T11:10:06,Labastida,Expense,transport,-179.27,3489.65
buyer_8,Antonio,45,ES71209515561182359610,TRX_N-00050-28179211,2020-05-05T14:50:08,Labastida,Housing,Mortgage,-943.56,2546.09
buyer_8,Antonio,45,ES71209515561182359610,TRX_N-00051-03589136,2020-05-05T19:22:31,Labastida,Basic services,water,-77.3,2468.79
buyer_8,Antonio,45,ES71209515561182359610,TRX_N-00052-02106539,2020-05-05T11:21:51,Labastida,Basic services,internet,-78.87,2389.92
buyer_8,Antonio,45,ES71209515561182359610,TRX_N-00053-12566188,2020-05-06T17:21:57,Labastida,Basic services,internet,-31.45,2358.47
buyer_8,Antonio,45,ES71209515561182359610,TRX_N-00054-45360089,2020-05-06T11:40:53,Labastida,Basic services,phone,-21.46,2337.01
buyer_8,Antonio,45,ES71209515561182359610,TRX_N-00055-76413118,2020-05-07T13:43:43,Labastida,Basic services,electricity,-62.69,2274.32
buyer_8,Antonio,45,ES71209515561182359610,TRX_N-00056-01417904,2020-05-13T18:54:06,Labastida,Expense,transport,-142.36,2131.96
buyer_8,Antonio,45,ES71209515561182359610,TRX_N-00057-91243870,2020-05-20T08:11:54,Zuia,Expense,healthcare,-338.4,1793.56
buyer_8,Antonio,45,ES71209515561182359610,TRX_N-00058-51139963,2020-05-29T12:10:41,Labastida,Expense,food,-664.65,1128.91
buyer_8,Antonio,45,ES71209515561182359610,TRX_N-00059-07039463,2020-05-30T15:22:50,Labastida,Expense,transport,-63.53,1065.38
buyer_8,Antonio,45,ES71209515561182359610,TRX_N-00060-96886268,2020-06-01T10:08:01,Labastida,transfer,Salary,2009.66,3075.04
buyer_8,Antonio,45,ES71209515561182359610,TRX_N-00061-83510437,2020-06-01T10:08:01,Labastida,transfer,Bonus,2181.74,5256.78
buyer_8,Antonio,45,ES71209515561182359610,TRX_N-00062-75540374,2020-06-05T20:31:38,Labastida,Housing,Mortgage,-943.56,4313.22
buyer_8,Antonio,45,ES71209515561182359610,TRX_N-00063-99171938,2020-06-05T11:00:56,Labastida,Basic services,water,-27.4,4285.82
buyer_8,Antonio,45,ES71209515561182359610,TRX_N-00064-02099816,2020-06-05T13:11:39,Labastida,Basic services,gas,-82.94,4202.88
buyer_8,Antonio,45,ES71209515561182359610,TRX_N-00065-81925101,2020-06-06T18:54:40,Labastida,Basic services,water,-57.2,4145.68
buyer_8,Antonio,45,ES71209515561182359610,TRX_N-00066-79717607,2020-06-06T20:57:23,Labastida,Basic services,electricity,-53.86,4091.82
buyer_8,Antonio,45,ES71209515561182359610,TRX_N-00067-22147895,2020-06-07T13:29:16,Labastida,Basic services,water,-14.83,4076.99
buyer_8,Antonio,45,ES71209515561182359610,TRX_N-00068-25408272,2020-06-27T16:09:35,Labastida,Expense,gifts,-324.39,3752.6
buyer_8,Antonio,45,ES71209515561182359610,TRX_N-00069-73988870,2020-06-29T08:08:22,Labastida,Expense,transport,-72.27,3680.33
buyer_8,Antonio,45,ES71209515561182359610,TRX_N-00070-40509310,2020-07-01T23:38:19,Labastida,transfer,Salary,2009.66,5689.99
buyer_8,Antonio,45,ES71209515561182359610,TRX_N-00071-47021869,2020-07-01T23:38:19,Labastida,transfer,Extra Income,200.97,5890.96
buyer_8,Antonio,45,ES71209515561182359610,TRX_N-00072-07647171,2020-07-03T10:58:32,Labastida,Expense,food,-203.12,5687.84
buyer_8,Antonio,45,ES71209515561182359610,TRX_N-00073-64970873,2020-07-05T11:27:37,Labastida,Housing,Mortgage,-943.56,4744.28
buyer_8,Antonio,45,ES71209515561182359610,TRX_N-00074-28533741,2020-07-05T09:25:54,Labastida,Basic services,electricity,-43.61,4700.67
buyer_8,Antonio,45,ES71209515561182359610,TRX_N-00075-66087596,2020-07-05T13:46:44,Labastida,Basic services,gas,-85.99,4614.68
buyer_8,Antonio,45,ES71209515561182359610,TRX_N-00076-18036611,2020-07-05T13:05:55,Labastida,Basic services,internet,-77.4,4537.28
buyer_8,Antonio,45,ES71209515561182359610,TRX_N-00077-81420214,2020-07-06T12:26:35,Labastida,Basic services,water,-14.69,4522.59
buyer_8,Antonio,45,ES71209515561182359610,TRX_N-00078-61526549,2020-07-16T20:10:37,Labastida,Expense,food,-123.7,4398.89
buyer_8,Antonio,45,ES71209515561182359610,TRX_N-00079-31180308,2020-07-23T12:03:13,Labastida,Expense,transport,-113.51,4285.38
buyer_8,Antonio,45,ES71209515561182359610,TRX_N-00080-30641485,2020-07-28T16:39:51,Labastida,Expense,healthcare,-353.73,3931.65
buyer_8,Antonio,45,ES71209515561182359610,TRX_N-00081-37273678,2020-08-01T08:34:41,Labastida,transfer,Salary,2009.66,5941.31
buyer_8,Antonio,45,ES71209515561182359610,TRX_N-00082-49149936,2020-08-03T17:46:39,Labastida,Expense,repairs,-347.69,5593.62
buyer_8,Antonio,45,ES71209515561182359610,TRX_N-00083-02369131,2020-08-05T15:29:53,Labastida,Housing,Mortgage,-943.56,4650.06
buyer_8,Antonio,45,ES71209515561182359610,TRX_N-00084-24105825,2020-08-05T19:53:26,Labastida,Basic services,water,-25.58,4624.48
buyer_8,Antonio,45,ES71209515561182359610,TRX_N-00085-19940940,2020-08-05T07:31:11,Labastida,Basic services,gas,-52.62,4571.86
buyer_8,Antonio,45,ES71209515561182359610,TRX_N-00086-37419219,2020-08-05T09:09:52,Labastida,Basic services,internet,-39.75,4532.11
buyer_8,Antonio,45,ES71209515561182359610,TRX_N-00087-57783166,2020-08-06T08:33:40,Labastida,Basic services,gas,-91.95,4440.16
buyer_8,Antonio,45,ES71209515561182359610,TRX_N-00088-34345216,2020-08-07T08:36:15,Labastida,Basic services,water,-44.23,4395.93
buyer_8,Antonio,45,ES71209515561182359610,TRX_N-00089-04859753,2020-08-07T13:41:25,Labastida,Basic services,gas,-36.82,4359.11
buyer_8,Antonio,45,ES71209515561182359610,TRX_N-00090-81848451,2020-08-11T10:33:46,Labastida,Expense,education,-406.74,3952.37
buyer_8,Antonio,45,ES71209515561182359610,TRX_N-00091-36521261,2020-08-12T12:55:58,Labastida,Expense,transport,-116.87,3835.5
buyer_8,Antonio,45,ES71209515561182359610,TRX_N-00092-04321935,2020-08-16T11:24:45,Labastida,Expense,leisure,-296.95,3538.55
buyer_8,Antonio,45,ES71209515561182359610,TRX_N-00093-51003809,2020-08-18T15:14:49,Labastida,Expense,leisure,-59.56,3478.99
buyer_8,Antonio,45,ES71209515561182359610,TRX_N-00094-42736205,2020-09-01T16:15:09,Labastida,transfer,Salary,2009.66,5488.65
buyer_8,Antonio,45,ES71209515561182359610,TRX_N-00095-38410122,2020-09-05T12:21:34,Labastida,Housing,Mortgage,-943.56,4545.09
buyer_8,Antonio,45,ES71209515561182359610,TRX_N-00096-22335558,2020-09-05T11:00:20,Labastida,Basic services,internet,-74.69,4470.4
buyer_8,Antonio,45,ES71209515561182359610,TRX_N-00097-05970245,2020-09-06T09:19:21,Labastida,Basic services,water,-62.75,4407.65
buyer_8,Antonio,45,ES71209515561182359610,TRX_N-00098-74069257,2020-09-06T21:27:21,Labastida,Basic services,electricity,-126.32,4281.33
buyer_8,Antonio,45,ES71209515561182359610,TRX_N-00099-89453116,2020-09-07T23:37:46,Labastida,Basic services,gas,-19.3,4262.03
buyer_8,Antonio,45,ES71209515561182359610,TRX_N-00100-91468695,2020-09-07T15:53:31,Labastida,Basic services,internet,-51.58,4210.45
buyer_8,Antonio,45,ES71209515561182359610,TRX_N-00101-81186556,2020-09-11T17:19:55,Labastida,Expense,transport,-127.64,4082.81
buyer_8,Antonio,45,ES71209515561182359610,TRX_N-00102-28624908,2020-09-14T20:00:59,Labastida,Expense,food,-276.24,3806.57
buyer_8,Antonio,45,ES71209515561182359610,TRX_N-00103-59188127,2020-09-20T13:09:14,Labastida,Expense,food,-645.39,3161.18
buyer_8,Antonio,45,ES71209515561182359610,TRX_N-00104-20697789,2020-10-01T10:51:41,Labastida,transfer,Salary,2009.66,5170.84
buyer_8,Antonio,45,ES71209515561182359610,TRX_N-00105-59565261,2020-10-01T10:51:41,Labastida,transfer,Extra Income,200.97,5371.81
buyer_8,Antonio,45,ES71209515561182359610,TRX_N-00106-70482493,2020-10-03T20:27:30,Labastida,Expense,food,-152.87,5218.94
buyer_8,Antonio,45,ES71209515561182359610,TRX_N-00107-71810192,2020-10-05T19:41:01,Labastida,Housing,Mortgage,-943.56,4275.38
buyer_8,Antonio,45,ES71209515561182359610,TRX_N-00108-29443878,2020-10-06T03:55:35,Labastida,Basic services,water,-31.08,4244.3
buyer_8,Antonio,45,ES71209515561182359610,TRX_N-00109-65809890,2020-10-06T10:28:46,Labastida,Basic services,electricity,-44.02,4200.28
buyer_8,Antonio,45,ES71209515561182359610,TRX_N-00110-14160212,2020-10-07T13:38:30,Labastida,Basic services,phone,-56.53,4143.75
buyer_8,Antonio,45,ES71209515561182359610,TRX_N-00111-90519263,2020-10-08T04:37:27,Arrasate,Expense,clothing,-373.75,3770.0
buyer_8,Antonio,45,ES71209515561182359610,TRX_N-00112-82959035,2020-10-24T11:44:29,Labastida,Expense,gifts,-321.89,3448.11
buyer_8,Antonio,45,ES71209515561182359610,TRX_N-00113-71764757,2020-10-25T16:47:18,Berango,Expense,education,-172.87,3275.24
buyer_8,Antonio,45,ES71209515561182359610,TRX_N-00114-64385586,2020-10-27T14:15:58,Labastida,Expense,food,-117.53,3157.71
buyer_8,Antonio,45,ES71209515561182359610,TRX_N-00115-34026489,2020-11-01T22:54:04,Labastida,transfer,Salary,2009.66,5167.37
buyer_8,Antonio,45,ES71209515561182359610,TRX_N-00116-48168192,2020-11-05T21:46:41,Labastida,Housing,Mortgage,-943.56,4223.81
buyer_8,Antonio,45,ES71209515561182359610,TRX_N-00117-29902276,2020-11-05T09:16:17,Labastida,Basic services,water,-70.25,4153.56
buyer_8,Antonio,45,ES71209515561182359610,TRX_N-00118-81056395,2020-11-05T11:30:26,Labastida,Basic services,internet,-55.55,4098.01
buyer_8,Antonio,45,ES71209515561182359610,TRX_N-00119-04866261,2020-11-05T09:19:01,Labastida,Expense,food,-209.19,3888.82
buyer_8,Antonio,45,ES71209515561182359610,TRX_N-00120-28245689,2020-11-05T10:39:47,Labastida,Expense,clothing,-188.78,3700.04
buyer_8,Antonio,45,ES71209515561182359610,TRX_N-00121-64999657,2020-11-06T16:52:24,Labastida,Basic services,electricity,-67.68,3632.36
buyer_8,Antonio,45,ES71209515561182359610,TRX_N-00122-94249205,2020-11-06T22:59:26,Labastida,Basic services,gas,-24.1,3608.26
buyer_8,Antonio,45,ES71209515561182359610,TRX_N-00123-35255019,2020-11-06T14:04:30,Labastida,Basic services,phone,-95.41,3512.85
buyer_8,Antonio,45,ES71209515561182359610,TRX_N-00124-71035875,2020-11-06T16:04:26,Labastida,Expense,food,-415.06,3097.79
buyer_8,Antonio,45,ES71209515561182359610,TRX_N-00125-10826900,2020-11-07T08:17:11,Labastida,Basic services,water,-21.42,3076.37
buyer_8,Antonio,45,ES71209515561182359610,TRX_N-00126-50866914,2020-11-07T08:01:59,Labastida,Basic services,internet,-65.16,3011.21
buyer_8,Antonio,45,ES71209515561182359610,TRX_N-00127-71060442,2020-11-22T16:51:35,Labastida,Expense,leisure,-193.3,2817.91
buyer_8,Antonio,45,ES71209515561182359610,TRX_N-00128-98791943,2020-11-27T15:05:59,Labastida,Expense,leisure,-161.88,2656.03
buyer_8,Antonio,45,ES71209515561182359610,TRX_N-00129-11945299,2020-12-01T15:18:29,Labastida,transfer,Salary,2009.66,4665.69
buyer_8,Antonio,45,ES71209515561182359610,TRX_N-00130-61054712,2020-12-01T15:18:29,Labastida,transfer,Bonus,2111.91,6777.6
buyer_8,Antonio,45,ES71209515561182359610,TRX_N-00131-38385085,2020-12-05T20:54:03,Labastida,Housing,Mortgage,-943.56,5834.04
buyer_8,Antonio,45,ES71209515561182359610,TRX_N-00132-63493077,2020-12-05T17:49:32,Labastida,Basic services,water,-73.64,5760.4
buyer_8,Antonio,45,ES71209515561182359610,TRX_N-00133-49848582,2020-12-05T09:19:24,Labastida,Basic services,gas,-95.51,5664.89
buyer_8,Antonio,45,ES71209515561182359610,TRX_N-00134-28964046,2020-12-05T15:16:05,Labastida,Basic services,internet,-66.13,5598.76
buyer_8,Antonio,45,ES71209515561182359610,TRX_N-00135-79391926,2020-12-06T08:02:48,Labastida,Basic services,gas,-85.2,5513.56
buyer_8,Antonio,45,ES71209515561182359610,TRX_N-00136-38650952,2020-12-06T18:17:45,Labastida,Basic services,internet,-50.79,5462.77
buyer_8,Antonio,45,ES71209515561182359610,TRX_N-00137-37207277,2020-12-07T11:39:03,Labastida,Basic services,water,-68.06,5394.71
buyer_8,Antonio,45,ES71209515561182359610,TRX_N-00138-93609672,2020-12-07T11:45:37,Labastida,Basic services,phone,-36.08,5358.63
buyer_8,Antonio,45,ES71209515561182359610,TRX_N-00139-35236734,2020-12-17T16:02:18,Labastida,Expense,travel,-1004.61,4354.02
buyer_8,Antonio,45,ES71209515561182359610,TRX_N-00140-79767333,2020-12-18T12:39:51,Labastida,Expense,transport,-107.95,4246.07
buyer_8,Antonio,45,ES71209515561182359610,TRX_N-00141-08190360,2021-01-01T14:38:42,Labastida,transfer,Salary,2009.66,6255.73
buyer_8,Antonio,45,ES71209515561182359610,TRX_N-00142-43801037,2021-01-01T14:38:42,Labastida,transfer,Extra Income,200.97,6456.7
buyer_8,Antonio,45,ES71209515561182359610,TRX_N-00143-87228886,2021-01-05T18:52:41,Labastida,Housing,Mortgage,-943.56,5513.14
buyer_8,Antonio,45,ES71209515561182359610,TRX_N-00144-23447569,2021-01-05T08:19:23,Labastida,Basic services,water,-32.43,5480.71
buyer_8,Antonio,45,ES71209515561182359610,TRX_N-00145-52197487,2021-01-05T18:56:30,Labastida,Basic services,electricity,-127.11,5353.6
buyer_8,Antonio,45,ES71209515561182359610,TRX_N-00146-19271359,2021-01-06T22:36:03,Labastida,Basic services,electricity,-56.7,5296.9
buyer_8,Antonio,45,ES71209515561182359610,TRX_N-00147-78120070,2021-01-07T12:30:19,Labastida,Basic services,electricity,-24.51,5272.39
buyer_8,Antonio,45,ES71209515561182359610,TRX_N-00148-67343999,2021-01-07T09:48:06,Labastida,Basic services,phone,-61.07,5211.32
buyer_8,Antonio,45,ES71209515561182359610,TRX_N-00149-13931839,2021-01-12T00:42:07,Labastida,Expense,food,-525.76,4685.56
buyer_8,Antonio,45,ES71209515561182359610,TRX_N-00150-18406862,2021-01-15T16:13:00,Labastida,Expense,travel,-1814.0,2871.56
buyer_8,Antonio,45,ES71209515561182359610,TRX_N-00151-75949307,2021-01-16T13:04:48,Labastida,Expense,healthcare,-63.01,2808.55
buyer_8,Antonio,45,ES71209515561182359610,TRX_N-00152-01121288,2021-02-01T23:40:16,Labastida,transfer,Salary,2009.66,4818.21
buyer_8,Antonio,45,ES71209515561182359610,TRX_N-00153-51226058,2021-02-02T02:01:10,Donostia,Expense,food,-697.41,4120.8
buyer_8,Antonio,45,ES71209515561182359610,TRX_N-00154-08736883,2021-02-05T15:45:33,Labastida,Housing,Mortgage,-943.56,3177.24
buyer_8,Antonio,45,ES71209515561182359610,TRX_N-00155-37551157,2021-02-06T17:17:13,Labastida,Basic services,electricity,-41.57,3135.67
buyer_8,Antonio,45,ES71209515561182359610,TRX_N-00156-54091232,2021-02-06T10:28:01,Labastida,Basic services,phone,-79.28,3056.39
buyer_8,Antonio,45,ES71209515561182359610,TRX_N-00157-89373424,2021-02-06T23:06:43,Labastida,Expense,repairs,-311.3,2745.09
buyer_8,Antonio,45,ES71209515561182359610,TRX_N-00158-43869974,2021-02-07T19:45:31,Labastida,Basic services,water,-78.45,2666.64
buyer_8,Antonio,45,ES71209515561182359610,TRX_N-00159-20935680,2021-02-07T03:31:25,Labastida,Basic services,internet,-40.22,2626.42
buyer_8,Antonio,45,ES71209515561182359610,TRX_N-00160-21858759,2021-02-08T13:26:13,Labastida,Expense,clothing,-69.55,2556.87
buyer_8,Antonio,45,ES71209515561182359610,TRX_N-00161-83729499,2021-03-01T18:54:08,Labastida,transfer,Salary,2009.66,4566.53
buyer_8,Antonio,45,ES71209515561182359610,TRX_N-00162-54536696,2021-03-01T18:54:08,Labastida,transfer,Extra Income,200.97,4767.5
buyer_8,Antonio,45,ES71209515561182359610,TRX_N-00163-16185627,2021-03-05T15:23:04,Labastida,Housing,Mortgage,-943.56,3823.94
buyer_8,Antonio,45,ES71209515561182359610,TRX_N-00164-44892983,2021-03-05T16:15:49,Labastida,Basic services,water,-62.89,3761.05
buyer_8,Antonio,45,ES71209515561182359610,TRX_N-00165-33706924,2021-03-06T15:54:23,Labastida,Basic services,internet,-50.58,3710.47
buyer_8,Antonio,45,ES71209515561182359610,TRX_N-00166-23000710,2021-03-06T23:30:24,Labastida,Basic services,phone,-58.93,3651.54
buyer_8,Antonio,45,ES71209515561182359610,TRX_N-00167-95631865,2021-03-07T00:01:18,Labastida,Basic services,water,-47.77,3603.77
buyer_8,Antonio,45,ES71209515561182359610,TRX_N-00168-84426595,2021-03-07T18:35:20,Labastida,Basic services,electricity,-37.35,3566.42
buyer_8,Antonio,45,ES71209515561182359610,TRX_N-00169-70586970,2021-03-07T08:30:09,Labastida,Basic services,internet,-47.72,3518.7
buyer_8,Antonio,45,ES71209515561182359610,TRX_N-00170-41643682,2021-03-14T21:05:11,Labastida,Expense,food,-546.04,2972.66
buyer_8,Antonio,45,ES71209515561182359610,TRX_N-00171-00851432,2021-04-01T11:08:11,Labastida,transfer,Salary,2009.66,4982.32
buyer_8,Antonio,45,ES71209515561182359610,TRX_N-00172-43085011,2021-04-03T20:17:05,Alegría-Dulantzi,Expense,transport,-30.06,4952.26
buyer_8,Antonio,45,ES71209515561182359610,TRX_N-00173-44658510,2021-04-04T14:15:34,Labastida,Expense,leisure,-26.83,4925.43
buyer_8,Antonio,45,ES71209515561182359610,TRX_N-00174-78407022,2021-04-05T09:01:42,Labastida,Housing,Mortgage,-943.56,3981.87
buyer_8,Antonio,45,ES71209515561182359610,TRX_N-00175-32194008,2021-04-05T10:25:30,Labastida,Basic services,electricity,-67.69,3914.18
buyer_8,Antonio,45,ES71209515561182359610,TRX_N-00176-07086513,2021-04-05T10:48:45,Labastida,Basic services,internet,-40.57,3873.61
buyer_8,Antonio,45,ES71209515561182359610,TRX_N-00177-72365797,2021-04-05T17:32:29,Labastida,Basic services,phone,-58.23,3815.38
buyer_8,Antonio,45,ES71209515561182359610,TRX_N-00178-46176616,2021-04-06T01:23:56,Labastida,Basic services,water,-50.19,3765.19
buyer_8,Antonio,45,ES71209515561182359610,TRX_N-00179-88271845,2021-04-07T09:15:48,Labastida,Basic services,water,-27.8,3737.39
buyer_8,Antonio,45,ES71209515561182359610,TRX_N-00180-15901011,2021-04-07T13:11:41,Labastida,Basic services,electricity,-105.08,3632.31
buyer_8,Antonio,45,ES71209515561182359610,TRX_N-00181-30346187,2021-04-07T13:27:35,Labastida,Basic services,gas,-88.47,3543.84
buyer_8,Antonio,45,ES71209515561182359610,TRX_N-00182-32990957,2021-04-22T05:06:30,Labastida,Expense,transport,-162.48,3381.36
buyer_8,Antonio,45,ES71209515561182359610,TRX_N-00183-99481316,2021-04-26T20:15:42,Mungia,Expense,transport,-168.14,3213.22
buyer_8,Antonio,45,ES71209515561182359610,TRX_N-00184-20175722,2021-04-30T21:14:16,Vitoria-Gasteiz,Expense,leisure,-238.32,2974.9
buyer_8,Antonio,45,ES71209515561182359610,TRX_N-00185-75144758,2021-05-01T19:17:55,Labastida,transfer,Salary,2009.66,4984.56
buyer_8,Antonio,45,ES71209515561182359610,TRX_N-00186-14894336,2021-05-05T16:46:23,Labastida,Housing,Mortgage,-943.56,4041.0
buyer_8,Antonio,45,ES71209515561182359610,TRX_N-00187-25925007,2021-05-05T13:34:36,Barakaldo,Expense,leisure,-114.84,3926.16
buyer_8,Antonio,45,ES71209515561182359610,TRX_N-00188-69220070,2021-05-06T09:05:34,Labastida,Basic services,gas,-46.79,3879.37
buyer_8,Antonio,45,ES71209515561182359610,TRX_N-00189-74499698,2021-05-07T08:07:48,Labastida,Basic services,water,-75.42,3803.95
buyer_8,Antonio,45,ES71209515561182359610,TRX_N-00190-47801461,2021-05-07T08:05:17,Labastida,Basic services,gas,-37.03,3766.92
buyer_8,Antonio,45,ES71209515561182359610,TRX_N-00191-74685402,2021-05-07T19:42:29,Labastida,Basic services,internet,-70.79,3696.13
buyer_8,Antonio,45,ES71209515561182359610,TRX_N-00192-08228549,2021-05-07T20:00:54,Labastida,Basic services,phone,-72.72,3623.41
buyer_8,Antonio,45,ES71209515561182359610,TRX_N-00193-92450281,2021-05-11T11:17:17,Oyón-Oion,Expense,transport,-112.98,3510.43
buyer_8,Antonio,45,ES71209515561182359610,TRX_N-00194-75473954,2021-05-27T19:04:52,Labastida,Expense,healthcare,-109.8,3400.63
buyer_8,Antonio,45,ES71209515561182359610,TRX_N-00195-88183335,2021-05-28T16:53:07,Labastida,Expense,transport,-198.67,3201.96
buyer_8,Antonio,45,ES71209515561182359610,TRX_N-00196-13621976,2021-06-01T19:58:30,Labastida,transfer,Salary,2009.66,5211.62
buyer_8,Antonio,45,ES71209515561182359610,TRX_N-00197-51012204,2021-06-01T19:58:30,Labastida,transfer,Extra Income,200.97,5412.59
buyer_8,Antonio,45,ES71209515561182359610,TRX_N-00198-38726391,2021-06-01T19:58:30,Labastida,transfer,Bonus,2072.38,7484.97
buyer_8,Antonio,45,ES71209515561182359610,TRX_N-00199-07628511,2021-06-05T05:53:25,Labastida,Housing,Mortgage,-943.56,6541.41
buyer_8,Antonio,45,ES71209515561182359610,TRX_N-00200-62544135,2021-06-06T17:40:52,Labastida,Basic services,electricity,-79.74,6461.67
buyer_8,Antonio,45,ES71209515561182359610,TRX_N-00201-01399881,2021-06-06T16:43:14,Labastida,Basic services,gas,-65.63,6396.04
buyer_8,Antonio,45,ES71209515561182359610,TRX_N-00202-20796818,2021-06-06T10:10:36,Labastida,Basic services,internet,-50.0,6346.04
buyer_8,Antonio,45,ES71209515561182359610,TRX_N-00203-36643723,2021-06-06T20:31:44,Labastida,Expense,clothing,-271.77,6074.27
buyer_8,Antonio,45,ES71209515561182359610,TRX_N-00204-69040554,2021-06-07T15:27:49,Labastida,Basic services,water,-53.79,6020.48
buyer_8,Antonio,45,ES71209515561182359610,TRX_N-00205-80893243,2021-06-07T16:06:18,Labastida,Basic services,electricity,-70.69,5949.79
buyer_8,Antonio,45,ES71209515561182359610,TRX_N-00206-01493981,2021-06-07T19:12:35,Labastida,Basic services,internet,-44.12,5905.67
buyer_8,Antonio,45,ES71209515561182359610,TRX_N-00207-73681682,2021-06-15T11:58:58,Labastida,Expense,transport,-93.99,5811.68
buyer_8,Antonio,45,ES71209515561182359610,TRX_N-00208-02734840,2021-07-01T15:29:06,Labastida,transfer,Salary,2009.66,7821.34
buyer_8,Antonio,45,ES71209515561182359610,TRX_N-00209-67328106,2021-07-05T08:41:52,Labastida,Housing,Mortgage,-943.56,6877.78
buyer_8,Antonio,45,ES71209515561182359610,TRX_N-00210-05193882,2021-07-05T01:12:53,Labastida,Basic services,electricity,-127.7,6750.08
buyer_8,Antonio,45,ES71209515561182359610,TRX_N-00211-25216181,2021-07-05T11:37:28,Labastida,Basic services,gas,-90.29,6659.79
buyer_8,Antonio,45,ES71209515561182359610,TRX_N-00212-24530229,2021-07-07T12:10:06,Labastida,Basic services,water,-73.94,6585.85
buyer_8,Antonio,45,ES71209515561182359610,TRX_N-00213-51417057,2021-07-07T09:48:59,Labastida,Basic services,phone,-50.48,6535.37
buyer_8,Antonio,45,ES71209515561182359610,TRX_N-00214-82762944,2021-07-11T16:46:13,Labastida,Expense,leisure,-260.96,6274.41
buyer_8,Antonio,45,ES71209515561182359610,TRX_N-00215-75126356,2021-07-20T16:39:00,Labastida,Expense,leisure,-42.21,6232.2
buyer_8,Antonio,45,ES71209515561182359610,TRX_N-00216-69145505,2021-07-22T22:14:00,Labastida,Expense,leisure,-292.7,5939.5
buyer_8,Antonio,45,ES71209515561182359610,TRX_N-00217-68210937,2021-07-24T18:38:52,Labastida,Expense,leisure,-176.99,5762.51
buyer_8,Antonio,45,ES71209515561182359610,TRX_N-00218-82368027,2021-08-01T19:24:48,Labastida,transfer,Salary,2009.66,7772.17
buyer_8,Antonio,45,ES71209515561182359610,TRX_N-00219-97748348,2021-08-05T16:11:06,Labastida,Housing,Mortgage,-943.56,6828.61
buyer_8,Antonio,45,ES71209515561182359610,TRX_N-00220-56839659,2021-08-05T17:39:50,Labastida,Basic services,electricity,-147.19,6681.42
buyer_8,Antonio,45,ES71209515561182359610,TRX_N-00221-74535442,2021-08-05T20:56:19,Labastida,Basic services,phone,-95.23,6586.19
buyer_8,Antonio,45,ES71209515561182359610,TRX_N-00222-09602144,2021-08-06T18:52:59,Labastida,Basic services,electricity,-53.24,6532.95
buyer_8,Antonio,45,ES71209515561182359610,TRX_N-00223-98091674,2021-08-07T12:25:01,Labastida,Basic services,water,-44.57,6488.38
buyer_8,Antonio,45,ES71209515561182359610,TRX_N-00224-01336600,2021-08-07T08:30:24,Labastida,Basic services,electricity,-140.36,6348.02
buyer_8,Antonio,45,ES71209515561182359610,TRX_N-00225-47850181,2021-08-10T11:16:09,Labastida,Expense,transport,-94.39,6253.63
buyer_8,Antonio,45,ES71209515561182359610,TRX_N-00226-82953996,2021-08-21T16:29:55,Labastida,Expense,repairs,-705.88,5547.75
buyer_8,Antonio,45,ES71209515561182359610,TRX_N-00227-19360448,2021-08-23T22:19:31,Labastida,Expense,healthcare,-357.28,5190.47
buyer_8,Antonio,45,ES71209515561182359610,TRX_N-00228-68413187,2021-09-01T17:43:58,Labastida,transfer,Salary,2009.66,7200.13
buyer_8,Antonio,45,ES71209515561182359610,TRX_N-00229-71152912,2021-09-01T17:43:58,Labastida,transfer,Extra Income,200.97,7401.1
buyer_8,Antonio,45,ES71209515561182359610,TRX_N-00230-70288135,2021-09-05T18:12:10,Labastida,Housing,Mortgage,-943.56,6457.54
buyer_8,Antonio,45,ES71209515561182359610,TRX_N-00231-74022523,2021-09-05T17:28:48,Labastida,Basic services,gas,-80.96,6376.58
buyer_8,Antonio,45,ES71209515561182359610,TRX_N-00232-88317241,2021-09-05T15:48:40,Labastida,Basic services,internet,-73.4,6303.18
buyer_8,Antonio,45,ES71209515561182359610,TRX_N-00233-30728074,2021-09-05T17:18:04,Labastida,Basic services,phone,-90.75,6212.43
buyer_8,Antonio,45,ES71209515561182359610,TRX_N-00234-19014085,2021-09-06T14:37:32,Labastida,Basic services,electricity,-54.76,6157.67
buyer_8,Antonio,45,ES71209515561182359610,TRX_N-00235-64644200,2021-09-06T14:41:15,Labastida,Basic services,gas,-82.16,6075.51
buyer_8,Antonio,45,ES71209515561182359610,TRX_N-00236-90093248,2021-09-06T18:08:00,Labastida,Basic services,internet,-64.08,6011.43
buyer_8,Antonio,45,ES71209515561182359610,TRX_N-00237-22702939,2021-09-06T14:35:44,Labastida,Basic services,phone,-58.38,5953.05
buyer_8,Antonio,45,ES71209515561182359610,TRX_N-00238-87872047,2021-09-07T11:56:59,Labastida,Basic services,water,-65.84,5887.21
buyer_8,Antonio,45,ES71209515561182359610,TRX_N-00239-74626838,2021-09-07T13:14:34,Labastida,Basic services,gas,-42.37,5844.84
buyer_8,Antonio,45,ES71209515561182359610,TRX_N-00240-37947360,2021-09-07T11:39:28,Labastida,Basic services,internet,-60.08,5784.76
buyer_8,Antonio,45,ES71209515561182359610,TRX_N-00241-21131478,2021-09-07T17:36:47,Labastida,Basic services,phone,-21.02,5763.74
buyer_8,Antonio,45,ES71209515561182359610,TRX_N-00242-89891973,2021-09-20T03:31:50,Labastida,Expense,gifts,-124.12,5639.62
buyer_8,Antonio,45,ES71209515561182359610,TRX_N-00243-40996916,2021-10-01T20:07:39,Labastida,transfer,Salary,2009.66,7649.28
buyer_8,Antonio,45,ES71209515561182359610,TRX_N-00244-52606893,2021-10-05T18:34:23,Labastida,Housing,Mortgage,-943.56,6705.72
buyer_8,Antonio,45,ES71209515561182359610,TRX_N-00245-60906243,2021-10-05T08:03:50,Labastida,Basic services,water,-23.2,6682.52
buyer_8,Antonio,45,ES71209515561182359610,TRX_N-00246-84998871,2021-10-05T14:30:40,Labastida,Basic services,gas,-78.33,6604.19
buyer_8,Antonio,45,ES71209515561182359610,TRX_N-00247-25149817,2021-10-05T07:09:35,Labastida,Basic services,internet,-71.9,6532.29
buyer_8,Antonio,45,ES71209515561182359610,TRX_N-00248-07914217,2021-10-05T10:14:33,Labastida,Basic services,phone,-24.04,6508.25
buyer_8,Antonio,45,ES71209515561182359610,TRX_N-00249-12518023,2021-10-06T18:53:01,Labastida,Basic services,electricity,-49.9,6458.35
buyer_8,Antonio,45,ES71209515561182359610,TRX_N-00250-19711893,2021-10-06T12:40:24,Labastida,Basic services,gas,-30.85,6427.5
buyer_8,Antonio,45,ES71209515561182359610,TRX_N-00251-67976436,2021-10-06T14:24:26,Labastida,Basic services,internet,-57.8,6369.7
buyer_8,Antonio,45,ES71209515561182359610,TRX_N-00252-44891315,2021-10-08T19:35:14,Labastida,Expense,education,-415.95,5953.75
buyer_8,Antonio,45,ES71209515561182359610,TRX_N-00253-26927714,2021-10-15T08:32:49,Labastida,Expense,clothing,-92.84,5860.91
buyer_8,Antonio,45,ES71209515561182359610,TRX_N-00254-56273833,2021-10-28T23:34:15,Basauri,Expense,leisure,-74.02,5786.89
buyer_8,Antonio,45,ES71209515561182359610,TRX_N-00255-19869238,2021-11-01T19:01:36,Labastida,transfer,Salary,2009.66,7796.55
buyer_8,Antonio,45,ES71209515561182359610,TRX_N-00256-25932871,2021-11-05T08:26:51,Labastida,Housing,Mortgage,-943.56,6852.99
buyer_8,Antonio,45,ES71209515561182359610,TRX_N-00257-86402253,2021-11-06T13:34:24,Labastida,Basic services,internet,-44.48,6808.51
buyer_8,Antonio,45,ES71209515561182359610,TRX_N-00258-22301457,2021-11-06T22:05:12,Labastida,Basic services,phone,-35.75,6772.76
buyer_8,Antonio,45,ES71209515561182359610,TRX_N-00259-83544533,2021-11-07T15:52:07,Labastida,Basic services,water,-64.52,6708.24
buyer_8,Antonio,45,ES71209515561182359610,TRX_N-00260-90998525,2021-11-07T19:52:09,Labastida,Basic services,electricity,-96.45,6611.79
buyer_8,Antonio,45,ES71209515561182359610,TRX_N-00261-97966116,2021-11-07T08:01:14,Labastida,Basic services,internet,-51.63,6560.16
buyer_8,Antonio,45,ES71209515561182359610,TRX_N-00262-00835238,2021-11-14T14:08:21,Eibar,Expense,leisure,-211.23,6348.93
buyer_8,Antonio,45,ES71209515561182359610,TRX_N-00263-71891601,2021-12-01T09:28:05,Labastida,transfer,Salary,2009.66,8358.59
buyer_8,Antonio,45,ES71209515561182359610,TRX_N-00264-74694592,2021-12-01T09:28:05,Labastida,transfer,Extra Income,200.97,8559.56
buyer_8,Antonio,45,ES71209515561182359610,TRX_N-00265-68987548,2021-12-01T09:28:05,Labastida,transfer,Bonus,2098.26,10657.82
buyer_8,Antonio,45,ES71209515561182359610,TRX_N-00266-53190409,2021-12-03T19:24:57,Labastida,Expense,gifts,-105.02,10552.8
buyer_8,Antonio,45,ES71209515561182359610,TRX_N-00267-98325219,2021-12-04T18:45:47,Labastida,Expense,appliances,-924.26,9628.54
buyer_8,Antonio,45,ES71209515561182359610,TRX_N-00268-21602925,2021-12-04T17:54:42,Labastida,Expense,gifts,-73.12,9555.42
buyer_8,Antonio,45,ES71209515561182359610,TRX_N-00269-25546918,2021-12-05T21:11:53,Labastida,Housing,Mortgage,-943.56,8611.86
buyer_8,Antonio,45,ES71209515561182359610,TRX_N-00270-94317950,2021-12-05T15:16:17,Labastida,Basic services,water,-19.25,8592.61
buyer_8,Antonio,45,ES71209515561182359610,TRX_N-00271-86568522,2021-12-05T20:10:51,Labastida,Basic services,gas,-80.4,8512.21
buyer_8,Antonio,45,ES71209515561182359610,TRX_N-00272-71967088,2021-12-05T19:42:02,Labastida,Basic services,phone,-73.01,8439.2
buyer_8,Antonio,45,ES71209515561182359610,TRX_N-00273-08688815,2021-12-07T08:36:40,Labastida,Basic services,electricity,-103.61,8335.59
buyer_8,Antonio,45,ES71209515561182359610,TRX_N-00274-26922085,2021-12-10T06:28:58,Labastida,Expense,food,-232.95,8102.64
buyer_8,Antonio,45,ES71209515561182359610,TRX_N-00275-78453647,2021-12-12T16:37:41,Labastida,Expense,food,-266.63,7836.01
buyer_8,Antonio,45,ES71209515561182359610,TRX_N-00276-93750467,2021-12-13T13:57:40,Labastida,Expense,education,-599.65,7236.36
buyer_8,Antonio,45,ES71209515561182359610,TRX_N-00277-53377929,2021-12-22T11:54:14,Alegría-Dulantzi,Expense,food,-104.43,7131.93
buyer_8,Antonio,45,ES71209515561182359610,TRX_N-00278-04224732,2021-12-23T15:12:49,Labastida,Expense,transport,-82.81,7049.12
buyer_8,Antonio,45,ES71209515561182359610,TRX_N-00279-72470942,2021-12-23T10:45:14,Errenteria,Expense,clothing,-317.14,6731.98
buyer_8,Antonio,45,ES71209515561182359610,TRX_N-00280-72773850,2022-01-01T17:40:02,Labastida,transfer,Salary,2009.66,8741.64
buyer_8,Antonio,45,ES71209515561182359610,TRX_N-00281-70837506,2022-01-05T17:00:37,Labastida,Housing,Mortgage,-943.56,7798.08
buyer_8,Antonio,45,ES71209515561182359610,TRX_N-00282-06581721,2022-01-06T10:26:56,Labastida,Basic services,electricity,-101.43,7696.65
buyer_8,Antonio,45,ES71209515561182359610,TRX_N-00283-80505248,2022-01-06T09:56:33,Labastida,Basic services,gas,-98.13,7598.52
buyer_8,Antonio,45,ES71209515561182359610,TRX_N-00284-48157353,2022-01-06T18:39:36,Labastida,Basic services,internet,-66.21,7532.31
buyer_8,Antonio,45,ES71209515561182359610,TRX_N-00285-04362899,2022-01-06T19:57:32,Labastida,Basic services,phone,-36.17,7496.14
buyer_8,Antonio,45,ES71209515561182359610,TRX_N-00286-89185416,2022-01-06T09:43:21,Santurtzi,Expense,transport,-53.01,7443.13
buyer_8,Antonio,45,ES71209515561182359610,TRX_N-00287-82098838,2022-01-07T09:32:26,Labastida,Basic services,water,-28.81,7414.32
buyer_8,Antonio,45,ES71209515561182359610,TRX_N-00288-39998043,2022-01-07T13:52:19,Labastida,Basic services,electricity,-78.83,7335.49
buyer_8,Antonio,45,ES71209515561182359610,TRX_N-00289-04716017,2022-01-07T04:00:02,Labastida,Basic services,internet,-72.14,7263.35
buyer_8,Antonio,45,ES71209515561182359610,TRX_N-00290-00580665,2022-01-07T11:01:46,Labastida,Basic services,phone,-94.06,7169.29
buyer_8,Antonio,45,ES71209515561182359610,TRX_N-00291-49417991,2022-01-11T14:31:07,Labastida,Expense,gifts,-130.88,7038.41
buyer_8,Antonio,45,ES71209515561182359610,TRX_N-00292-40490637,2022-01-12T23:40:29,Errenteria,Expense,transport,-129.62,6908.79
buyer_8,Antonio,45,ES71209515561182359610,TRX_N-00293-94298174,2022-01-18T00:28:47,Labastida,Expense,food,-521.27,6387.52
buyer_8,Antonio,45,ES71209515561182359610,TRX_N-00294-25187902,2022-01-20T12:22:29,Labastida,Expense,transport,-52.47,6335.05
buyer_8,Antonio,45,ES71209515561182359610,TRX_N-00295-52129365,2022-02-01T20:08:03,Labastida,transfer,Salary,2009.66,8344.71
buyer_8,Antonio,45,ES71209515561182359610,TRX_N-00296-29436720,2022-02-03T22:21:02,Labastida,Expense,clothing,-482.68,7862.03
buyer_8,Antonio,45,ES71209515561182359610,TRX_N-00297-03433317,2022-02-05T23:08:46,Labastida,Housing,Mortgage,-943.56,6918.47
buyer_8,Antonio,45,ES71209515561182359610,TRX_N-00298-68458768,2022-02-05T14:43:21,Labastida,Basic services,water,-21.37,6897.1
buyer_8,Antonio,45,ES71209515561182359610,TRX_N-00299-12982816,2022-02-05T12:00:40,Labastida,Basic services,electricity,-30.41,6866.69
buyer_8,Antonio,45,ES71209515561182359610,TRX_N-00300-09379595,2022-02-06T20:31:11,Labastida,Basic services,gas,-77.75,6788.94
buyer_8,Antonio,45,ES71209515561182359610,TRX_N-00301-23881469,2022-02-06T14:57:02,Labastida,Basic services,internet,-78.72,6710.22
buyer_8,Antonio,45,ES71209515561182359610,TRX_N-00302-00219977,2022-02-06T08:09:01,Errenteria,Expense,leisure,-204.95,6505.27
buyer_8,Antonio,45,ES71209515561182359610,TRX_N-00303-48026383,2022-02-07T16:00:01,Labastida,Basic services,phone,-76.53,6428.74
buyer_8,Antonio,45,ES71209515561182359610,TRX_N-00304-24284861,2022-02-08T11:38:03,Labastida,Expense,repairs,-617.55,5811.19
buyer_8,Antonio,45,ES71209515561182359610,TRX_N-00305-02858190,2022-02-16T15:41:47,Labastida,Expense,healthcare,-313.5,5497.69
buyer_8,Antonio,45,ES71209515561182359610,TRX_N-00306-17121108,2022-02-19T09:56:22,Labastida,Expense,clothing,-226.45,5271.24
buyer_8,Antonio,45,ES71209515561182359610,TRX_N-00307-88945569,2022-02-23T17:21:16,Labastida,Expense,clothing,-334.04,4937.2
buyer_8,Antonio,45,ES71209515561182359610,TRX_N-00308-90280500,2022-03-01T07:32:09,Labastida,transfer,Salary,2009.66,6946.86
buyer_8,Antonio,45,ES71209515561182359610,TRX_N-00309-97845365,2022-03-01T07:32:09,Labastida,transfer,Extra Income,200.97,7147.83
buyer_8,Antonio,45,ES71209515561182359610,TRX_N-00310-93187116,2022-03-05T07:01:14,Labastida,Housing,Mortgage,-943.56,6204.27
buyer_8,Antonio,45,ES71209515561182359610,TRX_N-00311-40530501,2022-03-05T09:44:58,Labastida,Basic services,electricity,-91.73,6112.54
buyer_8,Antonio,45,ES71209515561182359610,TRX_N-00312-69196919,2022-03-05T09:57:02,Labastida,Basic services,gas,-58.99,6053.55
buyer_8,Antonio,45,ES71209515561182359610,TRX_N-00313-18421112,2022-03-05T11:02:13,Labastida,Basic services,internet,-62.27,5991.28
buyer_8,Antonio,45,ES71209515561182359610,TRX_N-00314-16691126,2022-03-06T20:56:18,Labastida,Basic services,electricity,-130.65,5860.63
buyer_8,Antonio,45,ES71209515561182359610,TRX_N-00315-40547102,2022-03-06T08:28:17,Labastida,Basic services,gas,-43.29,5817.34
buyer_8,Antonio,45,ES71209515561182359610,TRX_N-00316-44318170,2022-03-08T14:03:24,Labastida,Expense,leisure,-180.73,5636.61
buyer_8,Antonio,45,ES71209515561182359610,TRX_N-00317-28106037,2022-03-15T19:15:25,Labastida,Expense,healthcare,-199.87,5436.74
buyer_8,Antonio,45,ES71209515561182359610,TRX_N-00318-04930578,2022-03-25T08:37:38,Labastida,Expense,food,-649.97,4786.77
buyer_8,Antonio,45,ES71209515561182359610,TRX_N-00319-85187890,2022-04-01T15:58:15,Labastida,transfer,Salary,2009.66,6796.43
buyer_8,Antonio,45,ES71209515561182359610,TRX_N-00320-43151531,2022-04-01T00:36:58,Labastida,Expense,transport,-111.16,6685.27
buyer_8,Antonio,45,ES71209515561182359610,TRX_N-00321-57640120,2022-04-05T03:02:28,Labastida,Housing,Mortgage,-943.56,5741.71
buyer_8,Antonio,45,ES71209515561182359610,TRX_N-00322-11901005,2022-04-05T09:48:04,Labastida,Basic services,electricity,-76.78,5664.93
buyer_8,Antonio,45,ES71209515561182359610,TRX_N-00323-47147625,2022-04-05T16:18:49,Labastida,Basic services,phone,-66.74,5598.19
buyer_8,Antonio,45,ES71209515561182359610,TRX_N-00324-90529231,2022-04-06T08:52:47,Labastida,Basic services,water,-19.37,5578.82
buyer_8,Antonio,45,ES71209515561182359610,TRX_N-00325-44001773,2022-04-06T08:33:10,Labastida,Basic services,gas,-66.93,5511.89
buyer_8,Antonio,45,ES71209515561182359610,TRX_N-00326-25235793,2022-04-06T15:28:02,Labastida,Basic services,phone,-80.5,5431.39
buyer_8,Antonio,45,ES71209515561182359610,TRX_N-00327-52578824,2022-04-07T22:49:05,Labastida,Basic services,electricity,-35.65,5395.74
buyer_8,Antonio,45,ES71209515561182359610,TRX_N-00328-10165755,2022-04-09T23:00:43,Labastida,Expense,clothing,-486.26,4909.48
buyer_8,Antonio,45,ES71209515561182359610,TRX_N-00329-70476654,2022-04-10T06:49:32,Labastida,Expense,gifts,-378.34,4531.14
buyer_8,Antonio,45,ES71209515561182359610,TRX_N-00330-69364955,2022-04-14T14:54:10,Labastida,Expense,clothing,-269.95,4261.19
buyer_8,Antonio,45,ES71209515561182359610,TRX_N-00331-12527894,2022-04-16T12:51:51,Labastida,Expense,healthcare,-96.16,4165.03
buyer_8,Antonio,45,ES71209515561182359610,TRX_N-00332-37085260,2022-04-17T04:03:47,Labastida,Expense,food,-600.85,3564.18
buyer_8,Antonio,45,ES71209515561182359610,TRX_N-00333-38942626,2022-04-19T09:52:56,Labastida,Expense,gifts,-124.74,3439.44
buyer_8,Antonio,45,ES71209515561182359610,TRX_N-00334-38780309,2022-04-24T08:33:39,Labastida,Expense,travel,-1047.62,2391.82
buyer_8,Antonio,45,ES71209515561182359610,TRX_N-00335-92792664,2022-05-01T13:47:41,Labastida,transfer,Salary,2009.66,4401.48
buyer_8,Antonio,45,ES71209515561182359610,TRX_N-00336-14610102,2022-05-05T19:32:17,Labastida,Housing,Mortgage,-943.56,3457.92
buyer_8,Antonio,45,ES71209515561182359610,TRX_N-00337-34071621,2022-05-05T10:42:15,Labastida,Basic services,water,-77.49,3380.43
buyer_8,Antonio,45,ES71209515561182359610,TRX_N-00338-20716185,2022-05-05T14:45:20,Labastida,Basic services,electricity,-36.71,3343.72
buyer_8,Antonio,45,ES71209515561182359610,TRX_N-00339-91836123,2022-05-05T21:57:52,Labastida,Basic services,phone,-27.54,3316.18
buyer_8,Antonio,45,ES71209515561182359610,TRX_N-00340-60050830,2022-05-06T12:25:46,Labastida,Basic services,gas,-91.07,3225.11
buyer_8,Antonio,45,ES71209515561182359610,TRX_N-00341-39995013,2022-05-06T11:23:32,Labastida,Basic services,internet,-39.15,3185.96
buyer_8,Antonio,45,ES71209515561182359610,TRX_N-00342-98102510,2022-05-06T01:06:16,Labastida,Basic services,phone,-22.21,3163.75
buyer_8,Antonio,45,ES71209515561182359610,TRX_N-00343-53955677,2022-05-07T19:31:21,Labastida,Basic services,water,-12.79,3150.96
buyer_8,Antonio,45,ES71209515561182359610,TRX_N-00344-00373471,2022-05-07T20:53:16,Labastida,Basic services,electricity,-104.83,3046.13
buyer_8,Antonio,45,ES71209515561182359610,TRX_N-00345-55267776,2022-05-18T19:58:32,Labastida,Expense,food,-102.8,2943.33
buyer_8,Antonio,45,ES71209515561182359610,TRX_N-00346-45496311,2022-05-29T18:44:43,Labastida,Expense,food,-493.23,2450.1
buyer_8,Antonio,45,ES71209515561182359610,TRX_N-00347-01862733,2022-06-01T13:48:14,Labastida,transfer,Salary,2009.66,4459.76
buyer_8,Antonio,45,ES71209515561182359610,TRX_N-00348-02861093,2022-06-01T13:48:14,Labastida,transfer,Extra Income,200.97,4660.73
buyer_8,Antonio,45,ES71209515561182359610,TRX_N-00349-04703804,2022-06-01T13:48:14,Labastida,transfer,Bonus,2073.83,6734.56
buyer_8,Antonio,45,ES71209515561182359610,TRX_N-00350-11115151,2022-06-05T02:21:15,Labastida,Housing,Mortgage,-943.56,5791.0
buyer_8,Antonio,45,ES71209515561182359610,TRX_N-00351-55571508,2022-06-07T10:15:12,Labastida,Basic services,electricity,-20.7,5770.3
buyer_8,Antonio,45,ES71209515561182359610,TRX_N-00352-14121683,2022-06-20T16:37:55,Santurtzi,Expense,leisure,-167.78,5602.52
buyer_8,Antonio,45,ES71209515561182359610,TRX_N-00353-44215378,2022-06-25T10:04:23,Sopela,Expense,education,-336.3,5266.22
buyer_8,Antonio,45,ES71209515561182359610,TRX_N-00354-71751650,2022-07-01T15:21:12,Labastida,transfer,Salary,2009.66,7275.88
buyer_8,Antonio,45,ES71209515561182359610,TRX_N-00355-94119879,2022-07-01T08:06:27,Labastida,Expense,transport,-142.86,7133.02
buyer_8,Antonio,45,ES71209515561182359610,TRX_N-00356-50725232,2022-07-04T16:52:52,Irun,Expense,healthcare,-390.27,6742.75
buyer_8,Antonio,45,ES71209515561182359610,TRX_N-00357-23716836,2022-07-05T01:43:34,Labastida,Housing,Mortgage,-943.56,5799.19
buyer_8,Antonio,45,ES71209515561182359610,TRX_N-00358-96072692,2022-07-05T09:30:56,Labastida,Basic services,gas,-49.72,5749.47
buyer_8,Antonio,45,ES71209515561182359610,TRX_N-00359-59528815,2022-07-05T08:04:05,Labastida,Basic services,internet,-76.33,5673.14
buyer_8,Antonio,45,ES71209515561182359610,TRX_N-00360-22413514,2022-07-05T13:08:10,Labastida,Basic services,phone,-51.72,5621.42
buyer_8,Antonio,45,ES71209515561182359610,TRX_N-00361-57921631,2022-07-06T23:49:17,Labastida,Basic services,water,-32.8,5588.62
buyer_8,Antonio,45,ES71209515561182359610,TRX_N-00362-73936899,2022-07-06T19:25:01,Labastida,Basic services,phone,-96.97,5491.65
buyer_8,Antonio,45,ES71209515561182359610,TRX_N-00363-12470374,2022-07-07T12:58:20,Labastida,Basic services,electricity,-67.56,5424.09
buyer_8,Antonio,45,ES71209515561182359610,TRX_N-00364-36959668,2022-07-07T20:47:15,Labastida,Expense,food,-787.9,4636.19
buyer_8,Antonio,45,ES71209515561182359610,TRX_N-00365-10760945,2022-07-10T11:00:30,Labastida,Expense,clothing,-203.4,4432.79
buyer_8,Antonio,45,ES71209515561182359610,TRX_N-00366-94149592,2022-07-12T14:04:07,Bermeo,Expense,food,-240.31,4192.48
buyer_8,Antonio,45,ES71209515561182359610,TRX_N-00367-34329922,2022-07-22T18:50:08,Labastida,Expense,food,-156.51,4035.97
buyer_8,Antonio,45,ES71209515561182359610,TRX_N-00368-55095772,2022-08-01T13:05:16,Labastida,transfer,Salary,2009.66,6045.63
buyer_8,Antonio,45,ES71209515561182359610,TRX_N-00369-88134363,2022-08-05T02:16:18,Labastida,Housing,Mortgage,-943.56,5102.07
buyer_8,Antonio,45,ES71209515561182359610,TRX_N-00370-85540488,2022-08-05T13:13:28,Labastida,Basic services,water,-57.19,5044.88
buyer_8,Antonio,45,ES71209515561182359610,TRX_N-00371-67353587,2022-08-05T14:29:11,Labastida,Basic services,gas,-19.45,5025.43
buyer_8,Antonio,45,ES71209515561182359610,TRX_N-00372-52744619,2022-08-05T17:36:44,Labastida,Basic services,phone,-39.82,4985.61
buyer_8,Antonio,45,ES71209515561182359610,TRX_N-00373-55453044,2022-08-06T10:36:05,Labastida,Basic services,phone,-53.44,4932.17
buyer_8,Antonio,45,ES71209515561182359610,TRX_N-00374-77795165,2022-08-07T19:31:23,Labastida,Basic services,phone,-69.53,4862.64
buyer_8,Antonio,45,ES71209515561182359610,TRX_N-00375-28717807,2022-08-20T10:43:35,Labastida,Expense,repairs,-941.91,3920.73
buyer_8,Antonio,45,ES71209515561182359610,TRX_N-00376-89850083,2022-08-26T14:03:39,Labastida,Expense,transport,-58.49,3862.24
buyer_8,Antonio,45,ES71209515561182359610,TRX_N-00377-36761180,2022-09-01T01:27:08,Labastida,transfer,Salary,2009.66,5871.9
buyer_8,Antonio,45,ES71209515561182359610,TRX_N-00378-23767641,2022-09-01T01:27:08,Labastida,transfer,Extra Income,200.97,6072.87
buyer_8,Antonio,45,ES71209515561182359610,TRX_N-00379-21560843,2022-09-05T11:42:15,Labastida,Housing,Mortgage,-943.56,5129.31
buyer_8,Antonio,45,ES71209515561182359610,TRX_N-00380-85366786,2022-09-05T13:53:11,Labastida,Basic services,internet,-44.94,5084.37
buyer_8,Antonio,45,ES71209515561182359610,TRX_N-00381-07982573,2022-09-06T13:19:07,Labastida,Basic services,water,-52.71,5031.66
buyer_8,Antonio,45,ES71209515561182359610,TRX_N-00382-31320974,2022-09-06T11:39:35,Labastida,Basic services,electricity,-85.44,4946.22
buyer_8,Antonio,45,ES71209515561182359610,TRX_N-00383-50353492,2022-09-06T13:00:54,Labastida,Basic services,gas,-33.78,4912.44
buyer_8,Antonio,45,ES71209515561182359610,TRX_N-00384-35601503,2022-09-06T09:53:50,Labastida,Expense,transport,-30.48,4881.96
buyer_8,Antonio,45,ES71209515561182359610,TRX_N-00385-56060254,2022-09-11T03:07:14,Labastida,Expense,transport,-174.69,4707.27
buyer_8,Antonio,45,ES71209515561182359610,TRX_N-00386-44125827,2022-09-14T09:36:09,Labastida,Expense,education,-190.93,4516.34
buyer_8,Antonio,45,ES71209515561182359610,TRX_N-00387-30429553,2022-09-16T13:46:35,Labastida,Expense,transport,-46.76,4469.58
buyer_8,Antonio,45,ES71209515561182359610,TRX_N-00388-18635935,2022-10-01T16:55:53,Labastida,transfer,Salary,2009.66,6479.24
buyer_8,Antonio,45,ES71209515561182359610,TRX_N-00389-85337595,2022-10-02T02:57:51,Labastida,Expense,leisure,-149.17,6330.07
buyer_8,Antonio,45,ES71209515561182359610,TRX_N-00390-07200004,2022-10-05T10:41:48,Labastida,Housing,Mortgage,-943.56,5386.51
buyer_8,Antonio,45,ES71209515561182359610,TRX_N-00391-44998864,2022-10-05T13:58:28,Labastida,Basic services,electricity,-145.16,5241.35
buyer_8,Antonio,45,ES71209515561182359610,TRX_N-00392-55265278,2022-10-06T12:21:10,Labastida,Basic services,electricity,-55.66,5185.69
buyer_8,Antonio,45,ES71209515561182359610,TRX_N-00393-80758571,2022-10-06T10:04:59,Labastida,Basic services,phone,-42.43,5143.26
buyer_8,Antonio,45,ES71209515561182359610,TRX_N-00394-43363489,2022-10-18T18:58:02,Sestao,Expense,clothing,-493.46,4649.8
buyer_8,Antonio,45,ES71209515561182359610,TRX_N-00395-38788688,2022-10-21T14:21:02,Eibar,Expense,clothing,-139.19,4510.61
buyer_8,Antonio,45,ES71209515561182359610,TRX_N-00396-84153443,2022-10-27T04:46:41,Labastida,Expense,clothing,-185.3,4325.31
buyer_8,Antonio,45,ES71209515561182359610,TRX_N-00397-85678765,2022-10-29T11:33:00,Labastida,Expense,transport,-61.13,4264.18
buyer_8,Antonio,45,ES71209515561182359610,TRX_N-00398-37580894,2022-11-01T08:24:46,Labastida,transfer,Salary,2009.66,6273.84
buyer_8,Antonio,45,ES71209515561182359610,TRX_N-00399-33050488,2022-11-02T12:57:36,Labastida,Expense,food,-318.24,5955.6
buyer_8,Antonio,45,ES71209515561182359610,TRX_N-00400-19882728,2022-11-05T08:45:21,Labastida,Housing,Mortgage,-943.56,5012.04
buyer_8,Antonio,45,ES71209515561182359610,TRX_N-00401-93971735,2022-11-05T13:40:19,Labastida,Basic services,electricity,-82.56,4929.48
buyer_8,Antonio,45,ES71209515561182359610,TRX_N-00402-40616036,2022-11-05T16:46:40,Labastida,Basic services,gas,-65.87,4863.61
buyer_8,Antonio,45,ES71209515561182359610,TRX_N-00403-91273039,2022-11-06T18:48:03,Labastida,Basic services,water,-12.52,4851.09
buyer_8,Antonio,45,ES71209515561182359610,TRX_N-00404-25561947,2022-11-07T11:33:07,Labastida,Basic services,water,-20.21,4830.88
buyer_8,Antonio,45,ES71209515561182359610,TRX_N-00405-40408363,2022-11-07T14:06:56,Labastida,Basic services,electricity,-129.8,4701.08
buyer_8,Antonio,45,ES71209515561182359610,TRX_N-00406-77449322,2022-11-11T18:23:53,Labastida,Expense,gifts,-344.16,4356.92
buyer_8,Antonio,45,ES71209515561182359610,TRX_N-00407-74581799,2022-11-14T20:52:27,Labastida,Expense,transport,-152.06,4204.86
buyer_8,Antonio,45,ES71209515561182359610,TRX_N-00408-75520992,2022-11-14T21:44:12,Labastida,Expense,gifts,-191.3,4013.56
buyer_8,Antonio,45,ES71209515561182359610,TRX_N-00409-36636721,2022-11-19T08:33:18,Galdakao,Expense,food,-613.64,3399.92
buyer_8,Antonio,45,ES71209515561182359610,TRX_N-00410-19044311,2022-11-22T19:45:05,Mungia,Expense,leisure,-63.25,3336.67
buyer_8,Antonio,45,ES71209515561182359610,TRX_N-00411-09968861,2022-11-22T15:37:41,Portugalete,Expense,repairs,-106.74,3229.93
buyer_8,Antonio,45,ES71209515561182359610,TRX_N-00412-55224146,2022-12-01T18:24:05,Labastida,transfer,Salary,2009.66,5239.59
buyer_8,Antonio,45,ES71209515561182359610,TRX_N-00413-70055354,2022-12-01T18:24:05,Labastida,transfer,Extra Income,200.97,5440.56
buyer_8,Antonio,45,ES71209515561182359610,TRX_N-00414-15048498,2022-12-01T18:24:05,Labastida,transfer,Bonus,2196.06,7636.62
buyer_8,Antonio,45,ES71209515561182359610,TRX_N-00415-46880679,2022-12-05T12:48:38,Labastida,Housing,Mortgage,-943.56,6693.06
buyer_8,Antonio,45,ES71209515561182359610,TRX_N-00416-91748425,2022-12-05T10:22:52,Labastida,Basic services,water,-39.0,6654.06
buyer_8,Antonio,45,ES71209515561182359610,TRX_N-00417-75610044,2022-12-06T08:43:22,Labastida,Basic services,gas,-83.61,6570.45
buyer_8,Antonio,45,ES71209515561182359610,TRX_N-00418-23612511,2022-12-06T09:48:26,Labastida,Basic services,internet,-35.77,6534.68
buyer_8,Antonio,45,ES71209515561182359610,TRX_N-00419-31367632,2022-12-07T17:48:14,Labastida,Basic services,water,-76.35,6458.33
buyer_8,Antonio,45,ES71209515561182359610,TRX_N-00420-42712982,2022-12-07T09:03:44,Labastida,Basic services,electricity,-53.93,6404.4
buyer_8,Antonio,45,ES71209515561182359610,TRX_N-00421-76715116,2022-12-12T11:59:02,Labastida,Expense,food,-228.32,6176.08
buyer_8,Antonio,45,ES71209515561182359610,TRX_N-00422-91334479,2022-12-31T16:14:51,Labastida,Expense,food,-218.9,5957.18
buyer_8,Antonio,45,ES71209515561182359610,TRX_N-00423-58669953,2023-01-01T08:58:54,Labastida,transfer,Salary,2009.66,7966.84
buyer_8,Antonio,45,ES71209515561182359610,TRX_N-00424-05889595,2023-01-02T14:57:09,Labastida,Expense,clothing,-62.28,7904.56
buyer_8,Antonio,45,ES71209515561182359610,TRX_N-00425-51922745,2023-01-03T13:55:30,Labastida,Expense,food,-240.17,7664.39
buyer_8,Antonio,45,ES71209515561182359610,TRX_N-00426-48902780,2023-01-05T13:42:05,Labastida,Housing,Mortgage,-943.56,6720.83
buyer_8,Antonio,45,ES71209515561182359610,TRX_N-00427-74596157,2023-01-05T04:50:21,Labastida,Basic services,internet,-46.89,6673.94
buyer_8,Antonio,45,ES71209515561182359610,TRX_N-00428-83991147,2023-01-06T12:08:08,Labastida,Basic services,electricity,-43.65,6630.29
buyer_8,Antonio,45,ES71209515561182359610,TRX_N-00429-42112501,2023-01-06T10:40:08,Labastida,Basic services,gas,-70.82,6559.47
buyer_8,Antonio,45,ES71209515561182359610,TRX_N-00430-73840552,2023-01-06T17:35:51,Labastida,Expense,food,-325.02,6234.45
buyer_8,Antonio,45,ES71209515561182359610,TRX_N-00431-45687148,2023-01-07T09:14:37,Labastida,Basic services,internet,-63.52,6170.93
buyer_8,Antonio,45,ES71209515561182359610,TRX_N-00432-22576523,2023-01-10T20:00:44,Labastida,Expense,clothing,-346.39,5824.54
buyer_8,Antonio,45,ES71209515561182359610,TRX_N-00433-66767076,2023-01-25T14:50:04,Labastida,Expense,clothing,-434.15,5390.39
buyer_8,Antonio,45,ES71209515561182359610,TRX_N-00434-94071953,2023-01-28T21:16:31,Labastida,Expense,food,-682.05,4708.34
buyer_8,Antonio,45,ES71209515561182359610,TRX_N-00435-71359330,2023-01-31T14:59:31,Labastida,Expense,education,-180.12,4528.22
buyer_8,Antonio,45,ES71209515561182359610,TRX_N-00436-94771313,2023-02-01T14:58:24,Labastida,transfer,Salary,2009.66,6537.88
buyer_8,Antonio,45,ES71209515561182359610,TRX_N-00437-40773814,2023-02-01T11:34:23,Labastida,Expense,leisure,-177.92,6359.96
buyer_8,Antonio,45,ES71209515561182359610,TRX_N-00438-27241539,2023-02-02T22:28:35,Labastida,Expense,food,-134.09,6225.87
buyer_8,Antonio,45,ES71209515561182359610,TRX_N-00439-69075441,2023-02-05T11:38:39,Labastida,Housing,Mortgage,-943.56,5282.31
buyer_8,Antonio,45,ES71209515561182359610,TRX_N-00440-57266009,2023-02-05T09:02:39,Labastida,Basic services,gas,-51.61,5230.7
buyer_8,Antonio,45,ES71209515561182359610,TRX_N-00441-43411649,2023-02-06T20:47:20,Labastida,Basic services,electricity,-141.54,5089.16
buyer_8,Antonio,45,ES71209515561182359610,TRX_N-00442-46111112,2023-02-07T14:07:32,Labastida,Basic services,water,-14.8,5074.36
buyer_8,Antonio,45,ES71209515561182359610,TRX_N-00443-45224394,2023-02-07T11:12:33,Labastida,Basic services,electricity,-20.02,5054.34
buyer_8,Antonio,45,ES71209515561182359610,TRX_N-00444-95328894,2023-02-07T12:46:50,Labastida,Basic services,gas,-26.42,5027.92
buyer_8,Antonio,45,ES71209515561182359610,TRX_N-00445-32327385,2023-02-07T08:47:48,Labastida,Basic services,internet,-72.89,4955.03
buyer_8,Antonio,45,ES71209515561182359610,TRX_N-00446-84954748,2023-03-01T20:03:19,Labastida,transfer,Salary,2009.66,6964.69
buyer_8,Antonio,45,ES71209515561182359610,TRX_N-00447-83776666,2023-03-01T20:03:19,Labastida,transfer,Extra Income,200.97,7165.66
buyer_8,Antonio,45,ES71209515561182359610,TRX_N-00448-20601370,2023-03-04T13:07:14,Hernani,Expense,healthcare,-27.66,7138.0
buyer_8,Antonio,45,ES71209515561182359610,TRX_N-00449-47474937,2023-03-05T17:08:16,Labastida,Housing,Mortgage,-943.56,6194.44
buyer_8,Antonio,45,ES71209515561182359610,TRX_N-00450-00289413,2023-03-05T15:04:08,Labastida,Basic services,phone,-97.54,6096.9
buyer_8,Antonio,45,ES71209515561182359610,TRX_N-00451-74147051,2023-03-06T10:06:45,Labastida,Basic services,gas,-51.13,6045.77
buyer_8,Antonio,45,ES71209515561182359610,TRX_N-00452-08918306,2023-03-07T19:32:21,Labastida,Basic services,water,-16.36,6029.41
buyer_8,Antonio,45,ES71209515561182359610,TRX_N-00453-27070789,2023-03-07T10:22:43,Labastida,Basic services,electricity,-121.59,5907.82
buyer_8,Antonio,45,ES71209515561182359610,TRX_N-00454-00253250,2023-03-10T19:54:17,Labastida,Expense,food,-134.49,5773.33
buyer_8,Antonio,45,ES71209515561182359610,TRX_N-00455-18998287,2023-03-26T08:01:35,Elciego,Expense,clothing,-111.52,5661.81
buyer_8,Antonio,45,ES71209515561182359610,TRX_N-00456-48406298,2023-04-01T06:46:10,Labastida,transfer,Salary,2009.66,7671.47
buyer_8,Antonio,45,ES71209515561182359610,TRX_N-00457-72050286,2023-04-01T13:33:07,Basauri,Expense,food,-766.91,6904.56
buyer_8,Antonio,45,ES71209515561182359610,TRX_N-00458-53143471,2023-04-03T16:03:45,Labastida,Expense,healthcare,-189.85,6714.71
buyer_8,Antonio,45,ES71209515561182359610,TRX_N-00459-57993375,2023-04-05T13:51:41,Labastida,Housing,Mortgage,-943.56,5771.15
buyer_8,Antonio,45,ES71209515561182359610,TRX_N-00460-36350924,2023-04-05T19:20:26,Labastida,Basic services,internet,-69.14,5702.01
buyer_8,Antonio,45,ES71209515561182359610,TRX_N-00461-72881112,2023-04-06T13:57:54,Labastida,Basic services,electricity,-117.7,5584.31
buyer_8,Antonio,45,ES71209515561182359610,TRX_N-00462-19174077,2023-04-06T22:26:04,Labastida,Basic services,internet,-70.49,5513.82
buyer_8,Antonio,45,ES71209515561182359610,TRX_N-00463-91364527,2023-04-07T19:43:40,Labastida,Basic services,electricity,-92.01,5421.81
buyer_8,Antonio,45,ES71209515561182359610,TRX_N-00464-58363695,2023-04-07T19:25:47,Labastida,Basic services,internet,-74.9,5346.91
buyer_8,Antonio,45,ES71209515561182359610,TRX_N-00465-20672813,2023-04-10T12:32:04,Labastida,Expense,clothing,-324.22,5022.69
buyer_8,Antonio,45,ES71209515561182359610,TRX_N-00466-81621809,2023-04-14T17:50:41,Labastida,Expense,clothing,-302.0,4720.69
buyer_8,Antonio,45,ES71209515561182359610,TRX_N-00467-78015015,2023-04-16T11:00:47,Labastida,Expense,repairs,-607.77,4112.92
buyer_8,Antonio,45,ES71209515561182359610,TRX_N-00468-13282262,2023-04-27T17:13:28,Labastida,Expense,travel,-2437.37,1675.55
buyer_8,Antonio,45,ES71209515561182359610,TRX_N-00469-17086935,2023-05-01T09:22:43,Labastida,transfer,Salary,2009.66,3685.21
buyer_8,Antonio,45,ES71209515561182359610,TRX_N-00470-51976158,2023-05-01T09:22:43,Labastida,transfer,Extra Income,200.97,3886.18
buyer_8,Antonio,45,ES71209515561182359610,TRX_N-00471-02693481,2023-05-05T12:15:24,Labastida,Housing,Mortgage,-943.56,2942.62
buyer_8,Antonio,45,ES71209515561182359610,TRX_N-00472-50240641,2023-05-05T13:26:04,Labastida,Basic services,gas,-21.5,2921.12
buyer_8,Antonio,45,ES71209515561182359610,TRX_N-00473-39174974,2023-05-05T17:01:40,Labastida,Basic services,phone,-73.61,2847.51
buyer_8,Antonio,45,ES71209515561182359610,TRX_N-00474-19872086,2023-05-05T10:45:03,Labastida,Expense,education,-760.99,2086.52
buyer_8,Antonio,45,ES71209515561182359610,TRX_N-00475-51044511,2023-05-05T18:53:14,Labastida,Expense,appliances,-155.72,1930.8
buyer_8,Antonio,45,ES71209515561182359610,TRX_N-00476-97164918,2023-05-06T14:44:33,Labastida,Basic services,water,-14.1,1916.7
buyer_8,Antonio,45,ES71209515561182359610,TRX_N-00477-10096029,2023-05-06T18:51:43,Labastida,Basic services,electricity,-114.42,1802.28
buyer_8,Antonio,45,ES71209515561182359610,TRX_N-00478-37208745,2023-05-06T18:18:51,Labastida,Expense,transport,-108.35,1693.93
buyer_8,Antonio,45,ES71209515561182359610,TRX_N-00479-39168027,2023-05-07T19:08:34,Labastida,Basic services,phone,-20.26,1673.67
buyer_8,Antonio,45,ES71209515561182359610,TRX_N-00480-56789226,2023-05-08T15:42:15,Labastida,Expense,clothing,-67.3,1606.37
buyer_8,Antonio,45,ES71209515561182359610,TRX_N-00481-07470294,2023-05-10T20:02:32,Labastida,Expense,leisure,-257.3,1349.07
buyer_8,Antonio,45,ES71209515561182359610,TRX_N-00482-72530833,2023-05-18T19:12:40,Bermeo,Expense,healthcare,-354.68,994.39
buyer_8,Antonio,45,ES71209515561182359610,TRX_N-00483-97965482,2023-05-20T19:25:52,Labastida,Expense,transport,-75.98,918.41
buyer_8,Antonio,45,ES71209515561182359610,TRX_N-00484-15737695,2023-05-21T05:50:57,Labastida,Expense,leisure,-173.74,744.67
buyer_8,Antonio,45,ES71209515561182359610,TRX_N-00485-09731220,2023-05-27T09:58:58,Labastida,Expense,healthcare,-360.47,384.2
buyer_8,Antonio,45,ES71209515561182359610,TRX_N-00486-17287127,2023-06-01T14:30:21,Labastida,transfer,Salary,2009.66,2393.86
buyer_8,Antonio,45,ES71209515561182359610,TRX_N-00487-88006614,2023-06-01T14:30:21,Labastida,transfer,Bonus,1992.58,4386.44
buyer_8,Antonio,45,ES71209515561182359610,TRX_N-00488-93775328,2023-06-03T20:43:36,Labastida,Expense,leisure,-110.18,4276.26
buyer_8,Antonio,45,ES71209515561182359610,TRX_N-00489-87883622,2023-06-05T17:00:00,Labastida,Housing,Mortgage,-943.56,3332.7
buyer_8,Antonio,45,ES71209515561182359610,TRX_N-00490-84789981,2023-06-05T03:41:55,Labastida,Basic services,gas,-92.16,3240.54
buyer_8,Antonio,45,ES71209515561182359610,TRX_N-00491-86609992,2023-06-05T10:52:38,Labastida,Basic services,internet,-66.87,3173.67
buyer_8,Antonio,45,ES71209515561182359610,TRX_N-00492-62154173,2023-06-06T12:35:56,Labastida,Basic services,internet,-75.52,3098.15
buyer_8,Antonio,45,ES71209515561182359610,TRX_N-00493-16579865,2023-06-07T17:03:55,Labastida,Basic services,internet,-40.54,3057.61
buyer_8,Antonio,45,ES71209515561182359610,TRX_N-00494-90652314,2023-06-07T20:59:51,Labastida,Basic services,phone,-37.14,3020.47
buyer_8,Antonio,45,ES71209515561182359610,TRX_N-00495-73576673,2023-06-09T13:37:51,Labastida,Expense,leisure,-274.18,2746.29
buyer_8,Antonio,45,ES71209515561182359610,TRX_N-00496-04585218,2023-06-18T12:03:23,Labastida,Expense,repairs,-201.94,2544.35
buyer_8,Antonio,45,ES71209515561182359610,TRX_N-00497-62462893,2023-06-19T11:36:57,Labastida,Expense,healthcare,-332.93,2211.42
buyer_8,Antonio,45,ES71209515561182359610,TRX_N-00498-13036729,2023-06-20T19:10:38,Getxo,Expense,food,-610.98,1600.44
buyer_8,Antonio,45,ES71209515561182359610,TRX_N-00499-19587844,2023-06-24T06:56:25,Labastida,Expense,transport,-113.92,1486.52
buyer_8,Antonio,45,ES71209515561182359610,TRX_N-00500-28571842,2023-07-01T04:13:11,Labastida,transfer,Salary,2009.66,3496.18
buyer_8,Antonio,45,ES71209515561182359610,TRX_N-00501-94729307,2023-07-01T04:13:11,Labastida,transfer,Extra Income,200.97,3697.15
buyer_8,Antonio,45,ES71209515561182359610,TRX_N-00502-03736401,2023-07-01T11:22:22,Labastida,Expense,leisure,-184.36,3512.79
buyer_8,Antonio,45,ES71209515561182359610,TRX_N-00503-70947355,2023-07-05T09:11:51,Labastida,Housing,Mortgage,-943.56,2569.23
buyer_8,Antonio,45,ES71209515561182359610,TRX_N-00504-56881911,2023-07-05T15:44:56,Labastida,Basic services,water,-34.54,2534.69
buyer_8,Antonio,45,ES71209515561182359610,TRX_N-00505-83375893,2023-07-05T20:27:13,Labastida,Basic services,internet,-55.65,2479.04
buyer_8,Antonio,45,ES71209515561182359610,TRX_N-00506-90458354,2023-07-06T09:58:38,Labastida,Basic services,water,-77.56,2401.48
buyer_8,Antonio,45,ES71209515561182359610,TRX_N-00507-34819339,2023-07-06T15:23:46,Labastida,Basic services,gas,-74.57,2326.91
buyer_8,Antonio,45,ES71209515561182359610,TRX_N-00508-35078760,2023-07-07T06:57:03,Labastida,Basic services,water,-23.69,2303.22
buyer_8,Antonio,45,ES71209515561182359610,TRX_N-00509-09513943,2023-07-07T22:31:27,Labastida,Basic services,internet,-48.68,2254.54
buyer_8,Antonio,45,ES71209515561182359610,TRX_N-00510-05511474,2023-07-23T08:29:22,Labastida,Expense,transport,-28.79,2225.75
buyer_8,Antonio,45,ES71209515561182359610,TRX_N-00511-07931158,2023-07-28T17:36:39,Sestao,Expense,food,-522.58,1703.17
buyer_8,Antonio,45,ES71209515561182359610,TRX_N-00512-69538662,2023-07-29T15:24:50,Salvatierra/Agurain,Expense,gifts,-176.48,1526.69
buyer_8,Antonio,45,ES71209515561182359610,TRX_N-00513-82491451,2023-08-01T10:51:28,Labastida,transfer,Salary,2009.66,3536.35
buyer_8,Antonio,45,ES71209515561182359610,TRX_N-00514-59604148,2023-08-05T18:28:47,Labastida,Housing,Mortgage,-943.56,2592.79
buyer_8,Antonio,45,ES71209515561182359610,TRX_N-00515-58678251,2023-08-05T14:42:11,Labastida,Basic services,internet,-65.33,2527.46
buyer_8,Antonio,45,ES71209515561182359610,TRX_N-00516-48135988,2023-08-05T18:42:15,Labastida,Expense,leisure,-24.52,2502.94
buyer_8,Antonio,45,ES71209515561182359610,TRX_N-00517-82594258,2023-08-06T20:47:35,Labastida,Basic services,water,-51.33,2451.61
buyer_8,Antonio,45,ES71209515561182359610,TRX_N-00518-84977044,2023-08-07T12:52:37,Labastida,Basic services,gas,-16.82,2434.79
buyer_8,Antonio,45,ES71209515561182359610,TRX_N-00519-56271694,2023-08-18T10:45:51,Labastida,Expense,food,-158.25,2276.54
buyer_8,Antonio,45,ES71209515561182359610,TRX_N-00520-64189766,2023-08-23T11:36:53,Labastida,Expense,food,-251.47,2025.07
buyer_8,Antonio,45,ES71209515561182359610,TRX_N-00521-30762500,2023-08-30T08:29:21,Labastida,Expense,food,-406.36,1618.71
buyer_8,Antonio,45,ES71209515561182359610,TRX_N-00522-06519016,2023-09-01T11:50:44,Labastida,transfer,Salary,2009.66,3628.37
buyer_8,Antonio,45,ES71209515561182359610,TRX_N-00523-20495841,2023-09-05T16:19:55,Labastida,Housing,Mortgage,-943.56,2684.81
buyer_8,Antonio,45,ES71209515561182359610,TRX_N-00524-46529154,2023-09-05T18:09:33,Labastida,Basic services,water,-76.0,2608.81
buyer_8,Antonio,45,ES71209515561182359610,TRX_N-00525-17637899,2023-09-05T19:26:15,Labastida,Basic services,internet,-69.89,2538.92
buyer_8,Antonio,45,ES71209515561182359610,TRX_N-00526-37456744,2023-09-06T10:08:22,Labastida,Basic services,electricity,-20.42,2518.5
buyer_8,Antonio,45,ES71209515561182359610,TRX_N-00527-27539484,2023-09-06T16:40:21,Labastida,Basic services,gas,-62.77,2455.73
buyer_8,Antonio,45,ES71209515561182359610,TRX_N-00528-27134279,2023-09-06T03:25:48,Labastida,Basic services,internet,-75.94,2379.79
buyer_8,Antonio,45,ES71209515561182359610,TRX_N-00529-77624686,2023-09-06T15:21:17,Salvatierra/Agurain,Expense,healthcare,-156.14,2223.65
buyer_8,Antonio,45,ES71209515561182359610,TRX_N-00530-73990714,2023-09-07T18:42:55,Labastida,Basic services,water,-43.46,2180.19
buyer_8,Antonio,45,ES71209515561182359610,TRX_N-00531-47080969,2023-09-07T00:32:22,Labastida,Basic services,gas,-96.75,2083.44
buyer_8,Antonio,45,ES71209515561182359610,TRX_N-00532-14021235,2023-09-07T13:43:37,Labastida,Basic services,phone,-73.77,2009.67
buyer_8,Antonio,45,ES71209515561182359610,TRX_N-00533-10371825,2023-09-20T19:02:07,Labastida,Expense,healthcare,-48.61,1961.06
buyer_8,Antonio,45,ES71209515561182359610,TRX_N-00534-31867995,2023-09-23T10:38:17,Hernani,Expense,clothing,-90.63,1870.43
buyer_8,Antonio,45,ES71209515561182359610,TRX_N-00535-88602242,2023-10-01T13:50:37,Labastida,transfer,Salary,2009.66,3880.09
buyer_8,Antonio,45,ES71209515561182359610,TRX_N-00536-43191359,2023-10-01T13:50:37,Labastida,transfer,Extra Income,200.97,4081.06
buyer_8,Antonio,45,ES71209515561182359610,TRX_N-00537-83571855,2023-10-04T16:15:15,Labastida,Expense,healthcare,-288.45,3792.61
buyer_8,Antonio,45,ES71209515561182359610,TRX_N-00538-28885656,2023-10-05T22:40:53,Labastida,Housing,Mortgage,-943.56,2849.05
buyer_8,Antonio,45,ES71209515561182359610,TRX_N-00539-69924671,2023-10-05T11:01:21,Labastida,Basic services,water,-24.28,2824.77
buyer_8,Antonio,45,ES71209515561182359610,TRX_N-00540-14622889,2023-10-05T14:12:02,Labastida,Expense,education,-898.66,1926.11
buyer_8,Antonio,45,ES71209515561182359610,TRX_N-00541-57065469,2023-10-06T06:47:06,Labastida,Basic services,water,-49.99,1876.12
buyer_8,Antonio,45,ES71209515561182359610,TRX_N-00542-34620532,2023-10-09T21:36:06,Labastida,Expense,transport,-99.13,1776.99
buyer_8,Antonio,45,ES71209515561182359610,TRX_N-00543-55937713,2023-10-16T02:30:19,Labastida,Expense,food,-677.53,1099.46
buyer_8,Antonio,45,ES71209515561182359610,TRX_N-00544-50947268,2023-10-20T19:54:47,Labastida,Expense,food,-450.94,648.52
buyer_8,Antonio,45,ES71209515561182359610,TRX_N-00545-60215573,2023-11-01T11:23:34,Labastida,transfer,Salary,2009.66,2658.18
buyer_8,Antonio,45,ES71209515561182359610,TRX_N-00546-11314677,2023-11-05T23:11:53,Labastida,Housing,Mortgage,-943.56,1714.62
buyer_8,Antonio,45,ES71209515561182359610,TRX_N-00547-64378138,2023-11-05T16:58:23,Labastida,Basic services,electricity,-54.74,1659.88
buyer_8,Antonio,45,ES71209515561182359610,TRX_N-00548-31334386,2023-11-05T10:01:44,Labastida,Basic services,gas,-57.71,1602.17
buyer_8,Antonio,45,ES71209515561182359610,TRX_N-00549-79316122,2023-11-05T10:49:13,Labastida,Basic services,internet,-32.07,1570.1
buyer_8,Antonio,45,ES71209515561182359610,TRX_N-00550-73713977,2023-11-07T03:22:49,Labastida,Basic services,gas,-76.12,1493.98
buyer_8,Antonio,45,ES71209515561182359610,TRX_N-00551-30967618,2023-11-09T13:19:39,Labastida,Expense,food,-112.59,1381.39
buyer_8,Antonio,45,ES71209515561182359610,TRX_N-00552-15000461,2023-11-12T15:17:54,Leioa,Expense,leisure,-78.95,1302.44
buyer_8,Antonio,45,ES71209515561182359610,TRX_N-00553-33029386,2023-11-24T18:54:59,Labastida,Expense,food,-605.84,696.6
buyer_8,Antonio,45,ES71209515561182359610,TRX_N-00554-63691483,2023-11-28T19:49:40,Labastida,Expense,repairs,-406.36,290.24
buyer_8,Antonio,45,ES71209515561182359610,TRX_N-00555-94714151,2023-12-01T08:55:57,Labastida,transfer,Salary,2009.66,2299.9
buyer_8,Antonio,45,ES71209515561182359610,TRX_N-00556-49427910,2023-12-01T08:55:57,Labastida,transfer,Bonus,2209.45,4509.35
buyer_8,Antonio,45,ES71209515561182359610,TRX_N-00557-61776029,2023-12-01T22:08:15,Labastida,Expense,food,-312.86,4196.49
buyer_8,Antonio,45,ES71209515561182359610,TRX_N-00558-75482958,2023-12-04T18:16:32,Labastida,Expense,transport,-181.52,4014.97
buyer_8,Antonio,45,ES71209515561182359610,TRX_N-00559-06703039,2023-12-05T10:43:41,Labastida,Housing,Mortgage,-943.56,3071.41
buyer_8,Antonio,45,ES71209515561182359610,TRX_N-00560-22867975,2023-12-05T14:22:16,Labastida,Basic services,water,-34.24,3037.17
buyer_8,Antonio,45,ES71209515561182359610,TRX_N-00561-32601318,2023-12-05T09:51:58,Labastida,Basic services,electricity,-140.6,2896.57
buyer_8,Antonio,45,ES71209515561182359610,TRX_N-00562-59709928,2023-12-06T19:20:25,Labastida,Basic services,water,-15.94,2880.63
buyer_8,Antonio,45,ES71209515561182359610,TRX_N-00563-69494563,2023-12-06T20:58:05,Labastida,Basic services,phone,-96.11,2784.52
buyer_8,Antonio,45,ES71209515561182359610,TRX_N-00564-95438564,2023-12-07T18:11:33,Labastida,Basic services,gas,-35.03,2749.49
buyer_8,Antonio,45,ES71209515561182359610,TRX_N-00565-70612175,2023-12-14T20:24:11,Labastida,Expense,food,-629.41,2120.08
buyer_8,Antonio,45,ES71209515561182359610,TRX_N-00566-15992717,2023-12-30T15:59:29,Labastida,Expense,leisure,-114.93,2005.15
buyer_8,Antonio,45,ES71209515561182359610,TRX_N-00567-21447916,2024-01-01T13:12:54,Labastida,transfer,Salary,2009.66,4014.81
buyer_8,Antonio,45,ES71209515561182359610,TRX_N-00568-97400494,2024-01-01T13:12:54,Labastida,transfer,Extra Income,200.97,4215.78
buyer_8,Antonio,45,ES71209515561182359610,TRX_N-00569-54402735,2024-01-02T08:40:02,Labastida,Expense,food,-671.78,3544.0
buyer_8,Antonio,45,ES71209515561182359610,TRX_N-00570-71950510,2024-01-05T10:14:14,Labastida,Housing,Mortgage,-943.56,2600.44
buyer_8,Antonio,45,ES71209515561182359610,TRX_N-00571-12124721,2024-01-05T12:23:00,Labastida,Basic services,water,-68.41,2532.03
buyer_8,Antonio,45,ES71209515561182359610,TRX_N-00572-60387040,2024-01-05T09:44:25,Labastida,Basic services,gas,-16.18,2515.85
buyer_8,Antonio,45,ES71209515561182359610,TRX_N-00573-74493610,2024-01-07T17:37:11,Labastida,Basic services,gas,-29.0,2486.85
buyer_8,Antonio,45,ES71209515561182359610,TRX_N-00574-60329597,2024-01-07T08:36:18,Labastida,Basic services,phone,-57.47,2429.38
buyer_8,Antonio,45,ES71209515561182359610,TRX_N-00575-96880107,2024-02-01T14:04:16,Labastida,transfer,Salary,2009.66,4439.04
buyer_8,Antonio,45,ES71209515561182359610,TRX_N-00576-09331781,2024-02-01T19:15:06,Basauri,Expense,healthcare,-323.4,4115.64
buyer_8,Antonio,45,ES71209515561182359610,TRX_N-00577-86221437,2024-02-05T11:00:04,Labastida,Housing,Mortgage,-943.56,3172.08
buyer_8,Antonio,45,ES71209515561182359610,TRX_N-00578-26252513,2024-02-05T16:49:31,Labastida,Basic services,water,-78.28,3093.8
buyer_8,Antonio,45,ES71209515561182359610,TRX_N-00579-53910622,2024-02-05T16:39:39,Labastida,Basic services,electricity,-44.44,3049.36
buyer_8,Antonio,45,ES71209515561182359610,TRX_N-00580-85544793,2024-02-05T14:13:03,Labastida,Basic services,gas,-89.96,2959.4
buyer_8,Antonio,45,ES71209515561182359610,TRX_N-00581-95893510,2024-02-06T12:54:30,Labastida,Basic services,gas,-96.87,2862.53
buyer_8,Antonio,45,ES71209515561182359610,TRX_N-00582-38146398,2024-02-06T20:06:41,Labastida,Basic services,internet,-54.32,2808.21
buyer_8,Antonio,45,ES71209515561182359610,TRX_N-00583-52493553,2024-02-07T10:03:50,Labastida,Basic services,electricity,-102.82,2705.39
buyer_8,Antonio,45,ES71209515561182359610,TRX_N-00584-33651218,2024-02-07T20:26:26,Labastida,Basic services,gas,-59.81,2645.58
buyer_8,Antonio,45,ES71209515561182359610,TRX_N-00585-11379423,2024-02-07T22:39:56,Labastida,Basic services,internet,-74.08,2571.5
buyer_8,Antonio,45,ES71209515561182359610,TRX_N-00586-48320645,2024-02-07T20:27:44,Labastida,Expense,transport,-87.46,2484.04
buyer_8,Antonio,45,ES71209515561182359610,TRX_N-00587-09377427,2024-02-16T18:54:30,Labastida,Expense,education,-369.25,2114.79
buyer_8,Antonio,45,ES71209515561182359610,TRX_N-00588-81116284,2024-02-20T08:21:31,Labastida,Expense,clothing,-316.07,1798.72
buyer_8,Antonio,45,ES71209515561182359610,TRX_N-00589-98899780,2024-02-23T18:27:06,Bermeo,Expense,healthcare,-138.43,1660.29
buyer_8,Antonio,45,ES71209515561182359610,TRX_N-00590-20954833,2024-03-01T15:31:12,Labastida,transfer,Salary,2009.66,3669.95
buyer_8,Antonio,45,ES71209515561182359610,TRX_N-00591-20300363,2024-03-05T12:35:50,Labastida,Housing,Mortgage,-943.56,2726.39
buyer_8,Antonio,45,ES71209515561182359610,TRX_N-00592-52664563,2024-03-05T12:10:15,Labastida,Basic services,gas,-60.75,2665.64
buyer_8,Antonio,45,ES71209515561182359610,TRX_N-00593-55997703,2024-03-05T22:41:13,Labastida,Basic services,phone,-51.69,2613.95
buyer_8,Antonio,45,ES71209515561182359610,TRX_N-00594-68781921,2024-03-06T13:51:57,Labastida,Basic services,electricity,-81.35,2532.6
buyer_8,Antonio,45,ES71209515561182359610,TRX_N-00595-34503070,2024-03-06T16:58:23,Labastida,Basic services,gas,-82.75,2449.85
buyer_8,Antonio,45,ES71209515561182359610,TRX_N-00596-37228615,2024-03-07T02:26:27,Labastida,Basic services,internet,-31.39,2418.46
buyer_8,Antonio,45,ES71209515561182359610,TRX_N-00597-26203516,2024-03-07T21:21:37,Labastida,Basic services,phone,-92.13,2326.33
buyer_8,Antonio,45,ES71209515561182359610,TRX_N-00598-96928706,2024-03-17T21:43:36,Labastida,Expense,transport,-30.83,2295.5
buyer_8,Antonio,45,ES71209515561182359610,TRX_N-00599-90625816,2024-04-01T04:38:34,Labastida,transfer,Salary,2009.66,4305.16
buyer_8,Antonio,45,ES71209515561182359610,TRX_N-00600-21163019,2024-04-01T04:38:34,Labastida,transfer,Extra Income,200.97,4506.13
buyer_8,Antonio,45,ES71209515561182359610,TRX_N-00601-20975643,2024-04-05T11:16:04,Labastida,Housing,Mortgage,-943.56,3562.57
buyer_8,Antonio,45,ES71209515561182359610,TRX_N-00602-07900340,2024-04-05T10:25:01,Labastida,Basic services,electricity,-130.46,3432.11
buyer_8,Antonio,45,ES71209515561182359610,TRX_N-00603-41345055,2024-04-05T08:45:29,Labastida,Basic services,internet,-73.28,3358.83
buyer_8,Antonio,45,ES71209515561182359610,TRX_N-00604-79281642,2024-04-06T15:57:01,Labastida,Basic services,gas,-68.81,3290.02
buyer_8,Antonio,45,ES71209515561182359610,TRX_N-00605-17142606,2024-04-06T20:47:59,Labastida,Expense,gifts,-363.11,2926.91
buyer_8,Antonio,45,ES71209515561182359610,TRX_N-00606-35433132,2024-04-07T18:07:02,Labastida,Basic services,internet,-66.93,2859.98
buyer_8,Antonio,45,ES71209515561182359610,TRX_N-00607-19857265,2024-04-27T10:23:45,Labastida,Expense,transport,-121.68,2738.3
buyer_8,Antonio,45,ES71209515561182359610,TRX_N-00608-27323658,2024-04-27T11:35:44,Labastida,Expense,clothing,-384.31,2353.99
buyer_8,Antonio,45,ES71209515561182359610,TRX_N-00609-40256457,2024-05-01T11:10:49,Labastida,transfer,Salary,2009.66,4363.65
buyer_8,Antonio,45,ES71209515561182359610,TRX_N-00610-26515803,2024-05-03T09:39:43,Labastida,Expense,leisure,-77.47,4286.18
buyer_8,Antonio,45,ES71209515561182359610,TRX_N-00611-50178804,2024-05-05T15:30:35,Labastida,Housing,Mortgage,-943.56,3342.62
buyer_8,Antonio,45,ES71209515561182359610,TRX_N-00612-98911604,2024-05-05T18:37:30,Labastida,Basic services,electricity,-121.51,3221.11
buyer_8,Antonio,45,ES71209515561182359610,TRX_N-00613-20356643,2024-05-06T01:25:49,Labastida,Basic services,water,-12.75,3208.36
buyer_8,Antonio,45,ES71209515561182359610,TRX_N-00614-50439899,2024-05-06T16:43:40,Labastida,Basic services,electricity,-141.02,3067.34
buyer_8,Antonio,45,ES71209515561182359610,TRX_N-00615-67562806,2024-05-06T19:43:04,Labastida,Basic services,gas,-27.63,3039.71
buyer_8,Antonio,45,ES71209515561182359610,TRX_N-00616-07731520,2024-05-06T18:52:11,Labastida,Basic services,phone,-99.34,2940.37
buyer_8,Antonio,45,ES71209515561182359610,TRX_N-00617-76888665,2024-05-07T12:54:02,Labastida,Basic services,electricity,-45.05,2895.32
buyer_8,Antonio,45,ES71209515561182359610,TRX_N-00618-49391266,2024-05-07T17:11:17,Labastida,Basic services,gas,-82.21,2813.11
buyer_8,Antonio,45,ES71209515561182359610,TRX_N-00619-37501704,2024-05-07T10:10:12,Labastida,Basic services,internet,-46.64,2766.47
buyer_8,Antonio,45,ES71209515561182359610,TRX_N-00620-33667084,2024-05-09T20:14:39,Labastida,Expense,food,-192.6,2573.87
buyer_8,Antonio,45,ES71209515561182359610,TRX_N-00621-23860857,2024-05-15T08:53:38,Labastida,Expense,food,-412.83,2161.04
buyer_8,Antonio,45,ES71209515561182359610,TRX_N-00622-26721825,2024-06-01T17:53:05,Labastida,transfer,Salary,2009.66,4170.7
buyer_8,Antonio,45,ES71209515561182359610,TRX_N-00623-40615414,2024-06-01T17:53:05,Labastida,transfer,Extra Income,200.97,4371.67
buyer_8,Antonio,45,ES71209515561182359610,TRX_N-00624-41560750,2024-06-01T17:53:05,Labastida,transfer,Bonus,1980.71,6352.38
buyer_8,Antonio,45,ES71209515561182359610,TRX_N-00625-68738631,2024-06-05T13:55:32,Labastida,Housing,Mortgage,-943.56,5408.82
buyer_8,Antonio,45,ES71209515561182359610,TRX_N-00626-71433450,2024-06-05T18:06:54,Labastida,Basic services,water,-74.88,5333.94
buyer_8,Antonio,45,ES71209515561182359610,TRX_N-00627-26701201,2024-06-06T11:23:11,Labastida,Basic services,water,-67.84,5266.1
buyer_8,Antonio,45,ES71209515561182359610,TRX_N-00628-44881511,2024-06-06T14:08:30,Labastida,Basic services,internet,-30.82,5235.28
buyer_8,Antonio,45,ES71209515561182359610,TRX_N-00629-03221645,2024-06-06T16:50:34,Labastida,Basic services,phone,-92.06,5143.22
buyer_8,Antonio,45,ES71209515561182359610,TRX_N-00630-01237274,2024-06-07T15:55:09,Labastida,Basic services,electricity,-103.87,5039.35
buyer_8,Antonio,45,ES71209515561182359610,TRX_N-00631-47127495,2024-06-13T19:43:59,Labastida,Expense,travel,-247.93,4791.42
buyer_8,Antonio,45,ES71209515561182359610,TRX_N-00632-22585150,2024-06-23T15:04:48,Labastida,Expense,food,-526.75,4264.67
buyer_8,Antonio,45,ES71209515561182359610,TRX_N-00633-07172066,2024-06-24T15:00:13,Andoain,Expense,transport,-101.97,4162.7
buyer_8,Antonio,45,ES71209515561182359610,TRX_N-00634-59403403,2024-06-24T10:41:50,Labastida,Expense,education,-731.29,3431.41
buyer_8,Antonio,45,ES71209515561182359610,TRX_N-00635-61904260,2024-07-01T17:40:31,Labastida,transfer,Salary,2009.66,5441.07
buyer_8,Antonio,45,ES71209515561182359610,TRX_N-00636-13098173,2024-07-02T20:14:09,Labastida,Expense,food,-207.61,5233.46
buyer_8,Antonio,45,ES71209515561182359610,TRX_N-00637-64987410,2024-07-05T17:36:47,Labastida,Housing,Mortgage,-943.56,4289.9
buyer_8,Antonio,45,ES71209515561182359610,TRX_N-00638-72551422,2024-07-05T21:17:34,Labastida,Basic services,water,-28.5,4261.4
buyer_8,Antonio,45,ES71209515561182359610,TRX_N-00639-43734590,2024-07-05T16:26:22,Labastida,Basic services,internet,-66.93,4194.47
buyer_8,Antonio,45,ES71209515561182359610,TRX_N-00640-01958739,2024-07-07T16:31:27,Labastida,Basic services,water,-14.46,4180.01
buyer_8,Antonio,45,ES71209515561182359610,TRX_N-00641-25999271,2024-07-07T19:26:15,Labastida,Basic services,electricity,-102.72,4077.29
buyer_8,Antonio,45,ES71209515561182359610,TRX_N-00642-77963116,2024-07-07T12:25:36,Labastida,Basic services,gas,-71.78,4005.51
buyer_8,Antonio,45,ES71209515561182359610,TRX_N-00643-00583227,2024-07-07T13:43:38,Labastida,Basic services,internet,-46.54,3958.97
buyer_8,Antonio,45,ES71209515561182359610,TRX_N-00644-70273838,2024-07-29T09:32:28,Labastida,Expense,healthcare,-152.14,3806.83
buyer_8,Antonio,45,ES71209515561182359610,TRX_N-00645-99717233,2024-08-01T18:26:33,Labastida,transfer,Salary,2009.66,5816.49
buyer_8,Antonio,45,ES71209515561182359610,TRX_N-00646-68813728,2024-08-01T18:26:33,Labastida,transfer,Extra Income,200.97,6017.46
buyer_8,Antonio,45,ES71209515561182359610,TRX_N-00647-60755646,2024-08-01T18:05:15,Labastida,Expense,food,-532.76,5484.7
buyer_8,Antonio,45,ES71209515561182359610,TRX_N-00648-50848059,2024-08-05T11:14:39,Labastida,Housing,Mortgage,-943.56,4541.14
buyer_8,Antonio,45,ES71209515561182359610,TRX_N-00649-42129231,2024-08-05T09:16:00,Labastida,Basic services,internet,-68.43,4472.71
buyer_8,Antonio,45,ES71209515561182359610,TRX_N-00650-16731874,2024-08-06T18:19:59,Labastida,Basic services,phone,-58.76,4413.95
buyer_8,Antonio,45,ES71209515561182359610,TRX_N-00651-64754628,2024-08-06T17:18:54,Labastida,Expense,clothing,-152.57,4261.38
buyer_8,Antonio,45,ES71209515561182359610,TRX_N-00652-77866980,2024-08-06T20:54:47,Labastida,Expense,gifts,-347.13,3914.25
buyer_8,Antonio,45,ES71209515561182359610,TRX_N-00653-02597617,2024-08-07T23:27:31,Labastida,Basic services,water,-75.91,3838.34
buyer_8,Antonio,45,ES71209515561182359610,TRX_N-00654-68097170,2024-08-07T18:07:41,Labastida,Basic services,internet,-43.14,3795.2
buyer_8,Antonio,45,ES71209515561182359610,TRX_N-00655-28246957,2024-08-07T08:48:27,Labastida,Basic services,phone,-35.92,3759.28
buyer_8,Antonio,45,ES71209515561182359610,TRX_N-00656-96224737,2024-08-16T11:50:33,Labastida,Expense,healthcare,-128.48,3630.8
buyer_8,Antonio,45,ES71209515561182359610,TRX_N-00657-32484033,2024-08-20T09:26:28,Labastida,Expense,food,-481.44,3149.36
buyer_8,Antonio,45,ES71209515561182359610,TRX_N-00658-66736725,2024-08-22T11:31:16,Labastida,Expense,food,-760.49,2388.87
buyer_8,Antonio,45,ES71209515561182359610,TRX_N-00659-61687585,2024-08-30T11:46:15,Labastida,Expense,leisure,-195.25,2193.62
buyer_8,Antonio,45,ES71209515561182359610,TRX_N-00660-92429803,2024-09-01T05:45:21,Labastida,transfer,Salary,2009.66,4203.28
buyer_8,Antonio,45,ES71209515561182359610,TRX_N-00661-42352570,2024-09-01T20:03:02,Labastida,Expense,food,-321.18,3882.1
buyer_8,Antonio,45,ES71209515561182359610,TRX_N-00662-10739075,2024-09-03T14:44:11,Portugalete,Expense,healthcare,-79.08,3803.02
buyer_8,Antonio,45,ES71209515561182359610,TRX_N-00663-68271074,2024-09-05T12:06:47,Labastida,Housing,Mortgage,-943.56,2859.46
buyer_8,Antonio,45,ES71209515561182359610,TRX_N-00664-37283381,2024-09-05T10:51:20,Labastida,Basic services,electricity,-149.16,2710.3
buyer_8,Antonio,45,ES71209515561182359610,TRX_N-00665-03540998,2024-09-05T15:44:57,Labastida,Basic services,gas,-15.32,2694.98
buyer_8,Antonio,45,ES71209515561182359610,TRX_N-00666-22163562,2024-09-05T11:57:54,Labastida,Basic services,phone,-93.0,2601.98
buyer_8,Antonio,45,ES71209515561182359610,TRX_N-00667-60274696,2024-09-06T20:18:27,Labastida,Basic services,gas,-31.75,2570.23
buyer_8,Antonio,45,ES71209515561182359610,TRX_N-00668-94069406,2024-09-06T16:24:15,Labastida,Basic services,phone,-75.62,2494.61
buyer_8,Antonio,45,ES71209515561182359610,TRX_N-00669-33302225,2024-09-07T08:33:20,Labastida,Basic services,water,-66.72,2427.89
buyer_8,Antonio,45,ES71209515561182359610,TRX_N-00670-33118291,2024-09-07T19:34:39,Labastida,Basic services,internet,-33.13,2394.76
buyer_8,Antonio,45,ES71209515561182359610,TRX_N-00671-78840884,2024-09-19T14:10:14,Labastida,Expense,food,-674.74,1720.02
buyer_8,Antonio,45,ES71209515561182359610,TRX_N-00672-30104955,2024-10-01T15:55:20,Labastida,transfer,Salary,2009.66,3729.68
buyer_8,Antonio,45,ES71209515561182359610,TRX_N-00673-69348644,2024-10-01T15:55:20,Labastida,transfer,Extra Income,200.97,3930.65
buyer_8,Antonio,45,ES71209515561182359610,TRX_N-00674-41123795,2024-10-03T19:18:57,Labastida,Expense,transport,-162.51,3768.14
buyer_8,Antonio,45,ES71209515561182359610,TRX_N-00675-03191902,2024-10-05T09:17:14,Labastida,Housing,Mortgage,-943.56,2824.58
buyer_8,Antonio,45,ES71209515561182359610,TRX_N-00676-52418791,2024-10-05T15:51:13,Labastida,Basic services,electricity,-36.94,2787.64
buyer_8,Antonio,45,ES71209515561182359610,TRX_N-00677-25503053,2024-10-05T18:09:08,Labastida,Basic services,phone,-98.67,2688.97
buyer_8,Antonio,45,ES71209515561182359610,TRX_N-00678-86683599,2024-10-05T20:10:58,Labastida,Expense,education,-307.65,2381.32
buyer_8,Antonio,45,ES71209515561182359610,TRX_N-00679-44076449,2024-10-06T14:50:38,Labastida,Basic services,electricity,-82.18,2299.14
buyer_8,Antonio,45,ES71209515561182359610,TRX_N-00680-33961366,2024-10-06T18:26:44,Labastida,Basic services,internet,-61.02,2238.12
buyer_8,Antonio,45,ES71209515561182359610,TRX_N-00681-99205929,2024-10-06T09:51:26,Labastida,Basic services,phone,-93.74,2144.38
buyer_8,Antonio,45,ES71209515561182359610,TRX_N-00682-80272630,2024-10-07T13:03:53,Labastida,Basic services,internet,-74.69,2069.69
