profile,name,age,iban,trx_id,timestamp,city,trx_type,trx_cat,amount_eur,balance
buyer_1,Luis,1996-08-10,ES36209580831926802634,TRX_N-00001-94097834,2022-01-01T16:30:05,Bilbao,incomes,salary,1481.0,2499.65
buyer_1,Luis,1996-08-10,ES36209580831926802634,TRX_N-00002-10285326,2022-01-01T16:30:05,Bilbao,incomes,salary_partner,1167.06,3666.71
buyer_1,Luis,1996-08-10,ES36209580831926802634,TRX_N-00003-80265466,2022-01-02T08:29:27,Bilbao,expenses,gifts,-848.09,2818.62
buyer_1,Luis,1996-08-10,ES36209580831926802634,TRX_N-00004-24577880,2022-01-04T17:33:36,Bilbao,expenses,mortgage,-743.13,2075.49
buyer_1,Luis,1996-08-10,ES36209580831926802634,TRX_N-00005-51556500,2022-01-05T10:17:22,Bilbao,expenses,transport,-54.65,2020.84
buyer_1,Luis,1996-08-10,ES36209580831926802634,TRX_N-00006-74820986,2022-01-05T14:19:55,Bilbao,expenses,clothing,-112.59,1908.25
buyer_1,Luis,1996-08-10,ES36209580831926802634,TRX_N-00007-12591200,2022-01-05T04:35:48,Bilbao,expenses,healthcare,-67.18,1841.07
buyer_1,Luis,1996-08-10,ES36209580831926802634,TRX_N-00008-70042421,2022-01-05T16:01:22,Bilbao,expenses,children,-54.52,1786.55
buyer_1,Luis,1996-08-10,ES36209580831926802634,TRX_N-00009-08947529,2022-01-06T17:46:38,Bilbao,expenses,internet,-42.0,1744.55
buyer_1,Luis,1996-08-10,ES36209580831926802634,TRX_N-00010-50387699,2022-01-06T14:00:01,Bilbao,expenses,food,-121.11,1623.44
buyer_1,Luis,1996-08-10,ES36209580831926802634,TRX_N-00011-28122007,2022-01-06T11:03:38,Bilbao,expenses,leisure,-22.95,1600.49
buyer_1,Luis,1996-08-10,ES36209580831926802634,TRX_N-00012-96364619,2022-01-07T12:05:51,Bilbao,expenses,food,-120.03,1480.46
buyer_1,Luis,1996-08-10,ES36209580831926802634,TRX_N-00013-45610054,2022-01-07T15:03:33,Bilbao,expenses,cash,-100.0,1380.46
buyer_1,Luis,1996-08-10,ES36209580831926802634,TRX_N-00014-17080030,2022-01-08T11:34:06,Bilbao,expenses,water,-20.34,1360.12
buyer_1,Luis,1996-08-10,ES36209580831926802634,TRX_N-00015-17079316,2022-01-08T15:56:01,Bilbao,expenses,electricity,-62.9,1297.22
buyer_1,Luis,1996-08-10,ES36209580831926802634,TRX_N-00016-19907426,2022-01-08T19:21:28,Bilbao,expenses,gas,-91.86,1205.36
buyer_1,Luis,1996-08-10,ES36209580831926802634,TRX_N-00017-59335514,2022-01-08T15:20:59,Bilbao,expenses,phone,-33.97,1171.39
buyer_1,Luis,1996-08-10,ES36209580831926802634,TRX_N-00018-39651491,2022-01-08T11:47:12,Bilbao,expenses,food,-123.73,1047.66
buyer_1,Luis,1996-08-10,ES36209580831926802634,TRX_N-00019-66784248,2022-01-08T22:05:38,Bilbao,expenses,leisure,-44.25,1003.41
buyer_1,Luis,1996-08-10,ES36209580831926802634,TRX_N-00020-32294424,2022-01-08T11:29:34,Bilbao,expenses,cash,-100.0,903.41
buyer_1,Luis,1996-08-10,ES36209580831926802634,TRX_N-00021-51393615,2022-01-08T15:15:02,Bilbao,expenses,appliances,-405.82,497.59
buyer_1,Luis,1996-08-10,ES36209580831926802634,TRX_N-00022-23199711,2022-01-10T15:43:49,Bilbao,expenses,healthcare,-68.58,429.01
buyer_1,Luis,1996-08-10,ES36209580831926802634,TRX_N-00023-82817985,2022-01-10T08:30:49,Zarautz,expenses,cash,-100.0,329.01
buyer_1,Luis,1996-08-10,ES36209580831926802634,TRX_N-00024-41341829,2022-01-14T10:13:47,Hondarribia,expenses,transport,-73.13,255.88
buyer_1,Luis,1996-08-10,ES36209580831926802634,TRX_N-00025-16697468,2022-01-15T09:06:11,Bilbao,expenses,cash,-100.0,155.88
buyer_1,Luis,1996-08-10,ES36209580831926802634,TRX_N-00026-26267509,2022-01-17T12:25:53,Bilbao,expenses,transport,-65.56,90.32
buyer_1,Luis,1996-08-10,ES36209580831926802634,TRX_N-00027-42897290,2022-01-17T11:24:49,Bilbao,expenses,cash,-100.0,-9.68
buyer_1,Luis,1996-08-10,ES36209580831926802634,TRX_N-00028-19924465,2022-01-17T03:34:06,Barakaldo,expenses,repairs,-247.83,-257.51
buyer_1,Luis,1996-08-10,ES36209580831926802634,TRX_N-00029-21590803,2022-01-17T11:45:53,Bilbao,expenses,children,-76.19,-333.7
buyer_1,Luis,1996-08-10,ES36209580831926802634,TRX_N-00030-82050612,2022-01-19T14:17:59,Durango,expenses,transport,-73.19,-406.89
buyer_1,Luis,1996-08-10,ES36209580831926802634,TRX_N-00031-57627783,2022-01-19T13:37:43,Bilbao,expenses,repairs,-175.59,-582.48
buyer_1,Luis,1996-08-10,ES36209580831926802634,TRX_N-00032-16604872,2022-01-20T14:40:43,Bilbao,expenses,transport,-50.5,-632.98
buyer_1,Luis,1996-08-10,ES36209580831926802634,TRX_N-00033-30924948,2022-01-21T10:14:04,Bilbao,expenses,leisure,-45.74,-678.72
buyer_1,Luis,1996-08-10,ES36209580831926802634,TRX_N-00034-92155683,2022-01-22T19:26:17,Bilbao,expenses,leisure,-22.16,-700.88
buyer_1,Luis,1996-08-10,ES36209580831926802634,TRX_N-00035-89709810,2022-01-23T16:44:55,Bilbao,expenses,cash,-100.0,-800.88
buyer_1,Luis,1996-08-10,ES36209580831926802634,TRX_N-00036-73406270,2022-01-24T20:09:52,Bilbao,expenses,appliances,-212.96,-1013.84
buyer_1,Luis,1996-08-10,ES36209580831926802634,TRX_N-00037-13228951,2022-01-25T16:01:37,Bilbao,expenses,gifts,-771.84,-1785.68
buyer_1,Luis,1996-08-10,ES36209580831926802634,TRX_N-00038-91188037,2022-01-30T09:36:07,Bilbao,expenses,leisure,-25.3,-1810.98
buyer_1,Luis,1996-08-10,ES36209580831926802634,TRX_N-00039-92718047,2022-01-30T07:23:54,Getxo,expenses,cash,-100.0,-1910.98
buyer_1,Luis,1996-08-10,ES36209580831926802634,TRX_N-00040-32641389,2022-02-01T21:06:36,Bilbao,incomes,salary,1481.0,-429.98
buyer_1,Luis,1996-08-10,ES36209580831926802634,TRX_N-00041-75841555,2022-02-01T21:06:36,Bilbao,incomes,salary_partner,1167.06,737.08
buyer_1,Luis,1996-08-10,ES36209580831926802634,TRX_N-00042-63079092,2022-02-01T16:27:09,Bilbao,expenses,leisure,-73.96,663.12
buyer_1,Luis,1996-08-10,ES36209580831926802634,TRX_N-00043-23089189,2022-02-03T15:05:03,Bilbao,expenses,education,-75.83,587.29
buyer_1,Luis,1996-08-10,ES36209580831926802634,TRX_N-00044-70371290,2022-02-04T03:05:04,Bilbao,expenses,mortgage,-743.13,-155.84
buyer_1,Luis,1996-08-10,ES36209580831926802634,TRX_N-00045-57919237,2022-02-04T17:23:55,Bilbao,expenses,cash,-100.0,-255.84
buyer_1,Luis,1996-08-10,ES36209580831926802634,TRX_N-00046-15967772,2022-02-05T23:22:19,Bilbao,expenses,electricity,-52.26,-308.1
buyer_1,Luis,1996-08-10,ES36209580831926802634,TRX_N-00047-45918476,2022-02-06T11:17:07,Bilbao,expenses,leisure,-54.64,-362.74
buyer_1,Luis,1996-08-10,ES36209580831926802634,TRX_N-00048-08052704,2022-02-07T12:23:25,Bilbao,expenses,internet,-42.0,-404.74
buyer_1,Luis,1996-08-10,ES36209580831926802634,TRX_N-00049-27805798,2022-02-07T22:10:55,Bilbao,expenses,phone,-32.61,-437.35
buyer_1,Luis,1996-08-10,ES36209580831926802634,TRX_N-00050-55764170,2022-02-08T15:12:15,Bilbao,expenses,water,-25.61,-462.96
buyer_1,Luis,1996-08-10,ES36209580831926802634,TRX_N-00051-01509073,2022-02-08T09:39:19,Bilbao,expenses,gas,-75.63,-538.59
buyer_1,Luis,1996-08-10,ES36209580831926802634,TRX_N-00052-35625719,2022-02-11T12:24:22,Bilbao,expenses,transport,-75.35,-613.94
buyer_1,Luis,1996-08-10,ES36209580831926802634,TRX_N-00053-29590324,2022-02-12T16:08:44,Vitoria-Gasteiz,expenses,repairs,-152.09,-766.03
buyer_1,Luis,1996-08-10,ES36209580831926802634,TRX_N-00054-00621721,2022-02-14T11:33:24,Bilbao,expenses,repairs,-133.37,-899.4
buyer_1,Luis,1996-08-10,ES36209580831926802634,TRX_N-00055-83984511,2022-02-14T18:21:22,Bilbao,expenses,children,-203.6,-1103.0
buyer_1,Luis,1996-08-10,ES36209580831926802634,TRX_N-00056-48759284,2022-02-15T04:44:11,Labastida,expenses,appliances,-318.56,-1421.56
buyer_1,Luis,1996-08-10,ES36209580831926802634,TRX_N-00057-80899688,2022-02-17T03:39:41,Bilbao,expenses,travel,-1030.09,-2451.65
buyer_1,Luis,1996-08-10,ES36209580831926802634,TRX_N-00058-20133825,2022-02-18T16:54:10,Bilbao,expenses,food,-102.67,-2554.32
buyer_1,Luis,1996-08-10,ES36209580831926802634,TRX_N-00059-14999746,2022-02-18T10:16:17,Eibar,expenses,education,-49.21,-2603.53
buyer_1,Luis,1996-08-10,ES36209580831926802634,TRX_N-00060-05675846,2022-02-20T16:37:11,Bilbao,expenses,cash,-100.0,-2703.53
buyer_1,Luis,1996-08-10,ES36209580831926802634,TRX_N-00061-86326385,2022-02-21T04:40:29,Bilbao,expenses,transport,-46.78,-2750.31
buyer_1,Luis,1996-08-10,ES36209580831926802634,TRX_N-00062-00060031,2022-02-23T17:07:15,Bilbao,expenses,cash,-100.0,-2850.31
buyer_1,Luis,1996-08-10,ES36209580831926802634,TRX_N-00063-80512560,2022-02-24T09:39:09,Bilbao,expenses,leisure,-79.81,-2930.12
buyer_1,Luis,1996-08-10,ES36209580831926802634,TRX_N-00064-04550301,2022-02-24T18:29:29,Bilbao,expenses,gifts,-745.85,-3675.97
buyer_1,Luis,1996-08-10,ES36209580831926802634,TRX_N-00065-24356954,2022-02-25T20:35:06,Bilbao,expenses,leisure,-20.84,-3696.81
buyer_1,Luis,1996-08-10,ES36209580831926802634,TRX_N-00066-78319921,2022-02-25T12:54:57,Bilbao,expenses,healthcare,-87.12,-3783.93
buyer_1,Luis,1996-08-10,ES36209580831926802634,TRX_N-00067-32307478,2022-02-25T08:38:28,Bilbao,expenses,education,-55.64,-3839.57
buyer_1,Luis,1996-08-10,ES36209580831926802634,TRX_N-00068-91594832,2022-02-27T13:50:39,Bilbao,expenses,transport,-43.28,-3882.85
buyer_1,Luis,1996-08-10,ES36209580831926802634,TRX_N-00069-17261362,2022-02-28T09:44:55,Bilbao,expenses,food,-88.8,-3971.65
buyer_1,Luis,1996-08-10,ES36209580831926802634,TRX_N-00070-53977830,2022-02-28T08:05:14,Amurrio,expenses,cash,-100.0,-4071.65
buyer_1,Luis,1996-08-10,ES36209580831926802634,TRX_N-00071-67057822,2022-03-01T14:05:04,Bilbao,incomes,salary,1481.0,-2590.65
buyer_1,Luis,1996-08-10,ES36209580831926802634,TRX_N-00072-93954066,2022-03-01T14:05:04,Bilbao,incomes,salary_partner,1167.06,-1423.59
buyer_1,Luis,1996-08-10,ES36209580831926802634,TRX_N-00073-46875233,2022-03-01T14:05:04,Bilbao,incomes,extra_income,241.2,-1182.39
buyer_1,Luis,1996-08-10,ES36209580831926802634,TRX_N-00074-12449625,2022-03-02T14:36:00,Bilbao,expenses,transport,-65.7,-1248.09
buyer_1,Luis,1996-08-10,ES36209580831926802634,TRX_N-00075-38924926,2022-03-03T08:43:59,Bilbao,expenses,food,-84.75,-1332.84
buyer_1,Luis,1996-08-10,ES36209580831926802634,TRX_N-00076-09986894,2022-03-04T04:21:00,Bilbao,expenses,mortgage,-743.13,-2075.97
buyer_1,Luis,1996-08-10,ES36209580831926802634,TRX_N-00077-67163675,2022-03-05T09:07:50,Bilbao,expenses,leisure,-50.21,-2126.18
buyer_1,Luis,1996-08-10,ES36209580831926802634,TRX_N-00078-39966233,2022-03-06T09:50:49,Bilbao,expenses,water,-22.8,-2148.98
buyer_1,Luis,1996-08-10,ES36209580831926802634,TRX_N-00079-89798745,2022-03-08T22:52:07,Bilbao,expenses,phone,-43.26,-2192.24
buyer_1,Luis,1996-08-10,ES36209580831926802634,TRX_N-00080-82436617,2022-03-08T14:00:06,Bilbao,expenses,electricity,-29.03,-2221.27
buyer_1,Luis,1996-08-10,ES36209580831926802634,TRX_N-00081-68664357,2022-03-08T15:41:46,Bilbao,expenses,gas,-49.31,-2270.58
buyer_1,Luis,1996-08-10,ES36209580831926802634,TRX_N-00082-63411403,2022-03-08T16:56:37,Bilbao,expenses,internet,-42.0,-2312.58
buyer_1,Luis,1996-08-10,ES36209580831926802634,TRX_N-00083-62604379,2022-03-13T10:18:08,Bilbao,expenses,leisure,-33.67,-2346.25
buyer_1,Luis,1996-08-10,ES36209580831926802634,TRX_N-00084-14248354,2022-03-14T09:39:04,Elciego,expenses,leisure,-66.13,-2412.38
buyer_1,Luis,1996-08-10,ES36209580831926802634,TRX_N-00085-89984084,2022-03-16T14:57:02,Bilbao,expenses,food,-76.66,-2489.04
buyer_1,Luis,1996-08-10,ES36209580831926802634,TRX_N-00086-56419021,2022-03-16T10:49:34,Bilbao,expenses,leisure,-29.94,-2518.98
buyer_1,Luis,1996-08-10,ES36209580831926802634,TRX_N-00087-31369227,2022-03-17T05:21:20,Bilbao,expenses,food,-107.2,-2626.18
buyer_1,Luis,1996-08-10,ES36209580831926802634,TRX_N-00088-07949750,2022-03-19T10:17:36,Bilbao,expenses,food,-93.49,-2719.67
buyer_1,Luis,1996-08-10,ES36209580831926802634,TRX_N-00089-14441375,2022-03-22T14:31:42,Bilbao,expenses,leisure,-20.12,-2739.79
buyer_1,Luis,1996-08-10,ES36209580831926802634,TRX_N-00090-31450073,2022-03-26T16:37:40,Bilbao,expenses,cash,-100.0,-2839.79
buyer_1,Luis,1996-08-10,ES36209580831926802634,TRX_N-00091-45248599,2022-03-26T12:20:21,Bilbao,expenses,gifts,-194.33,-3034.12
buyer_1,Luis,1996-08-10,ES36209580831926802634,TRX_N-00092-94193623,2022-03-27T11:41:35,Bilbao,expenses,education,-64.29,-3098.41
buyer_1,Luis,1996-08-10,ES36209580831926802634,TRX_N-00093-28053991,2022-03-29T19:31:17,Bilbao,expenses,clothing,-137.3,-3235.71
buyer_1,Luis,1996-08-10,ES36209580831926802634,TRX_N-00094-80352947,2022-03-30T15:49:03,Bilbao,expenses,education,-73.9,-3309.61
buyer_1,Luis,1996-08-10,ES36209580831926802634,TRX_N-00095-47506869,2022-04-01T14:32:27,Bilbao,incomes,salary,1481.0,-1828.61
buyer_1,Luis,1996-08-10,ES36209580831926802634,TRX_N-00096-20195243,2022-04-01T14:32:27,Bilbao,incomes,salary_partner,1167.06,-661.55
buyer_1,Luis,1996-08-10,ES36209580831926802634,TRX_N-00097-47333090,2022-04-01T09:55:43,Bilbao,expenses,food,-118.37,-779.92
buyer_1,Luis,1996-08-10,ES36209580831926802634,TRX_N-00098-29663238,2022-04-01T16:08:29,Bilbao,expenses,cash,-100.0,-879.92
buyer_1,Luis,1996-08-10,ES36209580831926802634,TRX_N-00099-98900397,2022-04-03T04:55:29,Bermeo,expenses,cash,-100.0,-979.92
buyer_1,Luis,1996-08-10,ES36209580831926802634,TRX_N-00100-90920505,2022-04-03T10:29:18,Bilbao,expenses,gifts,-600.43,-1580.35
buyer_1,Luis,1996-08-10,ES36209580831926802634,TRX_N-00101-36569246,2022-04-04T19:10:06,Bilbao,expenses,mortgage,-743.13,-2323.48
buyer_1,Luis,1996-08-10,ES36209580831926802634,TRX_N-00102-10494750,2022-04-04T17:43:47,Leioa,expenses,clothing,-131.08,-2454.56
buyer_1,Luis,1996-08-10,ES36209580831926802634,TRX_N-00103-51091815,2022-04-04T18:22:29,Bilbao,expenses,cash,-100.0,-2554.56
buyer_1,Luis,1996-08-10,ES36209580831926802634,TRX_N-00104-89449499,2022-04-04T20:44:31,Bilbao,expenses,gifts,-659.76,-3214.32
buyer_1,Luis,1996-08-10,ES36209580831926802634,TRX_N-00105-09637540,2022-04-05T10:22:03,Bilbao,expenses,water,-21.72,-3236.04
buyer_1,Luis,1996-08-10,ES36209580831926802634,TRX_N-00106-51640489,2022-04-05T15:27:31,Vitoria-Gasteiz,expenses,appliances,-358.44,-3594.48
buyer_1,Luis,1996-08-10,ES36209580831926802634,TRX_N-00107-07329147,2022-04-06T09:53:28,Bilbao,expenses,internet,-42.0,-3636.48
buyer_1,Luis,1996-08-10,ES36209580831926802634,TRX_N-00108-47410671,2022-04-07T13:07:46,Bilbao,expenses,electricity,-72.21,-3708.69
buyer_1,Luis,1996-08-10,ES36209580831926802634,TRX_N-00109-37779048,2022-04-07T15:04:50,Bilbao,expenses,gas,-44.17,-3752.86
buyer_1,Luis,1996-08-10,ES36209580831926802634,TRX_N-00110-45281813,2022-04-07T21:28:49,Bilbao,expenses,transport,-63.97,-3816.83
buyer_1,Luis,1996-08-10,ES36209580831926802634,TRX_N-00111-74581833,2022-04-07T10:39:37,Bilbao,expenses,appliances,-110.11,-3926.94
buyer_1,Luis,1996-08-10,ES36209580831926802634,TRX_N-00112-11019210,2022-04-08T23:55:30,Bilbao,expenses,phone,-43.1,-3970.04
buyer_1,Luis,1996-08-10,ES36209580831926802634,TRX_N-00113-34462055,2022-04-08T16:00:37,Bilbao,expenses,leisure,-60.37,-4030.41
buyer_1,Luis,1996-08-10,ES36209580831926802634,TRX_N-00114-31855665,2022-04-11T08:31:40,Bilbao,expenses,transport,-89.92,-4120.33
buyer_1,Luis,1996-08-10,ES36209580831926802634,TRX_N-00115-55897039,2022-04-13T22:52:43,Zarautz,expenses,leisure,-38.17,-4158.5
buyer_1,Luis,1996-08-10,ES36209580831926802634,TRX_N-00116-67189072,2022-04-14T15:32:56,Bilbao,expenses,repairs,-34.63,-4193.13
buyer_1,Luis,1996-08-10,ES36209580831926802634,TRX_N-00117-14267034,2022-04-17T19:39:54,Mungia,expenses,food,-70.88,-4264.01
buyer_1,Luis,1996-08-10,ES36209580831926802634,TRX_N-00118-61127277,2022-04-18T09:03:51,Bilbao,expenses,leisure,-42.87,-4306.88
buyer_1,Luis,1996-08-10,ES36209580831926802634,TRX_N-00119-09434889,2022-04-20T17:23:05,Bilbao,expenses,transport,-43.35,-4350.23
buyer_1,Luis,1996-08-10,ES36209580831926802634,TRX_N-00120-54238022,2022-04-21T12:04:06,Bilbao,expenses,leisure,-46.11,-4396.34
buyer_1,Luis,1996-08-10,ES36209580831926802634,TRX_N-00121-12109067,2022-04-21T10:02:15,Bilbao,expenses,gifts,-52.13,-4448.47
buyer_1,Luis,1996-08-10,ES36209580831926802634,TRX_N-00122-58380100,2022-04-22T11:56:15,Bilbao,expenses,repairs,-93.13,-4541.6
buyer_1,Luis,1996-08-10,ES36209580831926802634,TRX_N-00123-61805291,2022-04-23T18:55:08,Bilbao,expenses,food,-121.21,-4662.81
buyer_1,Luis,1996-08-10,ES36209580831926802634,TRX_N-00124-39369491,2022-04-24T16:14:37,Alegría-Dulantzi,expenses,food,-97.6,-4760.41
buyer_1,Luis,1996-08-10,ES36209580831926802634,TRX_N-00125-80616483,2022-04-27T18:57:38,Bilbao,expenses,leisure,-63.39,-4823.8
buyer_1,Luis,1996-08-10,ES36209580831926802634,TRX_N-00126-32599062,2022-05-01T15:04:48,Bilbao,incomes,salary,1481.0,-3342.8
buyer_1,Luis,1996-08-10,ES36209580831926802634,TRX_N-00127-96565370,2022-05-01T15:04:48,Bilbao,incomes,salary_partner,1167.06,-2175.74
buyer_1,Luis,1996-08-10,ES36209580831926802634,TRX_N-00128-01143496,2022-05-01T13:24:42,Bilbao,expenses,transport,-64.43,-2240.17
buyer_1,Luis,1996-08-10,ES36209580831926802634,TRX_N-00129-34688593,2022-05-01T15:46:49,Labastida,expenses,leisure,-71.19,-2311.36
buyer_1,Luis,1996-08-10,ES36209580831926802634,TRX_N-00130-56907581,2022-05-01T10:57:52,Bilbao,expenses,cash,-100.0,-2411.36
buyer_1,Luis,1996-08-10,ES36209580831926802634,TRX_N-00131-62730346,2022-05-02T10:13:10,Mungia,expenses,transport,-85.49,-2496.85
buyer_1,Luis,1996-08-10,ES36209580831926802634,TRX_N-00132-03290029,2022-05-02T08:17:23,Bilbao,expenses,cash,-100.0,-2596.85
buyer_1,Luis,1996-08-10,ES36209580831926802634,TRX_N-00133-58876980,2022-05-03T22:02:10,Bilbao,expenses,cash,-100.0,-2696.85
buyer_1,Luis,1996-08-10,ES36209580831926802634,TRX_N-00134-58206932,2022-05-04T13:07:03,Bilbao,expenses,mortgage,-743.13,-3439.98
buyer_1,Luis,1996-08-10,ES36209580831926802634,TRX_N-00135-43671259,2022-05-04T14:42:58,Bilbao,expenses,leisure,-69.71,-3509.69
buyer_1,Luis,1996-08-10,ES36209580831926802634,TRX_N-00136-03060114,2022-05-05T19:31:12,Bilbao,expenses,electricity,-47.11,-3556.8
buyer_1,Luis,1996-08-10,ES36209580831926802634,TRX_N-00137-77711738,2022-05-05T12:36:06,Bilbao,expenses,leisure,-57.41,-3614.21
buyer_1,Luis,1996-08-10,ES36209580831926802634,TRX_N-00138-49648521,2022-05-06T08:54:37,Bilbao,expenses,food,-70.74,-3684.95
buyer_1,Luis,1996-08-10,ES36209580831926802634,TRX_N-00139-87819919,2022-05-07T08:40:05,Bilbao,expenses,water,-44.64,-3729.59
buyer_1,Luis,1996-08-10,ES36209580831926802634,TRX_N-00140-31526496,2022-05-07T03:43:53,Bilbao,expenses,internet,-42.0,-3771.59
buyer_1,Luis,1996-08-10,ES36209580831926802634,TRX_N-00141-59545071,2022-05-07T09:38:36,Irun,expenses,cash,-100.0,-3871.59
buyer_1,Luis,1996-08-10,ES36209580831926802634,TRX_N-00142-10659625,2022-05-08T15:51:04,Bilbao,expenses,gas,-74.87,-3946.46
buyer_1,Luis,1996-08-10,ES36209580831926802634,TRX_N-00143-72494783,2022-05-08T10:07:43,Bilbao,expenses,phone,-42.24,-3988.7
buyer_1,Luis,1996-08-10,ES36209580831926802634,TRX_N-00144-17190320,2022-05-10T12:39:28,Bilbao,expenses,leisure,-73.76,-4062.46
buyer_1,Luis,1996-08-10,ES36209580831926802634,TRX_N-00145-70959508,2022-05-13T17:52:51,Bilbao,expenses,transport,-80.64,-4143.1
buyer_1,Luis,1996-08-10,ES36209580831926802634,TRX_N-00146-13233258,2022-05-13T13:58:42,Bilbao,expenses,education,-53.56,-4196.66
buyer_1,Luis,1996-08-10,ES36209580831926802634,TRX_N-00147-33927668,2022-05-14T16:56:36,Amurrio,expenses,clothing,-45.26,-4241.92
buyer_1,Luis,1996-08-10,ES36209580831926802634,TRX_N-00148-68562290,2022-05-14T13:27:32,Leioa,expenses,cash,-100.0,-4341.92
buyer_1,Luis,1996-08-10,ES36209580831926802634,TRX_N-00149-94035190,2022-05-15T09:44:06,Bilbao,expenses,leisure,-73.44,-4415.36
buyer_1,Luis,1996-08-10,ES36209580831926802634,TRX_N-00150-92696286,2022-05-16T08:54:35,Bilbao,expenses,children,-234.3,-4649.66
buyer_1,Luis,1996-08-10,ES36209580831926802634,TRX_N-00151-33624617,2022-05-17T19:23:43,Salvatierra/Agurain,expenses,transport,-40.74,-4690.4
buyer_1,Luis,1996-08-10,ES36209580831926802634,TRX_N-00152-62582840,2022-05-17T13:42:15,Bilbao,expenses,cash,-100.0,-4790.4
buyer_1,Luis,1996-08-10,ES36209580831926802634,TRX_N-00153-91324031,2022-05-19T08:44:17,Bilbao,expenses,transport,-65.26,-4855.66
buyer_1,Luis,1996-08-10,ES36209580831926802634,TRX_N-00154-97159020,2022-05-20T13:00:54,Bilbao,expenses,leisure,-70.57,-4926.23
buyer_1,Luis,1996-08-10,ES36209580831926802634,TRX_N-00155-43214908,2022-05-21T20:09:09,Errenteria,expenses,transport,-85.74,-5011.97
buyer_1,Luis,1996-08-10,ES36209580831926802634,TRX_N-00156-20917856,2022-05-23T19:26:44,Bilbao,expenses,children,-181.56,-5193.53
buyer_1,Luis,1996-08-10,ES36209580831926802634,TRX_N-00157-07202833,2022-05-25T10:21:40,Bilbao,expenses,cash,-100.0,-5293.53
buyer_1,Luis,1996-08-10,ES36209580831926802634,TRX_N-00158-84484746,2022-05-25T20:46:34,Erandio,expenses,repairs,-250.82,-5544.35
buyer_1,Luis,1996-08-10,ES36209580831926802634,TRX_N-00159-93111093,2022-05-26T11:38:55,Amurrio,expenses,food,-77.52,-5621.87
buyer_1,Luis,1996-08-10,ES36209580831926802634,TRX_N-00160-90794260,2022-05-26T12:59:10,Bilbao,expenses,leisure,-50.75,-5672.62
buyer_1,Luis,1996-08-10,ES36209580831926802634,TRX_N-00161-48665429,2022-05-28T11:54:15,Bilbao,expenses,food,-80.41,-5753.03
buyer_1,Luis,1996-08-10,ES36209580831926802634,TRX_N-00162-99043557,2022-05-29T11:27:24,Bilbao,expenses,repairs,-113.44,-5866.47
buyer_1,Luis,1996-08-10,ES36209580831926802634,TRX_N-00163-03876257,2022-05-30T21:35:53,Bilbao,expenses,cash,-100.0,-5966.47
buyer_1,Luis,1996-08-10,ES36209580831926802634,TRX_N-00164-56809510,2022-05-31T10:29:55,Bilbao,expenses,cash,-100.0,-6066.47
buyer_1,Luis,1996-08-10,ES36209580831926802634,TRX_N-00165-99155462,2022-06-01T08:42:06,Bilbao,incomes,salary,1481.0,-4585.47
buyer_1,Luis,1996-08-10,ES36209580831926802634,TRX_N-00166-24122448,2022-06-01T08:42:06,Bilbao,incomes,salary_partner,1167.06,-3418.41
buyer_1,Luis,1996-08-10,ES36209580831926802634,TRX_N-00167-19194080,2022-06-01T08:42:06,Bilbao,incomes,salary_bonus,1119.94,-2298.47
buyer_1,Luis,1996-08-10,ES36209580831926802634,TRX_N-00168-62473647,2022-06-01T08:42:06,Bilbao,incomes,salary_partner_bonus,837.84,-1460.63
buyer_1,Luis,1996-08-10,ES36209580831926802634,TRX_N-00169-25367798,2022-06-02T17:20:29,Bilbao,expenses,taxes,-1307.34,-2767.97
buyer_1,Luis,1996-08-10,ES36209580831926802634,TRX_N-00170-82022170,2022-06-02T05:06:37,Bilbao,expenses,insurance,-311.51,-3079.48
buyer_1,Luis,1996-08-10,ES36209580831926802634,TRX_N-00171-80561392,2022-06-03T12:55:51,Bilbao,expenses,leisure,-56.82,-3136.3
buyer_1,Luis,1996-08-10,ES36209580831926802634,TRX_N-00172-83641246,2022-06-04T14:51:14,Bilbao,expenses,mortgage,-743.13,-3879.43
buyer_1,Luis,1996-08-10,ES36209580831926802634,TRX_N-00173-90267303,2022-06-04T09:39:25,Bilbao,expenses,food,-98.15,-3977.58
buyer_1,Luis,1996-08-10,ES36209580831926802634,TRX_N-00174-08793103,2022-06-05T18:53:30,Bilbao,expenses,electricity,-51.37,-4028.95
buyer_1,Luis,1996-08-10,ES36209580831926802634,TRX_N-00175-03370414,2022-06-05T13:42:14,Bilbao,expenses,gas,-39.87,-4068.82
buyer_1,Luis,1996-08-10,ES36209580831926802634,TRX_N-00176-69640910,2022-06-05T16:22:21,Bilbao,expenses,phone,-37.71,-4106.53
buyer_1,Luis,1996-08-10,ES36209580831926802634,TRX_N-00177-13996914,2022-06-07T15:04:53,Bilbao,expenses,water,-33.4,-4139.93
buyer_1,Luis,1996-08-10,ES36209580831926802634,TRX_N-00178-34753253,2022-06-07T17:48:25,Bilbao,expenses,transport,-45.0,-4184.93
buyer_1,Luis,1996-08-10,ES36209580831926802634,TRX_N-00179-33446972,2022-06-07T01:37:21,Bermeo,expenses,gifts,-629.72,-4814.65
buyer_1,Luis,1996-08-10,ES36209580831926802634,TRX_N-00180-34969875,2022-06-08T19:10:22,Bilbao,expenses,internet,-42.0,-4856.65
buyer_1,Luis,1996-08-10,ES36209580831926802634,TRX_N-00181-76084643,2022-06-08T16:54:23,Bilbao,expenses,leisure,-62.21,-4918.86
buyer_1,Luis,1996-08-10,ES36209580831926802634,TRX_N-00182-97840314,2022-06-09T11:27:54,Bilbao,expenses,transport,-81.05,-4999.91
buyer_1,Luis,1996-08-10,ES36209580831926802634,TRX_N-00183-24994841,2022-06-12T18:34:11,Donostia,expenses,food,-99.44,-5099.35
buyer_1,Luis,1996-08-10,ES36209580831926802634,TRX_N-00184-67051910,2022-06-12T16:26:48,Bilbao,expenses,gifts,-476.83,-5576.18
buyer_1,Luis,1996-08-10,ES36209580831926802634,TRX_N-00185-84003972,2022-06-13T08:52:25,Bilbao,expenses,food,-75.68,-5651.86
buyer_1,Luis,1996-08-10,ES36209580831926802634,TRX_N-00186-82666352,2022-06-13T08:43:39,Bilbao,expenses,leisure,-80.62,-5732.48
buyer_1,Luis,1996-08-10,ES36209580831926802634,TRX_N-00187-36313162,2022-06-14T12:58:29,Bilbao,expenses,cash,-100.0,-5832.48
buyer_1,Luis,1996-08-10,ES36209580831926802634,TRX_N-00188-35725238,2022-06-14T21:24:31,Bilbao,expenses,gifts,-171.24,-6003.72
buyer_1,Luis,1996-08-10,ES36209580831926802634,TRX_N-00189-01618535,2022-06-15T04:52:23,Berango,expenses,cash,-100.0,-6103.72
buyer_1,Luis,1996-08-10,ES36209580831926802634,TRX_N-00190-41363836,2022-06-17T09:55:05,Bilbao,expenses,leisure,-33.11,-6136.83
buyer_1,Luis,1996-08-10,ES36209580831926802634,TRX_N-00191-05190802,2022-06-17T19:57:28,Bilbao,expenses,education,-47.32,-6184.15
buyer_1,Luis,1996-08-10,ES36209580831926802634,TRX_N-00192-06898690,2022-06-17T08:20:29,Bilbao,expenses,travel,-1437.11,-7621.26
buyer_1,Luis,1996-08-10,ES36209580831926802634,TRX_N-00193-04472325,2022-06-19T19:52:36,Bilbao,expenses,food,-118.71,-7739.97
buyer_1,Luis,1996-08-10,ES36209580831926802634,TRX_N-00194-89700764,2022-06-21T19:38:04,Bilbao,expenses,food,-110.09,-7850.06
buyer_1,Luis,1996-08-10,ES36209580831926802634,TRX_N-00195-30342758,2022-06-22T13:58:10,Durango,expenses,appliances,-169.72,-8019.78
buyer_1,Luis,1996-08-10,ES36209580831926802634,TRX_N-00196-66760091,2022-06-24T08:28:35,Bilbao,expenses,leisure,-82.74,-8102.52
buyer_1,Luis,1996-08-10,ES36209580831926802634,TRX_N-00197-75622329,2022-06-26T12:12:44,Bilbao,expenses,food,-74.03,-8176.55
buyer_1,Luis,1996-08-10,ES36209580831926802634,TRX_N-00198-69186748,2022-06-26T20:47:46,Bilbao,expenses,education,-69.08,-8245.63
buyer_1,Luis,1996-08-10,ES36209580831926802634,TRX_N-00199-82932892,2022-06-29T19:47:42,Leioa,expenses,leisure,-52.0,-8297.63
buyer_1,Luis,1996-08-10,ES36209580831926802634,TRX_N-00200-73985885,2022-06-29T13:40:46,Bilbao,expenses,travel,-1105.83,-9403.46
buyer_1,Luis,1996-08-10,ES36209580831926802634,TRX_N-00201-27328573,2022-06-30T13:27:45,Bilbao,expenses,transport,-74.24,-9477.7
buyer_1,Luis,1996-08-10,ES36209580831926802634,TRX_N-00202-18652117,2022-06-30T19:24:27,Bilbao,expenses,travel,-578.02,-10055.72
buyer_1,Luis,1996-08-10,ES36209580831926802634,TRX_N-00203-82631572,2022-07-01T17:49:47,Bilbao,incomes,salary,1481.0,-8574.72
buyer_1,Luis,1996-08-10,ES36209580831926802634,TRX_N-00204-44528837,2022-07-01T17:49:47,Bilbao,incomes,salary_partner,1167.06,-7407.66
buyer_1,Luis,1996-08-10,ES36209580831926802634,TRX_N-00205-13886420,2022-07-01T17:49:47,Bilbao,incomes,extra_income,241.2,-7166.46
buyer_1,Luis,1996-08-10,ES36209580831926802634,TRX_N-00206-93784287,2022-07-01T12:12:11,Bilbao,expenses,clothing,-75.51,-7241.97
buyer_1,Luis,1996-08-10,ES36209580831926802634,TRX_N-00207-49231118,2022-07-02T19:16:52,Bilbao,expenses,clothing,-145.33,-7387.3
buyer_1,Luis,1996-08-10,ES36209580831926802634,TRX_N-00208-58605540,2022-07-03T18:59:02,Bilbao,expenses,leisure,-63.23,-7450.53
buyer_1,Luis,1996-08-10,ES36209580831926802634,TRX_N-00209-23894278,2022-07-04T17:36:50,Bilbao,expenses,mortgage,-743.13,-8193.66
buyer_1,Luis,1996-08-10,ES36209580831926802634,TRX_N-00210-75683641,2022-07-05T16:32:44,Bilbao,expenses,leisure,-72.01,-8265.67
buyer_1,Luis,1996-08-10,ES36209580831926802634,TRX_N-00211-26220993,2022-07-05T18:23:06,Bilbao,expenses,education,-56.85,-8322.52
buyer_1,Luis,1996-08-10,ES36209580831926802634,TRX_N-00212-19305767,2022-07-06T15:53:10,Bilbao,expenses,gas,-81.79,-8404.31
buyer_1,Luis,1996-08-10,ES36209580831926802634,TRX_N-00213-40259607,2022-07-06T17:28:48,Bilbao,expenses,internet,-42.0,-8446.31
buyer_1,Luis,1996-08-10,ES36209580831926802634,TRX_N-00214-52790731,2022-07-07T19:08:12,Bilbao,expenses,electricity,-69.75,-8516.06
buyer_1,Luis,1996-08-10,ES36209580831926802634,TRX_N-00215-13591239,2022-07-08T17:05:24,Bilbao,expenses,water,-38.37,-8554.43
buyer_1,Luis,1996-08-10,ES36209580831926802634,TRX_N-00216-15191105,2022-07-08T15:19:08,Bilbao,expenses,phone,-32.16,-8586.59
buyer_1,Luis,1996-08-10,ES36209580831926802634,TRX_N-00217-09565898,2022-07-08T17:39:02,Bilbao,expenses,food,-96.61,-8683.2
buyer_1,Luis,1996-08-10,ES36209580831926802634,TRX_N-00218-83811366,2022-07-08T11:54:11,Bilbao,expenses,leisure,-45.31,-8728.51
buyer_1,Luis,1996-08-10,ES36209580831926802634,TRX_N-00219-74896984,2022-07-08T15:29:33,Arrasate,expenses,cash,-100.0,-8828.51
buyer_1,Luis,1996-08-10,ES36209580831926802634,TRX_N-00220-97745663,2022-07-09T16:22:16,Bilbao,expenses,cash,-100.0,-8928.51
buyer_1,Luis,1996-08-10,ES36209580831926802634,TRX_N-00221-15177977,2022-07-09T23:15:18,Salvatierra/Agurain,expenses,repairs,-156.19,-9084.7
buyer_1,Luis,1996-08-10,ES36209580831926802634,TRX_N-00222-13256072,2022-07-10T08:46:38,Bilbao,expenses,transport,-55.58,-9140.28
buyer_1,Luis,1996-08-10,ES36209580831926802634,TRX_N-00223-02391305,2022-07-10T20:58:04,Bilbao,expenses,cash,-100.0,-9240.28
buyer_1,Luis,1996-08-10,ES36209580831926802634,TRX_N-00224-19441848,2022-07-11T19:39:34,Bilbao,expenses,cash,-100.0,-9340.28
buyer_1,Luis,1996-08-10,ES36209580831926802634,TRX_N-00225-38894502,2022-07-12T19:25:33,Eibar,expenses,education,-42.22,-9382.5
buyer_1,Luis,1996-08-10,ES36209580831926802634,TRX_N-00226-45937542,2022-07-13T11:51:57,Sestao,expenses,leisure,-59.83,-9442.33
buyer_1,Luis,1996-08-10,ES36209580831926802634,TRX_N-00227-79312663,2022-07-15T17:11:52,Bilbao,expenses,transport,-61.84,-9504.17
buyer_1,Luis,1996-08-10,ES36209580831926802634,TRX_N-00228-53743095,2022-07-15T12:17:20,Bilbao,expenses,repairs,-298.73,-9802.9
buyer_1,Luis,1996-08-10,ES36209580831926802634,TRX_N-00229-31198015,2022-07-15T19:00:25,Bilbao,expenses,children,-126.75,-9929.65
buyer_1,Luis,1996-08-10,ES36209580831926802634,TRX_N-00230-12838893,2022-07-16T20:24:12,Zuia,expenses,gifts,-28.11,-9957.76
buyer_1,Luis,1996-08-10,ES36209580831926802634,TRX_N-00231-49614441,2022-07-18T11:35:32,Bilbao,expenses,gifts,-333.79,-10291.55
buyer_1,Luis,1996-08-10,ES36209580831926802634,TRX_N-00232-26497842,2022-07-19T15:44:12,Bilbao,expenses,transport,-42.22,-10333.77
buyer_1,Luis,1996-08-10,ES36209580831926802634,TRX_N-00233-53965568,2022-07-20T14:01:32,Bilbao,expenses,repairs,-152.54,-10486.31
buyer_1,Luis,1996-08-10,ES36209580831926802634,TRX_N-00234-71004161,2022-07-22T12:38:29,Bilbao,expenses,repairs,-101.37,-10587.68
buyer_1,Luis,1996-08-10,ES36209580831926802634,TRX_N-00235-46918220,2022-07-23T14:11:51,Bilbao,expenses,transport,-60.74,-10648.42
buyer_1,Luis,1996-08-10,ES36209580831926802634,TRX_N-00236-68575853,2022-07-26T18:42:21,Bilbao,expenses,leisure,-72.28,-10720.7
buyer_1,Luis,1996-08-10,ES36209580831926802634,TRX_N-00237-79847345,2022-07-30T17:47:57,Bilbao,expenses,leisure,-83.21,-10803.91
buyer_1,Luis,1996-08-10,ES36209580831926802634,TRX_N-00238-59124361,2022-07-30T18:03:50,Leioa,expenses,gifts,-716.01,-11519.92
buyer_1,Luis,1996-08-10,ES36209580831926802634,TRX_N-00239-65783947,2022-07-31T17:03:57,Bilbao,expenses,healthcare,-75.38,-11595.3
buyer_1,Luis,1996-08-10,ES36209580831926802634,TRX_N-00240-45990124,2022-08-01T23:55:34,Bilbao,incomes,salary,1481.0,-10114.3
buyer_1,Luis,1996-08-10,ES36209580831926802634,TRX_N-00241-13901541,2022-08-01T23:55:34,Bilbao,incomes,salary_partner,1167.06,-8947.24
buyer_1,Luis,1996-08-10,ES36209580831926802634,TRX_N-00242-17900117,2022-08-02T11:24:43,Bilbao,expenses,repairs,-118.03,-9065.27
buyer_1,Luis,1996-08-10,ES36209580831926802634,TRX_N-00243-88667116,2022-08-04T02:39:27,Bilbao,expenses,mortgage,-743.13,-9808.4
buyer_1,Luis,1996-08-10,ES36209580831926802634,TRX_N-00244-04078618,2022-08-04T21:13:22,Bilbao,expenses,gifts,-411.17,-10219.57
buyer_1,Luis,1996-08-10,ES36209580831926802634,TRX_N-00245-03684387,2022-08-05T11:55:32,Bilbao,expenses,electricity,-26.23,-10245.8
buyer_1,Luis,1996-08-10,ES36209580831926802634,TRX_N-00246-75050378,2022-08-05T19:46:08,Bilbao,expenses,gas,-57.44,-10303.24
buyer_1,Luis,1996-08-10,ES36209580831926802634,TRX_N-00247-56813093,2022-08-05T06:32:35,Andoain,expenses,healthcare,-140.01,-10443.25
buyer_1,Luis,1996-08-10,ES36209580831926802634,TRX_N-00248-70768682,2022-08-06T07:20:45,Bilbao,expenses,phone,-44.24,-10487.49
buyer_1,Luis,1996-08-10,ES36209580831926802634,TRX_N-00249-21193019,2022-08-07T18:31:45,Bilbao,expenses,food,-93.58,-10581.07
buyer_1,Luis,1996-08-10,ES36209580831926802634,TRX_N-00250-46391072,2022-08-07T16:58:28,Bilbao,expenses,leisure,-38.97,-10620.04
buyer_1,Luis,1996-08-10,ES36209580831926802634,TRX_N-00251-64355905,2022-08-08T11:19:32,Bilbao,expenses,water,-20.56,-10640.6
buyer_1,Luis,1996-08-10,ES36209580831926802634,TRX_N-00252-77738227,2022-08-08T13:32:30,Bilbao,expenses,internet,-42.0,-10682.6
buyer_1,Luis,1996-08-10,ES36209580831926802634,TRX_N-00253-77542411,2022-08-09T08:07:56,Bilbao,expenses,leisure,-52.72,-10735.32
buyer_1,Luis,1996-08-10,ES36209580831926802634,TRX_N-00254-59550708,2022-08-09T13:43:18,Bilbao,expenses,gifts,-151.65,-10886.97
buyer_1,Luis,1996-08-10,ES36209580831926802634,TRX_N-00255-61228159,2022-08-09T22:23:08,Bilbao,expenses,children,-210.48,-11097.45
buyer_1,Luis,1996-08-10,ES36209580831926802634,TRX_N-00256-85844732,2022-08-10T16:50:09,Bilbao,expenses,leisure,-20.38,-11117.83
buyer_1,Luis,1996-08-10,ES36209580831926802634,TRX_N-00257-31227403,2022-08-11T12:19:49,Santurtzi,expenses,food,-109.65,-11227.48
buyer_1,Luis,1996-08-10,ES36209580831926802634,TRX_N-00258-04247916,2022-08-11T18:46:48,Donostia,expenses,gifts,-73.84,-11301.32
buyer_1,Luis,1996-08-10,ES36209580831926802634,TRX_N-00259-55960604,2022-08-13T09:57:25,Santurtzi,expenses,leisure,-67.09,-11368.41
buyer_1,Luis,1996-08-10,ES36209580831926802634,TRX_N-00260-75644984,2022-08-14T17:21:21,Bilbao,expenses,food,-121.98,-11490.39
buyer_1,Luis,1996-08-10,ES36209580831926802634,TRX_N-00261-04434451,2022-08-16T08:15:22,Bilbao,expenses,transport,-45.22,-11535.61
buyer_1,Luis,1996-08-10,ES36209580831926802634,TRX_N-00262-67730264,2022-08-16T20:49:25,Bilbao,expenses,cash,-100.0,-11635.61
buyer_1,Luis,1996-08-10,ES36209580831926802634,TRX_N-00263-71503085,2022-08-17T04:30:55,Bilbao,expenses,travel,-922.56,-12558.17
buyer_1,Luis,1996-08-10,ES36209580831926802634,TRX_N-00264-00445616,2022-08-19T11:54:05,Bilbao,expenses,food,-99.15,-12657.32
buyer_1,Luis,1996-08-10,ES36209580831926802634,TRX_N-00265-75857292,2022-08-19T18:51:31,Eibar,expenses,cash,-100.0,-12757.32
buyer_1,Luis,1996-08-10,ES36209580831926802634,TRX_N-00266-85248505,2022-08-20T08:45:00,Bilbao,expenses,leisure,-49.65,-12806.97
buyer_1,Luis,1996-08-10,ES36209580831926802634,TRX_N-00267-04017126,2022-08-21T18:04:00,Bilbao,expenses,food,-70.62,-12877.59
buyer_1,Luis,1996-08-10,ES36209580831926802634,TRX_N-00268-85026219,2022-08-26T14:03:45,Bilbao,expenses,transport,-63.26,-12940.85
buyer_1,Luis,1996-08-10,ES36209580831926802634,TRX_N-00269-38778650,2022-08-27T10:43:27,Bilbao,expenses,clothing,-93.09,-13033.94
buyer_1,Luis,1996-08-10,ES36209580831926802634,TRX_N-00270-57314843,2022-08-28T17:44:08,Bilbao,expenses,healthcare,-123.05,-13156.99
buyer_1,Luis,1996-08-10,ES36209580831926802634,TRX_N-00271-97843869,2022-08-28T17:00:24,Bilbao,expenses,cash,-100.0,-13256.99
buyer_1,Luis,1996-08-10,ES36209580831926802634,TRX_N-00272-85085765,2022-08-29T10:52:14,Leioa,expenses,appliances,-129.52,-13386.51
buyer_1,Luis,1996-08-10,ES36209580831926802634,TRX_N-00273-46020502,2022-09-01T01:06:11,Bilbao,incomes,salary,1481.0,-11905.51
buyer_1,Luis,1996-08-10,ES36209580831926802634,TRX_N-00274-47581133,2022-09-01T01:06:11,Bilbao,incomes,salary_partner,1167.06,-10738.45
buyer_1,Luis,1996-08-10,ES36209580831926802634,TRX_N-00275-70445595,2022-09-01T15:38:36,Bilbao,expenses,cash,-100.0,-10838.45
buyer_1,Luis,1996-08-10,ES36209580831926802634,TRX_N-00276-72298362,2022-09-02T13:42:03,Bilbao,expenses,clothing,-48.39,-10886.84
buyer_1,Luis,1996-08-10,ES36209580831926802634,TRX_N-00277-12248542,2022-09-03T10:20:57,Bilbao,expenses,food,-91.51,-10978.35
buyer_1,Luis,1996-08-10,ES36209580831926802634,TRX_N-00278-06492070,2022-09-03T18:49:49,Bilbao,expenses,transport,-41.0,-11019.35
buyer_1,Luis,1996-08-10,ES36209580831926802634,TRX_N-00279-51882726,2022-09-03T19:21:15,Bilbao,expenses,clothing,-110.7,-11130.05
buyer_1,Luis,1996-08-10,ES36209580831926802634,TRX_N-00280-55432675,2022-09-04T23:08:25,Bilbao,expenses,mortgage,-743.13,-11873.18
buyer_1,Luis,1996-08-10,ES36209580831926802634,TRX_N-00281-28551405,2022-09-05T15:10:01,Bilbao,expenses,healthcare,-66.82,-11940.0
buyer_1,Luis,1996-08-10,ES36209580831926802634,TRX_N-00282-87033829,2022-09-06T18:21:52,Bilbao,expenses,gas,-112.15,-12052.15
buyer_1,Luis,1996-08-10,ES36209580831926802634,TRX_N-00283-27327875,2022-09-06T09:45:12,Bilbao,expenses,clothing,-89.15,-12141.3
buyer_1,Luis,1996-08-10,ES36209580831926802634,TRX_N-00284-65794256,2022-09-06T14:35:47,Bilbao,expenses,cash,-100.0,-12241.3
buyer_1,Luis,1996-08-10,ES36209580831926802634,TRX_N-00285-48351647,2022-09-07T19:13:42,Bilbao,expenses,internet,-42.0,-12283.3
buyer_1,Luis,1996-08-10,ES36209580831926802634,TRX_N-00286-05737823,2022-09-08T11:38:39,Bilbao,expenses,water,-35.05,-12318.35
buyer_1,Luis,1996-08-10,ES36209580831926802634,TRX_N-00287-86763892,2022-09-08T11:57:59,Bilbao,expenses,electricity,-71.22,-12389.57
buyer_1,Luis,1996-08-10,ES36209580831926802634,TRX_N-00288-25327333,2022-09-08T18:01:34,Bilbao,expenses,phone,-36.44,-12426.01
buyer_1,Luis,1996-08-10,ES36209580831926802634,TRX_N-00289-31575797,2022-09-08T09:17:53,Bilbao,expenses,transport,-62.34,-12488.35
buyer_1,Luis,1996-08-10,ES36209580831926802634,TRX_N-00290-75932456,2022-09-09T20:05:24,Bilbao,expenses,transport,-74.87,-12563.22
buyer_1,Luis,1996-08-10,ES36209580831926802634,TRX_N-00291-30075898,2022-09-10T18:49:42,Bilbao,expenses,transport,-41.65,-12604.87
buyer_1,Luis,1996-08-10,ES36209580831926802634,TRX_N-00292-32010940,2022-09-11T22:05:56,Bilbao,expenses,appliances,-274.98,-12879.85
buyer_1,Luis,1996-08-10,ES36209580831926802634,TRX_N-00293-29121875,2022-09-12T17:04:20,Bilbao,expenses,food,-107.01,-12986.86
buyer_1,Luis,1996-08-10,ES36209580831926802634,TRX_N-00294-81604598,2022-09-12T11:09:09,Bilbao,expenses,education,-53.56,-13040.42
buyer_1,Luis,1996-08-10,ES36209580831926802634,TRX_N-00295-10025278,2022-09-12T11:29:11,Bilbao,expenses,gifts,-329.52,-13369.94
buyer_1,Luis,1996-08-10,ES36209580831926802634,TRX_N-00296-49291901,2022-09-14T19:40:10,Bilbao,expenses,repairs,-151.88,-13521.82
buyer_1,Luis,1996-08-10,ES36209580831926802634,TRX_N-00297-89960819,2022-09-15T18:40:23,Bilbao,expenses,cash,-100.0,-13621.82
buyer_1,Luis,1996-08-10,ES36209580831926802634,TRX_N-00298-11574476,2022-09-17T10:22:46,Bilbao,expenses,transport,-49.68,-13671.5
buyer_1,Luis,1996-08-10,ES36209580831926802634,TRX_N-00299-57931608,2022-09-18T20:50:49,Bilbao,expenses,leisure,-59.33,-13730.83
buyer_1,Luis,1996-08-10,ES36209580831926802634,TRX_N-00300-80834620,2022-09-18T15:28:13,Bilbao,expenses,children,-240.38,-13971.21
buyer_1,Luis,1996-08-10,ES36209580831926802634,TRX_N-00301-78348929,2022-09-19T19:41:21,Bilbao,expenses,food,-64.22,-14035.43
buyer_1,Luis,1996-08-10,ES36209580831926802634,TRX_N-00302-00840071,2022-09-19T15:54:36,Bilbao,expenses,transport,-70.02,-14105.45
buyer_1,Luis,1996-08-10,ES36209580831926802634,TRX_N-00303-57399208,2022-09-19T12:57:04,Bilbao,expenses,leisure,-54.15,-14159.6
buyer_1,Luis,1996-08-10,ES36209580831926802634,TRX_N-00304-78955465,2022-09-19T12:58:34,Bilbao,expenses,repairs,-137.94,-14297.54
buyer_1,Luis,1996-08-10,ES36209580831926802634,TRX_N-00305-68091848,2022-09-24T12:09:20,Bilbao,expenses,travel,-1415.17,-15712.71
buyer_1,Luis,1996-08-10,ES36209580831926802634,TRX_N-00306-62077327,2022-09-25T10:51:51,Bilbao,expenses,transport,-71.52,-15784.23
buyer_1,Luis,1996-08-10,ES36209580831926802634,TRX_N-00307-91108890,2022-09-25T11:16:05,Bilbao,expenses,gifts,-34.08,-15818.31
buyer_1,Luis,1996-08-10,ES36209580831926802634,TRX_N-00308-14504634,2022-09-27T14:21:07,Bilbao,expenses,food,-111.68,-15929.99
buyer_1,Luis,1996-08-10,ES36209580831926802634,TRX_N-00309-22876301,2022-09-27T19:59:19,Bilbao,expenses,leisure,-64.32,-15994.31
buyer_1,Luis,1996-08-10,ES36209580831926802634,TRX_N-00310-49292855,2022-09-28T21:55:07,Bilbao,expenses,food,-83.58,-16077.89
buyer_1,Luis,1996-08-10,ES36209580831926802634,TRX_N-00311-05356247,2022-09-28T08:19:16,Bilbao,expenses,transport,-84.68,-16162.57
buyer_1,Luis,1996-08-10,ES36209580831926802634,TRX_N-00312-08259365,2022-10-01T15:13:51,Bilbao,incomes,salary,1481.0,-14681.57
buyer_1,Luis,1996-08-10,ES36209580831926802634,TRX_N-00313-30623856,2022-10-01T15:13:51,Bilbao,incomes,salary_partner,1167.06,-13514.51
buyer_1,Luis,1996-08-10,ES36209580831926802634,TRX_N-00314-69868590,2022-10-01T15:13:51,Bilbao,incomes,extra_income,241.2,-13273.31
buyer_1,Luis,1996-08-10,ES36209580831926802634,TRX_N-00315-57296607,2022-10-02T16:35:31,Bilbao,expenses,cash,-100.0,-13373.31
buyer_1,Luis,1996-08-10,ES36209580831926802634,TRX_N-00316-79515179,2022-10-04T12:11:20,Bilbao,expenses,mortgage,-743.13,-14116.44
buyer_1,Luis,1996-08-10,ES36209580831926802634,TRX_N-00317-58918469,2022-10-05T17:02:54,Bilbao,expenses,transport,-89.11,-14205.55
buyer_1,Luis,1996-08-10,ES36209580831926802634,TRX_N-00318-93096260,2022-10-06T10:54:01,Bilbao,expenses,gas,-79.45,-14285.0
buyer_1,Luis,1996-08-10,ES36209580831926802634,TRX_N-00319-99914791,2022-10-06T11:44:05,Bilbao,expenses,internet,-42.0,-14327.0
buyer_1,Luis,1996-08-10,ES36209580831926802634,TRX_N-00320-70851964,2022-10-06T16:24:07,Bilbao,expenses,phone,-35.35,-14362.35
buyer_1,Luis,1996-08-10,ES36209580831926802634,TRX_N-00321-19588500,2022-10-08T09:07:39,Bilbao,expenses,water,-44.03,-14406.38
buyer_1,Luis,1996-08-10,ES36209580831926802634,TRX_N-00322-45040500,2022-10-08T08:22:51,Bilbao,expenses,electricity,-21.47,-14427.85
buyer_1,Luis,1996-08-10,ES36209580831926802634,TRX_N-00323-55539771,2022-10-08T21:49:21,Bilbao,expenses,appliances,-257.44,-14685.29
buyer_1,Luis,1996-08-10,ES36209580831926802634,TRX_N-00324-10564894,2022-10-09T16:50:17,Bilbao,expenses,clothing,-130.38,-14815.67
buyer_1,Luis,1996-08-10,ES36209580831926802634,TRX_N-00325-47637273,2022-10-09T15:16:01,Bilbao,expenses,cash,-100.0,-14915.67
buyer_1,Luis,1996-08-10,ES36209580831926802634,TRX_N-00326-33130464,2022-10-10T23:23:59,Bilbao,expenses,cash,-100.0,-15015.67
buyer_1,Luis,1996-08-10,ES36209580831926802634,TRX_N-00327-09726383,2022-10-10T06:55:04,Bilbao,expenses,repairs,-190.76,-15206.43
buyer_1,Luis,1996-08-10,ES36209580831926802634,TRX_N-00328-60960706,2022-10-11T18:43:23,Salvatierra/Agurain,expenses,cash,-100.0,-15306.43
buyer_1,Luis,1996-08-10,ES36209580831926802634,TRX_N-00329-85450707,2022-10-12T12:59:03,Salvatierra/Agurain,expenses,leisure,-52.13,-15358.56
buyer_1,Luis,1996-08-10,ES36209580831926802634,TRX_N-00330-62407277,2022-10-12T18:25:24,Bilbao,expenses,education,-65.65,-15424.21
buyer_1,Luis,1996-08-10,ES36209580831926802634,TRX_N-00331-12919395,2022-10-13T23:28:35,Bilbao,expenses,leisure,-84.46,-15508.67
buyer_1,Luis,1996-08-10,ES36209580831926802634,TRX_N-00332-05400191,2022-10-13T13:18:25,Bilbao,expenses,children,-183.59,-15692.26
buyer_1,Luis,1996-08-10,ES36209580831926802634,TRX_N-00333-17069535,2022-10-14T12:17:19,Bilbao,expenses,healthcare,-149.58,-15841.84
buyer_1,Luis,1996-08-10,ES36209580831926802634,TRX_N-00334-84052862,2022-10-14T15:06:48,Bilbao,expenses,gifts,-374.08,-16215.92
buyer_1,Luis,1996-08-10,ES36209580831926802634,TRX_N-00335-69850227,2022-10-15T08:25:35,Bilbao,expenses,appliances,-407.95,-16623.87
buyer_1,Luis,1996-08-10,ES36209580831926802634,TRX_N-00336-87530143,2022-10-16T17:54:12,Bilbao,expenses,leisure,-79.2,-16703.07
buyer_1,Luis,1996-08-10,ES36209580831926802634,TRX_N-00337-14530584,2022-10-17T14:18:13,Bilbao,expenses,children,-195.51,-16898.58
buyer_1,Luis,1996-08-10,ES36209580831926802634,TRX_N-00338-87568530,2022-10-20T19:24:17,Bilbao,expenses,transport,-73.86,-16972.44
buyer_1,Luis,1996-08-10,ES36209580831926802634,TRX_N-00339-97664369,2022-10-21T09:21:03,Bilbao,expenses,repairs,-38.12,-17010.56
buyer_1,Luis,1996-08-10,ES36209580831926802634,TRX_N-00340-57210022,2022-10-23T17:03:36,Alegría-Dulantzi,expenses,gifts,-73.16,-17083.72
buyer_1,Luis,1996-08-10,ES36209580831926802634,TRX_N-00341-98597299,2022-10-24T14:25:41,Bilbao,expenses,education,-63.57,-17147.29
buyer_1,Luis,1996-08-10,ES36209580831926802634,TRX_N-00342-91566835,2022-10-28T16:59:18,Bilbao,expenses,food,-112.7,-17259.99
buyer_1,Luis,1996-08-10,ES36209580831926802634,TRX_N-00343-24995517,2022-10-29T16:13:54,Bilbao,expenses,leisure,-77.86,-17337.85
buyer_1,Luis,1996-08-10,ES36209580831926802634,TRX_N-00344-12422738,2022-10-30T11:42:07,Santurtzi,expenses,transport,-70.82,-17408.67
buyer_1,Luis,1996-08-10,ES36209580831926802634,TRX_N-00345-04484219,2022-10-30T16:54:58,Bilbao,expenses,repairs,-34.32,-17442.99
buyer_1,Luis,1996-08-10,ES36209580831926802634,TRX_N-00346-75589913,2022-10-31T09:40:49,Bilbao,expenses,cash,-100.0,-17542.99
buyer_1,Luis,1996-08-10,ES36209580831926802634,TRX_N-00347-34964112,2022-11-01T17:09:29,Bilbao,incomes,salary,1481.0,-16061.99
buyer_1,Luis,1996-08-10,ES36209580831926802634,TRX_N-00348-90925995,2022-11-01T17:09:29,Bilbao,incomes,salary_partner,1167.06,-14894.93
buyer_1,Luis,1996-08-10,ES36209580831926802634,TRX_N-00349-30914905,2022-11-03T04:32:51,Bilbao,expenses,transport,-84.63,-14979.56
buyer_1,Luis,1996-08-10,ES36209580831926802634,TRX_N-00350-50166939,2022-11-03T12:09:41,Llodio,expenses,cash,-100.0,-15079.56
buyer_1,Luis,1996-08-10,ES36209580831926802634,TRX_N-00351-95188698,2022-11-04T20:17:12,Bilbao,expenses,mortgage,-743.13,-15822.69
buyer_1,Luis,1996-08-10,ES36209580831926802634,TRX_N-00352-40699393,2022-11-05T09:13:52,Bilbao,expenses,children,-227.66,-16050.35
buyer_1,Luis,1996-08-10,ES36209580831926802634,TRX_N-00353-12617502,2022-11-06T07:34:30,Bilbao,expenses,phone,-44.86,-16095.21
buyer_1,Luis,1996-08-10,ES36209580831926802634,TRX_N-00354-41931950,2022-11-06T09:08:18,Bilbao,expenses,leisure,-20.0,-16115.21
buyer_1,Luis,1996-08-10,ES36209580831926802634,TRX_N-00355-23948958,2022-11-07T21:19:07,Bilbao,expenses,gas,-72.56,-16187.77
buyer_1,Luis,1996-08-10,ES36209580831926802634,TRX_N-00356-89356511,2022-11-07T16:12:35,Bilbao,expenses,internet,-42.0,-16229.77
buyer_1,Luis,1996-08-10,ES36209580831926802634,TRX_N-00357-69686780,2022-11-07T16:38:29,Bilbao,expenses,gifts,-500.44,-16730.21
buyer_1,Luis,1996-08-10,ES36209580831926802634,TRX_N-00358-18278761,2022-11-08T09:08:46,Bilbao,expenses,electricity,-25.12,-16755.33
buyer_1,Luis,1996-08-10,ES36209580831926802634,TRX_N-00359-59299446,2022-11-08T08:37:44,Bilbao,expenses,water,-39.79,-16795.12
buyer_1,Luis,1996-08-10,ES36209580831926802634,TRX_N-00360-61594995,2022-11-08T23:03:42,Bilbao,expenses,food,-98.78,-16893.9
buyer_1,Luis,1996-08-10,ES36209580831926802634,TRX_N-00361-32431821,2022-11-08T18:54:26,Zuia,expenses,transport,-89.91,-16983.81
buyer_1,Luis,1996-08-10,ES36209580831926802634,TRX_N-00362-26117569,2022-11-08T09:06:41,Bilbao,expenses,healthcare,-94.25,-17078.06
buyer_1,Luis,1996-08-10,ES36209580831926802634,TRX_N-00363-12099953,2022-11-09T18:26:58,Bilbao,expenses,cash,-100.0,-17178.06
buyer_1,Luis,1996-08-10,ES36209580831926802634,TRX_N-00364-07148924,2022-11-10T15:05:29,Bilbao,expenses,cash,-100.0,-17278.06
buyer_1,Luis,1996-08-10,ES36209580831926802634,TRX_N-00365-27283478,2022-11-12T14:55:21,Bilbao,expenses,transport,-69.94,-17348.0
buyer_1,Luis,1996-08-10,ES36209580831926802634,TRX_N-00366-63121997,2022-11-12T11:42:32,Bilbao,expenses,leisure,-29.48,-17377.48
buyer_1,Luis,1996-08-10,ES36209580831926802634,TRX_N-00367-73404115,2022-11-17T14:17:26,Errenteria,expenses,leisure,-55.91,-17433.39
buyer_1,Luis,1996-08-10,ES36209580831926802634,TRX_N-00368-90130823,2022-11-19T18:42:35,Bilbao,expenses,repairs,-28.66,-17462.05
buyer_1,Luis,1996-08-10,ES36209580831926802634,TRX_N-00369-80557299,2022-11-21T07:14:32,Bilbao,expenses,cash,-100.0,-17562.05
buyer_1,Luis,1996-08-10,ES36209580831926802634,TRX_N-00370-32816577,2022-11-27T18:28:10,Bilbao,expenses,food,-86.01,-17648.06
buyer_1,Luis,1996-08-10,ES36209580831926802634,TRX_N-00371-48815611,2022-11-27T23:58:14,Bilbao,expenses,leisure,-28.68,-17676.74
buyer_1,Luis,1996-08-10,ES36209580831926802634,TRX_N-00372-75952215,2022-11-28T18:26:14,Bilbao,expenses,children,-60.43,-17737.17
buyer_1,Luis,1996-08-10,ES36209580831926802634,TRX_N-00373-64373156,2022-11-29T09:04:23,Bilbao,expenses,food,-96.75,-17833.92
buyer_1,Luis,1996-08-10,ES36209580831926802634,TRX_N-00374-36559858,2022-11-30T04:36:50,Bilbao,expenses,transport,-50.58,-17884.5
buyer_1,Luis,1996-08-10,ES36209580831926802634,TRX_N-00375-29822899,2022-12-01T00:53:07,Bilbao,incomes,salary,1481.0,-16403.5
buyer_1,Luis,1996-08-10,ES36209580831926802634,TRX_N-00376-53927899,2022-12-01T00:53:07,Bilbao,incomes,salary_partner,1167.06,-15236.44
buyer_1,Luis,1996-08-10,ES36209580831926802634,TRX_N-00377-24753045,2022-12-01T00:53:07,Bilbao,incomes,salary_bonus,1041.78,-14194.66
buyer_1,Luis,1996-08-10,ES36209580831926802634,TRX_N-00378-84703388,2022-12-01T00:53:07,Bilbao,incomes,salary_partner_bonus,837.15,-13357.51
buyer_1,Luis,1996-08-10,ES36209580831926802634,TRX_N-00379-28356862,2022-12-04T08:47:13,Bilbao,expenses,mortgage,-743.13,-14100.64
buyer_1,Luis,1996-08-10,ES36209580831926802634,TRX_N-00380-95934365,2022-12-05T08:31:29,Bilbao,expenses,water,-43.27,-14143.91
buyer_1,Luis,1996-08-10,ES36209580831926802634,TRX_N-00381-43940941,2022-12-05T05:22:18,Bilbao,expenses,electricity,-47.59,-14191.5
buyer_1,Luis,1996-08-10,ES36209580831926802634,TRX_N-00382-17769347,2022-12-05T16:27:30,Bilbao,expenses,gas,-74.05,-14265.55
buyer_1,Luis,1996-08-10,ES36209580831926802634,TRX_N-00383-87275793,2022-12-05T22:00:29,Bilbao,expenses,internet,-42.0,-14307.55
buyer_1,Luis,1996-08-10,ES36209580831926802634,TRX_N-00384-84562974,2022-12-06T15:52:16,Bilbao,expenses,food,-80.15,-14387.7
buyer_1,Luis,1996-08-10,ES36209580831926802634,TRX_N-00385-20050770,2022-12-06T17:02:44,Bilbao,expenses,education,-45.65,-14433.35
buyer_1,Luis,1996-08-10,ES36209580831926802634,TRX_N-00386-57610571,2022-12-06T11:18:44,Bilbao,expenses,gifts,-731.94,-15165.29
buyer_1,Luis,1996-08-10,ES36209580831926802634,TRX_N-00387-56423431,2022-12-07T13:12:21,Bilbao,expenses,food,-105.05,-15270.34
buyer_1,Luis,1996-08-10,ES36209580831926802634,TRX_N-00388-19326064,2022-12-08T23:27:37,Bilbao,expenses,phone,-44.26,-15314.6
buyer_1,Luis,1996-08-10,ES36209580831926802634,TRX_N-00389-56010930,2022-12-08T15:34:13,Bilbao,expenses,repairs,-164.58,-15479.18
buyer_1,Luis,1996-08-10,ES36209580831926802634,TRX_N-00390-30695633,2022-12-10T01:18:52,Durango,expenses,appliances,-323.28,-15802.46
buyer_1,Luis,1996-08-10,ES36209580831926802634,TRX_N-00391-64592918,2022-12-11T08:46:34,Bilbao,expenses,leisure,-69.76,-15872.22
buyer_1,Luis,1996-08-10,ES36209580831926802634,TRX_N-00392-10976169,2022-12-12T13:25:13,Donostia,expenses,transport,-57.88,-15930.1
buyer_1,Luis,1996-08-10,ES36209580831926802634,TRX_N-00393-94289228,2022-12-13T10:23:06,Bilbao,expenses,food,-114.66,-16044.76
buyer_1,Luis,1996-08-10,ES36209580831926802634,TRX_N-00394-39154785,2022-12-15T19:33:41,Bilbao,expenses,healthcare,-96.03,-16140.79
buyer_1,Luis,1996-08-10,ES36209580831926802634,TRX_N-00395-02392997,2022-12-15T13:46:16,Bilbao,expenses,cash,-100.0,-16240.79
buyer_1,Luis,1996-08-10,ES36209580831926802634,TRX_N-00396-40518275,2022-12-16T14:07:35,Salvatierra/Agurain,expenses,leisure,-49.88,-16290.67
buyer_1,Luis,1996-08-10,ES36209580831926802634,TRX_N-00397-57912444,2022-12-16T21:57:41,Bilbao,expenses,cash,-100.0,-16390.67
buyer_1,Luis,1996-08-10,ES36209580831926802634,TRX_N-00398-36973662,2022-12-18T11:06:25,Bilbao,expenses,cash,-100.0,-16490.67
buyer_1,Luis,1996-08-10,ES36209580831926802634,TRX_N-00399-07090790,2022-12-19T08:29:48,Bilbao,expenses,children,-106.36,-16597.03
buyer_1,Luis,1996-08-10,ES36209580831926802634,TRX_N-00400-96316105,2022-12-21T17:25:16,Bilbao,expenses,food,-68.78,-16665.81
buyer_1,Luis,1996-08-10,ES36209580831926802634,TRX_N-00401-07661500,2022-12-22T10:30:52,Bilbao,expenses,cash,-100.0,-16765.81
buyer_1,Luis,1996-08-10,ES36209580831926802634,TRX_N-00402-86330055,2022-12-23T10:29:34,Bilbao,expenses,repairs,-240.53,-17006.34
buyer_1,Luis,1996-08-10,ES36209580831926802634,TRX_N-00403-76674617,2022-12-26T00:26:47,Bilbao,expenses,cash,-100.0,-17106.34
buyer_1,Luis,1996-08-10,ES36209580831926802634,TRX_N-00404-59439314,2022-12-27T16:07:46,Bilbao,expenses,healthcare,-71.85,-17178.19
buyer_1,Luis,1996-08-10,ES36209580831926802634,TRX_N-00405-95884504,2022-12-28T18:01:09,Mungia,expenses,transport,-46.65,-17224.84
buyer_1,Luis,1996-08-10,ES36209580831926802634,TRX_N-00406-20657941,2022-12-30T09:42:40,Bilbao,expenses,education,-51.11,-17275.95
buyer_1,Luis,1996-08-10,ES36209580831926802634,TRX_N-00407-18201500,2022-12-30T08:56:10,Bilbao,expenses,children,-277.32,-17553.27
buyer_1,Luis,1996-08-10,ES36209580831926802634,TRX_N-00408-18899817,2023-01-01T10:23:36,Bilbao,incomes,salary,1516.22,-16037.05
buyer_1,Luis,1996-08-10,ES36209580831926802634,TRX_N-00409-32995197,2023-01-01T10:23:36,Bilbao,incomes,salary_partner,1194.81,-14842.24
buyer_1,Luis,1996-08-10,ES36209580831926802634,TRX_N-00410-01387695,2023-01-01T18:53:15,Bilbao,expenses,food,-90.55,-14932.79
buyer_1,Luis,1996-08-10,ES36209580831926802634,TRX_N-00411-87616279,2023-01-03T09:53:08,Bilbao,expenses,clothing,-154.99,-15087.78
buyer_1,Luis,1996-08-10,ES36209580831926802634,TRX_N-00412-92230562,2023-01-03T22:24:51,Bilbao,expenses,cash,-100.0,-15187.78
buyer_1,Luis,1996-08-10,ES36209580831926802634,TRX_N-00413-13366098,2023-01-04T13:55:12,Bilbao,expenses,mortgage,-743.13,-15930.91
buyer_1,Luis,1996-08-10,ES36209580831926802634,TRX_N-00414-06280770,2023-01-04T08:22:01,Bilbao,expenses,gifts,-382.68,-16313.59
buyer_1,Luis,1996-08-10,ES36209580831926802634,TRX_N-00415-56095211,2023-01-06T15:58:25,Bilbao,expenses,phone,-35.94,-16349.53
buyer_1,Luis,1996-08-10,ES36209580831926802634,TRX_N-00416-48388066,2023-01-06T17:42:23,Bilbao,expenses,education,-67.26,-16416.79
buyer_1,Luis,1996-08-10,ES36209580831926802634,TRX_N-00417-91989994,2023-01-06T13:32:53,Bilbao,expenses,repairs,-328.76,-16745.55
buyer_1,Luis,1996-08-10,ES36209580831926802634,TRX_N-00418-47870238,2023-01-08T11:19:25,Bilbao,expenses,water,-34.93,-16780.48
buyer_1,Luis,1996-08-10,ES36209580831926802634,TRX_N-00419-73333912,2023-01-08T15:59:53,Bilbao,expenses,electricity,-50.89,-16831.37
buyer_1,Luis,1996-08-10,ES36209580831926802634,TRX_N-00420-70218538,2023-01-08T12:31:40,Bilbao,expenses,gas,-83.85,-16915.22
buyer_1,Luis,1996-08-10,ES36209580831926802634,TRX_N-00421-99415734,2023-01-08T11:30:54,Bilbao,expenses,internet,-42.0,-16957.22
buyer_1,Luis,1996-08-10,ES36209580831926802634,TRX_N-00422-71192822,2023-01-08T00:16:44,Bilbao,expenses,education,-65.44,-17022.66
buyer_1,Luis,1996-08-10,ES36209580831926802634,TRX_N-00423-84037918,2023-01-08T14:19:13,Barakaldo,expenses,repairs,-48.53,-17071.19
buyer_1,Luis,1996-08-10,ES36209580831926802634,TRX_N-00424-40195292,2023-01-09T19:44:00,Bilbao,expenses,cash,-100.0,-17171.19
buyer_1,Luis,1996-08-10,ES36209580831926802634,TRX_N-00425-28950378,2023-01-10T17:17:52,Bilbao,expenses,food,-119.74,-17290.93
buyer_1,Luis,1996-08-10,ES36209580831926802634,TRX_N-00426-55993216,2023-01-11T13:13:48,Bilbao,expenses,transport,-77.22,-17368.15
buyer_1,Luis,1996-08-10,ES36209580831926802634,TRX_N-00427-73255845,2023-01-11T15:31:30,Bilbao,expenses,children,-84.04,-17452.19
buyer_1,Luis,1996-08-10,ES36209580831926802634,TRX_N-00428-81850859,2023-01-13T18:27:44,Getxo,expenses,food,-99.66,-17551.85
buyer_1,Luis,1996-08-10,ES36209580831926802634,TRX_N-00429-19875817,2023-01-13T20:55:09,Bilbao,expenses,healthcare,-77.57,-17629.42
buyer_1,Luis,1996-08-10,ES36209580831926802634,TRX_N-00430-91656767,2023-01-18T14:23:46,Bilbao,expenses,transport,-55.78,-17685.2
buyer_1,Luis,1996-08-10,ES36209580831926802634,TRX_N-00431-99880535,2023-01-18T13:35:28,Zarautz,expenses,cash,-100.0,-17785.2
buyer_1,Luis,1996-08-10,ES36209580831926802634,TRX_N-00432-59449323,2023-01-20T17:29:08,Bilbao,expenses,transport,-83.62,-17868.82
buyer_1,Luis,1996-08-10,ES36209580831926802634,TRX_N-00433-23746126,2023-01-22T17:41:54,Bilbao,expenses,leisure,-54.68,-17923.5
buyer_1,Luis,1996-08-10,ES36209580831926802634,TRX_N-00434-54598522,2023-01-23T17:44:53,Bilbao,expenses,food,-120.94,-18044.44
buyer_1,Luis,1996-08-10,ES36209580831926802634,TRX_N-00435-48926013,2023-01-23T11:28:37,Bilbao,expenses,transport,-74.96,-18119.4
buyer_1,Luis,1996-08-10,ES36209580831926802634,TRX_N-00436-32299367,2023-01-24T13:42:50,Bilbao,expenses,cash,-100.0,-18219.4
buyer_1,Luis,1996-08-10,ES36209580831926802634,TRX_N-00437-95286994,2023-01-25T15:22:16,Bilbao,expenses,transport,-83.21,-18302.61
buyer_1,Luis,1996-08-10,ES36209580831926802634,TRX_N-00438-30940543,2023-01-25T20:48:12,Llodio,expenses,clothing,-90.37,-18392.98
buyer_1,Luis,1996-08-10,ES36209580831926802634,TRX_N-00439-10777388,2023-01-26T23:53:53,Bilbao,expenses,healthcare,-96.37,-18489.35
buyer_1,Luis,1996-08-10,ES36209580831926802634,TRX_N-00440-76293919,2023-01-26T16:53:54,Bilbao,expenses,education,-65.8,-18555.15
buyer_1,Luis,1996-08-10,ES36209580831926802634,TRX_N-00441-76936859,2023-01-27T10:29:37,Bilbao,expenses,repairs,-56.51,-18611.66
buyer_1,Luis,1996-08-10,ES36209580831926802634,TRX_N-00442-10664313,2023-01-27T19:49:20,Bilbao,expenses,gifts,-288.81,-18900.47
buyer_1,Luis,1996-08-10,ES36209580831926802634,TRX_N-00443-53188007,2023-01-28T20:08:23,Leioa,expenses,food,-94.48,-18994.95
buyer_1,Luis,1996-08-10,ES36209580831926802634,TRX_N-00444-13550322,2023-01-28T11:09:59,Bilbao,expenses,gifts,-48.27,-19043.22
buyer_1,Luis,1996-08-10,ES36209580831926802634,TRX_N-00445-81833655,2023-01-29T11:02:31,Bilbao,expenses,repairs,-236.07,-19279.29
buyer_1,Luis,1996-08-10,ES36209580831926802634,TRX_N-00446-01449408,2023-01-30T17:56:45,Barakaldo,expenses,gifts,-199.36,-19478.65
buyer_1,Luis,1996-08-10,ES36209580831926802634,TRX_N-00447-41505407,2023-02-01T20:09:31,Bilbao,incomes,salary,1516.22,-17962.43
buyer_1,Luis,1996-08-10,ES36209580831926802634,TRX_N-00448-96805308,2023-02-01T20:09:31,Bilbao,incomes,salary_partner,1194.81,-16767.62
buyer_1,Luis,1996-08-10,ES36209580831926802634,TRX_N-00449-43184051,2023-02-01T20:09:31,Bilbao,incomes,extra_income,241.2,-16526.42
buyer_1,Luis,1996-08-10,ES36209580831926802634,TRX_N-00450-34914446,2023-02-01T08:00:39,Bilbao,expenses,food,-109.76,-16636.18
buyer_1,Luis,1996-08-10,ES36209580831926802634,TRX_N-00451-57692768,2023-02-01T14:01:47,Bilbao,expenses,transport,-75.77,-16711.95
buyer_1,Luis,1996-08-10,ES36209580831926802634,TRX_N-00452-37725434,2023-02-01T10:12:16,Bilbao,expenses,gifts,-371.1,-17083.05
buyer_1,Luis,1996-08-10,ES36209580831926802634,TRX_N-00453-66610946,2023-02-02T12:21:26,Bilbao,expenses,leisure,-47.84,-17130.89
buyer_1,Luis,1996-08-10,ES36209580831926802634,TRX_N-00454-37959138,2023-02-04T09:47:57,Bilbao,expenses,mortgage,-743.13,-17874.02
buyer_1,Luis,1996-08-10,ES36209580831926802634,TRX_N-00455-78838224,2023-02-05T15:25:51,Eibar,expenses,education,-50.42,-17924.44
buyer_1,Luis,1996-08-10,ES36209580831926802634,TRX_N-00456-54197583,2023-02-05T15:36:23,Pasaia,expenses,gifts,-46.88,-17971.32
buyer_1,Luis,1996-08-10,ES36209580831926802634,TRX_N-00457-31479434,2023-02-06T16:27:09,Bilbao,expenses,water,-24.7,-17996.02
buyer_1,Luis,1996-08-10,ES36209580831926802634,TRX_N-00458-36313456,2023-02-06T10:07:33,Bilbao,expenses,gas,-87.28,-18083.3
buyer_1,Luis,1996-08-10,ES36209580831926802634,TRX_N-00459-48831658,2023-02-07T12:13:11,Bilbao,expenses,electricity,-48.68,-18131.98
buyer_1,Luis,1996-08-10,ES36209580831926802634,TRX_N-00460-38337008,2023-02-07T10:05:46,Bilbao,expenses,cash,-100.0,-18231.98
buyer_1,Luis,1996-08-10,ES36209580831926802634,TRX_N-00461-99296637,2023-02-08T16:53:17,Bilbao,expenses,internet,-42.0,-18273.98
buyer_1,Luis,1996-08-10,ES36209580831926802634,TRX_N-00462-04625207,2023-02-08T12:50:28,Bilbao,expenses,phone,-42.1,-18316.08
buyer_1,Luis,1996-08-10,ES36209580831926802634,TRX_N-00463-23916886,2023-02-10T10:03:50,Bilbao,expenses,clothing,-51.96,-18368.04
buyer_1,Luis,1996-08-10,ES36209580831926802634,TRX_N-00464-16717595,2023-02-11T17:56:34,Vitoria-Gasteiz,expenses,cash,-100.0,-18468.04
buyer_1,Luis,1996-08-10,ES36209580831926802634,TRX_N-00465-18621933,2023-02-14T21:49:02,Bilbao,expenses,clothing,-125.3,-18593.34
buyer_1,Luis,1996-08-10,ES36209580831926802634,TRX_N-00466-09424734,2023-02-15T20:07:03,Bilbao,expenses,food,-102.96,-18696.3
buyer_1,Luis,1996-08-10,ES36209580831926802634,TRX_N-00467-46015676,2023-02-17T09:47:41,Bilbao,expenses,food,-99.82,-18796.12
buyer_1,Luis,1996-08-10,ES36209580831926802634,TRX_N-00468-06374793,2023-02-18T20:15:40,Bilbao,expenses,food,-101.24,-18897.36
buyer_1,Luis,1996-08-10,ES36209580831926802634,TRX_N-00469-85457273,2023-02-21T11:17:38,Bilbao,expenses,education,-75.34,-18972.7
buyer_1,Luis,1996-08-10,ES36209580831926802634,TRX_N-00470-52723082,2023-02-22T03:16:53,Bilbao,expenses,cash,-100.0,-19072.7
buyer_1,Luis,1996-08-10,ES36209580831926802634,TRX_N-00471-61523655,2023-02-23T06:21:45,Bilbao,expenses,cash,-100.0,-19172.7
buyer_1,Luis,1996-08-10,ES36209580831926802634,TRX_N-00472-31195570,2023-02-24T10:42:50,Bilbao,expenses,cash,-100.0,-19272.7
buyer_1,Luis,1996-08-10,ES36209580831926802634,TRX_N-00473-75234318,2023-02-26T18:50:41,Bilbao,expenses,repairs,-115.12,-19387.82
buyer_1,Luis,1996-08-10,ES36209580831926802634,TRX_N-00474-05305707,2023-02-28T20:57:54,Getxo,expenses,food,-106.78,-19494.6
buyer_1,Luis,1996-08-10,ES36209580831926802634,TRX_N-00475-31222316,2023-02-28T08:02:26,Bilbao,expenses,healthcare,-137.79,-19632.39
buyer_1,Luis,1996-08-10,ES36209580831926802634,TRX_N-00476-47367955,2023-03-01T10:19:01,Bilbao,incomes,salary,1516.22,-18116.17
buyer_1,Luis,1996-08-10,ES36209580831926802634,TRX_N-00477-01013906,2023-03-01T10:19:01,Bilbao,incomes,salary_partner,1194.81,-16921.36
buyer_1,Luis,1996-08-10,ES36209580831926802634,TRX_N-00478-34185954,2023-03-02T13:51:41,Bilbao,expenses,clothing,-50.96,-16972.32
buyer_1,Luis,1996-08-10,ES36209580831926802634,TRX_N-00479-05039938,2023-03-04T16:32:30,Bilbao,expenses,mortgage,-743.13,-17715.45
buyer_1,Luis,1996-08-10,ES36209580831926802634,TRX_N-00480-03349872,2023-03-04T13:36:22,Bilbao,expenses,food,-100.44,-17815.89
buyer_1,Luis,1996-08-10,ES36209580831926802634,TRX_N-00481-99484013,2023-03-04T10:43:09,Bilbao,expenses,cash,-100.0,-17915.89
buyer_1,Luis,1996-08-10,ES36209580831926802634,TRX_N-00482-13749257,2023-03-05T16:44:58,Bilbao,expenses,water,-31.65,-17947.54
buyer_1,Luis,1996-08-10,ES36209580831926802634,TRX_N-00483-79158267,2023-03-05T18:01:53,Bilbao,expenses,electricity,-44.86,-17992.4
buyer_1,Luis,1996-08-10,ES36209580831926802634,TRX_N-00484-35462691,2023-03-06T19:01:54,Labastida,expenses,leisure,-55.07,-18047.47
buyer_1,Luis,1996-08-10,ES36209580831926802634,TRX_N-00485-46520745,2023-03-07T02:40:25,Bilbao,expenses,phone,-44.74,-18092.21
buyer_1,Luis,1996-08-10,ES36209580831926802634,TRX_N-00486-41514614,2023-03-07T09:19:42,Bilbao,expenses,food,-85.15,-18177.36
buyer_1,Luis,1996-08-10,ES36209580831926802634,TRX_N-00487-58767197,2023-03-07T21:18:08,Eibar,expenses,cash,-100.0,-18277.36
buyer_1,Luis,1996-08-10,ES36209580831926802634,TRX_N-00488-70734095,2023-03-07T09:12:39,Bilbao,expenses,children,-100.33,-18377.69
buyer_1,Luis,1996-08-10,ES36209580831926802634,TRX_N-00489-09278961,2023-03-08T09:10:03,Bilbao,expenses,gas,-73.94,-18451.63
buyer_1,Luis,1996-08-10,ES36209580831926802634,TRX_N-00490-81734385,2023-03-08T16:06:00,Bilbao,expenses,internet,-42.0,-18493.63
buyer_1,Luis,1996-08-10,ES36209580831926802634,TRX_N-00491-33989387,2023-03-12T16:31:56,Bilbao,expenses,cash,-100.0,-18593.63
buyer_1,Luis,1996-08-10,ES36209580831926802634,TRX_N-00492-04990096,2023-03-13T08:31:04,Bilbao,expenses,cash,-100.0,-18693.63
buyer_1,Luis,1996-08-10,ES36209580831926802634,TRX_N-00493-64393441,2023-03-19T13:35:39,Bilbao,expenses,repairs,-150.57,-18844.2
buyer_1,Luis,1996-08-10,ES36209580831926802634,TRX_N-00494-33504341,2023-03-19T22:18:39,Bilbao,expenses,children,-191.23,-19035.43
buyer_1,Luis,1996-08-10,ES36209580831926802634,TRX_N-00495-29476585,2023-03-20T03:31:55,Bilbao,expenses,food,-120.32,-19155.75
buyer_1,Luis,1996-08-10,ES36209580831926802634,TRX_N-00496-45423213,2023-03-21T09:18:00,Bilbao,expenses,food,-84.36,-19240.11
buyer_1,Luis,1996-08-10,ES36209580831926802634,TRX_N-00497-72773196,2023-03-21T17:12:21,Bilbao,expenses,leisure,-76.63,-19316.74
buyer_1,Luis,1996-08-10,ES36209580831926802634,TRX_N-00498-84914215,2023-03-23T14:19:39,Bilbao,expenses,food,-124.66,-19441.4
buyer_1,Luis,1996-08-10,ES36209580831926802634,TRX_N-00499-66971020,2023-03-25T13:41:22,Bilbao,expenses,food,-75.42,-19516.82
buyer_1,Luis,1996-08-10,ES36209580831926802634,TRX_N-00500-94114376,2023-03-27T19:32:39,Bilbao,expenses,clothing,-118.58,-19635.4
buyer_1,Luis,1996-08-10,ES36209580831926802634,TRX_N-00501-36153372,2023-03-28T02:52:44,Bilbao,expenses,children,-154.09,-19789.49
buyer_1,Luis,1996-08-10,ES36209580831926802634,TRX_N-00502-31321436,2023-03-29T11:39:53,Bilbao,expenses,leisure,-67.73,-19857.22
buyer_1,Luis,1996-08-10,ES36209580831926802634,TRX_N-00503-43898430,2023-03-30T12:39:38,Bilbao,expenses,children,-69.87,-19927.09
buyer_1,Luis,1996-08-10,ES36209580831926802634,TRX_N-00504-55551487,2023-03-31T18:54:13,Bilbao,expenses,leisure,-50.1,-19977.19
buyer_1,Luis,1996-08-10,ES36209580831926802634,TRX_N-00505-86287744,2023-04-01T22:28:45,Bilbao,incomes,salary,1516.22,-18460.97
buyer_1,Luis,1996-08-10,ES36209580831926802634,TRX_N-00506-42227610,2023-04-01T22:28:45,Bilbao,incomes,salary_partner,1194.81,-17266.16
buyer_1,Luis,1996-08-10,ES36209580831926802634,TRX_N-00507-40044755,2023-04-01T14:44:04,Bermeo,expenses,cash,-100.0,-17366.16
buyer_1,Luis,1996-08-10,ES36209580831926802634,TRX_N-00508-36231566,2023-04-02T19:40:36,Bilbao,expenses,leisure,-56.13,-17422.29
buyer_1,Luis,1996-08-10,ES36209580831926802634,TRX_N-00509-08802788,2023-04-03T14:59:43,Portugalete,expenses,travel,-655.67,-18077.96
buyer_1,Luis,1996-08-10,ES36209580831926802634,TRX_N-00510-15321033,2023-04-04T17:35:01,Bilbao,expenses,mortgage,-743.13,-18821.09
buyer_1,Luis,1996-08-10,ES36209580831926802634,TRX_N-00511-23572592,2023-04-04T17:18:08,Bilbao,expenses,cash,-100.0,-18921.09
buyer_1,Luis,1996-08-10,ES36209580831926802634,TRX_N-00512-24226985,2023-04-05T10:45:00,Bilbao,expenses,water,-25.99,-18947.08
buyer_1,Luis,1996-08-10,ES36209580831926802634,TRX_N-00513-89395584,2023-04-06T08:23:42,Bilbao,expenses,internet,-42.0,-18989.08
buyer_1,Luis,1996-08-10,ES36209580831926802634,TRX_N-00514-94119470,2023-04-07T21:21:22,Bilbao,expenses,electricity,-31.39,-19020.47
buyer_1,Luis,1996-08-10,ES36209580831926802634,TRX_N-00515-13663311,2023-04-07T18:59:57,Bilbao,expenses,transport,-52.39,-19072.86
buyer_1,Luis,1996-08-10,ES36209580831926802634,TRX_N-00516-44948624,2023-04-08T09:58:47,Bilbao,expenses,gas,-69.55,-19142.41
buyer_1,Luis,1996-08-10,ES36209580831926802634,TRX_N-00517-54705304,2023-04-08T19:58:40,Bilbao,expenses,phone,-43.89,-19186.3
buyer_1,Luis,1996-08-10,ES36209580831926802634,TRX_N-00518-12289279,2023-04-08T20:58:01,Getxo,expenses,food,-112.65,-19298.95
buyer_1,Luis,1996-08-10,ES36209580831926802634,TRX_N-00519-55015781,2023-04-08T13:16:09,Andoain,expenses,leisure,-55.72,-19354.67
buyer_1,Luis,1996-08-10,ES36209580831926802634,TRX_N-00520-01155505,2023-04-11T17:40:15,Bilbao,expenses,cash,-100.0,-19454.67
buyer_1,Luis,1996-08-10,ES36209580831926802634,TRX_N-00521-91130304,2023-04-12T09:38:40,Barakaldo,expenses,education,-68.14,-19522.81
buyer_1,Luis,1996-08-10,ES36209580831926802634,TRX_N-00522-87219539,2023-04-14T19:08:49,Bilbao,expenses,food,-88.69,-19611.5
buyer_1,Luis,1996-08-10,ES36209580831926802634,TRX_N-00523-91012967,2023-04-15T07:55:39,Bilbao,expenses,food,-103.37,-19714.87
buyer_1,Luis,1996-08-10,ES36209580831926802634,TRX_N-00524-10007102,2023-04-15T08:38:28,Arrasate,expenses,transport,-55.64,-19770.51
buyer_1,Luis,1996-08-10,ES36209580831926802634,TRX_N-00525-53228474,2023-04-16T14:24:37,Bilbao,expenses,transport,-66.05,-19836.56
buyer_1,Luis,1996-08-10,ES36209580831926802634,TRX_N-00526-92698907,2023-04-17T11:54:29,Bilbao,expenses,repairs,-173.79,-20010.35
buyer_1,Luis,1996-08-10,ES36209580831926802634,TRX_N-00527-75200100,2023-04-20T09:06:55,Bilbao,expenses,appliances,-142.42,-20152.77
buyer_1,Luis,1996-08-10,ES36209580831926802634,TRX_N-00528-46814713,2023-04-22T05:20:12,Bilbao,expenses,clothing,-79.13,-20231.9
buyer_1,Luis,1996-08-10,ES36209580831926802634,TRX_N-00529-99953591,2023-04-23T08:56:55,Bilbao,expenses,transport,-68.7,-20300.6
buyer_1,Luis,1996-08-10,ES36209580831926802634,TRX_N-00530-87921909,2023-04-26T06:34:31,Bilbao,expenses,transport,-67.55,-20368.15
buyer_1,Luis,1996-08-10,ES36209580831926802634,TRX_N-00531-95646266,2023-04-26T04:27:27,Bilbao,expenses,leisure,-49.73,-20417.88
buyer_1,Luis,1996-08-10,ES36209580831926802634,TRX_N-00532-98494033,2023-04-27T08:51:47,Bilbao,expenses,repairs,-226.01,-20643.89
buyer_1,Luis,1996-08-10,ES36209580831926802634,TRX_N-00533-02594875,2023-04-29T12:50:24,Barakaldo,expenses,travel,-784.28,-21428.17
buyer_1,Luis,1996-08-10,ES36209580831926802634,TRX_N-00534-32511394,2023-04-29T22:06:00,Bilbao,expenses,gifts,-334.36,-21762.53
buyer_1,Luis,1996-08-10,ES36209580831926802634,TRX_N-00535-00025772,2023-05-01T18:50:55,Bilbao,incomes,salary,1516.22,-20246.31
buyer_1,Luis,1996-08-10,ES36209580831926802634,TRX_N-00536-03077750,2023-05-01T18:50:55,Bilbao,incomes,salary_partner,1194.81,-19051.5
buyer_1,Luis,1996-08-10,ES36209580831926802634,TRX_N-00537-07355993,2023-05-01T18:50:55,Bilbao,incomes,extra_income,241.2,-18810.3
buyer_1,Luis,1996-08-10,ES36209580831926802634,TRX_N-00538-89730165,2023-05-01T08:07:21,Bilbao,expenses,leisure,-79.99,-18890.29
buyer_1,Luis,1996-08-10,ES36209580831926802634,TRX_N-00539-08056426,2023-05-01T20:11:52,Salvatierra/Agurain,expenses,gifts,-518.91,-19409.2
buyer_1,Luis,1996-08-10,ES36209580831926802634,TRX_N-00540-20938518,2023-05-04T20:45:23,Bilbao,expenses,mortgage,-743.13,-20152.33
buyer_1,Luis,1996-08-10,ES36209580831926802634,TRX_N-00541-53764168,2023-05-05T15:41:22,Bilbao,expenses,water,-36.83,-20189.16
buyer_1,Luis,1996-08-10,ES36209580831926802634,TRX_N-00542-80580107,2023-05-05T12:18:19,Donostia,expenses,healthcare,-45.35,-20234.51
buyer_1,Luis,1996-08-10,ES36209580831926802634,TRX_N-00543-01463125,2023-05-06T18:20:45,Bilbao,expenses,gas,-79.83,-20314.34
buyer_1,Luis,1996-08-10,ES36209580831926802634,TRX_N-00544-91733584,2023-05-06T19:18:01,Bilbao,expenses,food,-109.11,-20423.45
buyer_1,Luis,1996-08-10,ES36209580831926802634,TRX_N-00545-54643824,2023-05-07T20:25:13,Bilbao,expenses,electricity,-22.21,-20445.66
buyer_1,Luis,1996-08-10,ES36209580831926802634,TRX_N-00546-57609582,2023-05-07T21:50:34,Bilbao,expenses,internet,-42.0,-20487.66
buyer_1,Luis,1996-08-10,ES36209580831926802634,TRX_N-00547-10563763,2023-05-08T13:40:25,Bilbao,expenses,phone,-40.94,-20528.6
buyer_1,Luis,1996-08-10,ES36209580831926802634,TRX_N-00548-99829075,2023-05-08T14:01:13,Bilbao,expenses,education,-49.34,-20577.94
buyer_1,Luis,1996-08-10,ES36209580831926802634,TRX_N-00549-34198230,2023-05-09T23:12:27,Bilbao,expenses,healthcare,-44.2,-20622.14
buyer_1,Luis,1996-08-10,ES36209580831926802634,TRX_N-00550-84798662,2023-05-09T18:39:39,Iruña de Oca,expenses,education,-61.71,-20683.85
buyer_1,Luis,1996-08-10,ES36209580831926802634,TRX_N-00551-39774899,2023-05-10T08:56:31,Bilbao,expenses,healthcare,-186.49,-20870.34
buyer_1,Luis,1996-08-10,ES36209580831926802634,TRX_N-00552-57981448,2023-05-10T17:07:44,Bilbao,expenses,travel,-1358.74,-22229.08
buyer_1,Luis,1996-08-10,ES36209580831926802634,TRX_N-00553-72495194,2023-05-11T11:15:45,Bilbao,expenses,repairs,-85.74,-22314.82
buyer_1,Luis,1996-08-10,ES36209580831926802634,TRX_N-00554-51267461,2023-05-12T21:03:47,Bilbao,expenses,clothing,-130.83,-22445.65
buyer_1,Luis,1996-08-10,ES36209580831926802634,TRX_N-00555-98378986,2023-05-13T19:09:20,Bilbao,expenses,leisure,-74.21,-22519.86
buyer_1,Luis,1996-08-10,ES36209580831926802634,TRX_N-00556-85841553,2023-05-13T19:05:33,Bilbao,expenses,healthcare,-135.72,-22655.58
buyer_1,Luis,1996-08-10,ES36209580831926802634,TRX_N-00557-66196052,2023-05-14T12:27:37,Bilbao,expenses,travel,-292.59,-22948.17
buyer_1,Luis,1996-08-10,ES36209580831926802634,TRX_N-00558-54390200,2023-05-15T14:46:23,Barakaldo,expenses,repairs,-304.26,-23252.43
buyer_1,Luis,1996-08-10,ES36209580831926802634,TRX_N-00559-73010253,2023-05-16T16:52:39,Bilbao,expenses,leisure,-41.66,-23294.09
buyer_1,Luis,1996-08-10,ES36209580831926802634,TRX_N-00560-10796365,2023-05-17T19:13:13,Bilbao,expenses,leisure,-77.3,-23371.39
buyer_1,Luis,1996-08-10,ES36209580831926802634,TRX_N-00561-48688485,2023-05-18T15:16:34,Bilbao,expenses,clothing,-82.01,-23453.4
buyer_1,Luis,1996-08-10,ES36209580831926802634,TRX_N-00562-10760201,2023-05-19T20:51:07,Labastida,expenses,cash,-100.0,-23553.4
buyer_1,Luis,1996-08-10,ES36209580831926802634,TRX_N-00563-07794240,2023-05-19T05:39:27,Andoain,expenses,gifts,-272.11,-23825.51
buyer_1,Luis,1996-08-10,ES36209580831926802634,TRX_N-00564-01663414,2023-05-20T08:19:09,Bilbao,expenses,leisure,-82.57,-23908.08
buyer_1,Luis,1996-08-10,ES36209580831926802634,TRX_N-00565-77649631,2023-05-22T11:33:52,Mungia,expenses,leisure,-51.84,-23959.92
buyer_1,Luis,1996-08-10,ES36209580831926802634,TRX_N-00566-78376566,2023-05-23T20:11:35,Bilbao,expenses,appliances,-281.53,-24241.45
buyer_1,Luis,1996-08-10,ES36209580831926802634,TRX_N-00567-31168620,2023-05-23T10:29:18,Bilbao,expenses,children,-93.27,-24334.72
buyer_1,Luis,1996-08-10,ES36209580831926802634,TRX_N-00568-82621911,2023-05-24T17:54:01,Bilbao,expenses,leisure,-57.59,-24392.31
buyer_1,Luis,1996-08-10,ES36209580831926802634,TRX_N-00569-16463775,2023-05-27T12:16:10,Zuia,expenses,cash,-100.0,-24492.31
buyer_1,Luis,1996-08-10,ES36209580831926802634,TRX_N-00570-48704095,2023-05-31T17:27:52,Bilbao,expenses,food,-122.45,-24614.76
buyer_1,Luis,1996-08-10,ES36209580831926802634,TRX_N-00571-22121295,2023-05-31T17:37:16,Bilbao,expenses,children,-180.23,-24794.99
buyer_1,Luis,1996-08-10,ES36209580831926802634,TRX_N-00572-18460559,2023-06-01T08:31:39,Bilbao,incomes,salary,1516.22,-23278.77
buyer_1,Luis,1996-08-10,ES36209580831926802634,TRX_N-00573-03138011,2023-06-01T08:31:39,Bilbao,incomes,salary_partner,1194.81,-22083.96
buyer_1,Luis,1996-08-10,ES36209580831926802634,TRX_N-00574-69043384,2023-06-01T08:31:39,Bilbao,incomes,salary_bonus,1085.34,-20998.62
buyer_1,Luis,1996-08-10,ES36209580831926802634,TRX_N-00575-81537304,2023-06-01T08:31:39,Bilbao,incomes,salary_partner_bonus,931.74,-20066.88
buyer_1,Luis,1996-08-10,ES36209580831926802634,TRX_N-00576-51305146,2023-06-02T15:41:06,Bilbao,expenses,taxes,-1689.65,-21756.53
buyer_1,Luis,1996-08-10,ES36209580831926802634,TRX_N-00577-80143423,2023-06-02T18:25:34,Bilbao,expenses,insurance,-340.0,-22096.53
buyer_1,Luis,1996-08-10,ES36209580831926802634,TRX_N-00578-07736864,2023-06-02T10:00:29,Bilbao,expenses,appliances,-420.0,-22516.53
buyer_1,Luis,1996-08-10,ES36209580831926802634,TRX_N-00579-77564560,2023-06-03T09:52:48,Bilbao,expenses,transport,-60.97,-22577.5
buyer_1,Luis,1996-08-10,ES36209580831926802634,TRX_N-00580-99095677,2023-06-04T11:15:03,Bilbao,expenses,mortgage,-743.13,-23320.63
buyer_1,Luis,1996-08-10,ES36209580831926802634,TRX_N-00581-80037008,2023-06-05T21:04:39,Bilbao,expenses,internet,-42.0,-23362.63
buyer_1,Luis,1996-08-10,ES36209580831926802634,TRX_N-00582-79581730,2023-06-05T17:33:52,Iruña de Oca,expenses,clothing,-152.73,-23515.36
buyer_1,Luis,1996-08-10,ES36209580831926802634,TRX_N-00583-62542999,2023-06-05T17:48:33,Bilbao,expenses,education,-73.05,-23588.41
buyer_1,Luis,1996-08-10,ES36209580831926802634,TRX_N-00584-92257647,2023-06-06T16:51:31,Bilbao,expenses,water,-24.69,-23613.1
buyer_1,Luis,1996-08-10,ES36209580831926802634,TRX_N-00585-08130593,2023-06-06T06:10:31,Bilbao,expenses,clothing,-134.06,-23747.16
buyer_1,Luis,1996-08-10,ES36209580831926802634,TRX_N-00586-69873764,2023-06-07T10:45:10,Bilbao,expenses,electricity,-70.62,-23817.78
buyer_1,Luis,1996-08-10,ES36209580831926802634,TRX_N-00587-89543845,2023-06-07T12:23:29,Bilbao,expenses,transport,-64.26,-23882.04
buyer_1,Luis,1996-08-10,ES36209580831926802634,TRX_N-00588-97553493,2023-06-08T14:48:11,Bilbao,expenses,gas,-56.0,-23938.04
buyer_1,Luis,1996-08-10,ES36209580831926802634,TRX_N-00589-50214877,2023-06-08T14:59:55,Bilbao,expenses,phone,-39.47,-23977.51
buyer_1,Luis,1996-08-10,ES36209580831926802634,TRX_N-00590-21838685,2023-06-08T11:03:16,Bilbao,expenses,leisure,-53.45,-24030.96
buyer_1,Luis,1996-08-10,ES36209580831926802634,TRX_N-00591-92396850,2023-06-09T10:15:37,Bilbao,expenses,clothing,-49.92,-24080.88
buyer_1,Luis,1996-08-10,ES36209580831926802634,TRX_N-00592-62818277,2023-06-09T14:15:09,Bilbao,expenses,cash,-100.0,-24180.88
buyer_1,Luis,1996-08-10,ES36209580831926802634,TRX_N-00593-21568098,2023-06-10T21:07:22,Bilbao,expenses,transport,-70.8,-24251.68
buyer_1,Luis,1996-08-10,ES36209580831926802634,TRX_N-00594-13607143,2023-06-10T16:14:30,Bilbao,expenses,education,-77.49,-24329.17
buyer_1,Luis,1996-08-10,ES36209580831926802634,TRX_N-00595-40146354,2023-06-10T16:15:10,Bilbao,expenses,gifts,-83.55,-24412.72
buyer_1,Luis,1996-08-10,ES36209580831926802634,TRX_N-00596-65109911,2023-06-11T10:01:12,Bilbao,expenses,transport,-59.59,-24472.31
buyer_1,Luis,1996-08-10,ES36209580831926802634,TRX_N-00597-94146362,2023-06-11T15:21:33,Bilbao,expenses,cash,-100.0,-24572.31
buyer_1,Luis,1996-08-10,ES36209580831926802634,TRX_N-00598-51793187,2023-06-12T14:26:51,Durango,expenses,leisure,-82.61,-24654.92
buyer_1,Luis,1996-08-10,ES36209580831926802634,TRX_N-00599-86681333,2023-06-12T08:10:12,Bilbao,expenses,clothing,-83.55,-24738.47
buyer_1,Luis,1996-08-10,ES36209580831926802634,TRX_N-00600-62814616,2023-06-13T07:51:40,Bilbao,expenses,clothing,-56.33,-24794.8
buyer_1,Luis,1996-08-10,ES36209580831926802634,TRX_N-00601-03726858,2023-06-16T11:56:47,Bilbao,expenses,transport,-68.79,-24863.59
buyer_1,Luis,1996-08-10,ES36209580831926802634,TRX_N-00602-12994302,2023-06-16T17:08:25,Hondarribia,expenses,gifts,-506.43,-25370.02
buyer_1,Luis,1996-08-10,ES36209580831926802634,TRX_N-00603-65206533,2023-06-16T15:01:24,Bilbao,expenses,children,-255.51,-25625.53
buyer_1,Luis,1996-08-10,ES36209580831926802634,TRX_N-00604-86645796,2023-06-19T18:27:17,Amurrio,expenses,gifts,-96.29,-25721.82
buyer_1,Luis,1996-08-10,ES36209580831926802634,TRX_N-00605-54848618,2023-06-20T14:23:38,Bilbao,expenses,cash,-100.0,-25821.82
buyer_1,Luis,1996-08-10,ES36209580831926802634,TRX_N-00606-48818579,2023-06-21T10:16:46,Bilbao,expenses,cash,-100.0,-25921.82
buyer_1,Luis,1996-08-10,ES36209580831926802634,TRX_N-00607-64090513,2023-06-23T20:55:50,Bilbao,expenses,repairs,-238.53,-26160.35
buyer_1,Luis,1996-08-10,ES36209580831926802634,TRX_N-00608-44714129,2023-06-24T18:44:00,Bilbao,expenses,cash,-100.0,-26260.35
buyer_1,Luis,1996-08-10,ES36209580831926802634,TRX_N-00609-55290764,2023-06-24T16:02:02,Bilbao,expenses,gifts,-644.1,-26904.45
buyer_1,Luis,1996-08-10,ES36209580831926802634,TRX_N-00610-18531429,2023-06-25T08:28:49,Bermeo,expenses,food,-89.49,-26993.94
buyer_1,Luis,1996-08-10,ES36209580831926802634,TRX_N-00611-51843308,2023-06-27T15:11:52,Bilbao,expenses,food,-74.22,-27068.16
buyer_1,Luis,1996-08-10,ES36209580831926802634,TRX_N-00612-62732389,2023-06-27T22:18:42,Bilbao,expenses,education,-62.31,-27130.47
buyer_1,Luis,1996-08-10,ES36209580831926802634,TRX_N-00613-59315616,2023-06-29T10:46:48,Bilbao,expenses,food,-93.69,-27224.16
buyer_1,Luis,1996-08-10,ES36209580831926802634,TRX_N-00614-04486013,2023-06-29T16:17:26,Vitoria-Gasteiz,expenses,transport,-52.44,-27276.6
buyer_1,Luis,1996-08-10,ES36209580831926802634,TRX_N-00615-91492712,2023-06-30T11:44:27,Bilbao,expenses,repairs,-201.07,-27477.67
buyer_1,Luis,1996-08-10,ES36209580831926802634,TRX_N-00616-13860199,2023-07-01T06:35:17,Bilbao,incomes,salary,1516.22,-25961.45
buyer_1,Luis,1996-08-10,ES36209580831926802634,TRX_N-00617-18163964,2023-07-01T06:35:17,Bilbao,incomes,salary_partner,1194.81,-24766.64
buyer_1,Luis,1996-08-10,ES36209580831926802634,TRX_N-00618-29931587,2023-07-01T22:38:22,Bilbao,expenses,appliances,-102.47,-24869.11
buyer_1,Luis,1996-08-10,ES36209580831926802634,TRX_N-00619-03555980,2023-07-02T18:18:39,Andoain,expenses,cash,-100.0,-24969.11
buyer_1,Luis,1996-08-10,ES36209580831926802634,TRX_N-00620-67080279,2023-07-02T09:11:15,Bilbao,expenses,appliances,-289.66,-25258.77
buyer_1,Luis,1996-08-10,ES36209580831926802634,TRX_N-00621-97172128,2023-07-03T08:23:52,Bilbao,expenses,education,-73.69,-25332.46
buyer_1,Luis,1996-08-10,ES36209580831926802634,TRX_N-00622-81320304,2023-07-03T12:09:19,Bilbao,expenses,children,-141.17,-25473.63
buyer_1,Luis,1996-08-10,ES36209580831926802634,TRX_N-00623-91931361,2023-07-04T10:09:13,Bilbao,expenses,mortgage,-743.13,-26216.76
buyer_1,Luis,1996-08-10,ES36209580831926802634,TRX_N-00624-22216175,2023-07-04T08:03:03,Bilbao,expenses,education,-47.19,-26263.95
buyer_1,Luis,1996-08-10,ES36209580831926802634,TRX_N-00625-46403987,2023-07-05T11:48:46,Bilbao,expenses,phone,-38.58,-26302.53
buyer_1,Luis,1996-08-10,ES36209580831926802634,TRX_N-00626-99602185,2023-07-05T19:17:10,Bilbao,expenses,gifts,-598.76,-26901.29
buyer_1,Luis,1996-08-10,ES36209580831926802634,TRX_N-00627-61535635,2023-07-06T20:02:36,Bilbao,expenses,gas,-104.28,-27005.57
buyer_1,Luis,1996-08-10,ES36209580831926802634,TRX_N-00628-35038392,2023-07-08T22:49:55,Bilbao,expenses,internet,-42.0,-27047.57
buyer_1,Luis,1996-08-10,ES36209580831926802634,TRX_N-00629-07833629,2023-07-08T09:02:32,Bilbao,expenses,water,-25.09,-27072.66
buyer_1,Luis,1996-08-10,ES36209580831926802634,TRX_N-00630-75202857,2023-07-08T08:45:44,Bilbao,expenses,electricity,-86.51,-27159.17
buyer_1,Luis,1996-08-10,ES36209580831926802634,TRX_N-00631-17335074,2023-07-08T19:09:12,Bilbao,expenses,food,-109.83,-27269.0
buyer_1,Luis,1996-08-10,ES36209580831926802634,TRX_N-00632-64659238,2023-07-09T09:19:58,Bilbao,expenses,cash,-100.0,-27369.0
buyer_1,Luis,1996-08-10,ES36209580831926802634,TRX_N-00633-39027363,2023-07-10T15:11:34,Bilbao,expenses,transport,-63.69,-27432.69
buyer_1,Luis,1996-08-10,ES36209580831926802634,TRX_N-00634-53177112,2023-07-11T09:27:06,Bilbao,expenses,healthcare,-38.78,-27471.47
buyer_1,Luis,1996-08-10,ES36209580831926802634,TRX_N-00635-93625715,2023-07-12T14:53:25,Bilbao,expenses,leisure,-63.14,-27534.61
buyer_1,Luis,1996-08-10,ES36209580831926802634,TRX_N-00636-56828131,2023-07-13T12:02:54,Bilbao,expenses,clothing,-93.49,-27628.1
buyer_1,Luis,1996-08-10,ES36209580831926802634,TRX_N-00637-62065874,2023-07-14T08:41:41,Bilbao,expenses,cash,-100.0,-27728.1
buyer_1,Luis,1996-08-10,ES36209580831926802634,TRX_N-00638-40722329,2023-07-17T10:59:59,Bilbao,expenses,food,-84.49,-27812.59
buyer_1,Luis,1996-08-10,ES36209580831926802634,TRX_N-00639-78929176,2023-07-19T19:28:46,Bilbao,expenses,transport,-60.84,-27873.43
buyer_1,Luis,1996-08-10,ES36209580831926802634,TRX_N-00640-40241037,2023-07-19T04:51:35,Bilbao,expenses,healthcare,-125.34,-27998.77
buyer_1,Luis,1996-08-10,ES36209580831926802634,TRX_N-00641-25923377,2023-07-20T20:13:27,Bilbao,expenses,cash,-100.0,-28098.77
buyer_1,Luis,1996-08-10,ES36209580831926802634,TRX_N-00642-06246960,2023-07-22T07:14:03,Bilbao,expenses,travel,-681.49,-28780.26
buyer_1,Luis,1996-08-10,ES36209580831926802634,TRX_N-00643-09413220,2023-07-22T17:38:25,Bilbao,expenses,repairs,-78.37,-28858.63
buyer_1,Luis,1996-08-10,ES36209580831926802634,TRX_N-00644-77019371,2023-07-24T09:02:05,Bilbao,expenses,transport,-86.67,-28945.3
buyer_1,Luis,1996-08-10,ES36209580831926802634,TRX_N-00645-75526418,2023-07-25T20:03:50,Bilbao,expenses,food,-101.42,-29046.72
buyer_1,Luis,1996-08-10,ES36209580831926802634,TRX_N-00646-88504279,2023-07-30T18:26:48,Bilbao,expenses,food,-88.44,-29135.16
buyer_1,Luis,1996-08-10,ES36209580831926802634,TRX_N-00647-36512869,2023-07-31T08:59:05,Arrasate,expenses,transport,-74.01,-29209.17
buyer_1,Luis,1996-08-10,ES36209580831926802634,TRX_N-00648-93190433,2023-07-31T16:25:49,Bilbao,expenses,leisure,-48.4,-29257.57
buyer_1,Luis,1996-08-10,ES36209580831926802634,TRX_N-00649-35891349,2023-08-01T20:25:09,Bilbao,incomes,salary,1516.22,-27741.35
buyer_1,Luis,1996-08-10,ES36209580831926802634,TRX_N-00650-15060914,2023-08-01T20:25:09,Bilbao,incomes,salary_partner,1194.81,-26546.54
buyer_1,Luis,1996-08-10,ES36209580831926802634,TRX_N-00651-38947123,2023-08-01T18:47:24,Lasarte-Oria,expenses,healthcare,-52.79,-26599.33
buyer_1,Luis,1996-08-10,ES36209580831926802634,TRX_N-00652-02394870,2023-08-01T21:42:02,Bilbao,expenses,education,-60.48,-26659.81
buyer_1,Luis,1996-08-10,ES36209580831926802634,TRX_N-00653-27480725,2023-08-02T19:45:55,Bilbao,expenses,transport,-73.45,-26733.26
buyer_1,Luis,1996-08-10,ES36209580831926802634,TRX_N-00654-82597623,2023-08-03T18:48:13,Bilbao,expenses,healthcare,-50.62,-26783.88
buyer_1,Luis,1996-08-10,ES36209580831926802634,TRX_N-00655-28457243,2023-08-04T14:47:31,Bilbao,expenses,mortgage,-743.13,-27527.01
buyer_1,Luis,1996-08-10,ES36209580831926802634,TRX_N-00656-35719808,2023-08-04T18:07:06,Pasaia,expenses,food,-68.74,-27595.75
buyer_1,Luis,1996-08-10,ES36209580831926802634,TRX_N-00657-11169234,2023-08-04T14:45:10,Bilbao,expenses,transport,-69.96,-27665.71
buyer_1,Luis,1996-08-10,ES36209580831926802634,TRX_N-00658-85763512,2023-08-05T22:38:29,Bilbao,expenses,repairs,-274.55,-27940.26
buyer_1,Luis,1996-08-10,ES36209580831926802634,TRX_N-00659-19428054,2023-08-06T19:40:46,Bilbao,expenses,internet,-42.0,-27982.26
buyer_1,Luis,1996-08-10,ES36209580831926802634,TRX_N-00660-57794034,2023-08-06T14:30:15,Zarautz,expenses,cash,-100.0,-28082.26
buyer_1,Luis,1996-08-10,ES36209580831926802634,TRX_N-00661-44720300,2023-08-07T13:15:52,Bilbao,expenses,food,-119.14,-28201.4
buyer_1,Luis,1996-08-10,ES36209580831926802634,TRX_N-00662-62344974,2023-08-08T11:46:39,Bilbao,expenses,electricity,-51.83,-28253.23
buyer_1,Luis,1996-08-10,ES36209580831926802634,TRX_N-00663-42764497,2023-08-08T20:05:26,Bilbao,expenses,phone,-39.49,-28292.72
buyer_1,Luis,1996-08-10,ES36209580831926802634,TRX_N-00664-16565820,2023-08-08T02:11:24,Bilbao,expenses,water,-33.07,-28325.79
buyer_1,Luis,1996-08-10,ES36209580831926802634,TRX_N-00665-18883034,2023-08-08T16:58:33,Bilbao,expenses,gas,-91.59,-28417.38
buyer_1,Luis,1996-08-10,ES36209580831926802634,TRX_N-00666-78496729,2023-08-09T18:33:50,Bilbao,expenses,food,-93.77,-28511.15
buyer_1,Luis,1996-08-10,ES36209580831926802634,TRX_N-00667-95858399,2023-08-09T20:04:43,Bilbao,expenses,leisure,-84.1,-28595.25
buyer_1,Luis,1996-08-10,ES36209580831926802634,TRX_N-00668-99865980,2023-08-10T21:17:14,Bilbao,expenses,education,-52.11,-28647.36
buyer_1,Luis,1996-08-10,ES36209580831926802634,TRX_N-00669-70224761,2023-08-12T10:16:47,Bilbao,expenses,gifts,-82.31,-28729.67
buyer_1,Luis,1996-08-10,ES36209580831926802634,TRX_N-00670-46208200,2023-08-15T15:36:18,Bilbao,expenses,gifts,-672.56,-29402.23
buyer_1,Luis,1996-08-10,ES36209580831926802634,TRX_N-00671-85177702,2023-08-16T03:24:00,Bilbao,expenses,cash,-100.0,-29502.23
buyer_1,Luis,1996-08-10,ES36209580831926802634,TRX_N-00672-97928449,2023-08-17T18:45:03,Bilbao,expenses,children,-54.91,-29557.14
buyer_1,Luis,1996-08-10,ES36209580831926802634,TRX_N-00673-57921959,2023-08-19T20:38:49,Bilbao,expenses,education,-44.35,-29601.49
buyer_1,Luis,1996-08-10,ES36209580831926802634,TRX_N-00674-26249646,2023-08-19T08:30:13,Bilbao,expenses,cash,-100.0,-29701.49
buyer_1,Luis,1996-08-10,ES36209580831926802634,TRX_N-00675-39489608,2023-08-19T02:16:27,Bilbao,expenses,gifts,-105.82,-29807.31
buyer_1,Luis,1996-08-10,ES36209580831926802634,TRX_N-00676-44379312,2023-08-25T16:30:05,Bilbao,expenses,leisure,-45.03,-29852.34
buyer_1,Luis,1996-08-10,ES36209580831926802634,TRX_N-00677-12812753,2023-08-26T05:42:09,Bilbao,expenses,education,-43.37,-29895.71
buyer_1,Luis,1996-08-10,ES36209580831926802634,TRX_N-00678-41196572,2023-08-27T12:51:21,Bilbao,expenses,gifts,-198.97,-30094.68
buyer_1,Luis,1996-08-10,ES36209580831926802634,TRX_N-00679-11631877,2023-08-31T13:35:34,Bilbao,expenses,children,-119.12,-30213.8
buyer_1,Luis,1996-08-10,ES36209580831926802634,TRX_N-00680-69748028,2023-09-01T19:11:50,Bilbao,incomes,salary,1516.22,-28697.58
buyer_1,Luis,1996-08-10,ES36209580831926802634,TRX_N-00681-49999307,2023-09-01T19:11:50,Bilbao,incomes,salary_partner,1194.81,-27502.77
buyer_1,Luis,1996-08-10,ES36209580831926802634,TRX_N-00682-67968804,2023-09-01T19:11:50,Bilbao,incomes,extra_income,241.2,-27261.57
buyer_1,Luis,1996-08-10,ES36209580831926802634,TRX_N-00683-36515199,2023-09-01T11:31:55,Bilbao,expenses,gifts,-617.36,-27878.93
buyer_1,Luis,1996-08-10,ES36209580831926802634,TRX_N-00684-83472641,2023-09-03T03:58:10,Bilbao,expenses,food,-70.12,-27949.05
buyer_1,Luis,1996-08-10,ES36209580831926802634,TRX_N-00685-94638552,2023-09-03T14:14:05,Bilbao,expenses,transport,-70.2,-28019.25
buyer_1,Luis,1996-08-10,ES36209580831926802634,TRX_N-00686-57050871,2023-09-03T07:29:12,Bilbao,expenses,healthcare,-90.84,-28110.09
buyer_1,Luis,1996-08-10,ES36209580831926802634,TRX_N-00687-81739458,2023-09-03T15:14:24,Bilbao,expenses,education,-68.39,-28178.48
buyer_1,Luis,1996-08-10,ES36209580831926802634,TRX_N-00688-21340142,2023-09-03T06:12:51,Bilbao,expenses,cash,-100.0,-28278.48
buyer_1,Luis,1996-08-10,ES36209580831926802634,TRX_N-00689-33257497,2023-09-04T11:26:04,Bilbao,expenses,mortgage,-743.13,-29021.61
buyer_1,Luis,1996-08-10,ES36209580831926802634,TRX_N-00690-35831872,2023-09-05T15:33:49,Bilbao,expenses,gas,-86.62,-29108.23
buyer_1,Luis,1996-08-10,ES36209580831926802634,TRX_N-00691-86736487,2023-09-05T13:26:13,Bilbao,expenses,food,-71.93,-29180.16
buyer_1,Luis,1996-08-10,ES36209580831926802634,TRX_N-00692-83623893,2023-09-06T11:20:54,Bilbao,expenses,electricity,-65.26,-29245.42
buyer_1,Luis,1996-08-10,ES36209580831926802634,TRX_N-00693-61655382,2023-09-07T12:34:54,Bilbao,expenses,food,-98.58,-29344.0
buyer_1,Luis,1996-08-10,ES36209580831926802634,TRX_N-00694-20209734,2023-09-07T19:26:40,Bilbao,expenses,clothing,-153.02,-29497.02
buyer_1,Luis,1996-08-10,ES36209580831926802634,TRX_N-00695-47699753,2023-09-08T17:14:13,Bilbao,expenses,internet,-42.0,-29539.02
buyer_1,Luis,1996-08-10,ES36209580831926802634,TRX_N-00696-25754357,2023-09-08T17:26:29,Bilbao,expenses,water,-36.67,-29575.69
buyer_1,Luis,1996-08-10,ES36209580831926802634,TRX_N-00697-22243433,2023-09-08T20:19:19,Bilbao,expenses,phone,-38.09,-29613.78
buyer_1,Luis,1996-08-10,ES36209580831926802634,TRX_N-00698-74796508,2023-09-08T23:56:02,Bilbao,expenses,clothing,-77.05,-29690.83
buyer_1,Luis,1996-08-10,ES36209580831926802634,TRX_N-00699-87318641,2023-09-11T05:22:47,Bilbao,expenses,leisure,-35.2,-29726.03
buyer_1,Luis,1996-08-10,ES36209580831926802634,TRX_N-00700-42762705,2023-09-11T08:25:37,Bilbao,expenses,repairs,-170.95,-29896.98
buyer_1,Luis,1996-08-10,ES36209580831926802634,TRX_N-00701-77980953,2023-09-11T08:01:52,Bilbao,expenses,gifts,-354.21,-30251.19
buyer_1,Luis,1996-08-10,ES36209580831926802634,TRX_N-00702-59376024,2023-09-13T19:36:25,Llodio,expenses,gifts,-203.01,-30454.2
buyer_1,Luis,1996-08-10,ES36209580831926802634,TRX_N-00703-38892580,2023-09-14T08:36:00,Bilbao,expenses,leisure,-60.98,-30515.18
buyer_1,Luis,1996-08-10,ES36209580831926802634,TRX_N-00704-78740062,2023-09-17T15:42:16,Bilbao,expenses,transport,-60.06,-30575.24
buyer_1,Luis,1996-08-10,ES36209580831926802634,TRX_N-00705-18473375,2023-09-17T19:02:09,Bilbao,expenses,cash,-100.0,-30675.24
buyer_1,Luis,1996-08-10,ES36209580831926802634,TRX_N-00706-14752776,2023-09-17T19:33:11,Bilbao,expenses,appliances,-194.41,-30869.65
buyer_1,Luis,1996-08-10,ES36209580831926802634,TRX_N-00707-49449935,2023-09-20T20:16:09,Bilbao,expenses,gifts,-294.37,-31164.02
buyer_1,Luis,1996-08-10,ES36209580831926802634,TRX_N-00708-62764644,2023-09-21T15:54:36,Bilbao,expenses,food,-90.46,-31254.48
buyer_1,Luis,1996-08-10,ES36209580831926802634,TRX_N-00709-52045682,2023-09-22T08:45:57,Bilbao,expenses,transport,-65.9,-31320.38
buyer_1,Luis,1996-08-10,ES36209580831926802634,TRX_N-00710-99877912,2023-09-23T12:23:53,Bilbao,expenses,leisure,-61.72,-31382.1
buyer_1,Luis,1996-08-10,ES36209580831926802634,TRX_N-00711-24631180,2023-09-23T18:49:42,Bilbao,expenses,children,-198.25,-31580.35
buyer_1,Luis,1996-08-10,ES36209580831926802634,TRX_N-00712-44346892,2023-09-25T16:47:01,Bilbao,expenses,cash,-100.0,-31680.35
buyer_1,Luis,1996-08-10,ES36209580831926802634,TRX_N-00713-47632861,2023-09-26T00:36:14,Bilbao,expenses,cash,-100.0,-31780.35
buyer_1,Luis,1996-08-10,ES36209580831926802634,TRX_N-00714-59900353,2023-09-26T18:10:41,Bilbao,expenses,travel,-1062.55,-32842.9
buyer_1,Luis,1996-08-10,ES36209580831926802634,TRX_N-00715-08238412,2023-09-28T16:22:03,Bilbao,expenses,transport,-59.75,-32902.65
buyer_1,Luis,1996-08-10,ES36209580831926802634,TRX_N-00716-19167908,2023-09-28T10:29:00,Bilbao,expenses,cash,-100.0,-33002.65
buyer_1,Luis,1996-08-10,ES36209580831926802634,TRX_N-00717-78524229,2023-09-29T17:15:58,Donostia,expenses,cash,-100.0,-33102.65
buyer_1,Luis,1996-08-10,ES36209580831926802634,TRX_N-00718-23255397,2023-09-30T12:37:33,Bilbao,expenses,food,-76.4,-33179.05
buyer_1,Luis,1996-08-10,ES36209580831926802634,TRX_N-00719-42245702,2023-09-30T08:49:04,Bilbao,expenses,cash,-100.0,-33279.05
buyer_1,Luis,1996-08-10,ES36209580831926802634,TRX_N-00720-73120838,2023-10-01T19:48:49,Bilbao,incomes,salary,1516.22,-31762.83
buyer_1,Luis,1996-08-10,ES36209580831926802634,TRX_N-00721-75738321,2023-10-01T19:48:49,Bilbao,incomes,salary_partner,1194.81,-30568.02
buyer_1,Luis,1996-08-10,ES36209580831926802634,TRX_N-00722-03146992,2023-10-02T11:07:09,Bilbao,expenses,food,-76.61,-30644.63
buyer_1,Luis,1996-08-10,ES36209580831926802634,TRX_N-00723-07275376,2023-10-02T12:26:24,Bilbao,expenses,cash,-100.0,-30744.63
buyer_1,Luis,1996-08-10,ES36209580831926802634,TRX_N-00724-03256065,2023-10-03T15:50:43,Bilbao,expenses,transport,-56.83,-30801.46
buyer_1,Luis,1996-08-10,ES36209580831926802634,TRX_N-00725-93113654,2023-10-03T21:04:08,Bilbao,expenses,cash,-100.0,-30901.46
buyer_1,Luis,1996-08-10,ES36209580831926802634,TRX_N-00726-31565473,2023-10-04T01:23:04,Bilbao,expenses,mortgage,-743.13,-31644.59
buyer_1,Luis,1996-08-10,ES36209580831926802634,TRX_N-00727-93044921,2023-10-06T07:12:25,Bilbao,expenses,electricity,-65.94,-31710.53
buyer_1,Luis,1996-08-10,ES36209580831926802634,TRX_N-00728-51645370,2023-10-08T19:27:42,Bilbao,expenses,phone,-42.5,-31753.03
buyer_1,Luis,1996-08-10,ES36209580831926802634,TRX_N-00729-29803883,2023-10-08T08:06:05,Bilbao,expenses,water,-39.01,-31792.04
buyer_1,Luis,1996-08-10,ES36209580831926802634,TRX_N-00730-14557532,2023-10-08T13:45:37,Bilbao,expenses,gas,-112.3,-31904.34
buyer_1,Luis,1996-08-10,ES36209580831926802634,TRX_N-00731-88867530,2023-10-08T10:50:49,Bilbao,expenses,internet,-42.0,-31946.34
buyer_1,Luis,1996-08-10,ES36209580831926802634,TRX_N-00732-53079974,2023-10-09T21:50:40,Bilbao,expenses,cash,-100.0,-32046.34
buyer_1,Luis,1996-08-10,ES36209580831926802634,TRX_N-00733-53110534,2023-10-11T11:59:23,Bilbao,expenses,transport,-45.22,-32091.56
buyer_1,Luis,1996-08-10,ES36209580831926802634,TRX_N-00734-41975405,2023-10-15T08:59:51,Bermeo,expenses,cash,-100.0,-32191.56
buyer_1,Luis,1996-08-10,ES36209580831926802634,TRX_N-00735-60377796,2023-10-16T08:40:12,Lasarte-Oria,expenses,food,-65.68,-32257.24
buyer_1,Luis,1996-08-10,ES36209580831926802634,TRX_N-00736-90731196,2023-10-17T15:21:44,Bilbao,expenses,food,-90.26,-32347.5
buyer_1,Luis,1996-08-10,ES36209580831926802634,TRX_N-00737-11122479,2023-10-19T19:50:06,Bilbao,expenses,leisure,-30.2,-32377.7
buyer_1,Luis,1996-08-10,ES36209580831926802634,TRX_N-00738-69169843,2023-10-19T14:01:23,Bilbao,expenses,cash,-100.0,-32477.7
buyer_1,Luis,1996-08-10,ES36209580831926802634,TRX_N-00739-74603749,2023-10-20T22:06:09,Bilbao,expenses,cash,-100.0,-32577.7
buyer_1,Luis,1996-08-10,ES36209580831926802634,TRX_N-00740-81748170,2023-10-22T11:23:28,Leioa,expenses,food,-77.29,-32654.99
buyer_1,Luis,1996-08-10,ES36209580831926802634,TRX_N-00741-58444493,2023-10-23T10:56:24,Bilbao,expenses,children,-69.14,-32724.13
buyer_1,Luis,1996-08-10,ES36209580831926802634,TRX_N-00742-46651386,2023-10-24T11:56:17,Getxo,expenses,healthcare,-152.39,-32876.52
buyer_1,Luis,1996-08-10,ES36209580831926802634,TRX_N-00743-61740464,2023-10-26T08:35:55,Barakaldo,expenses,food,-63.31,-32939.83
buyer_1,Luis,1996-08-10,ES36209580831926802634,TRX_N-00744-72596762,2023-10-26T20:12:37,Sopela,expenses,transport,-48.74,-32988.57
buyer_1,Luis,1996-08-10,ES36209580831926802634,TRX_N-00745-68871372,2023-10-26T17:14:35,Bilbao,expenses,leisure,-61.23,-33049.8
buyer_1,Luis,1996-08-10,ES36209580831926802634,TRX_N-00746-54946290,2023-10-28T14:59:05,Bilbao,expenses,gifts,-108.43,-33158.23
buyer_1,Luis,1996-08-10,ES36209580831926802634,TRX_N-00747-61022409,2023-10-30T16:24:28,Bilbao,expenses,transport,-40.21,-33198.44
buyer_1,Luis,1996-08-10,ES36209580831926802634,TRX_N-00748-21747264,2023-10-30T10:30:11,Bilbao,expenses,repairs,-252.57,-33451.01
buyer_1,Luis,1996-08-10,ES36209580831926802634,TRX_N-00749-93922948,2023-10-31T18:30:37,Bilbao,expenses,repairs,-221.88,-33672.89
buyer_1,Luis,1996-08-10,ES36209580831926802634,TRX_N-00750-35699519,2023-11-01T18:54:53,Bilbao,incomes,salary,1516.22,-32156.67
buyer_1,Luis,1996-08-10,ES36209580831926802634,TRX_N-00751-47020229,2023-11-01T18:54:53,Bilbao,incomes,salary_partner,1194.81,-30961.86
buyer_1,Luis,1996-08-10,ES36209580831926802634,TRX_N-00752-06252618,2023-11-02T09:35:10,Bilbao,expenses,transport,-82.65,-31044.51
buyer_1,Luis,1996-08-10,ES36209580831926802634,TRX_N-00753-13206892,2023-11-02T18:09:14,Bilbao,expenses,education,-43.95,-31088.46
buyer_1,Luis,1996-08-10,ES36209580831926802634,TRX_N-00754-19159553,2023-11-03T22:24:09,Bilbao,expenses,cash,-100.0,-31188.46
buyer_1,Luis,1996-08-10,ES36209580831926802634,TRX_N-00755-24818756,2023-11-03T19:15:23,Bilbao,expenses,gifts,-231.2,-31419.66
buyer_1,Luis,1996-08-10,ES36209580831926802634,TRX_N-00756-04244366,2023-11-04T12:40:08,Bilbao,expenses,mortgage,-743.13,-32162.79
buyer_1,Luis,1996-08-10,ES36209580831926802634,TRX_N-00757-83288509,2023-11-05T18:30:45,Bilbao,expenses,water,-39.36,-32202.15
buyer_1,Luis,1996-08-10,ES36209580831926802634,TRX_N-00758-97605715,2023-11-05T18:14:17,Santurtzi,expenses,leisure,-34.53,-32236.68
buyer_1,Luis,1996-08-10,ES36209580831926802634,TRX_N-00759-07460636,2023-11-06T10:20:08,Bilbao,expenses,electricity,-55.28,-32291.96
buyer_1,Luis,1996-08-10,ES36209580831926802634,TRX_N-00760-99634115,2023-11-06T02:27:22,Bilbao,expenses,leisure,-45.94,-32337.9
buyer_1,Luis,1996-08-10,ES36209580831926802634,TRX_N-00761-84262945,2023-11-07T19:19:41,Santurtzi,expenses,food,-103.11,-32441.01
buyer_1,Luis,1996-08-10,ES36209580831926802634,TRX_N-00762-75522906,2023-11-07T21:22:34,Bilbao,expenses,cash,-100.0,-32541.01
buyer_1,Luis,1996-08-10,ES36209580831926802634,TRX_N-00763-22096807,2023-11-07T19:07:55,Bilbao,expenses,gifts,-739.34,-33280.35
buyer_1,Luis,1996-08-10,ES36209580831926802634,TRX_N-00764-77075838,2023-11-07T14:03:48,Bilbao,expenses,children,-249.31,-33529.66
buyer_1,Luis,1996-08-10,ES36209580831926802634,TRX_N-00765-31751484,2023-11-08T07:18:13,Bilbao,expenses,gas,-83.08,-33612.74
buyer_1,Luis,1996-08-10,ES36209580831926802634,TRX_N-00766-76608361,2023-11-08T10:39:08,Bilbao,expenses,internet,-42.0,-33654.74
buyer_1,Luis,1996-08-10,ES36209580831926802634,TRX_N-00767-44852571,2023-11-08T18:47:36,Bilbao,expenses,phone,-40.05,-33694.79
buyer_1,Luis,1996-08-10,ES36209580831926802634,TRX_N-00768-62195508,2023-11-08T08:10:47,Bilbao,expenses,transport,-80.46,-33775.25
buyer_1,Luis,1996-08-10,ES36209580831926802634,TRX_N-00769-66646882,2023-11-09T08:49:43,Bilbao,expenses,food,-77.76,-33853.01
buyer_1,Luis,1996-08-10,ES36209580831926802634,TRX_N-00770-23331914,2023-11-11T12:44:14,Bilbao,expenses,travel,-1057.71,-34910.72
buyer_1,Luis,1996-08-10,ES36209580831926802634,TRX_N-00771-21946344,2023-11-12T23:22:16,Bilbao,expenses,food,-100.61,-35011.33
buyer_1,Luis,1996-08-10,ES36209580831926802634,TRX_N-00772-36468858,2023-11-14T12:29:54,Bilbao,expenses,food,-71.76,-35083.09
buyer_1,Luis,1996-08-10,ES36209580831926802634,TRX_N-00773-47650820,2023-11-14T10:44:31,Bilbao,expenses,leisure,-35.07,-35118.16
buyer_1,Luis,1996-08-10,ES36209580831926802634,TRX_N-00774-12502568,2023-11-16T22:20:21,Bilbao,expenses,transport,-89.07,-35207.23
buyer_1,Luis,1996-08-10,ES36209580831926802634,TRX_N-00775-59860679,2023-11-18T16:12:20,Bilbao,expenses,repairs,-170.08,-35377.31
buyer_1,Luis,1996-08-10,ES36209580831926802634,TRX_N-00776-17757109,2023-11-20T13:10:57,Oyón-Oion,expenses,clothing,-109.62,-35486.93
buyer_1,Luis,1996-08-10,ES36209580831926802634,TRX_N-00777-74770271,2023-11-20T18:50:19,Amurrio,expenses,cash,-100.0,-35586.93
buyer_1,Luis,1996-08-10,ES36209580831926802634,TRX_N-00778-90897911,2023-11-21T10:40:30,Errenteria,expenses,clothing,-113.61,-35700.54
buyer_1,Luis,1996-08-10,ES36209580831926802634,TRX_N-00779-34194382,2023-11-23T10:24:46,Bilbao,expenses,repairs,-253.53,-35954.07
buyer_1,Luis,1996-08-10,ES36209580831926802634,TRX_N-00780-55986751,2023-11-24T21:43:13,Bilbao,expenses,leisure,-22.11,-35976.18
buyer_1,Luis,1996-08-10,ES36209580831926802634,TRX_N-00781-61990017,2023-11-28T11:04:58,Bilbao,expenses,food,-79.79,-36055.97
buyer_1,Luis,1996-08-10,ES36209580831926802634,TRX_N-00782-78376581,2023-11-28T23:23:22,Bilbao,expenses,gifts,-185.75,-36241.72
buyer_1,Luis,1996-08-10,ES36209580831926802634,TRX_N-00783-14251750,2023-12-01T03:30:58,Bilbao,incomes,salary,1516.22,-34725.5
buyer_1,Luis,1996-08-10,ES36209580831926802634,TRX_N-00784-79494621,2023-12-01T03:30:58,Bilbao,incomes,salary_partner,1194.81,-33530.69
buyer_1,Luis,1996-08-10,ES36209580831926802634,TRX_N-00785-61676759,2023-12-01T03:30:58,Bilbao,incomes,salary_bonus,1169.14,-32361.55
buyer_1,Luis,1996-08-10,ES36209580831926802634,TRX_N-00786-81913073,2023-12-01T03:30:58,Bilbao,incomes,salary_partner_bonus,847.49,-31514.06
buyer_1,Luis,1996-08-10,ES36209580831926802634,TRX_N-00787-69702454,2023-12-01T20:42:20,Bilbao,expenses,repairs,-186.72,-31700.78
buyer_1,Luis,1996-08-10,ES36209580831926802634,TRX_N-00788-17331600,2023-12-03T11:20:44,Bermeo,expenses,food,-118.43,-31819.21
buyer_1,Luis,1996-08-10,ES36209580831926802634,TRX_N-00789-99474267,2023-12-03T17:00:17,Bilbao,expenses,clothing,-115.93,-31935.14
buyer_1,Luis,1996-08-10,ES36209580831926802634,TRX_N-00790-95597291,2023-12-04T18:58:33,Bilbao,expenses,mortgage,-743.13,-32678.27
buyer_1,Luis,1996-08-10,ES36209580831926802634,TRX_N-00791-95465053,2023-12-04T20:50:29,Lasarte-Oria,expenses,transport,-40.19,-32718.46
buyer_1,Luis,1996-08-10,ES36209580831926802634,TRX_N-00792-43040138,2023-12-04T12:33:46,Bilbao,expenses,clothing,-94.26,-32812.72
buyer_1,Luis,1996-08-10,ES36209580831926802634,TRX_N-00793-37469703,2023-12-05T18:21:53,Bilbao,expenses,gas,-40.95,-32853.67
buyer_1,Luis,1996-08-10,ES36209580831926802634,TRX_N-00794-54269986,2023-12-05T09:14:52,Bilbao,expenses,internet,-42.0,-32895.67
buyer_1,Luis,1996-08-10,ES36209580831926802634,TRX_N-00795-22872686,2023-12-05T17:43:37,Bilbao,expenses,leisure,-57.76,-32953.43
buyer_1,Luis,1996-08-10,ES36209580831926802634,TRX_N-00796-11736082,2023-12-06T12:42:19,Bilbao,expenses,healthcare,-76.81,-33030.24
buyer_1,Luis,1996-08-10,ES36209580831926802634,TRX_N-00797-87681934,2023-12-06T11:16:13,Bilbao,expenses,cash,-100.0,-33130.24
buyer_1,Luis,1996-08-10,ES36209580831926802634,TRX_N-00798-03445533,2023-12-07T18:01:16,Bilbao,expenses,leisure,-81.04,-33211.28
buyer_1,Luis,1996-08-10,ES36209580831926802634,TRX_N-00799-29749398,2023-12-08T13:08:46,Bilbao,expenses,electricity,-21.61,-33232.89
buyer_1,Luis,1996-08-10,ES36209580831926802634,TRX_N-00800-21322792,2023-12-08T19:23:17,Bilbao,expenses,water,-36.49,-33269.38
buyer_1,Luis,1996-08-10,ES36209580831926802634,TRX_N-00801-00980960,2023-12-08T14:26:59,Bilbao,expenses,phone,-32.4,-33301.78
buyer_1,Luis,1996-08-10,ES36209580831926802634,TRX_N-00802-15973651,2023-12-08T09:50:41,Durango,expenses,food,-86.91,-33388.69
buyer_1,Luis,1996-08-10,ES36209580831926802634,TRX_N-00803-86755055,2023-12-08T15:32:52,Bilbao,expenses,transport,-44.8,-33433.49
buyer_1,Luis,1996-08-10,ES36209580831926802634,TRX_N-00804-76861067,2023-12-10T23:07:55,Bermeo,expenses,food,-124.55,-33558.04
buyer_1,Luis,1996-08-10,ES36209580831926802634,TRX_N-00805-41466905,2023-12-13T16:24:49,Andoain,expenses,food,-67.48,-33625.52
buyer_1,Luis,1996-08-10,ES36209580831926802634,TRX_N-00806-69172257,2023-12-13T18:54:25,Bilbao,expenses,leisure,-34.44,-33659.96
buyer_1,Luis,1996-08-10,ES36209580831926802634,TRX_N-00807-79474985,2023-12-14T11:04:08,Leioa,expenses,food,-75.73,-33735.69
buyer_1,Luis,1996-08-10,ES36209580831926802634,TRX_N-00808-08176940,2023-12-14T18:55:14,Bilbao,expenses,cash,-100.0,-33835.69
buyer_1,Luis,1996-08-10,ES36209580831926802634,TRX_N-00809-64545994,2023-12-15T10:03:34,Bilbao,expenses,education,-57.76,-33893.45
buyer_1,Luis,1996-08-10,ES36209580831926802634,TRX_N-00810-85283066,2023-12-18T04:21:05,Bilbao,expenses,food,-62.75,-33956.2
buyer_1,Luis,1996-08-10,ES36209580831926802634,TRX_N-00811-89025692,2023-12-18T11:41:23,Galdakao,expenses,repairs,-269.21,-34225.41
buyer_1,Luis,1996-08-10,ES36209580831926802634,TRX_N-00812-62395476,2023-12-19T18:23:28,Bilbao,expenses,gifts,-615.46,-34840.87
buyer_1,Luis,1996-08-10,ES36209580831926802634,TRX_N-00813-70156854,2023-12-20T20:06:41,Bilbao,expenses,transport,-59.09,-34899.96
buyer_1,Luis,1996-08-10,ES36209580831926802634,TRX_N-00814-98727938,2023-12-21T06:07:32,Bilbao,expenses,food,-90.31,-34990.27
buyer_1,Luis,1996-08-10,ES36209580831926802634,TRX_N-00815-18384453,2023-12-21T18:56:20,Bilbao,expenses,clothing,-69.03,-35059.3
buyer_1,Luis,1996-08-10,ES36209580831926802634,TRX_N-00816-52055656,2023-12-21T17:11:33,Bilbao,expenses,appliances,-329.51,-35388.81
buyer_1,Luis,1996-08-10,ES36209580831926802634,TRX_N-00817-71766189,2023-12-21T23:52:47,Bilbao,expenses,children,-63.99,-35452.8
buyer_1,Luis,1996-08-10,ES36209580831926802634,TRX_N-00818-42667930,2023-12-23T12:05:21,Bilbao,expenses,children,-245.86,-35698.66
buyer_1,Luis,1996-08-10,ES36209580831926802634,TRX_N-00819-78341018,2023-12-25T23:23:33,Bilbao,expenses,food,-81.58,-35780.24
buyer_1,Luis,1996-08-10,ES36209580831926802634,TRX_N-00820-26558000,2023-12-25T12:42:49,Bilbao,expenses,leisure,-22.67,-35802.91
buyer_1,Luis,1996-08-10,ES36209580831926802634,TRX_N-00821-60013511,2023-12-25T09:49:31,Bilbao,expenses,cash,-100.0,-35902.91
buyer_1,Luis,1996-08-10,ES36209580831926802634,TRX_N-00822-65696591,2023-12-26T20:47:03,Bilbao,expenses,food,-105.95,-36008.86
buyer_1,Luis,1996-08-10,ES36209580831926802634,TRX_N-00823-11425330,2023-12-31T05:35:48,Bilbao,expenses,healthcare,-126.07,-36134.93
buyer_1,Luis,1996-08-10,ES36209580831926802634,TRX_N-00824-39882891,2024-01-01T21:14:12,Bilbao,incomes,salary,1572.01,-34562.92
buyer_1,Luis,1996-08-10,ES36209580831926802634,TRX_N-00825-80363220,2024-01-01T21:14:12,Bilbao,incomes,salary_partner,1238.77,-33324.15
buyer_1,Luis,1996-08-10,ES36209580831926802634,TRX_N-00826-43539605,2024-01-01T21:14:12,Bilbao,incomes,extra_income,241.2,-33082.95
buyer_1,Luis,1996-08-10,ES36209580831926802634,TRX_N-00827-27021650,2024-01-01T20:03:56,Bilbao,expenses,repairs,-259.61,-33342.56
buyer_1,Luis,1996-08-10,ES36209580831926802634,TRX_N-00828-63348994,2024-01-02T09:31:06,Bilbao,expenses,food,-61.35,-33403.91
buyer_1,Luis,1996-08-10,ES36209580831926802634,TRX_N-00829-78301470,2024-01-02T12:42:25,Bilbao,expenses,leisure,-63.91,-33467.82
buyer_1,Luis,1996-08-10,ES36209580831926802634,TRX_N-00830-61776211,2024-01-04T12:48:13,Bilbao,expenses,mortgage,-743.13,-34210.95
buyer_1,Luis,1996-08-10,ES36209580831926802634,TRX_N-00831-11582205,2024-01-04T20:16:00,Bilbao,expenses,food,-104.58,-34315.53
buyer_1,Luis,1996-08-10,ES36209580831926802634,TRX_N-00832-71349634,2024-01-05T04:59:25,Bilbao,expenses,internet,-42.0,-34357.53
buyer_1,Luis,1996-08-10,ES36209580831926802634,TRX_N-00833-58953288,2024-01-05T16:27:19,Bilbao,expenses,phone,-41.78,-34399.31
buyer_1,Luis,1996-08-10,ES36209580831926802634,TRX_N-00834-32321035,2024-01-06T13:12:29,Bilbao,expenses,gifts,-59.27,-34458.58
buyer_1,Luis,1996-08-10,ES36209580831926802634,TRX_N-00835-68466469,2024-01-08T09:41:50,Bilbao,expenses,gas,-86.96,-34545.54
buyer_1,Luis,1996-08-10,ES36209580831926802634,TRX_N-00836-04487859,2024-01-08T23:12:05,Bilbao,expenses,water,-39.71,-34585.25
buyer_1,Luis,1996-08-10,ES36209580831926802634,TRX_N-00837-11945200,2024-01-08T23:07:27,Bilbao,expenses,electricity,-78.11,-34663.36
buyer_1,Luis,1996-08-10,ES36209580831926802634,TRX_N-00838-34634085,2024-01-08T08:51:22,Bilbao,expenses,transport,-78.68,-34742.04
buyer_1,Luis,1996-08-10,ES36209580831926802634,TRX_N-00839-20960789,2024-01-08T14:00:36,Bilbao,expenses,cash,-100.0,-34842.04
buyer_1,Luis,1996-08-10,ES36209580831926802634,TRX_N-00840-08693956,2024-01-09T14:45:20,Bilbao,expenses,food,-94.74,-34936.78
buyer_1,Luis,1996-08-10,ES36209580831926802634,TRX_N-00841-57104033,2024-01-11T14:47:59,Bilbao,expenses,repairs,-108.15,-35044.93
buyer_1,Luis,1996-08-10,ES36209580831926802634,TRX_N-00842-10972250,2024-01-13T10:37:06,Bilbao,expenses,travel,-488.16,-35533.09
buyer_1,Luis,1996-08-10,ES36209580831926802634,TRX_N-00843-13217162,2024-01-15T09:20:06,Bilbao,expenses,healthcare,-142.87,-35675.96
buyer_1,Luis,1996-08-10,ES36209580831926802634,TRX_N-00844-94283303,2024-01-19T10:21:34,Santurtzi,expenses,food,-105.89,-35781.85
buyer_1,Luis,1996-08-10,ES36209580831926802634,TRX_N-00845-07348827,2024-01-19T10:15:57,Bilbao,expenses,transport,-72.85,-35854.7
buyer_1,Luis,1996-08-10,ES36209580831926802634,TRX_N-00846-95330846,2024-01-20T02:11:05,Bilbao,expenses,repairs,-215.52,-36070.22
buyer_1,Luis,1996-08-10,ES36209580831926802634,TRX_N-00847-38132930,2024-01-23T11:29:56,Bilbao,expenses,leisure,-58.14,-36128.36
buyer_1,Luis,1996-08-10,ES36209580831926802634,TRX_N-00848-86449977,2024-01-23T21:25:29,Bilbao,expenses,children,-160.64,-36289.0
buyer_1,Luis,1996-08-10,ES36209580831926802634,TRX_N-00849-40736087,2024-01-24T11:45:08,Donostia,expenses,food,-88.17,-36377.17
buyer_1,Luis,1996-08-10,ES36209580831926802634,TRX_N-00850-42201161,2024-01-25T15:57:08,Bilbao,expenses,cash,-100.0,-36477.17
buyer_1,Luis,1996-08-10,ES36209580831926802634,TRX_N-00851-18782133,2024-01-27T22:52:03,Basauri,expenses,travel,-850.36,-37327.53
buyer_1,Luis,1996-08-10,ES36209580831926802634,TRX_N-00852-25040380,2024-01-28T20:17:33,Bilbao,expenses,food,-84.23,-37411.76
buyer_1,Luis,1996-08-10,ES36209580831926802634,TRX_N-00853-74819339,2024-01-29T20:20:32,Bilbao,expenses,education,-73.2,-37484.96
buyer_1,Luis,1996-08-10,ES36209580831926802634,TRX_N-00854-99087349,2024-01-30T16:37:24,Bilbao,expenses,transport,-87.04,-37572.0
buyer_1,Luis,1996-08-10,ES36209580831926802634,TRX_N-00855-17155666,2024-02-01T14:02:01,Bilbao,incomes,salary,1572.01,-35999.99
buyer_1,Luis,1996-08-10,ES36209580831926802634,TRX_N-00856-84552168,2024-02-01T14:02:01,Bilbao,incomes,salary_partner,1238.77,-34761.22
buyer_1,Luis,1996-08-10,ES36209580831926802634,TRX_N-00857-24108875,2024-02-01T09:01:57,Bilbao,expenses,healthcare,-160.2,-34921.42
buyer_1,Luis,1996-08-10,ES36209580831926802634,TRX_N-00858-99337972,2024-02-02T23:35:12,Bilbao,expenses,appliances,-204.91,-35126.33
buyer_1,Luis,1996-08-10,ES36209580831926802634,TRX_N-00859-28337693,2024-02-03T16:09:30,Bilbao,expenses,education,-62.95,-35189.28
buyer_1,Luis,1996-08-10,ES36209580831926802634,TRX_N-00860-83626829,2024-02-03T01:38:49,Bilbao,expenses,repairs,-316.43,-35505.71
buyer_1,Luis,1996-08-10,ES36209580831926802634,TRX_N-00861-22949935,2024-02-04T16:20:52,Bilbao,expenses,mortgage,-743.13,-36248.84
buyer_1,Luis,1996-08-10,ES36209580831926802634,TRX_N-00862-37660114,2024-02-05T10:51:14,Bilbao,expenses,electricity,-85.9,-36334.74
buyer_1,Luis,1996-08-10,ES36209580831926802634,TRX_N-00863-14121947,2024-02-05T19:47:00,Bilbao,expenses,phone,-36.93,-36371.67
buyer_1,Luis,1996-08-10,ES36209580831926802634,TRX_N-00864-77609231,2024-02-05T15:09:14,Bilbao,expenses,food,-101.23,-36472.9
buyer_1,Luis,1996-08-10,ES36209580831926802634,TRX_N-00865-17118423,2024-02-05T15:50:55,Bilbao,expenses,travel,-576.39,-37049.29
buyer_1,Luis,1996-08-10,ES36209580831926802634,TRX_N-00866-13485420,2024-02-07T01:51:00,Barakaldo,expenses,leisure,-66.41,-37115.7
buyer_1,Luis,1996-08-10,ES36209580831926802634,TRX_N-00867-57944237,2024-02-08T18:34:26,Bilbao,expenses,water,-42.52,-37158.22
buyer_1,Luis,1996-08-10,ES36209580831926802634,TRX_N-00868-57611277,2024-02-08T20:13:20,Bilbao,expenses,gas,-77.44,-37235.66
buyer_1,Luis,1996-08-10,ES36209580831926802634,TRX_N-00869-12381107,2024-02-08T09:29:26,Bilbao,expenses,internet,-42.0,-37277.66
buyer_1,Luis,1996-08-10,ES36209580831926802634,TRX_N-00870-06535174,2024-02-09T22:34:06,Bilbao,expenses,food,-75.49,-37353.15
buyer_1,Luis,1996-08-10,ES36209580831926802634,TRX_N-00871-88616879,2024-02-09T13:09:36,Bilbao,expenses,education,-50.03,-37403.18
buyer_1,Luis,1996-08-10,ES36209580831926802634,TRX_N-00872-14401825,2024-02-10T17:23:43,Errenteria,expenses,clothing,-70.11,-37473.29
buyer_1,Luis,1996-08-10,ES36209580831926802634,TRX_N-00873-59658734,2024-02-10T15:22:25,Bilbao,expenses,cash,-100.0,-37573.29
buyer_1,Luis,1996-08-10,ES36209580831926802634,TRX_N-00874-54217637,2024-02-13T08:08:30,Bilbao,expenses,healthcare,-45.56,-37618.85
buyer_1,Luis,1996-08-10,ES36209580831926802634,TRX_N-00875-48376454,2024-02-13T13:25:04,Bilbao,expenses,cash,-100.0,-37718.85
buyer_1,Luis,1996-08-10,ES36209580831926802634,TRX_N-00876-91738964,2024-02-13T20:11:21,Bilbao,expenses,travel,-1014.1,-38732.95
buyer_1,Luis,1996-08-10,ES36209580831926802634,TRX_N-00877-76363840,2024-02-14T08:42:45,Bilbao,expenses,children,-100.59,-38833.54
buyer_1,Luis,1996-08-10,ES36209580831926802634,TRX_N-00878-56849631,2024-02-15T21:44:25,Donostia,expenses,leisure,-74.34,-38907.88
buyer_1,Luis,1996-08-10,ES36209580831926802634,TRX_N-00879-91663742,2024-02-20T10:31:05,Bilbao,expenses,clothing,-62.06,-38969.94
buyer_1,Luis,1996-08-10,ES36209580831926802634,TRX_N-00880-26291142,2024-02-21T16:15:21,Bilbao,expenses,cash,-100.0,-39069.94
buyer_1,Luis,1996-08-10,ES36209580831926802634,TRX_N-00881-22160968,2024-02-23T23:20:13,Hernani,expenses,transport,-59.06,-39129.0
buyer_1,Luis,1996-08-10,ES36209580831926802634,TRX_N-00882-75909321,2024-02-23T09:29:32,Labastida,expenses,repairs,-279.83,-39408.83
buyer_1,Luis,1996-08-10,ES36209580831926802634,TRX_N-00883-55335889,2024-02-24T06:20:21,Bilbao,expenses,food,-75.41,-39484.24
buyer_1,Luis,1996-08-10,ES36209580831926802634,TRX_N-00884-31991744,2024-02-25T20:38:48,Bilbao,expenses,transport,-54.79,-39539.03
buyer_1,Luis,1996-08-10,ES36209580831926802634,TRX_N-00885-24138005,2024-02-27T23:20:57,Bilbao,expenses,leisure,-79.53,-39618.56
buyer_1,Luis,1996-08-10,ES36209580831926802634,TRX_N-00886-56222334,2024-02-27T11:17:46,Bilbao,expenses,cash,-100.0,-39718.56
buyer_1,Luis,1996-08-10,ES36209580831926802634,TRX_N-00887-52667372,2024-03-01T06:19:00,Bilbao,incomes,salary,1572.01,-38146.55
buyer_1,Luis,1996-08-10,ES36209580831926802634,TRX_N-00888-17424912,2024-03-01T06:19:00,Bilbao,incomes,salary_partner,1238.77,-36907.78
buyer_1,Luis,1996-08-10,ES36209580831926802634,TRX_N-00889-73690194,2024-03-01T11:19:07,Bilbao,expenses,cash,-100.0,-37007.78
buyer_1,Luis,1996-08-10,ES36209580831926802634,TRX_N-00890-29432768,2024-03-03T16:59:10,Bilbao,expenses,food,-108.77,-37116.55
buyer_1,Luis,1996-08-10,ES36209580831926802634,TRX_N-00891-32760835,2024-03-04T08:19:53,Bilbao,expenses,mortgage,-743.13,-37859.68
buyer_1,Luis,1996-08-10,ES36209580831926802634,TRX_N-00892-65353563,2024-03-04T10:31:10,Bilbao,expenses,education,-57.27,-37916.95
buyer_1,Luis,1996-08-10,ES36209580831926802634,TRX_N-00893-32467581,2024-03-05T17:00:10,Bilbao,expenses,water,-35.41,-37952.36
buyer_1,Luis,1996-08-10,ES36209580831926802634,TRX_N-00894-26736295,2024-03-05T13:07:06,Bilbao,expenses,gas,-104.6,-38056.96
buyer_1,Luis,1996-08-10,ES36209580831926802634,TRX_N-00895-20649961,2024-03-05T13:13:23,Bilbao,expenses,internet,-42.0,-38098.96
buyer_1,Luis,1996-08-10,ES36209580831926802634,TRX_N-00896-99471084,2024-03-05T13:28:13,Bilbao,expenses,food,-70.34,-38169.3
buyer_1,Luis,1996-08-10,ES36209580831926802634,TRX_N-00897-79546040,2024-03-05T08:05:47,Bilbao,expenses,cash,-100.0,-38269.3
buyer_1,Luis,1996-08-10,ES36209580831926802634,TRX_N-00898-63622804,2024-03-06T16:09:35,Bilbao,expenses,healthcare,-169.36,-38438.66
buyer_1,Luis,1996-08-10,ES36209580831926802634,TRX_N-00899-14029678,2024-03-06T01:29:05,Bilbao,expenses,education,-62.6,-38501.26
buyer_1,Luis,1996-08-10,ES36209580831926802634,TRX_N-00900-31828613,2024-03-08T16:59:45,Bilbao,expenses,phone,-36.16,-38537.42
buyer_1,Luis,1996-08-10,ES36209580831926802634,TRX_N-00901-90917993,2024-03-08T09:25:41,Bilbao,expenses,electricity,-33.02,-38570.44
buyer_1,Luis,1996-08-10,ES36209580831926802634,TRX_N-00902-48942003,2024-03-08T13:35:00,Bilbao,expenses,leisure,-55.65,-38626.09
buyer_1,Luis,1996-08-10,ES36209580831926802634,TRX_N-00903-01732736,2024-03-09T23:39:26,Bilbao,expenses,food,-107.57,-38733.66
buyer_1,Luis,1996-08-10,ES36209580831926802634,TRX_N-00904-84110518,2024-03-10T19:00:28,Bilbao,expenses,education,-72.63,-38806.29
buyer_1,Luis,1996-08-10,ES36209580831926802634,TRX_N-00905-54839072,2024-03-11T13:12:40,Zarautz,expenses,cash,-100.0,-38906.29
buyer_1,Luis,1996-08-10,ES36209580831926802634,TRX_N-00906-38064724,2024-03-11T01:21:20,Donostia,expenses,travel,-1884.41,-40790.7
buyer_1,Luis,1996-08-10,ES36209580831926802634,TRX_N-00907-31865921,2024-03-12T15:23:23,Bilbao,expenses,food,-111.25,-40901.95
buyer_1,Luis,1996-08-10,ES36209580831926802634,TRX_N-00908-70592391,2024-03-13T20:28:31,Bilbao,expenses,transport,-49.46,-40951.41
buyer_1,Luis,1996-08-10,ES36209580831926802634,TRX_N-00909-31932810,2024-03-13T18:01:40,Bilbao,expenses,cash,-100.0,-41051.41
buyer_1,Luis,1996-08-10,ES36209580831926802634,TRX_N-00910-52688645,2024-03-16T19:34:51,Bilbao,expenses,cash,-100.0,-41151.41
buyer_1,Luis,1996-08-10,ES36209580831926802634,TRX_N-00911-79274069,2024-03-19T10:59:40,Bilbao,expenses,transport,-78.53,-41229.94
buyer_1,Luis,1996-08-10,ES36209580831926802634,TRX_N-00912-43220512,2024-03-20T11:58:11,Bilbao,expenses,cash,-100.0,-41329.94
buyer_1,Luis,1996-08-10,ES36209580831926802634,TRX_N-00913-93054357,2024-03-22T13:14:58,Sestao,expenses,clothing,-122.66,-41452.6
buyer_1,Luis,1996-08-10,ES36209580831926802634,TRX_N-00914-40147737,2024-03-23T12:06:29,Llodio,expenses,healthcare,-73.59,-41526.19
buyer_1,Luis,1996-08-10,ES36209580831926802634,TRX_N-00915-29408550,2024-03-24T15:50:07,Bilbao,expenses,cash,-100.0,-41626.19
buyer_1,Luis,1996-08-10,ES36209580831926802634,TRX_N-00916-02875072,2024-03-25T20:19:41,Bilbao,expenses,gifts,-703.11,-42329.3
buyer_1,Luis,1996-08-10,ES36209580831926802634,TRX_N-00917-60350279,2024-03-26T08:54:40,Bilbao,expenses,clothing,-106.0,-42435.3
buyer_1,Luis,1996-08-10,ES36209580831926802634,TRX_N-00918-14227707,2024-03-28T16:56:01,Bilbao,expenses,clothing,-133.11,-42568.41
buyer_1,Luis,1996-08-10,ES36209580831926802634,TRX_N-00919-50218077,2024-03-28T18:36:04,Bilbao,expenses,healthcare,-171.46,-42739.87
buyer_1,Luis,1996-08-10,ES36209580831926802634,TRX_N-00920-36845798,2024-03-30T16:45:48,Bilbao,expenses,leisure,-53.49,-42793.36
buyer_1,Luis,1996-08-10,ES36209580831926802634,TRX_N-00921-03702936,2024-03-31T10:52:44,Bilbao,expenses,food,-68.68,-42862.04
buyer_1,Luis,1996-08-10,ES36209580831926802634,TRX_N-00922-29227917,2024-03-31T12:18:13,Bilbao,expenses,repairs,-280.53,-43142.57
buyer_1,Luis,1996-08-10,ES36209580831926802634,TRX_N-00923-23715303,2024-04-01T11:41:42,Bilbao,incomes,salary,1572.01,-41570.56
buyer_1,Luis,1996-08-10,ES36209580831926802634,TRX_N-00924-60340544,2024-04-01T11:41:42,Bilbao,incomes,salary_partner,1238.77,-40331.79
buyer_1,Luis,1996-08-10,ES36209580831926802634,TRX_N-00925-24495213,2024-04-01T11:41:42,Bilbao,incomes,extra_income,241.2,-40090.59
buyer_1,Luis,1996-08-10,ES36209580831926802634,TRX_N-00926-47072274,2024-04-01T17:52:02,Bilbao,expenses,food,-73.85,-40164.44
buyer_1,Luis,1996-08-10,ES36209580831926802634,TRX_N-00927-77755116,2024-04-02T21:44:03,Bilbao,expenses,food,-84.96,-40249.4
buyer_1,Luis,1996-08-10,ES36209580831926802634,TRX_N-00928-98787009,2024-04-04T04:22:46,Bilbao,expenses,mortgage,-743.13,-40992.53
buyer_1,Luis,1996-08-10,ES36209580831926802634,TRX_N-00929-12010218,2024-04-05T16:39:58,Bilbao,expenses,water,-40.53,-41033.06
buyer_1,Luis,1996-08-10,ES36209580831926802634,TRX_N-00930-99951449,2024-04-05T17:07:24,Eibar,expenses,transport,-82.32,-41115.38
buyer_1,Luis,1996-08-10,ES36209580831926802634,TRX_N-00931-51370311,2024-04-05T18:16:36,Bilbao,expenses,leisure,-19.65,-41135.03
buyer_1,Luis,1996-08-10,ES36209580831926802634,TRX_N-00932-60006431,2024-04-05T11:54:20,Bilbao,expenses,cash,-100.0,-41235.03
buyer_1,Luis,1996-08-10,ES36209580831926802634,TRX_N-00933-95826611,2024-04-06T14:32:22,Erandio,expenses,repairs,-41.75,-41276.78
buyer_1,Luis,1996-08-10,ES36209580831926802634,TRX_N-00934-33153175,2024-04-07T10:55:48,Bilbao,expenses,phone,-41.56,-41318.34
buyer_1,Luis,1996-08-10,ES36209580831926802634,TRX_N-00935-08543967,2024-04-07T04:14:30,Elciego,expenses,food,-95.95,-41414.29
buyer_1,Luis,1996-08-10,ES36209580831926802634,TRX_N-00936-02652401,2024-04-08T08:38:42,Bilbao,expenses,internet,-42.0,-41456.29
buyer_1,Luis,1996-08-10,ES36209580831926802634,TRX_N-00937-63690746,2024-04-08T18:26:27,Bilbao,expenses,electricity,-30.5,-41486.79
buyer_1,Luis,1996-08-10,ES36209580831926802634,TRX_N-00938-02071648,2024-04-08T09:32:08,Bilbao,expenses,gas,-95.49,-41582.28
buyer_1,Luis,1996-08-10,ES36209580831926802634,TRX_N-00939-81057217,2024-04-08T09:25:29,Bilbao,expenses,clothing,-68.36,-41650.64
buyer_1,Luis,1996-08-10,ES36209580831926802634,TRX_N-00940-50573527,2024-04-12T23:03:37,Sopela,expenses,food,-103.49,-41754.13
buyer_1,Luis,1996-08-10,ES36209580831926802634,TRX_N-00941-62613088,2024-04-13T14:05:12,Bilbao,expenses,leisure,-19.62,-41773.75
buyer_1,Luis,1996-08-10,ES36209580831926802634,TRX_N-00942-15320591,2024-04-13T19:21:39,Bilbao,expenses,cash,-100.0,-41873.75
buyer_1,Luis,1996-08-10,ES36209580831926802634,TRX_N-00943-61893462,2024-04-14T10:05:21,Bilbao,expenses,transport,-53.61,-41927.36
buyer_1,Luis,1996-08-10,ES36209580831926802634,TRX_N-00944-46225065,2024-04-15T15:12:48,Bilbao,expenses,transport,-74.62,-42001.98
buyer_1,Luis,1996-08-10,ES36209580831926802634,TRX_N-00945-90602465,2024-04-16T16:22:25,Bilbao,expenses,transport,-50.74,-42052.72
buyer_1,Luis,1996-08-10,ES36209580831926802634,TRX_N-00946-44720616,2024-04-17T19:28:12,Bilbao,expenses,cash,-100.0,-42152.72
buyer_1,Luis,1996-08-10,ES36209580831926802634,TRX_N-00947-21681973,2024-04-17T08:23:42,Bilbao,expenses,repairs,-299.64,-42452.36
buyer_1,Luis,1996-08-10,ES36209580831926802634,TRX_N-00948-04882377,2024-04-18T10:22:39,Bilbao,expenses,leisure,-83.44,-42535.8
buyer_1,Luis,1996-08-10,ES36209580831926802634,TRX_N-00949-17018332,2024-04-18T09:14:40,Eibar,expenses,clothing,-88.26,-42624.06
buyer_1,Luis,1996-08-10,ES36209580831926802634,TRX_N-00950-49200706,2024-04-18T13:35:35,Bilbao,expenses,cash,-100.0,-42724.06
buyer_1,Luis,1996-08-10,ES36209580831926802634,TRX_N-00951-89750804,2024-04-20T16:02:48,Bilbao,expenses,cash,-100.0,-42824.06
buyer_1,Luis,1996-08-10,ES36209580831926802634,TRX_N-00952-95855581,2024-04-21T16:42:13,Bilbao,expenses,leisure,-61.8,-42885.86
buyer_1,Luis,1996-08-10,ES36209580831926802634,TRX_N-00953-70512079,2024-04-21T08:46:42,Bilbao,expenses,cash,-100.0,-42985.86
buyer_1,Luis,1996-08-10,ES36209580831926802634,TRX_N-00954-83207314,2024-04-22T14:42:58,Bilbao,expenses,cash,-100.0,-43085.86
buyer_1,Luis,1996-08-10,ES36209580831926802634,TRX_N-00955-01196602,2024-04-24T11:07:14,Bilbao,expenses,cash,-100.0,-43185.86
buyer_1,Luis,1996-08-10,ES36209580831926802634,TRX_N-00956-73253483,2024-04-25T08:43:28,Bilbao,expenses,leisure,-72.48,-43258.34
buyer_1,Luis,1996-08-10,ES36209580831926802634,TRX_N-00957-83088861,2024-04-26T11:12:24,Bilbao,expenses,cash,-100.0,-43358.34
buyer_1,Luis,1996-08-10,ES36209580831926802634,TRX_N-00958-94591853,2024-04-27T12:16:27,Bilbao,expenses,food,-109.76,-43468.1
buyer_1,Luis,1996-08-10,ES36209580831926802634,TRX_N-00959-75466700,2024-04-27T22:28:17,Donostia,expenses,cash,-100.0,-43568.1
buyer_1,Luis,1996-08-10,ES36209580831926802634,TRX_N-00960-38250481,2024-04-27T15:42:41,Bilbao,expenses,children,-267.59,-43835.69
buyer_1,Luis,1996-08-10,ES36209580831926802634,TRX_N-00961-09746054,2024-04-29T16:38:34,Bilbao,expenses,food,-88.87,-43924.56
buyer_1,Luis,1996-08-10,ES36209580831926802634,TRX_N-00962-26828332,2024-05-01T15:49:59,Bilbao,incomes,salary,1572.01,-42352.55
buyer_1,Luis,1996-08-10,ES36209580831926802634,TRX_N-00963-39552324,2024-05-01T15:49:59,Bilbao,incomes,salary_partner,1238.77,-41113.78
buyer_1,Luis,1996-08-10,ES36209580831926802634,TRX_N-00964-58777379,2024-05-01T09:21:33,Bilbao,expenses,leisure,-40.72,-41154.5
buyer_1,Luis,1996-08-10,ES36209580831926802634,TRX_N-00965-76651941,2024-05-02T12:38:59,Bilbao,expenses,leisure,-54.59,-41209.09
buyer_1,Luis,1996-08-10,ES36209580831926802634,TRX_N-00966-30569082,2024-05-03T20:20:19,Bilbao,expenses,children,-215.37,-41424.46
buyer_1,Luis,1996-08-10,ES36209580831926802634,TRX_N-00967-81639982,2024-05-04T17:18:56,Bilbao,expenses,mortgage,-743.13,-42167.59
buyer_1,Luis,1996-08-10,ES36209580831926802634,TRX_N-00968-96252553,2024-05-05T08:41:27,Bilbao,expenses,electricity,-50.83,-42218.42
buyer_1,Luis,1996-08-10,ES36209580831926802634,TRX_N-00969-07228874,2024-05-05T10:44:57,Bilbao,expenses,gifts,-132.92,-42351.34
buyer_1,Luis,1996-08-10,ES36209580831926802634,TRX_N-00970-10583705,2024-05-07T09:22:56,Bilbao,expenses,water,-41.54,-42392.88
buyer_1,Luis,1996-08-10,ES36209580831926802634,TRX_N-00971-30531438,2024-05-07T20:45:55,Bilbao,expenses,gas,-84.84,-42477.72
buyer_1,Luis,1996-08-10,ES36209580831926802634,TRX_N-00972-44421486,2024-05-07T19:26:28,Bilbao,expenses,food,-96.51,-42574.23
buyer_1,Luis,1996-08-10,ES36209580831926802634,TRX_N-00973-52023843,2024-05-08T10:44:08,Bilbao,expenses,internet,-42.0,-42616.23
buyer_1,Luis,1996-08-10,ES36209580831926802634,TRX_N-00974-93782424,2024-05-08T14:41:27,Bilbao,expenses,phone,-43.68,-42659.91
buyer_1,Luis,1996-08-10,ES36209580831926802634,TRX_N-00975-32715155,2024-05-09T09:38:59,Bilbao,expenses,repairs,-322.52,-42982.43
buyer_1,Luis,1996-08-10,ES36209580831926802634,TRX_N-00976-69691865,2024-05-11T20:56:00,Bilbao,expenses,transport,-55.34,-43037.77
buyer_1,Luis,1996-08-10,ES36209580831926802634,TRX_N-00977-87373675,2024-05-11T08:03:06,Bilbao,expenses,leisure,-43.9,-43081.67
buyer_1,Luis,1996-08-10,ES36209580831926802634,TRX_N-00978-11036906,2024-05-13T13:45:34,Bilbao,expenses,cash,-100.0,-43181.67
buyer_1,Luis,1996-08-10,ES36209580831926802634,TRX_N-00979-87443232,2024-05-14T11:04:21,Bilbao,expenses,food,-117.2,-43298.87
buyer_1,Luis,1996-08-10,ES36209580831926802634,TRX_N-00980-33611120,2024-05-15T15:21:15,Bilbao,expenses,cash,-100.0,-43398.87
buyer_1,Luis,1996-08-10,ES36209580831926802634,TRX_N-00981-11245925,2024-05-16T22:36:52,Bilbao,expenses,leisure,-62.74,-43461.61
buyer_1,Luis,1996-08-10,ES36209580831926802634,TRX_N-00982-49689388,2024-05-17T13:36:30,Bilbao,expenses,food,-99.34,-43560.95
buyer_1,Luis,1996-08-10,ES36209580831926802634,TRX_N-00983-50938058,2024-05-17T18:08:37,Bilbao,expenses,leisure,-20.27,-43581.22
buyer_1,Luis,1996-08-10,ES36209580831926802634,TRX_N-00984-50871008,2024-05-19T13:04:30,Bilbao,expenses,food,-69.02,-43650.24
buyer_1,Luis,1996-08-10,ES36209580831926802634,TRX_N-00985-22500713,2024-05-19T12:01:21,Bilbao,expenses,transport,-56.24,-43706.48
buyer_1,Luis,1996-08-10,ES36209580831926802634,TRX_N-00986-04169522,2024-05-19T14:35:34,Bilbao,expenses,education,-42.59,-43749.07
buyer_1,Luis,1996-08-10,ES36209580831926802634,TRX_N-00987-91169762,2024-05-19T13:08:01,Bilbao,expenses,travel,-990.38,-44739.45
buyer_1,Luis,1996-08-10,ES36209580831926802634,TRX_N-00988-53375241,2024-05-20T14:52:50,Bilbao,expenses,food,-76.75,-44816.2
buyer_1,Luis,1996-08-10,ES36209580831926802634,TRX_N-00989-00265870,2024-05-21T09:39:08,Bilbao,expenses,transport,-69.4,-44885.6
buyer_1,Luis,1996-08-10,ES36209580831926802634,TRX_N-00990-45180670,2024-05-21T10:14:03,Bilbao,expenses,cash,-100.0,-44985.6
buyer_1,Luis,1996-08-10,ES36209580831926802634,TRX_N-00991-80053695,2024-05-21T12:41:58,Bilbao,expenses,repairs,-102.77,-45088.37
buyer_1,Luis,1996-08-10,ES36209580831926802634,TRX_N-00992-84120450,2024-05-23T14:40:01,Andoain,expenses,food,-86.89,-45175.26
buyer_1,Luis,1996-08-10,ES36209580831926802634,TRX_N-00993-96420997,2024-05-24T15:29:34,Lasarte-Oria,expenses,transport,-67.16,-45242.42
buyer_1,Luis,1996-08-10,ES36209580831926802634,TRX_N-00994-04564375,2024-05-25T04:02:02,Bilbao,expenses,leisure,-22.73,-45265.15
buyer_1,Luis,1996-08-10,ES36209580831926802634,TRX_N-00995-33044750,2024-05-25T22:32:49,Bilbao,expenses,cash,-100.0,-45365.15
buyer_1,Luis,1996-08-10,ES36209580831926802634,TRX_N-00996-42267907,2024-05-28T15:25:26,Basauri,expenses,food,-75.36,-45440.51
buyer_1,Luis,1996-08-10,ES36209580831926802634,TRX_N-00997-32282150,2024-05-29T11:52:33,Bilbao,expenses,food,-104.92,-45545.43
buyer_1,Luis,1996-08-10,ES36209580831926802634,TRX_N-00998-80494497,2024-05-30T08:04:56,Bilbao,expenses,gifts,-341.97,-45887.4
buyer_1,Luis,1996-08-10,ES36209580831926802634,TRX_N-00999-56131873,2024-05-31T16:38:04,Bilbao,expenses,gifts,-445.75,-46333.15
buyer_1,Luis,1996-08-10,ES36209580831926802634,TRX_N-01000-16923573,2024-06-01T11:26:21,Bilbao,incomes,salary,1572.01,-44761.14
buyer_1,Luis,1996-08-10,ES36209580831926802634,TRX_N-01001-93124641,2024-06-01T11:26:21,Bilbao,incomes,salary_partner,1238.77,-43522.37
buyer_1,Luis,1996-08-10,ES36209580831926802634,TRX_N-01002-47362113,2024-06-01T11:26:21,Bilbao,incomes,salary_bonus,1125.98,-42396.39
buyer_1,Luis,1996-08-10,ES36209580831926802634,TRX_N-01003-41879808,2024-06-01T11:26:21,Bilbao,incomes,salary_partner_bonus,887.6,-41508.79
buyer_1,Luis,1996-08-10,ES36209580831926802634,TRX_N-01004-81854343,2024-06-01T10:25:34,Bilbao,expenses,taxes,-1328.35,-42837.14
buyer_1,Luis,1996-08-10,ES36209580831926802634,TRX_N-01005-89637889,2024-06-01T20:21:50,Bilbao,expenses,insurance,-455.42,-43292.56
buyer_1,Luis,1996-08-10,ES36209580831926802634,TRX_N-01006-67550130,2024-06-03T23:27:12,Bilbao,expenses,transport,-82.56,-43375.12
buyer_1,Luis,1996-08-10,ES36209580831926802634,TRX_N-01007-52931100,2024-06-03T08:16:22,Bilbao,expenses,leisure,-53.21,-43428.33
buyer_1,Luis,1996-08-10,ES36209580831926802634,TRX_N-01008-71737518,2024-06-04T14:58:25,Bilbao,expenses,mortgage,-743.13,-44171.46
buyer_1,Luis,1996-08-10,ES36209580831926802634,TRX_N-01009-48603063,2024-06-05T10:30:31,Bilbao,expenses,electricity,-52.75,-44224.21
buyer_1,Luis,1996-08-10,ES36209580831926802634,TRX_N-01010-64303749,2024-06-05T14:45:11,Bilbao,expenses,cash,-100.0,-44324.21
buyer_1,Luis,1996-08-10,ES36209580831926802634,TRX_N-01011-05081115,2024-06-05T09:04:35,Bilbao,expenses,gifts,-786.15,-45110.36
buyer_1,Luis,1996-08-10,ES36209580831926802634,TRX_N-01012-73211584,2024-06-06T19:20:21,Bilbao,expenses,gas,-54.53,-45164.89
buyer_1,Luis,1996-08-10,ES36209580831926802634,TRX_N-01013-77596626,2024-06-06T13:14:54,Bilbao,expenses,repairs,-90.28,-45255.17
buyer_1,Luis,1996-08-10,ES36209580831926802634,TRX_N-01014-47714383,2024-06-07T15:05:55,Bilbao,expenses,internet,-42.0,-45297.17
buyer_1,Luis,1996-08-10,ES36209580831926802634,TRX_N-01015-39898345,2024-06-07T16:59:02,Bilbao,expenses,phone,-38.65,-45335.82
buyer_1,Luis,1996-08-10,ES36209580831926802634,TRX_N-01016-06975221,2024-06-07T22:39:30,Bilbao,expenses,food,-100.24,-45436.06
buyer_1,Luis,1996-08-10,ES36209580831926802634,TRX_N-01017-84171294,2024-06-07T15:08:15,Bilbao,expenses,leisure,-42.42,-45478.48
buyer_1,Luis,1996-08-10,ES36209580831926802634,TRX_N-01018-60452320,2024-06-08T19:44:25,Bilbao,expenses,water,-30.64,-45509.12
buyer_1,Luis,1996-08-10,ES36209580831926802634,TRX_N-01019-01741595,2024-06-10T12:02:48,Bilbao,expenses,cash,-100.0,-45609.12
buyer_1,Luis,1996-08-10,ES36209580831926802634,TRX_N-01020-77613832,2024-06-12T20:36:56,Labastida,expenses,food,-60.22,-45669.34
buyer_1,Luis,1996-08-10,ES36209580831926802634,TRX_N-01021-59101697,2024-06-12T02:41:36,Bilbao,expenses,cash,-100.0,-45769.34
buyer_1,Luis,1996-08-10,ES36209580831926802634,TRX_N-01022-81829250,2024-06-13T13:21:25,Llodio,expenses,food,-110.59,-45879.93
buyer_1,Luis,1996-08-10,ES36209580831926802634,TRX_N-01023-91966387,2024-06-13T09:09:04,Bilbao,expenses,cash,-100.0,-45979.93
buyer_1,Luis,1996-08-10,ES36209580831926802634,TRX_N-01024-60232609,2024-06-13T20:40:41,Bilbao,expenses,gifts,-312.43,-46292.36
buyer_1,Luis,1996-08-10,ES36209580831926802634,TRX_N-01025-00155595,2024-06-14T09:17:41,Durango,expenses,transport,-83.74,-46376.1
buyer_1,Luis,1996-08-10,ES36209580831926802634,TRX_N-01026-40139004,2024-06-14T09:19:28,Bilbao,expenses,cash,-100.0,-46476.1
buyer_1,Luis,1996-08-10,ES36209580831926802634,TRX_N-01027-71345024,2024-06-15T09:10:32,Bilbao,expenses,cash,-100.0,-46576.1
buyer_1,Luis,1996-08-10,ES36209580831926802634,TRX_N-01028-53028844,2024-06-18T17:43:18,Bilbao,expenses,transport,-75.43,-46651.53
buyer_1,Luis,1996-08-10,ES36209580831926802634,TRX_N-01029-49974851,2024-06-18T16:27:33,Bilbao,expenses,education,-53.9,-46705.43
buyer_1,Luis,1996-08-10,ES36209580831926802634,TRX_N-01030-82039385,2024-06-19T09:42:09,Bilbao,expenses,healthcare,-77.84,-46783.27
buyer_1,Luis,1996-08-10,ES36209580831926802634,TRX_N-01031-85748855,2024-06-19T16:56:03,Bilbao,expenses,education,-44.49,-46827.76
buyer_1,Luis,1996-08-10,ES36209580831926802634,TRX_N-01032-00506134,2024-06-20T09:33:20,Vitoria-Gasteiz,expenses,transport,-86.15,-46913.91
buyer_1,Luis,1996-08-10,ES36209580831926802634,TRX_N-01033-68120643,2024-06-22T00:16:34,Bilbao,expenses,leisure,-56.41,-46970.32
buyer_1,Luis,1996-08-10,ES36209580831926802634,TRX_N-01034-24029236,2024-06-23T10:53:15,Bilbao,expenses,food,-106.95,-47077.27
buyer_1,Luis,1996-08-10,ES36209580831926802634,TRX_N-01035-50886117,2024-06-24T15:03:25,Bilbao,expenses,transport,-58.1,-47135.37
buyer_1,Luis,1996-08-10,ES36209580831926802634,TRX_N-01036-26334159,2024-06-25T10:41:27,Bilbao,expenses,food,-102.85,-47238.22
buyer_1,Luis,1996-08-10,ES36209580831926802634,TRX_N-01037-73237232,2024-06-27T14:44:03,Bilbao,expenses,cash,-100.0,-47338.22
buyer_1,Luis,1996-08-10,ES36209580831926802634,TRX_N-01038-89186441,2024-06-27T10:16:19,Bilbao,expenses,gifts,-573.99,-47912.21
buyer_1,Luis,1996-08-10,ES36209580831926802634,TRX_N-01039-07017069,2024-06-28T18:20:54,Bilbao,expenses,gifts,-660.87,-48573.08
buyer_1,Luis,1996-08-10,ES36209580831926802634,TRX_N-01040-26087304,2024-06-30T12:27:09,Bilbao,expenses,food,-80.15,-48653.23
buyer_1,Luis,1996-08-10,ES36209580831926802634,TRX_N-01041-34951597,2024-06-30T10:23:31,Bilbao,expenses,cash,-100.0,-48753.23
buyer_1,Luis,1996-08-10,ES36209580831926802634,TRX_N-01042-18980272,2024-07-01T03:30:12,Bilbao,incomes,salary,1572.01,-47181.22
buyer_1,Luis,1996-08-10,ES36209580831926802634,TRX_N-01043-83863334,2024-07-01T03:30:12,Bilbao,incomes,salary_partner,1238.77,-45942.45
buyer_1,Luis,1996-08-10,ES36209580831926802634,TRX_N-01044-98349829,2024-07-01T16:37:44,Bilbao,expenses,transport,-61.74,-46004.19
buyer_1,Luis,1996-08-10,ES36209580831926802634,TRX_N-01045-86105091,2024-07-02T14:33:43,Donostia,expenses,cash,-100.0,-46104.19
buyer_1,Luis,1996-08-10,ES36209580831926802634,TRX_N-01046-20193548,2024-07-03T14:16:05,Bilbao,expenses,leisure,-53.25,-46157.44
buyer_1,Luis,1996-08-10,ES36209580831926802634,TRX_N-01047-01941949,2024-07-03T12:45:45,Vitoria-Gasteiz,expenses,clothing,-119.49,-46276.93
buyer_1,Luis,1996-08-10,ES36209580831926802634,TRX_N-01048-45968473,2024-07-04T12:14:10,Bilbao,expenses,mortgage,-743.13,-47020.06
buyer_1,Luis,1996-08-10,ES36209580831926802634,TRX_N-01049-85237950,2024-07-06T21:57:26,Bilbao,expenses,internet,-42.0,-47062.06
buyer_1,Luis,1996-08-10,ES36209580831926802634,TRX_N-01050-77845658,2024-07-08T19:28:42,Bilbao,expenses,electricity,-80.72,-47142.78
buyer_1,Luis,1996-08-10,ES36209580831926802634,TRX_N-01051-64077708,2024-07-08T11:28:18,Bilbao,expenses,phone,-41.37,-47184.15
buyer_1,Luis,1996-08-10,ES36209580831926802634,TRX_N-01052-49576358,2024-07-08T17:47:07,Bilbao,expenses,water,-37.86,-47222.01
buyer_1,Luis,1996-08-10,ES36209580831926802634,TRX_N-01053-91785342,2024-07-08T16:28:53,Bilbao,expenses,gas,-84.64,-47306.65
buyer_1,Luis,1996-08-10,ES36209580831926802634,TRX_N-01054-89898744,2024-07-10T10:39:14,Erandio,expenses,education,-61.9,-47368.55
buyer_1,Luis,1996-08-10,ES36209580831926802634,TRX_N-01055-08441516,2024-07-11T17:47:12,Bilbao,expenses,leisure,-83.6,-47452.15
buyer_1,Luis,1996-08-10,ES36209580831926802634,TRX_N-01056-25847654,2024-07-12T08:00:16,Bilbao,expenses,food,-61.92,-47514.07
buyer_1,Luis,1996-08-10,ES36209580831926802634,TRX_N-01057-83452171,2024-07-12T18:33:34,Bilbao,expenses,travel,-427.31,-47941.38
buyer_1,Luis,1996-08-10,ES36209580831926802634,TRX_N-01058-43892798,2024-07-16T18:57:33,Bilbao,expenses,food,-101.17,-48042.55
buyer_1,Luis,1996-08-10,ES36209580831926802634,TRX_N-01059-72279275,2024-07-16T15:45:03,Bilbao,expenses,repairs,-35.2,-48077.75
buyer_1,Luis,1996-08-10,ES36209580831926802634,TRX_N-01060-67086161,2024-07-17T20:37:41,Bilbao,expenses,transport,-63.21,-48140.96
buyer_1,Luis,1996-08-10,ES36209580831926802634,TRX_N-01061-12820996,2024-07-17T23:04:18,Bilbao,expenses,education,-67.58,-48208.54
buyer_1,Luis,1996-08-10,ES36209580831926802634,TRX_N-01062-61039758,2024-07-19T20:42:22,Bilbao,expenses,transport,-88.42,-48296.96
buyer_1,Luis,1996-08-10,ES36209580831926802634,TRX_N-01063-24463985,2024-07-20T08:37:15,Bilbao,expenses,leisure,-70.44,-48367.4
buyer_1,Luis,1996-08-10,ES36209580831926802634,TRX_N-01064-11088779,2024-07-21T18:40:53,Bilbao,expenses,repairs,-178.87,-48546.27
buyer_1,Luis,1996-08-10,ES36209580831926802634,TRX_N-01065-84722446,2024-07-21T18:18:23,Bilbao,expenses,gifts,-162.51,-48708.78
buyer_1,Luis,1996-08-10,ES36209580831926802634,TRX_N-01066-73824787,2024-07-22T15:39:15,Bilbao,expenses,cash,-100.0,-48808.78
buyer_1,Luis,1996-08-10,ES36209580831926802634,TRX_N-01067-12679346,2024-07-24T21:18:14,Bilbao,expenses,cash,-100.0,-48908.78
buyer_1,Luis,1996-08-10,ES36209580831926802634,TRX_N-01068-82484146,2024-07-27T18:50:57,Bilbao,expenses,cash,-100.0,-49008.78
buyer_1,Luis,1996-08-10,ES36209580831926802634,TRX_N-01069-27048338,2024-07-27T11:54:35,Bilbao,expenses,gifts,-634.67,-49643.45
buyer_1,Luis,1996-08-10,ES36209580831926802634,TRX_N-01070-39358478,2024-07-28T20:49:51,Bilbao,expenses,leisure,-57.78,-49701.23
buyer_1,Luis,1996-08-10,ES36209580831926802634,TRX_N-01071-93855623,2024-07-28T08:29:09,Bilbao,expenses,healthcare,-109.14,-49810.37
buyer_1,Luis,1996-08-10,ES36209580831926802634,TRX_N-01072-33454299,2024-07-28T10:56:36,Bilbao,expenses,cash,-100.0,-49910.37
buyer_1,Luis,1996-08-10,ES36209580831926802634,TRX_N-01073-58700615,2024-07-28T15:53:36,Bilbao,expenses,children,-167.29,-50077.66
buyer_1,Luis,1996-08-10,ES36209580831926802634,TRX_N-01074-01675564,2024-07-31T03:33:17,Bilbao,expenses,leisure,-73.52,-50151.18
buyer_1,Luis,1996-08-10,ES36209580831926802634,TRX_N-01075-20725606,2024-07-31T17:09:27,Getxo,expenses,cash,-100.0,-50251.18
buyer_1,Luis,1996-08-10,ES36209580831926802634,TRX_N-01076-19371763,2024-07-31T17:43:39,Bilbao,expenses,gifts,-120.0,-50371.18
buyer_1,Luis,1996-08-10,ES36209580831926802634,TRX_N-01077-75357677,2024-08-01T20:15:08,Bilbao,incomes,salary,1572.01,-48799.17
buyer_1,Luis,1996-08-10,ES36209580831926802634,TRX_N-01078-31340295,2024-08-01T20:15:08,Bilbao,incomes,salary_partner,1238.77,-47560.4
buyer_1,Luis,1996-08-10,ES36209580831926802634,TRX_N-01079-70940110,2024-08-01T20:15:08,Bilbao,incomes,extra_income,241.2,-47319.2
buyer_1,Luis,1996-08-10,ES36209580831926802634,TRX_N-01080-91131491,2024-08-02T20:46:36,Bilbao,expenses,education,-50.66,-47369.86
buyer_1,Luis,1996-08-10,ES36209580831926802634,TRX_N-01081-10466829,2024-08-03T16:36:41,Bilbao,expenses,food,-105.65,-47475.51
buyer_1,Luis,1996-08-10,ES36209580831926802634,TRX_N-01082-01636588,2024-08-03T18:45:32,Bilbao,expenses,cash,-100.0,-47575.51
buyer_1,Luis,1996-08-10,ES36209580831926802634,TRX_N-01083-27840130,2024-08-04T17:54:49,Bilbao,expenses,mortgage,-743.13,-48318.64
buyer_1,Luis,1996-08-10,ES36209580831926802634,TRX_N-01084-68188010,2024-08-04T08:01:28,Bilbao,expenses,healthcare,-77.31,-48395.95
buyer_1,Luis,1996-08-10,ES36209580831926802634,TRX_N-01085-64954192,2024-08-05T16:32:29,Andoain,expenses,travel,-1670.84,-50066.79
buyer_1,Luis,1996-08-10,ES36209580831926802634,TRX_N-01086-60670125,2024-08-05T08:48:14,Bilbao,expenses,repairs,-113.95,-50180.74
buyer_1,Luis,1996-08-10,ES36209580831926802634,TRX_N-01087-43689671,2024-08-07T12:07:42,Bilbao,expenses,electricity,-21.83,-50202.57
buyer_1,Luis,1996-08-10,ES36209580831926802634,TRX_N-01088-14515540,2024-08-07T13:25:48,Bilbao,expenses,internet,-42.0,-50244.57
buyer_1,Luis,1996-08-10,ES36209580831926802634,TRX_N-01089-16573130,2024-08-07T16:56:01,Bilbao,expenses,phone,-42.58,-50287.15
buyer_1,Luis,1996-08-10,ES36209580831926802634,TRX_N-01090-70045487,2024-08-07T16:47:27,Bilbao,expenses,leisure,-72.52,-50359.67
buyer_1,Luis,1996-08-10,ES36209580831926802634,TRX_N-01091-28845111,2024-08-08T17:19:44,Bilbao,expenses,water,-44.79,-50404.46
buyer_1,Luis,1996-08-10,ES36209580831926802634,TRX_N-01092-93711112,2024-08-08T17:15:50,Bilbao,expenses,gas,-114.33,-50518.79
buyer_1,Luis,1996-08-10,ES36209580831926802634,TRX_N-01093-26645180,2024-08-08T15:33:44,Bilbao,expenses,repairs,-195.48,-50714.27
buyer_1,Luis,1996-08-10,ES36209580831926802634,TRX_N-01094-89059736,2024-08-09T18:19:42,Bilbao,expenses,food,-110.12,-50824.39
buyer_1,Luis,1996-08-10,ES36209580831926802634,TRX_N-01095-32572765,2024-08-09T11:45:47,Bilbao,expenses,leisure,-73.57,-50897.96
buyer_1,Luis,1996-08-10,ES36209580831926802634,TRX_N-01096-45900729,2024-08-09T12:48:26,Bilbao,expenses,travel,-1778.82,-52676.78
buyer_1,Luis,1996-08-10,ES36209580831926802634,TRX_N-01097-49042651,2024-08-10T08:41:09,Bilbao,expenses,transport,-88.79,-52765.57
buyer_1,Luis,1996-08-10,ES36209580831926802634,TRX_N-01098-76977966,2024-08-12T18:41:27,Bilbao,expenses,appliances,-194.06,-52959.63
buyer_1,Luis,1996-08-10,ES36209580831926802634,TRX_N-01099-99768327,2024-08-13T17:24:33,Bilbao,expenses,transport,-47.15,-53006.78
buyer_1,Luis,1996-08-10,ES36209580831926802634,TRX_N-01100-81434335,2024-08-13T17:16:06,Bilbao,expenses,leisure,-64.58,-53071.36
buyer_1,Luis,1996-08-10,ES36209580831926802634,TRX_N-01101-29735850,2024-08-18T08:04:19,Bilbao,expenses,appliances,-171.16,-53242.52
buyer_1,Luis,1996-08-10,ES36209580831926802634,TRX_N-01102-44109984,2024-08-20T16:53:34,Bilbao,expenses,gifts,-636.82,-53879.34
buyer_1,Luis,1996-08-10,ES36209580831926802634,TRX_N-01103-09125773,2024-08-21T16:12:54,Bilbao,expenses,healthcare,-41.85,-53921.19
buyer_1,Luis,1996-08-10,ES36209580831926802634,TRX_N-01104-86592105,2024-08-23T17:59:28,Bilbao,expenses,transport,-58.22,-53979.41
buyer_1,Luis,1996-08-10,ES36209580831926802634,TRX_N-01105-86374822,2024-08-24T02:08:09,Irun,expenses,healthcare,-126.44,-54105.85
buyer_1,Luis,1996-08-10,ES36209580831926802634,TRX_N-01106-29579497,2024-08-25T14:38:06,Basauri,expenses,transport,-68.19,-54174.04
buyer_1,Luis,1996-08-10,ES36209580831926802634,TRX_N-01107-32828760,2024-08-25T16:34:15,Bilbao,expenses,children,-115.73,-54289.77
buyer_1,Luis,1996-08-10,ES36209580831926802634,TRX_N-01108-27737750,2024-08-26T12:51:56,Bilbao,expenses,food,-78.04,-54367.81
buyer_1,Luis,1996-08-10,ES36209580831926802634,TRX_N-01109-93060454,2024-08-26T13:21:52,Bilbao,expenses,cash,-100.0,-54467.81
buyer_1,Luis,1996-08-10,ES36209580831926802634,TRX_N-01110-68344769,2024-08-27T14:06:00,Galdakao,expenses,transport,-82.24,-54550.05
buyer_1,Luis,1996-08-10,ES36209580831926802634,TRX_N-01111-10119376,2024-08-27T09:30:03,Bilbao,expenses,leisure,-33.26,-54583.31
buyer_1,Luis,1996-08-10,ES36209580831926802634,TRX_N-01112-84075837,2024-08-27T15:56:02,Zarautz,expenses,gifts,-72.96,-54656.27
buyer_1,Luis,1996-08-10,ES36209580831926802634,TRX_N-01113-00335242,2024-08-29T10:41:41,Bilbao,expenses,transport,-57.63,-54713.9
buyer_1,Luis,1996-08-10,ES36209580831926802634,TRX_N-01114-97757737,2024-08-29T15:17:39,Bilbao,expenses,cash,-100.0,-54813.9
buyer_1,Luis,1996-08-10,ES36209580831926802634,TRX_N-01115-31048624,2024-08-29T14:48:08,Bilbao,expenses,repairs,-179.36,-54993.26
buyer_1,Luis,1996-08-10,ES36209580831926802634,TRX_N-01116-47540823,2024-08-31T18:13:46,Bilbao,expenses,cash,-100.0,-55093.26
buyer_1,Luis,1996-08-10,ES36209580831926802634,TRX_N-01117-23704915,2024-09-01T01:02:33,Bilbao,incomes,salary,1572.01,-53521.25
buyer_1,Luis,1996-08-10,ES36209580831926802634,TRX_N-01118-83342102,2024-09-01T01:02:33,Bilbao,incomes,salary_partner,1238.77,-52282.48
buyer_1,Luis,1996-08-10,ES36209580831926802634,TRX_N-01119-00294878,2024-09-02T10:02:05,Hernani,expenses,cash,-100.0,-52382.48
buyer_1,Luis,1996-08-10,ES36209580831926802634,TRX_N-01120-19669084,2024-09-02T19:48:11,Bilbao,expenses,appliances,-415.84,-52798.32
buyer_1,Luis,1996-08-10,ES36209580831926802634,TRX_N-01121-18778690,2024-09-03T19:25:04,Bilbao,expenses,leisure,-22.97,-52821.29
buyer_1,Luis,1996-08-10,ES36209580831926802634,TRX_N-01122-01784853,2024-09-04T07:18:45,Bilbao,expenses,mortgage,-743.13,-53564.42
buyer_1,Luis,1996-08-10,ES36209580831926802634,TRX_N-01123-48571453,2024-09-04T13:16:17,Bilbao,expenses,education,-62.78,-53627.2
buyer_1,Luis,1996-08-10,ES36209580831926802634,TRX_N-01124-48613887,2024-09-04T09:40:58,Bilbao,expenses,cash,-100.0,-53727.2
buyer_1,Luis,1996-08-10,ES36209580831926802634,TRX_N-01125-01608502,2024-09-05T16:27:55,Bilbao,expenses,internet,-42.0,-53769.2
buyer_1,Luis,1996-08-10,ES36209580831926802634,TRX_N-01126-71418236,2024-09-06T22:44:09,Bilbao,expenses,electricity,-71.77,-53840.97
buyer_1,Luis,1996-08-10,ES36209580831926802634,TRX_N-01127-97197635,2024-09-07T07:44:52,Bilbao,expenses,water,-32.63,-53873.6
buyer_1,Luis,1996-08-10,ES36209580831926802634,TRX_N-01128-14359494,2024-09-07T11:47:14,Bilbao,expenses,gas,-112.13,-53985.73
buyer_1,Luis,1996-08-10,ES36209580831926802634,TRX_N-01129-44927063,2024-09-07T09:43:01,Bilbao,expenses,food,-103.02,-54088.75
buyer_1,Luis,1996-08-10,ES36209580831926802634,TRX_N-01130-85457220,2024-09-08T14:11:37,Bilbao,expenses,phone,-38.72,-54127.47
buyer_1,Luis,1996-08-10,ES36209580831926802634,TRX_N-01131-95149892,2024-09-08T13:01:55,Bilbao,expenses,transport,-71.93,-54199.4
buyer_1,Luis,1996-08-10,ES36209580831926802634,TRX_N-01132-40656451,2024-09-11T12:20:22,Bilbao,expenses,transport,-69.96,-54269.36
buyer_1,Luis,1996-08-10,ES36209580831926802634,TRX_N-01133-13841816,2024-09-11T08:29:53,Bilbao,expenses,cash,-100.0,-54369.36
buyer_1,Luis,1996-08-10,ES36209580831926802634,TRX_N-01134-83990576,2024-09-12T19:54:24,Bilbao,expenses,repairs,-94.27,-54463.63
buyer_1,Luis,1996-08-10,ES36209580831926802634,TRX_N-01135-89376181,2024-09-13T09:08:24,Bilbao,expenses,children,-89.05,-54552.68
buyer_1,Luis,1996-08-10,ES36209580831926802634,TRX_N-01136-34880279,2024-09-14T17:58:41,Bilbao,expenses,food,-75.49,-54628.17
buyer_1,Luis,1996-08-10,ES36209580831926802634,TRX_N-01137-53050718,2024-09-14T13:17:31,Bilbao,expenses,education,-49.74,-54677.91
buyer_1,Luis,1996-08-10,ES36209580831926802634,TRX_N-01138-60302615,2024-09-16T09:22:08,Bilbao,expenses,food,-87.89,-54765.8
buyer_1,Luis,1996-08-10,ES36209580831926802634,TRX_N-01139-30595136,2024-09-17T08:26:13,Bilbao,expenses,education,-52.8,-54818.6
buyer_1,Luis,1996-08-10,ES36209580831926802634,TRX_N-01140-34299950,2024-09-17T13:59:53,Bilbao,expenses,gifts,-533.53,-55352.13
buyer_1,Luis,1996-08-10,ES36209580831926802634,TRX_N-01141-69343660,2024-09-18T20:23:43,Bilbao,expenses,food,-88.99,-55441.12
buyer_1,Luis,1996-08-10,ES36209580831926802634,TRX_N-01142-38077960,2024-09-18T23:41:09,Bilbao,expenses,travel,-1634.01,-57075.13
buyer_1,Luis,1996-08-10,ES36209580831926802634,TRX_N-01143-58907038,2024-09-19T19:11:50,Bilbao,expenses,food,-98.49,-57173.62
buyer_1,Luis,1996-08-10,ES36209580831926802634,TRX_N-01144-74750067,2024-09-20T19:38:14,Bilbao,expenses,children,-166.87,-57340.49
buyer_1,Luis,1996-08-10,ES36209580831926802634,TRX_N-01145-85500540,2024-09-21T20:38:53,Bilbao,expenses,leisure,-35.11,-57375.6
buyer_1,Luis,1996-08-10,ES36209580831926802634,TRX_N-01146-49131707,2024-09-22T06:43:35,Bilbao,expenses,healthcare,-42.73,-57418.33
buyer_1,Luis,1996-08-10,ES36209580831926802634,TRX_N-01147-83941665,2024-09-23T11:28:04,Bilbao,expenses,leisure,-28.13,-57446.46
buyer_1,Luis,1996-08-10,ES36209580831926802634,TRX_N-01148-42267741,2024-09-23T03:46:48,Durango,expenses,gifts,-78.03,-57524.49
buyer_1,Luis,1996-08-10,ES36209580831926802634,TRX_N-01149-58986428,2024-09-24T17:00:29,Hondarribia,expenses,food,-85.88,-57610.37
buyer_1,Luis,1996-08-10,ES36209580831926802634,TRX_N-01150-11518823,2024-09-27T19:19:02,Bilbao,expenses,transport,-67.31,-57677.68
buyer_1,Luis,1996-08-10,ES36209580831926802634,TRX_N-01151-40624806,2024-09-28T18:15:27,Erandio,expenses,leisure,-26.65,-57704.33
buyer_1,Luis,1996-08-10,ES36209580831926802634,TRX_N-01152-93730838,2024-09-29T18:38:15,Bilbao,expenses,leisure,-33.12,-57737.45
buyer_1,Luis,1996-08-10,ES36209580831926802634,TRX_N-01153-56145686,2024-09-29T11:49:51,Bilbao,expenses,cash,-100.0,-57837.45
buyer_1,Luis,1996-08-10,ES36209580831926802634,TRX_N-01154-47664250,2024-09-30T12:58:19,Leioa,expenses,cash,-100.0,-57937.45
buyer_1,Luis,1996-08-10,ES36209580831926802634,TRX_N-01155-71534600,2024-10-01T15:58:58,Bilbao,incomes,salary,1572.01,-56365.44
buyer_1,Luis,1996-08-10,ES36209580831926802634,TRX_N-01156-29434922,2024-10-01T15:58:58,Bilbao,incomes,salary_partner,1238.77,-55126.67
buyer_1,Luis,1996-08-10,ES36209580831926802634,TRX_N-01157-77783881,2024-10-02T23:06:21,Bilbao,expenses,gifts,-620.09,-55746.76
buyer_1,Luis,1996-08-10,ES36209580831926802634,TRX_N-01158-14263152,2024-10-04T08:03:51,Bilbao,expenses,mortgage,-743.13,-56489.89
buyer_1,Luis,1996-08-10,ES36209580831926802634,TRX_N-01159-75464565,2024-10-04T01:18:57,Bilbao,expenses,repairs,-42.61,-56532.5
buyer_1,Luis,1996-08-10,ES36209580831926802634,TRX_N-01160-60621884,2024-10-05T11:16:41,Bilbao,expenses,internet,-42.0,-56574.5
buyer_1,Luis,1996-08-10,ES36209580831926802634,TRX_N-01161-09951582,2024-10-06T14:23:52,Bilbao,expenses,electricity,-25.4,-56599.9
buyer_1,Luis,1996-08-10,ES36209580831926802634,TRX_N-01162-59718309,2024-10-06T23:50:26,Bilbao,expenses,leisure,-34.94,-56634.84
buyer_1,Luis,1996-08-10,ES36209580831926802634,TRX_N-01163-40108715,2024-10-07T08:16:06,Bilbao,expenses,phone,-35.3,-56670.14
buyer_1,Luis,1996-08-10,ES36209580831926802634,TRX_N-01164-17445932,2024-10-07T13:18:52,Bilbao,expenses,clothing,-118.26,-56788.4
buyer_1,Luis,1996-08-10,ES36209580831926802634,TRX_N-01165-40146884,2024-10-08T17:48:35,Bilbao,expenses,gas,-105.61,-56894.01
buyer_1,Luis,1996-08-10,ES36209580831926802634,TRX_N-01166-32309731,2024-10-08T15:36:01,Bilbao,expenses,water,-32.54,-56926.55
buyer_1,Luis,1996-08-10,ES36209580831926802634,TRX_N-01167-83056247,2024-10-08T22:40:51,Bilbao,expenses,food,-67.93,-56994.48
buyer_1,Luis,1996-08-10,ES36209580831926802634,TRX_N-01168-49710391,2024-10-08T13:59:34,Bilbao,expenses,repairs,-181.78,-57176.26
buyer_2,Carmen,40,ES59209517581497961835,TRX_N-00001-06108412,2022-01-01T07:00:35,Zarautz,incomes,salary,1263.46,2869.79
buyer_2,Carmen,40,ES59209517581497961835,TRX_N-00002-49892527,2022-01-01T07:00:35,Zarautz,incomes,salary_partner,1020.72,3890.51
buyer_2,Carmen,40,ES59209517581497961835,TRX_N-00003-24101454,2022-01-02T18:47:31,Zarautz,expenses,food,-114.09,3776.42
buyer_2,Carmen,40,ES59209517581497961835,TRX_N-00004-76417183,2022-01-03T12:05:51,Zarautz,expenses,food,-122.33,3654.09
buyer_2,Carmen,40,ES59209517581497961835,TRX_N-00005-65964911,2022-01-03T16:16:40,Zarautz,expenses,leisure,-84.06,3570.03
buyer_2,Carmen,40,ES59209517581497961835,TRX_N-00006-87513613,2022-01-03T19:07:52,Zarautz,expenses,healthcare,-150.32,3419.71
buyer_2,Carmen,40,ES59209517581497961835,TRX_N-00007-18307286,2022-01-04T11:00:32,Zarautz,expenses,mortgage,-1091.91,2327.8
buyer_2,Carmen,40,ES59209517581497961835,TRX_N-00008-18031454,2022-01-04T17:45:36,Zarautz,expenses,appliances,-289.6,2038.2
buyer_2,Carmen,40,ES59209517581497961835,TRX_N-00009-82661589,2022-01-06T13:41:03,Zarautz,expenses,electricity,-32.29,2005.91
buyer_2,Carmen,40,ES59209517581497961835,TRX_N-00010-64901367,2022-01-06T17:58:54,Zarautz,expenses,gas,-39.05,1966.86
buyer_2,Carmen,40,ES59209517581497961835,TRX_N-00011-93700640,2022-01-06T10:27:56,Zarautz,expenses,food,-116.65,1850.21
buyer_2,Carmen,40,ES59209517581497961835,TRX_N-00012-25098658,2022-01-06T22:59:07,Portugalete,expenses,cash,-100.0,1750.21
buyer_2,Carmen,40,ES59209517581497961835,TRX_N-00013-35193564,2022-01-07T09:47:32,Zarautz,expenses,internet,-42.0,1708.21
buyer_2,Carmen,40,ES59209517581497961835,TRX_N-00014-72960705,2022-01-07T14:54:23,Zarautz,expenses,phone,-32.6,1675.61
buyer_2,Carmen,40,ES59209517581497961835,TRX_N-00015-64169564,2022-01-07T04:38:57,Zarautz,expenses,cash,-100.0,1575.61
buyer_2,Carmen,40,ES59209517581497961835,TRX_N-00016-02483804,2022-01-08T14:40:19,Zarautz,expenses,water,-36.89,1538.72
buyer_2,Carmen,40,ES59209517581497961835,TRX_N-00017-71959098,2022-01-09T10:50:11,Zarautz,expenses,repairs,-117.89,1420.83
buyer_2,Carmen,40,ES59209517581497961835,TRX_N-00018-28932270,2022-01-11T23:32:14,Zarautz,expenses,leisure,-71.56,1349.27
buyer_2,Carmen,40,ES59209517581497961835,TRX_N-00019-75105318,2022-01-12T19:08:01,Zarautz,expenses,repairs,-163.04,1186.23
buyer_2,Carmen,40,ES59209517581497961835,TRX_N-00020-03190399,2022-01-15T08:31:06,Zarautz,expenses,travel,-745.19,441.04
buyer_2,Carmen,40,ES59209517581497961835,TRX_N-00021-81752745,2022-01-15T23:59:01,Zarautz,expenses,gifts,-540.84,-99.8
buyer_2,Carmen,40,ES59209517581497961835,TRX_N-00022-00608549,2022-01-16T18:04:25,Mungia,expenses,food,-74.94,-174.74
buyer_2,Carmen,40,ES59209517581497961835,TRX_N-00023-98446029,2022-01-18T15:18:33,Zarautz,expenses,food,-110.22,-284.96
buyer_2,Carmen,40,ES59209517581497961835,TRX_N-00024-43319942,2022-01-18T09:36:39,Zarautz,expenses,leisure,-37.79,-322.75
buyer_2,Carmen,40,ES59209517581497961835,TRX_N-00025-93387047,2022-01-19T08:00:58,Zarautz,expenses,education,-53.53,-376.28
buyer_2,Carmen,40,ES59209517581497961835,TRX_N-00026-47209137,2022-01-19T15:38:44,Zarautz,expenses,cash,-100.0,-476.28
buyer_2,Carmen,40,ES59209517581497961835,TRX_N-00027-82761194,2022-01-19T11:43:31,Zarautz,expenses,repairs,-182.27,-658.55
buyer_2,Carmen,40,ES59209517581497961835,TRX_N-00028-21650814,2022-01-20T20:16:08,Zarautz,expenses,leisure,-80.67,-739.22
buyer_2,Carmen,40,ES59209517581497961835,TRX_N-00029-51321585,2022-01-21T01:16:52,Zarautz,expenses,repairs,-185.59,-924.81
buyer_2,Carmen,40,ES59209517581497961835,TRX_N-00030-50642041,2022-01-22T17:00:13,Zarautz,expenses,food,-78.39,-1003.2
buyer_2,Carmen,40,ES59209517581497961835,TRX_N-00031-88987430,2022-01-23T13:22:29,Zarautz,expenses,gifts,-675.67,-1678.87
buyer_2,Carmen,40,ES59209517581497961835,TRX_N-00032-06314916,2022-01-24T08:32:48,Zarautz,expenses,cash,-100.0,-1778.87
buyer_2,Carmen,40,ES59209517581497961835,TRX_N-00033-48225614,2022-01-25T16:41:54,Zarautz,expenses,food,-75.64,-1854.51
buyer_2,Carmen,40,ES59209517581497961835,TRX_N-00034-91133346,2022-01-25T19:34:18,Zarautz,expenses,gifts,-263.75,-2118.26
buyer_2,Carmen,40,ES59209517581497961835,TRX_N-00035-53887047,2022-01-26T11:30:56,Zarautz,expenses,transport,-72.7,-2190.96
buyer_2,Carmen,40,ES59209517581497961835,TRX_N-00036-65363980,2022-01-27T14:13:05,Zarautz,expenses,education,-73.2,-2264.16
buyer_2,Carmen,40,ES59209517581497961835,TRX_N-00037-27143581,2022-01-29T11:12:31,Lasarte-Oria,expenses,cash,-100.0,-2364.16
buyer_2,Carmen,40,ES59209517581497961835,TRX_N-00038-29604158,2022-01-30T20:25:21,Zarautz,expenses,clothing,-111.2,-2475.36
buyer_2,Carmen,40,ES59209517581497961835,TRX_N-00039-18462386,2022-01-31T15:06:25,Zarautz,expenses,food,-112.89,-2588.25
buyer_2,Carmen,40,ES59209517581497961835,TRX_N-00040-79631151,2022-02-01T23:19:29,Zarautz,incomes,salary,1263.46,-1324.79
buyer_2,Carmen,40,ES59209517581497961835,TRX_N-00041-95175558,2022-02-01T23:19:29,Zarautz,incomes,salary_partner,1020.72,-304.07
buyer_2,Carmen,40,ES59209517581497961835,TRX_N-00042-22785304,2022-02-01T10:47:19,Arrasate,expenses,clothing,-117.93,-422.0
buyer_2,Carmen,40,ES59209517581497961835,TRX_N-00043-48709690,2022-02-02T15:50:54,Erandio,expenses,food,-79.56,-501.56
buyer_2,Carmen,40,ES59209517581497961835,TRX_N-00044-28515819,2022-02-03T19:44:14,Zarautz,expenses,children,-214.16,-715.72
buyer_2,Carmen,40,ES59209517581497961835,TRX_N-00045-29992915,2022-02-04T17:31:41,Zarautz,expenses,mortgage,-1091.91,-1807.63
buyer_2,Carmen,40,ES59209517581497961835,TRX_N-00046-79899278,2022-02-04T12:30:29,Zarautz,expenses,clothing,-47.05,-1854.68
buyer_2,Carmen,40,ES59209517581497961835,TRX_N-00047-53471301,2022-02-04T22:59:39,Zarautz,expenses,cash,-100.0,-1954.68
buyer_2,Carmen,40,ES59209517581497961835,TRX_N-00048-32967895,2022-02-05T15:57:48,Zarautz,expenses,gas,-75.91,-2030.59
buyer_2,Carmen,40,ES59209517581497961835,TRX_N-00049-28552968,2022-02-06T17:29:57,Zarautz,expenses,water,-30.13,-2060.72
buyer_2,Carmen,40,ES59209517581497961835,TRX_N-00050-80150450,2022-02-06T12:00:16,Zarautz,expenses,internet,-42.0,-2102.72
buyer_2,Carmen,40,ES59209517581497961835,TRX_N-00051-32061840,2022-02-07T12:39:31,Zarautz,expenses,electricity,-32.59,-2135.31
buyer_2,Carmen,40,ES59209517581497961835,TRX_N-00052-16643932,2022-02-07T12:14:14,Zarautz,expenses,phone,-37.56,-2172.87
buyer_2,Carmen,40,ES59209517581497961835,TRX_N-00053-80170806,2022-02-09T15:57:57,Donostia,expenses,leisure,-58.69,-2231.56
buyer_2,Carmen,40,ES59209517581497961835,TRX_N-00054-49875521,2022-02-10T10:58:07,Vitoria-Gasteiz,expenses,transport,-58.8,-2290.36
buyer_2,Carmen,40,ES59209517581497961835,TRX_N-00055-22032394,2022-02-11T08:00:00,Zarautz,expenses,cash,-100.0,-2390.36
buyer_2,Carmen,40,ES59209517581497961835,TRX_N-00056-52310105,2022-02-12T09:51:30,Zarautz,expenses,food,-89.7,-2480.06
buyer_2,Carmen,40,ES59209517581497961835,TRX_N-00057-98152432,2022-02-15T10:54:12,Zarautz,expenses,cash,-100.0,-2580.06
buyer_2,Carmen,40,ES59209517581497961835,TRX_N-00058-96839037,2022-02-15T11:57:59,Zarautz,expenses,gifts,-527.86,-3107.92
buyer_2,Carmen,40,ES59209517581497961835,TRX_N-00059-38940217,2022-02-16T21:44:00,Zarautz,expenses,gifts,-485.03,-3592.95
buyer_2,Carmen,40,ES59209517581497961835,TRX_N-00060-81434510,2022-02-18T02:52:14,Zarautz,expenses,education,-70.47,-3663.42
buyer_2,Carmen,40,ES59209517581497961835,TRX_N-00061-06788060,2022-02-18T13:52:26,Portugalete,expenses,cash,-100.0,-3763.42
buyer_2,Carmen,40,ES59209517581497961835,TRX_N-00062-20822885,2022-02-19T09:19:38,Zarautz,expenses,cash,-100.0,-3863.42
buyer_2,Carmen,40,ES59209517581497961835,TRX_N-00063-90495578,2022-02-23T11:04:34,Zarautz,expenses,food,-87.74,-3951.16
buyer_2,Carmen,40,ES59209517581497961835,TRX_N-00064-17435687,2022-02-23T11:02:13,Zarautz,expenses,leisure,-22.38,-3973.54
buyer_2,Carmen,40,ES59209517581497961835,TRX_N-00065-23982037,2022-02-24T08:02:32,Zarautz,expenses,leisure,-22.48,-3996.02
buyer_2,Carmen,40,ES59209517581497961835,TRX_N-00066-44684928,2022-02-25T18:25:31,Zarautz,expenses,food,-88.28,-4084.3
buyer_2,Carmen,40,ES59209517581497961835,TRX_N-00067-69140672,2022-02-25T18:45:13,Zarautz,expenses,cash,-100.0,-4184.3
buyer_2,Carmen,40,ES59209517581497961835,TRX_N-00068-24173332,2022-02-26T11:06:39,Zarautz,expenses,leisure,-69.11,-4253.41
buyer_2,Carmen,40,ES59209517581497961835,TRX_N-00069-91210673,2022-02-28T12:14:08,Zarautz,expenses,food,-72.78,-4326.19
buyer_2,Carmen,40,ES59209517581497961835,TRX_N-00070-93658617,2022-02-28T20:53:59,Zarautz,expenses,transport,-40.03,-4366.22
buyer_2,Carmen,40,ES59209517581497961835,TRX_N-00071-26880254,2022-03-01T08:55:09,Zarautz,incomes,salary,1263.46,-3102.76
buyer_2,Carmen,40,ES59209517581497961835,TRX_N-00072-82579125,2022-03-01T08:55:09,Zarautz,incomes,salary_partner,1020.72,-2082.04
buyer_2,Carmen,40,ES59209517581497961835,TRX_N-00073-85387604,2022-03-01T08:55:09,Zarautz,incomes,extra_income,152.67,-1929.37
buyer_2,Carmen,40,ES59209517581497961835,TRX_N-00074-36494018,2022-03-01T11:59:13,Zarautz,expenses,food,-73.72,-2003.09
buyer_2,Carmen,40,ES59209517581497961835,TRX_N-00075-05843050,2022-03-01T12:25:56,Zarautz,expenses,leisure,-24.67,-2027.76
buyer_2,Carmen,40,ES59209517581497961835,TRX_N-00076-11687359,2022-03-02T13:50:20,Zarautz,expenses,repairs,-329.64,-2357.4
buyer_2,Carmen,40,ES59209517581497961835,TRX_N-00077-72020381,2022-03-04T08:56:52,Zarautz,expenses,mortgage,-1091.91,-3449.31
buyer_2,Carmen,40,ES59209517581497961835,TRX_N-00078-85133432,2022-03-04T09:19:59,Zarautz,expenses,cash,-100.0,-3549.31
buyer_2,Carmen,40,ES59209517581497961835,TRX_N-00079-38254480,2022-03-05T17:48:36,Zarautz,expenses,water,-27.21,-3576.52
buyer_2,Carmen,40,ES59209517581497961835,TRX_N-00080-10933034,2022-03-05T18:25:10,Zarautz,expenses,electricity,-69.83,-3646.35
buyer_2,Carmen,40,ES59209517581497961835,TRX_N-00081-38906182,2022-03-05T17:50:59,Zarautz,expenses,internet,-42.0,-3688.35
buyer_2,Carmen,40,ES59209517581497961835,TRX_N-00082-06653485,2022-03-05T16:28:23,Zarautz,expenses,phone,-35.02,-3723.37
buyer_2,Carmen,40,ES59209517581497961835,TRX_N-00083-16770646,2022-03-07T13:41:47,Zarautz,expenses,gas,-91.07,-3814.44
buyer_2,Carmen,40,ES59209517581497961835,TRX_N-00084-67549096,2022-03-07T08:05:56,Zarautz,expenses,transport,-74.98,-3889.42
buyer_2,Carmen,40,ES59209517581497961835,TRX_N-00085-80085680,2022-03-07T12:31:22,Zarautz,expenses,cash,-100.0,-3989.42
buyer_2,Carmen,40,ES59209517581497961835,TRX_N-00086-48590319,2022-03-08T10:25:29,Zarautz,expenses,food,-82.23,-4071.65
buyer_2,Carmen,40,ES59209517581497961835,TRX_N-00087-79512329,2022-03-09T19:20:21,Leioa,expenses,food,-123.39,-4195.04
buyer_2,Carmen,40,ES59209517581497961835,TRX_N-00088-42124426,2022-03-09T17:12:26,Zarautz,expenses,transport,-49.55,-4244.59
buyer_2,Carmen,40,ES59209517581497961835,TRX_N-00089-07161622,2022-03-09T11:37:51,Zarautz,expenses,leisure,-55.63,-4300.22
buyer_2,Carmen,40,ES59209517581497961835,TRX_N-00090-47443525,2022-03-10T05:18:06,Zarautz,expenses,food,-113.99,-4414.21
buyer_2,Carmen,40,ES59209517581497961835,TRX_N-00091-53790033,2022-03-10T19:11:58,Zarautz,expenses,children,-98.01,-4512.22
buyer_2,Carmen,40,ES59209517581497961835,TRX_N-00092-74008836,2022-03-11T11:32:42,Zarautz,expenses,leisure,-78.96,-4591.18
buyer_2,Carmen,40,ES59209517581497961835,TRX_N-00093-13239270,2022-03-15T17:43:46,Zarautz,expenses,transport,-83.68,-4674.86
buyer_2,Carmen,40,ES59209517581497961835,TRX_N-00094-36960170,2022-03-17T17:11:33,Zarautz,expenses,food,-108.13,-4782.99
buyer_2,Carmen,40,ES59209517581497961835,TRX_N-00095-87755350,2022-03-18T14:10:17,Arrasate,expenses,clothing,-110.8,-4893.79
buyer_2,Carmen,40,ES59209517581497961835,TRX_N-00096-32503405,2022-03-19T17:28:36,Zarautz,expenses,cash,-100.0,-4993.79
buyer_2,Carmen,40,ES59209517581497961835,TRX_N-00097-44352393,2022-03-20T23:02:01,Zarautz,expenses,food,-72.73,-5066.52
buyer_2,Carmen,40,ES59209517581497961835,TRX_N-00098-36058884,2022-03-24T09:43:16,Zarautz,expenses,food,-101.35,-5167.87
buyer_2,Carmen,40,ES59209517581497961835,TRX_N-00099-78659137,2022-03-24T13:14:07,Zarautz,expenses,leisure,-65.12,-5232.99
buyer_2,Carmen,40,ES59209517581497961835,TRX_N-00100-38605618,2022-03-24T15:13:21,Zarautz,expenses,cash,-100.0,-5332.99
buyer_2,Carmen,40,ES59209517581497961835,TRX_N-00101-01125181,2022-04-01T16:25:54,Zarautz,incomes,salary,1263.46,-4069.53
buyer_2,Carmen,40,ES59209517581497961835,TRX_N-00102-99244947,2022-04-01T16:25:54,Zarautz,incomes,salary_partner,1020.72,-3048.81
buyer_2,Carmen,40,ES59209517581497961835,TRX_N-00103-96332213,2022-04-02T19:32:42,Hernani,expenses,food,-124.02,-3172.83
buyer_2,Carmen,40,ES59209517581497961835,TRX_N-00104-90249033,2022-04-02T17:26:52,Zarautz,expenses,leisure,-23.58,-3196.41
buyer_2,Carmen,40,ES59209517581497961835,TRX_N-00105-75138366,2022-04-03T17:28:38,Zarautz,expenses,repairs,-234.97,-3431.38
buyer_2,Carmen,40,ES59209517581497961835,TRX_N-00106-32663066,2022-04-04T22:23:53,Zarautz,expenses,mortgage,-1091.91,-4523.29
buyer_2,Carmen,40,ES59209517581497961835,TRX_N-00107-53090418,2022-04-04T14:07:55,Pasaia,expenses,healthcare,-172.81,-4696.1
buyer_2,Carmen,40,ES59209517581497961835,TRX_N-00108-63123462,2022-04-05T13:47:35,Zarautz,expenses,food,-108.24,-4804.34
buyer_2,Carmen,40,ES59209517581497961835,TRX_N-00109-37591523,2022-04-06T08:49:18,Zarautz,expenses,electricity,-51.48,-4855.82
buyer_2,Carmen,40,ES59209517581497961835,TRX_N-00110-79654888,2022-04-07T16:18:20,Zarautz,expenses,gas,-88.41,-4944.23
buyer_2,Carmen,40,ES59209517581497961835,TRX_N-00111-30282988,2022-04-08T14:35:30,Zarautz,expenses,water,-27.56,-4971.79
buyer_2,Carmen,40,ES59209517581497961835,TRX_N-00112-26392621,2022-04-08T13:26:06,Zarautz,expenses,internet,-42.0,-5013.79
buyer_2,Carmen,40,ES59209517581497961835,TRX_N-00113-79966305,2022-04-08T10:14:07,Zarautz,expenses,phone,-35.36,-5049.15
buyer_2,Carmen,40,ES59209517581497961835,TRX_N-00114-57986336,2022-04-11T19:01:48,Zarautz,expenses,food,-84.47,-5133.62
buyer_2,Carmen,40,ES59209517581497961835,TRX_N-00115-35326343,2022-04-12T22:04:49,Zarautz,expenses,leisure,-45.87,-5179.49
buyer_2,Carmen,40,ES59209517581497961835,TRX_N-00116-63489183,2022-04-13T08:57:11,Zarautz,expenses,cash,-100.0,-5279.49
buyer_2,Carmen,40,ES59209517581497961835,TRX_N-00117-50918856,2022-04-13T08:13:40,Zarautz,expenses,children,-142.94,-5422.43
buyer_2,Carmen,40,ES59209517581497961835,TRX_N-00118-89489352,2022-04-14T16:20:41,Zarautz,expenses,food,-89.53,-5511.96
buyer_2,Carmen,40,ES59209517581497961835,TRX_N-00119-89112870,2022-04-14T19:16:03,Zarautz,expenses,transport,-43.04,-5555.0
buyer_2,Carmen,40,ES59209517581497961835,TRX_N-00120-47930275,2022-04-15T11:21:29,Zarautz,expenses,cash,-100.0,-5655.0
buyer_2,Carmen,40,ES59209517581497961835,TRX_N-00121-03999016,2022-04-17T20:18:48,Zarautz,expenses,education,-77.57,-5732.57
buyer_2,Carmen,40,ES59209517581497961835,TRX_N-00122-28396756,2022-04-19T16:51:56,Zarautz,expenses,leisure,-26.48,-5759.05
buyer_2,Carmen,40,ES59209517581497961835,TRX_N-00123-38898714,2022-04-20T09:20:52,Zarautz,expenses,transport,-88.1,-5847.15
buyer_2,Carmen,40,ES59209517581497961835,TRX_N-00124-73848502,2022-04-21T16:48:58,Zarautz,expenses,appliances,-183.98,-6031.13
buyer_2,Carmen,40,ES59209517581497961835,TRX_N-00125-14076704,2022-04-22T18:06:17,Zarautz,expenses,healthcare,-119.33,-6150.46
buyer_2,Carmen,40,ES59209517581497961835,TRX_N-00126-23998358,2022-04-22T15:21:53,Zarautz,expenses,gifts,-319.37,-6469.83
buyer_2,Carmen,40,ES59209517581497961835,TRX_N-00127-37947433,2022-04-23T09:48:52,Zarautz,expenses,cash,-100.0,-6569.83
buyer_2,Carmen,40,ES59209517581497961835,TRX_N-00128-19389667,2022-04-23T15:26:42,Zarautz,expenses,appliances,-177.51,-6747.34
buyer_2,Carmen,40,ES59209517581497961835,TRX_N-00129-81002688,2022-04-24T21:35:13,Zarautz,expenses,transport,-46.6,-6793.94
buyer_2,Carmen,40,ES59209517581497961835,TRX_N-00130-04692766,2022-04-24T11:37:39,Zarautz,expenses,cash,-100.0,-6893.94
buyer_2,Carmen,40,ES59209517581497961835,TRX_N-00131-34722730,2022-04-24T00:41:07,Barakaldo,expenses,gifts,-168.22,-7062.16
buyer_2,Carmen,40,ES59209517581497961835,TRX_N-00132-06910608,2022-04-25T14:50:00,Vitoria-Gasteiz,expenses,food,-97.22,-7159.38
buyer_2,Carmen,40,ES59209517581497961835,TRX_N-00133-43210720,2022-04-25T04:46:42,Llodio,expenses,leisure,-21.67,-7181.05
buyer_2,Carmen,40,ES59209517581497961835,TRX_N-00134-26291756,2022-04-25T18:29:44,Zarautz,expenses,repairs,-38.64,-7219.69
buyer_2,Carmen,40,ES59209517581497961835,TRX_N-00135-39403069,2022-04-26T23:56:56,Zarautz,expenses,repairs,-75.31,-7295.0
buyer_2,Carmen,40,ES59209517581497961835,TRX_N-00136-98065727,2022-04-27T04:14:52,Zarautz,expenses,repairs,-125.16,-7420.16
buyer_2,Carmen,40,ES59209517581497961835,TRX_N-00137-08603589,2022-04-29T15:08:56,Zarautz,expenses,cash,-100.0,-7520.16
buyer_2,Carmen,40,ES59209517581497961835,TRX_N-00138-25538705,2022-04-30T09:46:49,Zarautz,expenses,leisure,-73.16,-7593.32
buyer_2,Carmen,40,ES59209517581497961835,TRX_N-00139-03460498,2022-05-01T16:39:26,Zarautz,incomes,salary,1263.46,-6329.86
buyer_2,Carmen,40,ES59209517581497961835,TRX_N-00140-85371380,2022-05-01T16:39:26,Zarautz,incomes,salary_partner,1020.72,-5309.14
buyer_2,Carmen,40,ES59209517581497961835,TRX_N-00141-50690167,2022-05-01T02:02:37,Labastida,expenses,transport,-66.82,-5375.96
buyer_2,Carmen,40,ES59209517581497961835,TRX_N-00142-22419846,2022-05-03T20:44:44,Berango,expenses,transport,-45.18,-5421.14
buyer_2,Carmen,40,ES59209517581497961835,TRX_N-00143-80715732,2022-05-03T13:16:27,Zarautz,expenses,cash,-100.0,-5521.14
buyer_2,Carmen,40,ES59209517581497961835,TRX_N-00144-83482889,2022-05-03T17:41:56,Zarautz,expenses,appliances,-115.04,-5636.18
buyer_2,Carmen,40,ES59209517581497961835,TRX_N-00145-22311384,2022-05-04T13:24:18,Zarautz,expenses,mortgage,-1091.91,-6728.09
buyer_2,Carmen,40,ES59209517581497961835,TRX_N-00146-25058723,2022-05-04T18:18:20,Zarautz,expenses,food,-86.28,-6814.37
buyer_2,Carmen,40,ES59209517581497961835,TRX_N-00147-68695111,2022-05-04T11:11:49,Zarautz,expenses,education,-52.15,-6866.52
buyer_2,Carmen,40,ES59209517581497961835,TRX_N-00148-17219302,2022-05-04T20:12:27,Labastida,expenses,cash,-100.0,-6966.52
buyer_2,Carmen,40,ES59209517581497961835,TRX_N-00149-26535763,2022-05-05T15:22:35,Zarautz,expenses,food,-63.36,-7029.88
buyer_2,Carmen,40,ES59209517581497961835,TRX_N-00150-25218449,2022-05-05T12:41:41,Zarautz,expenses,cash,-100.0,-7129.88
buyer_2,Carmen,40,ES59209517581497961835,TRX_N-00151-23682986,2022-05-06T11:24:51,Zarautz,expenses,cash,-100.0,-7229.88
buyer_2,Carmen,40,ES59209517581497961835,TRX_N-00152-78700448,2022-05-07T17:39:55,Zarautz,expenses,water,-26.38,-7256.26
buyer_2,Carmen,40,ES59209517581497961835,TRX_N-00153-66380679,2022-05-07T10:25:24,Zarautz,expenses,internet,-42.0,-7298.26
buyer_2,Carmen,40,ES59209517581497961835,TRX_N-00154-90575782,2022-05-08T10:23:08,Zarautz,expenses,electricity,-24.87,-7323.13
buyer_2,Carmen,40,ES59209517581497961835,TRX_N-00155-47590783,2022-05-08T11:31:37,Zarautz,expenses,gas,-86.23,-7409.36
buyer_2,Carmen,40,ES59209517581497961835,TRX_N-00156-83546729,2022-05-08T11:04:50,Zarautz,expenses,phone,-44.53,-7453.89
buyer_2,Carmen,40,ES59209517581497961835,TRX_N-00157-10556569,2022-05-08T19:13:21,Zarautz,expenses,appliances,-84.39,-7538.28
buyer_2,Carmen,40,ES59209517581497961835,TRX_N-00158-97590763,2022-05-09T12:31:35,Berango,expenses,transport,-64.23,-7602.51
buyer_2,Carmen,40,ES59209517581497961835,TRX_N-00159-69610125,2022-05-10T17:56:25,Arrasate,expenses,transport,-43.25,-7645.76
buyer_2,Carmen,40,ES59209517581497961835,TRX_N-00160-05297901,2022-05-10T10:21:31,Zarautz,expenses,clothing,-89.04,-7734.8
buyer_2,Carmen,40,ES59209517581497961835,TRX_N-00161-35415069,2022-05-10T09:20:25,Zarautz,expenses,cash,-100.0,-7834.8
buyer_2,Carmen,40,ES59209517581497961835,TRX_N-00162-57444292,2022-05-11T12:24:18,Zarautz,expenses,cash,-100.0,-7934.8
buyer_2,Carmen,40,ES59209517581497961835,TRX_N-00163-60154017,2022-05-12T09:01:26,Zarautz,expenses,transport,-48.6,-7983.4
buyer_2,Carmen,40,ES59209517581497961835,TRX_N-00164-60194261,2022-05-14T17:37:33,Vitoria-Gasteiz,expenses,repairs,-27.15,-8010.55
buyer_2,Carmen,40,ES59209517581497961835,TRX_N-00165-81281551,2022-05-15T02:56:30,Irun,expenses,transport,-59.0,-8069.55
buyer_2,Carmen,40,ES59209517581497961835,TRX_N-00166-09301145,2022-05-16T13:30:43,Elciego,expenses,transport,-81.97,-8151.52
buyer_2,Carmen,40,ES59209517581497961835,TRX_N-00167-41297899,2022-05-17T00:11:48,Getxo,expenses,leisure,-74.32,-8225.84
buyer_2,Carmen,40,ES59209517581497961835,TRX_N-00168-45632710,2022-05-17T08:04:19,Zarautz,expenses,cash,-100.0,-8325.84
buyer_2,Carmen,40,ES59209517581497961835,TRX_N-00169-94573993,2022-05-18T11:08:09,Zarautz,expenses,gifts,-68.81,-8394.65
buyer_2,Carmen,40,ES59209517581497961835,TRX_N-00170-94263026,2022-05-19T03:57:07,Zarautz,expenses,transport,-66.03,-8460.68
buyer_2,Carmen,40,ES59209517581497961835,TRX_N-00171-74255809,2022-05-19T13:12:34,Zarautz,expenses,clothing,-117.53,-8578.21
buyer_2,Carmen,40,ES59209517581497961835,TRX_N-00172-66707567,2022-05-25T09:40:55,Santurtzi,expenses,food,-98.81,-8677.02
buyer_2,Carmen,40,ES59209517581497961835,TRX_N-00173-72107450,2022-05-26T18:07:30,Zarautz,expenses,transport,-74.44,-8751.46
buyer_2,Carmen,40,ES59209517581497961835,TRX_N-00174-07165770,2022-05-26T11:25:57,Zarautz,expenses,education,-56.3,-8807.76
buyer_2,Carmen,40,ES59209517581497961835,TRX_N-00175-92971030,2022-05-29T17:52:37,Zarautz,expenses,gifts,-444.89,-9252.65
buyer_2,Carmen,40,ES59209517581497961835,TRX_N-00176-47722674,2022-05-30T09:44:07,Zarautz,expenses,cash,-100.0,-9352.65
buyer_2,Carmen,40,ES59209517581497961835,TRX_N-00177-09779118,2022-06-01T22:49:52,Zarautz,incomes,salary,1263.46,-8089.19
buyer_2,Carmen,40,ES59209517581497961835,TRX_N-00178-89477401,2022-06-01T22:49:52,Zarautz,incomes,salary_partner,1020.72,-7068.47
buyer_2,Carmen,40,ES59209517581497961835,TRX_N-00179-30481117,2022-06-01T22:49:52,Zarautz,incomes,salary_bonus,916.95,-6151.52
buyer_2,Carmen,40,ES59209517581497961835,TRX_N-00180-81098232,2022-06-01T22:49:52,Zarautz,incomes,salary_partner_bonus,770.35,-5381.17
buyer_2,Carmen,40,ES59209517581497961835,TRX_N-00181-56936986,2022-06-03T08:18:00,Zarautz,expenses,education,-65.91,-5447.08
buyer_2,Carmen,40,ES59209517581497961835,TRX_N-00182-86229308,2022-06-04T19:47:58,Zarautz,expenses,mortgage,-1091.91,-6538.99
buyer_2,Carmen,40,ES59209517581497961835,TRX_N-00183-87136677,2022-06-04T13:38:42,Zarautz,expenses,travel,-704.19,-7243.18
buyer_2,Carmen,40,ES59209517581497961835,TRX_N-00184-05195130,2022-06-05T11:17:00,Zarautz,expenses,electricity,-23.97,-7267.15
buyer_2,Carmen,40,ES59209517581497961835,TRX_N-00185-31498413,2022-06-05T08:36:41,Zarautz,expenses,internet,-42.0,-7309.15
buyer_2,Carmen,40,ES59209517581497961835,TRX_N-00186-75251481,2022-06-06T15:09:33,Zarautz,expenses,gas,-96.92,-7406.07
buyer_2,Carmen,40,ES59209517581497961835,TRX_N-00187-93442355,2022-06-07T06:08:59,Zarautz,expenses,transport,-62.63,-7468.7
buyer_2,Carmen,40,ES59209517581497961835,TRX_N-00188-46969925,2022-06-07T11:12:53,Zarautz,expenses,leisure,-57.86,-7526.56
buyer_2,Carmen,40,ES59209517581497961835,TRX_N-00189-46566489,2022-06-07T14:01:49,Zarautz,expenses,gifts,-101.49,-7628.05
buyer_2,Carmen,40,ES59209517581497961835,TRX_N-00190-64307221,2022-06-07T09:09:46,Zarautz,expenses,children,-172.59,-7800.64
buyer_2,Carmen,40,ES59209517581497961835,TRX_N-00191-01678834,2022-06-08T16:34:24,Zarautz,expenses,water,-35.75,-7836.39
buyer_2,Carmen,40,ES59209517581497961835,TRX_N-00192-41186586,2022-06-08T11:36:28,Zarautz,expenses,phone,-37.43,-7873.82
buyer_2,Carmen,40,ES59209517581497961835,TRX_N-00193-15161318,2022-06-10T09:00:22,Iruña de Oca,expenses,transport,-76.16,-7949.98
buyer_2,Carmen,40,ES59209517581497961835,TRX_N-00194-53424240,2022-06-10T09:50:33,Zarautz,expenses,repairs,-205.09,-8155.07
buyer_2,Carmen,40,ES59209517581497961835,TRX_N-00195-92717181,2022-06-11T19:03:26,Zarautz,expenses,food,-122.22,-8277.29
buyer_2,Carmen,40,ES59209517581497961835,TRX_N-00196-23070409,2022-06-13T10:33:09,Zarautz,expenses,gifts,-36.84,-8314.13
buyer_2,Carmen,40,ES59209517581497961835,TRX_N-00197-07769673,2022-06-14T17:15:31,Hernani,expenses,cash,-100.0,-8414.13
buyer_2,Carmen,40,ES59209517581497961835,TRX_N-00198-30019207,2022-06-16T10:35:11,Zarautz,expenses,food,-60.57,-8474.7
buyer_2,Carmen,40,ES59209517581497961835,TRX_N-00199-17429596,2022-06-18T05:37:10,Zarautz,expenses,cash,-100.0,-8574.7
buyer_2,Carmen,40,ES59209517581497961835,TRX_N-00200-15854772,2022-06-19T16:39:12,Zarautz,expenses,leisure,-77.06,-8651.76
buyer_2,Carmen,40,ES59209517581497961835,TRX_N-00201-74968884,2022-06-19T16:14:24,Zarautz,expenses,healthcare,-155.02,-8806.78
buyer_2,Carmen,40,ES59209517581497961835,TRX_N-00202-31754266,2022-06-21T15:49:14,Leioa,expenses,clothing,-46.68,-8853.46
buyer_2,Carmen,40,ES59209517581497961835,TRX_N-00203-57548987,2022-06-22T09:14:15,Zarautz,expenses,leisure,-34.25,-8887.71
buyer_2,Carmen,40,ES59209517581497961835,TRX_N-00204-71266336,2022-06-22T13:36:54,Zarautz,expenses,appliances,-175.21,-9062.92
buyer_2,Carmen,40,ES59209517581497961835,TRX_N-00205-88622430,2022-06-23T18:52:16,Pasaia,expenses,food,-108.76,-9171.68
buyer_2,Carmen,40,ES59209517581497961835,TRX_N-00206-46505685,2022-06-24T04:29:35,Zarautz,expenses,appliances,-305.67,-9477.35
buyer_2,Carmen,40,ES59209517581497961835,TRX_N-00207-29720216,2022-06-25T20:42:16,Zarautz,expenses,cash,-100.0,-9577.35
buyer_2,Carmen,40,ES59209517581497961835,TRX_N-00208-23333776,2022-06-26T11:21:44,Zarautz,expenses,education,-77.41,-9654.76
buyer_2,Carmen,40,ES59209517581497961835,TRX_N-00209-58535636,2022-06-26T16:51:12,Zarautz,expenses,cash,-100.0,-9754.76
buyer_2,Carmen,40,ES59209517581497961835,TRX_N-00210-65655984,2022-06-27T08:38:54,Zarautz,expenses,cash,-100.0,-9854.76
buyer_2,Carmen,40,ES59209517581497961835,TRX_N-00211-79804962,2022-06-28T17:22:11,Zarautz,expenses,healthcare,-183.33,-10038.09
buyer_2,Carmen,40,ES59209517581497961835,TRX_N-00212-17077837,2022-06-28T14:49:34,Zarautz,expenses,cash,-100.0,-10138.09
buyer_2,Carmen,40,ES59209517581497961835,TRX_N-00213-70998953,2022-06-29T15:40:29,Zarautz,expenses,food,-112.79,-10250.88
buyer_2,Carmen,40,ES59209517581497961835,TRX_N-00214-03846454,2022-06-30T11:13:08,Zarautz,expenses,food,-74.28,-10325.16
buyer_2,Carmen,40,ES59209517581497961835,TRX_N-00215-19473403,2022-06-30T19:45:53,Zarautz,expenses,cash,-100.0,-10425.16
buyer_2,Carmen,40,ES59209517581497961835,TRX_N-00216-18487361,2022-07-01T16:18:28,Zarautz,incomes,salary,1263.46,-9161.7
buyer_2,Carmen,40,ES59209517581497961835,TRX_N-00217-59362543,2022-07-01T16:18:28,Zarautz,incomes,salary_partner,1020.72,-8140.98
buyer_2,Carmen,40,ES59209517581497961835,TRX_N-00218-61870542,2022-07-01T16:18:28,Zarautz,incomes,extra_income,152.67,-7988.31
buyer_2,Carmen,40,ES59209517581497961835,TRX_N-00219-48529015,2022-07-02T23:17:44,Zarautz,expenses,education,-61.33,-8049.64
buyer_2,Carmen,40,ES59209517581497961835,TRX_N-00220-75751531,2022-07-03T17:51:37,Zarautz,expenses,leisure,-33.53,-8083.17
buyer_2,Carmen,40,ES59209517581497961835,TRX_N-00221-37024643,2022-07-04T10:18:16,Zarautz,expenses,mortgage,-1091.91,-9175.08
buyer_2,Carmen,40,ES59209517581497961835,TRX_N-00222-23374374,2022-07-05T14:44:25,Zarautz,expenses,water,-27.83,-9202.91
buyer_2,Carmen,40,ES59209517581497961835,TRX_N-00223-89210562,2022-07-05T19:28:12,Sopela,expenses,leisure,-40.89,-9243.8
buyer_2,Carmen,40,ES59209517581497961835,TRX_N-00224-40669981,2022-07-06T10:00:48,Zarautz,expenses,leisure,-77.69,-9321.49
buyer_2,Carmen,40,ES59209517581497961835,TRX_N-00225-64229402,2022-07-07T11:48:25,Zarautz,expenses,cash,-100.0,-9421.49
buyer_2,Carmen,40,ES59209517581497961835,TRX_N-00226-57046136,2022-07-08T18:00:19,Zarautz,expenses,electricity,-71.0,-9492.49
buyer_2,Carmen,40,ES59209517581497961835,TRX_N-00227-11350132,2022-07-08T13:32:50,Zarautz,expenses,gas,-110.96,-9603.45
buyer_2,Carmen,40,ES59209517581497961835,TRX_N-00228-49519827,2022-07-08T17:20:55,Zarautz,expenses,internet,-42.0,-9645.45
buyer_2,Carmen,40,ES59209517581497961835,TRX_N-00229-50931208,2022-07-08T02:34:40,Zarautz,expenses,phone,-38.42,-9683.87
buyer_2,Carmen,40,ES59209517581497961835,TRX_N-00230-94698821,2022-07-09T20:32:56,Alegría-Dulantzi,expenses,leisure,-28.13,-9712.0
buyer_2,Carmen,40,ES59209517581497961835,TRX_N-00231-35713992,2022-07-10T14:14:22,Santurtzi,expenses,repairs,-190.87,-9902.87
buyer_2,Carmen,40,ES59209517581497961835,TRX_N-00232-23600529,2022-07-11T10:32:35,Zarautz,expenses,clothing,-48.47,-9951.34
buyer_2,Carmen,40,ES59209517581497961835,TRX_N-00233-52347748,2022-07-14T20:44:09,Zarautz,expenses,food,-120.63,-10071.97
buyer_2,Carmen,40,ES59209517581497961835,TRX_N-00234-68798436,2022-07-14T23:29:08,Zarautz,expenses,transport,-85.54,-10157.51
buyer_2,Carmen,40,ES59209517581497961835,TRX_N-00235-45948391,2022-07-15T08:55:51,Zarautz,expenses,transport,-89.16,-10246.67
buyer_2,Carmen,40,ES59209517581497961835,TRX_N-00236-76454043,2022-07-15T20:06:35,Hernani,expenses,cash,-100.0,-10346.67
buyer_2,Carmen,40,ES59209517581497961835,TRX_N-00237-28567859,2022-07-16T17:00:45,Elciego,expenses,food,-81.48,-10428.15
buyer_2,Carmen,40,ES59209517581497961835,TRX_N-00238-12424366,2022-07-17T19:32:39,Zarautz,expenses,cash,-100.0,-10528.15
buyer_2,Carmen,40,ES59209517581497961835,TRX_N-00239-03005449,2022-07-17T13:00:29,Zarautz,expenses,repairs,-50.37,-10578.52
buyer_2,Carmen,40,ES59209517581497961835,TRX_N-00240-30320419,2022-07-17T19:10:36,Zarautz,expenses,gifts,-662.75,-11241.27
buyer_2,Carmen,40,ES59209517581497961835,TRX_N-00241-58236749,2022-07-19T13:15:58,Zarautz,expenses,children,-100.98,-11342.25
buyer_2,Carmen,40,ES59209517581497961835,TRX_N-00242-89435891,2022-07-20T23:22:36,Zarautz,expenses,transport,-61.45,-11403.7
buyer_2,Carmen,40,ES59209517581497961835,TRX_N-00243-27222922,2022-07-20T19:20:32,Zarautz,expenses,healthcare,-128.44,-11532.14
buyer_2,Carmen,40,ES59209517581497961835,TRX_N-00244-04122365,2022-07-22T20:54:48,Zarautz,expenses,repairs,-133.53,-11665.67
buyer_2,Carmen,40,ES59209517581497961835,TRX_N-00245-29964230,2022-07-24T17:17:37,Zarautz,expenses,food,-89.05,-11754.72
buyer_2,Carmen,40,ES59209517581497961835,TRX_N-00246-66110480,2022-07-24T17:41:50,Zarautz,expenses,cash,-100.0,-11854.72
buyer_2,Carmen,40,ES59209517581497961835,TRX_N-00247-23039759,2022-07-26T13:00:26,Zarautz,expenses,healthcare,-60.22,-11914.94
buyer_2,Carmen,40,ES59209517581497961835,TRX_N-00248-01777694,2022-07-27T20:50:24,Zarautz,expenses,food,-115.63,-12030.57
buyer_2,Carmen,40,ES59209517581497961835,TRX_N-00249-43488553,2022-07-28T20:29:47,Zarautz,expenses,food,-108.14,-12138.71
buyer_2,Carmen,40,ES59209517581497961835,TRX_N-00250-22579669,2022-07-29T09:22:39,Zarautz,expenses,cash,-100.0,-12238.71
buyer_2,Carmen,40,ES59209517581497961835,TRX_N-00251-03207624,2022-07-30T18:21:20,Pasaia,expenses,repairs,-295.33,-12534.04
buyer_2,Carmen,40,ES59209517581497961835,TRX_N-00252-84175222,2022-07-31T22:15:56,Zarautz,expenses,travel,-812.49,-13346.53
buyer_2,Carmen,40,ES59209517581497961835,TRX_N-00253-70697151,2022-07-31T13:08:48,Zarautz,expenses,children,-69.51,-13416.04
buyer_2,Carmen,40,ES59209517581497961835,TRX_N-00254-56254261,2022-08-01T10:51:37,Zarautz,incomes,salary,1263.46,-12152.58
buyer_2,Carmen,40,ES59209517581497961835,TRX_N-00255-38082447,2022-08-01T10:51:37,Zarautz,incomes,salary_partner,1020.72,-11131.86
buyer_2,Carmen,40,ES59209517581497961835,TRX_N-00256-66647338,2022-08-01T10:30:18,Zarautz,expenses,leisure,-32.23,-11164.09
buyer_2,Carmen,40,ES59209517581497961835,TRX_N-00257-88241919,2022-08-01T06:21:19,Zarautz,expenses,healthcare,-151.64,-11315.73
buyer_2,Carmen,40,ES59209517581497961835,TRX_N-00258-87802891,2022-08-01T18:00:25,Zarautz,expenses,cash,-100.0,-11415.73
buyer_2,Carmen,40,ES59209517581497961835,TRX_N-00259-65984079,2022-08-04T21:17:24,Zarautz,expenses,mortgage,-1091.91,-12507.64
buyer_2,Carmen,40,ES59209517581497961835,TRX_N-00260-52867243,2022-08-05T16:37:42,Zarautz,expenses,electricity,-64.02,-12571.66
buyer_2,Carmen,40,ES59209517581497961835,TRX_N-00261-95294151,2022-08-05T13:50:37,Zarautz,expenses,gas,-109.36,-12681.02
buyer_2,Carmen,40,ES59209517581497961835,TRX_N-00262-74178043,2022-08-05T17:28:11,Zarautz,expenses,internet,-42.0,-12723.02
buyer_2,Carmen,40,ES59209517581497961835,TRX_N-00263-29792035,2022-08-05T13:02:27,Zarautz,expenses,phone,-33.45,-12756.47
buyer_2,Carmen,40,ES59209517581497961835,TRX_N-00264-99032445,2022-08-05T18:10:54,Leioa,expenses,appliances,-412.03,-13168.5
buyer_2,Carmen,40,ES59209517581497961835,TRX_N-00265-35759176,2022-08-05T12:45:25,Zarautz,expenses,gifts,-53.93,-13222.43
buyer_2,Carmen,40,ES59209517581497961835,TRX_N-00266-64549329,2022-08-06T18:34:22,Zarautz,expenses,clothing,-125.7,-13348.13
buyer_2,Carmen,40,ES59209517581497961835,TRX_N-00267-14381233,2022-08-06T23:59:00,Zarautz,expenses,education,-45.91,-13394.04
buyer_2,Carmen,40,ES59209517581497961835,TRX_N-00268-70103807,2022-08-07T22:53:01,Andoain,expenses,appliances,-205.9,-13599.94
buyer_2,Carmen,40,ES59209517581497961835,TRX_N-00269-20271142,2022-08-08T17:51:23,Zarautz,expenses,water,-20.54,-13620.48
buyer_2,Carmen,40,ES59209517581497961835,TRX_N-00270-21668742,2022-08-10T22:08:32,Zarautz,expenses,cash,-100.0,-13720.48
buyer_2,Carmen,40,ES59209517581497961835,TRX_N-00271-72434659,2022-08-14T11:05:37,Zarautz,expenses,food,-112.4,-13832.88
buyer_2,Carmen,40,ES59209517581497961835,TRX_N-00272-09178762,2022-08-14T18:12:19,Zarautz,expenses,education,-55.08,-13887.96
buyer_2,Carmen,40,ES59209517581497961835,TRX_N-00273-39117029,2022-08-16T17:04:06,Zarautz,expenses,food,-71.99,-13959.95
buyer_2,Carmen,40,ES59209517581497961835,TRX_N-00274-74885010,2022-08-16T16:35:24,Zarautz,expenses,children,-210.52,-14170.47
buyer_2,Carmen,40,ES59209517581497961835,TRX_N-00275-60963204,2022-08-17T22:48:48,Zarautz,expenses,food,-111.31,-14281.78
buyer_2,Carmen,40,ES59209517581497961835,TRX_N-00276-45012433,2022-08-20T17:56:42,Zarautz,expenses,cash,-100.0,-14381.78
buyer_2,Carmen,40,ES59209517581497961835,TRX_N-00277-55662974,2022-08-21T13:28:30,Zarautz,expenses,transport,-54.23,-14436.01
buyer_2,Carmen,40,ES59209517581497961835,TRX_N-00278-31444381,2022-08-21T19:26:46,Leioa,expenses,clothing,-158.47,-14594.48
buyer_2,Carmen,40,ES59209517581497961835,TRX_N-00279-46723859,2022-08-21T13:42:29,Zarautz,expenses,healthcare,-129.47,-14723.95
buyer_2,Carmen,40,ES59209517581497961835,TRX_N-00280-60684341,2022-08-21T13:08:20,Zarautz,expenses,cash,-100.0,-14823.95
buyer_2,Carmen,40,ES59209517581497961835,TRX_N-00281-56103524,2022-08-22T12:38:31,Zarautz,expenses,food,-83.44,-14907.39
buyer_2,Carmen,40,ES59209517581497961835,TRX_N-00282-12546398,2022-08-22T20:41:32,Zarautz,expenses,children,-110.55,-15017.94
buyer_2,Carmen,40,ES59209517581497961835,TRX_N-00283-50663747,2022-08-23T19:42:27,Zarautz,expenses,cash,-100.0,-15117.94
buyer_2,Carmen,40,ES59209517581497961835,TRX_N-00284-64070418,2022-08-23T15:37:52,Zarautz,expenses,gifts,-202.38,-15320.32
buyer_2,Carmen,40,ES59209517581497961835,TRX_N-00285-66308060,2022-08-24T10:49:33,Zarautz,expenses,cash,-100.0,-15420.32
buyer_2,Carmen,40,ES59209517581497961835,TRX_N-00286-54497909,2022-08-26T00:43:34,Zarautz,expenses,leisure,-74.3,-15494.62
buyer_2,Carmen,40,ES59209517581497961835,TRX_N-00287-63202078,2022-08-27T13:00:27,Zarautz,expenses,leisure,-27.82,-15522.44
buyer_2,Carmen,40,ES59209517581497961835,TRX_N-00288-31410251,2022-08-28T17:58:04,Irun,expenses,cash,-100.0,-15622.44
buyer_2,Carmen,40,ES59209517581497961835,TRX_N-00289-43726835,2022-08-29T16:24:34,Zarautz,expenses,food,-99.79,-15722.23
buyer_2,Carmen,40,ES59209517581497961835,TRX_N-00290-87633898,2022-08-31T12:03:10,Zarautz,expenses,transport,-42.66,-15764.89
buyer_2,Carmen,40,ES59209517581497961835,TRX_N-00291-84346727,2022-08-31T19:00:33,Zarautz,expenses,leisure,-57.5,-15822.39
buyer_2,Carmen,40,ES59209517581497961835,TRX_N-00292-59037559,2022-09-01T18:13:40,Zarautz,incomes,salary,1263.46,-14558.93
buyer_2,Carmen,40,ES59209517581497961835,TRX_N-00293-66416168,2022-09-01T18:13:40,Zarautz,incomes,salary_partner,1020.72,-13538.21
buyer_2,Carmen,40,ES59209517581497961835,TRX_N-00294-48387087,2022-09-03T15:58:51,Zarautz,expenses,cash,-100.0,-13638.21
buyer_2,Carmen,40,ES59209517581497961835,TRX_N-00295-45615449,2022-09-03T14:18:10,Zarautz,expenses,appliances,-371.69,-14009.9
buyer_2,Carmen,40,ES59209517581497961835,TRX_N-00296-05322720,2022-09-04T09:21:48,Zarautz,expenses,mortgage,-1091.91,-15101.81
buyer_2,Carmen,40,ES59209517581497961835,TRX_N-00297-12007365,2022-09-04T17:12:56,Zarautz,expenses,food,-85.07,-15186.88
buyer_2,Carmen,40,ES59209517581497961835,TRX_N-00298-29085437,2022-09-04T09:36:24,Santurtzi,expenses,cash,-100.0,-15286.88
buyer_2,Carmen,40,ES59209517581497961835,TRX_N-00299-03905187,2022-09-05T12:39:41,Zarautz,expenses,electricity,-62.84,-15349.72
buyer_2,Carmen,40,ES59209517581497961835,TRX_N-00300-32064444,2022-09-05T16:34:34,Zarautz,expenses,phone,-40.57,-15390.29
buyer_2,Carmen,40,ES59209517581497961835,TRX_N-00301-97709064,2022-09-06T03:39:44,Zarautz,expenses,internet,-42.0,-15432.29
buyer_2,Carmen,40,ES59209517581497961835,TRX_N-00302-64574807,2022-09-07T12:42:46,Zarautz,expenses,water,-23.45,-15455.74
buyer_2,Carmen,40,ES59209517581497961835,TRX_N-00303-61083079,2022-09-08T02:51:18,Zarautz,expenses,gas,-66.46,-15522.2
buyer_2,Carmen,40,ES59209517581497961835,TRX_N-00304-68055173,2022-09-08T19:13:10,Zarautz,expenses,cash,-100.0,-15622.2
buyer_2,Carmen,40,ES59209517581497961835,TRX_N-00305-94258628,2022-09-10T20:21:45,Zarautz,expenses,children,-253.91,-15876.11
buyer_2,Carmen,40,ES59209517581497961835,TRX_N-00306-92406196,2022-09-11T07:05:14,Zarautz,expenses,cash,-100.0,-15976.11
buyer_2,Carmen,40,ES59209517581497961835,TRX_N-00307-57509409,2022-09-11T15:39:20,Llodio,expenses,repairs,-204.76,-16180.87
buyer_2,Carmen,40,ES59209517581497961835,TRX_N-00308-18228082,2022-09-12T07:16:16,Zarautz,expenses,leisure,-37.95,-16218.82
buyer_2,Carmen,40,ES59209517581497961835,TRX_N-00309-53976591,2022-09-14T20:57:34,Zarautz,expenses,gifts,-214.15,-16432.97
buyer_2,Carmen,40,ES59209517581497961835,TRX_N-00310-62545078,2022-09-15T16:20:29,Zarautz,expenses,healthcare,-81.45,-16514.42
buyer_2,Carmen,40,ES59209517581497961835,TRX_N-00311-97394714,2022-09-16T18:27:20,Zarautz,expenses,food,-97.93,-16612.35
buyer_2,Carmen,40,ES59209517581497961835,TRX_N-00312-90431419,2022-09-16T17:31:44,Zarautz,expenses,travel,-1780.48,-18392.83
buyer_2,Carmen,40,ES59209517581497961835,TRX_N-00313-31887379,2022-09-16T19:32:52,Zarautz,expenses,gifts,-782.62,-19175.45
buyer_2,Carmen,40,ES59209517581497961835,TRX_N-00314-19720886,2022-09-17T18:39:11,Zarautz,expenses,education,-54.43,-19229.88
buyer_2,Carmen,40,ES59209517581497961835,TRX_N-00315-57261029,2022-09-18T16:14:04,Zarautz,expenses,food,-113.87,-19343.75
buyer_2,Carmen,40,ES59209517581497961835,TRX_N-00316-14396122,2022-09-18T12:48:30,Zarautz,expenses,education,-71.08,-19414.83
buyer_2,Carmen,40,ES59209517581497961835,TRX_N-00317-21867273,2022-09-19T21:56:33,Zarautz,expenses,transport,-71.94,-19486.77
buyer_2,Carmen,40,ES59209517581497961835,TRX_N-00318-62482519,2022-09-19T08:11:45,Zarautz,expenses,leisure,-41.87,-19528.64
buyer_2,Carmen,40,ES59209517581497961835,TRX_N-00319-36824734,2022-09-20T08:38:51,Zarautz,expenses,leisure,-31.87,-19560.51
buyer_2,Carmen,40,ES59209517581497961835,TRX_N-00320-58885844,2022-09-20T18:49:56,Zarautz,expenses,repairs,-314.69,-19875.2
buyer_2,Carmen,40,ES59209517581497961835,TRX_N-00321-54610169,2022-09-21T15:06:12,Zarautz,expenses,leisure,-73.71,-19948.91
buyer_2,Carmen,40,ES59209517581497961835,TRX_N-00322-63278082,2022-09-22T15:01:01,Zarautz,expenses,leisure,-59.64,-20008.55
buyer_2,Carmen,40,ES59209517581497961835,TRX_N-00323-26600568,2022-09-23T10:15:10,Zarautz,expenses,travel,-1100.59,-21109.14
buyer_2,Carmen,40,ES59209517581497961835,TRX_N-00324-62412470,2022-09-25T13:43:39,Zarautz,expenses,food,-69.87,-21179.01
buyer_2,Carmen,40,ES59209517581497961835,TRX_N-00325-87794772,2022-09-25T17:15:09,Barakaldo,expenses,appliances,-235.21,-21414.22
buyer_2,Carmen,40,ES59209517581497961835,TRX_N-00326-49078776,2022-09-29T19:05:02,Zarautz,expenses,food,-99.42,-21513.64
buyer_2,Carmen,40,ES59209517581497961835,TRX_N-00327-49324124,2022-09-30T23:22:47,Zarautz,expenses,food,-88.47,-21602.11
buyer_2,Carmen,40,ES59209517581497961835,TRX_N-00328-00211328,2022-10-01T20:48:23,Zarautz,incomes,salary,1263.46,-20338.65
buyer_2,Carmen,40,ES59209517581497961835,TRX_N-00329-13919010,2022-10-01T20:48:23,Zarautz,incomes,salary_partner,1020.72,-19317.93
buyer_2,Carmen,40,ES59209517581497961835,TRX_N-00330-47026582,2022-10-01T20:48:23,Zarautz,incomes,extra_income,152.67,-19165.26
buyer_2,Carmen,40,ES59209517581497961835,TRX_N-00331-57156130,2022-10-01T08:16:12,Zarautz,expenses,leisure,-77.45,-19242.71
buyer_2,Carmen,40,ES59209517581497961835,TRX_N-00332-72982836,2022-10-01T10:19:36,Zarautz,expenses,repairs,-314.34,-19557.05
buyer_2,Carmen,40,ES59209517581497961835,TRX_N-00333-87325844,2022-10-02T10:20:13,Zarautz,expenses,food,-94.02,-19651.07
buyer_2,Carmen,40,ES59209517581497961835,TRX_N-00334-50720456,2022-10-02T19:17:52,Berango,expenses,cash,-100.0,-19751.07
buyer_2,Carmen,40,ES59209517581497961835,TRX_N-00335-72184704,2022-10-04T13:46:44,Zarautz,expenses,mortgage,-1091.91,-20842.98
buyer_2,Carmen,40,ES59209517581497961835,TRX_N-00336-04762579,2022-10-04T20:07:47,Zarautz,expenses,cash,-100.0,-20942.98
buyer_2,Carmen,40,ES59209517581497961835,TRX_N-00337-98021419,2022-10-05T11:39:59,Zarautz,expenses,leisure,-34.25,-20977.23
buyer_2,Carmen,40,ES59209517581497961835,TRX_N-00338-35637474,2022-10-05T04:07:52,Zarautz,expenses,education,-66.3,-21043.53
buyer_2,Carmen,40,ES59209517581497961835,TRX_N-00339-97794605,2022-10-05T10:21:25,Zarautz,expenses,gifts,-765.49,-21809.02
buyer_2,Carmen,40,ES59209517581497961835,TRX_N-00340-66431919,2022-10-06T15:06:19,Zarautz,expenses,water,-33.13,-21842.15
buyer_2,Carmen,40,ES59209517581497961835,TRX_N-00341-74887668,2022-10-06T12:57:25,Zarautz,expenses,phone,-40.01,-21882.16
buyer_2,Carmen,40,ES59209517581497961835,TRX_N-00342-68043544,2022-10-06T14:30:34,Zarautz,expenses,food,-63.23,-21945.39
buyer_2,Carmen,40,ES59209517581497961835,TRX_N-00343-50246214,2022-10-06T12:43:56,Zarautz,expenses,transport,-65.35,-22010.74
buyer_2,Carmen,40,ES59209517581497961835,TRX_N-00344-79566656,2022-10-08T18:53:44,Zarautz,expenses,gas,-60.37,-22071.11
buyer_2,Carmen,40,ES59209517581497961835,TRX_N-00345-91640452,2022-10-08T20:31:53,Zarautz,expenses,internet,-42.0,-22113.11
buyer_2,Carmen,40,ES59209517581497961835,TRX_N-00346-17690466,2022-10-08T08:35:09,Zarautz,expenses,electricity,-81.24,-22194.35
buyer_2,Carmen,40,ES59209517581497961835,TRX_N-00347-63498497,2022-10-08T14:59:11,Santurtzi,expenses,transport,-89.04,-22283.39
buyer_2,Carmen,40,ES59209517581497961835,TRX_N-00348-49156382,2022-10-10T09:31:01,Irun,expenses,transport,-42.89,-22326.28
buyer_2,Carmen,40,ES59209517581497961835,TRX_N-00349-34708606,2022-10-11T09:23:17,Zarautz,expenses,cash,-100.0,-22426.28
buyer_2,Carmen,40,ES59209517581497961835,TRX_N-00350-07520991,2022-10-12T14:46:40,Zarautz,expenses,transport,-69.96,-22496.24
buyer_2,Carmen,40,ES59209517581497961835,TRX_N-00351-07439620,2022-10-13T08:02:55,Zarautz,expenses,transport,-82.55,-22578.79
buyer_2,Carmen,40,ES59209517581497961835,TRX_N-00352-87431450,2022-10-14T16:38:28,Vitoria-Gasteiz,expenses,food,-116.52,-22695.31
buyer_2,Carmen,40,ES59209517581497961835,TRX_N-00353-73918292,2022-10-14T06:15:30,Zarautz,expenses,leisure,-18.08,-22713.39
buyer_2,Carmen,40,ES59209517581497961835,TRX_N-00354-21564056,2022-10-15T18:00:32,Zarautz,expenses,gifts,-495.65,-23209.04
buyer_2,Carmen,40,ES59209517581497961835,TRX_N-00355-34303394,2022-10-17T08:22:48,Zarautz,expenses,food,-119.72,-23328.76
buyer_2,Carmen,40,ES59209517581497961835,TRX_N-00356-57607040,2022-10-17T14:46:56,Zarautz,expenses,transport,-42.97,-23371.73
buyer_2,Carmen,40,ES59209517581497961835,TRX_N-00357-79365197,2022-10-20T11:41:18,Zarautz,expenses,food,-69.79,-23441.52
buyer_2,Carmen,40,ES59209517581497961835,TRX_N-00358-80529950,2022-10-26T18:20:32,Zarautz,expenses,repairs,-35.58,-23477.1
buyer_2,Carmen,40,ES59209517581497961835,TRX_N-00359-23427863,2022-10-27T08:37:24,Zarautz,expenses,clothing,-119.8,-23596.9
buyer_2,Carmen,40,ES59209517581497961835,TRX_N-00360-39642283,2022-10-28T13:43:44,Errenteria,expenses,food,-87.46,-23684.36
buyer_2,Carmen,40,ES59209517581497961835,TRX_N-00361-08026501,2022-10-28T19:57:25,Zarautz,expenses,transport,-70.45,-23754.81
buyer_2,Carmen,40,ES59209517581497961835,TRX_N-00362-45136414,2022-10-28T16:19:47,Zarautz,expenses,education,-47.81,-23802.62
buyer_2,Carmen,40,ES59209517581497961835,TRX_N-00363-36308372,2022-10-29T16:30:33,Zarautz,expenses,cash,-100.0,-23902.62
buyer_2,Carmen,40,ES59209517581497961835,TRX_N-00364-67379703,2022-10-31T17:44:27,Zarautz,expenses,transport,-87.24,-23989.86
buyer_2,Carmen,40,ES59209517581497961835,TRX_N-00365-39764682,2022-11-01T14:24:26,Zarautz,incomes,salary,1263.46,-22726.4
buyer_2,Carmen,40,ES59209517581497961835,TRX_N-00366-51165613,2022-11-01T14:24:26,Zarautz,incomes,salary_partner,1020.72,-21705.68
buyer_2,Carmen,40,ES59209517581497961835,TRX_N-00367-34330970,2022-11-01T20:04:34,Zarautz,expenses,transport,-51.82,-21757.5
buyer_2,Carmen,40,ES59209517581497961835,TRX_N-00368-42955167,2022-11-01T08:09:57,Zarautz,expenses,repairs,-212.97,-21970.47
buyer_2,Carmen,40,ES59209517581497961835,TRX_N-00369-49234304,2022-11-03T08:41:53,Zarautz,expenses,cash,-100.0,-22070.47
buyer_2,Carmen,40,ES59209517581497961835,TRX_N-00370-27150717,2022-11-03T19:30:13,Zarautz,expenses,children,-223.75,-22294.22
buyer_2,Carmen,40,ES59209517581497961835,TRX_N-00371-48379697,2022-11-04T20:27:17,Zarautz,expenses,mortgage,-1091.91,-23386.13
buyer_2,Carmen,40,ES59209517581497961835,TRX_N-00372-98243600,2022-11-04T15:59:09,Zarautz,expenses,transport,-52.25,-23438.38
buyer_2,Carmen,40,ES59209517581497961835,TRX_N-00373-73381771,2022-11-04T14:45:12,Zarautz,expenses,cash,-100.0,-23538.38
buyer_2,Carmen,40,ES59209517581497961835,TRX_N-00374-29074410,2022-11-04T08:21:47,Zarautz,expenses,appliances,-288.58,-23826.96
buyer_2,Carmen,40,ES59209517581497961835,TRX_N-00375-11924696,2022-11-05T23:01:23,Zarautz,expenses,phone,-30.93,-23857.89
buyer_2,Carmen,40,ES59209517581497961835,TRX_N-00376-38674962,2022-11-06T18:46:55,Zarautz,expenses,electricity,-82.42,-23940.31
buyer_2,Carmen,40,ES59209517581497961835,TRX_N-00377-75849178,2022-11-07T14:45:01,Zarautz,expenses,gas,-104.01,-24044.32
buyer_2,Carmen,40,ES59209517581497961835,TRX_N-00378-14231138,2022-11-07T18:21:05,Zarautz,expenses,clothing,-73.99,-24118.31
buyer_2,Carmen,40,ES59209517581497961835,TRX_N-00379-26243759,2022-11-08T18:38:38,Zarautz,expenses,water,-30.01,-24148.32
buyer_2,Carmen,40,ES59209517581497961835,TRX_N-00380-42451330,2022-11-08T08:14:11,Zarautz,expenses,internet,-42.0,-24190.32
buyer_2,Carmen,40,ES59209517581497961835,TRX_N-00381-98841958,2022-11-09T14:40:34,Zarautz,expenses,transport,-79.93,-24270.25
buyer_2,Carmen,40,ES59209517581497961835,TRX_N-00382-88826741,2022-11-10T19:29:57,Oyón-Oion,expenses,transport,-40.88,-24311.13
buyer_2,Carmen,40,ES59209517581497961835,TRX_N-00383-63129149,2022-11-10T20:41:15,Zarautz,expenses,cash,-100.0,-24411.13
buyer_2,Carmen,40,ES59209517581497961835,TRX_N-00384-02490854,2022-11-12T13:28:57,Zarautz,expenses,food,-112.55,-24523.68
buyer_2,Carmen,40,ES59209517581497961835,TRX_N-00385-10507666,2022-11-12T17:49:51,Zarautz,expenses,transport,-54.46,-24578.14
buyer_2,Carmen,40,ES59209517581497961835,TRX_N-00386-58494135,2022-11-13T01:57:00,Zarautz,expenses,food,-111.74,-24689.88
buyer_2,Carmen,40,ES59209517581497961835,TRX_N-00387-41183684,2022-11-15T09:00:58,Zarautz,expenses,travel,-1895.35,-26585.23
buyer_2,Carmen,40,ES59209517581497961835,TRX_N-00388-14807866,2022-11-16T10:51:38,Zarautz,expenses,repairs,-165.75,-26750.98
buyer_2,Carmen,40,ES59209517581497961835,TRX_N-00389-33701160,2022-11-17T01:03:10,Zarautz,expenses,food,-99.62,-26850.6
buyer_2,Carmen,40,ES59209517581497961835,TRX_N-00390-09313432,2022-11-18T02:51:21,Zarautz,expenses,leisure,-68.69,-26919.29
buyer_2,Carmen,40,ES59209517581497961835,TRX_N-00391-79108811,2022-11-19T21:46:57,Zarautz,expenses,food,-124.75,-27044.04
buyer_2,Carmen,40,ES59209517581497961835,TRX_N-00392-82912982,2022-11-20T21:56:12,Andoain,expenses,appliances,-209.87,-27253.91
buyer_2,Carmen,40,ES59209517581497961835,TRX_N-00393-83461974,2022-11-21T13:10:34,Basauri,expenses,food,-112.52,-27366.43
buyer_2,Carmen,40,ES59209517581497961835,TRX_N-00394-89158542,2022-11-21T02:38:55,Barakaldo,expenses,cash,-100.0,-27466.43
buyer_2,Carmen,40,ES59209517581497961835,TRX_N-00395-47098820,2022-11-23T18:19:31,Zarautz,expenses,leisure,-27.63,-27494.06
buyer_2,Carmen,40,ES59209517581497961835,TRX_N-00396-36184191,2022-11-23T23:51:25,Zarautz,expenses,clothing,-117.5,-27611.56
buyer_2,Carmen,40,ES59209517581497961835,TRX_N-00397-83365247,2022-11-23T16:02:57,Zarautz,expenses,cash,-100.0,-27711.56
buyer_2,Carmen,40,ES59209517581497961835,TRX_N-00398-94139149,2022-11-24T20:16:25,Zarautz,expenses,cash,-100.0,-27811.56
buyer_2,Carmen,40,ES59209517581497961835,TRX_N-00399-73970846,2022-11-25T22:49:35,Zarautz,expenses,cash,-100.0,-27911.56
buyer_2,Carmen,40,ES59209517581497961835,TRX_N-00400-78470753,2022-11-29T08:36:58,Zarautz,expenses,food,-94.9,-28006.46
buyer_2,Carmen,40,ES59209517581497961835,TRX_N-00401-55329854,2022-12-01T15:30:53,Zarautz,incomes,salary,1263.46,-26743.0
buyer_2,Carmen,40,ES59209517581497961835,TRX_N-00402-40474241,2022-12-01T15:30:53,Zarautz,incomes,salary_partner,1020.72,-25722.28
buyer_2,Carmen,40,ES59209517581497961835,TRX_N-00403-01272954,2022-12-01T15:30:53,Zarautz,incomes,salary_bonus,950.27,-24772.01
buyer_2,Carmen,40,ES59209517581497961835,TRX_N-00404-86151779,2022-12-01T15:30:53,Zarautz,incomes,salary_partner_bonus,761.82,-24010.19
buyer_2,Carmen,40,ES59209517581497961835,TRX_N-00405-36463120,2022-12-01T21:05:24,Zarautz,expenses,food,-87.52,-24097.71
buyer_2,Carmen,40,ES59209517581497961835,TRX_N-00406-75203375,2022-12-01T13:37:43,Zarautz,expenses,education,-64.21,-24161.92
buyer_2,Carmen,40,ES59209517581497961835,TRX_N-00407-77187128,2022-12-04T15:45:03,Zarautz,expenses,mortgage,-1091.91,-25253.83
buyer_2,Carmen,40,ES59209517581497961835,TRX_N-00408-46706062,2022-12-05T13:24:26,Zarautz,expenses,repairs,-198.67,-25452.5
buyer_2,Carmen,40,ES59209517581497961835,TRX_N-00409-35532922,2022-12-05T08:22:42,Zarautz,expenses,gifts,-467.24,-25919.74
buyer_2,Carmen,40,ES59209517581497961835,TRX_N-00410-35085081,2022-12-06T20:42:55,Zarautz,expenses,water,-42.8,-25962.54
buyer_2,Carmen,40,ES59209517581497961835,TRX_N-00411-71282167,2022-12-07T01:59:44,Zarautz,expenses,transport,-86.88,-26049.42
buyer_2,Carmen,40,ES59209517581497961835,TRX_N-00412-29966143,2022-12-07T08:46:56,Zarautz,expenses,cash,-100.0,-26149.42
buyer_2,Carmen,40,ES59209517581497961835,TRX_N-00413-28641418,2022-12-08T20:55:34,Zarautz,expenses,phone,-40.13,-26189.55
buyer_2,Carmen,40,ES59209517581497961835,TRX_N-00414-58838831,2022-12-08T14:34:15,Zarautz,expenses,electricity,-48.96,-26238.51
buyer_2,Carmen,40,ES59209517581497961835,TRX_N-00415-62998460,2022-12-08T13:18:35,Zarautz,expenses,gas,-104.44,-26342.95
buyer_2,Carmen,40,ES59209517581497961835,TRX_N-00416-37722279,2022-12-08T11:38:30,Zarautz,expenses,internet,-42.0,-26384.95
buyer_2,Carmen,40,ES59209517581497961835,TRX_N-00417-27370054,2022-12-08T23:58:21,Zarautz,expenses,food,-95.0,-26479.95
buyer_2,Carmen,40,ES59209517581497961835,TRX_N-00418-74022885,2022-12-08T19:23:42,Andoain,expenses,cash,-100.0,-26579.95
buyer_2,Carmen,40,ES59209517581497961835,TRX_N-00419-00266341,2022-12-12T10:01:04,Zarautz,expenses,food,-119.53,-26699.48
buyer_2,Carmen,40,ES59209517581497961835,TRX_N-00420-95605230,2022-12-12T10:53:48,Zarautz,expenses,clothing,-153.95,-26853.43
buyer_2,Carmen,40,ES59209517581497961835,TRX_N-00421-17336118,2022-12-13T22:26:12,Zarautz,expenses,food,-75.3,-26928.73
buyer_2,Carmen,40,ES59209517581497961835,TRX_N-00422-99045824,2022-12-13T03:19:33,Zarautz,expenses,leisure,-33.71,-26962.44
buyer_2,Carmen,40,ES59209517581497961835,TRX_N-00423-33888800,2022-12-15T11:16:03,Zarautz,expenses,food,-119.53,-27081.97
buyer_2,Carmen,40,ES59209517581497961835,TRX_N-00424-16809332,2022-12-15T10:15:16,Zarautz,expenses,transport,-46.59,-27128.56
buyer_2,Carmen,40,ES59209517581497961835,TRX_N-00425-12782876,2022-12-15T16:39:51,Zarautz,expenses,leisure,-47.37,-27175.93
buyer_2,Carmen,40,ES59209517581497961835,TRX_N-00426-08882901,2022-12-18T09:49:49,Zarautz,expenses,food,-80.67,-27256.6
buyer_2,Carmen,40,ES59209517581497961835,TRX_N-00427-28792708,2022-12-19T08:54:50,Zarautz,expenses,gifts,-816.27,-28072.87
buyer_2,Carmen,40,ES59209517581497961835,TRX_N-00428-21997870,2022-12-20T16:22:04,Durango,expenses,transport,-51.75,-28124.62
buyer_2,Carmen,40,ES59209517581497961835,TRX_N-00429-74365003,2022-12-24T08:01:13,Zarautz,expenses,leisure,-19.66,-28144.28
buyer_2,Carmen,40,ES59209517581497961835,TRX_N-00430-41257480,2022-12-28T17:08:51,Zarautz,expenses,food,-115.4,-28259.68
buyer_2,Carmen,40,ES59209517581497961835,TRX_N-00431-43934493,2022-12-28T04:05:05,Zarautz,expenses,healthcare,-52.22,-28311.9
buyer_2,Carmen,40,ES59209517581497961835,TRX_N-00432-67223578,2022-12-28T08:17:06,Zarautz,expenses,cash,-100.0,-28411.9
buyer_2,Carmen,40,ES59209517581497961835,TRX_N-00433-94275741,2022-12-30T23:06:27,Zarautz,expenses,transport,-49.3,-28461.2
buyer_2,Carmen,40,ES59209517581497961835,TRX_N-00434-71747983,2022-12-30T20:12:19,Zarautz,expenses,travel,-1541.94,-30003.14
buyer_2,Carmen,40,ES59209517581497961835,TRX_N-00435-99178761,2022-12-31T10:31:06,Zarautz,expenses,transport,-65.5,-30068.64
buyer_2,Carmen,40,ES59209517581497961835,TRX_N-00436-20064796,2023-01-01T10:25:04,Zarautz,incomes,salary,1308.64,-28760.0
buyer_2,Carmen,40,ES59209517581497961835,TRX_N-00437-80056201,2023-01-01T10:25:04,Zarautz,incomes,salary_partner,1057.22,-27702.78
buyer_2,Carmen,40,ES59209517581497961835,TRX_N-00438-70237645,2023-01-01T10:25:04,Zarautz,incomes,extra_income,152.67,-27550.11
buyer_2,Carmen,40,ES59209517581497961835,TRX_N-00439-80793405,2023-01-01T17:28:24,Zarautz,expenses,cash,-100.0,-27650.11
buyer_2,Carmen,40,ES59209517581497961835,TRX_N-00440-22411052,2023-01-02T18:45:43,Zarautz,expenses,food,-76.33,-27726.44
buyer_2,Carmen,40,ES59209517581497961835,TRX_N-00441-50364817,2023-01-02T19:41:00,Zarautz,expenses,repairs,-79.37,-27805.81
buyer_2,Carmen,40,ES59209517581497961835,TRX_N-00442-97333004,2023-01-04T20:09:55,Zarautz,expenses,mortgage,-1091.91,-28897.72
buyer_2,Carmen,40,ES59209517581497961835,TRX_N-00443-54485421,2023-01-05T23:03:54,Zarautz,expenses,water,-40.63,-28938.35
buyer_2,Carmen,40,ES59209517581497961835,TRX_N-00444-23484861,2023-01-05T04:18:00,Zarautz,expenses,gas,-71.26,-29009.61
buyer_2,Carmen,40,ES59209517581497961835,TRX_N-00445-11876077,2023-01-05T21:42:27,Zarautz,expenses,phone,-35.39,-29045.0
buyer_2,Carmen,40,ES59209517581497961835,TRX_N-00446-48175452,2023-01-05T14:55:11,Vitoria-Gasteiz,expenses,appliances,-84.03,-29129.03
buyer_2,Carmen,40,ES59209517581497961835,TRX_N-00447-94432709,2023-01-06T17:50:07,Zarautz,expenses,cash,-100.0,-29229.03
buyer_2,Carmen,40,ES59209517581497961835,TRX_N-00448-66106841,2023-01-07T13:54:55,Zarautz,expenses,food,-117.36,-29346.39
buyer_2,Carmen,40,ES59209517581497961835,TRX_N-00449-49006420,2023-01-07T10:47:03,Zarautz,expenses,transport,-48.82,-29395.21
buyer_2,Carmen,40,ES59209517581497961835,TRX_N-00450-06898725,2023-01-08T14:55:48,Zarautz,expenses,internet,-42.0,-29437.21
buyer_2,Carmen,40,ES59209517581497961835,TRX_N-00451-67790246,2023-01-08T08:18:02,Zarautz,expenses,electricity,-53.58,-29490.79
buyer_2,Carmen,40,ES59209517581497961835,TRX_N-00452-07554339,2023-01-10T09:44:15,Zarautz,expenses,clothing,-125.93,-29616.72
buyer_2,Carmen,40,ES59209517581497961835,TRX_N-00453-65133249,2023-01-11T14:11:45,Donostia,expenses,food,-77.44,-29694.16
buyer_2,Carmen,40,ES59209517581497961835,TRX_N-00454-96801895,2023-01-13T17:46:59,Lasarte-Oria,expenses,food,-116.78,-29810.94
buyer_2,Carmen,40,ES59209517581497961835,TRX_N-00455-38060065,2023-01-14T14:48:12,Zarautz,expenses,appliances,-117.32,-29928.26
buyer_2,Carmen,40,ES59209517581497961835,TRX_N-00456-36972717,2023-01-15T23:50:30,Zarautz,expenses,leisure,-62.29,-29990.55
buyer_2,Carmen,40,ES59209517581497961835,TRX_N-00457-39818566,2023-01-17T02:48:38,Zarautz,expenses,education,-60.21,-30050.76
buyer_2,Carmen,40,ES59209517581497961835,TRX_N-00458-86438399,2023-01-18T20:43:18,Zarautz,expenses,food,-101.43,-30152.19
buyer_2,Carmen,40,ES59209517581497961835,TRX_N-00459-09635580,2023-01-18T14:00:39,Zarautz,expenses,appliances,-158.45,-30310.64
buyer_2,Carmen,40,ES59209517581497961835,TRX_N-00460-48972540,2023-01-19T09:42:40,Lasarte-Oria,expenses,repairs,-290.51,-30601.15
buyer_2,Carmen,40,ES59209517581497961835,TRX_N-00461-22877287,2023-01-21T15:02:37,Zarautz,expenses,gifts,-40.82,-30641.97
buyer_2,Carmen,40,ES59209517581497961835,TRX_N-00462-38001927,2023-01-22T10:51:28,Oyón-Oion,expenses,gifts,-660.14,-31302.11
buyer_2,Carmen,40,ES59209517581497961835,TRX_N-00463-85165703,2023-01-23T15:18:44,Zarautz,expenses,repairs,-48.12,-31350.23
buyer_2,Carmen,40,ES59209517581497961835,TRX_N-00464-01797873,2023-01-28T19:10:00,Zarautz,expenses,cash,-100.0,-31450.23
buyer_2,Carmen,40,ES59209517581497961835,TRX_N-00465-10760537,2023-01-30T05:48:23,Zarautz,expenses,food,-61.41,-31511.64
buyer_2,Carmen,40,ES59209517581497961835,TRX_N-00466-52117813,2023-01-30T14:22:52,Zarautz,expenses,clothing,-130.4,-31642.04
buyer_2,Carmen,40,ES59209517581497961835,TRX_N-00467-54350206,2023-01-30T13:52:17,Zarautz,expenses,cash,-100.0,-31742.04
buyer_2,Carmen,40,ES59209517581497961835,TRX_N-00468-23741892,2023-01-31T17:03:27,Zarautz,expenses,cash,-100.0,-31842.04
buyer_2,Carmen,40,ES59209517581497961835,TRX_N-00469-70978699,2023-02-01T17:03:49,Zarautz,incomes,salary,1308.64,-30533.4
buyer_2,Carmen,40,ES59209517581497961835,TRX_N-00470-80170384,2023-02-01T17:03:49,Zarautz,incomes,salary_partner,1057.22,-29476.18
buyer_2,Carmen,40,ES59209517581497961835,TRX_N-00471-34684858,2023-02-01T15:47:27,Berango,expenses,transport,-87.04,-29563.22
buyer_2,Carmen,40,ES59209517581497961835,TRX_N-00472-04598465,2023-02-04T09:19:27,Zarautz,expenses,mortgage,-1091.91,-30655.13
buyer_2,Carmen,40,ES59209517581497961835,TRX_N-00473-96940657,2023-02-04T13:07:16,Zarautz,expenses,food,-98.88,-30754.01
buyer_2,Carmen,40,ES59209517581497961835,TRX_N-00474-56560221,2023-02-05T14:05:46,Zarautz,expenses,gas,-74.8,-30828.81
buyer_2,Carmen,40,ES59209517581497961835,TRX_N-00475-81822781,2023-02-05T13:40:48,Galdakao,expenses,food,-67.94,-30896.75
buyer_2,Carmen,40,ES59209517581497961835,TRX_N-00476-22282620,2023-02-06T18:10:54,Zarautz,expenses,phone,-35.97,-30932.72
buyer_2,Carmen,40,ES59209517581497961835,TRX_N-00477-19319181,2023-02-06T15:09:59,Zarautz,expenses,leisure,-19.94,-30952.66
buyer_2,Carmen,40,ES59209517581497961835,TRX_N-00478-10774508,2023-02-06T13:02:59,Zarautz,expenses,clothing,-89.62,-31042.28
buyer_2,Carmen,40,ES59209517581497961835,TRX_N-00479-46146513,2023-02-06T08:55:50,Zarautz,expenses,cash,-100.0,-31142.28
buyer_2,Carmen,40,ES59209517581497961835,TRX_N-00480-45685954,2023-02-06T15:18:27,Zarautz,expenses,gifts,-231.85,-31374.13
buyer_2,Carmen,40,ES59209517581497961835,TRX_N-00481-21798596,2023-02-07T15:57:18,Zarautz,expenses,water,-41.75,-31415.88
buyer_2,Carmen,40,ES59209517581497961835,TRX_N-00482-86296646,2023-02-07T17:02:40,Zarautz,expenses,cash,-100.0,-31515.88
buyer_2,Carmen,40,ES59209517581497961835,TRX_N-00483-81220906,2023-02-07T12:17:51,Zarautz,expenses,repairs,-245.3,-31761.18
buyer_2,Carmen,40,ES59209517581497961835,TRX_N-00484-33606750,2023-02-08T19:51:31,Zarautz,expenses,electricity,-40.68,-31801.86
buyer_2,Carmen,40,ES59209517581497961835,TRX_N-00485-26835424,2023-02-08T08:59:52,Zarautz,expenses,internet,-42.0,-31843.86
buyer_2,Carmen,40,ES59209517581497961835,TRX_N-00486-66500994,2023-02-09T19:28:49,Zarautz,expenses,leisure,-42.72,-31886.58
buyer_2,Carmen,40,ES59209517581497961835,TRX_N-00487-36081670,2023-02-10T13:01:34,Zarautz,expenses,leisure,-23.21,-31909.79
buyer_2,Carmen,40,ES59209517581497961835,TRX_N-00488-38449913,2023-02-11T08:53:07,Labastida,expenses,cash,-100.0,-32009.79
buyer_2,Carmen,40,ES59209517581497961835,TRX_N-00489-57047478,2023-02-13T14:55:00,Zarautz,expenses,leisure,-49.74,-32059.53
buyer_2,Carmen,40,ES59209517581497961835,TRX_N-00490-11073782,2023-02-14T15:34:02,Zarautz,expenses,transport,-45.3,-32104.83
buyer_2,Carmen,40,ES59209517581497961835,TRX_N-00491-80606400,2023-02-16T08:16:56,Zarautz,expenses,cash,-100.0,-32204.83
buyer_2,Carmen,40,ES59209517581497961835,TRX_N-00492-21033733,2023-02-17T15:26:20,Zarautz,expenses,cash,-100.0,-32304.83
buyer_2,Carmen,40,ES59209517581497961835,TRX_N-00493-63778532,2023-02-18T16:30:00,Zarautz,expenses,food,-64.3,-32369.13
buyer_2,Carmen,40,ES59209517581497961835,TRX_N-00494-01124059,2023-02-18T14:38:52,Zarautz,expenses,transport,-58.76,-32427.89
buyer_2,Carmen,40,ES59209517581497961835,TRX_N-00495-56466720,2023-02-22T00:31:17,Zarautz,expenses,cash,-100.0,-32527.89
buyer_2,Carmen,40,ES59209517581497961835,TRX_N-00496-66246254,2023-02-24T19:56:50,Zarautz,expenses,gifts,-296.26,-32824.15
buyer_2,Carmen,40,ES59209517581497961835,TRX_N-00497-67658129,2023-02-26T08:51:19,Zarautz,expenses,gifts,-287.51,-33111.66
buyer_2,Carmen,40,ES59209517581497961835,TRX_N-00498-61386655,2023-03-01T09:17:59,Zarautz,incomes,salary,1308.64,-31803.02
buyer_2,Carmen,40,ES59209517581497961835,TRX_N-00499-79744602,2023-03-01T09:17:59,Zarautz,incomes,salary_partner,1057.22,-30745.8
buyer_2,Carmen,40,ES59209517581497961835,TRX_N-00500-64170040,2023-03-03T04:45:35,Zarautz,expenses,leisure,-33.84,-30779.64
buyer_2,Carmen,40,ES59209517581497961835,TRX_N-00501-69659073,2023-03-04T13:44:34,Zarautz,expenses,mortgage,-1091.91,-31871.55
buyer_2,Carmen,40,ES59209517581497961835,TRX_N-00502-79404110,2023-03-04T07:31:15,Zarautz,expenses,gifts,-389.7,-32261.25
buyer_2,Carmen,40,ES59209517581497961835,TRX_N-00503-79340436,2023-03-05T16:11:22,Zarautz,expenses,gas,-45.77,-32307.02
buyer_2,Carmen,40,ES59209517581497961835,TRX_N-00504-34950434,2023-03-05T11:26:39,Zarautz,expenses,phone,-34.36,-32341.38
buyer_2,Carmen,40,ES59209517581497961835,TRX_N-00505-95131843,2023-03-05T10:22:49,Zarautz,expenses,repairs,-162.11,-32503.49
buyer_2,Carmen,40,ES59209517581497961835,TRX_N-00506-13692395,2023-03-06T08:16:08,Zarautz,expenses,electricity,-82.04,-32585.53
buyer_2,Carmen,40,ES59209517581497961835,TRX_N-00507-56512967,2023-03-06T16:08:53,Zarautz,expenses,leisure,-82.32,-32667.85
buyer_2,Carmen,40,ES59209517581497961835,TRX_N-00508-41520788,2023-03-07T16:07:29,Zarautz,expenses,gifts,-407.71,-33075.56
buyer_2,Carmen,40,ES59209517581497961835,TRX_N-00509-04848491,2023-03-08T05:43:50,Zarautz,expenses,water,-23.3,-33098.86
buyer_2,Carmen,40,ES59209517581497961835,TRX_N-00510-24294369,2023-03-08T19:11:50,Zarautz,expenses,internet,-42.0,-33140.86
buyer_2,Carmen,40,ES59209517581497961835,TRX_N-00511-15486469,2023-03-10T08:53:52,Zarautz,expenses,transport,-57.87,-33198.73
buyer_2,Carmen,40,ES59209517581497961835,TRX_N-00512-44524273,2023-03-10T10:27:32,Zarautz,expenses,cash,-100.0,-33298.73
buyer_2,Carmen,40,ES59209517581497961835,TRX_N-00513-31947747,2023-03-10T16:02:55,Zarautz,expenses,travel,-357.71,-33656.44
buyer_2,Carmen,40,ES59209517581497961835,TRX_N-00514-57413843,2023-03-11T12:33:39,Zarautz,expenses,leisure,-36.51,-33692.95
buyer_2,Carmen,40,ES59209517581497961835,TRX_N-00515-17885930,2023-03-11T22:49:48,Durango,expenses,appliances,-133.72,-33826.67
buyer_2,Carmen,40,ES59209517581497961835,TRX_N-00516-18246691,2023-03-11T16:41:30,Zarautz,expenses,gifts,-250.82,-34077.49
buyer_2,Carmen,40,ES59209517581497961835,TRX_N-00517-80998575,2023-03-12T18:46:50,Zarautz,expenses,food,-95.49,-34172.98
buyer_2,Carmen,40,ES59209517581497961835,TRX_N-00518-38497360,2023-03-13T19:31:35,Zarautz,expenses,cash,-100.0,-34272.98
buyer_2,Carmen,40,ES59209517581497961835,TRX_N-00519-53156563,2023-03-14T08:16:19,Zarautz,expenses,food,-81.77,-34354.75
buyer_2,Carmen,40,ES59209517581497961835,TRX_N-00520-89255758,2023-03-14T12:10:28,Sopela,expenses,cash,-100.0,-34454.75
buyer_2,Carmen,40,ES59209517581497961835,TRX_N-00521-65012847,2023-03-17T18:00:05,Salvatierra/Agurain,expenses,food,-95.05,-34549.8
buyer_2,Carmen,40,ES59209517581497961835,TRX_N-00522-23123484,2023-03-19T10:37:16,Zarautz,expenses,transport,-60.53,-34610.33
buyer_2,Carmen,40,ES59209517581497961835,TRX_N-00523-08778946,2023-03-19T11:05:35,Pasaia,expenses,cash,-100.0,-34710.33
buyer_2,Carmen,40,ES59209517581497961835,TRX_N-00524-08028435,2023-03-19T18:43:55,Zarautz,expenses,repairs,-153.11,-34863.44
buyer_2,Carmen,40,ES59209517581497961835,TRX_N-00525-07686635,2023-03-20T17:34:58,Zarautz,expenses,cash,-100.0,-34963.44
buyer_2,Carmen,40,ES59209517581497961835,TRX_N-00526-00139646,2023-03-21T20:55:09,Zarautz,expenses,leisure,-55.5,-35018.94
buyer_2,Carmen,40,ES59209517581497961835,TRX_N-00527-10063354,2023-03-21T09:58:48,Zarautz,expenses,education,-53.07,-35072.01
buyer_2,Carmen,40,ES59209517581497961835,TRX_N-00528-20762496,2023-03-22T11:18:51,Zarautz,expenses,cash,-100.0,-35172.01
buyer_2,Carmen,40,ES59209517581497961835,TRX_N-00529-40642005,2023-03-22T08:31:26,Zarautz,expenses,appliances,-275.46,-35447.47
buyer_2,Carmen,40,ES59209517581497961835,TRX_N-00530-07514458,2023-03-23T09:58:50,Zarautz,expenses,leisure,-45.42,-35492.89
buyer_2,Carmen,40,ES59209517581497961835,TRX_N-00531-28167640,2023-03-25T13:01:19,Zarautz,expenses,clothing,-70.57,-35563.46
buyer_2,Carmen,40,ES59209517581497961835,TRX_N-00532-95263731,2023-03-25T18:07:35,Zarautz,expenses,cash,-100.0,-35663.46
buyer_2,Carmen,40,ES59209517581497961835,TRX_N-00533-73820085,2023-03-26T15:27:06,Zarautz,expenses,cash,-100.0,-35763.46
buyer_2,Carmen,40,ES59209517581497961835,TRX_N-00534-88169173,2023-03-26T16:47:27,Arrasate,expenses,appliances,-199.95,-35963.41
buyer_2,Carmen,40,ES59209517581497961835,TRX_N-00535-92276512,2023-03-26T15:42:58,Arrasate,expenses,repairs,-197.86,-36161.27
buyer_2,Carmen,40,ES59209517581497961835,TRX_N-00536-73237249,2023-03-27T17:30:06,Zarautz,expenses,repairs,-223.69,-36384.96
buyer_2,Carmen,40,ES59209517581497961835,TRX_N-00537-35024340,2023-03-28T14:37:46,Zarautz,expenses,transport,-75.07,-36460.03
buyer_2,Carmen,40,ES59209517581497961835,TRX_N-00538-76778875,2023-03-29T14:43:43,Zarautz,expenses,leisure,-27.48,-36487.51
buyer_2,Carmen,40,ES59209517581497961835,TRX_N-00539-37520023,2023-04-01T14:59:32,Zarautz,incomes,salary,1308.64,-35178.87
buyer_2,Carmen,40,ES59209517581497961835,TRX_N-00540-24348697,2023-04-01T14:59:32,Zarautz,incomes,salary_partner,1057.22,-34121.65
buyer_2,Carmen,40,ES59209517581497961835,TRX_N-00541-27722399,2023-04-01T10:05:25,Zarautz,expenses,cash,-100.0,-34221.65
buyer_2,Carmen,40,ES59209517581497961835,TRX_N-00542-03825183,2023-04-02T19:04:07,Zarautz,expenses,cash,-100.0,-34321.65
buyer_2,Carmen,40,ES59209517581497961835,TRX_N-00543-82609639,2023-04-03T04:56:27,Leioa,expenses,food,-101.31,-34422.96
buyer_2,Carmen,40,ES59209517581497961835,TRX_N-00544-35649508,2023-04-03T18:16:32,Zarautz,expenses,transport,-61.94,-34484.9
buyer_2,Carmen,40,ES59209517581497961835,TRX_N-00545-70459579,2023-04-04T09:50:05,Zarautz,expenses,mortgage,-1091.91,-35576.81
buyer_2,Carmen,40,ES59209517581497961835,TRX_N-00546-98799942,2023-04-04T08:53:05,Zarautz,expenses,food,-98.05,-35674.86
buyer_2,Carmen,40,ES59209517581497961835,TRX_N-00547-48036007,2023-04-04T19:25:00,Zarautz,expenses,cash,-100.0,-35774.86
buyer_2,Carmen,40,ES59209517581497961835,TRX_N-00548-79930176,2023-04-04T12:30:27,Zarautz,expenses,appliances,-204.13,-35978.99
buyer_2,Carmen,40,ES59209517581497961835,TRX_N-00549-22316816,2023-04-05T19:26:57,Zarautz,expenses,food,-82.82,-36061.81
buyer_2,Carmen,40,ES59209517581497961835,TRX_N-00550-36492028,2023-04-06T09:15:26,Zarautz,expenses,gas,-40.79,-36102.6
buyer_2,Carmen,40,ES59209517581497961835,TRX_N-00551-23769602,2023-04-06T13:06:25,Zarautz,expenses,cash,-100.0,-36202.6
buyer_2,Carmen,40,ES59209517581497961835,TRX_N-00552-58430853,2023-04-07T14:34:06,Zarautz,expenses,phone,-32.93,-36235.53
buyer_2,Carmen,40,ES59209517581497961835,TRX_N-00553-71852063,2023-04-08T10:55:47,Zarautz,expenses,electricity,-54.49,-36290.02
buyer_2,Carmen,40,ES59209517581497961835,TRX_N-00554-39050766,2023-04-08T09:56:29,Zarautz,expenses,internet,-42.0,-36332.02
buyer_2,Carmen,40,ES59209517581497961835,TRX_N-00555-75822525,2023-04-08T20:47:55,Zarautz,expenses,water,-32.52,-36364.54
buyer_2,Carmen,40,ES59209517581497961835,TRX_N-00556-47145189,2023-04-08T11:25:39,Zarautz,expenses,education,-73.88,-36438.42
buyer_2,Carmen,40,ES59209517581497961835,TRX_N-00557-15077683,2023-04-09T18:50:45,Zarautz,expenses,leisure,-44.33,-36482.75
buyer_2,Carmen,40,ES59209517581497961835,TRX_N-00558-07822033,2023-04-09T14:35:40,Zarautz,expenses,children,-212.12,-36694.87
buyer_2,Carmen,40,ES59209517581497961835,TRX_N-00559-99222313,2023-04-10T12:57:37,Zarautz,expenses,leisure,-48.04,-36742.91
buyer_2,Carmen,40,ES59209517581497961835,TRX_N-00560-77673552,2023-04-10T08:38:54,Zarautz,expenses,healthcare,-139.25,-36882.16
buyer_2,Carmen,40,ES59209517581497961835,TRX_N-00561-21319392,2023-04-10T15:59:02,Zarautz,expenses,children,-140.06,-37022.22
buyer_2,Carmen,40,ES59209517581497961835,TRX_N-00562-52490887,2023-04-12T20:09:10,Zarautz,expenses,education,-52.56,-37074.78
buyer_2,Carmen,40,ES59209517581497961835,TRX_N-00563-67809654,2023-04-12T11:48:29,Zarautz,expenses,repairs,-244.26,-37319.04
buyer_2,Carmen,40,ES59209517581497961835,TRX_N-00564-09578869,2023-04-15T19:04:20,Zarautz,expenses,transport,-64.58,-37383.62
buyer_2,Carmen,40,ES59209517581497961835,TRX_N-00565-07913699,2023-04-16T12:00:38,Portugalete,expenses,cash,-100.0,-37483.62
buyer_2,Carmen,40,ES59209517581497961835,TRX_N-00566-55065210,2023-04-18T10:31:04,Zarautz,expenses,transport,-71.0,-37554.62
buyer_2,Carmen,40,ES59209517581497961835,TRX_N-00567-03367784,2023-04-19T18:31:42,Zarautz,expenses,cash,-100.0,-37654.62
buyer_2,Carmen,40,ES59209517581497961835,TRX_N-00568-21514619,2023-04-20T08:30:20,Amurrio,expenses,food,-109.35,-37763.97
buyer_2,Carmen,40,ES59209517581497961835,TRX_N-00569-01293459,2023-04-20T14:02:34,Erandio,expenses,transport,-53.69,-37817.66
buyer_2,Carmen,40,ES59209517581497961835,TRX_N-00570-43756709,2023-04-21T17:20:02,Zarautz,expenses,leisure,-32.14,-37849.8
buyer_2,Carmen,40,ES59209517581497961835,TRX_N-00571-49624347,2023-04-21T11:12:50,Zarautz,expenses,education,-73.97,-37923.77
buyer_2,Carmen,40,ES59209517581497961835,TRX_N-00572-35366382,2023-04-22T08:05:34,Zarautz,expenses,transport,-61.53,-37985.3
buyer_2,Carmen,40,ES59209517581497961835,TRX_N-00573-25910203,2023-04-25T23:40:38,Zarautz,expenses,cash,-100.0,-38085.3
buyer_2,Carmen,40,ES59209517581497961835,TRX_N-00574-48349161,2023-04-28T07:38:07,Zarautz,expenses,transport,-65.08,-38150.38
buyer_2,Carmen,40,ES59209517581497961835,TRX_N-00575-95039887,2023-04-30T15:50:21,Zarautz,expenses,clothing,-131.2,-38281.58
buyer_2,Carmen,40,ES59209517581497961835,TRX_N-00576-65393756,2023-05-01T11:34:30,Zarautz,incomes,salary,1308.64,-36972.94
buyer_2,Carmen,40,ES59209517581497961835,TRX_N-00577-81133128,2023-05-01T11:34:30,Zarautz,incomes,salary_partner,1057.22,-35915.72
buyer_2,Carmen,40,ES59209517581497961835,TRX_N-00578-73175672,2023-05-01T11:34:30,Zarautz,incomes,extra_income,152.67,-35763.05
buyer_2,Carmen,40,ES59209517581497961835,TRX_N-00579-22623229,2023-05-01T16:04:40,Iruña de Oca,expenses,food,-97.06,-35860.11
buyer_2,Carmen,40,ES59209517581497961835,TRX_N-00580-83639005,2023-05-01T20:52:02,Zarautz,expenses,leisure,-80.06,-35940.17
buyer_2,Carmen,40,ES59209517581497961835,TRX_N-00581-85741246,2023-05-02T15:12:54,Zarautz,expenses,repairs,-222.86,-36163.03
buyer_2,Carmen,40,ES59209517581497961835,TRX_N-00582-13468175,2023-05-02T22:12:52,Zarautz,expenses,children,-91.33,-36254.36
buyer_2,Carmen,40,ES59209517581497961835,TRX_N-00583-25927531,2023-05-03T13:02:26,Zarautz,expenses,food,-69.41,-36323.77
buyer_2,Carmen,40,ES59209517581497961835,TRX_N-00584-00719671,2023-05-03T15:31:01,Donostia,expenses,transport,-87.79,-36411.56
buyer_2,Carmen,40,ES59209517581497961835,TRX_N-00585-71777159,2023-05-04T14:38:29,Zarautz,expenses,mortgage,-1091.91,-37503.47
buyer_2,Carmen,40,ES59209517581497961835,TRX_N-00586-79904188,2023-05-05T16:16:08,Zarautz,expenses,water,-42.44,-37545.91
buyer_2,Carmen,40,ES59209517581497961835,TRX_N-00587-19770133,2023-05-05T12:39:22,Zarautz,expenses,electricity,-58.32,-37604.23
buyer_2,Carmen,40,ES59209517581497961835,TRX_N-00588-80425772,2023-05-05T12:19:06,Zarautz,expenses,phone,-43.7,-37647.93
buyer_2,Carmen,40,ES59209517581497961835,TRX_N-00589-02454850,2023-05-07T18:40:28,Zarautz,expenses,food,-86.24,-37734.17
buyer_2,Carmen,40,ES59209517581497961835,TRX_N-00590-48039676,2023-05-08T23:06:34,Zarautz,expenses,gas,-75.1,-37809.27
buyer_2,Carmen,40,ES59209517581497961835,TRX_N-00591-01724305,2023-05-08T20:13:19,Zarautz,expenses,internet,-42.0,-37851.27
buyer_2,Carmen,40,ES59209517581497961835,TRX_N-00592-51112172,2023-05-08T16:51:29,Zarautz,expenses,repairs,-160.13,-38011.4
buyer_2,Carmen,40,ES59209517581497961835,TRX_N-00593-99703687,2023-05-10T09:34:10,Zarautz,expenses,repairs,-194.84,-38206.24
buyer_2,Carmen,40,ES59209517581497961835,TRX_N-00594-03023266,2023-05-10T23:12:55,Zarautz,expenses,gifts,-558.25,-38764.49
buyer_2,Carmen,40,ES59209517581497961835,TRX_N-00595-80515587,2023-05-14T22:28:41,Hondarribia,expenses,transport,-89.6,-38854.09
buyer_2,Carmen,40,ES59209517581497961835,TRX_N-00596-87960732,2023-05-14T11:21:08,Zarautz,expenses,leisure,-68.08,-38922.17
buyer_2,Carmen,40,ES59209517581497961835,TRX_N-00597-06153418,2023-05-15T10:45:44,Zarautz,expenses,cash,-100.0,-39022.17
buyer_2,Carmen,40,ES59209517581497961835,TRX_N-00598-76232358,2023-05-17T17:57:24,Zarautz,expenses,repairs,-254.05,-39276.22
buyer_2,Carmen,40,ES59209517581497961835,TRX_N-00599-47002910,2023-05-21T09:00:09,Zarautz,expenses,education,-68.53,-39344.75
buyer_2,Carmen,40,ES59209517581497961835,TRX_N-00600-51099841,2023-05-21T09:47:53,Zarautz,expenses,cash,-100.0,-39444.75
buyer_2,Carmen,40,ES59209517581497961835,TRX_N-00601-59178624,2023-05-22T20:15:53,Zarautz,expenses,cash,-100.0,-39544.75
buyer_2,Carmen,40,ES59209517581497961835,TRX_N-00602-56120657,2023-05-24T13:55:25,Zarautz,expenses,leisure,-37.14,-39581.89
buyer_2,Carmen,40,ES59209517581497961835,TRX_N-00603-16891804,2023-05-25T11:51:24,Zarautz,expenses,leisure,-83.95,-39665.84
buyer_2,Carmen,40,ES59209517581497961835,TRX_N-00604-38197008,2023-05-25T11:46:16,Zarautz,expenses,children,-122.15,-39787.99
buyer_2,Carmen,40,ES59209517581497961835,TRX_N-00605-62895987,2023-05-27T03:51:58,Zarautz,expenses,cash,-100.0,-39887.99
buyer_2,Carmen,40,ES59209517581497961835,TRX_N-00606-53137748,2023-05-27T16:49:37,Zarautz,expenses,repairs,-186.4,-40074.39
buyer_2,Carmen,40,ES59209517581497961835,TRX_N-00607-02563653,2023-05-28T18:30:59,Zarautz,expenses,leisure,-80.09,-40154.48
buyer_2,Carmen,40,ES59209517581497961835,TRX_N-00608-03269743,2023-05-31T17:12:32,Zarautz,expenses,children,-182.59,-40337.07
buyer_2,Carmen,40,ES59209517581497961835,TRX_N-00609-62591626,2023-06-01T20:26:05,Zarautz,incomes,salary,1308.64,-39028.43
buyer_2,Carmen,40,ES59209517581497961835,TRX_N-00610-59287183,2023-06-01T20:26:05,Zarautz,incomes,salary_partner,1057.22,-37971.21
buyer_2,Carmen,40,ES59209517581497961835,TRX_N-00611-30530861,2023-06-01T20:26:05,Zarautz,incomes,salary_bonus,974.95,-36996.26
buyer_2,Carmen,40,ES59209517581497961835,TRX_N-00612-87104934,2023-06-01T20:26:05,Zarautz,incomes,salary_partner_bonus,792.95,-36203.31
buyer_2,Carmen,40,ES59209517581497961835,TRX_N-00613-91235425,2023-06-03T13:17:46,Zarautz,expenses,repairs,-56.67,-36259.98
buyer_2,Carmen,40,ES59209517581497961835,TRX_N-00614-40900317,2023-06-04T14:27:33,Zarautz,expenses,mortgage,-1091.91,-37351.89
buyer_2,Carmen,40,ES59209517581497961835,TRX_N-00615-77866790,2023-06-04T22:24:21,Iruña de Oca,expenses,travel,-1725.79,-39077.68
buyer_2,Carmen,40,ES59209517581497961835,TRX_N-00616-36051683,2023-06-05T13:11:00,Zarautz,expenses,electricity,-29.48,-39107.16
buyer_2,Carmen,40,ES59209517581497961835,TRX_N-00617-82671994,2023-06-05T20:07:07,Zarautz,expenses,gas,-64.18,-39171.34
buyer_2,Carmen,40,ES59209517581497961835,TRX_N-00618-03287110,2023-06-05T08:47:19,Zarautz,expenses,internet,-42.0,-39213.34
buyer_2,Carmen,40,ES59209517581497961835,TRX_N-00619-53509464,2023-06-06T08:10:06,Zarautz,expenses,phone,-43.57,-39256.91
buyer_2,Carmen,40,ES59209517581497961835,TRX_N-00620-43237678,2023-06-06T10:06:05,Zarautz,expenses,leisure,-31.81,-39288.72
buyer_2,Carmen,40,ES59209517581497961835,TRX_N-00621-65687559,2023-06-07T17:40:04,Zarautz,expenses,water,-21.7,-39310.42
buyer_2,Carmen,40,ES59209517581497961835,TRX_N-00622-76430323,2023-06-08T02:49:08,Zarautz,expenses,leisure,-52.72,-39363.14
buyer_2,Carmen,40,ES59209517581497961835,TRX_N-00623-34469556,2023-06-08T11:49:40,Andoain,expenses,gifts,-137.82,-39500.96
buyer_2,Carmen,40,ES59209517581497961835,TRX_N-00624-96942331,2023-06-11T19:17:35,Zarautz,expenses,leisure,-24.65,-39525.61
buyer_2,Carmen,40,ES59209517581497961835,TRX_N-00625-64765598,2023-06-13T20:14:02,Amurrio,expenses,transport,-71.02,-39596.63
buyer_2,Carmen,40,ES59209517581497961835,TRX_N-00626-92939676,2023-06-13T14:18:27,Zarautz,expenses,leisure,-53.08,-39649.71
buyer_2,Carmen,40,ES59209517581497961835,TRX_N-00627-49614367,2023-06-13T19:16:46,Zuia,expenses,gifts,-74.26,-39723.97
buyer_2,Carmen,40,ES59209517581497961835,TRX_N-00628-14531281,2023-06-14T12:17:17,Zarautz,expenses,education,-45.63,-39769.6
buyer_2,Carmen,40,ES59209517581497961835,TRX_N-00629-17689222,2023-06-14T09:08:36,Zarautz,expenses,children,-188.66,-39958.26
buyer_2,Carmen,40,ES59209517581497961835,TRX_N-00630-17414008,2023-06-18T15:11:24,Zarautz,expenses,food,-100.32,-40058.58
buyer_2,Carmen,40,ES59209517581497961835,TRX_N-00631-90994350,2023-06-19T10:29:21,Zarautz,expenses,food,-61.83,-40120.41
buyer_2,Carmen,40,ES59209517581497961835,TRX_N-00632-69958154,2023-06-19T15:08:53,Zarautz,expenses,leisure,-29.85,-40150.26
buyer_2,Carmen,40,ES59209517581497961835,TRX_N-00633-27584611,2023-06-20T08:23:34,Zarautz,expenses,repairs,-260.32,-40410.58
buyer_2,Carmen,40,ES59209517581497961835,TRX_N-00634-54104451,2023-06-22T08:38:36,Zarautz,expenses,food,-61.06,-40471.64
buyer_2,Carmen,40,ES59209517581497961835,TRX_N-00635-97330633,2023-06-22T15:11:24,Zarautz,expenses,healthcare,-86.88,-40558.52
buyer_2,Carmen,40,ES59209517581497961835,TRX_N-00636-61837852,2023-06-23T20:15:26,Zarautz,expenses,clothing,-87.88,-40646.4
buyer_2,Carmen,40,ES59209517581497961835,TRX_N-00637-79908779,2023-06-23T16:12:17,Zarautz,expenses,healthcare,-146.8,-40793.2
buyer_2,Carmen,40,ES59209517581497961835,TRX_N-00638-12831069,2023-06-23T18:39:09,Zarautz,expenses,cash,-100.0,-40893.2
buyer_2,Carmen,40,ES59209517581497961835,TRX_N-00639-87133684,2023-06-25T18:00:43,Zarautz,expenses,cash,-100.0,-40993.2
buyer_2,Carmen,40,ES59209517581497961835,TRX_N-00640-83620339,2023-06-29T16:16:58,Zarautz,expenses,travel,-421.24,-41414.44
buyer_2,Carmen,40,ES59209517581497961835,TRX_N-00641-83813680,2023-07-01T20:47:40,Zarautz,incomes,salary,1308.64,-40105.8
buyer_2,Carmen,40,ES59209517581497961835,TRX_N-00642-39303495,2023-07-01T20:47:40,Zarautz,incomes,salary_partner,1057.22,-39048.58
buyer_2,Carmen,40,ES59209517581497961835,TRX_N-00643-67596792,2023-07-01T18:25:44,Leioa,expenses,food,-118.86,-39167.44
buyer_2,Carmen,40,ES59209517581497961835,TRX_N-00644-85172155,2023-07-02T20:16:36,Zarautz,expenses,leisure,-43.16,-39210.6
buyer_2,Carmen,40,ES59209517581497961835,TRX_N-00645-46868602,2023-07-04T18:17:10,Zarautz,expenses,mortgage,-1091.91,-40302.51
buyer_2,Carmen,40,ES59209517581497961835,TRX_N-00646-34695747,2023-07-05T10:41:26,Zarautz,expenses,water,-31.32,-40333.83
buyer_2,Carmen,40,ES59209517581497961835,TRX_N-00647-60634702,2023-07-05T13:09:58,Zarautz,expenses,electricity,-72.64,-40406.47
buyer_2,Carmen,40,ES59209517581497961835,TRX_N-00648-78254761,2023-07-06T14:59:59,Zarautz,expenses,gas,-101.86,-40508.33
buyer_2,Carmen,40,ES59209517581497961835,TRX_N-00649-36332808,2023-07-06T11:48:17,Zarautz,expenses,internet,-42.0,-40550.33
buyer_2,Carmen,40,ES59209517581497961835,TRX_N-00650-78224515,2023-07-07T16:40:32,Zarautz,expenses,phone,-37.36,-40587.69
buyer_2,Carmen,40,ES59209517581497961835,TRX_N-00651-39535094,2023-07-08T14:59:39,Hernani,expenses,leisure,-44.23,-40631.92
buyer_2,Carmen,40,ES59209517581497961835,TRX_N-00652-48494665,2023-07-08T20:41:58,Zarautz,expenses,cash,-100.0,-40731.92
buyer_2,Carmen,40,ES59209517581497961835,TRX_N-00653-05022807,2023-07-09T16:42:32,Zarautz,expenses,education,-72.22,-40804.14
buyer_2,Carmen,40,ES59209517581497961835,TRX_N-00654-68984463,2023-07-09T13:52:49,Zarautz,expenses,appliances,-334.9,-41139.04
buyer_2,Carmen,40,ES59209517581497961835,TRX_N-00655-46601281,2023-07-11T19:15:04,Donostia,expenses,cash,-100.0,-41239.04
buyer_2,Carmen,40,ES59209517581497961835,TRX_N-00656-11958819,2023-07-12T20:29:43,Zarautz,expenses,leisure,-68.64,-41307.68
buyer_2,Carmen,40,ES59209517581497961835,TRX_N-00657-17730749,2023-07-14T19:06:30,Zarautz,expenses,cash,-100.0,-41407.68
buyer_2,Carmen,40,ES59209517581497961835,TRX_N-00658-45498564,2023-07-15T20:54:55,Zarautz,expenses,leisure,-35.7,-41443.38
buyer_2,Carmen,40,ES59209517581497961835,TRX_N-00659-12961697,2023-07-17T10:40:24,Zarautz,expenses,cash,-100.0,-41543.38
buyer_2,Carmen,40,ES59209517581497961835,TRX_N-00660-17112960,2023-07-18T12:38:50,Zarautz,expenses,repairs,-313.55,-41856.93
buyer_2,Carmen,40,ES59209517581497961835,TRX_N-00661-98054455,2023-07-19T20:27:22,Santurtzi,expenses,education,-54.95,-41911.88
buyer_2,Carmen,40,ES59209517581497961835,TRX_N-00662-46638496,2023-07-19T07:10:11,Zarautz,expenses,repairs,-257.8,-42169.68
buyer_2,Carmen,40,ES59209517581497961835,TRX_N-00663-67083423,2023-07-19T16:34:11,Arrasate,expenses,gifts,-199.15,-42368.83
buyer_2,Carmen,40,ES59209517581497961835,TRX_N-00664-79307066,2023-07-21T18:44:05,Zarautz,expenses,repairs,-317.33,-42686.16
buyer_2,Carmen,40,ES59209517581497961835,TRX_N-00665-84260526,2023-07-21T20:57:28,Zarautz,expenses,gifts,-365.69,-43051.85
buyer_2,Carmen,40,ES59209517581497961835,TRX_N-00666-79195069,2023-07-24T20:17:44,Pasaia,expenses,cash,-100.0,-43151.85
buyer_2,Carmen,40,ES59209517581497961835,TRX_N-00667-14034364,2023-07-24T19:24:57,Labastida,expenses,appliances,-305.52,-43457.37
buyer_2,Carmen,40,ES59209517581497961835,TRX_N-00668-33274743,2023-07-25T14:50:18,Durango,expenses,education,-47.8,-43505.17
buyer_2,Carmen,40,ES59209517581497961835,TRX_N-00669-35168739,2023-07-26T19:08:51,Zarautz,expenses,clothing,-130.07,-43635.24
buyer_2,Carmen,40,ES59209517581497961835,TRX_N-00670-12738463,2023-07-27T16:34:43,Zarautz,expenses,children,-95.33,-43730.57
buyer_2,Carmen,40,ES59209517581497961835,TRX_N-00671-17941871,2023-07-30T13:31:14,Sopela,expenses,cash,-100.0,-43830.57
buyer_2,Carmen,40,ES59209517581497961835,TRX_N-00672-75001270,2023-07-31T19:57:35,Amurrio,expenses,cash,-100.0,-43930.57
buyer_2,Carmen,40,ES59209517581497961835,TRX_N-00673-42058325,2023-08-01T17:33:05,Zarautz,incomes,salary,1308.64,-42621.93
buyer_2,Carmen,40,ES59209517581497961835,TRX_N-00674-93322456,2023-08-01T17:33:05,Zarautz,incomes,salary_partner,1057.22,-41564.71
buyer_2,Carmen,40,ES59209517581497961835,TRX_N-00675-21204335,2023-08-02T12:49:26,Zarautz,expenses,clothing,-137.34,-41702.05
buyer_2,Carmen,40,ES59209517581497961835,TRX_N-00676-71352040,2023-08-02T12:31:41,Zarautz,expenses,appliances,-176.95,-41879.0
buyer_2,Carmen,40,ES59209517581497961835,TRX_N-00677-39875416,2023-08-03T12:26:06,Zarautz,expenses,food,-65.59,-41944.59
buyer_2,Carmen,40,ES59209517581497961835,TRX_N-00678-17933160,2023-08-04T12:57:50,Zarautz,expenses,mortgage,-1091.91,-43036.5
buyer_2,Carmen,40,ES59209517581497961835,TRX_N-00679-21025762,2023-08-05T15:28:44,Zarautz,expenses,water,-30.06,-43066.56
buyer_2,Carmen,40,ES59209517581497961835,TRX_N-00680-48599546,2023-08-05T06:26:40,Zarautz,expenses,electricity,-75.06,-43141.62
buyer_2,Carmen,40,ES59209517581497961835,TRX_N-00681-42364177,2023-08-05T13:53:48,Bilbao,expenses,appliances,-395.5,-43537.12
buyer_2,Carmen,40,ES59209517581497961835,TRX_N-00682-44652296,2023-08-06T19:32:58,Zarautz,expenses,gas,-112.4,-43649.52
buyer_2,Carmen,40,ES59209517581497961835,TRX_N-00683-51274104,2023-08-06T15:35:49,Zarautz,expenses,internet,-42.0,-43691.52
buyer_2,Carmen,40,ES59209517581497961835,TRX_N-00684-01874116,2023-08-06T17:11:06,Zarautz,expenses,phone,-43.08,-43734.6
buyer_2,Carmen,40,ES59209517581497961835,TRX_N-00685-05133026,2023-08-06T10:19:24,Zarautz,expenses,appliances,-187.4,-43922.0
buyer_2,Carmen,40,ES59209517581497961835,TRX_N-00686-50380132,2023-08-07T11:11:37,Zarautz,expenses,appliances,-405.32,-44327.32
buyer_2,Carmen,40,ES59209517581497961835,TRX_N-00687-91360255,2023-08-08T04:43:43,Zarautz,expenses,clothing,-105.25,-44432.57
buyer_2,Carmen,40,ES59209517581497961835,TRX_N-00688-64241652,2023-08-09T18:32:09,Zarautz,expenses,leisure,-44.65,-44477.22
buyer_2,Carmen,40,ES59209517581497961835,TRX_N-00689-31087766,2023-08-10T14:12:35,Berango,expenses,food,-103.25,-44580.47
buyer_2,Carmen,40,ES59209517581497961835,TRX_N-00690-06967642,2023-08-10T17:40:17,Zarautz,expenses,transport,-71.25,-44651.72
buyer_2,Carmen,40,ES59209517581497961835,TRX_N-00691-79801202,2023-08-12T11:12:41,Zarautz,expenses,gifts,-722.24,-45373.96
buyer_2,Carmen,40,ES59209517581497961835,TRX_N-00692-31259909,2023-08-14T13:19:07,Zuia,expenses,cash,-100.0,-45473.96
buyer_2,Carmen,40,ES59209517581497961835,TRX_N-00693-84112795,2023-08-19T19:43:02,Zarautz,expenses,food,-112.69,-45586.65
buyer_2,Carmen,40,ES59209517581497961835,TRX_N-00694-35493529,2023-08-19T20:29:10,Zarautz,expenses,education,-73.61,-45660.26
buyer_2,Carmen,40,ES59209517581497961835,TRX_N-00695-70479492,2023-08-19T18:28:30,Zarautz,expenses,cash,-100.0,-45760.26
buyer_2,Carmen,40,ES59209517581497961835,TRX_N-00696-83865792,2023-08-20T08:26:14,Santurtzi,expenses,appliances,-221.82,-45982.08
buyer_2,Carmen,40,ES59209517581497961835,TRX_N-00697-31804784,2023-08-24T10:01:14,Zarautz,expenses,leisure,-41.44,-46023.52
buyer_2,Carmen,40,ES59209517581497961835,TRX_N-00698-56754068,2023-08-24T18:28:41,Zarautz,expenses,cash,-100.0,-46123.52
buyer_2,Carmen,40,ES59209517581497961835,TRX_N-00699-31504347,2023-08-25T03:00:42,Zarautz,expenses,leisure,-41.43,-46164.95
buyer_2,Carmen,40,ES59209517581497961835,TRX_N-00700-97835086,2023-08-25T10:03:39,Zarautz,expenses,appliances,-244.4,-46409.35
buyer_2,Carmen,40,ES59209517581497961835,TRX_N-00701-53405141,2023-08-26T08:59:37,Zarautz,expenses,leisure,-84.59,-46493.94
buyer_2,Carmen,40,ES59209517581497961835,TRX_N-00702-29695124,2023-08-28T14:38:21,Zarautz,expenses,transport,-86.76,-46580.7
buyer_2,Carmen,40,ES59209517581497961835,TRX_N-00703-37159567,2023-08-28T03:14:27,Zarautz,expenses,clothing,-90.92,-46671.62
buyer_2,Carmen,40,ES59209517581497961835,TRX_N-00704-05809130,2023-08-28T09:18:48,Zarautz,expenses,repairs,-73.81,-46745.43
buyer_2,Carmen,40,ES59209517581497961835,TRX_N-00705-76171346,2023-08-29T17:24:50,Zarautz,expenses,repairs,-212.06,-46957.49
buyer_2,Carmen,40,ES59209517581497961835,TRX_N-00706-20700361,2023-09-01T09:04:06,Zarautz,incomes,salary,1308.64,-45648.85
buyer_2,Carmen,40,ES59209517581497961835,TRX_N-00707-55546867,2023-09-01T09:04:06,Zarautz,incomes,salary_partner,1057.22,-44591.63
buyer_2,Carmen,40,ES59209517581497961835,TRX_N-00708-26875726,2023-09-01T09:04:06,Zarautz,incomes,extra_income,152.67,-44438.96
buyer_2,Carmen,40,ES59209517581497961835,TRX_N-00709-99601362,2023-09-03T22:53:38,Zarautz,expenses,education,-74.14,-44513.1
buyer_2,Carmen,40,ES59209517581497961835,TRX_N-00710-35166989,2023-09-04T10:29:24,Zarautz,expenses,mortgage,-1091.91,-45605.01
buyer_2,Carmen,40,ES59209517581497961835,TRX_N-00711-83734978,2023-09-05T15:37:09,Zarautz,expenses,education,-64.84,-45669.85
buyer_2,Carmen,40,ES59209517581497961835,TRX_N-00712-50499508,2023-09-06T17:27:05,Zarautz,expenses,food,-103.43,-45773.28
buyer_2,Carmen,40,ES59209517581497961835,TRX_N-00713-51037205,2023-09-06T19:20:05,Zarautz,expenses,cash,-100.0,-45873.28
buyer_2,Carmen,40,ES59209517581497961835,TRX_N-00714-23492097,2023-09-07T09:23:26,Zarautz,expenses,water,-28.09,-45901.37
buyer_2,Carmen,40,ES59209517581497961835,TRX_N-00715-42440671,2023-09-07T19:53:47,Salvatierra/Agurain,expenses,repairs,-164.64,-46066.01
buyer_2,Carmen,40,ES59209517581497961835,TRX_N-00716-68009509,2023-09-08T19:40:08,Zarautz,expenses,phone,-41.83,-46107.84
buyer_2,Carmen,40,ES59209517581497961835,TRX_N-00717-62526602,2023-09-08T20:35:47,Zarautz,expenses,electricity,-23.46,-46131.3
buyer_2,Carmen,40,ES59209517581497961835,TRX_N-00718-97515297,2023-09-08T08:58:32,Zarautz,expenses,gas,-84.85,-46216.15
buyer_2,Carmen,40,ES59209517581497961835,TRX_N-00719-37859758,2023-09-08T12:47:44,Zarautz,expenses,internet,-42.0,-46258.15
buyer_2,Carmen,40,ES59209517581497961835,TRX_N-00720-25521038,2023-09-08T13:52:36,Zarautz,expenses,gifts,-260.89,-46519.04
buyer_2,Carmen,40,ES59209517581497961835,TRX_N-00721-41049332,2023-09-11T20:04:21,Zarautz,expenses,transport,-57.64,-46576.68
buyer_2,Carmen,40,ES59209517581497961835,TRX_N-00722-81976885,2023-09-11T13:27:14,Zarautz,expenses,leisure,-61.62,-46638.3
buyer_2,Carmen,40,ES59209517581497961835,TRX_N-00723-10971482,2023-09-13T04:41:05,Zarautz,expenses,cash,-100.0,-46738.3
buyer_2,Carmen,40,ES59209517581497961835,TRX_N-00724-70211185,2023-09-16T11:11:29,Sopela,expenses,food,-111.95,-46850.25
buyer_2,Carmen,40,ES59209517581497961835,TRX_N-00725-86186752,2023-09-18T05:55:38,Zarautz,expenses,leisure,-73.14,-46923.39
buyer_2,Carmen,40,ES59209517581497961835,TRX_N-00726-82970896,2023-09-18T11:09:18,Zarautz,expenses,clothing,-82.75,-47006.14
buyer_2,Carmen,40,ES59209517581497961835,TRX_N-00727-35182405,2023-09-20T08:26:16,Zarautz,expenses,leisure,-77.11,-47083.25
buyer_2,Carmen,40,ES59209517581497961835,TRX_N-00728-95592112,2023-09-22T18:01:52,Zarautz,expenses,food,-76.46,-47159.71
buyer_2,Carmen,40,ES59209517581497961835,TRX_N-00729-83534419,2023-09-23T12:32:19,Zarautz,expenses,food,-99.51,-47259.22
buyer_2,Carmen,40,ES59209517581497961835,TRX_N-00730-57828643,2023-09-24T08:41:37,Zarautz,expenses,leisure,-30.95,-47290.17
buyer_2,Carmen,40,ES59209517581497961835,TRX_N-00731-02736834,2023-09-27T16:32:27,Alegría-Dulantzi,expenses,healthcare,-143.37,-47433.54
buyer_2,Carmen,40,ES59209517581497961835,TRX_N-00732-59694140,2023-09-30T18:27:49,Zarautz,expenses,leisure,-76.21,-47509.75
buyer_2,Carmen,40,ES59209517581497961835,TRX_N-00733-13672533,2023-10-01T13:09:20,Zarautz,incomes,salary,1308.64,-46201.11
buyer_2,Carmen,40,ES59209517581497961835,TRX_N-00734-30464252,2023-10-01T13:09:20,Zarautz,incomes,salary_partner,1057.22,-45143.89
buyer_2,Carmen,40,ES59209517581497961835,TRX_N-00735-14164794,2023-10-02T15:20:19,Zarautz,expenses,leisure,-42.2,-45186.09
buyer_2,Carmen,40,ES59209517581497961835,TRX_N-00736-78950534,2023-10-02T22:36:21,Zarautz,expenses,children,-190.38,-45376.47
buyer_2,Carmen,40,ES59209517581497961835,TRX_N-00737-18284754,2023-10-03T18:03:31,Santurtzi,expenses,leisure,-80.81,-45457.28
buyer_2,Carmen,40,ES59209517581497961835,TRX_N-00738-71290535,2023-10-03T17:20:14,Zarautz,expenses,cash,-100.0,-45557.28
buyer_2,Carmen,40,ES59209517581497961835,TRX_N-00739-70411731,2023-10-04T15:26:31,Zarautz,expenses,mortgage,-1091.91,-46649.19
buyer_2,Carmen,40,ES59209517581497961835,TRX_N-00740-63133623,2023-10-04T14:11:46,Basauri,expenses,leisure,-59.77,-46708.96
buyer_2,Carmen,40,ES59209517581497961835,TRX_N-00741-08866406,2023-10-04T10:32:10,Zarautz,expenses,clothing,-81.17,-46790.13
buyer_2,Carmen,40,ES59209517581497961835,TRX_N-00742-82362380,2023-10-04T17:49:53,Zarautz,expenses,cash,-100.0,-46890.13
buyer_2,Carmen,40,ES59209517581497961835,TRX_N-00743-66544642,2023-10-05T10:07:21,Zarautz,expenses,transport,-69.89,-46960.02
buyer_2,Carmen,40,ES59209517581497961835,TRX_N-00744-16325508,2023-10-05T20:56:40,Zarautz,expenses,clothing,-126.82,-47086.84
buyer_2,Carmen,40,ES59209517581497961835,TRX_N-00745-56116192,2023-10-06T21:49:00,Zarautz,expenses,electricity,-60.74,-47147.58
buyer_2,Carmen,40,ES59209517581497961835,TRX_N-00746-24579106,2023-10-06T09:32:59,Zarautz,expenses,internet,-42.0,-47189.58
buyer_2,Carmen,40,ES59209517581497961835,TRX_N-00747-63851745,2023-10-07T18:20:27,Iruña de Oca,expenses,cash,-100.0,-47289.58
buyer_2,Carmen,40,ES59209517581497961835,TRX_N-00748-64155235,2023-10-08T07:35:24,Zarautz,expenses,water,-32.12,-47321.7
buyer_2,Carmen,40,ES59209517581497961835,TRX_N-00749-96136899,2023-10-08T15:32:23,Zarautz,expenses,gas,-47.37,-47369.07
buyer_2,Carmen,40,ES59209517581497961835,TRX_N-00750-00769712,2023-10-08T13:21:19,Zarautz,expenses,phone,-30.05,-47399.12
buyer_2,Carmen,40,ES59209517581497961835,TRX_N-00751-35742320,2023-10-09T14:30:00,Zarautz,expenses,education,-51.53,-47450.65
buyer_2,Carmen,40,ES59209517581497961835,TRX_N-00752-28203330,2023-10-10T09:55:42,Zarautz,expenses,food,-85.0,-47535.65
buyer_2,Carmen,40,ES59209517581497961835,TRX_N-00753-61441019,2023-10-11T17:59:00,Zarautz,expenses,food,-105.34,-47640.99
buyer_2,Carmen,40,ES59209517581497961835,TRX_N-00754-40936009,2023-10-11T18:28:12,Zarautz,expenses,education,-74.77,-47715.76
buyer_2,Carmen,40,ES59209517581497961835,TRX_N-00755-33732268,2023-10-11T16:09:01,Zarautz,expenses,cash,-100.0,-47815.76
buyer_2,Carmen,40,ES59209517581497961835,TRX_N-00756-29051749,2023-10-14T08:07:52,Zarautz,expenses,cash,-100.0,-47915.76
buyer_2,Carmen,40,ES59209517581497961835,TRX_N-00757-08399538,2023-10-16T23:54:41,Hondarribia,expenses,leisure,-27.65,-47943.41
buyer_2,Carmen,40,ES59209517581497961835,TRX_N-00758-41380307,2023-10-16T19:23:26,Getxo,expenses,gifts,-55.55,-47998.96
buyer_2,Carmen,40,ES59209517581497961835,TRX_N-00759-65701788,2023-10-19T16:39:51,Zarautz,expenses,food,-124.02,-48122.98
buyer_2,Carmen,40,ES59209517581497961835,TRX_N-00760-36138277,2023-10-22T12:39:27,Zarautz,expenses,cash,-100.0,-48222.98
buyer_2,Carmen,40,ES59209517581497961835,TRX_N-00761-65715214,2023-10-22T20:51:21,Zarautz,expenses,repairs,-52.37,-48275.35
buyer_2,Carmen,40,ES59209517581497961835,TRX_N-00762-22281596,2023-10-23T17:14:40,Zarautz,expenses,cash,-100.0,-48375.35
buyer_2,Carmen,40,ES59209517581497961835,TRX_N-00763-20253805,2023-10-23T19:34:56,Andoain,expenses,gifts,-666.03,-49041.38
buyer_2,Carmen,40,ES59209517581497961835,TRX_N-00764-16080341,2023-10-25T15:35:31,Zarautz,expenses,cash,-100.0,-49141.38
buyer_2,Carmen,40,ES59209517581497961835,TRX_N-00765-57263345,2023-10-26T08:04:51,Zarautz,expenses,transport,-65.43,-49206.81
buyer_2,Carmen,40,ES59209517581497961835,TRX_N-00766-03798979,2023-10-28T16:15:33,Zarautz,expenses,healthcare,-43.49,-49250.3
buyer_2,Carmen,40,ES59209517581497961835,TRX_N-00767-55692768,2023-10-28T23:40:23,Zarautz,expenses,appliances,-113.49,-49363.79
buyer_2,Carmen,40,ES59209517581497961835,TRX_N-00768-32951891,2023-10-30T13:02:08,Zarautz,expenses,education,-51.71,-49415.5
buyer_2,Carmen,40,ES59209517581497961835,TRX_N-00769-22016117,2023-10-31T09:24:38,Santurtzi,expenses,cash,-100.0,-49515.5
buyer_2,Carmen,40,ES59209517581497961835,TRX_N-00770-48271052,2023-10-31T04:49:00,Zarautz,expenses,children,-170.76,-49686.26
buyer_2,Carmen,40,ES59209517581497961835,TRX_N-00771-70731709,2023-11-01T00:11:23,Zarautz,incomes,salary,1308.64,-48377.62
buyer_2,Carmen,40,ES59209517581497961835,TRX_N-00772-81345782,2023-11-01T00:11:23,Zarautz,incomes,salary_partner,1057.22,-47320.4
buyer_2,Carmen,40,ES59209517581497961835,TRX_N-00773-65705125,2023-11-01T09:23:25,Zarautz,expenses,food,-73.35,-47393.75
buyer_2,Carmen,40,ES59209517581497961835,TRX_N-00774-92559144,2023-11-01T13:04:04,Zarautz,expenses,transport,-52.26,-47446.01
buyer_2,Carmen,40,ES59209517581497961835,TRX_N-00775-18717592,2023-11-03T01:37:56,Zarautz,expenses,leisure,-84.04,-47530.05
buyer_2,Carmen,40,ES59209517581497961835,TRX_N-00776-89537423,2023-11-04T09:48:09,Zarautz,expenses,mortgage,-1091.91,-48621.96
buyer_2,Carmen,40,ES59209517581497961835,TRX_N-00777-39707496,2023-11-05T09:47:31,Zarautz,expenses,internet,-42.0,-48663.96
buyer_2,Carmen,40,ES59209517581497961835,TRX_N-00778-18641865,2023-11-07T07:35:21,Zarautz,expenses,gas,-73.18,-48737.14
buyer_2,Carmen,40,ES59209517581497961835,TRX_N-00779-62258127,2023-11-07T14:19:55,Zarautz,expenses,leisure,-27.52,-48764.66
buyer_2,Carmen,40,ES59209517581497961835,TRX_N-00780-18953587,2023-11-07T11:10:47,Zarautz,expenses,cash,-100.0,-48864.66
buyer_2,Carmen,40,ES59209517581497961835,TRX_N-00781-71197283,2023-11-08T12:06:44,Zarautz,expenses,electricity,-74.21,-48938.87
buyer_2,Carmen,40,ES59209517581497961835,TRX_N-00782-56889247,2023-11-08T19:06:01,Zarautz,expenses,water,-35.57,-48974.44
buyer_2,Carmen,40,ES59209517581497961835,TRX_N-00783-33066782,2023-11-08T16:37:55,Zarautz,expenses,phone,-44.34,-49018.78
buyer_2,Carmen,40,ES59209517581497961835,TRX_N-00784-56032237,2023-11-08T18:17:03,Zarautz,expenses,cash,-100.0,-49118.78
buyer_2,Carmen,40,ES59209517581497961835,TRX_N-00785-04491088,2023-11-10T05:58:10,Zarautz,expenses,cash,-100.0,-49218.78
buyer_2,Carmen,40,ES59209517581497961835,TRX_N-00786-45734347,2023-11-15T02:22:22,Zarautz,expenses,cash,-100.0,-49318.78
buyer_2,Carmen,40,ES59209517581497961835,TRX_N-00787-75214854,2023-11-15T11:38:17,Durango,expenses,appliances,-334.67,-49653.45
buyer_2,Carmen,40,ES59209517581497961835,TRX_N-00788-89765384,2023-11-19T20:50:25,Zarautz,expenses,transport,-68.17,-49721.62
buyer_2,Carmen,40,ES59209517581497961835,TRX_N-00789-71215700,2023-11-22T10:40:42,Zarautz,expenses,food,-120.34,-49841.96
buyer_2,Carmen,40,ES59209517581497961835,TRX_N-00790-47607290,2023-11-22T11:25:27,Zarautz,expenses,leisure,-44.53,-49886.49
buyer_2,Carmen,40,ES59209517581497961835,TRX_N-00791-75782994,2023-11-25T01:24:33,Zarautz,expenses,food,-73.22,-49959.71
buyer_2,Carmen,40,ES59209517581497961835,TRX_N-00792-76853643,2023-11-26T04:08:15,Zarautz,expenses,transport,-45.57,-50005.28
buyer_2,Carmen,40,ES59209517581497961835,TRX_N-00793-20836959,2023-11-27T20:04:54,Iruña de Oca,expenses,food,-65.44,-50070.72
buyer_2,Carmen,40,ES59209517581497961835,TRX_N-00794-30757722,2023-11-28T15:59:04,Eibar,expenses,leisure,-74.67,-50145.39
buyer_2,Carmen,40,ES59209517581497961835,TRX_N-00795-92190254,2023-11-28T21:41:49,Zarautz,expenses,cash,-100.0,-50245.39
buyer_2,Carmen,40,ES59209517581497961835,TRX_N-00796-28500537,2023-11-29T12:04:08,Zarautz,expenses,food,-107.36,-50352.75
buyer_2,Carmen,40,ES59209517581497961835,TRX_N-00797-79396203,2023-11-29T12:02:44,Zarautz,expenses,clothing,-136.48,-50489.23
buyer_2,Carmen,40,ES59209517581497961835,TRX_N-00798-74679520,2023-12-01T10:24:58,Zarautz,incomes,salary,1308.64,-49180.59
buyer_2,Carmen,40,ES59209517581497961835,TRX_N-00799-25064603,2023-12-01T10:24:58,Zarautz,incomes,salary_partner,1057.22,-48123.37
buyer_2,Carmen,40,ES59209517581497961835,TRX_N-00800-71241936,2023-12-01T10:24:58,Zarautz,incomes,extra_income,152.67,-47970.7
buyer_2,Carmen,40,ES59209517581497961835,TRX_N-00801-53091723,2023-12-01T10:24:58,Zarautz,incomes,salary_bonus,959.0,-47011.7
buyer_2,Carmen,40,ES59209517581497961835,TRX_N-00802-32146969,2023-12-01T10:24:58,Zarautz,incomes,salary_partner_bonus,834.67,-46177.03
buyer_2,Carmen,40,ES59209517581497961835,TRX_N-00803-82611741,2023-12-01T15:25:33,Zarautz,expenses,healthcare,-109.05,-46286.08
buyer_2,Carmen,40,ES59209517581497961835,TRX_N-00804-64495098,2023-12-01T13:58:28,Berango,expenses,cash,-100.0,-46386.08
buyer_2,Carmen,40,ES59209517581497961835,TRX_N-00805-17288129,2023-12-01T16:34:53,Zarautz,expenses,repairs,-75.99,-46462.07
buyer_2,Carmen,40,ES59209517581497961835,TRX_N-00806-06166503,2023-12-02T09:46:38,Mungia,expenses,clothing,-112.39,-46574.46
buyer_2,Carmen,40,ES59209517581497961835,TRX_N-00807-88512538,2023-12-03T11:49:35,Zarautz,expenses,transport,-82.38,-46656.84
buyer_2,Carmen,40,ES59209517581497961835,TRX_N-00808-11534660,2023-12-04T20:20:22,Zarautz,expenses,mortgage,-1091.91,-47748.75
buyer_2,Carmen,40,ES59209517581497961835,TRX_N-00809-87027444,2023-12-05T09:40:22,Zarautz,expenses,water,-26.44,-47775.19
buyer_2,Carmen,40,ES59209517581497961835,TRX_N-00810-17592593,2023-12-05T17:36:19,Zarautz,expenses,children,-159.35,-47934.54
buyer_2,Carmen,40,ES59209517581497961835,TRX_N-00811-46343340,2023-12-06T08:21:55,Zarautz,expenses,internet,-42.0,-47976.54
buyer_2,Carmen,40,ES59209517581497961835,TRX_N-00812-60817096,2023-12-06T19:44:45,Zarautz,expenses,repairs,-220.55,-48197.09
buyer_2,Carmen,40,ES59209517581497961835,TRX_N-00813-61398676,2023-12-07T22:23:22,Zarautz,expenses,transport,-49.07,-48246.16
buyer_2,Carmen,40,ES59209517581497961835,TRX_N-00814-74983384,2023-12-08T13:42:01,Zarautz,expenses,electricity,-20.26,-48266.42
buyer_2,Carmen,40,ES59209517581497961835,TRX_N-00815-38207128,2023-12-08T22:17:56,Zarautz,expenses,gas,-114.52,-48380.94
buyer_2,Carmen,40,ES59209517581497961835,TRX_N-00816-50270695,2023-12-08T19:01:57,Zarautz,expenses,phone,-41.43,-48422.37
buyer_2,Carmen,40,ES59209517581497961835,TRX_N-00817-08279498,2023-12-08T01:18:52,Zarautz,expenses,transport,-46.54,-48468.91
buyer_2,Carmen,40,ES59209517581497961835,TRX_N-00818-23721192,2023-12-10T17:40:02,Zarautz,expenses,leisure,-84.08,-48552.99
buyer_2,Carmen,40,ES59209517581497961835,TRX_N-00819-72784021,2023-12-11T11:42:03,Zarautz,expenses,leisure,-47.87,-48600.86
buyer_2,Carmen,40,ES59209517581497961835,TRX_N-00820-03739056,2023-12-12T11:01:50,Vitoria-Gasteiz,expenses,education,-55.34,-48656.2
buyer_2,Carmen,40,ES59209517581497961835,TRX_N-00821-21113891,2023-12-12T15:44:34,Irun,expenses,cash,-100.0,-48756.2
buyer_2,Carmen,40,ES59209517581497961835,TRX_N-00822-02280687,2023-12-13T19:35:52,Zarautz,expenses,food,-109.86,-48866.06
buyer_2,Carmen,40,ES59209517581497961835,TRX_N-00823-31242813,2023-12-14T15:39:44,Zarautz,expenses,transport,-64.34,-48930.4
buyer_2,Carmen,40,ES59209517581497961835,TRX_N-00824-87754253,2023-12-15T10:42:40,Llodio,expenses,leisure,-76.47,-49006.87
buyer_2,Carmen,40,ES59209517581497961835,TRX_N-00825-76221615,2023-12-15T19:31:24,Zarautz,expenses,children,-177.0,-49183.87
buyer_2,Carmen,40,ES59209517581497961835,TRX_N-00826-90824841,2023-12-17T18:00:56,Leioa,expenses,leisure,-63.07,-49246.94
buyer_2,Carmen,40,ES59209517581497961835,TRX_N-00827-67854042,2023-12-18T22:01:15,Zarautz,expenses,leisure,-57.71,-49304.65
buyer_2,Carmen,40,ES59209517581497961835,TRX_N-00828-22738768,2023-12-18T18:52:40,Santurtzi,expenses,appliances,-390.83,-49695.48
buyer_2,Carmen,40,ES59209517581497961835,TRX_N-00829-99298808,2023-12-23T17:41:20,Zarautz,expenses,clothing,-134.85,-49830.33
buyer_2,Carmen,40,ES59209517581497961835,TRX_N-00830-42318685,2023-12-23T19:33:05,Labastida,expenses,cash,-100.0,-49930.33
buyer_2,Carmen,40,ES59209517581497961835,TRX_N-00831-37321521,2023-12-24T20:51:24,Zarautz,expenses,transport,-56.8,-49987.13
buyer_2,Carmen,40,ES59209517581497961835,TRX_N-00832-97103172,2023-12-25T08:29:12,Zarautz,expenses,cash,-100.0,-50087.13
buyer_2,Carmen,40,ES59209517581497961835,TRX_N-00833-51371033,2023-12-27T14:54:27,Zarautz,expenses,food,-86.52,-50173.65
buyer_2,Carmen,40,ES59209517581497961835,TRX_N-00834-73531270,2023-12-28T18:51:58,Zarautz,expenses,healthcare,-180.25,-50353.9
buyer_2,Carmen,40,ES59209517581497961835,TRX_N-00835-56979440,2023-12-28T00:52:02,Lasarte-Oria,expenses,appliances,-218.09,-50571.99
buyer_2,Carmen,40,ES59209517581497961835,TRX_N-00836-11696527,2023-12-31T14:21:45,Zarautz,expenses,repairs,-236.3,-50808.29
buyer_2,Carmen,40,ES59209517581497961835,TRX_N-00837-24824784,2024-01-01T15:00:45,Zarautz,incomes,salary,1341.82,-49466.47
buyer_2,Carmen,40,ES59209517581497961835,TRX_N-00838-23497492,2024-01-01T15:00:45,Zarautz,incomes,salary_partner,1084.03,-48382.44
buyer_2,Carmen,40,ES59209517581497961835,TRX_N-00839-07966838,2024-01-02T16:34:02,Zarautz,expenses,transport,-67.68,-48450.12
buyer_2,Carmen,40,ES59209517581497961835,TRX_N-00840-87720973,2024-01-02T21:37:29,Amurrio,expenses,gifts,-573.81,-49023.93
buyer_2,Carmen,40,ES59209517581497961835,TRX_N-00841-10630317,2024-01-04T22:45:03,Zarautz,expenses,mortgage,-1091.91,-50115.84
buyer_2,Carmen,40,ES59209517581497961835,TRX_N-00842-40866348,2024-01-04T19:54:09,Zarautz,expenses,food,-121.95,-50237.79
buyer_2,Carmen,40,ES59209517581497961835,TRX_N-00843-57201362,2024-01-04T10:54:40,Zarautz,expenses,education,-42.61,-50280.4
buyer_2,Carmen,40,ES59209517581497961835,TRX_N-00844-08206568,2024-01-05T15:46:40,Zarautz,expenses,water,-20.42,-50300.82
buyer_2,Carmen,40,ES59209517581497961835,TRX_N-00845-03398898,2024-01-05T15:10:16,Zarautz,expenses,gas,-78.93,-50379.75
buyer_2,Carmen,40,ES59209517581497961835,TRX_N-00846-01012302,2024-01-05T01:04:15,Zarautz,expenses,internet,-42.0,-50421.75
buyer_2,Carmen,40,ES59209517581497961835,TRX_N-00847-01937237,2024-01-05T16:11:53,Zarautz,expenses,food,-115.06,-50536.81
buyer_2,Carmen,40,ES59209517581497961835,TRX_N-00848-87985935,2024-01-05T08:03:35,Andoain,expenses,leisure,-25.12,-50561.93
buyer_2,Carmen,40,ES59209517581497961835,TRX_N-00849-75491870,2024-01-06T11:22:38,Alegría-Dulantzi,expenses,food,-111.84,-50673.77
buyer_2,Carmen,40,ES59209517581497961835,TRX_N-00850-93075505,2024-01-06T17:41:11,Zarautz,expenses,transport,-48.79,-50722.56
buyer_2,Carmen,40,ES59209517581497961835,TRX_N-00851-36625848,2024-01-07T15:54:37,Zarautz,expenses,phone,-37.92,-50760.48
buyer_2,Carmen,40,ES59209517581497961835,TRX_N-00852-52578909,2024-01-08T11:55:09,Zarautz,expenses,electricity,-48.89,-50809.37
buyer_2,Carmen,40,ES59209517581497961835,TRX_N-00853-12788578,2024-01-08T20:33:43,Zarautz,expenses,food,-107.7,-50917.07
buyer_2,Carmen,40,ES59209517581497961835,TRX_N-00854-05918058,2024-01-09T12:06:53,Zarautz,expenses,appliances,-302.19,-51219.26
buyer_2,Carmen,40,ES59209517581497961835,TRX_N-00855-20728278,2024-01-10T15:17:45,Zarautz,expenses,clothing,-90.07,-51309.33
buyer_2,Carmen,40,ES59209517581497961835,TRX_N-00856-22546814,2024-01-12T17:58:25,Zarautz,expenses,transport,-62.38,-51371.71
buyer_2,Carmen,40,ES59209517581497961835,TRX_N-00857-18899573,2024-01-12T15:21:55,Zarautz,expenses,education,-48.89,-51420.6
buyer_2,Carmen,40,ES59209517581497961835,TRX_N-00858-09607101,2024-01-12T23:16:33,Zarautz,expenses,cash,-100.0,-51520.6
buyer_2,Carmen,40,ES59209517581497961835,TRX_N-00859-25608435,2024-01-13T12:42:08,Zuia,expenses,gifts,-116.79,-51637.39
buyer_2,Carmen,40,ES59209517581497961835,TRX_N-00860-99176985,2024-01-14T08:17:29,Zarautz,expenses,appliances,-297.01,-51934.4
buyer_2,Carmen,40,ES59209517581497961835,TRX_N-00861-23852939,2024-01-18T02:43:13,Zarautz,expenses,food,-98.92,-52033.32
buyer_2,Carmen,40,ES59209517581497961835,TRX_N-00862-94406190,2024-01-19T04:22:51,Zarautz,expenses,food,-108.48,-52141.8
buyer_2,Carmen,40,ES59209517581497961835,TRX_N-00863-34761027,2024-01-21T19:17:42,Zarautz,expenses,cash,-100.0,-52241.8
buyer_2,Carmen,40,ES59209517581497961835,TRX_N-00864-91898378,2024-01-22T11:17:59,Berango,expenses,cash,-100.0,-52341.8
buyer_2,Carmen,40,ES59209517581497961835,TRX_N-00865-48998376,2024-01-22T20:13:08,Zarautz,expenses,children,-248.67,-52590.47
buyer_2,Carmen,40,ES59209517581497961835,TRX_N-00866-72812734,2024-01-23T12:30:25,Zarautz,expenses,cash,-100.0,-52690.47
buyer_2,Carmen,40,ES59209517581497961835,TRX_N-00867-38426148,2024-01-24T12:43:29,Zarautz,expenses,clothing,-45.45,-52735.92
buyer_2,Carmen,40,ES59209517581497961835,TRX_N-00868-77789754,2024-01-24T09:07:53,Zarautz,expenses,cash,-100.0,-52835.92
buyer_2,Carmen,40,ES59209517581497961835,TRX_N-00869-86478698,2024-01-25T17:58:39,Zarautz,expenses,food,-65.77,-52901.69
buyer_2,Carmen,40,ES59209517581497961835,TRX_N-00870-10651083,2024-01-29T14:37:41,Zarautz,expenses,education,-55.6,-52957.29
buyer_2,Carmen,40,ES59209517581497961835,TRX_N-00871-79656910,2024-01-30T15:05:29,Eibar,expenses,clothing,-101.26,-53058.55
buyer_2,Carmen,40,ES59209517581497961835,TRX_N-00872-90078647,2024-02-01T16:45:53,Zarautz,incomes,salary,1341.82,-51716.73
buyer_2,Carmen,40,ES59209517581497961835,TRX_N-00873-31920660,2024-02-01T16:45:53,Zarautz,incomes,salary_partner,1084.03,-50632.7
buyer_2,Carmen,40,ES59209517581497961835,TRX_N-00874-58707833,2024-02-02T13:04:29,Zarautz,expenses,leisure,-70.6,-50703.3
buyer_2,Carmen,40,ES59209517581497961835,TRX_N-00875-84093222,2024-02-03T13:21:27,Zarautz,expenses,cash,-100.0,-50803.3
buyer_2,Carmen,40,ES59209517581497961835,TRX_N-00876-73334087,2024-02-03T13:31:34,Zarautz,expenses,repairs,-226.07,-51029.37
buyer_2,Carmen,40,ES59209517581497961835,TRX_N-00877-54658936,2024-02-04T18:58:53,Zarautz,expenses,mortgage,-1091.91,-52121.28
buyer_2,Carmen,40,ES59209517581497961835,TRX_N-00878-66755757,2024-02-04T17:35:20,Zarautz,expenses,transport,-68.45,-52189.73
buyer_2,Carmen,40,ES59209517581497961835,TRX_N-00879-45819177,2024-02-05T12:49:33,Zarautz,expenses,gas,-89.11,-52278.84
buyer_2,Carmen,40,ES59209517581497961835,TRX_N-00880-55350104,2024-02-05T14:50:06,Zarautz,expenses,phone,-44.31,-52323.15
buyer_2,Carmen,40,ES59209517581497961835,TRX_N-00881-78990232,2024-02-05T11:07:30,Zarautz,expenses,food,-91.51,-52414.66
buyer_2,Carmen,40,ES59209517581497961835,TRX_N-00882-52323925,2024-02-05T12:15:38,Elciego,expenses,cash,-100.0,-52514.66
buyer_2,Carmen,40,ES59209517581497961835,TRX_N-00883-80318785,2024-02-06T20:27:08,Zarautz,expenses,internet,-42.0,-52556.66
buyer_2,Carmen,40,ES59209517581497961835,TRX_N-00884-08711811,2024-02-07T01:48:26,Zarautz,expenses,healthcare,-187.17,-52743.83
buyer_2,Carmen,40,ES59209517581497961835,TRX_N-00885-30795919,2024-02-08T17:41:58,Zarautz,expenses,water,-33.59,-52777.42
buyer_2,Carmen,40,ES59209517581497961835,TRX_N-00886-87553827,2024-02-08T13:13:01,Zarautz,expenses,electricity,-76.59,-52854.01
buyer_2,Carmen,40,ES59209517581497961835,TRX_N-00887-03941847,2024-02-10T18:52:17,Zarautz,expenses,gifts,-537.67,-53391.68
buyer_2,Carmen,40,ES59209517581497961835,TRX_N-00888-35313673,2024-02-11T11:34:04,Zarautz,expenses,appliances,-120.42,-53512.1
buyer_2,Carmen,40,ES59209517581497961835,TRX_N-00889-69956974,2024-02-11T18:30:33,Zarautz,expenses,children,-277.17,-53789.27
buyer_2,Carmen,40,ES59209517581497961835,TRX_N-00890-71623453,2024-02-12T14:58:07,Zarautz,expenses,repairs,-164.61,-53953.88
buyer_2,Carmen,40,ES59209517581497961835,TRX_N-00891-42796619,2024-02-12T13:54:49,Zarautz,expenses,gifts,-443.58,-54397.46
buyer_2,Carmen,40,ES59209517581497961835,TRX_N-00892-85741515,2024-02-13T10:25:10,Zarautz,expenses,clothing,-91.39,-54488.85
buyer_2,Carmen,40,ES59209517581497961835,TRX_N-00893-87451085,2024-02-19T14:00:05,Zarautz,expenses,cash,-100.0,-54588.85
buyer_2,Carmen,40,ES59209517581497961835,TRX_N-00894-18726204,2024-02-20T16:04:45,Zarautz,expenses,transport,-51.27,-54640.12
buyer_2,Carmen,40,ES59209517581497961835,TRX_N-00895-17589755,2024-02-20T17:57:13,Zarautz,expenses,leisure,-78.69,-54718.81
buyer_2,Carmen,40,ES59209517581497961835,TRX_N-00896-72531775,2024-02-20T15:55:22,Zarautz,expenses,cash,-100.0,-54818.81
buyer_2,Carmen,40,ES59209517581497961835,TRX_N-00897-75196651,2024-02-22T10:27:57,Zarautz,expenses,cash,-100.0,-54918.81
buyer_2,Carmen,40,ES59209517581497961835,TRX_N-00898-95475489,2024-02-23T12:07:59,Zarautz,expenses,food,-118.09,-55036.9
buyer_2,Carmen,40,ES59209517581497961835,TRX_N-00899-28317174,2024-02-25T18:29:30,Zarautz,expenses,education,-78.57,-55115.47
buyer_2,Carmen,40,ES59209517581497961835,TRX_N-00900-34492167,2024-02-27T11:07:23,Zarautz,expenses,leisure,-23.29,-55138.76
buyer_2,Carmen,40,ES59209517581497961835,TRX_N-00901-21788699,2024-02-28T10:38:24,Zarautz,expenses,transport,-65.32,-55204.08
buyer_2,Carmen,40,ES59209517581497961835,TRX_N-00902-07704982,2024-02-29T12:24:35,Zarautz,expenses,food,-93.96,-55298.04
buyer_2,Carmen,40,ES59209517581497961835,TRX_N-00903-25129303,2024-02-29T08:12:29,Zarautz,expenses,gifts,-458.02,-55756.06
buyer_2,Carmen,40,ES59209517581497961835,TRX_N-00904-35738988,2024-03-01T06:17:36,Zarautz,incomes,salary,1341.82,-54414.24
buyer_2,Carmen,40,ES59209517581497961835,TRX_N-00905-75079016,2024-03-01T06:17:36,Zarautz,incomes,salary_partner,1084.03,-53330.21
buyer_2,Carmen,40,ES59209517581497961835,TRX_N-00906-93703255,2024-03-01T11:04:17,Zarautz,expenses,education,-78.24,-53408.45
buyer_2,Carmen,40,ES59209517581497961835,TRX_N-00907-24091583,2024-03-01T12:31:21,Errenteria,expenses,cash,-100.0,-53508.45
buyer_2,Carmen,40,ES59209517581497961835,TRX_N-00908-84430587,2024-03-03T18:16:36,Salvatierra/Agurain,expenses,transport,-67.65,-53576.1
buyer_2,Carmen,40,ES59209517581497961835,TRX_N-00909-84037355,2024-03-04T23:19:59,Zarautz,expenses,mortgage,-1091.91,-54668.01
buyer_2,Carmen,40,ES59209517581497961835,TRX_N-00910-73408797,2024-03-06T11:26:44,Zarautz,expenses,water,-28.83,-54696.84
buyer_2,Carmen,40,ES59209517581497961835,TRX_N-00911-23172950,2024-03-06T06:43:16,Zarautz,expenses,internet,-42.0,-54738.84
buyer_2,Carmen,40,ES59209517581497961835,TRX_N-00912-81699116,2024-03-06T18:48:17,Zarautz,expenses,food,-98.26,-54837.1
buyer_2,Carmen,40,ES59209517581497961835,TRX_N-00913-39763145,2024-03-07T08:27:28,Zarautz,expenses,leisure,-39.34,-54876.44
buyer_2,Carmen,40,ES59209517581497961835,TRX_N-00914-21800160,2024-03-07T18:32:33,Iruña de Oca,expenses,healthcare,-55.19,-54931.63
buyer_2,Carmen,40,ES59209517581497961835,TRX_N-00915-32811375,2024-03-08T13:33:03,Zarautz,expenses,gas,-110.81,-55042.44
buyer_2,Carmen,40,ES59209517581497961835,TRX_N-00916-98211547,2024-03-08T09:07:07,Zarautz,expenses,phone,-41.44,-55083.88
buyer_2,Carmen,40,ES59209517581497961835,TRX_N-00917-59152591,2024-03-08T14:42:38,Zarautz,expenses,electricity,-29.29,-55113.17
buyer_2,Carmen,40,ES59209517581497961835,TRX_N-00918-23417460,2024-03-09T16:56:46,Zarautz,expenses,leisure,-60.1,-55173.27
buyer_2,Carmen,40,ES59209517581497961835,TRX_N-00919-17140633,2024-03-09T19:26:43,Zarautz,expenses,repairs,-274.73,-55448.0
buyer_2,Carmen,40,ES59209517581497961835,TRX_N-00920-16243143,2024-03-11T09:27:32,Zarautz,expenses,transport,-44.57,-55492.57
buyer_2,Carmen,40,ES59209517581497961835,TRX_N-00921-51385126,2024-03-11T20:15:35,Zarautz,expenses,cash,-100.0,-55592.57
buyer_2,Carmen,40,ES59209517581497961835,TRX_N-00922-71308341,2024-03-12T20:36:10,Zarautz,expenses,cash,-100.0,-55692.57
buyer_2,Carmen,40,ES59209517581497961835,TRX_N-00923-86079881,2024-03-13T17:47:20,Zarautz,expenses,transport,-50.82,-55743.39
buyer_2,Carmen,40,ES59209517581497961835,TRX_N-00924-42814623,2024-03-14T17:51:40,Zarautz,expenses,gifts,-352.66,-56096.05
buyer_2,Carmen,40,ES59209517581497961835,TRX_N-00925-31203163,2024-03-14T09:49:05,Zarautz,expenses,children,-170.59,-56266.64
buyer_2,Carmen,40,ES59209517581497961835,TRX_N-00926-82714546,2024-03-18T14:35:06,Zarautz,expenses,food,-100.87,-56367.51
buyer_2,Carmen,40,ES59209517581497961835,TRX_N-00927-90172589,2024-03-21T17:48:03,Zarautz,expenses,food,-106.02,-56473.53
buyer_2,Carmen,40,ES59209517581497961835,TRX_N-00928-77636641,2024-03-21T17:41:31,Zarautz,expenses,repairs,-259.4,-56732.93
buyer_2,Carmen,40,ES59209517581497961835,TRX_N-00929-42998706,2024-03-22T19:59:12,Zarautz,expenses,food,-106.27,-56839.2
buyer_2,Carmen,40,ES59209517581497961835,TRX_N-00930-81806989,2024-03-26T10:22:36,Labastida,expenses,food,-80.71,-56919.91
buyer_2,Carmen,40,ES59209517581497961835,TRX_N-00931-74032153,2024-03-26T14:47:54,Zarautz,expenses,repairs,-242.13,-57162.04
buyer_2,Carmen,40,ES59209517581497961835,TRX_N-00932-75168244,2024-03-27T11:02:39,Leioa,expenses,food,-90.33,-57252.37
buyer_2,Carmen,40,ES59209517581497961835,TRX_N-00933-08330660,2024-03-27T09:29:15,Zarautz,expenses,leisure,-62.93,-57315.3
buyer_2,Carmen,40,ES59209517581497961835,TRX_N-00934-55285854,2024-03-28T13:20:23,Zarautz,expenses,cash,-100.0,-57415.3
buyer_2,Carmen,40,ES59209517581497961835,TRX_N-00935-30265317,2024-03-29T12:12:05,Zarautz,expenses,food,-99.21,-57514.51
buyer_2,Carmen,40,ES59209517581497961835,TRX_N-00936-16531522,2024-03-29T12:03:16,Zarautz,expenses,cash,-100.0,-57614.51
buyer_2,Carmen,40,ES59209517581497961835,TRX_N-00937-76871124,2024-03-31T14:38:15,Zarautz,expenses,food,-96.18,-57710.69
buyer_2,Carmen,40,ES59209517581497961835,TRX_N-00938-56874740,2024-03-31T14:21:26,Vitoria-Gasteiz,expenses,leisure,-60.54,-57771.23
buyer_2,Carmen,40,ES59209517581497961835,TRX_N-00939-42175765,2024-04-01T12:36:47,Zarautz,incomes,salary,1341.82,-56429.41
buyer_2,Carmen,40,ES59209517581497961835,TRX_N-00940-75894350,2024-04-01T12:36:47,Zarautz,incomes,salary_partner,1084.03,-55345.38
buyer_2,Carmen,40,ES59209517581497961835,TRX_N-00941-96234168,2024-04-01T12:36:47,Zarautz,incomes,extra_income,152.67,-55192.71
buyer_2,Carmen,40,ES59209517581497961835,TRX_N-00942-21277851,2024-04-01T17:32:49,Zuia,expenses,leisure,-60.59,-55253.3
buyer_2,Carmen,40,ES59209517581497961835,TRX_N-00943-79546175,2024-04-01T12:51:01,Errenteria,expenses,repairs,-155.02,-55408.32
buyer_2,Carmen,40,ES59209517581497961835,TRX_N-00944-16554779,2024-04-02T09:52:03,Zarautz,expenses,cash,-100.0,-55508.32
buyer_2,Carmen,40,ES59209517581497961835,TRX_N-00945-91103752,2024-04-04T22:07:31,Zarautz,expenses,mortgage,-1091.91,-56600.23
buyer_2,Carmen,40,ES59209517581497961835,TRX_N-00946-33267855,2024-04-04T09:16:30,Barakaldo,expenses,gifts,-425.02,-57025.25
buyer_2,Carmen,40,ES59209517581497961835,TRX_N-00947-11719361,2024-04-05T12:27:24,Zarautz,expenses,water,-43.17,-57068.42
buyer_2,Carmen,40,ES59209517581497961835,TRX_N-00948-29589664,2024-04-05T11:11:54,Zarautz,expenses,children,-241.69,-57310.11
buyer_2,Carmen,40,ES59209517581497961835,TRX_N-00949-87939680,2024-04-06T02:21:13,Zarautz,expenses,gas,-109.73,-57419.84
buyer_2,Carmen,40,ES59209517581497961835,TRX_N-00950-53258746,2024-04-06T14:30:55,Zarautz,expenses,internet,-42.0,-57461.84
buyer_2,Carmen,40,ES59209517581497961835,TRX_N-00951-81135150,2024-04-06T12:01:10,Zarautz,expenses,appliances,-183.28,-57645.12
buyer_2,Carmen,40,ES59209517581497961835,TRX_N-00952-40627944,2024-04-07T23:56:12,Zarautz,expenses,phone,-44.9,-57690.02
buyer_2,Carmen,40,ES59209517581497961835,TRX_N-00953-50307041,2024-04-07T14:33:24,Zarautz,expenses,leisure,-72.16,-57762.18
buyer_2,Carmen,40,ES59209517581497961835,TRX_N-00954-61276394,2024-04-07T19:51:36,Zarautz,expenses,cash,-100.0,-57862.18
buyer_2,Carmen,40,ES59209517581497961835,TRX_N-00955-58105592,2024-04-08T14:44:59,Zarautz,expenses,electricity,-39.12,-57901.3
buyer_2,Carmen,40,ES59209517581497961835,TRX_N-00956-53866053,2024-04-09T08:25:10,Zarautz,expenses,food,-103.17,-58004.47
buyer_2,Carmen,40,ES59209517581497961835,TRX_N-00957-51458423,2024-04-10T15:20:49,Pasaia,expenses,education,-55.85,-58060.32
buyer_2,Carmen,40,ES59209517581497961835,TRX_N-00958-06932571,2024-04-13T15:14:48,Salvatierra/Agurain,expenses,cash,-100.0,-58160.32
buyer_2,Carmen,40,ES59209517581497961835,TRX_N-00959-98296128,2024-04-13T08:03:09,Zarautz,expenses,repairs,-149.34,-58309.66
buyer_2,Carmen,40,ES59209517581497961835,TRX_N-00960-11102946,2024-04-14T13:21:04,Zarautz,expenses,food,-68.53,-58378.19
buyer_2,Carmen,40,ES59209517581497961835,TRX_N-00961-21776913,2024-04-18T16:54:05,Zarautz,expenses,leisure,-34.53,-58412.72
buyer_2,Carmen,40,ES59209517581497961835,TRX_N-00962-76790289,2024-04-18T10:18:10,Zarautz,expenses,travel,-603.6,-59016.32
buyer_2,Carmen,40,ES59209517581497961835,TRX_N-00963-63929483,2024-04-19T17:58:36,Zarautz,expenses,repairs,-60.14,-59076.46
buyer_2,Carmen,40,ES59209517581497961835,TRX_N-00964-73619805,2024-04-19T20:41:44,Zarautz,expenses,gifts,-790.3,-59866.76
buyer_2,Carmen,40,ES59209517581497961835,TRX_N-00965-11260473,2024-04-22T20:19:34,Zarautz,expenses,transport,-56.58,-59923.34
buyer_2,Carmen,40,ES59209517581497961835,TRX_N-00966-37850386,2024-04-23T15:54:27,Erandio,expenses,cash,-100.0,-60023.34
buyer_2,Carmen,40,ES59209517581497961835,TRX_N-00967-72230208,2024-04-24T15:58:42,Zarautz,expenses,gifts,-167.91,-60191.25
buyer_2,Carmen,40,ES59209517581497961835,TRX_N-00968-85895825,2024-04-26T20:42:00,Zarautz,expenses,food,-72.97,-60264.22
buyer_2,Carmen,40,ES59209517581497961835,TRX_N-00969-90736437,2024-04-27T10:00:52,Durango,expenses,food,-107.55,-60371.77
buyer_2,Carmen,40,ES59209517581497961835,TRX_N-00970-63795227,2024-04-27T11:58:34,Zarautz,expenses,education,-52.54,-60424.31
buyer_2,Carmen,40,ES59209517581497961835,TRX_N-00971-01722555,2024-04-27T03:48:44,Zarautz,expenses,cash,-100.0,-60524.31
buyer_2,Carmen,40,ES59209517581497961835,TRX_N-00972-93904086,2024-04-28T20:17:07,Zarautz,expenses,children,-221.59,-60745.9
buyer_2,Carmen,40,ES59209517581497961835,TRX_N-00973-87617115,2024-04-30T14:03:45,Zarautz,expenses,clothing,-82.57,-60828.47
buyer_2,Carmen,40,ES59209517581497961835,TRX_N-00974-24414417,2024-05-01T09:32:47,Zarautz,incomes,salary,1341.82,-59486.65
buyer_2,Carmen,40,ES59209517581497961835,TRX_N-00975-48286614,2024-05-01T09:32:47,Zarautz,incomes,salary_partner,1084.03,-58402.62
buyer_2,Carmen,40,ES59209517581497961835,TRX_N-00976-00173291,2024-05-01T13:36:11,Zarautz,expenses,food,-121.92,-58524.54
buyer_2,Carmen,40,ES59209517581497961835,TRX_N-00977-31228273,2024-05-01T15:23:13,Zarautz,expenses,cash,-100.0,-58624.54
buyer_2,Carmen,40,ES59209517581497961835,TRX_N-00978-26962724,2024-05-04T14:41:13,Zarautz,expenses,mortgage,-1091.91,-59716.45
buyer_2,Carmen,40,ES59209517581497961835,TRX_N-00979-72036852,2024-05-04T10:17:53,Zarautz,expenses,leisure,-77.03,-59793.48
buyer_2,Carmen,40,ES59209517581497961835,TRX_N-00980-07551101,2024-05-05T13:46:25,Zarautz,expenses,electricity,-64.63,-59858.11
buyer_2,Carmen,40,ES59209517581497961835,TRX_N-00981-43555921,2024-05-05T14:45:19,Zarautz,expenses,children,-129.3,-59987.41
buyer_2,Carmen,40,ES59209517581497961835,TRX_N-00982-56796348,2024-05-06T23:51:28,Zarautz,expenses,gas,-100.62,-60088.03
buyer_2,Carmen,40,ES59209517581497961835,TRX_N-00983-26860276,2024-05-06T14:07:05,Zarautz,expenses,leisure,-57.18,-60145.21
buyer_2,Carmen,40,ES59209517581497961835,TRX_N-00984-99773738,2024-05-06T13:48:45,Leioa,expenses,healthcare,-100.6,-60245.81
buyer_2,Carmen,40,ES59209517581497961835,TRX_N-00985-56829664,2024-05-07T13:28:19,Zarautz,expenses,internet,-42.0,-60287.81
buyer_2,Carmen,40,ES59209517581497961835,TRX_N-00986-10094662,2024-05-08T08:17:49,Zarautz,expenses,water,-32.68,-60320.49
buyer_2,Carmen,40,ES59209517581497961835,TRX_N-00987-74499417,2024-05-08T13:25:31,Zarautz,expenses,phone,-40.31,-60360.8
buyer_2,Carmen,40,ES59209517581497961835,TRX_N-00988-33987202,2024-05-08T16:38:07,Zarautz,expenses,repairs,-221.54,-60582.34
buyer_2,Carmen,40,ES59209517581497961835,TRX_N-00989-78022277,2024-05-09T08:51:34,Zarautz,expenses,leisure,-59.24,-60641.58
buyer_2,Carmen,40,ES59209517581497961835,TRX_N-00990-10901205,2024-05-09T11:00:42,Zarautz,expenses,cash,-100.0,-60741.58
buyer_2,Carmen,40,ES59209517581497961835,TRX_N-00991-66401994,2024-05-13T19:14:48,Zarautz,expenses,food,-86.74,-60828.32
buyer_2,Carmen,40,ES59209517581497961835,TRX_N-00992-39433556,2024-05-14T13:47:02,Sestao,expenses,cash,-100.0,-60928.32
buyer_2,Carmen,40,ES59209517581497961835,TRX_N-00993-90735345,2024-05-15T09:07:42,Zarautz,expenses,gifts,-395.94,-61324.26
buyer_2,Carmen,40,ES59209517581497961835,TRX_N-00994-38650499,2024-05-18T18:05:54,Zarautz,expenses,repairs,-224.47,-61548.73
buyer_2,Carmen,40,ES59209517581497961835,TRX_N-00995-69743685,2024-05-20T10:18:21,Zarautz,expenses,cash,-100.0,-61648.73
buyer_2,Carmen,40,ES59209517581497961835,TRX_N-00996-85223758,2024-05-22T22:20:36,Zarautz,expenses,education,-67.05,-61715.78
buyer_2,Carmen,40,ES59209517581497961835,TRX_N-00997-84715797,2024-05-22T09:30:15,Zarautz,expenses,cash,-100.0,-61815.78
buyer_2,Carmen,40,ES59209517581497961835,TRX_N-00998-66132460,2024-05-26T15:13:07,Zarautz,expenses,clothing,-79.48,-61895.26
buyer_2,Carmen,40,ES59209517581497961835,TRX_N-00999-74311849,2024-05-28T14:34:43,Zarautz,expenses,education,-66.62,-61961.88
buyer_2,Carmen,40,ES59209517581497961835,TRX_N-01000-97785183,2024-05-31T16:11:54,Zarautz,expenses,cash,-100.0,-62061.88
buyer_2,Carmen,40,ES59209517581497961835,TRX_N-01001-95147686,2024-05-31T18:56:19,Bermeo,expenses,appliances,-163.93,-62225.81
buyer_2,Carmen,40,ES59209517581497961835,TRX_N-01002-81567353,2024-06-01T08:18:29,Zarautz,incomes,salary,1341.82,-60883.99
buyer_2,Carmen,40,ES59209517581497961835,TRX_N-01003-18876400,2024-06-01T08:18:29,Zarautz,incomes,salary_partner,1084.03,-59799.96
buyer_2,Carmen,40,ES59209517581497961835,TRX_N-01004-18629100,2024-06-01T08:18:29,Zarautz,incomes,salary_bonus,985.99,-58813.97
buyer_2,Carmen,40,ES59209517581497961835,TRX_N-01005-40625516,2024-06-01T08:18:29,Zarautz,incomes,salary_partner_bonus,840.01,-57973.96
buyer_2,Carmen,40,ES59209517581497961835,TRX_N-01006-64320831,2024-06-01T19:38:54,Bilbao,expenses,food,-65.53,-58039.49
buyer_2,Carmen,40,ES59209517581497961835,TRX_N-01007-81402030,2024-06-01T15:23:31,Zarautz,expenses,cash,-100.0,-58139.49
buyer_2,Carmen,40,ES59209517581497961835,TRX_N-01008-87155984,2024-06-04T07:04:16,Zarautz,expenses,mortgage,-1091.91,-59231.4
buyer_2,Carmen,40,ES59209517581497961835,TRX_N-01009-74166762,2024-06-04T14:01:27,Zarautz,expenses,transport,-40.72,-59272.12
buyer_2,Carmen,40,ES59209517581497961835,TRX_N-01010-30688198,2024-06-04T16:56:58,Zarautz,expenses,leisure,-31.43,-59303.55
buyer_2,Carmen,40,ES59209517581497961835,TRX_N-01011-08970063,2024-06-05T04:09:35,Zarautz,expenses,electricity,-81.34,-59384.89
buyer_2,Carmen,40,ES59209517581497961835,TRX_N-01012-61792184,2024-06-05T12:44:40,Pasaia,expenses,clothing,-126.21,-59511.1
buyer_2,Carmen,40,ES59209517581497961835,TRX_N-01013-87816485,2024-06-06T12:03:00,Zarautz,expenses,internet,-42.0,-59553.1
buyer_2,Carmen,40,ES59209517581497961835,TRX_N-01014-41907069,2024-06-06T20:30:07,Zarautz,expenses,phone,-43.53,-59596.63
buyer_2,Carmen,40,ES59209517581497961835,TRX_N-01015-87001048,2024-06-06T12:53:07,Zarautz,expenses,food,-95.02,-59691.65
buyer_2,Carmen,40,ES59209517581497961835,TRX_N-01016-79651524,2024-06-07T23:52:46,Zarautz,expenses,leisure,-69.54,-59761.19
buyer_2,Carmen,40,ES59209517581497961835,TRX_N-01017-31252988,2024-06-07T15:18:16,Getxo,expenses,repairs,-325.76,-60086.95
buyer_2,Carmen,40,ES59209517581497961835,TRX_N-01018-80167354,2024-06-08T08:00:12,Zarautz,expenses,water,-40.86,-60127.81
buyer_2,Carmen,40,ES59209517581497961835,TRX_N-01019-95225138,2024-06-08T04:18:32,Zarautz,expenses,gas,-102.65,-60230.46
buyer_2,Carmen,40,ES59209517581497961835,TRX_N-01020-41786892,2024-06-08T19:35:21,Zarautz,expenses,gifts,-812.37,-61042.83
buyer_2,Carmen,40,ES59209517581497961835,TRX_N-01021-71497643,2024-06-10T14:23:31,Zarautz,expenses,clothing,-93.14,-61135.97
buyer_2,Carmen,40,ES59209517581497961835,TRX_N-01022-69046620,2024-06-12T14:37:55,Llodio,expenses,cash,-100.0,-61235.97
buyer_2,Carmen,40,ES59209517581497961835,TRX_N-01023-77135240,2024-06-12T10:30:13,Zarautz,expenses,gifts,-847.07,-62083.04
buyer_2,Carmen,40,ES59209517581497961835,TRX_N-01024-25647936,2024-06-15T14:36:21,Zarautz,expenses,transport,-55.78,-62138.82
buyer_2,Carmen,40,ES59209517581497961835,TRX_N-01025-93881085,2024-06-16T20:29:57,Zarautz,expenses,children,-140.06,-62278.88
buyer_2,Carmen,40,ES59209517581497961835,TRX_N-01026-60615501,2024-06-17T13:16:42,Zarautz,expenses,cash,-100.0,-62378.88
buyer_2,Carmen,40,ES59209517581497961835,TRX_N-01027-86918974,2024-06-18T10:00:24,Zarautz,expenses,leisure,-79.13,-62458.01
buyer_2,Carmen,40,ES59209517581497961835,TRX_N-01028-62447307,2024-06-18T16:03:33,Zarautz,expenses,repairs,-213.65,-62671.66
buyer_2,Carmen,40,ES59209517581497961835,TRX_N-01029-02000559,2024-06-19T20:31:26,Zarautz,expenses,healthcare,-164.29,-62835.95
buyer_2,Carmen,40,ES59209517581497961835,TRX_N-01030-84105267,2024-06-21T22:46:47,Zarautz,expenses,clothing,-65.2,-62901.15
buyer_2,Carmen,40,ES59209517581497961835,TRX_N-01031-90039550,2024-06-23T20:29:19,Zarautz,expenses,cash,-100.0,-63001.15
buyer_2,Carmen,40,ES59209517581497961835,TRX_N-01032-70890221,2024-06-23T18:28:53,Zarautz,expenses,repairs,-83.7,-63084.85
buyer_2,Carmen,40,ES59209517581497961835,TRX_N-01033-77303825,2024-06-23T10:53:35,Zarautz,expenses,children,-233.44,-63318.29
buyer_2,Carmen,40,ES59209517581497961835,TRX_N-01034-95953806,2024-06-28T20:14:18,Zarautz,expenses,clothing,-137.78,-63456.07
buyer_2,Carmen,40,ES59209517581497961835,TRX_N-01035-11966676,2024-06-30T09:29:44,Zarautz,expenses,repairs,-81.15,-63537.22
buyer_2,Carmen,40,ES59209517581497961835,TRX_N-01036-98653980,2024-07-01T09:09:39,Zarautz,incomes,salary,1341.82,-62195.4
buyer_2,Carmen,40,ES59209517581497961835,TRX_N-01037-07107505,2024-07-01T09:09:39,Zarautz,incomes,salary_partner,1084.03,-61111.37
buyer_2,Carmen,40,ES59209517581497961835,TRX_N-01038-90230651,2024-07-01T09:09:39,Zarautz,incomes,extra_income,152.67,-60958.7
buyer_2,Carmen,40,ES59209517581497961835,TRX_N-01039-63399402,2024-07-04T11:31:49,Zarautz,expenses,mortgage,-1091.91,-62050.61
buyer_2,Carmen,40,ES59209517581497961835,TRX_N-01040-96528800,2024-07-05T21:04:10,Zarautz,expenses,gas,-107.02,-62157.63
buyer_2,Carmen,40,ES59209517581497961835,TRX_N-01041-70440952,2024-07-05T11:48:57,Zarautz,expenses,internet,-42.0,-62199.63
buyer_2,Carmen,40,ES59209517581497961835,TRX_N-01042-01135443,2024-07-05T17:16:48,Zarautz,expenses,phone,-44.74,-62244.37
buyer_2,Carmen,40,ES59209517581497961835,TRX_N-01043-00039188,2024-07-06T17:49:24,Zarautz,expenses,water,-40.94,-62285.31
buyer_2,Carmen,40,ES59209517581497961835,TRX_N-01044-98636364,2024-07-06T10:10:48,Zarautz,expenses,electricity,-87.74,-62373.05
buyer_2,Carmen,40,ES59209517581497961835,TRX_N-01045-29110102,2024-07-07T09:56:33,Zarautz,expenses,food,-73.29,-62446.34
buyer_2,Carmen,40,ES59209517581497961835,TRX_N-01046-51831399,2024-07-08T09:32:07,Sopela,expenses,food,-71.36,-62517.7
buyer_2,Carmen,40,ES59209517581497961835,TRX_N-01047-66168484,2024-07-11T17:31:09,Zarautz,expenses,transport,-42.17,-62559.87
buyer_2,Carmen,40,ES59209517581497961835,TRX_N-01048-39587931,2024-07-11T20:07:16,Zarautz,expenses,cash,-100.0,-62659.87
buyer_2,Carmen,40,ES59209517581497961835,TRX_N-01049-62991583,2024-07-12T16:27:45,Berango,expenses,healthcare,-139.84,-62799.71
buyer_2,Carmen,40,ES59209517581497961835,TRX_N-01050-37958476,2024-07-16T19:50:04,Zarautz,expenses,food,-69.56,-62869.27
buyer_2,Carmen,40,ES59209517581497961835,TRX_N-01051-20577585,2024-07-16T19:55:55,Zarautz,expenses,children,-171.98,-63041.25
buyer_2,Carmen,40,ES59209517581497961835,TRX_N-01052-42378646,2024-07-17T15:57:13,Durango,expenses,transport,-67.7,-63108.95
buyer_2,Carmen,40,ES59209517581497961835,TRX_N-01053-31951875,2024-07-17T12:54:56,Zarautz,expenses,cash,-100.0,-63208.95
buyer_2,Carmen,40,ES59209517581497961835,TRX_N-01054-98797705,2024-07-17T11:06:35,Zarautz,expenses,children,-134.18,-63343.13
buyer_2,Carmen,40,ES59209517581497961835,TRX_N-01055-02247691,2024-07-19T23:11:07,Zarautz,expenses,food,-107.07,-63450.2
buyer_2,Carmen,40,ES59209517581497961835,TRX_N-01056-97889908,2024-07-21T22:31:35,Zarautz,expenses,leisure,-72.8,-63523.0
buyer_2,Carmen,40,ES59209517581497961835,TRX_N-01057-89357703,2024-07-21T17:41:36,Berango,expenses,cash,-100.0,-63623.0
buyer_2,Carmen,40,ES59209517581497961835,TRX_N-01058-96924359,2024-07-23T12:54:49,Galdakao,expenses,cash,-100.0,-63723.0
buyer_2,Carmen,40,ES59209517581497961835,TRX_N-01059-48935830,2024-07-24T18:11:44,Zarautz,expenses,healthcare,-130.56,-63853.56
buyer_2,Carmen,40,ES59209517581497961835,TRX_N-01060-39503515,2024-07-24T11:32:00,Zarautz,expenses,repairs,-301.23,-64154.79
buyer_2,Carmen,40,ES59209517581497961835,TRX_N-01061-09096868,2024-07-24T19:06:10,Zarautz,expenses,children,-118.69,-64273.48
buyer_2,Carmen,40,ES59209517581497961835,TRX_N-01062-86518870,2024-07-28T11:30:13,Zarautz,expenses,repairs,-216.9,-64490.38
buyer_2,Carmen,40,ES59209517581497961835,TRX_N-01063-54543665,2024-07-28T19:16:32,Arrasate,expenses,gifts,-538.57,-65028.95
buyer_2,Carmen,40,ES59209517581497961835,TRX_N-01064-56199530,2024-07-29T19:48:19,Hernani,expenses,clothing,-73.67,-65102.62
buyer_2,Carmen,40,ES59209517581497961835,TRX_N-01065-65551359,2024-08-01T14:23:13,Zarautz,incomes,salary,1341.82,-63760.8
buyer_2,Carmen,40,ES59209517581497961835,TRX_N-01066-47352058,2024-08-01T14:23:13,Zarautz,incomes,salary_partner,1084.03,-62676.77
buyer_2,Carmen,40,ES59209517581497961835,TRX_N-01067-28280858,2024-08-01T14:54:36,Zarautz,expenses,cash,-100.0,-62776.77
buyer_2,Carmen,40,ES59209517581497961835,TRX_N-01068-53215787,2024-08-02T11:51:13,Zarautz,expenses,healthcare,-168.75,-62945.52
buyer_2,Carmen,40,ES59209517581497961835,TRX_N-01069-53767720,2024-08-03T12:45:33,Zarautz,expenses,cash,-100.0,-63045.52
buyer_2,Carmen,40,ES59209517581497961835,TRX_N-01070-85662666,2024-08-03T19:24:49,Zarautz,expenses,appliances,-267.67,-63313.19
buyer_2,Carmen,40,ES59209517581497961835,TRX_N-01071-37718685,2024-08-04T21:37:17,Zarautz,expenses,mortgage,-1091.91,-64405.1
buyer_2,Carmen,40,ES59209517581497961835,TRX_N-01072-10339836,2024-08-05T12:30:34,Zarautz,expenses,electricity,-35.16,-64440.26
buyer_2,Carmen,40,ES59209517581497961835,TRX_N-01073-42994076,2024-08-05T10:29:14,Zarautz,expenses,cash,-100.0,-64540.26
buyer_2,Carmen,40,ES59209517581497961835,TRX_N-01074-92428666,2024-08-06T10:51:02,Zarautz,expenses,leisure,-34.69,-64574.95
buyer_2,Carmen,40,ES59209517581497961835,TRX_N-01075-15856735,2024-08-06T17:00:05,Zarautz,expenses,repairs,-190.83,-64765.78
buyer_2,Carmen,40,ES59209517581497961835,TRX_N-01076-89841394,2024-08-07T13:45:21,Zarautz,expenses,gas,-60.92,-64826.7
buyer_2,Carmen,40,ES59209517581497961835,TRX_N-01077-92596424,2024-08-07T13:06:27,Zarautz,expenses,cash,-100.0,-64926.7
buyer_2,Carmen,40,ES59209517581497961835,TRX_N-01078-16111067,2024-08-07T19:03:48,Zarautz,expenses,children,-216.6,-65143.3
buyer_2,Carmen,40,ES59209517581497961835,TRX_N-01079-20372759,2024-08-08T18:57:15,Zarautz,expenses,water,-30.57,-65173.87
buyer_2,Carmen,40,ES59209517581497961835,TRX_N-01080-81823922,2024-08-08T18:23:59,Zarautz,expenses,internet,-42.0,-65215.87
buyer_2,Carmen,40,ES59209517581497961835,TRX_N-01081-03208796,2024-08-08T17:35:58,Zarautz,expenses,phone,-43.84,-65259.71
buyer_2,Carmen,40,ES59209517581497961835,TRX_N-01082-89156501,2024-08-08T18:36:41,Zarautz,expenses,food,-87.99,-65347.7
buyer_2,Carmen,40,ES59209517581497961835,TRX_N-01083-92491756,2024-08-09T08:18:20,Zarautz,expenses,transport,-44.45,-65392.15
buyer_2,Carmen,40,ES59209517581497961835,TRX_N-01084-50394372,2024-08-09T11:00:53,Zarautz,expenses,clothing,-61.54,-65453.69
buyer_2,Carmen,40,ES59209517581497961835,TRX_N-01085-59547244,2024-08-09T12:03:43,Zuia,expenses,repairs,-296.05,-65749.74
buyer_2,Carmen,40,ES59209517581497961835,TRX_N-01086-70912825,2024-08-13T20:37:58,Zarautz,expenses,education,-65.37,-65815.11
buyer_2,Carmen,40,ES59209517581497961835,TRX_N-01087-22599786,2024-08-14T10:57:26,Zarautz,expenses,cash,-100.0,-65915.11
buyer_2,Carmen,40,ES59209517581497961835,TRX_N-01088-26045461,2024-08-15T19:45:08,Zarautz,expenses,leisure,-25.03,-65940.14
buyer_2,Carmen,40,ES59209517581497961835,TRX_N-01089-66444461,2024-08-16T14:49:45,Zarautz,expenses,repairs,-175.53,-66115.67
buyer_2,Carmen,40,ES59209517581497961835,TRX_N-01090-87295005,2024-08-18T10:48:09,Zarautz,expenses,leisure,-26.6,-66142.27
buyer_2,Carmen,40,ES59209517581497961835,TRX_N-01091-90289077,2024-08-18T09:00:59,Zarautz,expenses,clothing,-82.64,-66224.91
buyer_2,Carmen,40,ES59209517581497961835,TRX_N-01092-57589460,2024-08-18T13:17:08,Zarautz,expenses,education,-45.78,-66270.69
buyer_2,Carmen,40,ES59209517581497961835,TRX_N-01093-53831989,2024-08-18T09:04:41,Zarautz,expenses,cash,-100.0,-66370.69
buyer_2,Carmen,40,ES59209517581497961835,TRX_N-01094-25784672,2024-08-19T03:24:28,Zarautz,expenses,transport,-87.27,-66457.96
buyer_2,Carmen,40,ES59209517581497961835,TRX_N-01095-78819846,2024-08-20T03:13:28,Pasaia,expenses,leisure,-71.78,-66529.74
buyer_2,Carmen,40,ES59209517581497961835,TRX_N-01096-89382135,2024-08-20T14:26:10,Zarautz,expenses,gifts,-667.02,-67196.76
buyer_2,Carmen,40,ES59209517581497961835,TRX_N-01097-18597045,2024-08-21T08:27:08,Zarautz,expenses,leisure,-66.22,-67262.98
buyer_2,Carmen,40,ES59209517581497961835,TRX_N-01098-17817888,2024-08-21T09:54:10,Vitoria-Gasteiz,expenses,education,-59.78,-67322.76
buyer_2,Carmen,40,ES59209517581497961835,TRX_N-01099-81509725,2024-08-23T13:36:53,Sopela,expenses,food,-82.28,-67405.04
buyer_2,Carmen,40,ES59209517581497961835,TRX_N-01100-99639156,2024-08-24T16:55:44,Zarautz,expenses,leisure,-48.65,-67453.69
buyer_2,Carmen,40,ES59209517581497961835,TRX_N-01101-86515422,2024-08-24T16:07:52,Zarautz,expenses,clothing,-76.86,-67530.55
buyer_2,Carmen,40,ES59209517581497961835,TRX_N-01102-84634894,2024-08-25T13:31:48,Zarautz,expenses,transport,-55.95,-67586.5
buyer_2,Carmen,40,ES59209517581497961835,TRX_N-01103-36736751,2024-08-25T11:17:27,Zarautz,expenses,cash,-100.0,-67686.5
buyer_2,Carmen,40,ES59209517581497961835,TRX_N-01104-15890021,2024-08-31T10:37:24,Zarautz,expenses,travel,-747.49,-68433.99
buyer_2,Carmen,40,ES59209517581497961835,TRX_N-01105-90801474,2024-09-01T06:17:18,Zarautz,incomes,salary,1341.82,-67092.17
buyer_2,Carmen,40,ES59209517581497961835,TRX_N-01106-29005988,2024-09-01T06:17:18,Zarautz,incomes,salary_partner,1084.03,-66008.14
buyer_2,Carmen,40,ES59209517581497961835,TRX_N-01107-34979401,2024-09-02T08:38:20,Vitoria-Gasteiz,expenses,food,-75.56,-66083.7
buyer_2,Carmen,40,ES59209517581497961835,TRX_N-01108-72355536,2024-09-03T16:23:02,Zarautz,expenses,food,-80.22,-66163.92
buyer_2,Carmen,40,ES59209517581497961835,TRX_N-01109-80568128,2024-09-04T13:49:52,Zarautz,expenses,mortgage,-1091.91,-67255.83
buyer_2,Carmen,40,ES59209517581497961835,TRX_N-01110-01266804,2024-09-05T02:09:46,Zarautz,expenses,gas,-49.75,-67305.58
buyer_2,Carmen,40,ES59209517581497961835,TRX_N-01111-76258631,2024-09-05T14:26:38,Zarautz,expenses,internet,-42.0,-67347.58
buyer_2,Carmen,40,ES59209517581497961835,TRX_N-01112-63903559,2024-09-05T14:08:18,Zarautz,expenses,cash,-100.0,-67447.58
buyer_2,Carmen,40,ES59209517581497961835,TRX_N-01113-91355211,2024-09-06T08:49:53,Zarautz,expenses,food,-75.08,-67522.66
buyer_2,Carmen,40,ES59209517581497961835,TRX_N-01114-28610026,2024-09-07T15:38:14,Zarautz,expenses,water,-29.05,-67551.71
buyer_2,Carmen,40,ES59209517581497961835,TRX_N-01115-93946008,2024-09-07T11:45:11,Galdakao,expenses,repairs,-324.43,-67876.14
buyer_2,Carmen,40,ES59209517581497961835,TRX_N-01116-16081673,2024-09-08T18:59:58,Zarautz,expenses,phone,-35.5,-67911.64
buyer_2,Carmen,40,ES59209517581497961835,TRX_N-01117-06956319,2024-09-08T18:13:21,Zarautz,expenses,electricity,-49.9,-67961.54
buyer_2,Carmen,40,ES59209517581497961835,TRX_N-01118-35576998,2024-09-08T10:14:11,Zarautz,expenses,travel,-587.25,-68548.79
buyer_2,Carmen,40,ES59209517581497961835,TRX_N-01119-09747007,2024-09-10T18:51:08,Oyón-Oion,expenses,clothing,-101.69,-68650.48
buyer_2,Carmen,40,ES59209517581497961835,TRX_N-01120-26136748,2024-09-11T17:33:20,Zarautz,expenses,leisure,-27.72,-68678.2
buyer_2,Carmen,40,ES59209517581497961835,TRX_N-01121-67429644,2024-09-12T15:36:07,Zarautz,expenses,gifts,-274.79,-68952.99
buyer_2,Carmen,40,ES59209517581497961835,TRX_N-01122-82926209,2024-09-13T17:42:10,Zarautz,expenses,leisure,-48.06,-69001.05
buyer_2,Carmen,40,ES59209517581497961835,TRX_N-01123-30613992,2024-09-15T16:45:32,Zarautz,expenses,food,-85.52,-69086.57
buyer_2,Carmen,40,ES59209517581497961835,TRX_N-01124-26937449,2024-09-15T09:53:05,Zarautz,expenses,leisure,-57.74,-69144.31
buyer_2,Carmen,40,ES59209517581497961835,TRX_N-01125-99183899,2024-09-16T20:53:00,Zarautz,expenses,clothing,-158.84,-69303.15
buyer_2,Carmen,40,ES59209517581497961835,TRX_N-01126-76376353,2024-09-17T23:18:29,Sopela,expenses,leisure,-54.78,-69357.93
buyer_2,Carmen,40,ES59209517581497961835,TRX_N-01127-11215413,2024-09-17T20:39:05,Zarautz,expenses,education,-61.88,-69419.81
buyer_2,Carmen,40,ES59209517581497961835,TRX_N-01128-53711786,2024-09-18T20:13:01,Santurtzi,expenses,food,-63.99,-69483.8
buyer_2,Carmen,40,ES59209517581497961835,TRX_N-01129-51086274,2024-09-18T12:03:03,Zarautz,expenses,transport,-47.13,-69530.93
buyer_2,Carmen,40,ES59209517581497961835,TRX_N-01130-18451133,2024-09-18T10:59:14,Zarautz,expenses,healthcare,-107.73,-69638.66
buyer_2,Carmen,40,ES59209517581497961835,TRX_N-01131-21815165,2024-09-18T11:35:33,Sestao,expenses,cash,-100.0,-69738.66
buyer_2,Carmen,40,ES59209517581497961835,TRX_N-01132-05553180,2024-09-18T17:47:34,Zarautz,expenses,gifts,-311.93,-70050.59
buyer_2,Carmen,40,ES59209517581497961835,TRX_N-01133-78805693,2024-09-19T18:10:10,Zarautz,expenses,food,-83.85,-70134.44
buyer_2,Carmen,40,ES59209517581497961835,TRX_N-01134-35552550,2024-09-20T09:10:10,Zarautz,expenses,cash,-100.0,-70234.44
buyer_2,Carmen,40,ES59209517581497961835,TRX_N-01135-64127013,2024-09-20T12:19:46,Zarautz,expenses,repairs,-72.96,-70307.4
buyer_2,Carmen,40,ES59209517581497961835,TRX_N-01136-26741971,2024-09-20T11:17:31,Zarautz,expenses,gifts,-719.23,-71026.63
buyer_2,Carmen,40,ES59209517581497961835,TRX_N-01137-91330264,2024-09-21T21:26:12,Zarautz,expenses,transport,-48.52,-71075.15
buyer_2,Carmen,40,ES59209517581497961835,TRX_N-01138-88608862,2024-09-22T16:29:37,Zarautz,expenses,clothing,-61.06,-71136.21
buyer_2,Carmen,40,ES59209517581497961835,TRX_N-01139-21837396,2024-09-24T09:27:07,Zarautz,expenses,cash,-100.0,-71236.21
buyer_2,Carmen,40,ES59209517581497961835,TRX_N-01140-25553160,2024-09-26T10:50:21,Zarautz,expenses,food,-90.28,-71326.49
buyer_2,Carmen,40,ES59209517581497961835,TRX_N-01141-43350058,2024-09-26T23:55:32,Erandio,expenses,cash,-100.0,-71426.49
buyer_2,Carmen,40,ES59209517581497961835,TRX_N-01142-23671749,2024-09-29T14:23:39,Zarautz,expenses,children,-198.82,-71625.31
buyer_2,Carmen,40,ES59209517581497961835,TRX_N-01143-33250378,2024-10-01T18:47:03,Zarautz,incomes,salary,1341.82,-70283.49
buyer_2,Carmen,40,ES59209517581497961835,TRX_N-01144-53945691,2024-10-01T18:47:03,Zarautz,incomes,salary_partner,1084.03,-69199.46
buyer_2,Carmen,40,ES59209517581497961835,TRX_N-01145-48185590,2024-10-01T18:47:03,Zarautz,incomes,extra_income,152.67,-69046.79
buyer_2,Carmen,40,ES59209517581497961835,TRX_N-01146-74615574,2024-10-01T10:40:24,Zarautz,expenses,repairs,-96.78,-69143.57
buyer_2,Carmen,40,ES59209517581497961835,TRX_N-01147-98706623,2024-10-02T21:58:30,Zarautz,expenses,food,-94.39,-69237.96
buyer_2,Carmen,40,ES59209517581497961835,TRX_N-01148-76463533,2024-10-04T12:13:33,Zarautz,expenses,mortgage,-1091.91,-70329.87
buyer_2,Carmen,40,ES59209517581497961835,TRX_N-01149-85832619,2024-10-04T09:31:49,Hondarribia,expenses,food,-61.51,-70391.38
buyer_2,Carmen,40,ES59209517581497961835,TRX_N-01150-21913493,2024-10-04T20:58:35,Zarautz,expenses,travel,-558.37,-70949.75
buyer_2,Carmen,40,ES59209517581497961835,TRX_N-01151-35266714,2024-10-05T09:03:42,Zarautz,expenses,electricity,-86.72,-71036.47
buyer_2,Carmen,40,ES59209517581497961835,TRX_N-01152-59190437,2024-10-05T15:53:38,Alegría-Dulantzi,expenses,food,-117.58,-71154.05
buyer_2,Carmen,40,ES59209517581497961835,TRX_N-01153-83792762,2024-10-06T09:05:08,Zarautz,expenses,internet,-42.0,-71196.05
buyer_2,Carmen,40,ES59209517581497961835,TRX_N-01154-53848441,2024-10-07T08:03:33,Zarautz,expenses,gas,-92.4,-71288.45
buyer_2,Carmen,40,ES59209517581497961835,TRX_N-01155-82014056,2024-10-08T16:11:57,Zarautz,expenses,water,-32.28,-71320.73
buyer_2,Carmen,40,ES59209517581497961835,TRX_N-01156-07618499,2024-10-08T14:49:20,Zarautz,expenses,phone,-38.7,-71359.43
buyer_2,Carmen,40,ES59209517581497961835,TRX_N-01157-82789834,2024-10-08T03:07:44,Oyón-Oion,expenses,food,-117.41,-71476.84
buyer_2,Carmen,40,ES59209517581497961835,TRX_N-01158-11937994,2024-10-09T14:11:17,Sopela,expenses,clothing,-113.54,-71590.38
buyer_3,Ana,35,ES73209501612803164263,TRX_N-00001-04294266,2022-01-01T07:06:37,Amurrio,incomes,salary,1494.33,3014.4
buyer_3,Ana,35,ES73209501612803164263,TRX_N-00002-10241838,2022-01-01T07:06:37,Amurrio,incomes,salary_partner,999.05,4013.45
buyer_3,Ana,35,ES73209501612803164263,TRX_N-00003-76331447,2022-01-01T16:18:17,Amurrio,expenses,cash,-100.0,3913.45
buyer_3,Ana,35,ES73209501612803164263,TRX_N-00004-63167904,2022-01-02T13:06:06,Amurrio,expenses,travel,-1542.16,2371.29
buyer_3,Ana,35,ES73209501612803164263,TRX_N-00005-59708354,2022-01-02T23:50:13,Amurrio,expenses,gifts,-755.74,1615.55
buyer_3,Ana,35,ES73209501612803164263,TRX_N-00006-18238174,2022-01-03T12:18:29,Amurrio,expenses,food,-65.45,1550.1
buyer_3,Ana,35,ES73209501612803164263,TRX_N-00007-27734130,2022-01-03T11:20:44,Amurrio,expenses,leisure,-69.34,1480.76
buyer_3,Ana,35,ES73209501612803164263,TRX_N-00008-77706911,2022-01-04T09:25:10,Amurrio,expenses,mortgage,-938.86,541.9
buyer_3,Ana,35,ES73209501612803164263,TRX_N-00009-74558388,2022-01-04T13:15:17,Amurrio,expenses,healthcare,-115.84,426.06
buyer_3,Ana,35,ES73209501612803164263,TRX_N-00010-90467569,2022-01-05T08:41:16,Amurrio,expenses,electricity,-49.7,376.36
buyer_3,Ana,35,ES73209501612803164263,TRX_N-00011-91926731,2022-01-05T13:49:41,Amurrio,expenses,education,-77.66,298.7
buyer_3,Ana,35,ES73209501612803164263,TRX_N-00012-69368951,2022-01-05T08:47:52,Leioa,expenses,cash,-100.0,198.7
buyer_3,Ana,35,ES73209501612803164263,TRX_N-00013-58885477,2022-01-05T08:12:28,Amurrio,expenses,appliances,-371.59,-172.89
buyer_3,Ana,35,ES73209501612803164263,TRX_N-00014-40369913,2022-01-06T14:25:26,Amurrio,expenses,gas,-108.29,-281.18
buyer_3,Ana,35,ES73209501612803164263,TRX_N-00015-36172385,2022-01-06T12:32:04,Amurrio,expenses,internet,-42.0,-323.18
buyer_3,Ana,35,ES73209501612803164263,TRX_N-00016-53890832,2022-01-06T11:33:19,Amurrio,expenses,repairs,-179.16,-502.34
buyer_3,Ana,35,ES73209501612803164263,TRX_N-00017-16993637,2022-01-07T19:28:22,Amurrio,expenses,transport,-63.92,-566.26
buyer_3,Ana,35,ES73209501612803164263,TRX_N-00018-35529481,2022-01-07T11:03:14,Amurrio,expenses,children,-110.97,-677.23
buyer_3,Ana,35,ES73209501612803164263,TRX_N-00019-89040329,2022-01-08T13:46:55,Amurrio,expenses,phone,-38.78,-716.01
buyer_3,Ana,35,ES73209501612803164263,TRX_N-00020-88323363,2022-01-08T22:56:05,Amurrio,expenses,water,-41.95,-757.96
buyer_3,Ana,35,ES73209501612803164263,TRX_N-00021-83716592,2022-01-08T17:10:24,Amurrio,expenses,transport,-65.2,-823.16
buyer_3,Ana,35,ES73209501612803164263,TRX_N-00022-92723863,2022-01-08T23:53:28,Amurrio,expenses,cash,-100.0,-923.16
buyer_3,Ana,35,ES73209501612803164263,TRX_N-00023-72987029,2022-01-08T09:51:10,Amurrio,expenses,children,-75.37,-998.53
buyer_3,Ana,35,ES73209501612803164263,TRX_N-00024-02483567,2022-01-13T10:49:28,Amurrio,expenses,leisure,-73.03,-1071.56
buyer_3,Ana,35,ES73209501612803164263,TRX_N-00025-91555371,2022-01-15T09:35:04,Hondarribia,expenses,cash,-100.0,-1171.56
buyer_3,Ana,35,ES73209501612803164263,TRX_N-00026-05255882,2022-01-15T23:26:32,Amurrio,expenses,appliances,-75.64,-1247.2
buyer_3,Ana,35,ES73209501612803164263,TRX_N-00027-01339095,2022-01-16T15:56:52,Amurrio,expenses,cash,-100.0,-1347.2
buyer_3,Ana,35,ES73209501612803164263,TRX_N-00028-81396741,2022-01-17T18:46:28,Amurrio,expenses,food,-78.72,-1425.92
buyer_3,Ana,35,ES73209501612803164263,TRX_N-00029-23721489,2022-01-17T09:23:02,Amurrio,expenses,leisure,-19.18,-1445.1
buyer_3,Ana,35,ES73209501612803164263,TRX_N-00030-48326463,2022-01-18T11:21:09,Amurrio,expenses,transport,-57.17,-1502.27
buyer_3,Ana,35,ES73209501612803164263,TRX_N-00031-85132343,2022-01-19T11:43:23,Amurrio,expenses,leisure,-42.98,-1545.25
buyer_3,Ana,35,ES73209501612803164263,TRX_N-00032-24328933,2022-01-20T12:55:34,Amurrio,expenses,cash,-100.0,-1645.25
buyer_3,Ana,35,ES73209501612803164263,TRX_N-00033-20664179,2022-01-20T20:37:12,Amurrio,expenses,appliances,-306.3,-1951.55
buyer_3,Ana,35,ES73209501612803164263,TRX_N-00034-01544060,2022-01-20T19:46:41,Amurrio,expenses,children,-258.78,-2210.33
buyer_3,Ana,35,ES73209501612803164263,TRX_N-00035-77150545,2022-01-21T17:20:31,Amurrio,expenses,education,-75.26,-2285.59
buyer_3,Ana,35,ES73209501612803164263,TRX_N-00036-13299480,2022-01-21T16:30:10,Amurrio,expenses,cash,-100.0,-2385.59
buyer_3,Ana,35,ES73209501612803164263,TRX_N-00037-58134028,2022-01-21T02:37:34,Amurrio,expenses,gifts,-611.96,-2997.55
buyer_3,Ana,35,ES73209501612803164263,TRX_N-00038-42473112,2022-01-22T16:22:12,Amurrio,expenses,healthcare,-144.45,-3142.0
buyer_3,Ana,35,ES73209501612803164263,TRX_N-00039-77422201,2022-01-25T08:58:06,Amurrio,expenses,cash,-100.0,-3242.0
buyer_3,Ana,35,ES73209501612803164263,TRX_N-00040-98921440,2022-01-25T17:53:42,Amurrio,expenses,travel,-492.91,-3734.91
buyer_3,Ana,35,ES73209501612803164263,TRX_N-00041-76012454,2022-01-26T12:02:35,Getxo,expenses,transport,-67.43,-3802.34
buyer_3,Ana,35,ES73209501612803164263,TRX_N-00042-73751513,2022-01-27T15:07:23,Amurrio,expenses,appliances,-412.12,-4214.46
buyer_3,Ana,35,ES73209501612803164263,TRX_N-00043-19946827,2022-01-28T10:56:40,Alegría-Dulantzi,expenses,food,-69.8,-4284.26
buyer_3,Ana,35,ES73209501612803164263,TRX_N-00044-29809013,2022-01-28T22:23:49,Amurrio,expenses,children,-148.27,-4432.53
buyer_3,Ana,35,ES73209501612803164263,TRX_N-00045-95877693,2022-01-31T07:20:30,Amurrio,expenses,leisure,-84.29,-4516.82
buyer_3,Ana,35,ES73209501612803164263,TRX_N-00046-44251728,2022-02-01T23:53:23,Amurrio,incomes,salary,1494.33,-3022.49
buyer_3,Ana,35,ES73209501612803164263,TRX_N-00047-71282929,2022-02-01T23:53:23,Amurrio,incomes,salary_partner,999.05,-2023.44
buyer_3,Ana,35,ES73209501612803164263,TRX_N-00048-23486740,2022-02-01T01:56:58,Zarautz,expenses,food,-108.79,-2132.23
buyer_3,Ana,35,ES73209501612803164263,TRX_N-00049-69210368,2022-02-01T14:06:08,Irun,expenses,transport,-82.09,-2214.32
buyer_3,Ana,35,ES73209501612803164263,TRX_N-00050-51470375,2022-02-01T17:38:45,Amurrio,expenses,repairs,-314.59,-2528.91
buyer_3,Ana,35,ES73209501612803164263,TRX_N-00051-05563563,2022-02-02T19:45:55,Amurrio,expenses,repairs,-169.47,-2698.38
buyer_3,Ana,35,ES73209501612803164263,TRX_N-00052-59717127,2022-02-03T10:35:49,Amurrio,expenses,food,-66.13,-2764.51
buyer_3,Ana,35,ES73209501612803164263,TRX_N-00053-81583115,2022-02-04T21:45:03,Amurrio,expenses,mortgage,-938.86,-3703.37
buyer_3,Ana,35,ES73209501612803164263,TRX_N-00054-80207860,2022-02-05T16:00:38,Amurrio,expenses,water,-20.63,-3724.0
buyer_3,Ana,35,ES73209501612803164263,TRX_N-00055-10648614,2022-02-05T10:52:34,Amurrio,expenses,electricity,-88.27,-3812.27
buyer_3,Ana,35,ES73209501612803164263,TRX_N-00056-12421881,2022-02-05T20:31:26,Amurrio,expenses,internet,-42.0,-3854.27
buyer_3,Ana,35,ES73209501612803164263,TRX_N-00057-29517586,2022-02-08T01:17:59,Amurrio,expenses,gas,-80.74,-3935.01
buyer_3,Ana,35,ES73209501612803164263,TRX_N-00058-02169953,2022-02-08T17:03:51,Amurrio,expenses,phone,-33.79,-3968.8
buyer_3,Ana,35,ES73209501612803164263,TRX_N-00059-83423693,2022-02-08T04:39:13,Pasaia,expenses,appliances,-257.15,-4225.95
buyer_3,Ana,35,ES73209501612803164263,TRX_N-00060-42406751,2022-02-08T14:46:51,Amurrio,expenses,repairs,-127.78,-4353.73
buyer_3,Ana,35,ES73209501612803164263,TRX_N-00061-38766019,2022-02-09T23:55:31,Amurrio,expenses,repairs,-127.38,-4481.11
buyer_3,Ana,35,ES73209501612803164263,TRX_N-00062-80842898,2022-02-12T23:45:17,Amurrio,expenses,transport,-60.47,-4541.58
buyer_3,Ana,35,ES73209501612803164263,TRX_N-00063-28411470,2022-02-12T08:53:24,Amurrio,expenses,repairs,-298.44,-4840.02
buyer_3,Ana,35,ES73209501612803164263,TRX_N-00064-28814712,2022-02-15T20:25:30,Amurrio,expenses,cash,-100.0,-4940.02
buyer_3,Ana,35,ES73209501612803164263,TRX_N-00065-21533754,2022-02-16T08:49:54,Amurrio,expenses,food,-76.95,-5016.97
buyer_3,Ana,35,ES73209501612803164263,TRX_N-00066-37247424,2022-02-16T09:48:39,Amurrio,expenses,transport,-71.15,-5088.12
buyer_3,Ana,35,ES73209501612803164263,TRX_N-00067-02155046,2022-02-17T23:27:55,Andoain,expenses,food,-92.28,-5180.4
buyer_3,Ana,35,ES73209501612803164263,TRX_N-00068-08944658,2022-02-17T05:42:20,Amurrio,expenses,transport,-56.52,-5236.92
buyer_3,Ana,35,ES73209501612803164263,TRX_N-00069-46423604,2022-02-18T15:50:20,Amurrio,expenses,food,-110.04,-5346.96
buyer_3,Ana,35,ES73209501612803164263,TRX_N-00070-99732246,2022-02-21T11:14:52,Andoain,expenses,repairs,-288.86,-5635.82
buyer_3,Ana,35,ES73209501612803164263,TRX_N-00071-73447430,2022-02-22T10:52:42,Amurrio,expenses,children,-215.63,-5851.45
buyer_3,Ana,35,ES73209501612803164263,TRX_N-00072-47276169,2022-02-23T17:58:53,Amurrio,expenses,food,-113.39,-5964.84
buyer_3,Ana,35,ES73209501612803164263,TRX_N-00073-85363038,2022-02-23T15:19:23,Labastida,expenses,cash,-100.0,-6064.84
buyer_3,Ana,35,ES73209501612803164263,TRX_N-00074-43484679,2022-02-24T16:54:21,Arrasate,expenses,food,-118.14,-6182.98
buyer_3,Ana,35,ES73209501612803164263,TRX_N-00075-71573077,2022-02-25T13:34:56,Zuia,expenses,leisure,-59.83,-6242.81
buyer_3,Ana,35,ES73209501612803164263,TRX_N-00076-18053421,2022-02-25T00:01:24,Amurrio,expenses,clothing,-95.84,-6338.65
buyer_3,Ana,35,ES73209501612803164263,TRX_N-00077-96752174,2022-02-28T10:09:13,Amurrio,expenses,gifts,-417.77,-6756.42
buyer_3,Ana,35,ES73209501612803164263,TRX_N-00078-25192247,2022-03-01T12:24:48,Amurrio,incomes,salary,1494.33,-5262.09
buyer_3,Ana,35,ES73209501612803164263,TRX_N-00079-20041906,2022-03-01T12:24:48,Amurrio,incomes,salary_partner,999.05,-4263.04
buyer_3,Ana,35,ES73209501612803164263,TRX_N-00080-32567848,2022-03-01T12:24:48,Amurrio,incomes,extra_income,244.88,-4018.16
buyer_3,Ana,35,ES73209501612803164263,TRX_N-00081-65509696,2022-03-01T15:18:06,Amurrio,expenses,cash,-100.0,-4118.16
buyer_3,Ana,35,ES73209501612803164263,TRX_N-00082-35455787,2022-03-04T19:00:17,Amurrio,expenses,mortgage,-938.86,-5057.02
buyer_3,Ana,35,ES73209501612803164263,TRX_N-00083-15289587,2022-03-04T16:52:01,Amurrio,expenses,food,-119.1,-5176.12
buyer_3,Ana,35,ES73209501612803164263,TRX_N-00084-54322131,2022-03-04T12:58:47,Amurrio,expenses,leisure,-71.16,-5247.28
buyer_3,Ana,35,ES73209501612803164263,TRX_N-00085-10893878,2022-03-05T15:15:26,Amurrio,expenses,gas,-98.84,-5346.12
buyer_3,Ana,35,ES73209501612803164263,TRX_N-00086-99737142,2022-03-05T15:58:59,Amurrio,expenses,internet,-42.0,-5388.12
buyer_3,Ana,35,ES73209501612803164263,TRX_N-00087-28294295,2022-03-06T22:03:35,Hondarribia,expenses,leisure,-53.99,-5442.11
buyer_3,Ana,35,ES73209501612803164263,TRX_N-00088-78750693,2022-03-07T08:09:39,Amurrio,expenses,cash,-100.0,-5542.11
buyer_3,Ana,35,ES73209501612803164263,TRX_N-00089-02576265,2022-03-08T09:35:28,Amurrio,expenses,water,-23.09,-5565.2
buyer_3,Ana,35,ES73209501612803164263,TRX_N-00090-85520208,2022-03-08T19:45:35,Amurrio,expenses,electricity,-37.28,-5602.48
buyer_3,Ana,35,ES73209501612803164263,TRX_N-00091-68020518,2022-03-08T23:15:35,Amurrio,expenses,phone,-34.28,-5636.76
buyer_3,Ana,35,ES73209501612803164263,TRX_N-00092-65210462,2022-03-09T15:47:57,Amurrio,expenses,food,-65.98,-5702.74
buyer_3,Ana,35,ES73209501612803164263,TRX_N-00093-95510149,2022-03-10T19:31:06,Andoain,expenses,leisure,-45.01,-5747.75
buyer_3,Ana,35,ES73209501612803164263,TRX_N-00094-10601370,2022-03-10T08:20:19,Amurrio,expenses,education,-71.05,-5818.8
buyer_3,Ana,35,ES73209501612803164263,TRX_N-00095-03654768,2022-03-12T09:06:07,Amurrio,expenses,gifts,-709.52,-6528.32
buyer_3,Ana,35,ES73209501612803164263,TRX_N-00096-38071383,2022-03-14T10:45:37,Amurrio,expenses,cash,-100.0,-6628.32
buyer_3,Ana,35,ES73209501612803164263,TRX_N-00097-04519374,2022-03-15T21:03:34,Amurrio,expenses,transport,-65.43,-6693.75
buyer_3,Ana,35,ES73209501612803164263,TRX_N-00098-92592496,2022-03-15T04:10:49,Amurrio,expenses,repairs,-172.04,-6865.79
buyer_3,Ana,35,ES73209501612803164263,TRX_N-00099-84155001,2022-03-17T11:17:41,Amurrio,expenses,food,-110.57,-6976.36
buyer_3,Ana,35,ES73209501612803164263,TRX_N-00100-92217714,2022-03-17T16:05:46,Barakaldo,expenses,repairs,-56.09,-7032.45
buyer_3,Ana,35,ES73209501612803164263,TRX_N-00101-89238165,2022-03-18T10:46:57,Amurrio,expenses,leisure,-54.7,-7087.15
buyer_3,Ana,35,ES73209501612803164263,TRX_N-00102-98244489,2022-03-20T12:42:02,Amurrio,expenses,healthcare,-128.51,-7215.66
buyer_3,Ana,35,ES73209501612803164263,TRX_N-00103-55854066,2022-03-20T13:06:36,Durango,expenses,education,-50.08,-7265.74
buyer_3,Ana,35,ES73209501612803164263,TRX_N-00104-23352699,2022-03-20T11:52:05,Amurrio,expenses,children,-119.87,-7385.61
buyer_3,Ana,35,ES73209501612803164263,TRX_N-00105-33238277,2022-03-21T12:44:10,Amurrio,expenses,food,-120.86,-7506.47
buyer_3,Ana,35,ES73209501612803164263,TRX_N-00106-63113998,2022-03-22T07:18:05,Amurrio,expenses,healthcare,-173.35,-7679.82
buyer_3,Ana,35,ES73209501612803164263,TRX_N-00107-65077043,2022-03-23T18:08:51,Amurrio,expenses,clothing,-116.78,-7796.6
buyer_3,Ana,35,ES73209501612803164263,TRX_N-00108-73907866,2022-03-24T14:38:53,Labastida,expenses,appliances,-250.33,-8046.93
buyer_3,Ana,35,ES73209501612803164263,TRX_N-00109-39153419,2022-03-25T18:55:10,Amurrio,expenses,leisure,-75.15,-8122.08
buyer_3,Ana,35,ES73209501612803164263,TRX_N-00110-25614712,2022-03-29T19:23:14,Amurrio,expenses,food,-100.15,-8222.23
buyer_3,Ana,35,ES73209501612803164263,TRX_N-00111-38385659,2022-03-29T18:24:06,Amurrio,expenses,clothing,-76.83,-8299.06
buyer_3,Ana,35,ES73209501612803164263,TRX_N-00112-98209315,2022-03-29T18:54:21,Amurrio,expenses,appliances,-275.6,-8574.66
buyer_3,Ana,35,ES73209501612803164263,TRX_N-00113-52426985,2022-03-31T04:33:21,Amurrio,expenses,transport,-86.12,-8660.78
buyer_3,Ana,35,ES73209501612803164263,TRX_N-00114-16234147,2022-03-31T13:30:11,Llodio,expenses,leisure,-72.84,-8733.62
buyer_3,Ana,35,ES73209501612803164263,TRX_N-00115-65907349,2022-03-31T16:18:26,Erandio,expenses,cash,-100.0,-8833.62
buyer_3,Ana,35,ES73209501612803164263,TRX_N-00116-32237982,2022-04-01T11:27:32,Amurrio,incomes,salary,1494.33,-7339.29
buyer_3,Ana,35,ES73209501612803164263,TRX_N-00117-62235770,2022-04-01T11:27:32,Amurrio,incomes,salary_partner,999.05,-6340.24
buyer_3,Ana,35,ES73209501612803164263,TRX_N-00118-65736487,2022-04-01T09:45:21,Amurrio,expenses,leisure,-34.39,-6374.63
buyer_3,Ana,35,ES73209501612803164263,TRX_N-00119-47578647,2022-04-01T17:30:42,Amurrio,expenses,cash,-100.0,-6474.63
buyer_3,Ana,35,ES73209501612803164263,TRX_N-00120-13196963,2022-04-04T00:05:01,Amurrio,expenses,mortgage,-938.86,-7413.49
buyer_3,Ana,35,ES73209501612803164263,TRX_N-00121-54060877,2022-04-05T10:19:09,Amurrio,expenses,water,-30.85,-7444.34
buyer_3,Ana,35,ES73209501612803164263,TRX_N-00122-62484622,2022-04-05T18:08:42,Amurrio,expenses,electricity,-44.28,-7488.62
buyer_3,Ana,35,ES73209501612803164263,TRX_N-00123-63606973,2022-04-05T18:42:12,Amurrio,expenses,gas,-53.75,-7542.37
buyer_3,Ana,35,ES73209501612803164263,TRX_N-00124-18918363,2022-04-05T20:57:21,Amurrio,expenses,internet,-42.0,-7584.37
buyer_3,Ana,35,ES73209501612803164263,TRX_N-00125-20002630,2022-04-05T11:47:35,Amurrio,expenses,phone,-35.22,-7619.59
buyer_3,Ana,35,ES73209501612803164263,TRX_N-00126-88274009,2022-04-05T14:23:41,Errenteria,expenses,transport,-61.6,-7681.19
buyer_3,Ana,35,ES73209501612803164263,TRX_N-00127-60299422,2022-04-05T13:08:13,Amurrio,expenses,children,-152.9,-7834.09
buyer_3,Ana,35,ES73209501612803164263,TRX_N-00128-80911422,2022-04-08T14:04:55,Amurrio,expenses,leisure,-21.5,-7855.59
buyer_3,Ana,35,ES73209501612803164263,TRX_N-00129-70118387,2022-04-08T16:27:45,Amurrio,expenses,cash,-100.0,-7955.59
buyer_3,Ana,35,ES73209501612803164263,TRX_N-00130-00156055,2022-04-09T09:49:50,Amurrio,expenses,clothing,-140.19,-8095.78
buyer_3,Ana,35,ES73209501612803164263,TRX_N-00131-86459146,2022-04-09T15:41:01,Amurrio,expenses,cash,-100.0,-8195.78
buyer_3,Ana,35,ES73209501612803164263,TRX_N-00132-13758258,2022-04-10T17:45:41,Amurrio,expenses,cash,-100.0,-8295.78
buyer_3,Ana,35,ES73209501612803164263,TRX_N-00133-69147404,2022-04-12T16:32:42,Amurrio,expenses,education,-66.38,-8362.16
buyer_3,Ana,35,ES73209501612803164263,TRX_N-00134-95979641,2022-04-14T16:23:39,Amurrio,expenses,leisure,-66.42,-8428.58
buyer_3,Ana,35,ES73209501612803164263,TRX_N-00135-12522825,2022-04-14T12:50:16,Amurrio,expenses,cash,-100.0,-8528.58
buyer_3,Ana,35,ES73209501612803164263,TRX_N-00136-33670816,2022-04-14T19:06:29,Amurrio,expenses,children,-247.59,-8776.17
buyer_3,Ana,35,ES73209501612803164263,TRX_N-00137-50906261,2022-04-21T08:48:53,Amurrio,expenses,gifts,-673.32,-9449.49
buyer_3,Ana,35,ES73209501612803164263,TRX_N-00138-15403563,2022-04-21T07:22:19,Amurrio,expenses,children,-226.19,-9675.68
buyer_3,Ana,35,ES73209501612803164263,TRX_N-00139-77406389,2022-04-22T15:18:55,Amurrio,expenses,food,-94.07,-9769.75
buyer_3,Ana,35,ES73209501612803164263,TRX_N-00140-03320547,2022-04-24T11:09:16,Amurrio,expenses,education,-48.6,-9818.35
buyer_3,Ana,35,ES73209501612803164263,TRX_N-00141-03645944,2022-04-24T20:49:35,Amurrio,expenses,cash,-100.0,-9918.35
buyer_3,Ana,35,ES73209501612803164263,TRX_N-00142-81030519,2022-04-25T21:40:26,Amurrio,expenses,clothing,-115.54,-10033.89
buyer_3,Ana,35,ES73209501612803164263,TRX_N-00143-65191028,2022-04-25T10:25:46,Elciego,expenses,cash,-100.0,-10133.89
buyer_3,Ana,35,ES73209501612803164263,TRX_N-00144-47887225,2022-04-26T16:09:19,Amurrio,expenses,leisure,-60.05,-10193.94
buyer_3,Ana,35,ES73209501612803164263,TRX_N-00145-33013734,2022-04-27T10:34:43,Amurrio,expenses,gifts,-808.47,-11002.41
buyer_3,Ana,35,ES73209501612803164263,TRX_N-00146-77151773,2022-04-29T11:28:07,Amurrio,expenses,gifts,-785.28,-11787.69
buyer_3,Ana,35,ES73209501612803164263,TRX_N-00147-88940580,2022-04-30T15:08:20,Amurrio,expenses,repairs,-157.55,-11945.24
buyer_3,Ana,35,ES73209501612803164263,TRX_N-00148-34783858,2022-05-01T22:32:33,Amurrio,incomes,salary,1494.33,-10450.91
buyer_3,Ana,35,ES73209501612803164263,TRX_N-00149-63742804,2022-05-01T22:32:33,Amurrio,incomes,salary_partner,999.05,-9451.86
buyer_3,Ana,35,ES73209501612803164263,TRX_N-00150-13377789,2022-05-01T20:44:47,Amurrio,expenses,food,-108.18,-9560.04
buyer_3,Ana,35,ES73209501612803164263,TRX_N-00151-18665238,2022-05-01T15:19:03,Amurrio,expenses,children,-129.21,-9689.25
buyer_3,Ana,35,ES73209501612803164263,TRX_N-00152-81758124,2022-05-03T19:49:17,Amurrio,expenses,leisure,-71.52,-9760.77
buyer_3,Ana,35,ES73209501612803164263,TRX_N-00153-33383472,2022-05-03T23:35:41,Amurrio,expenses,cash,-100.0,-9860.77
buyer_3,Ana,35,ES73209501612803164263,TRX_N-00154-32503024,2022-05-04T20:08:50,Amurrio,expenses,mortgage,-938.86,-10799.63
buyer_3,Ana,35,ES73209501612803164263,TRX_N-00155-47836357,2022-05-04T08:49:46,Amurrio,expenses,leisure,-20.98,-10820.61
buyer_3,Ana,35,ES73209501612803164263,TRX_N-00156-55447041,2022-05-05T19:18:38,Amurrio,expenses,leisure,-30.24,-10850.85
buyer_3,Ana,35,ES73209501612803164263,TRX_N-00157-94999086,2022-05-06T14:03:05,Amurrio,expenses,electricity,-59.14,-10909.99
buyer_3,Ana,35,ES73209501612803164263,TRX_N-00158-45810756,2022-05-08T10:45:34,Amurrio,expenses,water,-30.07,-10940.06
buyer_3,Ana,35,ES73209501612803164263,TRX_N-00159-59333996,2022-05-08T08:11:19,Amurrio,expenses,gas,-91.62,-11031.68
buyer_3,Ana,35,ES73209501612803164263,TRX_N-00160-76811063,2022-05-08T17:00:28,Amurrio,expenses,internet,-42.0,-11073.68
buyer_3,Ana,35,ES73209501612803164263,TRX_N-00161-35364118,2022-05-08T16:51:39,Amurrio,expenses,phone,-40.51,-11114.19
buyer_3,Ana,35,ES73209501612803164263,TRX_N-00162-31286152,2022-05-11T22:02:44,Amurrio,expenses,healthcare,-134.4,-11248.59
buyer_3,Ana,35,ES73209501612803164263,TRX_N-00163-88443888,2022-05-13T22:16:56,Amurrio,expenses,food,-77.89,-11326.48
buyer_3,Ana,35,ES73209501612803164263,TRX_N-00164-10073993,2022-05-13T18:35:57,Amurrio,expenses,children,-137.15,-11463.63
buyer_3,Ana,35,ES73209501612803164263,TRX_N-00165-68582075,2022-05-16T13:53:29,Irun,expenses,leisure,-38.77,-11502.4
buyer_3,Ana,35,ES73209501612803164263,TRX_N-00166-05911416,2022-05-17T19:17:11,Amurrio,expenses,appliances,-264.02,-11766.42
buyer_3,Ana,35,ES73209501612803164263,TRX_N-00167-08949928,2022-05-19T03:33:33,Amurrio,expenses,food,-87.73,-11854.15
buyer_3,Ana,35,ES73209501612803164263,TRX_N-00168-00414629,2022-05-19T11:48:41,Amurrio,expenses,cash,-100.0,-11954.15
buyer_3,Ana,35,ES73209501612803164263,TRX_N-00169-86490826,2022-05-19T16:31:09,Amurrio,expenses,appliances,-287.28,-12241.43
buyer_3,Ana,35,ES73209501612803164263,TRX_N-00170-34772783,2022-05-20T07:33:45,Amurrio,expenses,children,-276.81,-12518.24
buyer_3,Ana,35,ES73209501612803164263,TRX_N-00171-01462407,2022-05-21T14:48:23,Amurrio,expenses,transport,-40.86,-12559.1
buyer_3,Ana,35,ES73209501612803164263,TRX_N-00172-45169930,2022-05-21T19:00:19,Amurrio,expenses,education,-76.32,-12635.42
buyer_3,Ana,35,ES73209501612803164263,TRX_N-00173-14802107,2022-05-21T02:23:03,Elciego,expenses,cash,-100.0,-12735.42
buyer_3,Ana,35,ES73209501612803164263,TRX_N-00174-65425905,2022-05-23T12:31:43,Amurrio,expenses,leisure,-53.8,-12789.22
buyer_3,Ana,35,ES73209501612803164263,TRX_N-00175-98753597,2022-05-23T10:03:44,Amurrio,expenses,appliances,-374.85,-13164.07
buyer_3,Ana,35,ES73209501612803164263,TRX_N-00176-21400634,2022-05-23T12:39:26,Amurrio,expenses,gifts,-726.38,-13890.45
buyer_3,Ana,35,ES73209501612803164263,TRX_N-00177-47558485,2022-05-25T17:57:17,Amurrio,expenses,food,-77.44,-13967.89
buyer_3,Ana,35,ES73209501612803164263,TRX_N-00178-44664813,2022-05-25T17:19:38,Amurrio,expenses,children,-102.5,-14070.39
buyer_3,Ana,35,ES73209501612803164263,TRX_N-00179-78634941,2022-05-26T20:12:59,Getxo,expenses,repairs,-294.25,-14364.64
buyer_3,Ana,35,ES73209501612803164263,TRX_N-00180-88574342,2022-05-27T18:56:46,Amurrio,expenses,leisure,-75.2,-14439.84
buyer_3,Ana,35,ES73209501612803164263,TRX_N-00181-53250950,2022-05-28T14:09:51,Amurrio,expenses,transport,-41.95,-14481.79
buyer_3,Ana,35,ES73209501612803164263,TRX_N-00182-78342450,2022-05-28T15:48:43,Sopela,expenses,leisure,-41.07,-14522.86
buyer_3,Ana,35,ES73209501612803164263,TRX_N-00183-31496027,2022-05-28T16:32:23,Amurrio,expenses,repairs,-167.13,-14689.99
buyer_3,Ana,35,ES73209501612803164263,TRX_N-00184-53848423,2022-05-30T08:20:54,Pasaia,expenses,food,-70.44,-14760.43
buyer_3,Ana,35,ES73209501612803164263,TRX_N-00185-55169514,2022-05-30T14:03:21,Amurrio,expenses,cash,-100.0,-14860.43
buyer_3,Ana,35,ES73209501612803164263,TRX_N-00186-85002192,2022-05-31T19:00:27,Amurrio,expenses,cash,-100.0,-14960.43
buyer_3,Ana,35,ES73209501612803164263,TRX_N-00187-61311909,2022-06-01T14:22:14,Amurrio,incomes,salary,1494.33,-13466.1
buyer_3,Ana,35,ES73209501612803164263,TRX_N-00188-06100402,2022-06-01T14:22:14,Amurrio,incomes,salary_partner,999.05,-12467.05
buyer_3,Ana,35,ES73209501612803164263,TRX_N-00189-48981113,2022-06-01T14:22:14,Amurrio,incomes,salary_bonus,1147.44,-11319.61
buyer_3,Ana,35,ES73209501612803164263,TRX_N-00190-45769011,2022-06-01T14:22:14,Amurrio,incomes,salary_partner_bonus,713.05,-10606.56
buyer_3,Ana,35,ES73209501612803164263,TRX_N-00191-72071779,2022-06-03T16:19:19,Amurrio,expenses,children,-227.95,-10834.51
buyer_3,Ana,35,ES73209501612803164263,TRX_N-00192-73725513,2022-06-04T10:04:24,Amurrio,expenses,mortgage,-938.86,-11773.37
buyer_3,Ana,35,ES73209501612803164263,TRX_N-00193-90750078,2022-06-04T20:51:59,Amurrio,expenses,transport,-63.46,-11836.83
buyer_3,Ana,35,ES73209501612803164263,TRX_N-00194-49111720,2022-06-04T16:49:02,Amurrio,expenses,leisure,-51.31,-11888.14
buyer_3,Ana,35,ES73209501612803164263,TRX_N-00195-53385976,2022-06-04T15:17:57,Amurrio,expenses,repairs,-119.98,-12008.12
buyer_3,Ana,35,ES73209501612803164263,TRX_N-00196-02817649,2022-06-05T09:22:32,Amurrio,expenses,gas,-30.44,-12038.56
buyer_3,Ana,35,ES73209501612803164263,TRX_N-00197-36126635,2022-06-05T16:06:12,Amurrio,expenses,phone,-38.68,-12077.24
buyer_3,Ana,35,ES73209501612803164263,TRX_N-00198-32298808,2022-06-05T10:26:12,Amurrio,expenses,cash,-100.0,-12177.24
buyer_3,Ana,35,ES73209501612803164263,TRX_N-00199-74923172,2022-06-06T17:31:07,Amurrio,expenses,water,-32.36,-12209.6
buyer_3,Ana,35,ES73209501612803164263,TRX_N-00200-75596313,2022-06-07T08:51:41,Amurrio,expenses,electricity,-40.75,-12250.35
buyer_3,Ana,35,ES73209501612803164263,TRX_N-00201-55151279,2022-06-07T15:20:58,Amurrio,expenses,internet,-42.0,-12292.35
buyer_3,Ana,35,ES73209501612803164263,TRX_N-00202-76562217,2022-06-08T23:28:38,Amurrio,expenses,cash,-100.0,-12392.35
buyer_3,Ana,35,ES73209501612803164263,TRX_N-00203-19267910,2022-06-09T10:10:17,Amurrio,expenses,food,-99.69,-12492.04
buyer_3,Ana,35,ES73209501612803164263,TRX_N-00204-49582623,2022-06-11T06:28:28,Amurrio,expenses,clothing,-135.05,-12627.09
buyer_3,Ana,35,ES73209501612803164263,TRX_N-00205-53050252,2022-06-12T17:37:57,Amurrio,expenses,gifts,-161.12,-12788.21
buyer_3,Ana,35,ES73209501612803164263,TRX_N-00206-68752377,2022-06-13T08:01:41,Amurrio,expenses,leisure,-25.39,-12813.6
buyer_3,Ana,35,ES73209501612803164263,TRX_N-00207-89174970,2022-06-14T21:33:09,Amurrio,expenses,cash,-100.0,-12913.6
buyer_3,Ana,35,ES73209501612803164263,TRX_N-00208-73689759,2022-06-19T16:20:01,Amurrio,expenses,food,-93.58,-13007.18
buyer_3,Ana,35,ES73209501612803164263,TRX_N-00209-11188739,2022-06-20T20:45:34,Amurrio,expenses,clothing,-46.16,-13053.34
buyer_3,Ana,35,ES73209501612803164263,TRX_N-00210-53372014,2022-06-22T08:22:33,Amurrio,expenses,food,-73.49,-13126.83
buyer_3,Ana,35,ES73209501612803164263,TRX_N-00211-93011368,2022-06-22T12:02:56,Santurtzi,expenses,transport,-85.61,-13212.44
buyer_3,Ana,35,ES73209501612803164263,TRX_N-00212-03395189,2022-06-23T12:07:07,Eibar,expenses,food,-84.53,-13296.97
buyer_3,Ana,35,ES73209501612803164263,TRX_N-00213-76041134,2022-06-27T13:25:30,Santurtzi,expenses,food,-118.64,-13415.61
buyer_3,Ana,35,ES73209501612803164263,TRX_N-00214-78281115,2022-06-28T09:43:20,Amurrio,expenses,food,-82.33,-13497.94
buyer_3,Ana,35,ES73209501612803164263,TRX_N-00215-99200772,2022-06-28T15:46:25,Amurrio,expenses,cash,-100.0,-13597.94
buyer_3,Ana,35,ES73209501612803164263,TRX_N-00216-47983020,2022-06-29T19:14:38,Amurrio,expenses,clothing,-61.64,-13659.58
buyer_3,Ana,35,ES73209501612803164263,TRX_N-00217-36233282,2022-07-01T12:15:28,Amurrio,incomes,salary,1494.33,-12165.25
buyer_3,Ana,35,ES73209501612803164263,TRX_N-00218-04688830,2022-07-01T12:15:28,Amurrio,incomes,salary_partner,999.05,-11166.2
buyer_3,Ana,35,ES73209501612803164263,TRX_N-00219-20585116,2022-07-01T12:15:28,Amurrio,incomes,extra_income,244.88,-10921.32
buyer_3,Ana,35,ES73209501612803164263,TRX_N-00220-76767560,2022-07-02T09:19:32,Amurrio,expenses,education,-72.32,-10993.64
buyer_3,Ana,35,ES73209501612803164263,TRX_N-00221-84367810,2022-07-02T17:38:31,Amurrio,expenses,repairs,-328.7,-11322.34
buyer_3,Ana,35,ES73209501612803164263,TRX_N-00222-53802471,2022-07-02T18:08:01,Amurrio,expenses,gifts,-346.69,-11669.03
buyer_3,Ana,35,ES73209501612803164263,TRX_N-00223-02871277,2022-07-04T10:42:16,Amurrio,expenses,mortgage,-938.86,-12607.89
buyer_3,Ana,35,ES73209501612803164263,TRX_N-00224-91311557,2022-07-06T12:50:59,Amurrio,expenses,water,-23.51,-12631.4
buyer_3,Ana,35,ES73209501612803164263,TRX_N-00225-40354893,2022-07-06T15:46:31,Amurrio,expenses,gas,-54.75,-12686.15
buyer_3,Ana,35,ES73209501612803164263,TRX_N-00226-96959384,2022-07-07T10:15:22,Portugalete,expenses,leisure,-31.06,-12717.21
buyer_3,Ana,35,ES73209501612803164263,TRX_N-00227-04378302,2022-07-07T04:27:18,Erandio,expenses,gifts,-28.26,-12745.47
buyer_3,Ana,35,ES73209501612803164263,TRX_N-00228-26638168,2022-07-08T22:43:10,Amurrio,expenses,phone,-43.57,-12789.04
buyer_3,Ana,35,ES73209501612803164263,TRX_N-00229-24713364,2022-07-08T18:59:21,Amurrio,expenses,electricity,-23.16,-12812.2
buyer_3,Ana,35,ES73209501612803164263,TRX_N-00230-80227272,2022-07-08T13:04:08,Amurrio,expenses,internet,-42.0,-12854.2
buyer_3,Ana,35,ES73209501612803164263,TRX_N-00231-19889337,2022-07-11T18:37:08,Amurrio,expenses,gifts,-74.35,-12928.55
buyer_3,Ana,35,ES73209501612803164263,TRX_N-00232-37845402,2022-07-12T17:57:53,Amurrio,expenses,transport,-56.32,-12984.87
buyer_3,Ana,35,ES73209501612803164263,TRX_N-00233-14786630,2022-07-12T20:02:10,Amurrio,expenses,healthcare,-114.36,-13099.23
buyer_3,Ana,35,ES73209501612803164263,TRX_N-00234-33096288,2022-07-12T09:50:47,Barakaldo,expenses,cash,-100.0,-13199.23
buyer_3,Ana,35,ES73209501612803164263,TRX_N-00235-99966287,2022-07-14T17:52:18,Bilbao,expenses,transport,-59.8,-13259.03
buyer_3,Ana,35,ES73209501612803164263,TRX_N-00236-21887214,2022-07-15T18:37:58,Amurrio,expenses,food,-118.76,-13377.79
buyer_3,Ana,35,ES73209501612803164263,TRX_N-00237-92084159,2022-07-15T12:19:39,Amurrio,expenses,repairs,-59.74,-13437.53
buyer_3,Ana,35,ES73209501612803164263,TRX_N-00238-57521340,2022-07-17T11:39:03,Labastida,expenses,leisure,-79.92,-13517.45
buyer_3,Ana,35,ES73209501612803164263,TRX_N-00239-90719153,2022-07-17T19:10:42,Amurrio,expenses,cash,-100.0,-13617.45
buyer_3,Ana,35,ES73209501612803164263,TRX_N-00240-29225150,2022-07-19T15:33:25,Amurrio,expenses,cash,-100.0,-13717.45
buyer_3,Ana,35,ES73209501612803164263,TRX_N-00241-14349930,2022-07-21T22:18:30,Amurrio,expenses,travel,-983.41,-14700.86
buyer_3,Ana,35,ES73209501612803164263,TRX_N-00242-32575628,2022-07-22T12:06:58,Hondarribia,expenses,education,-44.99,-14745.85
buyer_3,Ana,35,ES73209501612803164263,TRX_N-00243-15815537,2022-07-23T14:22:56,Amurrio,expenses,leisure,-57.53,-14803.38
buyer_3,Ana,35,ES73209501612803164263,TRX_N-00244-72730102,2022-07-24T08:49:02,Amurrio,expenses,leisure,-58.47,-14861.85
buyer_3,Ana,35,ES73209501612803164263,TRX_N-00245-34494733,2022-07-25T03:08:36,Labastida,expenses,food,-121.03,-14982.88
buyer_3,Ana,35,ES73209501612803164263,TRX_N-00246-43658770,2022-07-25T23:36:46,Amurrio,expenses,repairs,-306.71,-15289.59
buyer_3,Ana,35,ES73209501612803164263,TRX_N-00247-27101778,2022-07-27T15:03:36,Amurrio,expenses,children,-242.18,-15531.77
buyer_3,Ana,35,ES73209501612803164263,TRX_N-00248-70273998,2022-07-28T21:03:15,Amurrio,expenses,food,-67.61,-15599.38
buyer_3,Ana,35,ES73209501612803164263,TRX_N-00249-82128610,2022-07-28T19:05:12,Amurrio,expenses,appliances,-305.17,-15904.55
buyer_3,Ana,35,ES73209501612803164263,TRX_N-00250-95546287,2022-07-29T18:20:07,Amurrio,expenses,repairs,-227.74,-16132.29
buyer_3,Ana,35,ES73209501612803164263,TRX_N-00251-46297730,2022-07-30T11:50:41,Amurrio,expenses,cash,-100.0,-16232.29
buyer_3,Ana,35,ES73209501612803164263,TRX_N-00252-44287791,2022-07-31T09:47:32,Amurrio,expenses,education,-60.48,-16292.77
buyer_3,Ana,35,ES73209501612803164263,TRX_N-00253-97531906,2022-08-01T12:26:04,Amurrio,incomes,salary,1494.33,-14798.44
buyer_3,Ana,35,ES73209501612803164263,TRX_N-00254-22198383,2022-08-01T12:26:04,Amurrio,incomes,salary_partner,999.05,-13799.39
buyer_3,Ana,35,ES73209501612803164263,TRX_N-00255-18901053,2022-08-01T12:03:34,Amurrio,expenses,food,-98.71,-13898.1
buyer_3,Ana,35,ES73209501612803164263,TRX_N-00256-58573119,2022-08-01T05:37:28,Amurrio,expenses,leisure,-18.88,-13916.98
buyer_3,Ana,35,ES73209501612803164263,TRX_N-00257-79837500,2022-08-04T10:11:17,Amurrio,expenses,mortgage,-938.86,-14855.84
buyer_3,Ana,35,ES73209501612803164263,TRX_N-00258-47573702,2022-08-04T18:59:03,Amurrio,expenses,cash,-100.0,-14955.84
buyer_3,Ana,35,ES73209501612803164263,TRX_N-00259-29165008,2022-08-04T18:23:24,Amurrio,expenses,repairs,-49.79,-15005.63
buyer_3,Ana,35,ES73209501612803164263,TRX_N-00260-52414367,2022-08-05T05:40:12,Amurrio,expenses,gas,-65.01,-15070.64
buyer_3,Ana,35,ES73209501612803164263,TRX_N-00261-32627818,2022-08-05T18:19:24,Amurrio,expenses,cash,-100.0,-15170.64
buyer_3,Ana,35,ES73209501612803164263,TRX_N-00262-83361162,2022-08-06T09:55:49,Galdakao,expenses,food,-74.22,-15244.86
buyer_3,Ana,35,ES73209501612803164263,TRX_N-00263-29828736,2022-08-07T12:24:43,Amurrio,expenses,electricity,-39.24,-15284.1
buyer_3,Ana,35,ES73209501612803164263,TRX_N-00264-59170957,2022-08-07T14:17:26,Amurrio,expenses,food,-78.2,-15362.3
buyer_3,Ana,35,ES73209501612803164263,TRX_N-00265-33533986,2022-08-07T10:38:46,Amurrio,expenses,gifts,-530.99,-15893.29
buyer_3,Ana,35,ES73209501612803164263,TRX_N-00266-50505399,2022-08-08T18:18:49,Amurrio,expenses,phone,-32.36,-15925.65
buyer_3,Ana,35,ES73209501612803164263,TRX_N-00267-93085497,2022-08-08T08:03:11,Amurrio,expenses,water,-22.52,-15948.17
buyer_3,Ana,35,ES73209501612803164263,TRX_N-00268-41180564,2022-08-08T11:36:07,Amurrio,expenses,internet,-42.0,-15990.17
buyer_3,Ana,35,ES73209501612803164263,TRX_N-00269-85801676,2022-08-09T14:56:12,Amurrio,expenses,transport,-88.77,-16078.94
buyer_3,Ana,35,ES73209501612803164263,TRX_N-00270-35762579,2022-08-10T11:09:29,Amurrio,expenses,transport,-54.62,-16133.56
buyer_3,Ana,35,ES73209501612803164263,TRX_N-00271-05121038,2022-08-10T11:10:39,Amurrio,expenses,repairs,-158.1,-16291.66
buyer_3,Ana,35,ES73209501612803164263,TRX_N-00272-97693126,2022-08-14T00:10:29,Amurrio,expenses,food,-121.87,-16413.53
buyer_3,Ana,35,ES73209501612803164263,TRX_N-00273-97236365,2022-08-14T09:16:08,Amurrio,expenses,appliances,-327.97,-16741.5
buyer_3,Ana,35,ES73209501612803164263,TRX_N-00274-29862638,2022-08-17T18:55:48,Eibar,expenses,leisure,-70.61,-16812.11
buyer_3,Ana,35,ES73209501612803164263,TRX_N-00275-42185920,2022-08-18T10:14:05,Amurrio,expenses,food,-118.79,-16930.9
buyer_3,Ana,35,ES73209501612803164263,TRX_N-00276-42719185,2022-08-18T12:21:41,Amurrio,expenses,appliances,-409.55,-17340.45
buyer_3,Ana,35,ES73209501612803164263,TRX_N-00277-12757770,2022-08-19T08:59:20,Hondarribia,expenses,leisure,-79.83,-17420.28
buyer_3,Ana,35,ES73209501612803164263,TRX_N-00278-87984723,2022-08-19T14:11:29,Amurrio,expenses,cash,-100.0,-17520.28
buyer_3,Ana,35,ES73209501612803164263,TRX_N-00279-51690858,2022-08-19T17:05:28,Amurrio,expenses,gifts,-461.64,-17981.92
buyer_3,Ana,35,ES73209501612803164263,TRX_N-00280-33539812,2022-08-20T18:16:06,Amurrio,expenses,gifts,-44.78,-18026.7
buyer_3,Ana,35,ES73209501612803164263,TRX_N-00281-65204296,2022-08-22T11:25:40,Amurrio,expenses,leisure,-62.33,-18089.03
buyer_3,Ana,35,ES73209501612803164263,TRX_N-00282-16919278,2022-08-25T04:58:35,Bilbao,expenses,food,-78.46,-18167.49
buyer_3,Ana,35,ES73209501612803164263,TRX_N-00283-42966106,2022-08-27T12:42:51,Amurrio,expenses,food,-112.79,-18280.28
buyer_3,Ana,35,ES73209501612803164263,TRX_N-00284-57927800,2022-08-27T11:39:01,Amurrio,expenses,transport,-86.34,-18366.62
buyer_3,Ana,35,ES73209501612803164263,TRX_N-00285-48883959,2022-08-29T23:13:51,Vitoria-Gasteiz,expenses,food,-65.29,-18431.91
buyer_3,Ana,35,ES73209501612803164263,TRX_N-00286-54048189,2022-08-30T20:40:50,Amurrio,expenses,repairs,-114.14,-18546.05
buyer_3,Ana,35,ES73209501612803164263,TRX_N-00287-48807336,2022-09-01T09:23:19,Amurrio,incomes,salary,1494.33,-17051.72
buyer_3,Ana,35,ES73209501612803164263,TRX_N-00288-33651490,2022-09-01T09:23:19,Amurrio,incomes,salary_partner,999.05,-16052.67
buyer_3,Ana,35,ES73209501612803164263,TRX_N-00289-40722303,2022-09-02T10:50:55,Amurrio,expenses,gifts,-207.08,-16259.75
buyer_3,Ana,35,ES73209501612803164263,TRX_N-00290-46518278,2022-09-03T19:05:38,Amurrio,expenses,children,-167.06,-16426.81
buyer_3,Ana,35,ES73209501612803164263,TRX_N-00291-40154490,2022-09-04T20:23:06,Amurrio,expenses,mortgage,-938.86,-17365.67
buyer_3,Ana,35,ES73209501612803164263,TRX_N-00292-00452444,2022-09-04T21:06:14,Amurrio,expenses,clothing,-159.81,-17525.48
buyer_3,Ana,35,ES73209501612803164263,TRX_N-00293-81853017,2022-09-05T09:13:35,Amurrio,expenses,water,-37.42,-17562.9
buyer_3,Ana,35,ES73209501612803164263,TRX_N-00294-31158787,2022-09-06T12:45:20,Amurrio,expenses,children,-249.58,-17812.48
buyer_3,Ana,35,ES73209501612803164263,TRX_N-00295-35181711,2022-09-07T12:34:02,Donostia,expenses,cash,-100.0,-17912.48
buyer_3,Ana,35,ES73209501612803164263,TRX_N-00296-57977692,2022-09-08T22:59:11,Amurrio,expenses,gas,-113.81,-18026.29
buyer_3,Ana,35,ES73209501612803164263,TRX_N-00297-66566563,2022-09-08T12:42:06,Amurrio,expenses,electricity,-67.83,-18094.12
buyer_3,Ana,35,ES73209501612803164263,TRX_N-00298-02393142,2022-09-08T00:19:08,Amurrio,expenses,internet,-42.0,-18136.12
buyer_3,Ana,35,ES73209501612803164263,TRX_N-00299-54656570,2022-09-08T18:37:56,Amurrio,expenses,phone,-34.58,-18170.7
buyer_3,Ana,35,ES73209501612803164263,TRX_N-00300-00702960,2022-09-09T08:58:09,Amurrio,expenses,food,-108.73,-18279.43
buyer_3,Ana,35,ES73209501612803164263,TRX_N-00301-36936508,2022-09-11T20:06:30,Amurrio,expenses,leisure,-70.19,-18349.62
buyer_3,Ana,35,ES73209501612803164263,TRX_N-00302-02826449,2022-09-11T08:06:18,Amurrio,expenses,gifts,-840.97,-19190.59
buyer_3,Ana,35,ES73209501612803164263,TRX_N-00303-63653592,2022-09-12T03:55:52,Amurrio,expenses,food,-80.97,-19271.56
buyer_3,Ana,35,ES73209501612803164263,TRX_N-00304-31997047,2022-09-12T11:16:18,Amurrio,expenses,clothing,-62.45,-19334.01
buyer_3,Ana,35,ES73209501612803164263,TRX_N-00305-31825873,2022-09-13T12:08:24,Amurrio,expenses,gifts,-159.72,-19493.73
buyer_3,Ana,35,ES73209501612803164263,TRX_N-00306-52908546,2022-09-14T13:24:27,Amurrio,expenses,children,-125.3,-19619.03
buyer_3,Ana,35,ES73209501612803164263,TRX_N-00307-43696904,2022-09-16T09:39:30,Amurrio,expenses,transport,-46.84,-19665.87
buyer_3,Ana,35,ES73209501612803164263,TRX_N-00308-37496949,2022-09-17T12:54:00,Amurrio,expenses,food,-88.24,-19754.11
buyer_3,Ana,35,ES73209501612803164263,TRX_N-00309-87198812,2022-09-17T20:46:16,Amurrio,expenses,cash,-100.0,-19854.11
buyer_3,Ana,35,ES73209501612803164263,TRX_N-00310-91723798,2022-09-18T21:42:28,Getxo,expenses,gifts,-670.82,-20524.93
buyer_3,Ana,35,ES73209501612803164263,TRX_N-00311-48182208,2022-09-19T17:05:57,Amurrio,expenses,transport,-56.78,-20581.71
buyer_3,Ana,35,ES73209501612803164263,TRX_N-00312-59921022,2022-09-19T17:40:22,Amurrio,expenses,leisure,-72.22,-20653.93
buyer_3,Ana,35,ES73209501612803164263,TRX_N-00313-22456847,2022-09-19T17:36:39,Amurrio,expenses,appliances,-327.79,-20981.72
buyer_3,Ana,35,ES73209501612803164263,TRX_N-00314-20351733,2022-09-21T17:23:59,Amurrio,expenses,leisure,-28.05,-21009.77
buyer_3,Ana,35,ES73209501612803164263,TRX_N-00315-98342345,2022-09-21T21:09:46,Amurrio,expenses,gifts,-272.9,-21282.67
buyer_3,Ana,35,ES73209501612803164263,TRX_N-00316-98419819,2022-09-25T06:46:21,Amurrio,expenses,cash,-100.0,-21382.67
buyer_3,Ana,35,ES73209501612803164263,TRX_N-00317-78187409,2022-09-26T18:59:01,Amurrio,expenses,food,-60.65,-21443.32
buyer_3,Ana,35,ES73209501612803164263,TRX_N-00318-29046566,2022-09-26T12:03:55,Elciego,expenses,cash,-100.0,-21543.32
buyer_3,Ana,35,ES73209501612803164263,TRX_N-00319-22411813,2022-09-27T14:11:04,Amurrio,expenses,cash,-100.0,-21643.32
buyer_3,Ana,35,ES73209501612803164263,TRX_N-00320-79744407,2022-09-29T18:21:34,Hondarribia,expenses,leisure,-67.09,-21710.41
buyer_3,Ana,35,ES73209501612803164263,TRX_N-00321-57109768,2022-09-30T19:15:06,Amurrio,expenses,food,-105.32,-21815.73
buyer_3,Ana,35,ES73209501612803164263,TRX_N-00322-51214355,2022-10-01T08:32:00,Amurrio,incomes,salary,1494.33,-20321.4
buyer_3,Ana,35,ES73209501612803164263,TRX_N-00323-47111765,2022-10-01T08:32:00,Amurrio,incomes,salary_partner,999.05,-19322.35
buyer_3,Ana,35,ES73209501612803164263,TRX_N-00324-36326080,2022-10-01T08:32:00,Amurrio,incomes,extra_income,244.88,-19077.47
buyer_3,Ana,35,ES73209501612803164263,TRX_N-00325-19517716,2022-10-01T16:47:03,Amurrio,expenses,cash,-100.0,-19177.47
buyer_3,Ana,35,ES73209501612803164263,TRX_N-00326-98488736,2022-10-01T15:39:13,Salvatierra/Agurain,expenses,repairs,-144.07,-19321.54
buyer_3,Ana,35,ES73209501612803164263,TRX_N-00327-59373414,2022-10-04T17:12:11,Amurrio,expenses,mortgage,-938.86,-20260.4
buyer_3,Ana,35,ES73209501612803164263,TRX_N-00328-46474901,2022-10-04T18:38:49,Sestao,expenses,food,-123.5,-20383.9
buyer_3,Ana,35,ES73209501612803164263,TRX_N-00329-31623282,2022-10-04T15:02:53,Amurrio,expenses,transport,-73.92,-20457.82
buyer_3,Ana,35,ES73209501612803164263,TRX_N-00330-15442413,2022-10-05T09:33:50,Amurrio,expenses,gas,-56.67,-20514.49
buyer_3,Ana,35,ES73209501612803164263,TRX_N-00331-07848369,2022-10-05T03:46:47,Amurrio,expenses,phone,-36.42,-20550.91
buyer_3,Ana,35,ES73209501612803164263,TRX_N-00332-23554135,2022-10-05T20:17:45,Amurrio,expenses,food,-103.75,-20654.66
buyer_3,Ana,35,ES73209501612803164263,TRX_N-00333-10462058,2022-10-05T08:53:06,Amurrio,expenses,education,-74.33,-20728.99
buyer_3,Ana,35,ES73209501612803164263,TRX_N-00334-13004581,2022-10-05T04:04:42,Amurrio,expenses,cash,-100.0,-20828.99
buyer_3,Ana,35,ES73209501612803164263,TRX_N-00335-10799495,2022-10-06T13:01:53,Amurrio,expenses,water,-44.55,-20873.54
buyer_3,Ana,35,ES73209501612803164263,TRX_N-00336-58428484,2022-10-06T20:06:10,Amurrio,expenses,electricity,-25.73,-20899.27
buyer_3,Ana,35,ES73209501612803164263,TRX_N-00337-36208794,2022-10-06T19:49:48,Amurrio,expenses,internet,-42.0,-20941.27
buyer_3,Ana,35,ES73209501612803164263,TRX_N-00338-95622980,2022-10-06T18:19:43,Amurrio,expenses,transport,-70.4,-21011.67
buyer_3,Ana,35,ES73209501612803164263,TRX_N-00339-73989989,2022-10-08T16:06:07,Iruña de Oca,expenses,food,-82.53,-21094.2
buyer_3,Ana,35,ES73209501612803164263,TRX_N-00340-49348448,2022-10-08T16:42:57,Amurrio,expenses,transport,-51.73,-21145.93
buyer_3,Ana,35,ES73209501612803164263,TRX_N-00341-45164062,2022-10-09T15:23:45,Donostia,expenses,cash,-100.0,-21245.93
buyer_3,Ana,35,ES73209501612803164263,TRX_N-00342-33481908,2022-10-11T09:32:29,Amurrio,expenses,food,-89.03,-21334.96
buyer_3,Ana,35,ES73209501612803164263,TRX_N-00343-76852805,2022-10-11T11:03:30,Durango,expenses,cash,-100.0,-21434.96
buyer_3,Ana,35,ES73209501612803164263,TRX_N-00344-37660220,2022-10-13T12:48:44,Amurrio,expenses,food,-60.58,-21495.54
buyer_3,Ana,35,ES73209501612803164263,TRX_N-00345-13883116,2022-10-13T18:25:37,Amurrio,expenses,transport,-83.53,-21579.07
buyer_3,Ana,35,ES73209501612803164263,TRX_N-00346-62087855,2022-10-14T14:29:28,Amurrio,expenses,leisure,-82.99,-21662.06
buyer_3,Ana,35,ES73209501612803164263,TRX_N-00347-47843298,2022-10-16T15:31:53,Amurrio,expenses,healthcare,-154.69,-21816.75
buyer_3,Ana,35,ES73209501612803164263,TRX_N-00348-83242148,2022-10-16T02:08:30,Amurrio,expenses,cash,-100.0,-21916.75
buyer_3,Ana,35,ES73209501612803164263,TRX_N-00349-02585149,2022-10-18T07:42:59,Amurrio,expenses,leisure,-51.31,-21968.06
buyer_3,Ana,35,ES73209501612803164263,TRX_N-00350-48872678,2022-10-20T10:44:41,Amurrio,expenses,food,-103.85,-22071.91
buyer_3,Ana,35,ES73209501612803164263,TRX_N-00351-40451203,2022-10-20T15:48:07,Bilbao,expenses,clothing,-148.71,-22220.62
buyer_3,Ana,35,ES73209501612803164263,TRX_N-00352-92550335,2022-10-23T08:41:25,Amurrio,expenses,leisure,-28.63,-22249.25
buyer_3,Ana,35,ES73209501612803164263,TRX_N-00353-51680387,2022-10-26T13:43:05,Amurrio,expenses,cash,-100.0,-22349.25
buyer_3,Ana,35,ES73209501612803164263,TRX_N-00354-32231666,2022-10-27T16:25:45,Amurrio,expenses,children,-172.25,-22521.5
buyer_3,Ana,35,ES73209501612803164263,TRX_N-00355-71887164,2022-10-28T14:54:54,Amurrio,expenses,repairs,-40.8,-22562.3
buyer_3,Ana,35,ES73209501612803164263,TRX_N-00356-07320417,2022-10-29T14:24:48,Amurrio,expenses,cash,-100.0,-22662.3
buyer_3,Ana,35,ES73209501612803164263,TRX_N-00357-55260370,2022-10-31T17:54:43,Zuia,expenses,leisure,-52.67,-22714.97
buyer_3,Ana,35,ES73209501612803164263,TRX_N-00358-01223520,2022-11-01T13:10:46,Amurrio,incomes,salary,1494.33,-21220.64
buyer_3,Ana,35,ES73209501612803164263,TRX_N-00359-54046678,2022-11-01T13:10:46,Amurrio,incomes,salary_partner,999.05,-20221.59
buyer_3,Ana,35,ES73209501612803164263,TRX_N-00360-32803071,2022-11-01T10:56:10,Amurrio,expenses,food,-80.21,-20301.8
buyer_3,Ana,35,ES73209501612803164263,TRX_N-00361-01595899,2022-11-01T12:58:16,Amurrio,expenses,cash,-100.0,-20401.8
buyer_3,Ana,35,ES73209501612803164263,TRX_N-00362-06688235,2022-11-02T19:00:54,Amurrio,expenses,healthcare,-124.78,-20526.58
buyer_3,Ana,35,ES73209501612803164263,TRX_N-00363-83219087,2022-11-04T03:02:07,Amurrio,expenses,mortgage,-938.86,-21465.44
buyer_3,Ana,35,ES73209501612803164263,TRX_N-00364-42957638,2022-11-04T20:17:02,Amurrio,expenses,repairs,-235.14,-21700.58
buyer_3,Ana,35,ES73209501612803164263,TRX_N-00365-13275186,2022-11-05T14:54:29,Amurrio,expenses,water,-40.32,-21740.9
buyer_3,Ana,35,ES73209501612803164263,TRX_N-00366-10398514,2022-11-05T17:21:51,Amurrio,expenses,internet,-42.0,-21782.9
buyer_3,Ana,35,ES73209501612803164263,TRX_N-00367-81008930,2022-11-05T19:42:33,Amurrio,expenses,phone,-39.84,-21822.74
buyer_3,Ana,35,ES73209501612803164263,TRX_N-00368-24103243,2022-11-05T22:05:13,Amurrio,expenses,food,-63.29,-21886.03
buyer_3,Ana,35,ES73209501612803164263,TRX_N-00369-76269439,2022-11-05T20:58:37,Amurrio,expenses,repairs,-316.45,-22202.48
buyer_3,Ana,35,ES73209501612803164263,TRX_N-00370-13015118,2022-11-06T01:18:59,Amurrio,expenses,gas,-56.57,-22259.05
buyer_3,Ana,35,ES73209501612803164263,TRX_N-00371-15792203,2022-11-07T19:59:14,Hernani,expenses,food,-96.15,-22355.2
buyer_3,Ana,35,ES73209501612803164263,TRX_N-00372-18069077,2022-11-07T16:02:20,Basauri,expenses,appliances,-368.57,-22723.77
buyer_3,Ana,35,ES73209501612803164263,TRX_N-00373-70087927,2022-11-08T09:37:13,Amurrio,expenses,electricity,-50.57,-22774.34
buyer_3,Ana,35,ES73209501612803164263,TRX_N-00374-32698306,2022-11-09T23:44:19,Amurrio,expenses,cash,-100.0,-22874.34
buyer_3,Ana,35,ES73209501612803164263,TRX_N-00375-28957882,2022-11-10T13:05:48,Amurrio,expenses,education,-78.45,-22952.79
buyer_3,Ana,35,ES73209501612803164263,TRX_N-00376-96906689,2022-11-11T13:49:22,Amurrio,expenses,cash,-100.0,-23052.79
buyer_3,Ana,35,ES73209501612803164263,TRX_N-00377-07685634,2022-11-12T20:14:10,Amurrio,expenses,gifts,-743.53,-23796.32
buyer_3,Ana,35,ES73209501612803164263,TRX_N-00378-64266376,2022-11-13T17:02:08,Amurrio,expenses,food,-85.89,-23882.21
buyer_3,Ana,35,ES73209501612803164263,TRX_N-00379-75734192,2022-11-14T08:19:28,Vitoria-Gasteiz,expenses,food,-95.25,-23977.46
buyer_3,Ana,35,ES73209501612803164263,TRX_N-00380-19813958,2022-11-14T22:11:53,Amurrio,expenses,gifts,-649.73,-24627.19
buyer_3,Ana,35,ES73209501612803164263,TRX_N-00381-67184166,2022-11-16T16:33:02,Amurrio,expenses,cash,-100.0,-24727.19
buyer_3,Ana,35,ES73209501612803164263,TRX_N-00382-02759035,2022-11-16T15:58:11,Amurrio,expenses,children,-96.12,-24823.31
buyer_3,Ana,35,ES73209501612803164263,TRX_N-00383-44729242,2022-11-18T03:42:17,Amurrio,expenses,food,-70.76,-24894.07
buyer_3,Ana,35,ES73209501612803164263,TRX_N-00384-65372761,2022-11-18T18:12:06,Amurrio,expenses,transport,-71.95,-24966.02
buyer_3,Ana,35,ES73209501612803164263,TRX_N-00385-30651413,2022-11-22T14:52:15,Amurrio,expenses,food,-101.74,-25067.76
buyer_3,Ana,35,ES73209501612803164263,TRX_N-00386-61502076,2022-11-25T11:00:19,Amurrio,expenses,transport,-41.34,-25109.1
buyer_3,Ana,35,ES73209501612803164263,TRX_N-00387-05966392,2022-11-26T23:45:55,Amurrio,expenses,cash,-100.0,-25209.1
buyer_3,Ana,35,ES73209501612803164263,TRX_N-00388-09150639,2022-11-27T13:34:55,Amurrio,expenses,cash,-100.0,-25309.1
buyer_3,Ana,35,ES73209501612803164263,TRX_N-00389-05898415,2022-11-28T12:46:09,Llodio,expenses,healthcare,-114.48,-25423.58
buyer_3,Ana,35,ES73209501612803164263,TRX_N-00390-54033618,2022-11-29T12:39:44,Amurrio,expenses,gifts,-61.79,-25485.37
buyer_3,Ana,35,ES73209501612803164263,TRX_N-00391-06693887,2022-11-30T10:54:08,Amurrio,expenses,education,-42.41,-25527.78
buyer_3,Ana,35,ES73209501612803164263,TRX_N-00392-13097578,2022-12-01T16:13:47,Amurrio,incomes,salary,1494.33,-24033.45
buyer_3,Ana,35,ES73209501612803164263,TRX_N-00393-29241141,2022-12-01T16:13:47,Amurrio,incomes,salary_partner,999.05,-23034.4
buyer_3,Ana,35,ES73209501612803164263,TRX_N-00394-88183866,2022-12-01T16:13:47,Amurrio,incomes,salary_bonus,1185.48,-21848.92
buyer_3,Ana,35,ES73209501612803164263,TRX_N-00395-17148745,2022-12-01T16:13:47,Amurrio,incomes,salary_partner_bonus,787.91,-21061.01
buyer_3,Ana,35,ES73209501612803164263,TRX_N-00396-50086371,2022-12-02T20:49:36,Amurrio,expenses,education,-51.21,-21112.22
buyer_3,Ana,35,ES73209501612803164263,TRX_N-00397-65187066,2022-12-03T19:02:25,Arrasate,expenses,cash,-100.0,-21212.22
buyer_3,Ana,35,ES73209501612803164263,TRX_N-00398-33693843,2022-12-04T20:14:21,Amurrio,expenses,mortgage,-938.86,-22151.08
buyer_3,Ana,35,ES73209501612803164263,TRX_N-00399-90998640,2022-12-05T11:22:59,Amurrio,expenses,phone,-31.34,-22182.42
buyer_3,Ana,35,ES73209501612803164263,TRX_N-00400-74574770,2022-12-05T21:18:04,Amurrio,expenses,food,-85.41,-22267.83
buyer_3,Ana,35,ES73209501612803164263,TRX_N-00401-66629903,2022-12-06T10:22:54,Amurrio,expenses,water,-35.78,-22303.61
buyer_3,Ana,35,ES73209501612803164263,TRX_N-00402-15113834,2022-12-07T12:35:20,Amurrio,expenses,gas,-66.01,-22369.62
buyer_3,Ana,35,ES73209501612803164263,TRX_N-00403-78329216,2022-12-08T10:26:52,Amurrio,expenses,electricity,-53.73,-22423.35
buyer_3,Ana,35,ES73209501612803164263,TRX_N-00404-09387291,2022-12-08T11:59:29,Amurrio,expenses,internet,-42.0,-22465.35
buyer_3,Ana,35,ES73209501612803164263,TRX_N-00405-21815186,2022-12-08T14:18:49,Amurrio,expenses,food,-118.94,-22584.29
buyer_3,Ana,35,ES73209501612803164263,TRX_N-00406-01732073,2022-12-09T15:04:09,Amurrio,expenses,clothing,-149.44,-22733.73
buyer_3,Ana,35,ES73209501612803164263,TRX_N-00407-92628492,2022-12-09T20:47:19,Amurrio,expenses,gifts,-515.86,-23249.59
buyer_3,Ana,35,ES73209501612803164263,TRX_N-00408-45325207,2022-12-12T12:39:21,Amurrio,expenses,food,-76.74,-23326.33
buyer_3,Ana,35,ES73209501612803164263,TRX_N-00409-04480596,2022-12-12T13:46:55,Zarautz,expenses,leisure,-53.08,-23379.41
buyer_3,Ana,35,ES73209501612803164263,TRX_N-00410-03755138,2022-12-12T17:55:17,Amurrio,expenses,travel,-1179.47,-24558.88
buyer_3,Ana,35,ES73209501612803164263,TRX_N-00411-03395652,2022-12-13T08:47:46,Salvatierra/Agurain,expenses,food,-108.56,-24667.44
buyer_3,Ana,35,ES73209501612803164263,TRX_N-00412-54121209,2022-12-13T08:13:25,Basauri,expenses,cash,-100.0,-24767.44
buyer_3,Ana,35,ES73209501612803164263,TRX_N-00413-45082793,2022-12-14T09:17:28,Amurrio,expenses,gifts,-725.08,-25492.52
buyer_3,Ana,35,ES73209501612803164263,TRX_N-00414-82703074,2022-12-15T17:00:04,Amurrio,expenses,cash,-100.0,-25592.52
buyer_3,Ana,35,ES73209501612803164263,TRX_N-00415-39193696,2022-12-15T11:19:30,Amurrio,expenses,travel,-622.01,-26214.53
buyer_3,Ana,35,ES73209501612803164263,TRX_N-00416-82270607,2022-12-16T12:24:46,Amurrio,expenses,leisure,-36.28,-26250.81
buyer_3,Ana,35,ES73209501612803164263,TRX_N-00417-92324939,2022-12-17T14:47:11,Amurrio,expenses,clothing,-146.69,-26397.5
buyer_3,Ana,35,ES73209501612803164263,TRX_N-00418-51044725,2022-12-18T18:05:22,Erandio,expenses,gifts,-332.86,-26730.36
buyer_3,Ana,35,ES73209501612803164263,TRX_N-00419-71514377,2022-12-23T13:50:16,Amurrio,expenses,transport,-57.07,-26787.43
buyer_3,Ana,35,ES73209501612803164263,TRX_N-00420-59298144,2022-12-24T09:20:30,Amurrio,expenses,cash,-100.0,-26887.43
buyer_3,Ana,35,ES73209501612803164263,TRX_N-00421-02039177,2022-12-25T08:18:12,Oyón-Oion,expenses,repairs,-263.15,-27150.58
buyer_3,Ana,35,ES73209501612803164263,TRX_N-00422-42858815,2022-12-28T20:30:56,Amurrio,expenses,cash,-100.0,-27250.58
buyer_3,Ana,35,ES73209501612803164263,TRX_N-00423-63759035,2022-12-29T17:30:54,Amurrio,expenses,cash,-100.0,-27350.58
buyer_3,Ana,35,ES73209501612803164263,TRX_N-00424-39900522,2022-12-30T10:38:13,Amurrio,expenses,food,-95.33,-27445.91
buyer_3,Ana,35,ES73209501612803164263,TRX_N-00425-42709082,2022-12-31T17:10:25,Amurrio,expenses,leisure,-36.07,-27481.98
buyer_3,Ana,35,ES73209501612803164263,TRX_N-00426-79184147,2022-12-31T16:48:45,Sopela,expenses,repairs,-261.77,-27743.75
buyer_3,Ana,35,ES73209501612803164263,TRX_N-00427-35598055,2023-01-01T17:29:17,Amurrio,incomes,salary,1547.34,-26196.41
buyer_3,Ana,35,ES73209501612803164263,TRX_N-00428-28743702,2023-01-01T17:29:17,Amurrio,incomes,salary_partner,1034.49,-25161.92
buyer_3,Ana,35,ES73209501612803164263,TRX_N-00429-36768975,2023-01-01T16:35:26,Amurrio,expenses,education,-75.39,-25237.31
buyer_3,Ana,35,ES73209501612803164263,TRX_N-00430-55199374,2023-01-01T16:04:35,Amurrio,expenses,appliances,-225.28,-25462.59
buyer_3,Ana,35,ES73209501612803164263,TRX_N-00431-31384908,2023-01-02T05:50:15,Amurrio,expenses,cash,-100.0,-25562.59
buyer_3,Ana,35,ES73209501612803164263,TRX_N-00432-42265673,2023-01-03T08:49:21,Amurrio,expenses,gifts,-172.12,-25734.71
buyer_3,Ana,35,ES73209501612803164263,TRX_N-00433-09814983,2023-01-03T10:52:38,Amurrio,expenses,children,-232.28,-25966.99
buyer_3,Ana,35,ES73209501612803164263,TRX_N-00434-89605236,2023-01-04T12:54:47,Amurrio,expenses,mortgage,-938.86,-26905.85
buyer_3,Ana,35,ES73209501612803164263,TRX_N-00435-67351322,2023-01-04T17:13:09,Amurrio,expenses,food,-78.59,-26984.44
buyer_3,Ana,35,ES73209501612803164263,TRX_N-00436-61315867,2023-01-04T18:40:43,Portugalete,expenses,education,-60.92,-27045.36
buyer_3,Ana,35,ES73209501612803164263,TRX_N-00437-37642734,2023-01-04T19:09:43,Salvatierra/Agurain,expenses,appliances,-110.62,-27155.98
buyer_3,Ana,35,ES73209501612803164263,TRX_N-00438-82847861,2023-01-05T20:41:52,Amurrio,expenses,transport,-59.3,-27215.28
buyer_3,Ana,35,ES73209501612803164263,TRX_N-00439-32033908,2023-01-06T23:18:14,Amurrio,expenses,food,-114.35,-27329.63
buyer_3,Ana,35,ES73209501612803164263,TRX_N-00440-38383292,2023-01-06T15:07:05,Santurtzi,expenses,transport,-54.19,-27383.82
buyer_3,Ana,35,ES73209501612803164263,TRX_N-00441-38658880,2023-01-07T12:57:38,Amurrio,expenses,internet,-42.0,-27425.82
buyer_3,Ana,35,ES73209501612803164263,TRX_N-00442-40560914,2023-01-07T22:14:33,Amurrio,expenses,phone,-39.4,-27465.22
buyer_3,Ana,35,ES73209501612803164263,TRX_N-00443-75360196,2023-01-08T17:37:56,Amurrio,expenses,water,-32.83,-27498.05
buyer_3,Ana,35,ES73209501612803164263,TRX_N-00444-44727802,2023-01-08T17:02:46,Amurrio,expenses,electricity,-38.91,-27536.96
buyer_3,Ana,35,ES73209501612803164263,TRX_N-00445-12460683,2023-01-08T19:03:06,Amurrio,expenses,gas,-49.18,-27586.14
buyer_3,Ana,35,ES73209501612803164263,TRX_N-00446-36528542,2023-01-08T16:51:39,Amurrio,expenses,children,-83.78,-27669.92
buyer_3,Ana,35,ES73209501612803164263,TRX_N-00447-64505031,2023-01-09T11:45:41,Sopela,expenses,appliances,-266.94,-27936.86
buyer_3,Ana,35,ES73209501612803164263,TRX_N-00448-24331170,2023-01-10T10:31:03,Amurrio,expenses,gifts,-119.72,-28056.58
buyer_3,Ana,35,ES73209501612803164263,TRX_N-00449-80863601,2023-01-11T17:11:23,Amurrio,expenses,food,-88.18,-28144.76
buyer_3,Ana,35,ES73209501612803164263,TRX_N-00450-07201925,2023-01-11T12:03:06,Bermeo,expenses,cash,-100.0,-28244.76
buyer_3,Ana,35,ES73209501612803164263,TRX_N-00451-75252928,2023-01-11T04:31:16,Amurrio,expenses,gifts,-501.67,-28746.43
buyer_3,Ana,35,ES73209501612803164263,TRX_N-00452-74442247,2023-01-12T14:41:57,Amurrio,expenses,food,-94.82,-28841.25
buyer_3,Ana,35,ES73209501612803164263,TRX_N-00453-25627543,2023-01-12T20:16:27,Amurrio,expenses,transport,-89.43,-28930.68
buyer_3,Ana,35,ES73209501612803164263,TRX_N-00454-11508120,2023-01-12T10:06:50,Amurrio,expenses,repairs,-299.02,-29229.7
buyer_3,Ana,35,ES73209501612803164263,TRX_N-00455-19794815,2023-01-13T10:49:03,Lasarte-Oria,expenses,transport,-53.06,-29282.76
buyer_3,Ana,35,ES73209501612803164263,TRX_N-00456-02773805,2023-01-13T15:03:06,Amurrio,expenses,children,-270.25,-29553.01
buyer_3,Ana,35,ES73209501612803164263,TRX_N-00457-81805510,2023-01-14T07:16:51,Amurrio,expenses,children,-166.1,-29719.11
buyer_3,Ana,35,ES73209501612803164263,TRX_N-00458-51772329,2023-01-16T15:04:56,Amurrio,expenses,food,-85.94,-29805.05
buyer_3,Ana,35,ES73209501612803164263,TRX_N-00459-47154671,2023-01-18T18:52:41,Amurrio,expenses,food,-120.21,-29925.26
buyer_3,Ana,35,ES73209501612803164263,TRX_N-00460-99291124,2023-01-25T23:19:52,Amurrio,expenses,repairs,-178.78,-30104.04
buyer_3,Ana,35,ES73209501612803164263,TRX_N-00461-68740517,2023-01-26T21:04:28,Amurrio,expenses,gifts,-713.06,-30817.1
buyer_3,Ana,35,ES73209501612803164263,TRX_N-00462-24449528,2023-01-27T18:00:13,Amurrio,expenses,cash,-100.0,-30917.1
buyer_3,Ana,35,ES73209501612803164263,TRX_N-00463-48388544,2023-01-28T11:35:08,Amurrio,expenses,food,-73.57,-30990.67
buyer_3,Ana,35,ES73209501612803164263,TRX_N-00464-16011177,2023-01-31T09:34:59,Amurrio,expenses,food,-66.83,-31057.5
buyer_3,Ana,35,ES73209501612803164263,TRX_N-00465-93488293,2023-01-31T19:14:00,Hernani,expenses,education,-76.07,-31133.57
buyer_3,Ana,35,ES73209501612803164263,TRX_N-00466-57610300,2023-02-01T10:05:48,Amurrio,incomes,salary,1547.34,-29586.23
buyer_3,Ana,35,ES73209501612803164263,TRX_N-00467-33901984,2023-02-01T10:05:48,Amurrio,incomes,salary_partner,1034.49,-28551.74
buyer_3,Ana,35,ES73209501612803164263,TRX_N-00468-93039727,2023-02-01T10:05:48,Amurrio,incomes,extra_income,244.88,-28306.86
buyer_3,Ana,35,ES73209501612803164263,TRX_N-00469-17608110,2023-02-03T18:01:34,Eibar,expenses,food,-80.3,-28387.16
buyer_3,Ana,35,ES73209501612803164263,TRX_N-00470-14961769,2023-02-03T17:59:03,Amurrio,expenses,cash,-100.0,-28487.16
buyer_3,Ana,35,ES73209501612803164263,TRX_N-00471-30263538,2023-02-03T10:23:35,Amurrio,expenses,travel,-282.55,-28769.71
buyer_3,Ana,35,ES73209501612803164263,TRX_N-00472-36630383,2023-02-04T14:22:58,Amurrio,expenses,mortgage,-938.86,-29708.57
buyer_3,Ana,35,ES73209501612803164263,TRX_N-00473-24474824,2023-02-04T18:36:15,Irun,expenses,food,-69.6,-29778.17
buyer_3,Ana,35,ES73209501612803164263,TRX_N-00474-29022252,2023-02-05T15:03:39,Amurrio,expenses,gas,-111.73,-29889.9
buyer_3,Ana,35,ES73209501612803164263,TRX_N-00475-47013722,2023-02-06T10:18:26,Amurrio,expenses,water,-42.24,-29932.14
buyer_3,Ana,35,ES73209501612803164263,TRX_N-00476-54345287,2023-02-06T08:19:34,Amurrio,expenses,phone,-43.82,-29975.96
buyer_3,Ana,35,ES73209501612803164263,TRX_N-00477-12507698,2023-02-06T17:34:08,Amurrio,expenses,cash,-100.0,-30075.96
buyer_3,Ana,35,ES73209501612803164263,TRX_N-00478-90825851,2023-02-08T18:41:44,Amurrio,expenses,internet,-42.0,-30117.96
buyer_3,Ana,35,ES73209501612803164263,TRX_N-00479-11538512,2023-02-08T17:34:48,Amurrio,expenses,electricity,-57.64,-30175.6
buyer_3,Ana,35,ES73209501612803164263,TRX_N-00480-60703904,2023-02-08T11:58:57,Amurrio,expenses,transport,-72.4,-30248.0
buyer_3,Ana,35,ES73209501612803164263,TRX_N-00481-90239823,2023-02-11T09:48:36,Amurrio,expenses,repairs,-168.89,-30416.89
buyer_3,Ana,35,ES73209501612803164263,TRX_N-00482-33925752,2023-02-11T10:50:46,Amurrio,expenses,gifts,-166.19,-30583.08
buyer_3,Ana,35,ES73209501612803164263,TRX_N-00483-11484876,2023-02-13T12:37:58,Amurrio,expenses,transport,-62.81,-30645.89
buyer_3,Ana,35,ES73209501612803164263,TRX_N-00484-58051674,2023-02-13T19:07:36,Amurrio,expenses,cash,-100.0,-30745.89
buyer_3,Ana,35,ES73209501612803164263,TRX_N-00485-89872356,2023-02-16T13:33:35,Amurrio,expenses,food,-120.72,-30866.61
buyer_3,Ana,35,ES73209501612803164263,TRX_N-00486-54118469,2023-02-17T19:03:37,Mungia,expenses,food,-112.3,-30978.91
buyer_3,Ana,35,ES73209501612803164263,TRX_N-00487-22078425,2023-02-19T20:42:32,Amurrio,expenses,food,-93.25,-31072.16
buyer_3,Ana,35,ES73209501612803164263,TRX_N-00488-84303227,2023-02-20T19:43:39,Sestao,expenses,education,-64.98,-31137.14
buyer_3,Ana,35,ES73209501612803164263,TRX_N-00489-13570028,2023-02-22T15:58:58,Zarautz,expenses,transport,-80.85,-31217.99
buyer_3,Ana,35,ES73209501612803164263,TRX_N-00490-42473572,2023-02-23T08:11:20,Andoain,expenses,travel,-1185.98,-32403.97
buyer_3,Ana,35,ES73209501612803164263,TRX_N-00491-36534355,2023-02-24T14:02:41,Amurrio,expenses,leisure,-78.82,-32482.79
buyer_3,Ana,35,ES73209501612803164263,TRX_N-00492-17412421,2023-02-25T16:20:19,Sopela,expenses,cash,-100.0,-32582.79
buyer_3,Ana,35,ES73209501612803164263,TRX_N-00493-85662179,2023-02-26T15:11:04,Amurrio,expenses,education,-67.86,-32650.65
buyer_3,Ana,35,ES73209501612803164263,TRX_N-00494-42308236,2023-03-01T18:53:37,Amurrio,incomes,salary,1547.34,-31103.31
buyer_3,Ana,35,ES73209501612803164263,TRX_N-00495-44403711,2023-03-01T18:53:37,Amurrio,incomes,salary_partner,1034.49,-30068.82
buyer_3,Ana,35,ES73209501612803164263,TRX_N-00496-59933341,2023-03-03T15:47:23,Andoain,expenses,food,-116.31,-30185.13
buyer_3,Ana,35,ES73209501612803164263,TRX_N-00497-19599469,2023-03-03T10:44:14,Amurrio,expenses,leisure,-47.91,-30233.04
buyer_3,Ana,35,ES73209501612803164263,TRX_N-00498-37521558,2023-03-03T19:40:02,Amurrio,expenses,cash,-100.0,-30333.04
buyer_3,Ana,35,ES73209501612803164263,TRX_N-00499-40121877,2023-03-04T09:03:47,Amurrio,expenses,mortgage,-938.86,-31271.9
buyer_3,Ana,35,ES73209501612803164263,TRX_N-00500-22492302,2023-03-04T09:23:12,Labastida,expenses,education,-51.01,-31322.91
buyer_3,Ana,35,ES73209501612803164263,TRX_N-00501-26011272,2023-03-04T18:27:18,Amurrio,expenses,repairs,-227.4,-31550.31
buyer_3,Ana,35,ES73209501612803164263,TRX_N-00502-15565888,2023-03-05T15:00:39,Amurrio,expenses,water,-24.88,-31575.19
buyer_3,Ana,35,ES73209501612803164263,TRX_N-00503-72766164,2023-03-06T14:46:27,Amurrio,expenses,appliances,-144.78,-31719.97
buyer_3,Ana,35,ES73209501612803164263,TRX_N-00504-77245064,2023-03-07T20:54:47,Amurrio,expenses,electricity,-59.25,-31779.22
buyer_3,Ana,35,ES73209501612803164263,TRX_N-00505-69039357,2023-03-07T14:03:29,Amurrio,expenses,education,-75.38,-31854.6
buyer_3,Ana,35,ES73209501612803164263,TRX_N-00506-75632312,2023-03-08T08:40:11,Amurrio,expenses,gas,-52.66,-31907.26
buyer_3,Ana,35,ES73209501612803164263,TRX_N-00507-73047128,2023-03-08T17:05:26,Amurrio,expenses,internet,-42.0,-31949.26
buyer_3,Ana,35,ES73209501612803164263,TRX_N-00508-96496731,2023-03-08T18:42:57,Amurrio,expenses,phone,-43.65,-31992.91
buyer_3,Ana,35,ES73209501612803164263,TRX_N-00509-20978763,2023-03-09T12:51:36,Amurrio,expenses,cash,-100.0,-32092.91
buyer_3,Ana,35,ES73209501612803164263,TRX_N-00510-82378814,2023-03-10T10:39:55,Amurrio,expenses,food,-66.72,-32159.63
buyer_3,Ana,35,ES73209501612803164263,TRX_N-00511-50488732,2023-03-14T11:08:47,Amurrio,expenses,education,-54.39,-32214.02
buyer_3,Ana,35,ES73209501612803164263,TRX_N-00512-73663139,2023-03-14T19:53:18,Amurrio,expenses,cash,-100.0,-32314.02
buyer_3,Ana,35,ES73209501612803164263,TRX_N-00513-89863689,2023-03-16T10:10:48,Amurrio,expenses,repairs,-141.11,-32455.13
buyer_3,Ana,35,ES73209501612803164263,TRX_N-00514-76292074,2023-03-19T19:13:30,Amurrio,expenses,education,-59.62,-32514.75
buyer_3,Ana,35,ES73209501612803164263,TRX_N-00515-43328695,2023-03-19T15:43:05,Amurrio,expenses,appliances,-361.91,-32876.66
buyer_3,Ana,35,ES73209501612803164263,TRX_N-00516-79588921,2023-03-19T10:41:16,Amurrio,expenses,children,-204.89,-33081.55
buyer_3,Ana,35,ES73209501612803164263,TRX_N-00517-96308334,2023-03-21T11:04:22,Amurrio,expenses,leisure,-50.66,-33132.21
buyer_3,Ana,35,ES73209501612803164263,TRX_N-00518-48508962,2023-03-22T21:41:19,Elciego,expenses,food,-93.71,-33225.92
buyer_3,Ana,35,ES73209501612803164263,TRX_N-00519-64309728,2023-03-24T20:28:50,Amurrio,expenses,food,-84.42,-33310.34
buyer_3,Ana,35,ES73209501612803164263,TRX_N-00520-89470004,2023-03-24T10:56:05,Amurrio,expenses,cash,-100.0,-33410.34
buyer_3,Ana,35,ES73209501612803164263,TRX_N-00521-17281028,2023-03-25T15:57:17,Amurrio,expenses,transport,-70.72,-33481.06
buyer_3,Ana,35,ES73209501612803164263,TRX_N-00522-94033038,2023-03-26T14:54:19,Amurrio,expenses,repairs,-75.1,-33556.16
buyer_3,Ana,35,ES73209501612803164263,TRX_N-00523-73216639,2023-03-27T11:27:44,Amurrio,expenses,cash,-100.0,-33656.16
buyer_3,Ana,35,ES73209501612803164263,TRX_N-00524-18571616,2023-03-29T11:40:04,Oyón-Oion,expenses,food,-66.64,-33722.8
buyer_3,Ana,35,ES73209501612803164263,TRX_N-00525-79131984,2023-03-29T12:18:47,Llodio,expenses,transport,-40.03,-33762.83
buyer_3,Ana,35,ES73209501612803164263,TRX_N-00526-57722794,2023-03-29T14:33:06,Amurrio,expenses,cash,-100.0,-33862.83
buyer_3,Ana,35,ES73209501612803164263,TRX_N-00527-87994083,2023-03-30T09:13:32,Amurrio,expenses,transport,-75.32,-33938.15
buyer_3,Ana,35,ES73209501612803164263,TRX_N-00528-36254456,2023-03-30T23:47:01,Amurrio,expenses,cash,-100.0,-34038.15
buyer_3,Ana,35,ES73209501612803164263,TRX_N-00529-56256003,2023-04-01T12:00:21,Amurrio,incomes,salary,1547.34,-32490.81
buyer_3,Ana,35,ES73209501612803164263,TRX_N-00530-29652894,2023-04-01T12:00:21,Amurrio,incomes,salary_partner,1034.49,-31456.32
buyer_3,Ana,35,ES73209501612803164263,TRX_N-00531-34428708,2023-04-01T10:15:39,Amurrio,expenses,transport,-65.49,-31521.81
buyer_3,Ana,35,ES73209501612803164263,TRX_N-00532-68434572,2023-04-01T20:56:24,Amurrio,expenses,leisure,-61.47,-31583.28
buyer_3,Ana,35,ES73209501612803164263,TRX_N-00533-53969597,2023-04-02T18:34:41,Amurrio,expenses,leisure,-22.46,-31605.74
buyer_3,Ana,35,ES73209501612803164263,TRX_N-00534-21446124,2023-04-02T14:57:41,Amurrio,expenses,cash,-100.0,-31705.74
buyer_3,Ana,35,ES73209501612803164263,TRX_N-00535-04768496,2023-04-04T10:39:58,Amurrio,expenses,mortgage,-938.86,-32644.6
buyer_3,Ana,35,ES73209501612803164263,TRX_N-00536-12741013,2023-04-04T20:50:09,Amurrio,expenses,leisure,-39.18,-32683.78
buyer_3,Ana,35,ES73209501612803164263,TRX_N-00537-37945388,2023-04-05T01:31:49,Amurrio,expenses,gas,-37.13,-32720.91
buyer_3,Ana,35,ES73209501612803164263,TRX_N-00538-20811828,2023-04-06T21:33:54,Amurrio,expenses,internet,-42.0,-32762.91
buyer_3,Ana,35,ES73209501612803164263,TRX_N-00539-85953886,2023-04-07T04:55:26,Amurrio,expenses,water,-35.6,-32798.51
buyer_3,Ana,35,ES73209501612803164263,TRX_N-00540-06175667,2023-04-08T13:03:56,Amurrio,expenses,phone,-42.66,-32841.17
buyer_3,Ana,35,ES73209501612803164263,TRX_N-00541-74262250,2023-04-08T17:46:27,Amurrio,expenses,electricity,-30.51,-32871.68
buyer_3,Ana,35,ES73209501612803164263,TRX_N-00542-68163674,2023-04-08T13:42:12,Amurrio,expenses,food,-111.2,-32982.88
buyer_3,Ana,35,ES73209501612803164263,TRX_N-00543-10906645,2023-04-09T23:36:42,Amurrio,expenses,food,-82.97,-33065.85
buyer_3,Ana,35,ES73209501612803164263,TRX_N-00544-52136141,2023-04-09T13:57:21,Errenteria,expenses,clothing,-106.71,-33172.56
buyer_3,Ana,35,ES73209501612803164263,TRX_N-00545-90436492,2023-04-11T04:55:35,Amurrio,expenses,food,-99.37,-33271.93
buyer_3,Ana,35,ES73209501612803164263,TRX_N-00546-47449765,2023-04-11T19:16:23,Amurrio,expenses,gifts,-578.63,-33850.56
buyer_3,Ana,35,ES73209501612803164263,TRX_N-00547-60002047,2023-04-12T20:57:31,Amurrio,expenses,transport,-72.6,-33923.16
buyer_3,Ana,35,ES73209501612803164263,TRX_N-00548-58576766,2023-04-12T23:05:06,Arrasate,expenses,leisure,-21.29,-33944.45
buyer_3,Ana,35,ES73209501612803164263,TRX_N-00549-24085655,2023-04-12T19:42:35,Mungia,expenses,clothing,-140.34,-34084.79
buyer_3,Ana,35,ES73209501612803164263,TRX_N-00550-80129364,2023-04-13T18:02:27,Amurrio,expenses,food,-122.69,-34207.48
buyer_3,Ana,35,ES73209501612803164263,TRX_N-00551-27915078,2023-04-14T14:51:45,Amurrio,expenses,transport,-61.67,-34269.15
buyer_3,Ana,35,ES73209501612803164263,TRX_N-00552-32336749,2023-04-14T03:57:58,Amurrio,expenses,gifts,-84.7,-34353.85
buyer_3,Ana,35,ES73209501612803164263,TRX_N-00553-40542657,2023-04-15T15:01:14,Amurrio,expenses,leisure,-84.03,-34437.88
buyer_3,Ana,35,ES73209501612803164263,TRX_N-00554-74825967,2023-04-16T15:00:55,Amurrio,expenses,healthcare,-139.87,-34577.75
buyer_3,Ana,35,ES73209501612803164263,TRX_N-00555-26604933,2023-04-16T18:00:50,Amurrio,expenses,children,-268.59,-34846.34
buyer_3,Ana,35,ES73209501612803164263,TRX_N-00556-42159219,2023-04-17T13:35:49,Amurrio,expenses,cash,-100.0,-34946.34
buyer_3,Ana,35,ES73209501612803164263,TRX_N-00557-18527387,2023-04-18T14:39:27,Amurrio,expenses,transport,-45.04,-34991.38
buyer_3,Ana,35,ES73209501612803164263,TRX_N-00558-62534847,2023-04-18T18:27:58,Pasaia,expenses,cash,-100.0,-35091.38
buyer_3,Ana,35,ES73209501612803164263,TRX_N-00559-13216275,2023-04-19T01:26:42,Amurrio,expenses,leisure,-56.42,-35147.8
buyer_3,Ana,35,ES73209501612803164263,TRX_N-00560-69974330,2023-04-20T23:10:00,Amurrio,expenses,education,-63.72,-35211.52
buyer_3,Ana,35,ES73209501612803164263,TRX_N-00561-32011611,2023-04-21T15:16:37,Amurrio,expenses,leisure,-39.58,-35251.1
buyer_3,Ana,35,ES73209501612803164263,TRX_N-00562-32360655,2023-04-21T23:07:49,Sestao,expenses,cash,-100.0,-35351.1
buyer_3,Ana,35,ES73209501612803164263,TRX_N-00563-71043170,2023-04-24T11:37:49,Amurrio,expenses,food,-62.26,-35413.36
buyer_3,Ana,35,ES73209501612803164263,TRX_N-00564-80506443,2023-04-24T13:20:03,Amurrio,expenses,transport,-60.45,-35473.81
buyer_3,Ana,35,ES73209501612803164263,TRX_N-00565-06792149,2023-04-25T13:13:40,Amurrio,expenses,education,-50.18,-35523.99
buyer_3,Ana,35,ES73209501612803164263,TRX_N-00566-68841250,2023-04-25T19:46:05,Amurrio,expenses,gifts,-669.58,-36193.57
buyer_3,Ana,35,ES73209501612803164263,TRX_N-00567-95703940,2023-04-26T11:51:36,Amurrio,expenses,cash,-100.0,-36293.57
buyer_3,Ana,35,ES73209501612803164263,TRX_N-00568-16555945,2023-04-29T08:57:55,Amurrio,expenses,travel,-815.26,-37108.83
buyer_3,Ana,35,ES73209501612803164263,TRX_N-00569-34547064,2023-05-01T12:38:34,Amurrio,incomes,salary,1547.34,-35561.49
buyer_3,Ana,35,ES73209501612803164263,TRX_N-00570-04061426,2023-05-01T12:38:34,Amurrio,incomes,salary_partner,1034.49,-34527.0
buyer_3,Ana,35,ES73209501612803164263,TRX_N-00571-13067610,2023-05-01T14:23:20,Amurrio,expenses,food,-120.77,-34647.77
buyer_3,Ana,35,ES73209501612803164263,TRX_N-00572-03585807,2023-05-01T10:54:44,Amurrio,expenses,transport,-61.5,-34709.27
buyer_3,Ana,35,ES73209501612803164263,TRX_N-00573-39623625,2023-05-01T20:30:36,Amurrio,expenses,gifts,-272.08,-34981.35
buyer_3,Ana,35,ES73209501612803164263,TRX_N-00574-45854161,2023-05-02T10:41:25,Amurrio,expenses,transport,-54.14,-35035.49
buyer_3,Ana,35,ES73209501612803164263,TRX_N-00575-52709771,2023-05-04T15:43:42,Amurrio,expenses,mortgage,-938.86,-35974.35
buyer_3,Ana,35,ES73209501612803164263,TRX_N-00576-48357445,2023-05-04T16:46:10,Hondarribia,expenses,leisure,-67.29,-36041.64
buyer_3,Ana,35,ES73209501612803164263,TRX_N-00577-46907259,2023-05-04T16:00:10,Amurrio,expenses,clothing,-143.07,-36184.71
buyer_3,Ana,35,ES73209501612803164263,TRX_N-00578-76289917,2023-05-05T13:25:59,Amurrio,expenses,internet,-42.0,-36226.71
buyer_3,Ana,35,ES73209501612803164263,TRX_N-00579-21647727,2023-05-05T17:47:16,Amurrio,expenses,phone,-44.42,-36271.13
buyer_3,Ana,35,ES73209501612803164263,TRX_N-00580-37860496,2023-05-06T09:49:10,Andoain,expenses,leisure,-37.93,-36309.06
buyer_3,Ana,35,ES73209501612803164263,TRX_N-00581-25597389,2023-05-07T21:53:53,Amurrio,expenses,transport,-76.67,-36385.73
buyer_3,Ana,35,ES73209501612803164263,TRX_N-00582-85390016,2023-05-07T23:17:03,Amurrio,expenses,repairs,-284.97,-36670.7
buyer_3,Ana,35,ES73209501612803164263,TRX_N-00583-41613892,2023-05-08T20:37:37,Amurrio,expenses,water,-24.65,-36695.35
buyer_3,Ana,35,ES73209501612803164263,TRX_N-00584-46607694,2023-05-08T18:34:56,Amurrio,expenses,electricity,-65.96,-36761.31
buyer_3,Ana,35,ES73209501612803164263,TRX_N-00585-78279791,2023-05-08T17:26:16,Amurrio,expenses,gas,-66.56,-36827.87
buyer_3,Ana,35,ES73209501612803164263,TRX_N-00586-97554798,2023-05-08T08:59:11,Amurrio,expenses,transport,-71.63,-36899.5
buyer_3,Ana,35,ES73209501612803164263,TRX_N-00587-21005929,2023-05-10T12:40:20,Bilbao,expenses,food,-90.34,-36989.84
buyer_3,Ana,35,ES73209501612803164263,TRX_N-00588-69213703,2023-05-12T18:19:24,Bermeo,expenses,leisure,-29.5,-37019.34
buyer_3,Ana,35,ES73209501612803164263,TRX_N-00589-48428290,2023-05-12T10:30:32,Amurrio,expenses,repairs,-71.14,-37090.48
buyer_3,Ana,35,ES73209501612803164263,TRX_N-00590-35391953,2023-05-13T22:25:29,Berango,expenses,food,-63.87,-37154.35
buyer_3,Ana,35,ES73209501612803164263,TRX_N-00591-83457083,2023-05-15T15:56:38,Amurrio,expenses,transport,-54.6,-37208.95
buyer_3,Ana,35,ES73209501612803164263,TRX_N-00592-16733949,2023-05-17T21:49:26,Amurrio,expenses,food,-60.84,-37269.79
buyer_3,Ana,35,ES73209501612803164263,TRX_N-00593-61245868,2023-05-19T09:45:43,Amurrio,expenses,food,-63.27,-37333.06
buyer_3,Ana,35,ES73209501612803164263,TRX_N-00594-36418849,2023-05-20T09:21:36,Andoain,expenses,cash,-100.0,-37433.06
buyer_3,Ana,35,ES73209501612803164263,TRX_N-00595-61251761,2023-05-20T18:34:19,Amurrio,expenses,repairs,-39.76,-37472.82
buyer_3,Ana,35,ES73209501612803164263,TRX_N-00596-93182583,2023-05-21T02:37:55,Leioa,expenses,leisure,-75.85,-37548.67
buyer_3,Ana,35,ES73209501612803164263,TRX_N-00597-03788972,2023-05-22T14:03:09,Amurrio,expenses,cash,-100.0,-37648.67
buyer_3,Ana,35,ES73209501612803164263,TRX_N-00598-56167423,2023-05-23T18:26:22,Amurrio,expenses,repairs,-298.15,-37946.82
buyer_3,Ana,35,ES73209501612803164263,TRX_N-00599-74941140,2023-05-25T14:26:22,Amurrio,expenses,leisure,-27.31,-37974.13
buyer_3,Ana,35,ES73209501612803164263,TRX_N-00600-54915470,2023-05-27T22:24:13,Amurrio,expenses,transport,-60.21,-38034.34
buyer_3,Ana,35,ES73209501612803164263,TRX_N-00601-14312148,2023-05-28T12:47:22,Amurrio,expenses,repairs,-262.08,-38296.42
buyer_3,Ana,35,ES73209501612803164263,TRX_N-00602-82716778,2023-05-31T13:54:48,Amurrio,expenses,food,-94.23,-38390.65
buyer_3,Ana,35,ES73209501612803164263,TRX_N-00603-77297319,2023-06-01T17:31:37,Amurrio,incomes,salary,1547.34,-36843.31
buyer_3,Ana,35,ES73209501612803164263,TRX_N-00604-03566223,2023-06-01T17:31:37,Amurrio,incomes,salary_partner,1034.49,-35808.82
buyer_3,Ana,35,ES73209501612803164263,TRX_N-00605-56278645,2023-06-01T17:31:37,Amurrio,incomes,extra_income,244.88,-35563.94
buyer_3,Ana,35,ES73209501612803164263,TRX_N-00606-04959661,2023-06-01T17:31:37,Amurrio,incomes,salary_bonus,1135.56,-34428.38
buyer_3,Ana,35,ES73209501612803164263,TRX_N-00607-48038008,2023-06-01T17:31:37,Amurrio,incomes,salary_partner_bonus,800.63,-33627.75
buyer_3,Ana,35,ES73209501612803164263,TRX_N-00608-11513493,2023-06-01T02:39:58,Zuia,expenses,clothing,-96.0,-33723.75
buyer_3,Ana,35,ES73209501612803164263,TRX_N-00609-38344291,2023-06-02T14:37:19,Amurrio,expenses,education,-63.69,-33787.44
buyer_3,Ana,35,ES73209501612803164263,TRX_N-00610-52340521,2023-06-04T21:52:39,Amurrio,expenses,mortgage,-938.86,-34726.3
buyer_3,Ana,35,ES73209501612803164263,TRX_N-00611-87446502,2023-06-04T08:09:56,Amurrio,expenses,cash,-100.0,-34826.3
buyer_3,Ana,35,ES73209501612803164263,TRX_N-00612-77397637,2023-06-05T14:45:11,Amurrio,expenses,water,-32.78,-34859.08
buyer_3,Ana,35,ES73209501612803164263,TRX_N-00613-51785169,2023-06-05T13:34:34,Amurrio,expenses,phone,-32.33,-34891.41
buyer_3,Ana,35,ES73209501612803164263,TRX_N-00614-02598336,2023-06-05T19:51:57,Amurrio,expenses,cash,-100.0,-34991.41
buyer_3,Ana,35,ES73209501612803164263,TRX_N-00615-29371166,2023-06-06T13:11:39,Amurrio,expenses,electricity,-83.38,-35074.79
buyer_3,Ana,35,ES73209501612803164263,TRX_N-00616-83844621,2023-06-06T15:07:13,Amurrio,expenses,gas,-99.88,-35174.67
buyer_3,Ana,35,ES73209501612803164263,TRX_N-00617-15541425,2023-06-06T15:09:20,Amurrio,expenses,transport,-80.61,-35255.28
buyer_3,Ana,35,ES73209501612803164263,TRX_N-00618-02942688,2023-06-07T11:53:59,Amurrio,expenses,internet,-42.0,-35297.28
buyer_3,Ana,35,ES73209501612803164263,TRX_N-00619-92724923,2023-06-07T21:53:04,Amurrio,expenses,leisure,-46.39,-35343.67
buyer_3,Ana,35,ES73209501612803164263,TRX_N-00620-28700349,2023-06-07T19:18:48,Amurrio,expenses,repairs,-89.7,-35433.37
buyer_3,Ana,35,ES73209501612803164263,TRX_N-00621-05743078,2023-06-08T13:04:09,Amurrio,expenses,cash,-100.0,-35533.37
buyer_3,Ana,35,ES73209501612803164263,TRX_N-00622-26090141,2023-06-08T10:02:40,Amurrio,expenses,repairs,-252.39,-35785.76
buyer_3,Ana,35,ES73209501612803164263,TRX_N-00623-56667277,2023-06-08T18:35:37,Amurrio,expenses,children,-82.29,-35868.05
buyer_3,Ana,35,ES73209501612803164263,TRX_N-00624-70530054,2023-06-10T16:55:19,Amurrio,expenses,transport,-74.96,-35943.01
buyer_3,Ana,35,ES73209501612803164263,TRX_N-00625-91464060,2023-06-10T18:30:04,Amurrio,expenses,cash,-100.0,-36043.01
buyer_3,Ana,35,ES73209501612803164263,TRX_N-00626-49985680,2023-06-10T15:51:46,Durango,expenses,repairs,-66.14,-36109.15
buyer_3,Ana,35,ES73209501612803164263,TRX_N-00627-05334164,2023-06-11T17:52:26,Amurrio,expenses,food,-114.72,-36223.87
buyer_3,Ana,35,ES73209501612803164263,TRX_N-00628-14023288,2023-06-12T21:19:41,Amurrio,expenses,children,-154.72,-36378.59
buyer_3,Ana,35,ES73209501612803164263,TRX_N-00629-25138289,2023-06-14T22:44:56,Amurrio,expenses,cash,-100.0,-36478.59
buyer_3,Ana,35,ES73209501612803164263,TRX_N-00630-17450681,2023-06-14T12:33:47,Amurrio,expenses,travel,-978.55,-37457.14
buyer_3,Ana,35,ES73209501612803164263,TRX_N-00631-12232273,2023-06-15T12:02:05,Amurrio,expenses,cash,-100.0,-37557.14
buyer_3,Ana,35,ES73209501612803164263,TRX_N-00632-32226617,2023-06-19T06:01:01,Amurrio,expenses,leisure,-69.34,-37626.48
buyer_3,Ana,35,ES73209501612803164263,TRX_N-00633-98225145,2023-06-20T14:37:43,Amurrio,expenses,children,-155.16,-37781.64
buyer_3,Ana,35,ES73209501612803164263,TRX_N-00634-17695950,2023-06-22T00:02:06,Amurrio,expenses,healthcare,-175.09,-37956.73
buyer_3,Ana,35,ES73209501612803164263,TRX_N-00635-46102114,2023-06-25T10:59:44,Arrasate,expenses,food,-106.24,-38062.97
buyer_3,Ana,35,ES73209501612803164263,TRX_N-00636-67790280,2023-06-26T20:49:41,Amurrio,expenses,cash,-100.0,-38162.97
buyer_3,Ana,35,ES73209501612803164263,TRX_N-00637-54626549,2023-06-27T15:50:55,Amurrio,expenses,children,-53.35,-38216.32
buyer_3,Ana,35,ES73209501612803164263,TRX_N-00638-25222761,2023-06-28T17:08:20,Amurrio,expenses,food,-86.33,-38302.65
buyer_3,Ana,35,ES73209501612803164263,TRX_N-00639-45394804,2023-06-29T15:21:10,Amurrio,expenses,food,-104.73,-38407.38
buyer_3,Ana,35,ES73209501612803164263,TRX_N-00640-15996917,2023-06-29T17:03:57,Amurrio,expenses,cash,-100.0,-38507.38
buyer_3,Ana,35,ES73209501612803164263,TRX_N-00641-76510758,2023-06-29T12:00:52,Irun,expenses,repairs,-104.59,-38611.97
buyer_3,Ana,35,ES73209501612803164263,TRX_N-00642-49221171,2023-06-30T18:39:09,Amurrio,expenses,transport,-66.39,-38678.36
buyer_3,Ana,35,ES73209501612803164263,TRX_N-00643-27323160,2023-07-01T12:33:12,Amurrio,incomes,salary,1547.34,-37131.02
buyer_3,Ana,35,ES73209501612803164263,TRX_N-00644-10227076,2023-07-01T12:33:12,Amurrio,incomes,salary_partner,1034.49,-36096.53
buyer_3,Ana,35,ES73209501612803164263,TRX_N-00645-05065647,2023-07-02T15:42:37,Amurrio,expenses,cash,-100.0,-36196.53
buyer_3,Ana,35,ES73209501612803164263,TRX_N-00646-26082526,2023-07-03T16:29:29,Amurrio,expenses,transport,-59.68,-36256.21
buyer_3,Ana,35,ES73209501612803164263,TRX_N-00647-10536728,2023-07-04T14:37:01,Amurrio,expenses,mortgage,-938.86,-37195.07
buyer_3,Ana,35,ES73209501612803164263,TRX_N-00648-62758537,2023-07-04T15:57:11,Pasaia,expenses,cash,-100.0,-37295.07
buyer_3,Ana,35,ES73209501612803164263,TRX_N-00649-84482045,2023-07-04T14:56:28,Amurrio,expenses,appliances,-379.37,-37674.44
buyer_3,Ana,35,ES73209501612803164263,TRX_N-00650-92753171,2023-07-05T19:33:48,Amurrio,expenses,gas,-45.94,-37720.38
buyer_3,Ana,35,ES73209501612803164263,TRX_N-00651-95308116,2023-07-06T16:16:02,Amurrio,expenses,healthcare,-61.64,-37782.02
buyer_3,Ana,35,ES73209501612803164263,TRX_N-00652-09490817,2023-07-06T18:39:42,Amurrio,expenses,cash,-100.0,-37882.02
buyer_3,Ana,35,ES73209501612803164263,TRX_N-00653-41268695,2023-07-06T00:42:01,Amurrio,expenses,appliances,-238.27,-38120.29
buyer_3,Ana,35,ES73209501612803164263,TRX_N-00654-21038642,2023-07-07T13:08:26,Amurrio,expenses,internet,-42.0,-38162.29
buyer_3,Ana,35,ES73209501612803164263,TRX_N-00655-23668793,2023-07-07T21:16:14,Amurrio,expenses,food,-107.03,-38269.32
buyer_3,Ana,35,ES73209501612803164263,TRX_N-00656-56412998,2023-07-07T13:40:23,Amurrio,expenses,transport,-48.95,-38318.27
buyer_3,Ana,35,ES73209501612803164263,TRX_N-00657-05261695,2023-07-08T12:31:34,Amurrio,expenses,water,-22.29,-38340.56
buyer_3,Ana,35,ES73209501612803164263,TRX_N-00658-69204309,2023-07-08T10:26:17,Amurrio,expenses,electricity,-61.11,-38401.67
buyer_3,Ana,35,ES73209501612803164263,TRX_N-00659-94045186,2023-07-08T09:22:40,Amurrio,expenses,phone,-40.5,-38442.17
buyer_3,Ana,35,ES73209501612803164263,TRX_N-00660-98118676,2023-07-08T05:12:14,Amurrio,expenses,children,-220.15,-38662.32
buyer_3,Ana,35,ES73209501612803164263,TRX_N-00661-32825542,2023-07-11T13:56:20,Amurrio,expenses,food,-117.69,-38780.01
buyer_3,Ana,35,ES73209501612803164263,TRX_N-00662-98314214,2023-07-11T16:04:33,Amurrio,expenses,clothing,-74.0,-38854.01
buyer_3,Ana,35,ES73209501612803164263,TRX_N-00663-21311385,2023-07-12T15:44:21,Amurrio,expenses,cash,-100.0,-38954.01
buyer_3,Ana,35,ES73209501612803164263,TRX_N-00664-26657864,2023-07-14T11:27:27,Amurrio,expenses,food,-76.65,-39030.66
buyer_3,Ana,35,ES73209501612803164263,TRX_N-00665-36171064,2023-07-14T23:55:59,Amurrio,expenses,leisure,-39.42,-39070.08
buyer_3,Ana,35,ES73209501612803164263,TRX_N-00666-97372447,2023-07-15T11:28:37,Amurrio,expenses,transport,-89.33,-39159.41
buyer_3,Ana,35,ES73209501612803164263,TRX_N-00667-04605162,2023-07-15T12:44:46,Hondarribia,expenses,education,-63.71,-39223.12
buyer_3,Ana,35,ES73209501612803164263,TRX_N-00668-39266683,2023-07-16T13:30:28,Amurrio,expenses,appliances,-176.43,-39399.55
buyer_3,Ana,35,ES73209501612803164263,TRX_N-00669-68116513,2023-07-17T09:03:16,Amurrio,expenses,transport,-87.14,-39486.69
buyer_3,Ana,35,ES73209501612803164263,TRX_N-00670-63589375,2023-07-19T06:46:40,Amurrio,expenses,transport,-42.16,-39528.85
buyer_3,Ana,35,ES73209501612803164263,TRX_N-00671-84909295,2023-07-20T11:22:30,Eibar,expenses,transport,-67.55,-39596.4
buyer_3,Ana,35,ES73209501612803164263,TRX_N-00672-59353148,2023-07-20T13:48:39,Amurrio,expenses,cash,-100.0,-39696.4
buyer_3,Ana,35,ES73209501612803164263,TRX_N-00673-74622010,2023-07-21T15:34:58,Amurrio,expenses,transport,-77.73,-39774.13
buyer_3,Ana,35,ES73209501612803164263,TRX_N-00674-16256697,2023-07-22T12:23:14,Bilbao,expenses,food,-85.48,-39859.61
buyer_3,Ana,35,ES73209501612803164263,TRX_N-00675-24372277,2023-07-22T19:14:46,Amurrio,expenses,cash,-100.0,-39959.61
buyer_3,Ana,35,ES73209501612803164263,TRX_N-00676-69497985,2023-07-23T11:38:08,Amurrio,expenses,cash,-100.0,-40059.61
buyer_3,Ana,35,ES73209501612803164263,TRX_N-00677-81721165,2023-07-24T04:02:44,Amurrio,expenses,cash,-100.0,-40159.61
buyer_3,Ana,35,ES73209501612803164263,TRX_N-00678-24754556,2023-07-27T18:33:08,Amurrio,expenses,food,-94.44,-40254.05
buyer_3,Ana,35,ES73209501612803164263,TRX_N-00679-19760646,2023-07-27T17:41:47,Amurrio,expenses,gifts,-665.87,-40919.92
buyer_3,Ana,35,ES73209501612803164263,TRX_N-00680-73010079,2023-07-28T12:30:37,Amurrio,expenses,clothing,-129.1,-41049.02
buyer_3,Ana,35,ES73209501612803164263,TRX_N-00681-43013636,2023-07-29T10:39:17,Amurrio,expenses,clothing,-73.34,-41122.36
buyer_3,Ana,35,ES73209501612803164263,TRX_N-00682-65173213,2023-07-30T17:49:30,Amurrio,expenses,transport,-83.12,-41205.48
buyer_3,Ana,35,ES73209501612803164263,TRX_N-00683-81751708,2023-07-30T16:26:52,Amurrio,expenses,leisure,-59.06,-41264.54
buyer_3,Ana,35,ES73209501612803164263,TRX_N-00684-96886744,2023-07-30T20:43:37,Amurrio,expenses,children,-144.72,-41409.26
buyer_3,Ana,35,ES73209501612803164263,TRX_N-00685-48077512,2023-07-31T08:26:28,Amurrio,expenses,clothing,-136.73,-41545.99
buyer_3,Ana,35,ES73209501612803164263,TRX_N-00686-40998851,2023-07-31T18:43:14,Sopela,expenses,cash,-100.0,-41645.99
buyer_3,Ana,35,ES73209501612803164263,TRX_N-00687-07480798,2023-07-31T18:24:46,Amurrio,expenses,gifts,-286.61,-41932.6
buyer_3,Ana,35,ES73209501612803164263,TRX_N-00688-85736578,2023-08-01T12:57:16,Amurrio,incomes,salary,1547.34,-40385.26
buyer_3,Ana,35,ES73209501612803164263,TRX_N-00689-68658344,2023-08-01T12:57:16,Amurrio,incomes,salary_partner,1034.49,-39350.77
buyer_3,Ana,35,ES73209501612803164263,TRX_N-00690-64030367,2023-08-02T08:06:27,Amurrio,expenses,gifts,-292.17,-39642.94
buyer_3,Ana,35,ES73209501612803164263,TRX_N-00691-73361903,2023-08-03T05:58:58,Amurrio,expenses,clothing,-71.1,-39714.04
buyer_3,Ana,35,ES73209501612803164263,TRX_N-00692-90937177,2023-08-04T20:43:49,Amurrio,expenses,mortgage,-938.86,-40652.9
buyer_3,Ana,35,ES73209501612803164263,TRX_N-00693-12017235,2023-08-06T20:22:42,Amurrio,expenses,food,-112.3,-40765.2
buyer_3,Ana,35,ES73209501612803164263,TRX_N-00694-49984014,2023-08-07T21:59:58,Amurrio,expenses,electricity,-84.82,-40850.02
buyer_3,Ana,35,ES73209501612803164263,TRX_N-00695-10320995,2023-08-07T18:58:41,Amurrio,expenses,phone,-37.68,-40887.7
buyer_3,Ana,35,ES73209501612803164263,TRX_N-00696-59299111,2023-08-07T21:09:21,Amurrio,expenses,leisure,-43.8,-40931.5
buyer_3,Ana,35,ES73209501612803164263,TRX_N-00697-64901765,2023-08-07T12:18:16,Bilbao,expenses,cash,-100.0,-41031.5
buyer_3,Ana,35,ES73209501612803164263,TRX_N-00698-61490428,2023-08-08T18:00:50,Amurrio,expenses,water,-42.1,-41073.6
buyer_3,Ana,35,ES73209501612803164263,TRX_N-00699-82317516,2023-08-08T15:41:34,Amurrio,expenses,gas,-96.26,-41169.86
buyer_3,Ana,35,ES73209501612803164263,TRX_N-00700-68413927,2023-08-08T11:00:36,Amurrio,expenses,internet,-42.0,-41211.86
buyer_3,Ana,35,ES73209501612803164263,TRX_N-00701-05107498,2023-08-10T18:00:40,Amurrio,expenses,food,-115.94,-41327.8
buyer_3,Ana,35,ES73209501612803164263,TRX_N-00702-59432592,2023-08-12T16:17:55,Amurrio,expenses,leisure,-66.57,-41394.37
buyer_3,Ana,35,ES73209501612803164263,TRX_N-00703-11847851,2023-08-13T16:53:29,Amurrio,expenses,leisure,-66.72,-41461.09
buyer_3,Ana,35,ES73209501612803164263,TRX_N-00704-50300216,2023-08-13T05:21:15,Amurrio,expenses,cash,-100.0,-41561.09
buyer_3,Ana,35,ES73209501612803164263,TRX_N-00705-71198228,2023-08-15T23:02:01,Amurrio,expenses,repairs,-317.14,-41878.23
buyer_3,Ana,35,ES73209501612803164263,TRX_N-00706-32988967,2023-08-18T11:08:18,Amurrio,expenses,food,-95.87,-41974.1
buyer_3,Ana,35,ES73209501612803164263,TRX_N-00707-01766052,2023-08-18T20:27:25,Amurrio,expenses,cash,-100.0,-42074.1
buyer_3,Ana,35,ES73209501612803164263,TRX_N-00708-10394441,2023-08-18T11:26:52,Amurrio,expenses,gifts,-606.58,-42680.68
buyer_3,Ana,35,ES73209501612803164263,TRX_N-00709-51351367,2023-08-21T16:00:07,Lasarte-Oria,expenses,cash,-100.0,-42780.68
buyer_3,Ana,35,ES73209501612803164263,TRX_N-00710-01629075,2023-08-22T13:50:08,Amurrio,expenses,leisure,-40.55,-42821.23
buyer_3,Ana,35,ES73209501612803164263,TRX_N-00711-22974607,2023-08-22T20:54:21,Amurrio,expenses,gifts,-444.73,-43265.96
buyer_3,Ana,35,ES73209501612803164263,TRX_N-00712-09231343,2023-08-23T18:35:38,Zuia,expenses,cash,-100.0,-43365.96
buyer_3,Ana,35,ES73209501612803164263,TRX_N-00713-54087246,2023-08-24T17:17:52,Amurrio,expenses,food,-117.28,-43483.24
buyer_3,Ana,35,ES73209501612803164263,TRX_N-00714-08287515,2023-08-26T10:54:47,Amurrio,expenses,cash,-100.0,-43583.24
buyer_3,Ana,35,ES73209501612803164263,TRX_N-00715-45347504,2023-08-28T12:54:37,Amurrio,expenses,education,-74.97,-43658.21
buyer_3,Ana,35,ES73209501612803164263,TRX_N-00716-22125760,2023-08-29T00:46:42,Amurrio,expenses,cash,-100.0,-43758.21
buyer_3,Ana,35,ES73209501612803164263,TRX_N-00717-23083737,2023-08-30T21:35:11,Bermeo,expenses,clothing,-159.18,-43917.39
buyer_3,Ana,35,ES73209501612803164263,TRX_N-00718-41863584,2023-08-30T10:53:22,Amurrio,expenses,education,-51.77,-43969.16
buyer_3,Ana,35,ES73209501612803164263,TRX_N-00719-47325191,2023-09-01T08:46:51,Amurrio,incomes,salary,1547.34,-42421.82
buyer_3,Ana,35,ES73209501612803164263,TRX_N-00720-42454858,2023-09-01T08:46:51,Amurrio,incomes,salary_partner,1034.49,-41387.33
buyer_3,Ana,35,ES73209501612803164263,TRX_N-00721-68953649,2023-09-01T08:46:51,Amurrio,incomes,extra_income,244.88,-41142.45
buyer_3,Ana,35,ES73209501612803164263,TRX_N-00722-61455897,2023-09-01T13:44:08,Amurrio,expenses,repairs,-76.77,-41219.22
buyer_3,Ana,35,ES73209501612803164263,TRX_N-00723-35241719,2023-09-01T15:37:35,Amurrio,expenses,children,-193.16,-41412.38
buyer_3,Ana,35,ES73209501612803164263,TRX_N-00724-53057855,2023-09-02T19:41:20,Barakaldo,expenses,cash,-100.0,-41512.38
buyer_3,Ana,35,ES73209501612803164263,TRX_N-00725-52717344,2023-09-04T06:22:46,Amurrio,expenses,mortgage,-938.86,-42451.24
buyer_3,Ana,35,ES73209501612803164263,TRX_N-00726-57599469,2023-09-04T08:49:33,Amurrio,expenses,repairs,-50.52,-42501.76
buyer_3,Ana,35,ES73209501612803164263,TRX_N-00727-96718440,2023-09-05T23:40:44,Amurrio,expenses,water,-30.18,-42531.94
buyer_3,Ana,35,ES73209501612803164263,TRX_N-00728-00173642,2023-09-05T16:22:37,Amurrio,expenses,gas,-109.06,-42641.0
buyer_3,Ana,35,ES73209501612803164263,TRX_N-00729-77718814,2023-09-05T16:21:29,Amurrio,expenses,phone,-40.88,-42681.88
buyer_3,Ana,35,ES73209501612803164263,TRX_N-00730-49040566,2023-09-06T14:27:19,Amurrio,expenses,internet,-42.0,-42723.88
buyer_3,Ana,35,ES73209501612803164263,TRX_N-00731-98750953,2023-09-06T16:33:12,Salvatierra/Agurain,expenses,food,-106.7,-42830.58
buyer_3,Ana,35,ES73209501612803164263,TRX_N-00732-37899616,2023-09-06T07:56:03,Amurrio,expenses,leisure,-23.75,-42854.33
buyer_3,Ana,35,ES73209501612803164263,TRX_N-00733-46127480,2023-09-08T18:11:02,Amurrio,expenses,electricity,-46.97,-42901.3
buyer_3,Ana,35,ES73209501612803164263,TRX_N-00734-51075437,2023-09-09T16:59:25,Amurrio,expenses,food,-99.48,-43000.78
buyer_3,Ana,35,ES73209501612803164263,TRX_N-00735-04379082,2023-09-10T14:16:52,Amurrio,expenses,transport,-42.31,-43043.09
buyer_3,Ana,35,ES73209501612803164263,TRX_N-00736-03846118,2023-09-10T11:37:55,Amurrio,expenses,repairs,-293.83,-43336.92
buyer_3,Ana,35,ES73209501612803164263,TRX_N-00737-85750527,2023-09-12T23:28:40,Amurrio,expenses,food,-79.78,-43416.7
buyer_3,Ana,35,ES73209501612803164263,TRX_N-00738-12778485,2023-09-12T15:59:37,Amurrio,expenses,children,-100.76,-43517.46
buyer_3,Ana,35,ES73209501612803164263,TRX_N-00739-47727304,2023-09-14T01:08:47,Amurrio,expenses,food,-92.15,-43609.61
buyer_3,Ana,35,ES73209501612803164263,TRX_N-00740-75681922,2023-09-14T12:46:12,Amurrio,expenses,leisure,-28.0,-43637.61
buyer_3,Ana,35,ES73209501612803164263,TRX_N-00741-58466032,2023-09-17T08:38:32,Amurrio,expenses,cash,-100.0,-43737.61
buyer_3,Ana,35,ES73209501612803164263,TRX_N-00742-19695724,2023-09-19T08:31:41,Amurrio,expenses,education,-63.25,-43800.86
buyer_3,Ana,35,ES73209501612803164263,TRX_N-00743-94664666,2023-09-21T20:38:41,Amurrio,expenses,food,-66.79,-43867.65
buyer_3,Ana,35,ES73209501612803164263,TRX_N-00744-85454538,2023-09-22T17:17:05,Amurrio,expenses,leisure,-40.17,-43907.82
buyer_3,Ana,35,ES73209501612803164263,TRX_N-00745-32485335,2023-09-22T19:25:58,Leioa,expenses,cash,-100.0,-44007.82
buyer_3,Ana,35,ES73209501612803164263,TRX_N-00746-85500058,2023-09-24T18:49:06,Amurrio,expenses,transport,-59.99,-44067.81
buyer_3,Ana,35,ES73209501612803164263,TRX_N-00747-36886708,2023-09-24T11:46:14,Amurrio,expenses,clothing,-138.24,-44206.05
buyer_3,Ana,35,ES73209501612803164263,TRX_N-00748-59493917,2023-09-24T17:12:38,Amurrio,expenses,cash,-100.0,-44306.05
buyer_3,Ana,35,ES73209501612803164263,TRX_N-00749-14923868,2023-09-27T12:44:27,Amurrio,expenses,cash,-100.0,-44406.05
buyer_3,Ana,35,ES73209501612803164263,TRX_N-00750-54037241,2023-09-28T20:52:29,Amurrio,expenses,children,-122.64,-44528.69
buyer_3,Ana,35,ES73209501612803164263,TRX_N-00751-33180154,2023-09-29T11:30:59,Salvatierra/Agurain,expenses,clothing,-60.87,-44589.56
buyer_3,Ana,35,ES73209501612803164263,TRX_N-00752-28353021,2023-09-30T14:11:38,Amurrio,expenses,education,-46.63,-44636.19
buyer_3,Ana,35,ES73209501612803164263,TRX_N-00753-45147903,2023-10-01T12:30:57,Amurrio,incomes,salary,1547.34,-43088.85
buyer_3,Ana,35,ES73209501612803164263,TRX_N-00754-27743550,2023-10-01T12:30:57,Amurrio,incomes,salary_partner,1034.49,-42054.36
buyer_3,Ana,35,ES73209501612803164263,TRX_N-00755-44058222,2023-10-01T11:00:43,Leioa,expenses,healthcare,-172.26,-42226.62
buyer_3,Ana,35,ES73209501612803164263,TRX_N-00756-91058650,2023-10-03T13:02:43,Amurrio,expenses,transport,-80.86,-42307.48
buyer_3,Ana,35,ES73209501612803164263,TRX_N-00757-96027849,2023-10-03T14:15:39,Amurrio,expenses,cash,-100.0,-42407.48
buyer_3,Ana,35,ES73209501612803164263,TRX_N-00758-05186385,2023-10-04T17:43:50,Amurrio,expenses,mortgage,-938.86,-43346.34
buyer_3,Ana,35,ES73209501612803164263,TRX_N-00759-04666401,2023-10-04T11:54:48,Bilbao,expenses,repairs,-284.17,-43630.51
buyer_3,Ana,35,ES73209501612803164263,TRX_N-00760-49753629,2023-10-05T19:32:18,Amurrio,expenses,electricity,-81.27,-43711.78
buyer_3,Ana,35,ES73209501612803164263,TRX_N-00761-12341128,2023-10-05T09:29:48,Amurrio,expenses,gas,-104.14,-43815.92
buyer_3,Ana,35,ES73209501612803164263,TRX_N-00762-14257030,2023-10-05T15:51:34,Amurrio,expenses,phone,-44.94,-43860.86
buyer_3,Ana,35,ES73209501612803164263,TRX_N-00763-42992928,2023-10-05T14:25:37,Amurrio,expenses,leisure,-35.82,-43896.68
buyer_3,Ana,35,ES73209501612803164263,TRX_N-00764-69782998,2023-10-05T23:36:27,Amurrio,expenses,cash,-100.0,-43996.68
buyer_3,Ana,35,ES73209501612803164263,TRX_N-00765-07585010,2023-10-06T04:07:08,Amurrio,expenses,internet,-42.0,-44038.68
buyer_3,Ana,35,ES73209501612803164263,TRX_N-00766-81130492,2023-10-06T07:54:16,Amurrio,expenses,transport,-74.21,-44112.89
buyer_3,Ana,35,ES73209501612803164263,TRX_N-00767-29127285,2023-10-07T00:22:50,Amurrio,expenses,water,-20.61,-44133.5
buyer_3,Ana,35,ES73209501612803164263,TRX_N-00768-51685147,2023-10-08T15:39:54,Amurrio,expenses,cash,-100.0,-44233.5
buyer_3,Ana,35,ES73209501612803164263,TRX_N-00769-48162607,2023-10-10T17:01:44,Amurrio,expenses,food,-67.15,-44300.65
buyer_3,Ana,35,ES73209501612803164263,TRX_N-00770-20060436,2023-10-10T21:57:33,Amurrio,expenses,cash,-100.0,-44400.65
buyer_3,Ana,35,ES73209501612803164263,TRX_N-00771-58975595,2023-10-11T08:21:47,Amurrio,expenses,leisure,-70.19,-44470.84
buyer_3,Ana,35,ES73209501612803164263,TRX_N-00772-02087370,2023-10-16T15:46:23,Amurrio,expenses,leisure,-50.7,-44521.54
buyer_3,Ana,35,ES73209501612803164263,TRX_N-00773-99360587,2023-10-17T20:54:46,Amurrio,expenses,children,-248.43,-44769.97
buyer_3,Ana,35,ES73209501612803164263,TRX_N-00774-33033569,2023-10-18T12:27:58,Amurrio,expenses,education,-58.13,-44828.1
buyer_3,Ana,35,ES73209501612803164263,TRX_N-00775-73585671,2023-10-19T16:40:20,Amurrio,expenses,cash,-100.0,-44928.1
buyer_3,Ana,35,ES73209501612803164263,TRX_N-00776-56312788,2023-10-20T17:33:42,Amurrio,expenses,cash,-100.0,-45028.1
buyer_3,Ana,35,ES73209501612803164263,TRX_N-00777-07379176,2023-10-24T20:35:18,Amurrio,expenses,food,-70.29,-45098.39
buyer_3,Ana,35,ES73209501612803164263,TRX_N-00778-10385330,2023-10-25T16:15:40,Amurrio,expenses,food,-74.26,-45172.65
buyer_3,Ana,35,ES73209501612803164263,TRX_N-00779-77761409,2023-10-25T08:41:26,Amurrio,expenses,leisure,-21.57,-45194.22
buyer_3,Ana,35,ES73209501612803164263,TRX_N-00780-40072854,2023-10-25T19:38:10,Amurrio,expenses,cash,-100.0,-45294.22
buyer_3,Ana,35,ES73209501612803164263,TRX_N-00781-85034958,2023-10-25T07:34:27,Amurrio,expenses,gifts,-709.24,-46003.46
buyer_3,Ana,35,ES73209501612803164263,TRX_N-00782-12585903,2023-10-27T18:21:14,Amurrio,expenses,leisure,-24.05,-46027.51
buyer_3,Ana,35,ES73209501612803164263,TRX_N-00783-06684431,2023-10-27T17:15:24,Amurrio,expenses,clothing,-155.22,-46182.73
buyer_3,Ana,35,ES73209501612803164263,TRX_N-00784-46545278,2023-10-27T13:33:05,Amurrio,expenses,cash,-100.0,-46282.73
buyer_3,Ana,35,ES73209501612803164263,TRX_N-00785-02820315,2023-10-29T10:39:58,Amurrio,expenses,cash,-100.0,-46382.73
buyer_3,Ana,35,ES73209501612803164263,TRX_N-00786-70119649,2023-10-30T14:52:00,Amurrio,expenses,education,-49.01,-46431.74
buyer_3,Ana,35,ES73209501612803164263,TRX_N-00787-99931100,2023-10-30T22:00:31,Amurrio,expenses,repairs,-240.59,-46672.33
buyer_3,Ana,35,ES73209501612803164263,TRX_N-00788-62062116,2023-11-01T16:40:15,Amurrio,incomes,salary,1547.34,-45124.99
buyer_3,Ana,35,ES73209501612803164263,TRX_N-00789-99150750,2023-11-01T16:40:15,Amurrio,incomes,salary_partner,1034.49,-44090.5
buyer_3,Ana,35,ES73209501612803164263,TRX_N-00790-09620495,2023-11-01T09:33:09,Amurrio,expenses,gifts,-554.83,-44645.33
buyer_3,Ana,35,ES73209501612803164263,TRX_N-00791-14113632,2023-11-02T16:44:42,Amurrio,expenses,healthcare,-167.24,-44812.57
buyer_3,Ana,35,ES73209501612803164263,TRX_N-00792-48877427,2023-11-02T11:20:46,Amurrio,expenses,gifts,-300.4,-45112.97
buyer_3,Ana,35,ES73209501612803164263,TRX_N-00793-84450990,2023-11-04T20:50:15,Amurrio,expenses,mortgage,-938.86,-46051.83
buyer_3,Ana,35,ES73209501612803164263,TRX_N-00794-82917616,2023-11-04T18:06:08,Amurrio,expenses,healthcare,-87.48,-46139.31
buyer_3,Ana,35,ES73209501612803164263,TRX_N-00795-31299215,2023-11-05T18:25:42,Amurrio,expenses,water,-42.54,-46181.85
buyer_3,Ana,35,ES73209501612803164263,TRX_N-00796-91765166,2023-11-05T04:31:51,Amurrio,expenses,electricity,-67.66,-46249.51
buyer_3,Ana,35,ES73209501612803164263,TRX_N-00797-90343701,2023-11-05T18:51:47,Amurrio,expenses,appliances,-346.77,-46596.28
buyer_3,Ana,35,ES73209501612803164263,TRX_N-00798-49017326,2023-11-05T10:34:19,Amurrio,expenses,repairs,-113.47,-46709.75
buyer_3,Ana,35,ES73209501612803164263,TRX_N-00799-74413330,2023-11-06T03:32:11,Amurrio,expenses,phone,-31.18,-46740.93
buyer_3,Ana,35,ES73209501612803164263,TRX_N-00800-53924195,2023-11-06T15:11:00,Amurrio,expenses,food,-98.73,-46839.66
buyer_3,Ana,35,ES73209501612803164263,TRX_N-00801-12193611,2023-11-06T11:31:43,Amurrio,expenses,cash,-100.0,-46939.66
buyer_3,Ana,35,ES73209501612803164263,TRX_N-00802-62936887,2023-11-07T15:52:22,Amurrio,expenses,gas,-38.88,-46978.54
buyer_3,Ana,35,ES73209501612803164263,TRX_N-00803-34551224,2023-11-07T21:02:32,Amurrio,expenses,healthcare,-86.24,-47064.78
buyer_3,Ana,35,ES73209501612803164263,TRX_N-00804-20440459,2023-11-07T15:05:30,Amurrio,expenses,education,-64.6,-47129.38
buyer_3,Ana,35,ES73209501612803164263,TRX_N-00805-92827629,2023-11-08T10:11:46,Amurrio,expenses,internet,-42.0,-47171.38
buyer_3,Ana,35,ES73209501612803164263,TRX_N-00806-30713715,2023-11-08T09:19:26,Amurrio,expenses,repairs,-73.91,-47245.29
buyer_3,Ana,35,ES73209501612803164263,TRX_N-00807-52186177,2023-11-09T04:20:33,Amurrio,expenses,cash,-100.0,-47345.29
buyer_3,Ana,35,ES73209501612803164263,TRX_N-00808-86386069,2023-11-10T10:41:36,Amurrio,expenses,transport,-77.56,-47422.85
buyer_3,Ana,35,ES73209501612803164263,TRX_N-00809-18518129,2023-11-11T20:45:17,Amurrio,expenses,food,-111.21,-47534.06
buyer_3,Ana,35,ES73209501612803164263,TRX_N-00810-16177458,2023-11-11T20:56:41,Barakaldo,expenses,cash,-100.0,-47634.06
buyer_3,Ana,35,ES73209501612803164263,TRX_N-00811-60382453,2023-11-13T22:23:23,Hondarribia,expenses,food,-106.62,-47740.68
buyer_3,Ana,35,ES73209501612803164263,TRX_N-00812-17654793,2023-11-13T16:01:36,Amurrio,expenses,cash,-100.0,-47840.68
buyer_3,Ana,35,ES73209501612803164263,TRX_N-00813-67538577,2023-11-13T10:17:35,Amurrio,expenses,repairs,-102.72,-47943.4
buyer_3,Ana,35,ES73209501612803164263,TRX_N-00814-28656468,2023-11-15T17:49:41,Amurrio,expenses,leisure,-84.72,-48028.12
buyer_3,Ana,35,ES73209501612803164263,TRX_N-00815-32893863,2023-11-16T19:27:46,Amurrio,expenses,food,-120.39,-48148.51
buyer_3,Ana,35,ES73209501612803164263,TRX_N-00816-65677392,2023-11-16T13:28:04,Amurrio,expenses,leisure,-29.6,-48178.11
buyer_3,Ana,35,ES73209501612803164263,TRX_N-00817-78335456,2023-11-17T13:16:48,Amurrio,expenses,education,-65.83,-48243.94
buyer_3,Ana,35,ES73209501612803164263,TRX_N-00818-22877404,2023-11-17T10:47:02,Amurrio,expenses,children,-166.52,-48410.46
buyer_3,Ana,35,ES73209501612803164263,TRX_N-00819-22103328,2023-11-18T13:31:59,Amurrio,expenses,transport,-60.83,-48471.29
buyer_3,Ana,35,ES73209501612803164263,TRX_N-00820-29592113,2023-11-22T16:41:15,Eibar,expenses,leisure,-39.22,-48510.51
buyer_3,Ana,35,ES73209501612803164263,TRX_N-00821-67789315,2023-11-23T12:33:13,Amurrio,expenses,gifts,-269.32,-48779.83
buyer_3,Ana,35,ES73209501612803164263,TRX_N-00822-58573427,2023-11-27T03:03:53,Amurrio,expenses,children,-168.99,-48948.82
buyer_3,Ana,35,ES73209501612803164263,TRX_N-00823-48469064,2023-11-28T19:24:28,Amurrio,expenses,leisure,-60.34,-49009.16
buyer_3,Ana,35,ES73209501612803164263,TRX_N-00824-64907947,2023-11-29T17:49:42,Galdakao,expenses,transport,-52.72,-49061.88
buyer_3,Ana,35,ES73209501612803164263,TRX_N-00825-57466421,2023-11-29T12:01:32,Amurrio,expenses,gifts,-736.62,-49798.5
buyer_3,Ana,35,ES73209501612803164263,TRX_N-00826-99669833,2023-11-30T20:19:30,Irun,expenses,gifts,-774.79,-50573.29
buyer_3,Ana,35,ES73209501612803164263,TRX_N-00827-85870322,2023-12-01T17:57:39,Amurrio,incomes,salary,1547.34,-49025.95
buyer_3,Ana,35,ES73209501612803164263,TRX_N-00828-70312036,2023-12-01T17:57:39,Amurrio,incomes,salary_partner,1034.49,-47991.46
buyer_3,Ana,35,ES73209501612803164263,TRX_N-00829-00683074,2023-12-01T17:57:39,Amurrio,incomes,extra_income,244.88,-47746.58
buyer_3,Ana,35,ES73209501612803164263,TRX_N-00830-69617351,2023-12-01T17:57:39,Amurrio,incomes,salary_bonus,1209.82,-46536.76
buyer_3,Ana,35,ES73209501612803164263,TRX_N-00831-15496683,2023-12-01T17:57:39,Amurrio,incomes,salary_partner_bonus,817.23,-45719.53
buyer_3,Ana,35,ES73209501612803164263,TRX_N-00832-94509335,2023-12-03T05:34:15,Sopela,expenses,healthcare,-52.78,-45772.31
buyer_3,Ana,35,ES73209501612803164263,TRX_N-00833-15934764,2023-12-03T11:46:09,Amurrio,expenses,repairs,-124.31,-45896.62
buyer_3,Ana,35,ES73209501612803164263,TRX_N-00834-51906459,2023-12-04T19:24:31,Amurrio,expenses,mortgage,-938.86,-46835.48
buyer_3,Ana,35,ES73209501612803164263,TRX_N-00835-55239186,2023-12-04T16:12:25,Amurrio,expenses,food,-76.82,-46912.3
buyer_3,Ana,35,ES73209501612803164263,TRX_N-00836-63368769,2023-12-04T16:24:37,Amurrio,expenses,education,-75.18,-46987.48
buyer_3,Ana,35,ES73209501612803164263,TRX_N-00837-80769464,2023-12-04T18:27:22,Amurrio,expenses,cash,-100.0,-47087.48
buyer_3,Ana,35,ES73209501612803164263,TRX_N-00838-89849830,2023-12-05T02:08:54,Amurrio,expenses,electricity,-79.17,-47166.65
buyer_3,Ana,35,ES73209501612803164263,TRX_N-00839-51980909,2023-12-06T08:25:41,Amurrio,expenses,internet,-42.0,-47208.65
buyer_3,Ana,35,ES73209501612803164263,TRX_N-00840-38653759,2023-12-06T13:09:55,Amurrio,expenses,phone,-39.17,-47247.82
buyer_3,Ana,35,ES73209501612803164263,TRX_N-00841-94405210,2023-12-06T09:14:33,Amurrio,expenses,leisure,-32.33,-47280.15
buyer_3,Ana,35,ES73209501612803164263,TRX_N-00842-87702437,2023-12-06T08:04:31,Amurrio,expenses,appliances,-154.25,-47434.4
buyer_3,Ana,35,ES73209501612803164263,TRX_N-00843-05071225,2023-12-08T13:01:54,Amurrio,expenses,water,-27.95,-47462.35
buyer_3,Ana,35,ES73209501612803164263,TRX_N-00844-67829607,2023-12-08T14:47:41,Amurrio,expenses,gas,-93.43,-47555.78
buyer_3,Ana,35,ES73209501612803164263,TRX_N-00845-15154532,2023-12-09T08:20:21,Sopela,expenses,clothing,-146.92,-47702.7
buyer_3,Ana,35,ES73209501612803164263,TRX_N-00846-88196372,2023-12-09T08:19:37,Amurrio,expenses,gifts,-811.93,-48514.63
buyer_3,Ana,35,ES73209501612803164263,TRX_N-00847-93367331,2023-12-12T09:07:30,Amurrio,expenses,clothing,-79.89,-48594.52
buyer_3,Ana,35,ES73209501612803164263,TRX_N-00848-35259203,2023-12-13T20:08:04,Amurrio,expenses,cash,-100.0,-48694.52
buyer_3,Ana,35,ES73209501612803164263,TRX_N-00849-50464494,2023-12-16T12:35:13,Amurrio,expenses,cash,-100.0,-48794.52
buyer_3,Ana,35,ES73209501612803164263,TRX_N-00850-95020215,2023-12-17T04:16:27,Amurrio,expenses,education,-62.03,-48856.55
buyer_3,Ana,35,ES73209501612803164263,TRX_N-00851-54046806,2023-12-18T22:38:14,Amurrio,expenses,gifts,-587.41,-49443.96
buyer_3,Ana,35,ES73209501612803164263,TRX_N-00852-01793656,2023-12-23T01:02:04,Sestao,expenses,leisure,-37.14,-49481.1
buyer_3,Ana,35,ES73209501612803164263,TRX_N-00853-92354526,2023-12-23T08:01:26,Amurrio,expenses,children,-208.08,-49689.18
buyer_3,Ana,35,ES73209501612803164263,TRX_N-00854-40577494,2023-12-24T13:38:30,Amurrio,expenses,gifts,-333.7,-50022.88
buyer_3,Ana,35,ES73209501612803164263,TRX_N-00855-98803017,2023-12-25T12:42:33,Amurrio,expenses,clothing,-90.47,-50113.35
buyer_3,Ana,35,ES73209501612803164263,TRX_N-00856-95749657,2023-12-26T08:31:04,Amurrio,expenses,leisure,-34.59,-50147.94
buyer_3,Ana,35,ES73209501612803164263,TRX_N-00857-36210475,2023-12-26T18:52:23,Amurrio,expenses,appliances,-262.41,-50410.35
buyer_3,Ana,35,ES73209501612803164263,TRX_N-00858-18273629,2023-12-28T18:19:28,Amurrio,expenses,food,-85.3,-50495.65
buyer_3,Ana,35,ES73209501612803164263,TRX_N-00859-58246227,2023-12-28T22:10:25,Amurrio,expenses,transport,-79.64,-50575.29
buyer_3,Ana,35,ES73209501612803164263,TRX_N-00860-03543921,2023-12-28T12:03:26,Amurrio,expenses,leisure,-74.94,-50650.23
buyer_3,Ana,35,ES73209501612803164263,TRX_N-00861-70178486,2023-12-30T15:05:02,Amurrio,expenses,transport,-50.26,-50700.49
buyer_3,Ana,35,ES73209501612803164263,TRX_N-00862-19802975,2023-12-30T09:12:57,Amurrio,expenses,cash,-100.0,-50800.49
buyer_3,Ana,35,ES73209501612803164263,TRX_N-00863-90378611,2024-01-01T00:37:24,Amurrio,incomes,salary,1594.05,-49206.44
buyer_3,Ana,35,ES73209501612803164263,TRX_N-00864-47845315,2024-01-01T00:37:24,Amurrio,incomes,salary_partner,1065.72,-48140.72
buyer_3,Ana,35,ES73209501612803164263,TRX_N-00865-37660903,2024-01-02T00:34:35,Amurrio,expenses,food,-66.68,-48207.4
buyer_3,Ana,35,ES73209501612803164263,TRX_N-00866-83024175,2024-01-02T11:49:32,Amurrio,expenses,repairs,-193.34,-48400.74
buyer_3,Ana,35,ES73209501612803164263,TRX_N-00867-02754731,2024-01-02T13:01:19,Amurrio,expenses,gifts,-399.82,-48800.56
buyer_3,Ana,35,ES73209501612803164263,TRX_N-00868-72385460,2024-01-03T15:19:33,Amurrio,expenses,transport,-64.16,-48864.72
buyer_3,Ana,35,ES73209501612803164263,TRX_N-00869-44572756,2024-01-04T16:28:47,Amurrio,expenses,mortgage,-938.86,-49803.58
buyer_3,Ana,35,ES73209501612803164263,TRX_N-00870-19517336,2024-01-05T11:22:45,Amurrio,expenses,water,-35.2,-49838.78
buyer_3,Ana,35,ES73209501612803164263,TRX_N-00871-85016496,2024-01-05T02:23:58,Amurrio,expenses,gas,-83.69,-49922.47
buyer_3,Ana,35,ES73209501612803164263,TRX_N-00872-52562175,2024-01-05T09:56:48,Amurrio,expenses,phone,-32.3,-49954.77
buyer_3,Ana,35,ES73209501612803164263,TRX_N-00873-38972133,2024-01-06T10:59:54,Donostia,expenses,transport,-64.66,-50019.43
buyer_3,Ana,35,ES73209501612803164263,TRX_N-00874-72018061,2024-01-06T12:00:48,Amurrio,expenses,children,-168.81,-50188.24
buyer_3,Ana,35,ES73209501612803164263,TRX_N-00875-68806197,2024-01-07T12:38:53,Amurrio,expenses,gifts,-598.31,-50786.55
buyer_3,Ana,35,ES73209501612803164263,TRX_N-00876-37740669,2024-01-08T17:26:39,Amurrio,expenses,electricity,-65.62,-50852.17
buyer_3,Ana,35,ES73209501612803164263,TRX_N-00877-83840082,2024-01-08T13:56:24,Amurrio,expenses,internet,-42.0,-50894.17
buyer_3,Ana,35,ES73209501612803164263,TRX_N-00878-73601308,2024-01-08T23:28:20,Amurrio,expenses,food,-79.92,-50974.09
buyer_3,Ana,35,ES73209501612803164263,TRX_N-00879-36853570,2024-01-08T19:30:04,Amurrio,expenses,gifts,-165.81,-51139.9
buyer_3,Ana,35,ES73209501612803164263,TRX_N-00880-79177195,2024-01-09T03:38:56,Amurrio,expenses,transport,-48.02,-51187.92
buyer_3,Ana,35,ES73209501612803164263,TRX_N-00881-80564025,2024-01-12T17:51:25,Amurrio,expenses,transport,-69.61,-51257.53
buyer_3,Ana,35,ES73209501612803164263,TRX_N-00882-61834418,2024-01-13T06:59:08,Amurrio,expenses,transport,-58.89,-51316.42
buyer_3,Ana,35,ES73209501612803164263,TRX_N-00883-47775665,2024-01-13T13:50:44,Amurrio,expenses,healthcare,-175.07,-51491.49
buyer_3,Ana,35,ES73209501612803164263,TRX_N-00884-52491312,2024-01-13T17:57:49,Amurrio,expenses,cash,-100.0,-51591.49
buyer_3,Ana,35,ES73209501612803164263,TRX_N-00885-03804923,2024-01-14T13:30:23,Amurrio,expenses,leisure,-84.94,-51676.43
buyer_3,Ana,35,ES73209501612803164263,TRX_N-00886-30726751,2024-01-14T00:34:00,Oyón-Oion,expenses,clothing,-138.52,-51814.95
buyer_3,Ana,35,ES73209501612803164263,TRX_N-00887-85566824,2024-01-15T15:10:48,Amurrio,expenses,gifts,-162.37,-51977.32
buyer_3,Ana,35,ES73209501612803164263,TRX_N-00888-31822536,2024-01-19T22:17:39,Amurrio,expenses,transport,-81.25,-52058.57
buyer_3,Ana,35,ES73209501612803164263,TRX_N-00889-19157114,2024-01-19T20:25:33,Amurrio,expenses,cash,-100.0,-52158.57
buyer_3,Ana,35,ES73209501612803164263,TRX_N-00890-93654623,2024-01-20T08:27:34,Amurrio,expenses,food,-89.6,-52248.17
buyer_3,Ana,35,ES73209501612803164263,TRX_N-00891-76476275,2024-01-20T03:30:18,Donostia,expenses,cash,-100.0,-52348.17
buyer_3,Ana,35,ES73209501612803164263,TRX_N-00892-49769104,2024-01-21T19:29:07,Amurrio,expenses,food,-105.45,-52453.62
buyer_3,Ana,35,ES73209501612803164263,TRX_N-00893-20330952,2024-01-22T05:08:16,Amurrio,expenses,leisure,-61.95,-52515.57
buyer_3,Ana,35,ES73209501612803164263,TRX_N-00894-40202518,2024-01-22T15:04:15,Amurrio,expenses,clothing,-117.99,-52633.56
buyer_3,Ana,35,ES73209501612803164263,TRX_N-00895-95535277,2024-01-27T18:06:49,Amurrio,expenses,transport,-49.59,-52683.15
buyer_3,Ana,35,ES73209501612803164263,TRX_N-00896-17790787,2024-01-28T13:12:56,Amurrio,expenses,transport,-73.08,-52756.23
buyer_3,Ana,35,ES73209501612803164263,TRX_N-00897-69996824,2024-01-28T13:50:48,Amurrio,expenses,gifts,-64.35,-52820.58
buyer_3,Ana,35,ES73209501612803164263,TRX_N-00898-15563703,2024-01-29T11:36:54,Amurrio,expenses,cash,-100.0,-52920.58
buyer_3,Ana,35,ES73209501612803164263,TRX_N-00899-63776771,2024-01-30T18:20:52,Erandio,expenses,transport,-67.81,-52988.39
buyer_3,Ana,35,ES73209501612803164263,TRX_N-00900-43427356,2024-01-30T14:25:29,Amurrio,expenses,travel,-1365.02,-54353.41
buyer_3,Ana,35,ES73209501612803164263,TRX_N-00901-97116743,2024-02-01T11:56:54,Amurrio,incomes,salary,1594.05,-52759.36
buyer_3,Ana,35,ES73209501612803164263,TRX_N-00902-13189912,2024-02-01T11:56:54,Amurrio,incomes,salary_partner,1065.72,-51693.64
buyer_3,Ana,35,ES73209501612803164263,TRX_N-00903-46561867,2024-02-01T04:33:20,Amurrio,expenses,food,-111.23,-51804.87
buyer_3,Ana,35,ES73209501612803164263,TRX_N-00904-18436844,2024-02-02T18:30:18,Amurrio,expenses,food,-117.73,-51922.6
buyer_3,Ana,35,ES73209501612803164263,TRX_N-00905-14398468,2024-02-03T20:51:10,Amurrio,expenses,food,-102.29,-52024.89
buyer_3,Ana,35,ES73209501612803164263,TRX_N-00906-67099435,2024-02-03T16:39:49,Amurrio,expenses,cash,-100.0,-52124.89
buyer_3,Ana,35,ES73209501612803164263,TRX_N-00907-43221324,2024-02-03T20:57:57,Amurrio,expenses,gifts,-336.75,-52461.64
buyer_3,Ana,35,ES73209501612803164263,TRX_N-00908-25733994,2024-02-04T15:23:23,Amurrio,expenses,mortgage,-938.86,-53400.5
buyer_3,Ana,35,ES73209501612803164263,TRX_N-00909-19587896,2024-02-04T16:39:17,Lasarte-Oria,expenses,food,-98.54,-53499.04
buyer_3,Ana,35,ES73209501612803164263,TRX_N-00910-37568188,2024-02-04T17:20:15,Amurrio,expenses,repairs,-146.14,-53645.18
buyer_3,Ana,35,ES73209501612803164263,TRX_N-00911-60216429,2024-02-05T19:52:50,Amurrio,expenses,electricity,-29.03,-53674.21
buyer_3,Ana,35,ES73209501612803164263,TRX_N-00912-02824332,2024-02-05T05:04:30,Amurrio,expenses,leisure,-28.88,-53703.09
buyer_3,Ana,35,ES73209501612803164263,TRX_N-00913-29260091,2024-02-05T23:56:14,Amurrio,expenses,cash,-100.0,-53803.09
buyer_3,Ana,35,ES73209501612803164263,TRX_N-00914-15121020,2024-02-06T15:50:33,Amurrio,expenses,food,-112.36,-53915.45
buyer_3,Ana,35,ES73209501612803164263,TRX_N-00915-09167734,2024-02-07T09:47:32,Amurrio,expenses,gas,-68.39,-53983.84
buyer_3,Ana,35,ES73209501612803164263,TRX_N-00916-37637537,2024-02-07T08:50:06,Amurrio,expenses,food,-118.69,-54102.53
buyer_3,Ana,35,ES73209501612803164263,TRX_N-00917-72589275,2024-02-07T08:55:42,Amurrio,expenses,cash,-100.0,-54202.53
buyer_3,Ana,35,ES73209501612803164263,TRX_N-00918-91635508,2024-02-08T00:42:58,Amurrio,expenses,phone,-35.31,-54237.84
buyer_3,Ana,35,ES73209501612803164263,TRX_N-00919-69440126,2024-02-08T11:04:20,Amurrio,expenses,water,-37.24,-54275.08
buyer_3,Ana,35,ES73209501612803164263,TRX_N-00920-04252749,2024-02-08T10:35:29,Amurrio,expenses,internet,-42.0,-54317.08
buyer_3,Ana,35,ES73209501612803164263,TRX_N-00921-30562496,2024-02-08T06:15:03,Amurrio,expenses,transport,-57.5,-54374.58
buyer_3,Ana,35,ES73209501612803164263,TRX_N-00922-87785988,2024-02-08T15:06:46,Elciego,expenses,appliances,-306.97,-54681.55
buyer_3,Ana,35,ES73209501612803164263,TRX_N-00923-08516152,2024-02-09T01:21:06,Amurrio,expenses,leisure,-22.68,-54704.23
buyer_3,Ana,35,ES73209501612803164263,TRX_N-00924-02690178,2024-02-11T09:52:53,Amurrio,expenses,cash,-100.0,-54804.23
buyer_3,Ana,35,ES73209501612803164263,TRX_N-00925-29000460,2024-02-14T18:01:14,Amurrio,expenses,leisure,-83.94,-54888.17
buyer_3,Ana,35,ES73209501612803164263,TRX_N-00926-77959423,2024-02-17T18:30:30,Amurrio,expenses,children,-187.54,-55075.71
buyer_3,Ana,35,ES73209501612803164263,TRX_N-00927-21438974,2024-02-18T10:18:39,Amurrio,expenses,clothing,-52.5,-55128.21
buyer_3,Ana,35,ES73209501612803164263,TRX_N-00928-79256570,2024-02-18T13:33:34,Amurrio,expenses,healthcare,-103.79,-55232.0
buyer_3,Ana,35,ES73209501612803164263,TRX_N-00929-32863288,2024-02-22T08:55:43,Amurrio,expenses,food,-114.9,-55346.9
buyer_3,Ana,35,ES73209501612803164263,TRX_N-00930-59786657,2024-02-22T06:15:44,Amurrio,expenses,leisure,-56.98,-55403.88
buyer_3,Ana,35,ES73209501612803164263,TRX_N-00931-38317772,2024-02-22T13:25:40,Amurrio,expenses,cash,-100.0,-55503.88
buyer_3,Ana,35,ES73209501612803164263,TRX_N-00932-94700195,2024-02-22T10:05:48,Amurrio,expenses,gifts,-456.26,-55960.14
buyer_3,Ana,35,ES73209501612803164263,TRX_N-00933-49101415,2024-02-24T02:49:31,Amurrio,expenses,food,-85.52,-56045.66
buyer_3,Ana,35,ES73209501612803164263,TRX_N-00934-77901514,2024-02-25T11:06:02,Amurrio,expenses,healthcare,-177.9,-56223.56
buyer_3,Ana,35,ES73209501612803164263,TRX_N-00935-87564556,2024-02-25T14:09:21,Amurrio,expenses,gifts,-556.54,-56780.1
buyer_3,Ana,35,ES73209501612803164263,TRX_N-00936-93798118,2024-02-27T13:49:34,Amurrio,expenses,repairs,-207.5,-56987.6
buyer_3,Ana,35,ES73209501612803164263,TRX_N-00937-75505644,2024-02-29T18:13:50,Amurrio,expenses,transport,-55.37,-57042.97
buyer_3,Ana,35,ES73209501612803164263,TRX_N-00938-66097742,2024-02-29T10:05:34,Amurrio,expenses,repairs,-176.91,-57219.88
buyer_3,Ana,35,ES73209501612803164263,TRX_N-00939-35642941,2024-03-01T08:11:49,Amurrio,incomes,salary,1594.05,-55625.83
buyer_3,Ana,35,ES73209501612803164263,TRX_N-00940-97144118,2024-03-01T08:11:49,Amurrio,incomes,salary_partner,1065.72,-54560.11
buyer_3,Ana,35,ES73209501612803164263,TRX_N-00941-06726637,2024-03-01T17:18:47,Amurrio,expenses,food,-115.25,-54675.36
buyer_3,Ana,35,ES73209501612803164263,TRX_N-00942-33130878,2024-03-01T04:08:43,Amurrio,expenses,children,-269.66,-54945.02
buyer_3,Ana,35,ES73209501612803164263,TRX_N-00943-48363108,2024-03-02T08:05:06,Lasarte-Oria,expenses,cash,-100.0,-55045.02
buyer_3,Ana,35,ES73209501612803164263,TRX_N-00944-20924039,2024-03-04T23:32:50,Amurrio,expenses,mortgage,-938.86,-55983.88
buyer_3,Ana,35,ES73209501612803164263,TRX_N-00945-23224817,2024-03-05T11:48:09,Amurrio,expenses,electricity,-84.22,-56068.1
buyer_3,Ana,35,ES73209501612803164263,TRX_N-00946-96887400,2024-03-05T19:32:51,Hernani,expenses,healthcare,-65.24,-56133.34
buyer_3,Ana,35,ES73209501612803164263,TRX_N-00947-68460698,2024-03-06T12:21:17,Amurrio,expenses,repairs,-216.93,-56350.27
buyer_3,Ana,35,ES73209501612803164263,TRX_N-00948-22291136,2024-03-07T09:34:57,Amurrio,expenses,gas,-47.99,-56398.26
buyer_3,Ana,35,ES73209501612803164263,TRX_N-00949-81766839,2024-03-07T12:09:38,Amurrio,expenses,phone,-33.75,-56432.01
buyer_3,Ana,35,ES73209501612803164263,TRX_N-00950-94963209,2024-03-07T12:25:39,Amurrio,expenses,clothing,-103.23,-56535.24
buyer_3,Ana,35,ES73209501612803164263,TRX_N-00951-57630892,2024-03-08T12:00:53,Amurrio,expenses,water,-40.34,-56575.58
buyer_3,Ana,35,ES73209501612803164263,TRX_N-00952-52808085,2024-03-08T11:26:23,Amurrio,expenses,internet,-42.0,-56617.58
buyer_3,Ana,35,ES73209501612803164263,TRX_N-00953-06497981,2024-03-08T22:37:02,Amurrio,expenses,food,-68.73,-56686.31
buyer_3,Ana,35,ES73209501612803164263,TRX_N-00954-54648321,2024-03-09T13:24:47,Vitoria-Gasteiz,expenses,transport,-62.16,-56748.47
buyer_3,Ana,35,ES73209501612803164263,TRX_N-00955-44120616,2024-03-10T08:22:34,Amurrio,expenses,leisure,-29.75,-56778.22
buyer_3,Ana,35,ES73209501612803164263,TRX_N-00956-82638084,2024-03-12T04:50:34,Amurrio,expenses,healthcare,-157.91,-56936.13
buyer_3,Ana,35,ES73209501612803164263,TRX_N-00957-38381226,2024-03-12T22:27:11,Basauri,expenses,education,-49.94,-56986.07
buyer_3,Ana,35,ES73209501612803164263,TRX_N-00958-04493127,2024-03-15T16:58:14,Amurrio,expenses,gifts,-836.17,-57822.24
buyer_3,Ana,35,ES73209501612803164263,TRX_N-00959-81402419,2024-03-16T22:30:12,Amurrio,expenses,transport,-46.2,-57868.44
buyer_3,Ana,35,ES73209501612803164263,TRX_N-00960-19802453,2024-03-19T18:44:06,Amurrio,expenses,leisure,-19.36,-57887.8
buyer_3,Ana,35,ES73209501612803164263,TRX_N-00961-41362139,2024-03-20T10:35:20,Amurrio,expenses,leisure,-80.21,-57968.01
buyer_3,Ana,35,ES73209501612803164263,TRX_N-00962-82950019,2024-03-20T17:45:14,Amurrio,expenses,appliances,-176.95,-58144.96
buyer_3,Ana,35,ES73209501612803164263,TRX_N-00963-84922085,2024-03-21T23:00:50,Amurrio,expenses,food,-83.87,-58228.83
buyer_3,Ana,35,ES73209501612803164263,TRX_N-00964-64713423,2024-03-22T11:05:53,Amurrio,expenses,healthcare,-142.73,-58371.56
buyer_3,Ana,35,ES73209501612803164263,TRX_N-00965-75052518,2024-03-23T16:54:19,Amurrio,expenses,cash,-100.0,-58471.56
buyer_3,Ana,35,ES73209501612803164263,TRX_N-00966-17048909,2024-03-26T20:26:59,Salvatierra/Agurain,expenses,food,-71.71,-58543.27
buyer_3,Ana,35,ES73209501612803164263,TRX_N-00967-45809640,2024-03-30T23:51:24,Amurrio,expenses,children,-247.96,-58791.23
buyer_3,Ana,35,ES73209501612803164263,TRX_N-00968-39581271,2024-04-01T16:03:35,Amurrio,incomes,salary,1594.05,-57197.18
buyer_3,Ana,35,ES73209501612803164263,TRX_N-00969-40846536,2024-04-01T16:03:35,Amurrio,incomes,salary_partner,1065.72,-56131.46
buyer_3,Ana,35,ES73209501612803164263,TRX_N-00970-26304777,2024-04-01T16:03:35,Amurrio,incomes,extra_income,244.88,-55886.58
buyer_3,Ana,35,ES73209501612803164263,TRX_N-00971-78012240,2024-04-01T08:15:46,Amurrio,expenses,education,-57.88,-55944.46
buyer_3,Ana,35,ES73209501612803164263,TRX_N-00972-03073291,2024-04-02T07:16:49,Amurrio,expenses,food,-120.05,-56064.51
buyer_3,Ana,35,ES73209501612803164263,TRX_N-00973-24067968,2024-04-02T08:33:34,Zarautz,expenses,transport,-62.79,-56127.3
buyer_3,Ana,35,ES73209501612803164263,TRX_N-00974-91305187,2024-04-04T13:38:14,Amurrio,expenses,mortgage,-938.86,-57066.16
buyer_3,Ana,35,ES73209501612803164263,TRX_N-00975-49021430,2024-04-04T06:05:14,Amurrio,expenses,transport,-88.45,-57154.61
buyer_3,Ana,35,ES73209501612803164263,TRX_N-00976-66467893,2024-04-05T11:03:03,Salvatierra/Agurain,expenses,repairs,-234.53,-57389.14
buyer_3,Ana,35,ES73209501612803164263,TRX_N-00977-82973067,2024-04-06T10:50:20,Amurrio,expenses,gas,-45.68,-57434.82
buyer_3,Ana,35,ES73209501612803164263,TRX_N-00978-33298280,2024-04-06T17:32:46,Amurrio,expenses,cash,-100.0,-57534.82
buyer_3,Ana,35,ES73209501612803164263,TRX_N-00979-21844398,2024-04-06T15:19:03,Amurrio,expenses,children,-198.04,-57732.86
buyer_3,Ana,35,ES73209501612803164263,TRX_N-00980-21972882,2024-04-07T14:16:38,Amurrio,expenses,water,-29.93,-57762.79
buyer_3,Ana,35,ES73209501612803164263,TRX_N-00981-96875249,2024-04-07T20:42:34,Eibar,expenses,food,-84.68,-57847.47
buyer_3,Ana,35,ES73209501612803164263,TRX_N-00982-97276444,2024-04-08T13:07:51,Amurrio,expenses,electricity,-61.93,-57909.4
buyer_3,Ana,35,ES73209501612803164263,TRX_N-00983-50934932,2024-04-08T12:41:56,Amurrio,expenses,internet,-42.0,-57951.4
buyer_3,Ana,35,ES73209501612803164263,TRX_N-00984-31765550,2024-04-08T11:18:45,Amurrio,expenses,phone,-37.16,-57988.56
buyer_3,Ana,35,ES73209501612803164263,TRX_N-00985-40880114,2024-04-09T20:40:51,Amurrio,expenses,clothing,-115.75,-58104.31
buyer_3,Ana,35,ES73209501612803164263,TRX_N-00986-64393753,2024-04-10T18:16:39,Amurrio,expenses,food,-124.55,-58228.86
buyer_3,Ana,35,ES73209501612803164263,TRX_N-00987-80763041,2024-04-11T16:31:04,Getxo,expenses,transport,-71.95,-58300.81
buyer_3,Ana,35,ES73209501612803164263,TRX_N-00988-23412249,2024-04-11T10:35:36,Amurrio,expenses,education,-59.96,-58360.77
buyer_3,Ana,35,ES73209501612803164263,TRX_N-00989-54259729,2024-04-12T23:47:53,Amurrio,expenses,food,-92.66,-58453.43
buyer_3,Ana,35,ES73209501612803164263,TRX_N-00990-23356083,2024-04-12T08:15:14,Amurrio,expenses,appliances,-224.06,-58677.49
buyer_3,Ana,35,ES73209501612803164263,TRX_N-00991-60730959,2024-04-13T10:53:18,Santurtzi,expenses,cash,-100.0,-58777.49
buyer_3,Ana,35,ES73209501612803164263,TRX_N-00992-66307518,2024-04-15T17:43:05,Amurrio,expenses,food,-102.11,-58879.6
buyer_3,Ana,35,ES73209501612803164263,TRX_N-00993-64954315,2024-04-15T08:56:06,Amurrio,expenses,leisure,-83.75,-58963.35
buyer_3,Ana,35,ES73209501612803164263,TRX_N-00994-05085806,2024-04-16T13:22:34,Amurrio,expenses,food,-111.44,-59074.79
buyer_3,Ana,35,ES73209501612803164263,TRX_N-00995-35784920,2024-04-16T11:10:46,Amurrio,expenses,gifts,-88.32,-59163.11
buyer_3,Ana,35,ES73209501612803164263,TRX_N-00996-70840455,2024-04-17T08:34:58,Amurrio,expenses,clothing,-72.98,-59236.09
buyer_3,Ana,35,ES73209501612803164263,TRX_N-00997-24079522,2024-04-17T12:03:58,Galdakao,expenses,cash,-100.0,-59336.09
buyer_3,Ana,35,ES73209501612803164263,TRX_N-00998-08315787,2024-04-18T08:46:22,Amurrio,expenses,leisure,-34.35,-59370.44
buyer_3,Ana,35,ES73209501612803164263,TRX_N-00999-02934314,2024-04-18T11:53:43,Donostia,expenses,clothing,-94.88,-59465.32
buyer_3,Ana,35,ES73209501612803164263,TRX_N-01000-84625011,2024-04-18T13:02:14,Amurrio,expenses,cash,-100.0,-59565.32
buyer_3,Ana,35,ES73209501612803164263,TRX_N-01001-26630367,2024-04-19T11:15:36,Amurrio,expenses,leisure,-37.37,-59602.69
buyer_3,Ana,35,ES73209501612803164263,TRX_N-01002-65975818,2024-04-20T22:41:22,Amurrio,expenses,food,-89.84,-59692.53
buyer_3,Ana,35,ES73209501612803164263,TRX_N-01003-54552921,2024-04-20T03:05:28,Amurrio,expenses,transport,-57.41,-59749.94
buyer_3,Ana,35,ES73209501612803164263,TRX_N-01004-29084915,2024-04-20T18:16:14,Amurrio,expenses,healthcare,-150.79,-59900.73
buyer_3,Ana,35,ES73209501612803164263,TRX_N-01005-08086369,2024-04-22T17:52:30,Oyón-Oion,expenses,cash,-100.0,-60000.73
buyer_3,Ana,35,ES73209501612803164263,TRX_N-01006-99238138,2024-04-23T15:27:31,Amurrio,expenses,cash,-100.0,-60100.73
buyer_3,Ana,35,ES73209501612803164263,TRX_N-01007-44801392,2024-04-24T08:17:38,Portugalete,expenses,food,-77.14,-60177.87
buyer_3,Ana,35,ES73209501612803164263,TRX_N-01008-89940750,2024-04-25T19:16:33,Amurrio,expenses,transport,-85.89,-60263.76
buyer_3,Ana,35,ES73209501612803164263,TRX_N-01009-81620565,2024-04-26T17:11:07,Amurrio,expenses,food,-80.19,-60343.95
buyer_3,Ana,35,ES73209501612803164263,TRX_N-01010-04728154,2024-04-26T09:16:11,Berango,expenses,cash,-100.0,-60443.95
buyer_3,Ana,35,ES73209501612803164263,TRX_N-01011-26950450,2024-04-27T11:23:50,Amurrio,expenses,education,-47.15,-60491.1
buyer_3,Ana,35,ES73209501612803164263,TRX_N-01012-26022425,2024-04-27T16:06:36,Amurrio,expenses,cash,-100.0,-60591.1
buyer_3,Ana,35,ES73209501612803164263,TRX_N-01013-41150876,2024-04-29T05:19:12,Amurrio,expenses,transport,-55.9,-60647.0
buyer_3,Ana,35,ES73209501612803164263,TRX_N-01014-27464983,2024-04-29T12:34:12,Santurtzi,expenses,leisure,-25.7,-60672.7
buyer_3,Ana,35,ES73209501612803164263,TRX_N-01015-01161646,2024-04-30T13:29:49,Amurrio,expenses,transport,-74.6,-60747.3
buyer_3,Ana,35,ES73209501612803164263,TRX_N-01016-56168887,2024-05-01T08:22:54,Amurrio,incomes,salary,1594.05,-59153.25
buyer_3,Ana,35,ES73209501612803164263,TRX_N-01017-20342371,2024-05-01T08:22:54,Amurrio,incomes,salary_partner,1065.72,-58087.53
buyer_3,Ana,35,ES73209501612803164263,TRX_N-01018-51944819,2024-05-03T02:49:55,Amurrio,expenses,repairs,-146.52,-58234.05
buyer_3,Ana,35,ES73209501612803164263,TRX_N-01019-62465587,2024-05-04T18:43:59,Amurrio,expenses,mortgage,-938.86,-59172.91
buyer_3,Ana,35,ES73209501612803164263,TRX_N-01020-53224240,2024-05-04T13:19:51,Amurrio,expenses,children,-209.99,-59382.9
buyer_3,Ana,35,ES73209501612803164263,TRX_N-01021-56328738,2024-05-05T23:43:05,Amurrio,expenses,food,-107.57,-59490.47
buyer_3,Ana,35,ES73209501612803164263,TRX_N-01022-84467204,2024-05-06T14:47:03,Alegría-Dulantzi,expenses,transport,-43.18,-59533.65
buyer_3,Ana,35,ES73209501612803164263,TRX_N-01023-26787305,2024-05-07T10:27:31,Amurrio,expenses,phone,-30.48,-59564.13
buyer_3,Ana,35,ES73209501612803164263,TRX_N-01024-35500288,2024-05-07T14:27:17,Labastida,expenses,cash,-100.0,-59664.13
buyer_3,Ana,35,ES73209501612803164263,TRX_N-01025-91281005,2024-05-08T12:38:29,Amurrio,expenses,water,-36.6,-59700.73
buyer_3,Ana,35,ES73209501612803164263,TRX_N-01026-85871964,2024-05-08T10:39:57,Amurrio,expenses,electricity,-71.38,-59772.11
buyer_3,Ana,35,ES73209501612803164263,TRX_N-01027-03229033,2024-05-08T00:57:03,Amurrio,expenses,gas,-88.12,-59860.23
buyer_3,Ana,35,ES73209501612803164263,TRX_N-01028-85316130,2024-05-08T16:16:45,Amurrio,expenses,internet,-42.0,-59902.23
buyer_3,Ana,35,ES73209501612803164263,TRX_N-01029-75551928,2024-05-10T10:56:20,Amurrio,expenses,transport,-47.23,-59949.46
buyer_3,Ana,35,ES73209501612803164263,TRX_N-01030-13904551,2024-05-10T14:07:31,Amurrio,expenses,cash,-100.0,-60049.46
buyer_3,Ana,35,ES73209501612803164263,TRX_N-01031-40413984,2024-05-11T09:13:17,Sopela,expenses,food,-123.15,-60172.61
buyer_3,Ana,35,ES73209501612803164263,TRX_N-01032-85178571,2024-05-12T23:05:21,Amurrio,expenses,gifts,-65.76,-60238.37
buyer_3,Ana,35,ES73209501612803164263,TRX_N-01033-63902885,2024-05-15T23:41:38,Amurrio,expenses,food,-109.13,-60347.5
buyer_3,Ana,35,ES73209501612803164263,TRX_N-01034-64666156,2024-05-15T11:11:46,Amurrio,expenses,cash,-100.0,-60447.5
buyer_3,Ana,35,ES73209501612803164263,TRX_N-01035-08803087,2024-05-15T14:34:35,Amurrio,expenses,travel,-457.25,-60904.75
buyer_3,Ana,35,ES73209501612803164263,TRX_N-01036-57338695,2024-05-15T02:51:40,Amurrio,expenses,gifts,-448.71,-61353.46
buyer_3,Ana,35,ES73209501612803164263,TRX_N-01037-36009707,2024-05-16T17:24:18,Amurrio,expenses,education,-70.9,-61424.36
buyer_3,Ana,35,ES73209501612803164263,TRX_N-01038-33530629,2024-05-18T18:14:45,Pasaia,expenses,leisure,-66.76,-61491.12
buyer_3,Ana,35,ES73209501612803164263,TRX_N-01039-30691342,2024-05-20T12:53:21,Amurrio,expenses,cash,-100.0,-61591.12
buyer_3,Ana,35,ES73209501612803164263,TRX_N-01040-43899238,2024-05-21T19:36:13,Amurrio,expenses,cash,-100.0,-61691.12
buyer_3,Ana,35,ES73209501612803164263,TRX_N-01041-76303970,2024-05-22T15:00:02,Amurrio,expenses,cash,-100.0,-61791.12
buyer_3,Ana,35,ES73209501612803164263,TRX_N-01042-06862601,2024-05-23T18:45:37,Amurrio,expenses,food,-89.75,-61880.87
buyer_3,Ana,35,ES73209501612803164263,TRX_N-01043-15493922,2024-05-24T08:50:12,Lasarte-Oria,expenses,food,-98.17,-61979.04
buyer_3,Ana,35,ES73209501612803164263,TRX_N-01044-59538793,2024-05-24T17:48:37,Amurrio,expenses,children,-201.45,-62180.49
buyer_3,Ana,35,ES73209501612803164263,TRX_N-01045-40169511,2024-05-26T18:58:14,Amurrio,expenses,cash,-100.0,-62280.49
buyer_3,Ana,35,ES73209501612803164263,TRX_N-01046-67983714,2024-05-28T15:07:55,Labastida,expenses,food,-64.96,-62345.45
buyer_3,Ana,35,ES73209501612803164263,TRX_N-01047-60419213,2024-05-28T15:31:18,Amurrio,expenses,repairs,-34.49,-62379.94
buyer_3,Ana,35,ES73209501612803164263,TRX_N-01048-05460494,2024-05-29T09:32:27,Amurrio,expenses,appliances,-251.87,-62631.81
buyer_3,Ana,35,ES73209501612803164263,TRX_N-01049-60937910,2024-05-30T12:19:51,Amurrio,expenses,leisure,-78.93,-62710.74
buyer_3,Ana,35,ES73209501612803164263,TRX_N-01050-17805144,2024-05-30T09:14:29,Amurrio,expenses,education,-61.08,-62771.82
buyer_3,Ana,35,ES73209501612803164263,TRX_N-01051-41691188,2024-05-30T15:31:45,Amurrio,expenses,cash,-100.0,-62871.82
buyer_3,Ana,35,ES73209501612803164263,TRX_N-01052-65941635,2024-05-31T16:59:21,Amurrio,expenses,food,-84.69,-62956.51
buyer_3,Ana,35,ES73209501612803164263,TRX_N-01053-26256903,2024-06-01T23:53:21,Amurrio,incomes,salary,1594.05,-61362.46
buyer_3,Ana,35,ES73209501612803164263,TRX_N-01054-32333301,2024-06-01T23:53:21,Amurrio,incomes,salary_partner,1065.72,-60296.74
buyer_3,Ana,35,ES73209501612803164263,TRX_N-01055-12364062,2024-06-01T23:53:21,Amurrio,incomes,salary_bonus,1203.91,-59092.83
buyer_3,Ana,35,ES73209501612803164263,TRX_N-01056-37674495,2024-06-01T23:53:21,Amurrio,incomes,salary_partner_bonus,803.53,-58289.3
buyer_3,Ana,35,ES73209501612803164263,TRX_N-01057-33550643,2024-06-03T09:55:22,Amurrio,expenses,leisure,-32.23,-58321.53
buyer_3,Ana,35,ES73209501612803164263,TRX_N-01058-13916462,2024-06-04T14:56:53,Amurrio,expenses,mortgage,-938.86,-59260.39
buyer_3,Ana,35,ES73209501612803164263,TRX_N-01059-93487300,2024-06-05T11:34:46,Galdakao,expenses,cash,-100.0,-59360.39
buyer_3,Ana,35,ES73209501612803164263,TRX_N-01060-00441544,2024-06-06T21:19:14,Amurrio,expenses,leisure,-73.43,-59433.82
buyer_3,Ana,35,ES73209501612803164263,TRX_N-01061-86034821,2024-06-07T18:59:09,Amurrio,expenses,internet,-42.0,-59475.82
buyer_3,Ana,35,ES73209501612803164263,TRX_N-01062-11963664,2024-06-08T23:16:59,Amurrio,expenses,water,-22.53,-59498.35
buyer_3,Ana,35,ES73209501612803164263,TRX_N-01063-60212855,2024-06-08T07:25:11,Amurrio,expenses,electricity,-87.02,-59585.37
buyer_3,Ana,35,ES73209501612803164263,TRX_N-01064-63525330,2024-06-08T11:50:28,Amurrio,expenses,gas,-100.8,-59686.17
buyer_3,Ana,35,ES73209501612803164263,TRX_N-01065-94780799,2024-06-08T14:34:05,Amurrio,expenses,phone,-39.18,-59725.35
buyer_3,Ana,35,ES73209501612803164263,TRX_N-01066-14763938,2024-06-08T14:32:06,Amurrio,expenses,cash,-100.0,-59825.35
buyer_3,Ana,35,ES73209501612803164263,TRX_N-01067-50690838,2024-06-09T21:32:52,Amurrio,expenses,leisure,-25.07,-59850.42
buyer_3,Ana,35,ES73209501612803164263,TRX_N-01068-12781135,2024-06-12T17:21:41,Amurrio,expenses,transport,-55.62,-59906.04
buyer_3,Ana,35,ES73209501612803164263,TRX_N-01069-47592617,2024-06-13T11:38:38,Sestao,expenses,food,-114.15,-60020.19
buyer_3,Ana,35,ES73209501612803164263,TRX_N-01070-65448179,2024-06-14T13:39:58,Amurrio,expenses,leisure,-18.22,-60038.41
buyer_3,Ana,35,ES73209501612803164263,TRX_N-01071-06639592,2024-06-15T16:36:13,Amurrio,expenses,food,-71.94,-60110.35
buyer_3,Ana,35,ES73209501612803164263,TRX_N-01072-30163403,2024-06-15T20:24:14,Amurrio,expenses,gifts,-67.39,-60177.74
buyer_3,Ana,35,ES73209501612803164263,TRX_N-01073-75881625,2024-06-16T13:05:55,Amurrio,expenses,travel,-840.53,-61018.27
buyer_3,Ana,35,ES73209501612803164263,TRX_N-01074-37056057,2024-06-18T14:14:20,Irun,expenses,appliances,-394.85,-61413.12
buyer_3,Ana,35,ES73209501612803164263,TRX_N-01075-68147465,2024-06-22T12:29:21,Amurrio,expenses,cash,-100.0,-61513.12
buyer_3,Ana,35,ES73209501612803164263,TRX_N-01076-51372213,2024-06-23T17:14:45,Amurrio,expenses,transport,-88.37,-61601.49
buyer_3,Ana,35,ES73209501612803164263,TRX_N-01077-11134893,2024-06-24T19:05:26,Amurrio,expenses,cash,-100.0,-61701.49
buyer_3,Ana,35,ES73209501612803164263,TRX_N-01078-64483292,2024-06-27T12:32:50,Amurrio,expenses,children,-180.88,-61882.37
buyer_3,Ana,35,ES73209501612803164263,TRX_N-01079-77542974,2024-06-28T12:09:22,Amurrio,expenses,food,-68.18,-61950.55
buyer_3,Ana,35,ES73209501612803164263,TRX_N-01080-95073669,2024-06-28T19:14:55,Amurrio,expenses,cash,-100.0,-62050.55
buyer_3,Ana,35,ES73209501612803164263,TRX_N-01081-01763955,2024-06-29T09:09:55,Amurrio,expenses,food,-109.52,-62160.07
buyer_3,Ana,35,ES73209501612803164263,TRX_N-01082-63338260,2024-07-01T09:07:55,Amurrio,incomes,salary,1594.05,-60566.02
buyer_3,Ana,35,ES73209501612803164263,TRX_N-01083-18904906,2024-07-01T09:07:55,Amurrio,incomes,salary_partner,1065.72,-59500.3
buyer_3,Ana,35,ES73209501612803164263,TRX_N-01084-52793836,2024-07-01T10:13:35,Amurrio,expenses,food,-90.37,-59590.67
buyer_3,Ana,35,ES73209501612803164263,TRX_N-01085-20914554,2024-07-01T17:26:24,Amurrio,expenses,children,-135.27,-59725.94
buyer_3,Ana,35,ES73209501612803164263,TRX_N-01086-96191490,2024-07-02T08:24:04,Amurrio,expenses,transport,-59.07,-59785.01
buyer_3,Ana,35,ES73209501612803164263,TRX_N-01087-48809644,2024-07-02T15:42:56,Amurrio,expenses,cash,-100.0,-59885.01
buyer_3,Ana,35,ES73209501612803164263,TRX_N-01088-05317261,2024-07-04T08:22:07,Amurrio,expenses,mortgage,-938.86,-60823.87
buyer_3,Ana,35,ES73209501612803164263,TRX_N-01089-73716069,2024-07-04T20:30:51,Amurrio,expenses,clothing,-70.73,-60894.6
buyer_3,Ana,35,ES73209501612803164263,TRX_N-01090-66309660,2024-07-04T20:57:58,Amurrio,expenses,healthcare,-83.46,-60978.06
buyer_3,Ana,35,ES73209501612803164263,TRX_N-01091-43185673,2024-07-04T08:23:13,Amurrio,expenses,cash,-100.0,-61078.06
buyer_3,Ana,35,ES73209501612803164263,TRX_N-01092-36361076,2024-07-05T11:05:54,Amurrio,expenses,water,-29.27,-61107.33
buyer_3,Ana,35,ES73209501612803164263,TRX_N-01093-64442035,2024-07-05T01:07:39,Amurrio,expenses,electricity,-84.02,-61191.35
buyer_3,Ana,35,ES73209501612803164263,TRX_N-01094-27938178,2024-07-05T02:39:36,Amurrio,expenses,gas,-32.32,-61223.67
buyer_3,Ana,35,ES73209501612803164263,TRX_N-01095-35264143,2024-07-05T13:34:25,Amurrio,expenses,internet,-42.0,-61265.67
buyer_3,Ana,35,ES73209501612803164263,TRX_N-01096-20474644,2024-07-05T20:57:55,Amurrio,expenses,cash,-100.0,-61365.67
buyer_3,Ana,35,ES73209501612803164263,TRX_N-01097-51799230,2024-07-06T16:51:02,Amurrio,expenses,transport,-84.89,-61450.56
buyer_3,Ana,35,ES73209501612803164263,TRX_N-01098-49136181,2024-07-07T12:36:51,Amurrio,expenses,leisure,-61.37,-61511.93
buyer_3,Ana,35,ES73209501612803164263,TRX_N-01099-41585322,2024-07-07T16:27:22,Amurrio,expenses,travel,-1175.06,-62686.99
buyer_3,Ana,35,ES73209501612803164263,TRX_N-01100-91138974,2024-07-08T13:59:36,Amurrio,expenses,phone,-44.17,-62731.16
buyer_3,Ana,35,ES73209501612803164263,TRX_N-01101-98484678,2024-07-08T10:16:36,Berango,expenses,cash,-100.0,-62831.16
buyer_3,Ana,35,ES73209501612803164263,TRX_N-01102-00082866,2024-07-08T14:46:17,Amurrio,expenses,travel,-947.0,-63778.16
buyer_3,Ana,35,ES73209501612803164263,TRX_N-01103-19721830,2024-07-09T16:27:11,Pasaia,expenses,transport,-80.96,-63859.12
buyer_3,Ana,35,ES73209501612803164263,TRX_N-01104-47425829,2024-07-10T09:12:08,Amurrio,expenses,cash,-100.0,-63959.12
buyer_3,Ana,35,ES73209501612803164263,TRX_N-01105-31240510,2024-07-11T23:07:02,Amurrio,expenses,cash,-100.0,-64059.12
buyer_3,Ana,35,ES73209501612803164263,TRX_N-01106-60532282,2024-07-12T11:41:37,Amurrio,expenses,leisure,-69.13,-64128.25
buyer_3,Ana,35,ES73209501612803164263,TRX_N-01107-01730640,2024-07-14T21:51:13,Amurrio,expenses,transport,-43.13,-64171.38
buyer_3,Ana,35,ES73209501612803164263,TRX_N-01108-19648129,2024-07-14T18:03:02,Amurrio,expenses,leisure,-32.67,-64204.05
buyer_3,Ana,35,ES73209501612803164263,TRX_N-01109-62834957,2024-07-14T09:39:53,Eibar,expenses,clothing,-87.84,-64291.89
buyer_3,Ana,35,ES73209501612803164263,TRX_N-01110-16211556,2024-07-15T11:30:45,Hondarribia,expenses,food,-96.84,-64388.73
buyer_3,Ana,35,ES73209501612803164263,TRX_N-01111-18491857,2024-07-19T19:36:14,Amurrio,expenses,transport,-88.1,-64476.83
buyer_3,Ana,35,ES73209501612803164263,TRX_N-01112-39329305,2024-07-21T04:17:03,Amurrio,expenses,healthcare,-77.02,-64553.85
buyer_3,Ana,35,ES73209501612803164263,TRX_N-01113-90405758,2024-07-21T16:22:55,Bilbao,expenses,appliances,-272.52,-64826.37
buyer_3,Ana,35,ES73209501612803164263,TRX_N-01114-00192373,2024-07-22T02:37:58,Amurrio,expenses,transport,-47.41,-64873.78
buyer_3,Ana,35,ES73209501612803164263,TRX_N-01115-35387367,2024-07-23T21:43:57,Amurrio,expenses,clothing,-121.57,-64995.35
buyer_3,Ana,35,ES73209501612803164263,TRX_N-01116-47600398,2024-07-24T08:16:06,Amurrio,expenses,cash,-100.0,-65095.35
buyer_3,Ana,35,ES73209501612803164263,TRX_N-01117-61186091,2024-07-25T08:01:08,Amurrio,expenses,cash,-100.0,-65195.35
buyer_3,Ana,35,ES73209501612803164263,TRX_N-01118-40345786,2024-07-26T17:13:02,Bermeo,expenses,cash,-100.0,-65295.35
buyer_3,Ana,35,ES73209501612803164263,TRX_N-01119-62320381,2024-07-28T14:48:46,Amurrio,expenses,transport,-59.22,-65354.57
buyer_3,Ana,35,ES73209501612803164263,TRX_N-01120-44560413,2024-07-29T10:14:06,Amurrio,expenses,transport,-80.82,-65435.39
buyer_3,Ana,35,ES73209501612803164263,TRX_N-01121-39888446,2024-07-30T16:02:29,Amurrio,expenses,transport,-54.7,-65490.09
buyer_3,Ana,35,ES73209501612803164263,TRX_N-01122-87008165,2024-07-30T01:02:22,Amurrio,expenses,clothing,-107.48,-65597.57
buyer_3,Ana,35,ES73209501612803164263,TRX_N-01123-70331889,2024-08-01T10:48:29,Amurrio,incomes,salary,1594.05,-64003.52
buyer_3,Ana,35,ES73209501612803164263,TRX_N-01124-42532628,2024-08-01T10:48:29,Amurrio,incomes,salary_partner,1065.72,-62937.8
buyer_3,Ana,35,ES73209501612803164263,TRX_N-01125-06634391,2024-08-01T10:48:29,Amurrio,incomes,extra_income,244.88,-62692.92
buyer_3,Ana,35,ES73209501612803164263,TRX_N-01126-91371443,2024-08-01T19:15:11,Amurrio,expenses,food,-100.4,-62793.32
buyer_3,Ana,35,ES73209501612803164263,TRX_N-01127-74005114,2024-08-02T12:29:04,Amurrio,expenses,leisure,-48.1,-62841.42
buyer_3,Ana,35,ES73209501612803164263,TRX_N-01128-04669467,2024-08-04T09:52:23,Amurrio,expenses,mortgage,-938.86,-63780.28
buyer_3,Ana,35,ES73209501612803164263,TRX_N-01129-39007017,2024-08-06T20:15:18,Amurrio,expenses,phone,-31.57,-63811.85
buyer_3,Ana,35,ES73209501612803164263,TRX_N-01130-02563618,2024-08-08T08:39:15,Amurrio,expenses,internet,-42.0,-63853.85
buyer_3,Ana,35,ES73209501612803164263,TRX_N-01131-17581353,2024-08-08T13:06:23,Amurrio,expenses,water,-24.0,-63877.85
buyer_3,Ana,35,ES73209501612803164263,TRX_N-01132-00912450,2024-08-08T15:29:40,Amurrio,expenses,electricity,-61.67,-63939.52
buyer_3,Ana,35,ES73209501612803164263,TRX_N-01133-01736703,2024-08-08T19:54:27,Amurrio,expenses,gas,-77.03,-64016.55
buyer_3,Ana,35,ES73209501612803164263,TRX_N-01134-96352698,2024-08-08T17:04:43,Amurrio,expenses,repairs,-149.73,-64166.28
buyer_3,Ana,35,ES73209501612803164263,TRX_N-01135-47309519,2024-08-10T09:01:02,Amurrio,expenses,transport,-67.82,-64234.1
buyer_3,Ana,35,ES73209501612803164263,TRX_N-01136-51063139,2024-08-12T04:23:32,Amurrio,expenses,clothing,-88.38,-64322.48
buyer_3,Ana,35,ES73209501612803164263,TRX_N-01137-04070724,2024-08-13T19:38:17,Galdakao,expenses,healthcare,-128.68,-64451.16
buyer_3,Ana,35,ES73209501612803164263,TRX_N-01138-10607760,2024-08-14T16:36:45,Amurrio,expenses,transport,-79.28,-64530.44
buyer_3,Ana,35,ES73209501612803164263,TRX_N-01139-22392342,2024-08-17T18:24:56,Amurrio,expenses,repairs,-168.44,-64698.88
buyer_3,Ana,35,ES73209501612803164263,TRX_N-01140-56989444,2024-08-18T12:18:44,Amurrio,expenses,clothing,-154.83,-64853.71
buyer_3,Ana,35,ES73209501612803164263,TRX_N-01141-35172478,2024-08-20T06:12:10,Irun,expenses,leisure,-23.28,-64876.99
buyer_3,Ana,35,ES73209501612803164263,TRX_N-01142-18453912,2024-08-21T08:58:09,Amurrio,expenses,cash,-100.0,-64976.99
buyer_3,Ana,35,ES73209501612803164263,TRX_N-01143-83976887,2024-08-22T14:23:52,Amurrio,expenses,healthcare,-180.29,-65157.28
buyer_3,Ana,35,ES73209501612803164263,TRX_N-01144-88875572,2024-08-24T21:40:48,Amurrio,expenses,repairs,-109.26,-65266.54
buyer_3,Ana,35,ES73209501612803164263,TRX_N-01145-13485452,2024-08-25T13:36:49,Amurrio,expenses,cash,-100.0,-65366.54
buyer_3,Ana,35,ES73209501612803164263,TRX_N-01146-01977997,2024-08-26T15:49:45,Amurrio,expenses,food,-70.49,-65437.03
buyer_3,Ana,35,ES73209501612803164263,TRX_N-01147-34104647,2024-08-26T09:30:44,Amurrio,expenses,transport,-86.79,-65523.82
buyer_3,Ana,35,ES73209501612803164263,TRX_N-01148-96794379,2024-08-27T17:28:15,Amurrio,expenses,repairs,-260.42,-65784.24
buyer_3,Ana,35,ES73209501612803164263,TRX_N-01149-98454729,2024-08-28T17:59:43,Amurrio,expenses,repairs,-218.75,-66002.99
buyer_3,Ana,35,ES73209501612803164263,TRX_N-01150-31899654,2024-08-30T23:58:35,Zuia,expenses,education,-68.92,-66071.91
buyer_3,Ana,35,ES73209501612803164263,TRX_N-01151-42616834,2024-08-31T22:09:22,Amurrio,expenses,clothing,-51.17,-66123.08
buyer_3,Ana,35,ES73209501612803164263,TRX_N-01152-74056123,2024-08-31T08:03:23,Amurrio,expenses,children,-215.01,-66338.09
buyer_3,Ana,35,ES73209501612803164263,TRX_N-01153-39057210,2024-09-01T15:54:57,Amurrio,incomes,salary,1594.05,-64744.04
buyer_3,Ana,35,ES73209501612803164263,TRX_N-01154-20103425,2024-09-01T15:54:57,Amurrio,incomes,salary_partner,1065.72,-63678.32
buyer_3,Ana,35,ES73209501612803164263,TRX_N-01155-95911182,2024-09-01T19:27:59,Amurrio,expenses,food,-103.46,-63781.78
buyer_3,Ana,35,ES73209501612803164263,TRX_N-01156-65673921,2024-09-01T09:25:58,Amurrio,expenses,healthcare,-101.57,-63883.35
buyer_3,Ana,35,ES73209501612803164263,TRX_N-01157-85417193,2024-09-03T20:21:36,Mungia,expenses,leisure,-72.19,-63955.54
buyer_3,Ana,35,ES73209501612803164263,TRX_N-01158-64084019,2024-09-04T18:27:05,Amurrio,expenses,mortgage,-938.86,-64894.4
buyer_3,Ana,35,ES73209501612803164263,TRX_N-01159-34168807,2024-09-05T11:00:56,Amurrio,expenses,electricity,-20.09,-64914.49
buyer_3,Ana,35,ES73209501612803164263,TRX_N-01160-94291610,2024-09-05T20:04:30,Amurrio,expenses,gas,-53.45,-64967.94
buyer_3,Ana,35,ES73209501612803164263,TRX_N-01161-05394048,2024-09-05T16:26:15,Amurrio,expenses,internet,-42.0,-65009.94
buyer_3,Ana,35,ES73209501612803164263,TRX_N-01162-76927952,2024-09-07T01:13:34,Amurrio,expenses,leisure,-36.26,-65046.2
buyer_3,Ana,35,ES73209501612803164263,TRX_N-01163-01141120,2024-09-08T20:07:24,Amurrio,expenses,water,-44.13,-65090.33
buyer_3,Ana,35,ES73209501612803164263,TRX_N-01164-55617247,2024-09-08T22:16:50,Amurrio,expenses,phone,-44.93,-65135.26
buyer_3,Ana,35,ES73209501612803164263,TRX_N-01165-75644805,2024-09-08T17:27:34,Zuia,expenses,food,-66.74,-65202.0
buyer_3,Ana,35,ES73209501612803164263,TRX_N-01166-35762494,2024-09-10T22:02:05,Amurrio,expenses,cash,-100.0,-65302.0
buyer_3,Ana,35,ES73209501612803164263,TRX_N-01167-25638445,2024-09-12T22:42:38,Amurrio,expenses,cash,-100.0,-65402.0
buyer_3,Ana,35,ES73209501612803164263,TRX_N-01168-42466840,2024-09-17T08:13:17,Amurrio,expenses,leisure,-43.21,-65445.21
buyer_3,Ana,35,ES73209501612803164263,TRX_N-01169-73600525,2024-09-18T03:53:41,Amurrio,expenses,cash,-100.0,-65545.21
buyer_3,Ana,35,ES73209501612803164263,TRX_N-01170-23063022,2024-09-18T20:01:43,Berango,expenses,gifts,-623.31,-66168.52
buyer_3,Ana,35,ES73209501612803164263,TRX_N-01171-02019570,2024-09-21T17:21:02,Amurrio,expenses,gifts,-241.87,-66410.39
buyer_3,Ana,35,ES73209501612803164263,TRX_N-01172-27396855,2024-09-22T23:38:03,Amurrio,expenses,food,-69.76,-66480.15
buyer_3,Ana,35,ES73209501612803164263,TRX_N-01173-22286921,2024-09-24T20:42:42,Amurrio,expenses,cash,-100.0,-66580.15
buyer_3,Ana,35,ES73209501612803164263,TRX_N-01174-82627968,2024-09-25T09:28:09,Amurrio,expenses,children,-110.97,-66691.12
buyer_3,Ana,35,ES73209501612803164263,TRX_N-01175-08433250,2024-09-26T12:03:20,Amurrio,expenses,gifts,-640.06,-67331.18
buyer_3,Ana,35,ES73209501612803164263,TRX_N-01176-91639343,2024-09-30T20:41:28,Amurrio,expenses,transport,-60.13,-67391.31
buyer_3,Ana,35,ES73209501612803164263,TRX_N-01177-33097580,2024-10-01T20:14:52,Amurrio,incomes,salary,1594.05,-65797.26
buyer_3,Ana,35,ES73209501612803164263,TRX_N-01178-61672431,2024-10-01T20:14:52,Amurrio,incomes,salary_partner,1065.72,-64731.54
buyer_3,Ana,35,ES73209501612803164263,TRX_N-01179-05725144,2024-10-02T08:18:30,Amurrio,expenses,children,-105.4,-64836.94
buyer_3,Ana,35,ES73209501612803164263,TRX_N-01180-95502719,2024-10-03T14:25:02,Amurrio,expenses,food,-65.52,-64902.46
buyer_3,Ana,35,ES73209501612803164263,TRX_N-01181-06673703,2024-10-03T08:29:36,Amurrio,expenses,children,-214.77,-65117.23
buyer_3,Ana,35,ES73209501612803164263,TRX_N-01182-20659461,2024-10-04T17:34:06,Amurrio,expenses,mortgage,-938.86,-66056.09
buyer_3,Ana,35,ES73209501612803164263,TRX_N-01183-96259189,2024-10-05T18:37:29,Amurrio,expenses,water,-32.72,-66088.81
buyer_3,Ana,35,ES73209501612803164263,TRX_N-01184-08235333,2024-10-05T14:25:29,Amurrio,expenses,internet,-42.0,-66130.81
buyer_3,Ana,35,ES73209501612803164263,TRX_N-01185-91935323,2024-10-05T23:53:03,Amurrio,expenses,phone,-41.26,-66172.07
buyer_3,Ana,35,ES73209501612803164263,TRX_N-01186-76621297,2024-10-05T13:30:17,Amurrio,expenses,food,-89.24,-66261.31
buyer_3,Ana,35,ES73209501612803164263,TRX_N-01187-93238149,2024-10-05T09:27:48,Amurrio,expenses,leisure,-80.72,-66342.03
buyer_3,Ana,35,ES73209501612803164263,TRX_N-01188-99951985,2024-10-06T12:11:13,Amurrio,expenses,gas,-80.52,-66422.55
buyer_3,Ana,35,ES73209501612803164263,TRX_N-01189-35294291,2024-10-07T12:26:26,Amurrio,expenses,leisure,-33.32,-66455.87
buyer_3,Ana,35,ES73209501612803164263,TRX_N-01190-42497496,2024-10-08T22:20:13,Amurrio,expenses,electricity,-20.61,-66476.48
buyer_4,Jorge,50,ES82209578084093320757,TRX_N-00001-78676417,2022-01-01T13:12:11,Galdakao,incomes,salary,1370.36,3072.42
buyer_4,Jorge,50,ES82209578084093320757,TRX_N-00002-73014715,2022-01-01T13:12:11,Galdakao,incomes,salary_partner,1413.6,4486.02
buyer_4,Jorge,50,ES82209578084093320757,TRX_N-00003-08249369,2022-01-01T14:35:11,Galdakao,expenses,clothing,-90.4,4395.62
buyer_4,Jorge,50,ES82209578084093320757,TRX_N-00004-55929656,2022-01-04T14:20:56,Galdakao,expenses,mortgage,-979.09,3416.53
buyer_4,Jorge,50,ES82209578084093320757,TRX_N-00005-96991102,2022-01-04T18:55:28,Galdakao,expenses,cash,-100.0,3316.53
buyer_4,Jorge,50,ES82209578084093320757,TRX_N-00006-73778866,2022-01-05T14:13:54,Galdakao,expenses,gas,-60.29,3256.24
buyer_4,Jorge,50,ES82209578084093320757,TRX_N-00007-97353663,2022-01-05T08:39:31,Galdakao,expenses,children,-150.86,3105.38
buyer_4,Jorge,50,ES82209578084093320757,TRX_N-00008-84491980,2022-01-06T18:18:07,Galdakao,expenses,internet,-42.0,3063.38
buyer_4,Jorge,50,ES82209578084093320757,TRX_N-00009-74143189,2022-01-06T12:12:49,Galdakao,expenses,children,-109.62,2953.76
buyer_4,Jorge,50,ES82209578084093320757,TRX_N-00010-88483414,2022-01-07T08:40:42,Galdakao,expenses,electricity,-72.05,2881.71
buyer_4,Jorge,50,ES82209578084093320757,TRX_N-00011-10853532,2022-01-07T10:20:45,Galdakao,expenses,phone,-36.9,2844.81
buyer_4,Jorge,50,ES82209578084093320757,TRX_N-00012-33548173,2022-01-07T10:16:32,Galdakao,expenses,cash,-100.0,2744.81
buyer_4,Jorge,50,ES82209578084093320757,TRX_N-00013-59487137,2022-01-08T13:16:00,Galdakao,expenses,water,-32.48,2712.33
buyer_4,Jorge,50,ES82209578084093320757,TRX_N-00014-92182133,2022-01-08T00:54:39,Galdakao,expenses,cash,-100.0,2612.33
buyer_4,Jorge,50,ES82209578084093320757,TRX_N-00015-87128711,2022-01-10T09:38:15,Galdakao,expenses,travel,-1363.65,1248.68
buyer_4,Jorge,50,ES82209578084093320757,TRX_N-00016-81324143,2022-01-11T14:25:49,Galdakao,expenses,transport,-72.86,1175.82
buyer_4,Jorge,50,ES82209578084093320757,TRX_N-00017-12974374,2022-01-11T10:22:45,Galdakao,expenses,cash,-100.0,1075.82
buyer_4,Jorge,50,ES82209578084093320757,TRX_N-00018-72775561,2022-01-11T16:41:15,Galdakao,expenses,repairs,-57.69,1018.13
buyer_4,Jorge,50,ES82209578084093320757,TRX_N-00019-81692459,2022-01-12T16:22:14,Barakaldo,expenses,food,-100.02,918.11
buyer_4,Jorge,50,ES82209578084093320757,TRX_N-00020-09062277,2022-01-12T01:34:01,Galdakao,expenses,clothing,-85.62,832.49
buyer_4,Jorge,50,ES82209578084093320757,TRX_N-00021-98354310,2022-01-12T10:21:09,Galdakao,expenses,repairs,-328.27,504.22
buyer_4,Jorge,50,ES82209578084093320757,TRX_N-00022-84361089,2022-01-14T08:30:06,Galdakao,expenses,cash,-100.0,404.22
buyer_4,Jorge,50,ES82209578084093320757,TRX_N-00023-35766159,2022-01-15T20:19:09,Galdakao,expenses,leisure,-39.96,364.26
buyer_4,Jorge,50,ES82209578084093320757,TRX_N-00024-71897786,2022-01-16T04:16:24,Galdakao,expenses,food,-96.2,268.06
buyer_4,Jorge,50,ES82209578084093320757,TRX_N-00025-57814114,2022-01-18T13:23:38,Amurrio,expenses,food,-120.8,147.26
buyer_4,Jorge,50,ES82209578084093320757,TRX_N-00026-15587721,2022-01-18T03:52:47,Galdakao,expenses,repairs,-240.5,-93.24
buyer_4,Jorge,50,ES82209578084093320757,TRX_N-00027-83546155,2022-01-22T19:29:15,Galdakao,expenses,food,-94.22,-187.46
buyer_4,Jorge,50,ES82209578084093320757,TRX_N-00028-19000566,2022-01-23T13:33:23,Galdakao,expenses,leisure,-58.31,-245.77
buyer_4,Jorge,50,ES82209578084093320757,TRX_N-00029-00798433,2022-01-24T20:46:11,Basauri,expenses,gifts,-650.09,-895.86
buyer_4,Jorge,50,ES82209578084093320757,TRX_N-00030-49410546,2022-01-24T12:25:40,Galdakao,expenses,children,-161.71,-1057.57
buyer_4,Jorge,50,ES82209578084093320757,TRX_N-00031-04181455,2022-01-25T09:15:35,Galdakao,expenses,leisure,-35.15,-1092.72
buyer_4,Jorge,50,ES82209578084093320757,TRX_N-00032-06800943,2022-01-28T20:55:39,Galdakao,expenses,transport,-86.77,-1179.49
buyer_4,Jorge,50,ES82209578084093320757,TRX_N-00033-33267962,2022-01-28T05:00:57,Galdakao,expenses,cash,-100.0,-1279.49
buyer_4,Jorge,50,ES82209578084093320757,TRX_N-00034-22660472,2022-01-30T19:36:30,Galdakao,expenses,leisure,-48.27,-1327.76
buyer_4,Jorge,50,ES82209578084093320757,TRX_N-00035-78543511,2022-01-31T12:58:52,Galdakao,expenses,leisure,-29.52,-1357.28
buyer_4,Jorge,50,ES82209578084093320757,TRX_N-00036-59731705,2022-01-31T10:43:45,Galdakao,expenses,children,-204.44,-1561.72
buyer_4,Jorge,50,ES82209578084093320757,TRX_N-00037-01158809,2022-02-01T12:13:56,Galdakao,incomes,salary,1370.36,-191.36
buyer_4,Jorge,50,ES82209578084093320757,TRX_N-00038-13270380,2022-02-01T12:13:56,Galdakao,incomes,salary_partner,1413.6,1222.24
buyer_4,Jorge,50,ES82209578084093320757,TRX_N-00039-44256528,2022-02-01T11:02:25,Galdakao,expenses,food,-60.34,1161.9
buyer_4,Jorge,50,ES82209578084093320757,TRX_N-00040-59096791,2022-02-02T10:09:25,Galdakao,expenses,cash,-100.0,1061.9
buyer_4,Jorge,50,ES82209578084093320757,TRX_N-00041-00052168,2022-02-03T20:44:50,Galdakao,expenses,clothing,-89.31,972.59
buyer_4,Jorge,50,ES82209578084093320757,TRX_N-00042-57976337,2022-02-04T16:16:59,Galdakao,expenses,mortgage,-979.09,-6.5
buyer_4,Jorge,50,ES82209578084093320757,TRX_N-00043-98527178,2022-02-04T16:39:30,Andoain,expenses,repairs,-199.92,-206.42
buyer_4,Jorge,50,ES82209578084093320757,TRX_N-00044-38435613,2022-02-04T13:30:53,Galdakao,expenses,children,-189.75,-396.17
buyer_4,Jorge,50,ES82209578084093320757,TRX_N-00045-13195841,2022-02-05T08:48:40,Galdakao,expenses,internet,-42.0,-438.17
buyer_4,Jorge,50,ES82209578084093320757,TRX_N-00046-69503879,2022-02-05T14:34:42,Galdakao,expenses,cash,-100.0,-538.17
buyer_4,Jorge,50,ES82209578084093320757,TRX_N-00047-69495052,2022-02-07T08:19:38,Galdakao,expenses,gas,-104.19,-642.36
buyer_4,Jorge,50,ES82209578084093320757,TRX_N-00048-41328133,2022-02-07T08:28:30,Galdakao,expenses,phone,-36.72,-679.08
buyer_4,Jorge,50,ES82209578084093320757,TRX_N-00049-78474042,2022-02-07T11:36:33,Galdakao,expenses,leisure,-19.7,-698.78
buyer_4,Jorge,50,ES82209578084093320757,TRX_N-00050-38431042,2022-02-08T19:45:23,Galdakao,expenses,water,-40.41,-739.19
buyer_4,Jorge,50,ES82209578084093320757,TRX_N-00051-78463499,2022-02-08T18:23:48,Galdakao,expenses,electricity,-69.76,-808.95
buyer_4,Jorge,50,ES82209578084093320757,TRX_N-00052-38261109,2022-02-08T18:15:55,Galdakao,expenses,food,-111.02,-919.97
buyer_4,Jorge,50,ES82209578084093320757,TRX_N-00053-58418269,2022-02-08T09:25:02,Galdakao,expenses,healthcare,-48.23,-968.2
buyer_4,Jorge,50,ES82209578084093320757,TRX_N-00054-58851734,2022-02-09T02:44:16,Galdakao,expenses,gifts,-307.28,-1275.48
buyer_4,Jorge,50,ES82209578084093320757,TRX_N-00055-23984855,2022-02-10T20:01:38,Galdakao,expenses,repairs,-211.93,-1487.41
buyer_4,Jorge,50,ES82209578084093320757,TRX_N-00056-16012817,2022-02-12T13:05:04,Galdakao,expenses,leisure,-42.55,-1529.96
buyer_4,Jorge,50,ES82209578084093320757,TRX_N-00057-81235834,2022-02-12T17:39:16,Galdakao,expenses,repairs,-79.15,-1609.11
buyer_4,Jorge,50,ES82209578084093320757,TRX_N-00058-14252489,2022-02-12T15:30:31,Galdakao,expenses,children,-264.39,-1873.5
buyer_4,Jorge,50,ES82209578084093320757,TRX_N-00059-11754661,2022-02-13T17:03:04,Alegría-Dulantzi,expenses,gifts,-172.02,-2045.52
buyer_4,Jorge,50,ES82209578084093320757,TRX_N-00060-23617264,2022-02-13T07:53:21,Galdakao,expenses,children,-207.11,-2252.63
buyer_4,Jorge,50,ES82209578084093320757,TRX_N-00061-54780101,2022-02-15T13:45:21,Galdakao,expenses,leisure,-50.81,-2303.44
buyer_4,Jorge,50,ES82209578084093320757,TRX_N-00062-06499698,2022-02-15T20:04:53,Galdakao,expenses,gifts,-523.49,-2826.93
buyer_4,Jorge,50,ES82209578084093320757,TRX_N-00063-49125568,2022-02-16T12:18:45,Lasarte-Oria,expenses,healthcare,-47.07,-2874.0
buyer_4,Jorge,50,ES82209578084093320757,TRX_N-00064-77007044,2022-02-16T17:58:47,Galdakao,expenses,children,-116.7,-2990.7
buyer_4,Jorge,50,ES82209578084093320757,TRX_N-00065-15030534,2022-02-18T17:05:06,Galdakao,expenses,children,-101.84,-3092.54
buyer_4,Jorge,50,ES82209578084093320757,TRX_N-00066-57263780,2022-02-19T09:52:59,Galdakao,expenses,repairs,-44.73,-3137.27
buyer_4,Jorge,50,ES82209578084093320757,TRX_N-00067-57521169,2022-02-20T17:20:47,Galdakao,expenses,clothing,-119.35,-3256.62
buyer_4,Jorge,50,ES82209578084093320757,TRX_N-00068-23227389,2022-02-24T09:31:41,Getxo,expenses,cash,-100.0,-3356.62
buyer_4,Jorge,50,ES82209578084093320757,TRX_N-00069-69367943,2022-02-26T12:08:50,Galdakao,expenses,clothing,-80.87,-3437.49
buyer_4,Jorge,50,ES82209578084093320757,TRX_N-00070-80900406,2022-02-26T15:25:12,Galdakao,expenses,children,-63.08,-3500.57
buyer_4,Jorge,50,ES82209578084093320757,TRX_N-00071-05245089,2022-02-27T16:54:34,Galdakao,expenses,leisure,-47.78,-3548.35
buyer_4,Jorge,50,ES82209578084093320757,TRX_N-00072-51247743,2022-02-27T17:30:59,Galdakao,expenses,children,-119.4,-3667.75
buyer_4,Jorge,50,ES82209578084093320757,TRX_N-00073-83177579,2022-02-28T13:20:23,Galdakao,expenses,food,-113.79,-3781.54
buyer_4,Jorge,50,ES82209578084093320757,TRX_N-00074-38957071,2022-02-28T16:40:03,Galdakao,expenses,leisure,-52.14,-3833.68
buyer_4,Jorge,50,ES82209578084093320757,TRX_N-00075-01720466,2022-03-01T20:58:34,Galdakao,incomes,salary,1370.36,-2463.32
buyer_4,Jorge,50,ES82209578084093320757,TRX_N-00076-07062899,2022-03-01T20:58:34,Galdakao,incomes,salary_partner,1413.6,-1049.72
buyer_4,Jorge,50,ES82209578084093320757,TRX_N-00077-69354226,2022-03-01T17:59:30,Galdakao,expenses,leisure,-34.36,-1084.08
buyer_4,Jorge,50,ES82209578084093320757,TRX_N-00078-81199914,2022-03-01T07:25:44,Galdakao,expenses,cash,-100.0,-1184.08
buyer_4,Jorge,50,ES82209578084093320757,TRX_N-00079-44056813,2022-03-02T19:44:36,Galdakao,expenses,gifts,-542.31,-1726.39
buyer_4,Jorge,50,ES82209578084093320757,TRX_N-00080-00325583,2022-03-04T18:38:44,Galdakao,expenses,mortgage,-979.09,-2705.48
buyer_4,Jorge,50,ES82209578084093320757,TRX_N-00081-99199179,2022-03-05T09:31:46,Galdakao,expenses,water,-26.57,-2732.05
buyer_4,Jorge,50,ES82209578084093320757,TRX_N-00082-26095173,2022-03-05T12:24:49,Galdakao,expenses,phone,-35.43,-2767.48
buyer_4,Jorge,50,ES82209578084093320757,TRX_N-00083-25065121,2022-03-05T09:41:18,Galdakao,expenses,food,-97.95,-2865.43
buyer_4,Jorge,50,ES82209578084093320757,TRX_N-00084-40356911,2022-03-06T08:18:26,Galdakao,expenses,transport,-87.77,-2953.2
buyer_4,Jorge,50,ES82209578084093320757,TRX_N-00085-00298341,2022-03-07T20:19:09,Galdakao,expenses,electricity,-81.97,-3035.17
buyer_4,Jorge,50,ES82209578084093320757,TRX_N-00086-50941162,2022-03-07T19:39:59,Galdakao,expenses,internet,-42.0,-3077.17
buyer_4,Jorge,50,ES82209578084093320757,TRX_N-00087-47543026,2022-03-07T08:26:49,Galdakao,expenses,transport,-48.66,-3125.83
buyer_4,Jorge,50,ES82209578084093320757,TRX_N-00088-74169612,2022-03-07T18:00:49,Galdakao,expenses,healthcare,-88.98,-3214.81
buyer_4,Jorge,50,ES82209578084093320757,TRX_N-00089-61762841,2022-03-08T13:13:46,Galdakao,expenses,gas,-76.83,-3291.64
buyer_4,Jorge,50,ES82209578084093320757,TRX_N-00090-46458642,2022-03-08T16:50:03,Galdakao,expenses,gifts,-378.0,-3669.64
buyer_4,Jorge,50,ES82209578084093320757,TRX_N-00091-56275063,2022-03-10T12:42:23,Galdakao,expenses,leisure,-59.6,-3729.24
buyer_4,Jorge,50,ES82209578084093320757,TRX_N-00092-42482785,2022-03-10T12:56:29,Galdakao,expenses,cash,-100.0,-3829.24
buyer_4,Jorge,50,ES82209578084093320757,TRX_N-00093-95720640,2022-03-10T13:36:46,Galdakao,expenses,gifts,-89.28,-3918.52
buyer_4,Jorge,50,ES82209578084093320757,TRX_N-00094-50223156,2022-03-19T16:45:54,Galdakao,expenses,healthcare,-100.79,-4019.31
buyer_4,Jorge,50,ES82209578084093320757,TRX_N-00095-66026440,2022-03-21T15:53:06,Iruña de Oca,expenses,cash,-100.0,-4119.31
buyer_4,Jorge,50,ES82209578084093320757,TRX_N-00096-45714537,2022-03-25T19:14:21,Zuia,expenses,clothing,-117.41,-4236.72
buyer_4,Jorge,50,ES82209578084093320757,TRX_N-00097-03962600,2022-03-26T11:07:41,Vitoria-Gasteiz,expenses,cash,-100.0,-4336.72
buyer_4,Jorge,50,ES82209578084093320757,TRX_N-00098-89820714,2022-03-27T08:54:20,Galdakao,expenses,repairs,-47.99,-4384.71
buyer_4,Jorge,50,ES82209578084093320757,TRX_N-00099-72605000,2022-03-31T11:41:52,Galdakao,expenses,food,-74.08,-4458.79
buyer_4,Jorge,50,ES82209578084093320757,TRX_N-00100-32747834,2022-04-01T15:50:28,Galdakao,incomes,salary,1370.36,-3088.43
buyer_4,Jorge,50,ES82209578084093320757,TRX_N-00101-36630972,2022-04-01T15:50:28,Galdakao,incomes,salary_partner,1413.6,-1674.83
buyer_4,Jorge,50,ES82209578084093320757,TRX_N-00102-23745400,2022-04-01T15:50:28,Galdakao,incomes,extra_income,218.64,-1456.19
buyer_4,Jorge,50,ES82209578084093320757,TRX_N-00103-55814090,2022-04-02T15:28:48,Galdakao,expenses,leisure,-66.55,-1522.74
buyer_4,Jorge,50,ES82209578084093320757,TRX_N-00104-62773931,2022-04-02T08:17:22,Galdakao,expenses,gifts,-758.26,-2281.0
buyer_4,Jorge,50,ES82209578084093320757,TRX_N-00105-11874214,2022-04-03T17:54:19,Galdakao,expenses,children,-233.83,-2514.83
buyer_4,Jorge,50,ES82209578084093320757,TRX_N-00106-22761703,2022-04-04T13:54:08,Galdakao,expenses,mortgage,-979.09,-3493.92
buyer_4,Jorge,50,ES82209578084093320757,TRX_N-00107-68521758,2022-04-04T13:09:05,Galdakao,expenses,appliances,-418.23,-3912.15
buyer_4,Jorge,50,ES82209578084093320757,TRX_N-00108-23525333,2022-04-05T16:45:10,Galdakao,expenses,gas,-73.43,-3985.58
buyer_4,Jorge,50,ES82209578084093320757,TRX_N-00109-85557102,2022-04-06T17:52:19,Galdakao,expenses,water,-21.45,-4007.03
buyer_4,Jorge,50,ES82209578084093320757,TRX_N-00110-30144691,2022-04-06T13:14:18,Galdakao,expenses,internet,-42.0,-4049.03
buyer_4,Jorge,50,ES82209578084093320757,TRX_N-00111-39747661,2022-04-06T08:57:18,Galdakao,expenses,repairs,-29.22,-4078.25
buyer_4,Jorge,50,ES82209578084093320757,TRX_N-00112-75355327,2022-04-07T13:10:46,Galdakao,expenses,phone,-44.21,-4122.46
buyer_4,Jorge,50,ES82209578084093320757,TRX_N-00113-73427836,2022-04-07T11:46:22,Galdakao,expenses,cash,-100.0,-4222.46
buyer_4,Jorge,50,ES82209578084093320757,TRX_N-00114-76357461,2022-04-08T11:11:37,Galdakao,expenses,electricity,-77.57,-4300.03
buyer_4,Jorge,50,ES82209578084093320757,TRX_N-00115-84358228,2022-04-08T11:24:52,Galdakao,expenses,food,-77.15,-4377.18
buyer_4,Jorge,50,ES82209578084093320757,TRX_N-00116-83957268,2022-04-10T23:35:06,Galdakao,expenses,leisure,-19.6,-4396.78
buyer_4,Jorge,50,ES82209578084093320757,TRX_N-00117-92603288,2022-04-11T10:31:33,Galdakao,expenses,clothing,-131.28,-4528.06
buyer_4,Jorge,50,ES82209578084093320757,TRX_N-00118-55352727,2022-04-11T20:33:08,Galdakao,expenses,children,-176.72,-4704.78
buyer_4,Jorge,50,ES82209578084093320757,TRX_N-00119-35612840,2022-04-12T16:05:25,Galdakao,expenses,leisure,-56.9,-4761.68
buyer_4,Jorge,50,ES82209578084093320757,TRX_N-00120-23605497,2022-04-13T19:05:55,Galdakao,expenses,cash,-100.0,-4861.68
buyer_4,Jorge,50,ES82209578084093320757,TRX_N-00121-15662969,2022-04-15T16:18:38,Galdakao,expenses,cash,-100.0,-4961.68
buyer_4,Jorge,50,ES82209578084093320757,TRX_N-00122-46920307,2022-04-16T13:21:22,Galdakao,expenses,food,-76.67,-5038.35
buyer_4,Jorge,50,ES82209578084093320757,TRX_N-00123-27373508,2022-04-16T09:39:07,Galdakao,expenses,leisure,-53.56,-5091.91
buyer_4,Jorge,50,ES82209578084093320757,TRX_N-00124-80162788,2022-04-23T17:29:27,Galdakao,expenses,leisure,-24.78,-5116.69
buyer_4,Jorge,50,ES82209578084093320757,TRX_N-00125-74888883,2022-04-23T16:05:10,Galdakao,expenses,repairs,-162.31,-5279.0
buyer_4,Jorge,50,ES82209578084093320757,TRX_N-00126-28947449,2022-04-25T12:12:09,Galdakao,expenses,gifts,-34.74,-5313.74
buyer_4,Jorge,50,ES82209578084093320757,TRX_N-00127-03406794,2022-04-29T09:30:49,Galdakao,expenses,children,-51.13,-5364.87
buyer_4,Jorge,50,ES82209578084093320757,TRX_N-00128-71411359,2022-05-01T11:12:27,Galdakao,incomes,salary,1370.36,-3994.51
buyer_4,Jorge,50,ES82209578084093320757,TRX_N-00129-46677636,2022-05-01T11:12:27,Galdakao,incomes,salary_partner,1413.6,-2580.91
buyer_4,Jorge,50,ES82209578084093320757,TRX_N-00130-71635596,2022-05-01T00:51:19,Galdakao,expenses,appliances,-351.77,-2932.68
buyer_4,Jorge,50,ES82209578084093320757,TRX_N-00131-39780215,2022-05-02T22:31:15,Galdakao,expenses,transport,-44.85,-2977.53
buyer_4,Jorge,50,ES82209578084093320757,TRX_N-00132-05939485,2022-05-03T18:10:56,Galdakao,expenses,repairs,-251.88,-3229.41
buyer_4,Jorge,50,ES82209578084093320757,TRX_N-00133-44162566,2022-05-04T18:17:04,Galdakao,expenses,mortgage,-979.09,-4208.5
buyer_4,Jorge,50,ES82209578084093320757,TRX_N-00134-01191362,2022-05-04T20:40:35,Galdakao,expenses,food,-86.79,-4295.29
buyer_4,Jorge,50,ES82209578084093320757,TRX_N-00135-50473307,2022-05-04T21:44:52,Galdakao,expenses,cash,-100.0,-4395.29
buyer_4,Jorge,50,ES82209578084093320757,TRX_N-00136-06091314,2022-05-04T09:45:27,Galdakao,expenses,children,-166.06,-4561.35
buyer_4,Jorge,50,ES82209578084093320757,TRX_N-00137-32778438,2022-05-05T09:33:30,Galdakao,expenses,electricity,-88.96,-4650.31
buyer_4,Jorge,50,ES82209578084093320757,TRX_N-00138-76653216,2022-05-05T14:28:58,Galdakao,expenses,gas,-62.57,-4712.88
buyer_4,Jorge,50,ES82209578084093320757,TRX_N-00139-31301410,2022-05-05T21:18:37,Galdakao,expenses,cash,-100.0,-4812.88
buyer_4,Jorge,50,ES82209578084093320757,TRX_N-00140-71381530,2022-05-07T12:49:42,Galdakao,expenses,water,-43.66,-4856.54
buyer_4,Jorge,50,ES82209578084093320757,TRX_N-00141-14454498,2022-05-08T22:59:56,Galdakao,expenses,internet,-42.0,-4898.54
buyer_4,Jorge,50,ES82209578084093320757,TRX_N-00142-22207295,2022-05-08T14:00:46,Galdakao,expenses,phone,-34.83,-4933.37
buyer_4,Jorge,50,ES82209578084093320757,TRX_N-00143-81563821,2022-05-09T14:39:28,Galdakao,expenses,food,-77.67,-5011.04
buyer_4,Jorge,50,ES82209578084093320757,TRX_N-00144-50255056,2022-05-09T16:02:30,Galdakao,expenses,gifts,-202.67,-5213.71
buyer_4,Jorge,50,ES82209578084093320757,TRX_N-00145-55094586,2022-05-11T00:10:24,Basauri,expenses,gifts,-48.97,-5262.68
buyer_4,Jorge,50,ES82209578084093320757,TRX_N-00146-13909526,2022-05-15T12:22:47,Galdakao,expenses,gifts,-449.68,-5712.36
buyer_4,Jorge,50,ES82209578084093320757,TRX_N-00147-84447936,2022-05-17T22:31:04,Galdakao,expenses,education,-49.99,-5762.35
buyer_4,Jorge,50,ES82209578084093320757,TRX_N-00148-38771201,2022-05-17T08:32:37,Galdakao,expenses,gifts,-151.11,-5913.46
buyer_4,Jorge,50,ES82209578084093320757,TRX_N-00149-99038285,2022-05-20T14:33:38,Galdakao,expenses,cash,-100.0,-6013.46
buyer_4,Jorge,50,ES82209578084093320757,TRX_N-00150-78119642,2022-05-21T12:20:51,Hondarribia,expenses,transport,-40.35,-6053.81
buyer_4,Jorge,50,ES82209578084093320757,TRX_N-00151-39241918,2022-05-22T05:42:25,Galdakao,expenses,cash,-100.0,-6153.81
buyer_4,Jorge,50,ES82209578084093320757,TRX_N-00152-21705634,2022-05-23T08:15:51,Lasarte-Oria,expenses,cash,-100.0,-6253.81
buyer_4,Jorge,50,ES82209578084093320757,TRX_N-00153-99521299,2022-05-24T14:12:10,Galdakao,expenses,food,-84.73,-6338.54
buyer_4,Jorge,50,ES82209578084093320757,TRX_N-00154-27863542,2022-05-26T13:41:00,Galdakao,expenses,cash,-100.0,-6438.54
buyer_4,Jorge,50,ES82209578084093320757,TRX_N-00155-45246920,2022-05-27T15:39:18,Galdakao,expenses,repairs,-48.03,-6486.57
buyer_4,Jorge,50,ES82209578084093320757,TRX_N-00156-75899691,2022-05-27T19:45:20,Galdakao,expenses,gifts,-448.59,-6935.16
buyer_4,Jorge,50,ES82209578084093320757,TRX_N-00157-86366879,2022-05-29T09:27:52,Iruña de Oca,expenses,cash,-100.0,-7035.16
buyer_4,Jorge,50,ES82209578084093320757,TRX_N-00158-38047271,2022-05-30T17:05:44,Galdakao,expenses,cash,-100.0,-7135.16
buyer_4,Jorge,50,ES82209578084093320757,TRX_N-00159-72342546,2022-05-31T17:27:00,Bermeo,expenses,repairs,-246.62,-7381.78
buyer_4,Jorge,50,ES82209578084093320757,TRX_N-00160-29888881,2022-06-01T23:55:49,Galdakao,incomes,salary,1370.36,-6011.42
buyer_4,Jorge,50,ES82209578084093320757,TRX_N-00161-65122040,2022-06-01T23:55:49,Galdakao,incomes,salary_partner,1413.6,-4597.82
buyer_4,Jorge,50,ES82209578084093320757,TRX_N-00162-81997928,2022-06-01T23:55:49,Galdakao,incomes,salary_bonus,1082.7,-3515.12
buyer_4,Jorge,50,ES82209578084093320757,TRX_N-00163-59105224,2022-06-01T23:55:49,Galdakao,incomes,salary_partner_bonus,1033.1,-2482.02
buyer_4,Jorge,50,ES82209578084093320757,TRX_N-00164-19001190,2022-06-03T16:03:07,Getxo,expenses,education,-54.71,-2536.73
buyer_4,Jorge,50,ES82209578084093320757,TRX_N-00165-30750151,2022-06-04T16:55:12,Galdakao,expenses,mortgage,-979.09,-3515.82
buyer_4,Jorge,50,ES82209578084093320757,TRX_N-00166-10004507,2022-06-04T19:28:23,Galdakao,expenses,food,-77.25,-3593.07
buyer_4,Jorge,50,ES82209578084093320757,TRX_N-00167-61621860,2022-06-04T08:19:11,Galdakao,expenses,cash,-100.0,-3693.07
buyer_4,Jorge,50,ES82209578084093320757,TRX_N-00168-36902399,2022-06-05T14:24:47,Galdakao,expenses,water,-22.33,-3715.4
buyer_4,Jorge,50,ES82209578084093320757,TRX_N-00169-14351514,2022-06-06T04:39:11,Galdakao,expenses,electricity,-42.79,-3758.19
buyer_4,Jorge,50,ES82209578084093320757,TRX_N-00170-41828969,2022-06-06T20:34:10,Galdakao,expenses,gas,-35.75,-3793.94
buyer_4,Jorge,50,ES82209578084093320757,TRX_N-00171-75867179,2022-06-06T13:28:26,Galdakao,expenses,internet,-42.0,-3835.94
buyer_4,Jorge,50,ES82209578084093320757,TRX_N-00172-96147945,2022-06-06T20:28:25,Galdakao,expenses,phone,-38.51,-3874.45
buyer_4,Jorge,50,ES82209578084093320757,TRX_N-00173-07557685,2022-06-06T05:43:23,Alegría-Dulantzi,expenses,gifts,-567.61,-4442.06
buyer_4,Jorge,50,ES82209578084093320757,TRX_N-00174-63757433,2022-06-07T19:32:22,Galdakao,expenses,gifts,-87.78,-4529.84
buyer_4,Jorge,50,ES82209578084093320757,TRX_N-00175-16739658,2022-06-08T09:16:10,Galdakao,expenses,leisure,-76.91,-4606.75
buyer_4,Jorge,50,ES82209578084093320757,TRX_N-00176-92711266,2022-06-09T14:34:19,Galdakao,expenses,leisure,-69.34,-4676.09
buyer_4,Jorge,50,ES82209578084093320757,TRX_N-00177-98113230,2022-06-09T17:01:41,Galdakao,expenses,repairs,-35.35,-4711.44
buyer_4,Jorge,50,ES82209578084093320757,TRX_N-00178-96097884,2022-06-12T20:40:53,Galdakao,expenses,food,-105.94,-4817.38
buyer_4,Jorge,50,ES82209578084093320757,TRX_N-00179-77937073,2022-06-13T18:39:06,Galdakao,expenses,healthcare,-101.13,-4918.51
buyer_4,Jorge,50,ES82209578084093320757,TRX_N-00180-60057240,2022-06-13T13:52:50,Galdakao,expenses,repairs,-63.98,-4982.49
buyer_4,Jorge,50,ES82209578084093320757,TRX_N-00181-04641479,2022-06-16T14:16:24,Basauri,expenses,healthcare,-134.26,-5116.75
buyer_4,Jorge,50,ES82209578084093320757,TRX_N-00182-56077238,2022-06-16T10:43:27,Galdakao,expenses,cash,-100.0,-5216.75
buyer_4,Jorge,50,ES82209578084093320757,TRX_N-00183-67623095,2022-06-17T16:20:30,Elciego,expenses,clothing,-121.47,-5338.22
buyer_4,Jorge,50,ES82209578084093320757,TRX_N-00184-96143318,2022-06-17T15:07:49,Galdakao,expenses,repairs,-97.15,-5435.37
buyer_4,Jorge,50,ES82209578084093320757,TRX_N-00185-36713675,2022-06-19T05:29:45,Vitoria-Gasteiz,expenses,gifts,-721.06,-6156.43
buyer_4,Jorge,50,ES82209578084093320757,TRX_N-00186-44548660,2022-06-22T19:49:49,Galdakao,expenses,food,-118.97,-6275.4
buyer_4,Jorge,50,ES82209578084093320757,TRX_N-00187-88281929,2022-06-23T14:11:09,Galdakao,expenses,children,-72.95,-6348.35
buyer_4,Jorge,50,ES82209578084093320757,TRX_N-00188-26020549,2022-06-24T10:03:31,Galdakao,expenses,leisure,-66.75,-6415.1
buyer_4,Jorge,50,ES82209578084093320757,TRX_N-00189-94043176,2022-06-25T15:29:36,Galdakao,expenses,clothing,-146.0,-6561.1
buyer_4,Jorge,50,ES82209578084093320757,TRX_N-00190-94300642,2022-06-29T09:35:46,Galdakao,expenses,food,-61.06,-6622.16
buyer_4,Jorge,50,ES82209578084093320757,TRX_N-00191-73938456,2022-06-29T04:29:47,Galdakao,expenses,education,-48.36,-6670.52
buyer_4,Jorge,50,ES82209578084093320757,TRX_N-00192-41184266,2022-07-01T17:22:45,Galdakao,incomes,salary,1370.36,-5300.16
buyer_4,Jorge,50,ES82209578084093320757,TRX_N-00193-13441638,2022-07-01T17:22:45,Galdakao,incomes,salary_partner,1413.6,-3886.56
buyer_4,Jorge,50,ES82209578084093320757,TRX_N-00194-10467517,2022-07-01T17:22:45,Galdakao,incomes,extra_income,218.64,-3667.92
buyer_4,Jorge,50,ES82209578084093320757,TRX_N-00195-54083833,2022-07-01T17:23:22,Galdakao,expenses,food,-88.29,-3756.21
buyer_4,Jorge,50,ES82209578084093320757,TRX_N-00196-78497839,2022-07-01T17:20:26,Galdakao,expenses,clothing,-45.89,-3802.1
buyer_4,Jorge,50,ES82209578084093320757,TRX_N-00197-97801854,2022-07-01T23:30:19,Galdakao,expenses,cash,-100.0,-3902.1
buyer_4,Jorge,50,ES82209578084093320757,TRX_N-00198-31571878,2022-07-02T02:15:57,Galdakao,expenses,cash,-100.0,-4002.1
buyer_4,Jorge,50,ES82209578084093320757,TRX_N-00199-45943343,2022-07-04T11:17:59,Galdakao,expenses,mortgage,-979.09,-4981.19
buyer_4,Jorge,50,ES82209578084093320757,TRX_N-00200-29960950,2022-07-05T17:50:27,Galdakao,expenses,phone,-30.9,-5012.09
buyer_4,Jorge,50,ES82209578084093320757,TRX_N-00201-47535302,2022-07-05T18:27:03,Galdakao,expenses,food,-66.22,-5078.31
buyer_4,Jorge,50,ES82209578084093320757,TRX_N-00202-09224085,2022-07-05T11:40:00,Galdakao,expenses,education,-62.61,-5140.92
buyer_4,Jorge,50,ES82209578084093320757,TRX_N-00203-71408279,2022-07-06T09:39:48,Galdakao,expenses,electricity,-49.32,-5190.24
buyer_4,Jorge,50,ES82209578084093320757,TRX_N-00204-30752952,2022-07-06T18:24:19,Galdakao,expenses,internet,-42.0,-5232.24
buyer_4,Jorge,50,ES82209578084093320757,TRX_N-00205-09178412,2022-07-06T16:29:15,Galdakao,expenses,education,-62.27,-5294.51
buyer_4,Jorge,50,ES82209578084093320757,TRX_N-00206-59613081,2022-07-06T18:28:09,Galdakao,expenses,gifts,-165.46,-5459.97
buyer_4,Jorge,50,ES82209578084093320757,TRX_N-00207-77233803,2022-07-07T02:51:53,Galdakao,expenses,transport,-48.58,-5508.55
buyer_4,Jorge,50,ES82209578084093320757,TRX_N-00208-78486244,2022-07-07T12:46:21,Galdakao,expenses,repairs,-322.84,-5831.39
buyer_4,Jorge,50,ES82209578084093320757,TRX_N-00209-04109562,2022-07-08T12:03:08,Galdakao,expenses,water,-29.36,-5860.75
buyer_4,Jorge,50,ES82209578084093320757,TRX_N-00210-05260982,2022-07-08T13:06:40,Galdakao,expenses,gas,-77.13,-5937.88
buyer_4,Jorge,50,ES82209578084093320757,TRX_N-00211-64952609,2022-07-09T14:51:09,Galdakao,expenses,food,-73.28,-6011.16
buyer_4,Jorge,50,ES82209578084093320757,TRX_N-00212-42024775,2022-07-10T10:50:03,Galdakao,expenses,transport,-74.6,-6085.76
buyer_4,Jorge,50,ES82209578084093320757,TRX_N-00213-15195637,2022-07-13T16:33:32,Galdakao,expenses,leisure,-19.97,-6105.73
buyer_4,Jorge,50,ES82209578084093320757,TRX_N-00214-93193847,2022-07-15T09:21:16,Galdakao,expenses,transport,-54.48,-6160.21
buyer_4,Jorge,50,ES82209578084093320757,TRX_N-00215-84580703,2022-07-15T23:39:18,Galdakao,expenses,cash,-100.0,-6260.21
buyer_4,Jorge,50,ES82209578084093320757,TRX_N-00216-72695734,2022-07-16T15:12:51,Galdakao,expenses,transport,-73.62,-6333.83
buyer_4,Jorge,50,ES82209578084093320757,TRX_N-00217-61964695,2022-07-18T09:06:07,Lasarte-Oria,expenses,food,-104.9,-6438.73
buyer_4,Jorge,50,ES82209578084093320757,TRX_N-00218-61902514,2022-07-18T17:32:46,Galdakao,expenses,children,-194.51,-6633.24
buyer_4,Jorge,50,ES82209578084093320757,TRX_N-00219-28096416,2022-07-19T13:10:52,Galdakao,expenses,food,-82.48,-6715.72
buyer_4,Jorge,50,ES82209578084093320757,TRX_N-00220-98741888,2022-07-19T10:02:38,Galdakao,expenses,transport,-46.08,-6761.8
buyer_4,Jorge,50,ES82209578084093320757,TRX_N-00221-70969125,2022-07-20T21:02:27,Galdakao,expenses,food,-69.66,-6831.46
buyer_4,Jorge,50,ES82209578084093320757,TRX_N-00222-60915959,2022-07-21T13:30:15,Iruña de Oca,expenses,gifts,-395.73,-7227.19
buyer_4,Jorge,50,ES82209578084093320757,TRX_N-00223-00289063,2022-07-25T15:11:06,Galdakao,expenses,food,-77.92,-7305.11
buyer_4,Jorge,50,ES82209578084093320757,TRX_N-00224-87586306,2022-07-25T08:27:41,Pasaia,expenses,transport,-69.97,-7375.08
buyer_4,Jorge,50,ES82209578084093320757,TRX_N-00225-10046362,2022-07-25T17:19:58,Galdakao,expenses,education,-78.18,-7453.26
buyer_4,Jorge,50,ES82209578084093320757,TRX_N-00226-14440288,2022-07-27T09:41:11,Vitoria-Gasteiz,expenses,gifts,-283.35,-7736.61
buyer_4,Jorge,50,ES82209578084093320757,TRX_N-00227-87087037,2022-07-29T16:22:01,Galdakao,expenses,transport,-86.61,-7823.22
buyer_4,Jorge,50,ES82209578084093320757,TRX_N-00228-24141613,2022-07-30T10:24:28,Galdakao,expenses,leisure,-21.12,-7844.34
buyer_4,Jorge,50,ES82209578084093320757,TRX_N-00229-31339257,2022-07-30T23:45:00,Galdakao,expenses,children,-69.02,-7913.36
buyer_4,Jorge,50,ES82209578084093320757,TRX_N-00230-05651560,2022-07-31T08:46:46,Galdakao,expenses,transport,-43.73,-7957.09
buyer_4,Jorge,50,ES82209578084093320757,TRX_N-00231-36933594,2022-08-01T13:22:02,Galdakao,incomes,salary,1370.36,-6586.73
buyer_4,Jorge,50,ES82209578084093320757,TRX_N-00232-37271795,2022-08-01T13:22:02,Galdakao,incomes,salary_partner,1413.6,-5173.13
buyer_4,Jorge,50,ES82209578084093320757,TRX_N-00233-45162217,2022-08-02T13:47:38,Galdakao,expenses,food,-75.54,-5248.67
buyer_4,Jorge,50,ES82209578084093320757,TRX_N-00234-36476187,2022-08-03T22:46:45,Galdakao,expenses,leisure,-59.6,-5308.27
buyer_4,Jorge,50,ES82209578084093320757,TRX_N-00235-23852640,2022-08-04T14:35:00,Galdakao,expenses,mortgage,-979.09,-6287.36
buyer_4,Jorge,50,ES82209578084093320757,TRX_N-00236-48447792,2022-08-04T11:15:48,Galdakao,expenses,leisure,-43.81,-6331.17
buyer_4,Jorge,50,ES82209578084093320757,TRX_N-00237-43997267,2022-08-04T09:33:11,Galdakao,expenses,education,-52.56,-6383.73
buyer_4,Jorge,50,ES82209578084093320757,TRX_N-00238-75001158,2022-08-05T09:21:58,Galdakao,expenses,phone,-38.83,-6422.56
buyer_4,Jorge,50,ES82209578084093320757,TRX_N-00239-74313854,2022-08-06T17:46:37,Galdakao,expenses,electricity,-40.29,-6462.85
buyer_4,Jorge,50,ES82209578084093320757,TRX_N-00240-56424677,2022-08-06T19:16:17,Galdakao,expenses,transport,-40.99,-6503.84
buyer_4,Jorge,50,ES82209578084093320757,TRX_N-00241-24630215,2022-08-07T14:40:50,Galdakao,expenses,cash,-100.0,-6603.84
buyer_4,Jorge,50,ES82209578084093320757,TRX_N-00242-07218103,2022-08-08T20:29:17,Galdakao,expenses,water,-28.25,-6632.09
buyer_4,Jorge,50,ES82209578084093320757,TRX_N-00243-98325573,2022-08-08T14:35:58,Galdakao,expenses,gas,-97.58,-6729.67
buyer_4,Jorge,50,ES82209578084093320757,TRX_N-00244-78277924,2022-08-08T13:46:19,Galdakao,expenses,internet,-42.0,-6771.67
buyer_4,Jorge,50,ES82209578084093320757,TRX_N-00245-61384355,2022-08-08T10:27:36,Zuia,expenses,education,-42.93,-6814.6
buyer_4,Jorge,50,ES82209578084093320757,TRX_N-00246-81377664,2022-08-08T10:09:08,Galdakao,expenses,gifts,-161.05,-6975.65
buyer_4,Jorge,50,ES82209578084093320757,TRX_N-00247-90631970,2022-08-09T08:15:46,Berango,expenses,transport,-85.05,-7060.7
buyer_4,Jorge,50,ES82209578084093320757,TRX_N-00248-97509915,2022-08-09T23:51:12,Galdakao,expenses,gifts,-713.24,-7773.94
buyer_4,Jorge,50,ES82209578084093320757,TRX_N-00249-19097676,2022-08-11T15:30:13,Galdakao,expenses,transport,-60.83,-7834.77
buyer_4,Jorge,50,ES82209578084093320757,TRX_N-00250-92536327,2022-08-12T13:14:44,Galdakao,expenses,food,-71.47,-7906.24
buyer_4,Jorge,50,ES82209578084093320757,TRX_N-00251-51996394,2022-08-12T09:23:14,Galdakao,expenses,transport,-48.71,-7954.95
buyer_4,Jorge,50,ES82209578084093320757,TRX_N-00252-39791094,2022-08-13T15:32:31,Galdakao,expenses,appliances,-140.84,-8095.79
buyer_4,Jorge,50,ES82209578084093320757,TRX_N-00253-81543654,2022-08-14T07:40:31,Galdakao,expenses,cash,-100.0,-8195.79
buyer_4,Jorge,50,ES82209578084093320757,TRX_N-00254-18098357,2022-08-16T20:25:37,Galdakao,expenses,food,-97.59,-8293.38
buyer_4,Jorge,50,ES82209578084093320757,TRX_N-00255-94223819,2022-08-16T19:13:16,Galdakao,expenses,cash,-100.0,-8393.38
buyer_4,Jorge,50,ES82209578084093320757,TRX_N-00256-81916715,2022-08-17T19:13:40,Berango,expenses,gifts,-715.28,-9108.66
buyer_4,Jorge,50,ES82209578084093320757,TRX_N-00257-86297009,2022-08-18T15:28:44,Galdakao,expenses,cash,-100.0,-9208.66
buyer_4,Jorge,50,ES82209578084093320757,TRX_N-00258-47509688,2022-08-19T20:52:43,Portugalete,expenses,cash,-100.0,-9308.66
buyer_4,Jorge,50,ES82209578084093320757,TRX_N-00259-77622168,2022-08-20T13:28:35,Galdakao,expenses,cash,-100.0,-9408.66
buyer_4,Jorge,50,ES82209578084093320757,TRX_N-00260-33538096,2022-08-20T15:33:35,Galdakao,expenses,repairs,-61.07,-9469.73
buyer_4,Jorge,50,ES82209578084093320757,TRX_N-00261-21055200,2022-08-20T17:02:07,Galdakao,expenses,children,-117.7,-9587.43
buyer_4,Jorge,50,ES82209578084093320757,TRX_N-00262-87868847,2022-08-21T00:45:07,Galdakao,expenses,leisure,-27.57,-9615.0
buyer_4,Jorge,50,ES82209578084093320757,TRX_N-00263-42974929,2022-08-22T06:06:56,Galdakao,expenses,transport,-57.17,-9672.17
buyer_4,Jorge,50,ES82209578084093320757,TRX_N-00264-45032145,2022-08-22T11:57:53,Galdakao,expenses,repairs,-52.15,-9724.32
buyer_4,Jorge,50,ES82209578084093320757,TRX_N-00265-31904977,2022-08-23T19:47:45,Galdakao,expenses,transport,-87.75,-9812.07
buyer_4,Jorge,50,ES82209578084093320757,TRX_N-00266-85080529,2022-08-23T20:00:13,Galdakao,expenses,repairs,-282.05,-10094.12
buyer_4,Jorge,50,ES82209578084093320757,TRX_N-00267-94646827,2022-08-24T19:16:57,Galdakao,expenses,gifts,-343.04,-10437.16
buyer_4,Jorge,50,ES82209578084093320757,TRX_N-00268-83314014,2022-08-25T12:40:52,Galdakao,expenses,transport,-42.43,-10479.59
buyer_4,Jorge,50,ES82209578084093320757,TRX_N-00269-92181147,2022-08-25T19:19:04,Galdakao,expenses,cash,-100.0,-10579.59
buyer_4,Jorge,50,ES82209578084093320757,TRX_N-00270-13338102,2022-08-27T19:05:58,Galdakao,expenses,children,-222.42,-10802.01
buyer_4,Jorge,50,ES82209578084093320757,TRX_N-00271-85016225,2022-08-28T09:05:10,Galdakao,expenses,food,-110.28,-10912.29
buyer_4,Jorge,50,ES82209578084093320757,TRX_N-00272-56147023,2022-08-28T23:10:20,Eibar,expenses,transport,-87.93,-11000.22
buyer_4,Jorge,50,ES82209578084093320757,TRX_N-00273-74963346,2022-08-29T17:49:09,Galdakao,expenses,gifts,-797.56,-11797.78
buyer_4,Jorge,50,ES82209578084093320757,TRX_N-00274-87830798,2022-09-01T12:20:49,Galdakao,incomes,salary,1370.36,-10427.42
buyer_4,Jorge,50,ES82209578084093320757,TRX_N-00275-74995448,2022-09-01T12:20:49,Galdakao,incomes,salary_partner,1413.6,-9013.82
buyer_4,Jorge,50,ES82209578084093320757,TRX_N-00276-53854414,2022-09-01T16:19:57,Galdakao,expenses,leisure,-31.41,-9045.23
buyer_4,Jorge,50,ES82209578084093320757,TRX_N-00277-10573682,2022-09-01T19:28:05,Galdakao,expenses,cash,-100.0,-9145.23
buyer_4,Jorge,50,ES82209578084093320757,TRX_N-00278-45200051,2022-09-04T09:12:36,Galdakao,expenses,mortgage,-979.09,-10124.32
buyer_4,Jorge,50,ES82209578084093320757,TRX_N-00279-87830264,2022-09-04T13:52:44,Galdakao,expenses,cash,-100.0,-10224.32
buyer_4,Jorge,50,ES82209578084093320757,TRX_N-00280-91448049,2022-09-04T13:49:05,Galdakao,expenses,repairs,-122.4,-10346.72
buyer_4,Jorge,50,ES82209578084093320757,TRX_N-00281-62057435,2022-09-05T09:15:56,Galdakao,expenses,transport,-51.64,-10398.36
buyer_4,Jorge,50,ES82209578084093320757,TRX_N-00282-74463125,2022-09-06T09:24:24,Galdakao,expenses,internet,-42.0,-10440.36
buyer_4,Jorge,50,ES82209578084093320757,TRX_N-00283-07586060,2022-09-07T16:07:31,Galdakao,expenses,phone,-33.87,-10474.23
buyer_4,Jorge,50,ES82209578084093320757,TRX_N-00284-61142645,2022-09-07T21:59:37,Galdakao,expenses,education,-49.62,-10523.85
buyer_4,Jorge,50,ES82209578084093320757,TRX_N-00285-66254134,2022-09-08T11:30:11,Galdakao,expenses,water,-39.23,-10563.08
buyer_4,Jorge,50,ES82209578084093320757,TRX_N-00286-49946548,2022-09-08T13:40:01,Galdakao,expenses,electricity,-34.49,-10597.57
buyer_4,Jorge,50,ES82209578084093320757,TRX_N-00287-25132791,2022-09-08T19:37:37,Galdakao,expenses,gas,-105.09,-10702.66
buyer_4,Jorge,50,ES82209578084093320757,TRX_N-00288-89897560,2022-09-08T20:15:34,Galdakao,expenses,education,-65.46,-10768.12
buyer_4,Jorge,50,ES82209578084093320757,TRX_N-00289-01138504,2022-09-13T23:44:55,Galdakao,expenses,food,-69.21,-10837.33
buyer_4,Jorge,50,ES82209578084093320757,TRX_N-00290-61287074,2022-09-14T13:57:02,Galdakao,expenses,travel,-1086.62,-11923.95
buyer_4,Jorge,50,ES82209578084093320757,TRX_N-00291-50851730,2022-09-15T13:31:38,Oyón-Oion,expenses,leisure,-28.27,-11952.22
buyer_4,Jorge,50,ES82209578084093320757,TRX_N-00292-23576754,2022-09-16T17:46:54,Galdakao,expenses,transport,-86.65,-12038.87
buyer_4,Jorge,50,ES82209578084093320757,TRX_N-00293-73577004,2022-09-16T17:27:55,Sestao,expenses,leisure,-38.31,-12077.18
buyer_4,Jorge,50,ES82209578084093320757,TRX_N-00294-28393828,2022-09-18T04:18:34,Galdakao,expenses,cash,-100.0,-12177.18
buyer_4,Jorge,50,ES82209578084093320757,TRX_N-00295-70151926,2022-09-18T10:38:26,Galdakao,expenses,repairs,-197.35,-12374.53
buyer_4,Jorge,50,ES82209578084093320757,TRX_N-00296-33042201,2022-09-20T18:17:34,Galdakao,expenses,transport,-89.39,-12463.92
buyer_4,Jorge,50,ES82209578084093320757,TRX_N-00297-56320811,2022-09-20T16:24:35,Arrasate,expenses,cash,-100.0,-12563.92
buyer_4,Jorge,50,ES82209578084093320757,TRX_N-00298-23338697,2022-09-20T15:18:23,Galdakao,expenses,repairs,-32.86,-12596.78
buyer_4,Jorge,50,ES82209578084093320757,TRX_N-00299-30005211,2022-09-21T08:51:57,Galdakao,expenses,leisure,-37.02,-12633.8
buyer_4,Jorge,50,ES82209578084093320757,TRX_N-00300-07071676,2022-09-21T14:29:09,Leioa,expenses,cash,-100.0,-12733.8
buyer_4,Jorge,50,ES82209578084093320757,TRX_N-00301-99132928,2022-09-23T09:05:42,Galdakao,expenses,food,-61.95,-12795.75
buyer_4,Jorge,50,ES82209578084093320757,TRX_N-00302-40260651,2022-09-24T01:55:14,Galdakao,expenses,food,-79.38,-12875.13
buyer_4,Jorge,50,ES82209578084093320757,TRX_N-00303-92856823,2022-09-24T13:28:27,Galdakao,expenses,cash,-100.0,-12975.13
buyer_4,Jorge,50,ES82209578084093320757,TRX_N-00304-38357343,2022-09-25T08:45:08,Galdakao,expenses,clothing,-80.58,-13055.71
buyer_4,Jorge,50,ES82209578084093320757,TRX_N-00305-54769302,2022-09-26T07:54:19,Getxo,expenses,cash,-100.0,-13155.71
buyer_4,Jorge,50,ES82209578084093320757,TRX_N-00306-03588060,2022-09-27T12:01:08,Arrasate,expenses,cash,-100.0,-13255.71
buyer_4,Jorge,50,ES82209578084093320757,TRX_N-00307-99855553,2022-09-29T19:24:16,Galdakao,expenses,education,-73.42,-13329.13
buyer_4,Jorge,50,ES82209578084093320757,TRX_N-00308-71607940,2022-09-29T16:33:15,Galdakao,expenses,appliances,-338.34,-13667.47
buyer_4,Jorge,50,ES82209578084093320757,TRX_N-00309-96844492,2022-10-01T13:03:43,Galdakao,incomes,salary,1370.36,-12297.11
buyer_4,Jorge,50,ES82209578084093320757,TRX_N-00310-07199193,2022-10-01T13:03:43,Galdakao,incomes,salary_partner,1413.6,-10883.51
buyer_4,Jorge,50,ES82209578084093320757,TRX_N-00311-78129743,2022-10-01T11:10:35,Galdakao,expenses,transport,-64.41,-10947.92
buyer_4,Jorge,50,ES82209578084093320757,TRX_N-00312-37221887,2022-10-03T08:37:02,Galdakao,expenses,healthcare,-133.87,-11081.79
buyer_4,Jorge,50,ES82209578084093320757,TRX_N-00313-21209023,2022-10-04T10:17:17,Galdakao,expenses,mortgage,-979.09,-12060.88
buyer_4,Jorge,50,ES82209578084093320757,TRX_N-00314-25172240,2022-10-05T20:14:53,Galdakao,expenses,phone,-38.18,-12099.06
buyer_4,Jorge,50,ES82209578084093320757,TRX_N-00315-35933783,2022-10-05T19:44:59,Galdakao,expenses,leisure,-48.19,-12147.25
buyer_4,Jorge,50,ES82209578084093320757,TRX_N-00316-71215079,2022-10-06T14:50:23,Galdakao,expenses,water,-29.92,-12177.17
buyer_4,Jorge,50,ES82209578084093320757,TRX_N-00317-40180731,2022-10-06T10:22:14,Galdakao,expenses,internet,-42.0,-12219.17
buyer_4,Jorge,50,ES82209578084093320757,TRX_N-00318-71803238,2022-10-06T11:19:38,Galdakao,expenses,food,-83.78,-12302.95
buyer_4,Jorge,50,ES82209578084093320757,TRX_N-00319-58676239,2022-10-06T08:29:33,Galdakao,expenses,cash,-100.0,-12402.95
buyer_4,Jorge,50,ES82209578084093320757,TRX_N-00320-66014714,2022-10-06T02:28:37,Sopela,expenses,repairs,-154.46,-12557.41
buyer_4,Jorge,50,ES82209578084093320757,TRX_N-00321-94476059,2022-10-07T13:45:47,Galdakao,expenses,electricity,-54.62,-12612.03
buyer_4,Jorge,50,ES82209578084093320757,TRX_N-00322-39406124,2022-10-07T14:42:11,Galdakao,expenses,gas,-97.09,-12709.12
buyer_4,Jorge,50,ES82209578084093320757,TRX_N-00323-32611260,2022-10-08T17:35:19,Galdakao,expenses,clothing,-84.9,-12794.02
buyer_4,Jorge,50,ES82209578084093320757,TRX_N-00324-06154884,2022-10-11T18:43:45,Errenteria,expenses,transport,-60.92,-12854.94
buyer_4,Jorge,50,ES82209578084093320757,TRX_N-00325-39454904,2022-10-12T18:34:04,Galdakao,expenses,leisure,-26.79,-12881.73
buyer_4,Jorge,50,ES82209578084093320757,TRX_N-00326-46449225,2022-10-13T17:30:07,Galdakao,expenses,cash,-100.0,-12981.73
buyer_4,Jorge,50,ES82209578084093320757,TRX_N-00327-21075988,2022-10-13T21:42:32,Galdakao,expenses,repairs,-316.45,-13298.18
buyer_4,Jorge,50,ES82209578084093320757,TRX_N-00328-99304540,2022-10-14T14:44:47,Galdakao,expenses,leisure,-62.56,-13360.74
buyer_4,Jorge,50,ES82209578084093320757,TRX_N-00329-43829678,2022-10-14T15:09:58,Galdakao,expenses,repairs,-249.22,-13609.96
buyer_4,Jorge,50,ES82209578084093320757,TRX_N-00330-40849079,2022-10-17T07:25:48,Galdakao,expenses,transport,-48.26,-13658.22
buyer_4,Jorge,50,ES82209578084093320757,TRX_N-00331-26178778,2022-10-17T15:11:36,Galdakao,expenses,education,-48.3,-13706.52
buyer_4,Jorge,50,ES82209578084093320757,TRX_N-00332-54837152,2022-10-18T16:32:42,Sestao,expenses,healthcare,-150.48,-13857.0
buyer_4,Jorge,50,ES82209578084093320757,TRX_N-00333-71494749,2022-10-19T12:07:53,Galdakao,expenses,food,-69.36,-13926.36
buyer_4,Jorge,50,ES82209578084093320757,TRX_N-00334-62501998,2022-10-19T15:47:07,Salvatierra/Agurain,expenses,cash,-100.0,-14026.36
buyer_4,Jorge,50,ES82209578084093320757,TRX_N-00335-56537342,2022-10-21T18:52:12,Galdakao,expenses,food,-82.91,-14109.27
buyer_4,Jorge,50,ES82209578084093320757,TRX_N-00336-95093459,2022-10-23T20:12:23,Hondarribia,expenses,cash,-100.0,-14209.27
buyer_4,Jorge,50,ES82209578084093320757,TRX_N-00337-66212995,2022-10-26T13:12:58,Galdakao,expenses,leisure,-40.93,-14250.2
buyer_4,Jorge,50,ES82209578084093320757,TRX_N-00338-79989907,2022-10-27T12:07:25,Galdakao,expenses,food,-114.76,-14364.96
buyer_4,Jorge,50,ES82209578084093320757,TRX_N-00339-31173173,2022-11-01T15:10:18,Galdakao,incomes,salary,1370.36,-12994.6
buyer_4,Jorge,50,ES82209578084093320757,TRX_N-00340-55617954,2022-11-01T15:10:18,Galdakao,incomes,salary_partner,1413.6,-11581.0
buyer_4,Jorge,50,ES82209578084093320757,TRX_N-00341-02611671,2022-11-01T15:10:18,Galdakao,incomes,extra_income,218.64,-11362.36
buyer_4,Jorge,50,ES82209578084093320757,TRX_N-00342-07393574,2022-11-01T13:31:02,Galdakao,expenses,transport,-40.36,-11402.72
buyer_4,Jorge,50,ES82209578084093320757,TRX_N-00343-24394318,2022-11-01T16:10:47,Durango,expenses,leisure,-81.62,-11484.34
buyer_4,Jorge,50,ES82209578084093320757,TRX_N-00344-15027705,2022-11-03T13:49:53,Iruña de Oca,expenses,transport,-46.65,-11530.99
buyer_4,Jorge,50,ES82209578084093320757,TRX_N-00345-44280361,2022-11-03T13:44:15,Galdakao,expenses,cash,-100.0,-11630.99
buyer_4,Jorge,50,ES82209578084093320757,TRX_N-00346-26165687,2022-11-03T19:51:50,Galdakao,expenses,gifts,-373.44,-12004.43
buyer_4,Jorge,50,ES82209578084093320757,TRX_N-00347-73964778,2022-11-04T11:21:22,Galdakao,expenses,mortgage,-979.09,-12983.52
buyer_4,Jorge,50,ES82209578084093320757,TRX_N-00348-55819195,2022-11-04T19:55:05,Galdakao,expenses,cash,-100.0,-13083.52
buyer_4,Jorge,50,ES82209578084093320757,TRX_N-00349-39290544,2022-11-05T11:03:53,Galdakao,expenses,gas,-99.49,-13183.01
buyer_4,Jorge,50,ES82209578084093320757,TRX_N-00350-27406474,2022-11-05T11:43:12,Galdakao,expenses,internet,-42.0,-13225.01
buyer_4,Jorge,50,ES82209578084093320757,TRX_N-00351-13305669,2022-11-05T20:41:00,Galdakao,expenses,phone,-43.87,-13268.88
buyer_4,Jorge,50,ES82209578084093320757,TRX_N-00352-59194006,2022-11-05T08:50:21,Galdakao,expenses,clothing,-127.72,-13396.6
buyer_4,Jorge,50,ES82209578084093320757,TRX_N-00353-81402778,2022-11-06T08:26:02,Galdakao,expenses,water,-43.78,-13440.38
buyer_4,Jorge,50,ES82209578084093320757,TRX_N-00354-84649616,2022-11-06T20:54:51,Galdakao,expenses,food,-91.44,-13531.82
buyer_4,Jorge,50,ES82209578084093320757,TRX_N-00355-31735993,2022-11-07T03:36:51,Galdakao,expenses,electricity,-24.11,-13555.93
buyer_4,Jorge,50,ES82209578084093320757,TRX_N-00356-01839302,2022-11-07T12:55:01,Galdakao,expenses,children,-88.53,-13644.46
buyer_4,Jorge,50,ES82209578084093320757,TRX_N-00357-41354393,2022-11-09T05:39:38,Galdakao,expenses,repairs,-316.41,-13960.87
buyer_4,Jorge,50,ES82209578084093320757,TRX_N-00358-87416507,2022-11-10T07:34:28,Galdakao,expenses,repairs,-69.23,-14030.1
buyer_4,Jorge,50,ES82209578084093320757,TRX_N-00359-43328068,2022-11-12T18:48:21,Galdakao,expenses,clothing,-71.1,-14101.2
buyer_4,Jorge,50,ES82209578084093320757,TRX_N-00360-73737638,2022-11-14T23:19:04,Galdakao,expenses,clothing,-153.16,-14254.36
buyer_4,Jorge,50,ES82209578084093320757,TRX_N-00361-88434122,2022-11-16T19:25:13,Galdakao,expenses,leisure,-82.92,-14337.28
buyer_4,Jorge,50,ES82209578084093320757,TRX_N-00362-97037849,2022-11-17T12:27:34,Galdakao,expenses,leisure,-28.0,-14365.28
buyer_4,Jorge,50,ES82209578084093320757,TRX_N-00363-63046627,2022-11-19T08:55:08,Galdakao,expenses,food,-98.26,-14463.54
buyer_4,Jorge,50,ES82209578084093320757,TRX_N-00364-25509641,2022-11-19T08:57:06,Galdakao,expenses,clothing,-158.24,-14621.78
buyer_4,Jorge,50,ES82209578084093320757,TRX_N-00365-75269367,2022-11-19T14:47:15,Galdakao,expenses,education,-53.04,-14674.82
buyer_4,Jorge,50,ES82209578084093320757,TRX_N-00366-85792745,2022-11-20T22:52:38,Galdakao,expenses,transport,-83.72,-14758.54
buyer_4,Jorge,50,ES82209578084093320757,TRX_N-00367-62672337,2022-11-21T14:47:04,Galdakao,expenses,transport,-83.66,-14842.2
buyer_4,Jorge,50,ES82209578084093320757,TRX_N-00368-79662938,2022-11-22T11:37:34,Galdakao,expenses,food,-76.08,-14918.28
buyer_4,Jorge,50,ES82209578084093320757,TRX_N-00369-70260090,2022-11-22T08:12:53,Galdakao,expenses,transport,-44.9,-14963.18
buyer_4,Jorge,50,ES82209578084093320757,TRX_N-00370-62030754,2022-11-24T15:46:35,Galdakao,expenses,cash,-100.0,-15063.18
buyer_4,Jorge,50,ES82209578084093320757,TRX_N-00371-28822560,2022-11-25T09:14:28,Santurtzi,expenses,repairs,-311.26,-15374.44
buyer_4,Jorge,50,ES82209578084093320757,TRX_N-00372-86970381,2022-11-26T16:32:36,Galdakao,expenses,food,-91.09,-15465.53
buyer_4,Jorge,50,ES82209578084093320757,TRX_N-00373-27450615,2022-11-30T15:11:52,Galdakao,expenses,cash,-100.0,-15565.53
buyer_4,Jorge,50,ES82209578084093320757,TRX_N-00374-47711405,2022-12-01T15:17:50,Galdakao,incomes,salary,1370.36,-14195.17
buyer_4,Jorge,50,ES82209578084093320757,TRX_N-00375-08992481,2022-12-01T15:17:50,Galdakao,incomes,salary_partner,1413.6,-12781.57
buyer_4,Jorge,50,ES82209578084093320757,TRX_N-00376-75201757,2022-12-01T15:17:50,Galdakao,incomes,salary_bonus,1089.23,-11692.34
buyer_4,Jorge,50,ES82209578084093320757,TRX_N-00377-04885925,2022-12-01T15:17:50,Galdakao,incomes,salary_partner_bonus,1037.28,-10655.06
buyer_4,Jorge,50,ES82209578084093320757,TRX_N-00378-90143192,2022-12-02T19:56:33,Galdakao,expenses,food,-104.5,-10759.56
buyer_4,Jorge,50,ES82209578084093320757,TRX_N-00379-42192050,2022-12-04T11:23:20,Galdakao,expenses,mortgage,-979.09,-11738.65
buyer_4,Jorge,50,ES82209578084093320757,TRX_N-00380-79347400,2022-12-04T06:41:21,Galdakao,expenses,transport,-89.28,-11827.93
buyer_4,Jorge,50,ES82209578084093320757,TRX_N-00381-34899071,2022-12-04T13:42:05,Galdakao,expenses,leisure,-80.37,-11908.3
buyer_4,Jorge,50,ES82209578084093320757,TRX_N-00382-56814808,2022-12-05T15:52:35,Galdakao,expenses,transport,-45.0,-11953.3
buyer_4,Jorge,50,ES82209578084093320757,TRX_N-00383-32353697,2022-12-05T11:21:28,Sopela,expenses,education,-46.62,-11999.92
buyer_4,Jorge,50,ES82209578084093320757,TRX_N-00384-05569518,2022-12-05T11:12:42,Galdakao,expenses,gifts,-479.57,-12479.49
buyer_4,Jorge,50,ES82209578084093320757,TRX_N-00385-51354570,2022-12-06T12:35:18,Galdakao,expenses,clothing,-122.53,-12602.02
buyer_4,Jorge,50,ES82209578084093320757,TRX_N-00386-50705631,2022-12-07T09:51:04,Galdakao,expenses,electricity,-62.48,-12664.5
buyer_4,Jorge,50,ES82209578084093320757,TRX_N-00387-56135114,2022-12-07T09:15:45,Galdakao,expenses,phone,-32.76,-12697.26
buyer_4,Jorge,50,ES82209578084093320757,TRX_N-00388-09179943,2022-12-08T02:50:41,Galdakao,expenses,water,-37.0,-12734.26
buyer_4,Jorge,50,ES82209578084093320757,TRX_N-00389-54560161,2022-12-08T07:57:36,Galdakao,expenses,gas,-67.73,-12801.99
buyer_4,Jorge,50,ES82209578084093320757,TRX_N-00390-53588410,2022-12-08T21:50:46,Galdakao,expenses,internet,-42.0,-12843.99
buyer_4,Jorge,50,ES82209578084093320757,TRX_N-00391-45198053,2022-12-08T12:25:17,Galdakao,expenses,repairs,-193.65,-13037.64
buyer_4,Jorge,50,ES82209578084093320757,TRX_N-00392-09590508,2022-12-10T16:04:40,Galdakao,expenses,food,-86.33,-13123.97
buyer_4,Jorge,50,ES82209578084093320757,TRX_N-00393-77219866,2022-12-12T14:28:12,Galdakao,expenses,food,-99.24,-13223.21
buyer_4,Jorge,50,ES82209578084093320757,TRX_N-00394-15828762,2022-12-12T19:29:48,Galdakao,expenses,leisure,-34.39,-13257.6
buyer_4,Jorge,50,ES82209578084093320757,TRX_N-00395-92386614,2022-12-14T10:11:49,Galdakao,expenses,food,-105.14,-13362.74
buyer_4,Jorge,50,ES82209578084093320757,TRX_N-00396-42279818,2022-12-14T09:17:15,Errenteria,expenses,education,-70.83,-13433.57
buyer_4,Jorge,50,ES82209578084093320757,TRX_N-00397-51776236,2022-12-15T08:50:20,Galdakao,expenses,food,-71.9,-13505.47
buyer_4,Jorge,50,ES82209578084093320757,TRX_N-00398-98507975,2022-12-20T16:41:53,Galdakao,expenses,leisure,-41.56,-13547.03
buyer_4,Jorge,50,ES82209578084093320757,TRX_N-00399-29282501,2022-12-20T13:17:55,Oyón-Oion,expenses,appliances,-231.58,-13778.61
buyer_4,Jorge,50,ES82209578084093320757,TRX_N-00400-45996136,2022-12-21T08:30:38,Galdakao,expenses,cash,-100.0,-13878.61
buyer_4,Jorge,50,ES82209578084093320757,TRX_N-00401-04628834,2022-12-22T10:00:06,Mungia,expenses,repairs,-220.03,-14098.64
buyer_4,Jorge,50,ES82209578084093320757,TRX_N-00402-96070276,2022-12-23T23:40:26,Galdakao,expenses,food,-122.08,-14220.72
buyer_4,Jorge,50,ES82209578084093320757,TRX_N-00403-78786100,2022-12-25T15:26:26,Galdakao,expenses,gifts,-451.65,-14672.37
buyer_4,Jorge,50,ES82209578084093320757,TRX_N-00404-10898599,2022-12-27T19:57:12,Galdakao,expenses,leisure,-77.35,-14749.72
buyer_4,Jorge,50,ES82209578084093320757,TRX_N-00405-39906774,2022-12-27T19:40:39,Mungia,expenses,clothing,-87.13,-14836.85
buyer_4,Jorge,50,ES82209578084093320757,TRX_N-00406-10586281,2022-12-27T21:18:24,Galdakao,expenses,cash,-100.0,-14936.85
buyer_4,Jorge,50,ES82209578084093320757,TRX_N-00407-89357724,2022-12-28T09:16:20,Galdakao,expenses,food,-79.42,-15016.27
buyer_4,Jorge,50,ES82209578084093320757,TRX_N-00408-31385736,2022-12-28T12:21:04,Galdakao,expenses,cash,-100.0,-15116.27
buyer_4,Jorge,50,ES82209578084093320757,TRX_N-00409-67037084,2022-12-29T17:24:17,Galdakao,expenses,leisure,-79.05,-15195.32
buyer_4,Jorge,50,ES82209578084093320757,TRX_N-00410-74753119,2022-12-29T23:55:41,Galdakao,expenses,cash,-100.0,-15295.32
buyer_4,Jorge,50,ES82209578084093320757,TRX_N-00411-58321921,2022-12-30T18:51:35,Leioa,expenses,food,-69.25,-15364.57
buyer_4,Jorge,50,ES82209578084093320757,TRX_N-00412-19289217,2023-01-01T16:27:06,Galdakao,incomes,salary,1415.52,-13949.05
buyer_4,Jorge,50,ES82209578084093320757,TRX_N-00413-10858635,2023-01-01T16:27:06,Galdakao,incomes,salary_partner,1460.18,-12488.87
buyer_4,Jorge,50,ES82209578084093320757,TRX_N-00414-85582392,2023-01-01T20:46:12,Bermeo,expenses,leisure,-22.92,-12511.79
buyer_4,Jorge,50,ES82209578084093320757,TRX_N-00415-88576249,2023-01-02T15:33:14,Galdakao,expenses,clothing,-143.22,-12655.01
buyer_4,Jorge,50,ES82209578084093320757,TRX_N-00416-17525782,2023-01-03T16:30:47,Galdakao,expenses,children,-273.36,-12928.37
buyer_4,Jorge,50,ES82209578084093320757,TRX_N-00417-09028454,2023-01-04T18:33:22,Galdakao,expenses,mortgage,-979.09,-13907.46
buyer_4,Jorge,50,ES82209578084093320757,TRX_N-00418-09062948,2023-01-04T15:13:49,Galdakao,expenses,food,-97.71,-14005.17
buyer_4,Jorge,50,ES82209578084093320757,TRX_N-00419-64558613,2023-01-04T18:48:42,Eibar,expenses,cash,-100.0,-14105.17
buyer_4,Jorge,50,ES82209578084093320757,TRX_N-00420-39843399,2023-01-05T17:23:53,Galdakao,expenses,electricity,-84.98,-14190.15
buyer_4,Jorge,50,ES82209578084093320757,TRX_N-00421-52948988,2023-01-07T14:11:03,Galdakao,expenses,internet,-42.0,-14232.15
buyer_4,Jorge,50,ES82209578084093320757,TRX_N-00422-93219540,2023-01-07T15:13:33,Galdakao,expenses,cash,-100.0,-14332.15
buyer_4,Jorge,50,ES82209578084093320757,TRX_N-00423-95889863,2023-01-08T13:25:31,Galdakao,expenses,phone,-30.88,-14363.03
buyer_4,Jorge,50,ES82209578084093320757,TRX_N-00424-55836237,2023-01-08T22:21:53,Galdakao,expenses,water,-41.67,-14404.7
buyer_4,Jorge,50,ES82209578084093320757,TRX_N-00425-88070054,2023-01-08T15:54:07,Galdakao,expenses,gas,-56.86,-14461.56
buyer_4,Jorge,50,ES82209578084093320757,TRX_N-00426-48981269,2023-01-08T22:22:56,Galdakao,expenses,transport,-71.52,-14533.08
buyer_4,Jorge,50,ES82209578084093320757,TRX_N-00427-13490861,2023-01-10T08:43:20,Galdakao,expenses,leisure,-72.13,-14605.21
buyer_4,Jorge,50,ES82209578084093320757,TRX_N-00428-76133928,2023-01-12T22:27:26,Galdakao,expenses,food,-98.86,-14704.07
buyer_4,Jorge,50,ES82209578084093320757,TRX_N-00429-88900519,2023-01-12T15:48:14,Galdakao,expenses,children,-238.42,-14942.49
buyer_4,Jorge,50,ES82209578084093320757,TRX_N-00430-21860273,2023-01-13T11:54:02,Sopela,expenses,food,-103.1,-15045.59
buyer_4,Jorge,50,ES82209578084093320757,TRX_N-00431-32611598,2023-01-13T19:53:46,Galdakao,expenses,transport,-54.47,-15100.06
buyer_4,Jorge,50,ES82209578084093320757,TRX_N-00432-77344443,2023-01-13T14:39:13,Bermeo,expenses,gifts,-141.06,-15241.12
buyer_4,Jorge,50,ES82209578084093320757,TRX_N-00433-10042490,2023-01-15T18:49:06,Labastida,expenses,cash,-100.0,-15341.12
buyer_4,Jorge,50,ES82209578084093320757,TRX_N-00434-74554531,2023-01-16T12:44:43,Galdakao,expenses,children,-106.57,-15447.69
buyer_4,Jorge,50,ES82209578084093320757,TRX_N-00435-44764227,2023-01-19T10:44:53,Galdakao,expenses,food,-81.73,-15529.42
buyer_4,Jorge,50,ES82209578084093320757,TRX_N-00436-76317959,2023-01-20T13:50:27,Galdakao,expenses,education,-60.01,-15589.43
buyer_4,Jorge,50,ES82209578084093320757,TRX_N-00437-04925680,2023-01-21T22:21:14,Galdakao,expenses,cash,-100.0,-15689.43
buyer_4,Jorge,50,ES82209578084093320757,TRX_N-00438-82337420,2023-01-22T09:03:38,Galdakao,expenses,food,-83.13,-15772.56
buyer_4,Jorge,50,ES82209578084093320757,TRX_N-00439-06391288,2023-01-22T18:38:25,Galdakao,expenses,children,-162.61,-15935.17
buyer_4,Jorge,50,ES82209578084093320757,TRX_N-00440-33409234,2023-01-25T11:01:44,Galdakao,expenses,transport,-73.59,-16008.76
buyer_4,Jorge,50,ES82209578084093320757,TRX_N-00441-06714608,2023-01-27T13:06:43,Galdakao,expenses,gifts,-796.45,-16805.21
buyer_4,Jorge,50,ES82209578084093320757,TRX_N-00442-62398891,2023-01-28T23:53:26,Galdakao,expenses,cash,-100.0,-16905.21
buyer_4,Jorge,50,ES82209578084093320757,TRX_N-00443-87845348,2023-02-01T07:34:13,Galdakao,incomes,salary,1415.52,-15489.69
buyer_4,Jorge,50,ES82209578084093320757,TRX_N-00444-89655447,2023-02-01T07:34:13,Galdakao,incomes,salary_partner,1460.18,-14029.51
buyer_4,Jorge,50,ES82209578084093320757,TRX_N-00445-73992821,2023-02-01T20:59:55,Galdakao,expenses,food,-71.67,-14101.18
buyer_4,Jorge,50,ES82209578084093320757,TRX_N-00446-62789777,2023-02-04T13:12:18,Galdakao,expenses,mortgage,-979.09,-15080.27
buyer_4,Jorge,50,ES82209578084093320757,TRX_N-00447-53337172,2023-02-04T00:06:43,Basauri,expenses,appliances,-113.17,-15193.44
buyer_4,Jorge,50,ES82209578084093320757,TRX_N-00448-22944984,2023-02-05T18:08:03,Galdakao,expenses,transport,-70.14,-15263.58
buyer_4,Jorge,50,ES82209578084093320757,TRX_N-00449-48744700,2023-02-06T09:16:33,Galdakao,expenses,water,-38.09,-15301.67
buyer_4,Jorge,50,ES82209578084093320757,TRX_N-00450-94828491,2023-02-06T08:20:01,Galdakao,expenses,phone,-40.03,-15341.7
buyer_4,Jorge,50,ES82209578084093320757,TRX_N-00451-68207981,2023-02-07T13:09:24,Galdakao,expenses,internet,-42.0,-15383.7
buyer_4,Jorge,50,ES82209578084093320757,TRX_N-00452-61461658,2023-02-08T11:40:36,Galdakao,expenses,gas,-86.39,-15470.09
buyer_4,Jorge,50,ES82209578084093320757,TRX_N-00453-16792037,2023-02-08T14:19:32,Galdakao,expenses,electricity,-69.94,-15540.03
buyer_4,Jorge,50,ES82209578084093320757,TRX_N-00454-72277388,2023-02-08T15:39:40,Amurrio,expenses,clothing,-80.51,-15620.54
buyer_4,Jorge,50,ES82209578084093320757,TRX_N-00455-34336445,2023-02-08T13:40:00,Galdakao,expenses,children,-213.58,-15834.12
buyer_4,Jorge,50,ES82209578084093320757,TRX_N-00456-59484782,2023-02-09T10:23:39,Galdakao,expenses,education,-69.15,-15903.27
buyer_4,Jorge,50,ES82209578084093320757,TRX_N-00457-55436758,2023-02-12T13:41:50,Portugalete,expenses,food,-110.19,-16013.46
buyer_4,Jorge,50,ES82209578084093320757,TRX_N-00458-73651081,2023-02-13T16:41:37,Galdakao,expenses,repairs,-48.02,-16061.48
buyer_4,Jorge,50,ES82209578084093320757,TRX_N-00459-98851164,2023-02-15T14:36:46,Galdakao,expenses,repairs,-310.54,-16372.02
buyer_4,Jorge,50,ES82209578084093320757,TRX_N-00460-46219614,2023-02-17T20:51:34,Galdakao,expenses,healthcare,-50.89,-16422.91
buyer_4,Jorge,50,ES82209578084093320757,TRX_N-00461-38913066,2023-02-18T18:54:08,Galdakao,expenses,cash,-100.0,-16522.91
buyer_4,Jorge,50,ES82209578084093320757,TRX_N-00462-43913774,2023-02-18T23:28:27,Galdakao,expenses,repairs,-175.14,-16698.05
buyer_4,Jorge,50,ES82209578084093320757,TRX_N-00463-61619623,2023-02-19T23:12:30,Galdakao,expenses,cash,-100.0,-16798.05
buyer_4,Jorge,50,ES82209578084093320757,TRX_N-00464-73506058,2023-02-20T15:57:26,Galdakao,expenses,food,-104.36,-16902.41
buyer_4,Jorge,50,ES82209578084093320757,TRX_N-00465-38291693,2023-02-20T14:58:05,Galdakao,expenses,leisure,-40.16,-16942.57
buyer_4,Jorge,50,ES82209578084093320757,TRX_N-00466-39177819,2023-02-20T21:17:33,Galdakao,expenses,repairs,-90.06,-17032.63
buyer_4,Jorge,50,ES82209578084093320757,TRX_N-00467-67761499,2023-02-20T14:25:26,Galdakao,expenses,children,-262.08,-17294.71
buyer_4,Jorge,50,ES82209578084093320757,TRX_N-00468-73068541,2023-02-22T16:41:33,Galdakao,expenses,leisure,-19.24,-17313.95
buyer_4,Jorge,50,ES82209578084093320757,TRX_N-00469-68465606,2023-02-22T18:50:47,Andoain,expenses,healthcare,-125.48,-17439.43
buyer_4,Jorge,50,ES82209578084093320757,TRX_N-00470-97418326,2023-02-23T09:11:57,Galdakao,expenses,children,-141.33,-17580.76
buyer_4,Jorge,50,ES82209578084093320757,TRX_N-00471-49405598,2023-02-24T22:46:44,Galdakao,expenses,food,-110.59,-17691.35
buyer_4,Jorge,50,ES82209578084093320757,TRX_N-00472-29266071,2023-02-27T10:43:14,Galdakao,expenses,food,-69.05,-17760.4
buyer_4,Jorge,50,ES82209578084093320757,TRX_N-00473-65833611,2023-02-27T05:30:04,Galdakao,expenses,leisure,-28.48,-17788.88
buyer_4,Jorge,50,ES82209578084093320757,TRX_N-00474-84602926,2023-02-27T09:47:07,Galdakao,expenses,cash,-100.0,-17888.88
buyer_4,Jorge,50,ES82209578084093320757,TRX_N-00475-79251990,2023-02-28T19:01:23,Galdakao,expenses,leisure,-34.17,-17923.05
buyer_4,Jorge,50,ES82209578084093320757,TRX_N-00476-51833801,2023-02-28T15:57:06,Galdakao,expenses,repairs,-103.91,-18026.96
buyer_4,Jorge,50,ES82209578084093320757,TRX_N-00477-72614487,2023-03-01T12:19:06,Galdakao,incomes,salary,1415.52,-16611.44
buyer_4,Jorge,50,ES82209578084093320757,TRX_N-00478-77589968,2023-03-01T12:19:06,Galdakao,incomes,salary_partner,1460.18,-15151.26
buyer_4,Jorge,50,ES82209578084093320757,TRX_N-00479-40345352,2023-03-01T12:19:06,Galdakao,incomes,extra_income,218.64,-14932.62
buyer_4,Jorge,50,ES82209578084093320757,TRX_N-00480-28151487,2023-03-02T18:34:59,Galdakao,expenses,food,-77.35,-15009.97
buyer_4,Jorge,50,ES82209578084093320757,TRX_N-00481-05632955,2023-03-04T05:41:35,Galdakao,expenses,mortgage,-979.09,-15989.06
buyer_4,Jorge,50,ES82209578084093320757,TRX_N-00482-22615955,2023-03-04T18:50:17,Galdakao,expenses,cash,-100.0,-16089.06
buyer_4,Jorge,50,ES82209578084093320757,TRX_N-00483-94799342,2023-03-05T16:47:48,Galdakao,expenses,cash,-100.0,-16189.06
buyer_4,Jorge,50,ES82209578084093320757,TRX_N-00484-84973901,2023-03-06T01:52:02,Galdakao,expenses,gas,-113.58,-16302.64
buyer_4,Jorge,50,ES82209578084093320757,TRX_N-00485-39137735,2023-03-06T11:36:50,Galdakao,expenses,internet,-42.0,-16344.64
buyer_4,Jorge,50,ES82209578084093320757,TRX_N-00486-75514073,2023-03-06T03:11:46,Galdakao,expenses,phone,-34.8,-16379.44
buyer_4,Jorge,50,ES82209578084093320757,TRX_N-00487-50678632,2023-03-07T15:56:43,Galdakao,expenses,electricity,-24.62,-16404.06
buyer_4,Jorge,50,ES82209578084093320757,TRX_N-00488-25209731,2023-03-07T23:16:24,Galdakao,expenses,food,-85.56,-16489.62
buyer_4,Jorge,50,ES82209578084093320757,TRX_N-00489-61504326,2023-03-07T09:44:02,Galdakao,expenses,transport,-89.43,-16579.05
buyer_4,Jorge,50,ES82209578084093320757,TRX_N-00490-37222326,2023-03-08T20:38:10,Galdakao,expenses,water,-30.58,-16609.63
buyer_4,Jorge,50,ES82209578084093320757,TRX_N-00491-61552383,2023-03-08T13:35:01,Galdakao,expenses,transport,-89.65,-16699.28
buyer_4,Jorge,50,ES82209578084093320757,TRX_N-00492-39050980,2023-03-11T20:55:54,Galdakao,expenses,education,-68.68,-16767.96
buyer_4,Jorge,50,ES82209578084093320757,TRX_N-00493-92975350,2023-03-12T10:51:25,Galdakao,expenses,repairs,-268.61,-17036.57
buyer_4,Jorge,50,ES82209578084093320757,TRX_N-00494-46117243,2023-03-13T05:30:03,Alegría-Dulantzi,expenses,clothing,-149.72,-17186.29
buyer_4,Jorge,50,ES82209578084093320757,TRX_N-00495-90618353,2023-03-13T16:51:09,Galdakao,expenses,cash,-100.0,-17286.29
buyer_4,Jorge,50,ES82209578084093320757,TRX_N-00496-12476854,2023-03-14T12:54:59,Galdakao,expenses,gifts,-499.79,-17786.08
buyer_4,Jorge,50,ES82209578084093320757,TRX_N-00497-28524051,2023-03-15T16:18:00,Galdakao,expenses,cash,-100.0,-17886.08
buyer_4,Jorge,50,ES82209578084093320757,TRX_N-00498-16148206,2023-03-21T10:10:07,Galdakao,expenses,transport,-68.37,-17954.45
buyer_4,Jorge,50,ES82209578084093320757,TRX_N-00499-42193757,2023-03-21T16:32:03,Galdakao,expenses,cash,-100.0,-18054.45
buyer_4,Jorge,50,ES82209578084093320757,TRX_N-00500-09478075,2023-03-21T18:37:35,Galdakao,expenses,gifts,-283.22,-18337.67
buyer_4,Jorge,50,ES82209578084093320757,TRX_N-00501-19386739,2023-03-22T18:09:55,Galdakao,expenses,repairs,-237.42,-18575.09
buyer_4,Jorge,50,ES82209578084093320757,TRX_N-00502-77326091,2023-03-24T15:58:21,Galdakao,expenses,leisure,-37.5,-18612.59
buyer_4,Jorge,50,ES82209578084093320757,TRX_N-00503-27055210,2023-03-24T16:30:45,Galdakao,expenses,cash,-100.0,-18712.59
buyer_4,Jorge,50,ES82209578084093320757,TRX_N-00504-91434283,2023-03-25T14:27:18,Galdakao,expenses,cash,-100.0,-18812.59
buyer_4,Jorge,50,ES82209578084093320757,TRX_N-00505-64410198,2023-03-25T19:47:26,Galdakao,expenses,children,-251.41,-19064.0
buyer_4,Jorge,50,ES82209578084093320757,TRX_N-00506-97948549,2023-03-26T19:21:03,Galdakao,expenses,children,-243.49,-19307.49
buyer_4,Jorge,50,ES82209578084093320757,TRX_N-00507-19353057,2023-03-28T08:47:09,Galdakao,expenses,leisure,-47.22,-19354.71
buyer_4,Jorge,50,ES82209578084093320757,TRX_N-00508-52291755,2023-03-28T15:16:00,Galdakao,expenses,healthcare,-148.57,-19503.28
buyer_4,Jorge,50,ES82209578084093320757,TRX_N-00509-97825082,2023-04-01T14:29:13,Galdakao,incomes,salary,1415.52,-18087.76
buyer_4,Jorge,50,ES82209578084093320757,TRX_N-00510-40779370,2023-04-01T14:29:13,Galdakao,incomes,salary_partner,1460.18,-16627.58
buyer_4,Jorge,50,ES82209578084093320757,TRX_N-00511-51592570,2023-04-01T16:38:36,Galdakao,expenses,repairs,-212.68,-16840.26
buyer_4,Jorge,50,ES82209578084093320757,TRX_N-00512-27222568,2023-04-03T20:51:24,Galdakao,expenses,leisure,-63.1,-16903.36
buyer_4,Jorge,50,ES82209578084093320757,TRX_N-00513-22547838,2023-04-04T07:53:09,Galdakao,expenses,mortgage,-979.09,-17882.45
buyer_4,Jorge,50,ES82209578084093320757,TRX_N-00514-98169964,2023-04-04T06:20:04,Sestao,expenses,gifts,-92.91,-17975.36
buyer_4,Jorge,50,ES82209578084093320757,TRX_N-00515-20113920,2023-04-05T22:50:51,Galdakao,expenses,phone,-42.35,-18017.71
buyer_4,Jorge,50,ES82209578084093320757,TRX_N-00516-61386275,2023-04-06T19:09:47,Galdakao,expenses,electricity,-32.59,-18050.3
buyer_4,Jorge,50,ES82209578084093320757,TRX_N-00517-06128259,2023-04-06T19:44:36,Basauri,expenses,leisure,-57.85,-18108.15
buyer_4,Jorge,50,ES82209578084093320757,TRX_N-00518-67211142,2023-04-08T13:04:58,Galdakao,expenses,water,-24.54,-18132.69
buyer_4,Jorge,50,ES82209578084093320757,TRX_N-00519-90211151,2023-04-08T14:21:46,Galdakao,expenses,internet,-42.0,-18174.69
buyer_4,Jorge,50,ES82209578084093320757,TRX_N-00520-85335433,2023-04-08T02:27:43,Galdakao,expenses,gas,-30.83,-18205.52
buyer_4,Jorge,50,ES82209578084093320757,TRX_N-00521-22576183,2023-04-08T01:54:07,Galdakao,expenses,gifts,-437.58,-18643.1
buyer_4,Jorge,50,ES82209578084093320757,TRX_N-00522-18327212,2023-04-09T12:17:45,Galdakao,expenses,gifts,-426.24,-19069.34
buyer_4,Jorge,50,ES82209578084093320757,TRX_N-00523-01780557,2023-04-10T12:15:07,Galdakao,expenses,food,-95.02,-19164.36
buyer_4,Jorge,50,ES82209578084093320757,TRX_N-00524-07740765,2023-04-10T14:49:31,Galdakao,expenses,cash,-100.0,-19264.36
buyer_4,Jorge,50,ES82209578084093320757,TRX_N-00525-72972777,2023-04-10T11:49:27,Portugalete,expenses,gifts,-677.55,-19941.91
buyer_4,Jorge,50,ES82209578084093320757,TRX_N-00526-57383312,2023-04-12T20:57:26,Galdakao,expenses,children,-229.44,-20171.35
buyer_4,Jorge,50,ES82209578084093320757,TRX_N-00527-74451743,2023-04-14T18:22:05,Galdakao,expenses,cash,-100.0,-20271.35
buyer_4,Jorge,50,ES82209578084093320757,TRX_N-00528-40644881,2023-04-16T15:50:15,Galdakao,expenses,transport,-51.33,-20322.68
buyer_4,Jorge,50,ES82209578084093320757,TRX_N-00529-25599129,2023-04-16T04:59:56,Galdakao,expenses,clothing,-115.51,-20438.19
buyer_4,Jorge,50,ES82209578084093320757,TRX_N-00530-69256123,2023-04-16T10:23:45,Sestao,expenses,cash,-100.0,-20538.19
buyer_4,Jorge,50,ES82209578084093320757,TRX_N-00531-51787092,2023-04-18T15:25:13,Galdakao,expenses,cash,-100.0,-20638.19
buyer_4,Jorge,50,ES82209578084093320757,TRX_N-00532-43271359,2023-04-19T17:18:39,Galdakao,expenses,children,-179.34,-20817.53
buyer_4,Jorge,50,ES82209578084093320757,TRX_N-00533-81608770,2023-04-20T12:57:00,Galdakao,expenses,cash,-100.0,-20917.53
buyer_4,Jorge,50,ES82209578084093320757,TRX_N-00534-99125383,2023-04-21T11:55:15,Galdakao,expenses,repairs,-306.63,-21224.16
buyer_4,Jorge,50,ES82209578084093320757,TRX_N-00535-56871357,2023-04-22T08:03:37,Galdakao,expenses,transport,-43.4,-21267.56
buyer_4,Jorge,50,ES82209578084093320757,TRX_N-00536-89631481,2023-04-22T16:09:36,Galdakao,expenses,cash,-100.0,-21367.56
buyer_4,Jorge,50,ES82209578084093320757,TRX_N-00537-40532582,2023-04-22T08:16:01,Galdakao,expenses,repairs,-157.48,-21525.04
buyer_4,Jorge,50,ES82209578084093320757,TRX_N-00538-38178028,2023-04-23T11:38:39,Galdakao,expenses,food,-98.37,-21623.41
buyer_4,Jorge,50,ES82209578084093320757,TRX_N-00539-15004705,2023-04-23T20:59:19,Galdakao,expenses,leisure,-46.88,-21670.29
buyer_4,Jorge,50,ES82209578084093320757,TRX_N-00540-51407582,2023-04-26T17:30:43,Irun,expenses,cash,-100.0,-21770.29
buyer_4,Jorge,50,ES82209578084093320757,TRX_N-00541-16459841,2023-04-27T16:40:32,Galdakao,expenses,food,-94.64,-21864.93
buyer_4,Jorge,50,ES82209578084093320757,TRX_N-00542-84161081,2023-04-29T10:15:26,Galdakao,expenses,clothing,-108.58,-21973.51
buyer_4,Jorge,50,ES82209578084093320757,TRX_N-00543-81247105,2023-04-30T13:51:40,Hondarribia,expenses,clothing,-102.91,-22076.42
buyer_4,Jorge,50,ES82209578084093320757,TRX_N-00544-97664721,2023-05-01T16:19:50,Galdakao,incomes,salary,1415.52,-20660.9
buyer_4,Jorge,50,ES82209578084093320757,TRX_N-00545-24845903,2023-05-01T16:19:50,Galdakao,incomes,salary_partner,1460.18,-19200.72
buyer_4,Jorge,50,ES82209578084093320757,TRX_N-00546-68082707,2023-05-01T02:26:04,Galdakao,expenses,food,-100.35,-19301.07
buyer_4,Jorge,50,ES82209578084093320757,TRX_N-00547-59256020,2023-05-03T19:17:40,Galdakao,expenses,clothing,-104.08,-19405.15
buyer_4,Jorge,50,ES82209578084093320757,TRX_N-00548-24264900,2023-05-04T11:03:11,Galdakao,expenses,mortgage,-979.09,-20384.24
buyer_4,Jorge,50,ES82209578084093320757,TRX_N-00549-57271539,2023-05-06T08:56:07,Galdakao,expenses,water,-31.87,-20416.11
buyer_4,Jorge,50,ES82209578084093320757,TRX_N-00550-52272211,2023-05-06T19:19:53,Galdakao,expenses,internet,-42.0,-20458.11
buyer_4,Jorge,50,ES82209578084093320757,TRX_N-00551-57707404,2023-05-06T17:25:19,Galdakao,expenses,phone,-37.19,-20495.3
buyer_4,Jorge,50,ES82209578084093320757,TRX_N-00552-00746754,2023-05-06T15:05:10,Berango,expenses,repairs,-329.94,-20825.24
buyer_4,Jorge,50,ES82209578084093320757,TRX_N-00553-33275305,2023-05-08T15:21:53,Galdakao,expenses,electricity,-48.05,-20873.29
buyer_4,Jorge,50,ES82209578084093320757,TRX_N-00554-93353404,2023-05-08T17:15:09,Galdakao,expenses,gas,-55.42,-20928.71
buyer_4,Jorge,50,ES82209578084093320757,TRX_N-00555-89849914,2023-05-09T17:37:25,Arrasate,expenses,food,-104.45,-21033.16
buyer_4,Jorge,50,ES82209578084093320757,TRX_N-00556-30947324,2023-05-09T13:05:56,Galdakao,expenses,leisure,-67.55,-21100.71
buyer_4,Jorge,50,ES82209578084093320757,TRX_N-00557-28262210,2023-05-09T10:48:39,Galdakao,expenses,education,-49.93,-21150.64
buyer_4,Jorge,50,ES82209578084093320757,TRX_N-00558-05528278,2023-05-10T14:21:04,Galdakao,expenses,cash,-100.0,-21250.64
buyer_4,Jorge,50,ES82209578084093320757,TRX_N-00559-33874640,2023-05-11T14:52:54,Galdakao,expenses,food,-117.95,-21368.59
buyer_4,Jorge,50,ES82209578084093320757,TRX_N-00560-48474357,2023-05-11T18:10:27,Galdakao,expenses,cash,-100.0,-21468.59
buyer_4,Jorge,50,ES82209578084093320757,TRX_N-00561-94333357,2023-05-12T14:08:08,Getxo,expenses,clothing,-105.36,-21573.95
buyer_4,Jorge,50,ES82209578084093320757,TRX_N-00562-63967824,2023-05-12T15:30:44,Galdakao,expenses,repairs,-208.73,-21782.68
buyer_4,Jorge,50,ES82209578084093320757,TRX_N-00563-72434603,2023-05-13T10:28:53,Galdakao,expenses,gifts,-679.17,-22461.85
buyer_4,Jorge,50,ES82209578084093320757,TRX_N-00564-07619585,2023-05-14T10:23:42,Galdakao,expenses,cash,-100.0,-22561.85
buyer_4,Jorge,50,ES82209578084093320757,TRX_N-00565-56196528,2023-05-15T18:12:14,Galdakao,expenses,leisure,-56.36,-22618.21
buyer_4,Jorge,50,ES82209578084093320757,TRX_N-00566-53885504,2023-05-16T13:49:09,Galdakao,expenses,repairs,-31.32,-22649.53
buyer_4,Jorge,50,ES82209578084093320757,TRX_N-00567-48914009,2023-05-19T10:09:31,Galdakao,expenses,leisure,-45.8,-22695.33
buyer_4,Jorge,50,ES82209578084093320757,TRX_N-00568-04428524,2023-05-20T17:00:37,Galdakao,expenses,cash,-100.0,-22795.33
buyer_4,Jorge,50,ES82209578084093320757,TRX_N-00569-24630469,2023-05-22T19:17:32,Oyón-Oion,expenses,appliances,-294.91,-23090.24
buyer_4,Jorge,50,ES82209578084093320757,TRX_N-00570-86751718,2023-05-22T17:45:38,Galdakao,expenses,gifts,-742.59,-23832.83
buyer_4,Jorge,50,ES82209578084093320757,TRX_N-00571-31231345,2023-05-23T15:09:19,Oyón-Oion,expenses,cash,-100.0,-23932.83
buyer_4,Jorge,50,ES82209578084093320757,TRX_N-00572-05344736,2023-05-23T15:57:58,Galdakao,expenses,repairs,-40.09,-23972.92
buyer_4,Jorge,50,ES82209578084093320757,TRX_N-00573-06886788,2023-05-26T10:03:03,Galdakao,expenses,travel,-752.26,-24725.18
buyer_4,Jorge,50,ES82209578084093320757,TRX_N-00574-25762634,2023-05-26T19:15:15,Galdakao,expenses,repairs,-80.29,-24805.47
buyer_4,Jorge,50,ES82209578084093320757,TRX_N-00575-21923225,2023-05-27T16:31:53,Vitoria-Gasteiz,expenses,cash,-100.0,-24905.47
buyer_4,Jorge,50,ES82209578084093320757,TRX_N-00576-75483510,2023-05-28T13:52:32,Galdakao,expenses,leisure,-33.09,-24938.56
buyer_4,Jorge,50,ES82209578084093320757,TRX_N-00577-81066549,2023-05-28T12:11:11,Galdakao,expenses,gifts,-819.43,-25757.99
buyer_4,Jorge,50,ES82209578084093320757,TRX_N-00578-93794559,2023-05-29T09:13:02,Galdakao,expenses,cash,-100.0,-25857.99
buyer_4,Jorge,50,ES82209578084093320757,TRX_N-00579-66543135,2023-05-30T13:42:00,Galdakao,expenses,gifts,-169.25,-26027.24
buyer_4,Jorge,50,ES82209578084093320757,TRX_N-00580-92231990,2023-06-01T10:14:42,Galdakao,incomes,salary,1415.52,-24611.72
buyer_4,Jorge,50,ES82209578084093320757,TRX_N-00581-84694198,2023-06-01T10:14:42,Galdakao,incomes,salary_partner,1460.18,-23151.54
buyer_4,Jorge,50,ES82209578084093320757,TRX_N-00582-48084054,2023-06-01T10:14:42,Galdakao,incomes,extra_income,218.64,-22932.9
buyer_4,Jorge,50,ES82209578084093320757,TRX_N-00583-38869514,2023-06-01T10:14:42,Galdakao,incomes,salary_bonus,1000.98,-21931.92
buyer_4,Jorge,50,ES82209578084093320757,TRX_N-00584-19512183,2023-06-01T10:14:42,Galdakao,incomes,salary_partner_bonus,1137.38,-20794.54
buyer_4,Jorge,50,ES82209578084093320757,TRX_N-00585-52958511,2023-06-01T15:31:49,Galdakao,expenses,food,-106.72,-20901.26
buyer_4,Jorge,50,ES82209578084093320757,TRX_N-00586-88537788,2023-06-01T14:49:15,Galdakao,expenses,cash,-100.0,-21001.26
buyer_4,Jorge,50,ES82209578084093320757,TRX_N-00587-65087208,2023-06-02T10:35:49,Galdakao,expenses,transport,-82.44,-21083.7
buyer_4,Jorge,50,ES82209578084093320757,TRX_N-00588-84248170,2023-06-02T16:27:05,Galdakao,expenses,education,-66.21,-21149.91
buyer_4,Jorge,50,ES82209578084093320757,TRX_N-00589-05936959,2023-06-03T15:43:44,Galdakao,expenses,cash,-100.0,-21249.91
buyer_4,Jorge,50,ES82209578084093320757,TRX_N-00590-93284478,2023-06-03T00:51:14,Galdakao,expenses,repairs,-219.78,-21469.69
buyer_4,Jorge,50,ES82209578084093320757,TRX_N-00591-05080530,2023-06-04T16:06:52,Galdakao,expenses,mortgage,-979.09,-22448.78
buyer_4,Jorge,50,ES82209578084093320757,TRX_N-00592-44702888,2023-06-05T12:22:49,Galdakao,expenses,gas,-77.35,-22526.13
buyer_4,Jorge,50,ES82209578084093320757,TRX_N-00593-81510464,2023-06-05T10:03:39,Galdakao,expenses,internet,-42.0,-22568.13
buyer_4,Jorge,50,ES82209578084093320757,TRX_N-00594-48661065,2023-06-05T12:33:58,Galdakao,expenses,repairs,-93.85,-22661.98
buyer_4,Jorge,50,ES82209578084093320757,TRX_N-00595-93001251,2023-06-07T19:01:00,Galdakao,expenses,cash,-100.0,-22761.98
buyer_4,Jorge,50,ES82209578084093320757,TRX_N-00596-19815313,2023-06-08T07:20:07,Galdakao,expenses,water,-37.1,-22799.08
buyer_4,Jorge,50,ES82209578084093320757,TRX_N-00597-14198554,2023-06-08T08:13:35,Galdakao,expenses,electricity,-28.51,-22827.59
buyer_4,Jorge,50,ES82209578084093320757,TRX_N-00598-81134299,2023-06-08T20:33:06,Galdakao,expenses,phone,-36.6,-22864.19
buyer_4,Jorge,50,ES82209578084093320757,TRX_N-00599-81655588,2023-06-08T04:58:32,Galdakao,expenses,transport,-52.66,-22916.85
buyer_4,Jorge,50,ES82209578084093320757,TRX_N-00600-78744976,2023-06-09T09:47:59,Galdakao,expenses,transport,-85.23,-23002.08
buyer_4,Jorge,50,ES82209578084093320757,TRX_N-00601-04657345,2023-06-10T15:57:49,Lasarte-Oria,expenses,gifts,-597.5,-23599.58
buyer_4,Jorge,50,ES82209578084093320757,TRX_N-00602-10966065,2023-06-14T17:10:04,Galdakao,expenses,repairs,-31.58,-23631.16
buyer_4,Jorge,50,ES82209578084093320757,TRX_N-00603-98031940,2023-06-15T11:26:39,Galdakao,expenses,appliances,-362.28,-23993.44
buyer_4,Jorge,50,ES82209578084093320757,TRX_N-00604-16333039,2023-06-16T17:20:51,Galdakao,expenses,transport,-64.27,-24057.71
buyer_4,Jorge,50,ES82209578084093320757,TRX_N-00605-11929300,2023-06-19T17:58:55,Galdakao,expenses,leisure,-39.02,-24096.73
buyer_4,Jorge,50,ES82209578084093320757,TRX_N-00606-99355545,2023-06-21T14:25:04,Mungia,expenses,food,-70.58,-24167.31
buyer_4,Jorge,50,ES82209578084093320757,TRX_N-00607-97202170,2023-06-21T04:55:11,Galdakao,expenses,repairs,-97.19,-24264.5
buyer_4,Jorge,50,ES82209578084093320757,TRX_N-00608-24898319,2023-06-22T00:03:57,Galdakao,expenses,food,-105.53,-24370.03
buyer_4,Jorge,50,ES82209578084093320757,TRX_N-00609-43754785,2023-06-24T17:13:52,Galdakao,expenses,healthcare,-91.77,-24461.8
buyer_4,Jorge,50,ES82209578084093320757,TRX_N-00610-82752468,2023-06-24T19:23:39,Galdakao,expenses,education,-42.05,-24503.85
buyer_4,Jorge,50,ES82209578084093320757,TRX_N-00611-74828150,2023-06-24T16:36:23,Galdakao,expenses,gifts,-165.55,-24669.4
buyer_4,Jorge,50,ES82209578084093320757,TRX_N-00612-22510582,2023-06-26T18:25:47,Galdakao,expenses,food,-99.28,-24768.68
buyer_4,Jorge,50,ES82209578084093320757,TRX_N-00613-87534937,2023-06-26T23:16:42,Galdakao,expenses,transport,-59.06,-24827.74
buyer_4,Jorge,50,ES82209578084093320757,TRX_N-00614-12116033,2023-06-27T09:48:18,Galdakao,expenses,food,-116.32,-24944.06
buyer_4,Jorge,50,ES82209578084093320757,TRX_N-00615-79029456,2023-06-28T10:13:36,Galdakao,expenses,food,-77.73,-25021.79
buyer_4,Jorge,50,ES82209578084093320757,TRX_N-00616-02546172,2023-06-29T13:45:35,Galdakao,expenses,leisure,-43.79,-25065.58
buyer_4,Jorge,50,ES82209578084093320757,TRX_N-00617-41567144,2023-07-01T13:38:34,Galdakao,incomes,salary,1415.52,-23650.06
buyer_4,Jorge,50,ES82209578084093320757,TRX_N-00618-82703008,2023-07-01T13:38:34,Galdakao,incomes,salary_partner,1460.18,-22189.88
buyer_4,Jorge,50,ES82209578084093320757,TRX_N-00619-08361758,2023-07-03T21:20:25,Galdakao,expenses,food,-123.63,-22313.51
buyer_4,Jorge,50,ES82209578084093320757,TRX_N-00620-43998304,2023-07-04T21:43:24,Galdakao,expenses,mortgage,-979.09,-23292.6
buyer_4,Jorge,50,ES82209578084093320757,TRX_N-00621-78933857,2023-07-04T14:51:04,Galdakao,expenses,cash,-100.0,-23392.6
buyer_4,Jorge,50,ES82209578084093320757,TRX_N-00622-76975208,2023-07-05T11:11:32,Galdakao,expenses,gas,-48.92,-23441.52
buyer_4,Jorge,50,ES82209578084093320757,TRX_N-00623-95044030,2023-07-06T21:56:04,Galdakao,expenses,water,-41.9,-23483.42
buyer_4,Jorge,50,ES82209578084093320757,TRX_N-00624-38765415,2023-07-07T22:13:23,Galdakao,expenses,phone,-35.29,-23518.71
buyer_4,Jorge,50,ES82209578084093320757,TRX_N-00625-20364225,2023-07-08T10:12:05,Galdakao,expenses,electricity,-33.93,-23552.64
buyer_4,Jorge,50,ES82209578084093320757,TRX_N-00626-17101969,2023-07-08T17:00:07,Galdakao,expenses,internet,-42.0,-23594.64
buyer_4,Jorge,50,ES82209578084093320757,TRX_N-00627-04968115,2023-07-14T22:39:33,Galdakao,expenses,food,-66.64,-23661.28
buyer_4,Jorge,50,ES82209578084093320757,TRX_N-00628-16714530,2023-07-15T12:38:36,Galdakao,expenses,cash,-100.0,-23761.28
buyer_4,Jorge,50,ES82209578084093320757,TRX_N-00629-98737439,2023-07-16T03:51:32,Galdakao,expenses,clothing,-153.62,-23914.9
buyer_4,Jorge,50,ES82209578084093320757,TRX_N-00630-09503188,2023-07-20T19:51:12,Galdakao,expenses,cash,-100.0,-24014.9
buyer_4,Jorge,50,ES82209578084093320757,TRX_N-00631-38749609,2023-07-21T12:55:26,Errenteria,expenses,transport,-53.86,-24068.76
buyer_4,Jorge,50,ES82209578084093320757,TRX_N-00632-15290285,2023-07-22T18:35:46,Galdakao,expenses,food,-80.21,-24148.97
buyer_4,Jorge,50,ES82209578084093320757,TRX_N-00633-55760340,2023-07-25T21:09:44,Galdakao,expenses,transport,-59.42,-24208.39
buyer_4,Jorge,50,ES82209578084093320757,TRX_N-00634-54017072,2023-07-27T04:52:56,Galdakao,expenses,leisure,-82.23,-24290.62
buyer_4,Jorge,50,ES82209578084093320757,TRX_N-00635-37335261,2023-07-28T08:13:41,Sestao,expenses,cash,-100.0,-24390.62
buyer_4,Jorge,50,ES82209578084093320757,TRX_N-00636-62823386,2023-07-29T14:44:53,Galdakao,expenses,food,-80.58,-24471.2
buyer_4,Jorge,50,ES82209578084093320757,TRX_N-00637-87956287,2023-07-31T18:35:49,Oyón-Oion,expenses,transport,-64.91,-24536.11
buyer_4,Jorge,50,ES82209578084093320757,TRX_N-00638-37302764,2023-08-01T14:40:49,Galdakao,incomes,salary,1415.52,-23120.59
buyer_4,Jorge,50,ES82209578084093320757,TRX_N-00639-91014731,2023-08-01T14:40:49,Galdakao,incomes,salary_partner,1460.18,-21660.41
buyer_4,Jorge,50,ES82209578084093320757,TRX_N-00640-51101730,2023-08-01T12:01:30,Galdakao,expenses,cash,-100.0,-21760.41
buyer_4,Jorge,50,ES82209578084093320757,TRX_N-00641-82027947,2023-08-02T17:15:51,Galdakao,expenses,cash,-100.0,-21860.41
buyer_4,Jorge,50,ES82209578084093320757,TRX_N-00642-86400639,2023-08-03T12:41:17,Santurtzi,expenses,gifts,-548.34,-22408.75
buyer_4,Jorge,50,ES82209578084093320757,TRX_N-00643-72439550,2023-08-04T08:22:11,Galdakao,expenses,mortgage,-979.09,-23387.84
buyer_4,Jorge,50,ES82209578084093320757,TRX_N-00644-79212064,2023-08-04T09:45:30,Galdakao,expenses,clothing,-96.78,-23484.62
buyer_4,Jorge,50,ES82209578084093320757,TRX_N-00645-47582340,2023-08-05T21:21:08,Galdakao,expenses,leisure,-53.96,-23538.58
buyer_4,Jorge,50,ES82209578084093320757,TRX_N-00646-21335012,2023-08-05T04:05:50,Galdakao,expenses,cash,-100.0,-23638.58
buyer_4,Jorge,50,ES82209578084093320757,TRX_N-00647-52817889,2023-08-06T16:07:43,Galdakao,expenses,water,-26.16,-23664.74
buyer_4,Jorge,50,ES82209578084093320757,TRX_N-00648-84284859,2023-08-06T20:34:38,Galdakao,expenses,electricity,-55.36,-23720.1
buyer_4,Jorge,50,ES82209578084093320757,TRX_N-00649-75423290,2023-08-06T19:00:02,Galdakao,expenses,food,-113.69,-23833.79
buyer_4,Jorge,50,ES82209578084093320757,TRX_N-00650-94659722,2023-08-07T07:28:16,Galdakao,expenses,internet,-42.0,-23875.79
buyer_4,Jorge,50,ES82209578084093320757,TRX_N-00651-34997961,2023-08-08T04:03:06,Galdakao,expenses,phone,-38.22,-23914.01
buyer_4,Jorge,50,ES82209578084093320757,TRX_N-00652-99906381,2023-08-08T09:06:38,Galdakao,expenses,gas,-87.57,-24001.58
buyer_4,Jorge,50,ES82209578084093320757,TRX_N-00653-25824445,2023-08-08T23:42:50,Galdakao,expenses,cash,-100.0,-24101.58
buyer_4,Jorge,50,ES82209578084093320757,TRX_N-00654-39177737,2023-08-10T15:22:57,Galdakao,expenses,food,-81.01,-24182.59
buyer_4,Jorge,50,ES82209578084093320757,TRX_N-00655-57121537,2023-08-10T16:04:40,Galdakao,expenses,transport,-85.87,-24268.46
buyer_4,Jorge,50,ES82209578084093320757,TRX_N-00656-72288624,2023-08-10T17:47:55,Galdakao,expenses,travel,-1816.31,-26084.77
buyer_4,Jorge,50,ES82209578084093320757,TRX_N-00657-78539219,2023-08-11T19:20:57,Galdakao,expenses,cash,-100.0,-26184.77
buyer_4,Jorge,50,ES82209578084093320757,TRX_N-00658-74699382,2023-08-15T13:59:29,Galdakao,expenses,food,-123.5,-26308.27
buyer_4,Jorge,50,ES82209578084093320757,TRX_N-00659-09996393,2023-08-17T19:00:56,Galdakao,expenses,transport,-75.05,-26383.32
buyer_4,Jorge,50,ES82209578084093320757,TRX_N-00660-71230281,2023-08-17T15:44:53,Galdakao,expenses,leisure,-39.63,-26422.95
buyer_4,Jorge,50,ES82209578084093320757,TRX_N-00661-55439417,2023-08-17T22:43:36,Galdakao,expenses,children,-267.88,-26690.83
buyer_4,Jorge,50,ES82209578084093320757,TRX_N-00662-87422537,2023-08-18T14:02:14,Galdakao,expenses,healthcare,-125.44,-26816.27
buyer_4,Jorge,50,ES82209578084093320757,TRX_N-00663-11299317,2023-08-18T17:34:41,Galdakao,expenses,cash,-100.0,-26916.27
buyer_4,Jorge,50,ES82209578084093320757,TRX_N-00664-98422126,2023-08-19T23:33:15,Galdakao,expenses,education,-47.63,-26963.9
buyer_4,Jorge,50,ES82209578084093320757,TRX_N-00665-34385097,2023-08-20T09:52:51,Galdakao,expenses,transport,-71.13,-27035.03
buyer_4,Jorge,50,ES82209578084093320757,TRX_N-00666-70132129,2023-08-20T14:44:36,Galdakao,expenses,cash,-100.0,-27135.03
buyer_4,Jorge,50,ES82209578084093320757,TRX_N-00667-08453576,2023-08-21T18:15:02,Galdakao,expenses,cash,-100.0,-27235.03
buyer_4,Jorge,50,ES82209578084093320757,TRX_N-00668-25633592,2023-08-21T12:47:48,Galdakao,expenses,repairs,-311.74,-27546.77
buyer_4,Jorge,50,ES82209578084093320757,TRX_N-00669-23624310,2023-08-23T08:45:54,Galdakao,expenses,leisure,-79.62,-27626.39
buyer_4,Jorge,50,ES82209578084093320757,TRX_N-00670-89180022,2023-08-25T01:38:14,Galdakao,expenses,transport,-40.34,-27666.73
buyer_4,Jorge,50,ES82209578084093320757,TRX_N-00671-54559136,2023-08-25T20:08:49,Galdakao,expenses,cash,-100.0,-27766.73
buyer_4,Jorge,50,ES82209578084093320757,TRX_N-00672-63153217,2023-08-28T11:52:29,Galdakao,expenses,cash,-100.0,-27866.73
buyer_4,Jorge,50,ES82209578084093320757,TRX_N-00673-32106655,2023-08-29T17:13:44,Galdakao,expenses,food,-81.03,-27947.76
buyer_4,Jorge,50,ES82209578084093320757,TRX_N-00674-10492589,2023-08-30T20:36:58,Galdakao,expenses,transport,-54.14,-28001.9
buyer_4,Jorge,50,ES82209578084093320757,TRX_N-00675-86152187,2023-08-31T11:09:12,Galdakao,expenses,cash,-100.0,-28101.9
buyer_4,Jorge,50,ES82209578084093320757,TRX_N-00676-81603385,2023-09-01T06:05:15,Galdakao,incomes,salary,1415.52,-26686.38
buyer_4,Jorge,50,ES82209578084093320757,TRX_N-00677-92450534,2023-09-01T06:05:15,Galdakao,incomes,salary_partner,1460.18,-25226.2
buyer_4,Jorge,50,ES82209578084093320757,TRX_N-00678-67389379,2023-09-01T06:05:15,Galdakao,incomes,extra_income,218.64,-25007.56
buyer_4,Jorge,50,ES82209578084093320757,TRX_N-00679-68872323,2023-09-02T15:41:25,Galdakao,expenses,cash,-100.0,-25107.56
buyer_4,Jorge,50,ES82209578084093320757,TRX_N-00680-01719462,2023-09-03T15:50:42,Galdakao,expenses,leisure,-20.23,-25127.79
buyer_4,Jorge,50,ES82209578084093320757,TRX_N-00681-66828851,2023-09-04T19:37:26,Galdakao,expenses,mortgage,-979.09,-26106.88
buyer_4,Jorge,50,ES82209578084093320757,TRX_N-00682-34647735,2023-09-05T19:19:32,Galdakao,expenses,internet,-42.0,-26148.88
buyer_4,Jorge,50,ES82209578084093320757,TRX_N-00683-65817340,2023-09-05T11:04:36,Galdakao,expenses,children,-265.19,-26414.07
buyer_4,Jorge,50,ES82209578084093320757,TRX_N-00684-74368328,2023-09-06T12:43:18,Galdakao,expenses,gas,-107.67,-26521.74
buyer_4,Jorge,50,ES82209578084093320757,TRX_N-00685-15280470,2023-09-07T20:05:56,Galdakao,expenses,water,-38.66,-26560.4
buyer_4,Jorge,50,ES82209578084093320757,TRX_N-00686-79977860,2023-09-08T10:00:41,Galdakao,expenses,electricity,-53.21,-26613.61
buyer_4,Jorge,50,ES82209578084093320757,TRX_N-00687-22949999,2023-09-08T19:21:06,Galdakao,expenses,phone,-40.37,-26653.98
buyer_4,Jorge,50,ES82209578084093320757,TRX_N-00688-06409177,2023-09-08T10:17:39,Galdakao,expenses,food,-113.14,-26767.12
buyer_4,Jorge,50,ES82209578084093320757,TRX_N-00689-27015032,2023-09-08T09:17:06,Galdakao,expenses,leisure,-30.58,-26797.7
buyer_4,Jorge,50,ES82209578084093320757,TRX_N-00690-43596806,2023-09-08T09:46:37,Durango,expenses,healthcare,-160.4,-26958.1
buyer_4,Jorge,50,ES82209578084093320757,TRX_N-00691-48604621,2023-09-09T00:33:11,Galdakao,expenses,healthcare,-117.12,-27075.22
buyer_4,Jorge,50,ES82209578084093320757,TRX_N-00692-75101348,2023-09-09T09:35:57,Galdakao,expenses,cash,-100.0,-27175.22
buyer_4,Jorge,50,ES82209578084093320757,TRX_N-00693-05737970,2023-09-10T15:18:34,Bermeo,expenses,food,-68.74,-27243.96
buyer_4,Jorge,50,ES82209578084093320757,TRX_N-00694-07236808,2023-09-10T01:01:41,Galdakao,expenses,cash,-100.0,-27343.96
buyer_4,Jorge,50,ES82209578084093320757,TRX_N-00695-15667565,2023-09-11T12:31:57,Galdakao,expenses,cash,-100.0,-27443.96
buyer_4,Jorge,50,ES82209578084093320757,TRX_N-00696-83440645,2023-09-12T17:16:51,Galdakao,expenses,healthcare,-47.59,-27491.55
buyer_4,Jorge,50,ES82209578084093320757,TRX_N-00697-03513347,2023-09-13T15:32:57,Durango,expenses,food,-120.16,-27611.71
buyer_4,Jorge,50,ES82209578084093320757,TRX_N-00698-26743848,2023-09-14T11:56:59,Galdakao,expenses,food,-78.38,-27690.09
buyer_4,Jorge,50,ES82209578084093320757,TRX_N-00699-52137328,2023-09-14T15:45:22,Santurtzi,expenses,transport,-70.73,-27760.82
buyer_4,Jorge,50,ES82209578084093320757,TRX_N-00700-25479540,2023-09-17T19:10:59,Galdakao,expenses,cash,-100.0,-27860.82
buyer_4,Jorge,50,ES82209578084093320757,TRX_N-00701-82944398,2023-09-18T20:24:38,Galdakao,expenses,leisure,-39.29,-27900.11
buyer_4,Jorge,50,ES82209578084093320757,TRX_N-00702-11413856,2023-09-19T17:32:34,Galdakao,expenses,cash,-100.0,-28000.11
buyer_4,Jorge,50,ES82209578084093320757,TRX_N-00703-00517041,2023-09-22T07:13:37,Leioa,expenses,leisure,-70.31,-28070.42
buyer_4,Jorge,50,ES82209578084093320757,TRX_N-00704-14943027,2023-09-25T10:38:20,Durango,expenses,leisure,-58.58,-28129.0
buyer_4,Jorge,50,ES82209578084093320757,TRX_N-00705-55013272,2023-09-27T08:30:29,Galdakao,expenses,cash,-100.0,-28229.0
buyer_4,Jorge,50,ES82209578084093320757,TRX_N-00706-44510931,2023-09-28T15:08:49,Galdakao,expenses,leisure,-18.36,-28247.36
buyer_4,Jorge,50,ES82209578084093320757,TRX_N-00707-49353389,2023-09-30T11:47:17,Erandio,expenses,cash,-100.0,-28347.36
buyer_4,Jorge,50,ES82209578084093320757,TRX_N-00708-90855147,2023-10-01T18:08:40,Galdakao,incomes,salary,1415.52,-26931.84
buyer_4,Jorge,50,ES82209578084093320757,TRX_N-00709-81737647,2023-10-01T18:08:40,Galdakao,incomes,salary_partner,1460.18,-25471.66
buyer_4,Jorge,50,ES82209578084093320757,TRX_N-00710-44964457,2023-10-01T21:40:03,Galdakao,expenses,food,-84.47,-25556.13
buyer_4,Jorge,50,ES82209578084093320757,TRX_N-00711-24888066,2023-10-01T16:21:13,Galdakao,expenses,repairs,-317.06,-25873.19
buyer_4,Jorge,50,ES82209578084093320757,TRX_N-00712-55952529,2023-10-01T21:15:47,Zuia,expenses,gifts,-69.11,-25942.3
buyer_4,Jorge,50,ES82209578084093320757,TRX_N-00713-07589148,2023-10-03T19:37:19,Galdakao,expenses,travel,-783.74,-26726.04
buyer_4,Jorge,50,ES82209578084093320757,TRX_N-00714-95587146,2023-10-04T15:59:15,Galdakao,expenses,mortgage,-979.09,-27705.13
buyer_4,Jorge,50,ES82209578084093320757,TRX_N-00715-01335835,2023-10-04T13:16:19,Bilbao,expenses,appliances,-409.44,-28114.57
buyer_4,Jorge,50,ES82209578084093320757,TRX_N-00716-46705597,2023-10-06T03:32:41,Galdakao,expenses,cash,-100.0,-28214.57
buyer_4,Jorge,50,ES82209578084093320757,TRX_N-00717-62010221,2023-10-07T10:43:37,Sestao,expenses,food,-81.51,-28296.08
buyer_4,Jorge,50,ES82209578084093320757,TRX_N-00718-76788303,2023-10-07T20:51:07,Galdakao,expenses,appliances,-313.65,-28609.73
buyer_4,Jorge,50,ES82209578084093320757,TRX_N-00719-05740565,2023-10-08T08:59:33,Galdakao,expenses,internet,-42.0,-28651.73
buyer_4,Jorge,50,ES82209578084093320757,TRX_N-00720-08618688,2023-10-08T09:20:01,Galdakao,expenses,water,-21.01,-28672.74
buyer_4,Jorge,50,ES82209578084093320757,TRX_N-00721-34201018,2023-10-08T08:37:26,Galdakao,expenses,electricity,-56.97,-28729.71
buyer_4,Jorge,50,ES82209578084093320757,TRX_N-00722-90443546,2023-10-08T06:14:43,Galdakao,expenses,gas,-61.83,-28791.54
buyer_4,Jorge,50,ES82209578084093320757,TRX_N-00723-51534896,2023-10-08T11:56:03,Galdakao,expenses,phone,-39.43,-28830.97
buyer_4,Jorge,50,ES82209578084093320757,TRX_N-00724-76657649,2023-10-08T09:30:37,Galdakao,expenses,leisure,-73.86,-28904.83
buyer_4,Jorge,50,ES82209578084093320757,TRX_N-00725-24931384,2023-10-09T23:19:39,Galdakao,expenses,cash,-100.0,-29004.83
buyer_4,Jorge,50,ES82209578084093320757,TRX_N-00726-18361015,2023-10-10T10:12:20,Galdakao,expenses,cash,-100.0,-29104.83
buyer_4,Jorge,50,ES82209578084093320757,TRX_N-00727-07120982,2023-10-12T17:23:07,Galdakao,expenses,education,-70.77,-29175.6
buyer_4,Jorge,50,ES82209578084093320757,TRX_N-00728-04719061,2023-10-13T15:36:36,Galdakao,expenses,leisure,-61.16,-29236.76
buyer_4,Jorge,50,ES82209578084093320757,TRX_N-00729-93254514,2023-10-13T16:56:30,Galdakao,expenses,gifts,-409.9,-29646.66
buyer_4,Jorge,50,ES82209578084093320757,TRX_N-00730-34301513,2023-10-14T11:05:29,Pasaia,expenses,transport,-78.51,-29725.17
buyer_4,Jorge,50,ES82209578084093320757,TRX_N-00731-35009973,2023-10-14T16:03:27,Galdakao,expenses,cash,-100.0,-29825.17
buyer_4,Jorge,50,ES82209578084093320757,TRX_N-00732-83591423,2023-10-15T16:41:39,Galdakao,expenses,food,-64.8,-29889.97
buyer_4,Jorge,50,ES82209578084093320757,TRX_N-00733-18672232,2023-10-16T22:32:42,Galdakao,expenses,cash,-100.0,-29989.97
buyer_4,Jorge,50,ES82209578084093320757,TRX_N-00734-72773078,2023-10-16T12:04:49,Galdakao,expenses,repairs,-230.53,-30220.5
buyer_4,Jorge,50,ES82209578084093320757,TRX_N-00735-56471640,2023-10-16T14:32:05,Galdakao,expenses,children,-82.8,-30303.3
buyer_4,Jorge,50,ES82209578084093320757,TRX_N-00736-23494574,2023-10-17T13:59:21,Galdakao,expenses,leisure,-31.99,-30335.29
buyer_4,Jorge,50,ES82209578084093320757,TRX_N-00737-33375215,2023-10-19T06:18:26,Galdakao,expenses,leisure,-27.2,-30362.49
buyer_4,Jorge,50,ES82209578084093320757,TRX_N-00738-87002833,2023-10-22T01:51:32,Bermeo,expenses,repairs,-231.99,-30594.48
buyer_4,Jorge,50,ES82209578084093320757,TRX_N-00739-97505469,2023-10-23T09:23:35,Galdakao,expenses,food,-111.14,-30705.62
buyer_4,Jorge,50,ES82209578084093320757,TRX_N-00740-87795364,2023-10-23T15:46:23,Galdakao,expenses,education,-77.64,-30783.26
buyer_4,Jorge,50,ES82209578084093320757,TRX_N-00741-18428784,2023-10-25T13:43:11,Galdakao,expenses,leisure,-76.51,-30859.77
buyer_4,Jorge,50,ES82209578084093320757,TRX_N-00742-51319737,2023-10-31T09:37:16,Galdakao,expenses,food,-82.38,-30942.15
buyer_4,Jorge,50,ES82209578084093320757,TRX_N-00743-80613103,2023-10-31T13:33:36,Galdakao,expenses,leisure,-72.52,-31014.67
buyer_4,Jorge,50,ES82209578084093320757,TRX_N-00744-75284059,2023-11-01T17:00:25,Galdakao,incomes,salary,1415.52,-29599.15
buyer_4,Jorge,50,ES82209578084093320757,TRX_N-00745-14388680,2023-11-01T17:00:25,Galdakao,incomes,salary_partner,1460.18,-28138.97
buyer_4,Jorge,50,ES82209578084093320757,TRX_N-00746-49344400,2023-11-01T15:58:53,Galdakao,expenses,leisure,-72.93,-28211.9
buyer_4,Jorge,50,ES82209578084093320757,TRX_N-00747-41646906,2023-11-01T10:39:50,Galdakao,expenses,healthcare,-109.21,-28321.11
buyer_4,Jorge,50,ES82209578084093320757,TRX_N-00748-06350699,2023-11-04T08:24:08,Galdakao,expenses,mortgage,-979.09,-29300.2
buyer_4,Jorge,50,ES82209578084093320757,TRX_N-00749-55715068,2023-11-05T18:24:42,Galdakao,expenses,water,-25.7,-29325.9
buyer_4,Jorge,50,ES82209578084093320757,TRX_N-00750-89513245,2023-11-05T17:40:54,Arrasate,expenses,repairs,-47.07,-29372.97
buyer_4,Jorge,50,ES82209578084093320757,TRX_N-00751-67315139,2023-11-07T11:25:55,Galdakao,expenses,gas,-84.58,-29457.55
buyer_4,Jorge,50,ES82209578084093320757,TRX_N-00752-88790162,2023-11-07T09:44:45,Galdakao,expenses,repairs,-236.28,-29693.83
buyer_4,Jorge,50,ES82209578084093320757,TRX_N-00753-46841693,2023-11-08T08:10:23,Galdakao,expenses,electricity,-47.12,-29740.95
buyer_4,Jorge,50,ES82209578084093320757,TRX_N-00754-13361350,2023-11-08T08:07:46,Galdakao,expenses,internet,-42.0,-29782.95
buyer_4,Jorge,50,ES82209578084093320757,TRX_N-00755-88198718,2023-11-08T17:44:02,Galdakao,expenses,phone,-36.92,-29819.87
buyer_4,Jorge,50,ES82209578084093320757,TRX_N-00756-01506184,2023-11-08T22:16:42,Galdakao,expenses,food,-63.16,-29883.03
buyer_4,Jorge,50,ES82209578084093320757,TRX_N-00757-10822655,2023-11-08T19:13:07,Galdakao,expenses,education,-74.36,-29957.39
buyer_4,Jorge,50,ES82209578084093320757,TRX_N-00758-66192303,2023-11-09T16:16:43,Galdakao,expenses,transport,-68.72,-30026.11
buyer_4,Jorge,50,ES82209578084093320757,TRX_N-00759-91455974,2023-11-11T23:41:36,Galdakao,expenses,appliances,-342.44,-30368.55
buyer_4,Jorge,50,ES82209578084093320757,TRX_N-00760-37402538,2023-11-12T11:07:00,Arrasate,expenses,food,-119.99,-30488.54
buyer_4,Jorge,50,ES82209578084093320757,TRX_N-00761-68374792,2023-11-12T15:29:06,Galdakao,expenses,cash,-100.0,-30588.54
buyer_4,Jorge,50,ES82209578084093320757,TRX_N-00762-16718303,2023-11-13T05:03:50,Galdakao,expenses,food,-88.5,-30677.04
buyer_4,Jorge,50,ES82209578084093320757,TRX_N-00763-84222965,2023-11-15T21:39:30,Galdakao,expenses,education,-49.58,-30726.62
buyer_4,Jorge,50,ES82209578084093320757,TRX_N-00764-30966529,2023-11-17T12:08:59,Galdakao,expenses,clothing,-131.27,-30857.89
buyer_4,Jorge,50,ES82209578084093320757,TRX_N-00765-22421423,2023-11-17T15:50:14,Galdakao,expenses,appliances,-403.94,-31261.83
buyer_4,Jorge,50,ES82209578084093320757,TRX_N-00766-87959452,2023-11-17T08:55:12,Erandio,expenses,gifts,-784.37,-32046.2
buyer_4,Jorge,50,ES82209578084093320757,TRX_N-00767-60992972,2023-11-20T14:17:28,Galdakao,expenses,cash,-100.0,-32146.2
buyer_4,Jorge,50,ES82209578084093320757,TRX_N-00768-12897545,2023-11-20T08:29:06,Galdakao,expenses,travel,-1815.7,-33961.9
buyer_4,Jorge,50,ES82209578084093320757,TRX_N-00769-07866200,2023-11-20T20:02:35,Bilbao,expenses,appliances,-325.57,-34287.47
buyer_4,Jorge,50,ES82209578084093320757,TRX_N-00770-58379736,2023-11-23T11:08:16,Galdakao,expenses,repairs,-60.38,-34347.85
buyer_4,Jorge,50,ES82209578084093320757,TRX_N-00771-96156544,2023-11-24T11:37:37,Galdakao,expenses,leisure,-56.85,-34404.7
buyer_4,Jorge,50,ES82209578084093320757,TRX_N-00772-32685828,2023-11-24T18:27:17,Portugalete,expenses,healthcare,-90.02,-34494.72
buyer_4,Jorge,50,ES82209578084093320757,TRX_N-00773-58073622,2023-11-24T01:36:37,Galdakao,expenses,cash,-100.0,-34594.72
buyer_4,Jorge,50,ES82209578084093320757,TRX_N-00774-72635927,2023-11-25T22:51:44,Galdakao,expenses,transport,-66.89,-34661.61
buyer_4,Jorge,50,ES82209578084093320757,TRX_N-00775-75093294,2023-11-28T06:14:32,Galdakao,expenses,food,-119.99,-34781.6
buyer_4,Jorge,50,ES82209578084093320757,TRX_N-00776-09236901,2023-11-28T13:37:27,Galdakao,expenses,repairs,-48.82,-34830.42
buyer_4,Jorge,50,ES82209578084093320757,TRX_N-00777-79698683,2023-11-30T15:55:45,Galdakao,expenses,transport,-43.33,-34873.75
buyer_4,Jorge,50,ES82209578084093320757,TRX_N-00778-69095845,2023-12-01T15:34:36,Galdakao,incomes,salary,1415.52,-33458.23
buyer_4,Jorge,50,ES82209578084093320757,TRX_N-00779-67869701,2023-12-01T15:34:36,Galdakao,incomes,salary_partner,1460.18,-31998.05
buyer_4,Jorge,50,ES82209578084093320757,TRX_N-00780-45780449,2023-12-01T15:34:36,Galdakao,incomes,salary_bonus,1050.22,-30947.83
buyer_4,Jorge,50,ES82209578084093320757,TRX_N-00781-71589529,2023-12-01T15:34:36,Galdakao,incomes,salary_partner_bonus,1084.85,-29862.98
buyer_4,Jorge,50,ES82209578084093320757,TRX_N-00782-49069587,2023-12-01T16:46:06,Galdakao,expenses,children,-84.53,-29947.51
buyer_4,Jorge,50,ES82209578084093320757,TRX_N-00783-81769093,2023-12-02T15:34:59,Galdakao,expenses,healthcare,-50.89,-29998.4
buyer_4,Jorge,50,ES82209578084093320757,TRX_N-00784-91838200,2023-12-03T11:49:16,Galdakao,expenses,clothing,-92.21,-30090.61
buyer_4,Jorge,50,ES82209578084093320757,TRX_N-00785-90386934,2023-12-04T19:59:55,Galdakao,expenses,mortgage,-979.09,-31069.7
buyer_4,Jorge,50,ES82209578084093320757,TRX_N-00786-56306487,2023-12-05T22:08:06,Galdakao,expenses,electricity,-38.85,-31108.55
buyer_4,Jorge,50,ES82209578084093320757,TRX_N-00787-45577609,2023-12-05T17:53:47,Galdakao,expenses,phone,-35.98,-31144.53
buyer_4,Jorge,50,ES82209578084093320757,TRX_N-00788-13764133,2023-12-08T08:47:49,Galdakao,expenses,water,-39.58,-31184.11
buyer_4,Jorge,50,ES82209578084093320757,TRX_N-00789-35529031,2023-12-08T14:08:25,Galdakao,expenses,gas,-104.14,-31288.25
buyer_4,Jorge,50,ES82209578084093320757,TRX_N-00790-25830757,2023-12-08T08:18:22,Galdakao,expenses,internet,-42.0,-31330.25
buyer_4,Jorge,50,ES82209578084093320757,TRX_N-00791-98005565,2023-12-08T20:32:11,Galdakao,expenses,cash,-100.0,-31430.25
buyer_4,Jorge,50,ES82209578084093320757,TRX_N-00792-01534806,2023-12-09T10:16:58,Galdakao,expenses,cash,-100.0,-31530.25
buyer_4,Jorge,50,ES82209578084093320757,TRX_N-00793-69766757,2023-12-10T18:32:24,Galdakao,expenses,food,-92.37,-31622.62
buyer_4,Jorge,50,ES82209578084093320757,TRX_N-00794-37821234,2023-12-10T02:23:25,Galdakao,expenses,transport,-81.96,-31704.58
buyer_4,Jorge,50,ES82209578084093320757,TRX_N-00795-74594596,2023-12-10T00:35:26,Galdakao,expenses,repairs,-319.23,-32023.81
buyer_4,Jorge,50,ES82209578084093320757,TRX_N-00796-78032890,2023-12-13T22:02:30,Galdakao,expenses,healthcare,-189.94,-32213.75
buyer_4,Jorge,50,ES82209578084093320757,TRX_N-00797-83967895,2023-12-14T16:41:51,Galdakao,expenses,leisure,-80.73,-32294.48
buyer_4,Jorge,50,ES82209578084093320757,TRX_N-00798-19815354,2023-12-16T06:04:17,Galdakao,expenses,transport,-88.24,-32382.72
buyer_4,Jorge,50,ES82209578084093320757,TRX_N-00799-03329078,2023-12-17T11:30:36,Zarautz,expenses,transport,-51.92,-32434.64
buyer_4,Jorge,50,ES82209578084093320757,TRX_N-00800-28526024,2023-12-17T12:43:30,Galdakao,expenses,leisure,-30.44,-32465.08
buyer_4,Jorge,50,ES82209578084093320757,TRX_N-00801-24286447,2023-12-22T12:36:02,Galdakao,expenses,cash,-100.0,-32565.08
buyer_4,Jorge,50,ES82209578084093320757,TRX_N-00802-40198600,2023-12-24T10:04:51,Galdakao,expenses,cash,-100.0,-32665.08
buyer_4,Jorge,50,ES82209578084093320757,TRX_N-00803-91017921,2023-12-24T18:29:33,Barakaldo,expenses,appliances,-141.19,-32806.27
buyer_4,Jorge,50,ES82209578084093320757,TRX_N-00804-13891254,2023-12-25T08:38:12,Galdakao,expenses,transport,-69.16,-32875.43
buyer_4,Jorge,50,ES82209578084093320757,TRX_N-00805-45712927,2023-12-25T18:01:09,Galdakao,expenses,leisure,-19.89,-32895.32
buyer_4,Jorge,50,ES82209578084093320757,TRX_N-00806-09208797,2023-12-27T11:17:11,Galdakao,expenses,cash,-100.0,-32995.32
buyer_4,Jorge,50,ES82209578084093320757,TRX_N-00807-47142362,2023-12-28T02:18:06,Galdakao,expenses,education,-52.11,-33047.43
buyer_4,Jorge,50,ES82209578084093320757,TRX_N-00808-68525180,2023-12-29T09:19:41,Galdakao,expenses,cash,-100.0,-33147.43
buyer_4,Jorge,50,ES82209578084093320757,TRX_N-00809-77781892,2023-12-30T08:08:11,Berango,expenses,leisure,-51.62,-33199.05
buyer_4,Jorge,50,ES82209578084093320757,TRX_N-00810-91748304,2023-12-30T18:11:49,Galdakao,expenses,cash,-100.0,-33299.05
buyer_4,Jorge,50,ES82209578084093320757,TRX_N-00811-02201858,2024-01-01T23:29:36,Galdakao,incomes,salary,1459.99,-31839.06
buyer_4,Jorge,50,ES82209578084093320757,TRX_N-00812-64588712,2024-01-01T23:29:36,Galdakao,incomes,salary_partner,1506.05,-30333.01
buyer_4,Jorge,50,ES82209578084093320757,TRX_N-00813-84714793,2024-01-01T23:29:36,Galdakao,incomes,extra_income,218.64,-30114.37
buyer_4,Jorge,50,ES82209578084093320757,TRX_N-00814-05392436,2024-01-02T14:06:39,Galdakao,expenses,repairs,-146.22,-30260.59
buyer_4,Jorge,50,ES82209578084093320757,TRX_N-00815-99684877,2024-01-04T12:50:00,Galdakao,expenses,mortgage,-979.09,-31239.68
buyer_4,Jorge,50,ES82209578084093320757,TRX_N-00816-18683623,2024-01-04T14:37:35,Galdakao,expenses,education,-64.09,-31303.77
buyer_4,Jorge,50,ES82209578084093320757,TRX_N-00817-80598734,2024-01-05T15:37:40,Galdakao,expenses,water,-23.22,-31326.99
buyer_4,Jorge,50,ES82209578084093320757,TRX_N-00818-90824786,2024-01-05T11:26:04,Galdakao,expenses,gas,-77.43,-31404.42
buyer_4,Jorge,50,ES82209578084093320757,TRX_N-00819-25683997,2024-01-05T19:47:08,Galdakao,expenses,phone,-44.36,-31448.78
buyer_4,Jorge,50,ES82209578084093320757,TRX_N-00820-12075282,2024-01-05T19:04:36,Galdakao,expenses,food,-73.35,-31522.13
buyer_4,Jorge,50,ES82209578084093320757,TRX_N-00821-28004396,2024-01-08T13:29:47,Galdakao,expenses,electricity,-79.3,-31601.43
buyer_4,Jorge,50,ES82209578084093320757,TRX_N-00822-49191098,2024-01-08T15:45:27,Galdakao,expenses,internet,-42.0,-31643.43
buyer_4,Jorge,50,ES82209578084093320757,TRX_N-00823-66855113,2024-01-08T08:35:18,Galdakao,expenses,cash,-100.0,-31743.43
buyer_4,Jorge,50,ES82209578084093320757,TRX_N-00824-55064963,2024-01-10T10:52:49,Galdakao,expenses,cash,-100.0,-31843.43
buyer_4,Jorge,50,ES82209578084093320757,TRX_N-00825-24296933,2024-01-12T21:33:45,Galdakao,expenses,cash,-100.0,-31943.43
buyer_4,Jorge,50,ES82209578084093320757,TRX_N-00826-41375523,2024-01-12T20:59:58,Galdakao,expenses,gifts,-152.39,-32095.82
buyer_4,Jorge,50,ES82209578084093320757,TRX_N-00827-74381797,2024-01-13T13:54:51,Galdakao,expenses,cash,-100.0,-32195.82
buyer_4,Jorge,50,ES82209578084093320757,TRX_N-00828-86870267,2024-01-15T23:22:40,Galdakao,expenses,cash,-100.0,-32295.82
buyer_4,Jorge,50,ES82209578084093320757,TRX_N-00829-60382134,2024-01-17T17:45:03,Galdakao,expenses,leisure,-25.86,-32321.68
buyer_4,Jorge,50,ES82209578084093320757,TRX_N-00830-87197039,2024-01-20T19:51:41,Galdakao,expenses,cash,-100.0,-32421.68
buyer_4,Jorge,50,ES82209578084093320757,TRX_N-00831-33154382,2024-01-21T08:39:35,Galdakao,expenses,transport,-42.0,-32463.68
buyer_4,Jorge,50,ES82209578084093320757,TRX_N-00832-74990332,2024-01-21T14:32:11,Galdakao,expenses,leisure,-69.91,-32533.59
buyer_4,Jorge,50,ES82209578084093320757,TRX_N-00833-64311862,2024-01-21T10:47:32,Galdakao,expenses,cash,-100.0,-32633.59
buyer_4,Jorge,50,ES82209578084093320757,TRX_N-00834-11495959,2024-01-22T19:28:39,Galdakao,expenses,transport,-64.37,-32697.96
buyer_4,Jorge,50,ES82209578084093320757,TRX_N-00835-02121431,2024-01-22T20:49:12,Galdakao,expenses,cash,-100.0,-32797.96
buyer_4,Jorge,50,ES82209578084093320757,TRX_N-00836-50264426,2024-01-24T20:42:21,Llodio,expenses,food,-94.07,-32892.03
buyer_4,Jorge,50,ES82209578084093320757,TRX_N-00837-94281972,2024-01-24T03:08:10,Galdakao,expenses,transport,-69.86,-32961.89
buyer_4,Jorge,50,ES82209578084093320757,TRX_N-00838-53089737,2024-01-24T14:30:13,Galdakao,expenses,leisure,-69.88,-33031.77
buyer_4,Jorge,50,ES82209578084093320757,TRX_N-00839-78072349,2024-01-26T08:31:09,Galdakao,expenses,food,-84.19,-33115.96
buyer_4,Jorge,50,ES82209578084093320757,TRX_N-00840-17076747,2024-01-26T01:02:33,Galdakao,expenses,education,-63.74,-33179.7
buyer_4,Jorge,50,ES82209578084093320757,TRX_N-00841-85317231,2024-01-27T17:34:41,Galdakao,expenses,leisure,-68.42,-33248.12
buyer_4,Jorge,50,ES82209578084093320757,TRX_N-00842-52417209,2024-01-28T16:54:30,Galdakao,expenses,leisure,-25.97,-33274.09
buyer_4,Jorge,50,ES82209578084093320757,TRX_N-00843-08167602,2024-01-30T07:51:43,Galdakao,expenses,food,-87.42,-33361.51
buyer_4,Jorge,50,ES82209578084093320757,TRX_N-00844-93310839,2024-01-30T12:41:28,Galdakao,expenses,cash,-100.0,-33461.51
buyer_4,Jorge,50,ES82209578084093320757,TRX_N-00845-67244005,2024-01-31T13:52:42,Galdakao,expenses,cash,-100.0,-33561.51
buyer_4,Jorge,50,ES82209578084093320757,TRX_N-00846-96005956,2024-02-01T15:13:31,Galdakao,incomes,salary,1459.99,-32101.52
buyer_4,Jorge,50,ES82209578084093320757,TRX_N-00847-19237940,2024-02-01T15:13:31,Galdakao,incomes,salary_partner,1506.05,-30595.47
buyer_4,Jorge,50,ES82209578084093320757,TRX_N-00848-04619431,2024-02-03T16:45:53,Galdakao,expenses,leisure,-63.75,-30659.22
buyer_4,Jorge,50,ES82209578084093320757,TRX_N-00849-40631679,2024-02-04T15:04:43,Galdakao,expenses,mortgage,-979.09,-31638.31
buyer_4,Jorge,50,ES82209578084093320757,TRX_N-00850-18402019,2024-02-05T11:18:17,Galdakao,expenses,cash,-100.0,-31738.31
buyer_4,Jorge,50,ES82209578084093320757,TRX_N-00851-74307495,2024-02-06T16:18:58,Galdakao,expenses,food,-107.95,-31846.26
buyer_4,Jorge,50,ES82209578084093320757,TRX_N-00852-58003330,2024-02-07T19:07:15,Galdakao,expenses,water,-28.69,-31874.95
buyer_4,Jorge,50,ES82209578084093320757,TRX_N-00853-34452180,2024-02-07T08:49:34,Galdakao,expenses,electricity,-33.78,-31908.73
buyer_4,Jorge,50,ES82209578084093320757,TRX_N-00854-49163527,2024-02-08T20:41:27,Galdakao,expenses,gas,-101.49,-32010.22
buyer_4,Jorge,50,ES82209578084093320757,TRX_N-00855-96050080,2024-02-08T23:35:33,Galdakao,expenses,internet,-42.0,-32052.22
buyer_4,Jorge,50,ES82209578084093320757,TRX_N-00856-09367797,2024-02-08T22:18:55,Galdakao,expenses,phone,-36.25,-32088.47
buyer_4,Jorge,50,ES82209578084093320757,TRX_N-00857-37155662,2024-02-10T15:29:56,Galdakao,expenses,children,-257.87,-32346.34
buyer_4,Jorge,50,ES82209578084093320757,TRX_N-00858-23528481,2024-02-13T19:48:13,Portugalete,expenses,leisure,-61.21,-32407.55
buyer_4,Jorge,50,ES82209578084093320757,TRX_N-00859-22879001,2024-02-14T18:54:43,Salvatierra/Agurain,expenses,cash,-100.0,-32507.55
buyer_4,Jorge,50,ES82209578084093320757,TRX_N-00860-22072093,2024-02-15T10:07:04,Elciego,expenses,food,-120.52,-32628.07
buyer_4,Jorge,50,ES82209578084093320757,TRX_N-00861-09384516,2024-02-16T09:06:21,Galdakao,expenses,leisure,-68.13,-32696.2
buyer_4,Jorge,50,ES82209578084093320757,TRX_N-00862-83195813,2024-02-16T15:18:34,Galdakao,expenses,cash,-100.0,-32796.2
buyer_4,Jorge,50,ES82209578084093320757,TRX_N-00863-27657683,2024-02-22T08:05:30,Galdakao,expenses,leisure,-31.46,-32827.66
buyer_4,Jorge,50,ES82209578084093320757,TRX_N-00864-80104335,2024-02-22T11:04:50,Zuia,expenses,cash,-100.0,-32927.66
buyer_4,Jorge,50,ES82209578084093320757,TRX_N-00865-11278524,2024-02-22T13:56:47,Galdakao,expenses,travel,-568.53,-33496.19
buyer_4,Jorge,50,ES82209578084093320757,TRX_N-00866-13885139,2024-02-23T23:28:28,Amurrio,expenses,cash,-100.0,-33596.19
buyer_4,Jorge,50,ES82209578084093320757,TRX_N-00867-69993517,2024-02-24T20:06:27,Galdakao,expenses,transport,-86.22,-33682.41
buyer_4,Jorge,50,ES82209578084093320757,TRX_N-00868-37148721,2024-02-25T17:41:44,Galdakao,expenses,children,-228.36,-33910.77
buyer_4,Jorge,50,ES82209578084093320757,TRX_N-00869-18105906,2024-02-27T18:54:31,Galdakao,expenses,leisure,-72.25,-33983.02
buyer_4,Jorge,50,ES82209578084093320757,TRX_N-00870-10929537,2024-02-28T15:38:27,Galdakao,expenses,cash,-100.0,-34083.02
buyer_4,Jorge,50,ES82209578084093320757,TRX_N-00871-83594788,2024-02-29T12:09:52,Barakaldo,expenses,transport,-55.15,-34138.17
buyer_4,Jorge,50,ES82209578084093320757,TRX_N-00872-58117056,2024-03-01T14:07:03,Galdakao,incomes,salary,1459.99,-32678.18
buyer_4,Jorge,50,ES82209578084093320757,TRX_N-00873-10560256,2024-03-01T14:07:03,Galdakao,incomes,salary_partner,1506.05,-31172.13
buyer_4,Jorge,50,ES82209578084093320757,TRX_N-00874-21297308,2024-03-01T11:33:22,Galdakao,expenses,leisure,-79.28,-31251.41
buyer_4,Jorge,50,ES82209578084093320757,TRX_N-00875-65899522,2024-03-02T14:20:02,Galdakao,expenses,cash,-100.0,-31351.41
buyer_4,Jorge,50,ES82209578084093320757,TRX_N-00876-23012436,2024-03-03T18:28:05,Galdakao,expenses,healthcare,-73.07,-31424.48
buyer_4,Jorge,50,ES82209578084093320757,TRX_N-00877-72473872,2024-03-03T23:18:13,Galdakao,expenses,repairs,-307.31,-31731.79
buyer_4,Jorge,50,ES82209578084093320757,TRX_N-00878-59880556,2024-03-04T13:43:06,Galdakao,expenses,mortgage,-979.09,-32710.88
buyer_4,Jorge,50,ES82209578084093320757,TRX_N-00879-43865154,2024-03-05T12:57:07,Galdakao,expenses,gas,-54.37,-32765.25
buyer_4,Jorge,50,ES82209578084093320757,TRX_N-00880-75105389,2024-03-05T18:21:43,Galdakao,expenses,phone,-34.3,-32799.55
buyer_4,Jorge,50,ES82209578084093320757,TRX_N-00881-93579625,2024-03-05T17:10:50,Galdakao,expenses,clothing,-51.12,-32850.67
buyer_4,Jorge,50,ES82209578084093320757,TRX_N-00882-48532140,2024-03-06T22:55:31,Galdakao,expenses,water,-33.57,-32884.24
buyer_4,Jorge,50,ES82209578084093320757,TRX_N-00883-82277048,2024-03-06T20:25:25,Galdakao,expenses,leisure,-51.5,-32935.74
buyer_4,Jorge,50,ES82209578084093320757,TRX_N-00884-85884525,2024-03-07T15:22:12,Lasarte-Oria,expenses,food,-108.8,-33044.54
buyer_4,Jorge,50,ES82209578084093320757,TRX_N-00885-72243043,2024-03-07T20:33:11,Galdakao,expenses,cash,-100.0,-33144.54
buyer_4,Jorge,50,ES82209578084093320757,TRX_N-00886-92142143,2024-03-08T17:36:25,Galdakao,expenses,electricity,-71.69,-33216.23
buyer_4,Jorge,50,ES82209578084093320757,TRX_N-00887-63462624,2024-03-08T02:21:10,Galdakao,expenses,internet,-42.0,-33258.23
buyer_4,Jorge,50,ES82209578084093320757,TRX_N-00888-23353905,2024-03-08T19:00:31,Galdakao,expenses,food,-116.69,-33374.92
buyer_4,Jorge,50,ES82209578084093320757,TRX_N-00889-10968423,2024-03-09T11:37:26,Galdakao,expenses,leisure,-20.99,-33395.91
buyer_4,Jorge,50,ES82209578084093320757,TRX_N-00890-55719261,2024-03-09T11:25:41,Hernani,expenses,healthcare,-45.06,-33440.97
buyer_4,Jorge,50,ES82209578084093320757,TRX_N-00891-92931463,2024-03-12T09:47:35,Galdakao,expenses,leisure,-71.71,-33512.68
buyer_4,Jorge,50,ES82209578084093320757,TRX_N-00892-89431113,2024-03-12T11:10:28,Galdakao,expenses,children,-105.13,-33617.81
buyer_4,Jorge,50,ES82209578084093320757,TRX_N-00893-41153986,2024-03-13T21:52:31,Galdakao,expenses,transport,-47.73,-33665.54
buyer_4,Jorge,50,ES82209578084093320757,TRX_N-00894-52681517,2024-03-14T18:12:29,Galdakao,expenses,clothing,-48.02,-33713.56
buyer_4,Jorge,50,ES82209578084093320757,TRX_N-00895-13664028,2024-03-14T11:28:41,Galdakao,expenses,gifts,-765.25,-34478.81
buyer_4,Jorge,50,ES82209578084093320757,TRX_N-00896-76160565,2024-03-16T04:36:15,Portugalete,expenses,food,-60.54,-34539.35
buyer_4,Jorge,50,ES82209578084093320757,TRX_N-00897-56189262,2024-03-17T01:36:42,Galdakao,expenses,cash,-100.0,-34639.35
buyer_4,Jorge,50,ES82209578084093320757,TRX_N-00898-63604191,2024-03-18T19:44:26,Berango,expenses,leisure,-38.54,-34677.89
buyer_4,Jorge,50,ES82209578084093320757,TRX_N-00899-62521958,2024-03-18T16:26:26,Galdakao,expenses,children,-120.13,-34798.02
buyer_4,Jorge,50,ES82209578084093320757,TRX_N-00900-01117022,2024-03-20T12:16:18,Galdakao,expenses,cash,-100.0,-34898.02
buyer_4,Jorge,50,ES82209578084093320757,TRX_N-00901-06015665,2024-03-27T10:44:04,Galdakao,expenses,repairs,-55.33,-34953.35
buyer_4,Jorge,50,ES82209578084093320757,TRX_N-00902-59668653,2024-03-28T14:05:18,Galdakao,expenses,food,-72.96,-35026.31
buyer_4,Jorge,50,ES82209578084093320757,TRX_N-00903-71837852,2024-03-28T20:34:55,Galdakao,expenses,cash,-100.0,-35126.31
buyer_4,Jorge,50,ES82209578084093320757,TRX_N-00904-71966054,2024-03-31T07:44:21,Galdakao,expenses,transport,-80.14,-35206.45
buyer_4,Jorge,50,ES82209578084093320757,TRX_N-00905-31963310,2024-04-01T20:55:36,Galdakao,incomes,salary,1459.99,-33746.46
buyer_4,Jorge,50,ES82209578084093320757,TRX_N-00906-36906308,2024-04-01T20:55:36,Galdakao,incomes,salary_partner,1506.05,-32240.41
buyer_4,Jorge,50,ES82209578084093320757,TRX_N-00907-92556146,2024-04-04T12:09:17,Galdakao,expenses,mortgage,-979.09,-33219.5
buyer_4,Jorge,50,ES82209578084093320757,TRX_N-00908-43355296,2024-04-04T14:51:40,Galdakao,expenses,food,-102.65,-33322.15
buyer_4,Jorge,50,ES82209578084093320757,TRX_N-00909-93654178,2024-04-05T13:58:58,Galdakao,expenses,water,-38.99,-33361.14
buyer_4,Jorge,50,ES82209578084093320757,TRX_N-00910-44884986,2024-04-05T09:13:10,Bermeo,expenses,leisure,-31.52,-33392.66
buyer_4,Jorge,50,ES82209578084093320757,TRX_N-00911-03148804,2024-04-06T12:34:59,Galdakao,expenses,gas,-104.22,-33496.88
buyer_4,Jorge,50,ES82209578084093320757,TRX_N-00912-02854044,2024-04-06T09:51:55,Galdakao,expenses,internet,-42.0,-33538.88
buyer_4,Jorge,50,ES82209578084093320757,TRX_N-00913-94580986,2024-04-06T08:32:43,Getxo,expenses,food,-117.68,-33656.56
buyer_4,Jorge,50,ES82209578084093320757,TRX_N-00914-41858368,2024-04-07T14:30:37,Galdakao,expenses,electricity,-71.09,-33727.65
buyer_4,Jorge,50,ES82209578084093320757,TRX_N-00915-01882034,2024-04-07T14:37:21,Galdakao,expenses,cash,-100.0,-33827.65
buyer_4,Jorge,50,ES82209578084093320757,TRX_N-00916-80436844,2024-04-08T16:33:07,Galdakao,expenses,phone,-34.88,-33862.53
buyer_4,Jorge,50,ES82209578084093320757,TRX_N-00917-49337475,2024-04-08T14:07:03,Galdakao,expenses,cash,-100.0,-33962.53
buyer_4,Jorge,50,ES82209578084093320757,TRX_N-00918-33930082,2024-04-08T18:44:22,Galdakao,expenses,gifts,-234.94,-34197.47
buyer_4,Jorge,50,ES82209578084093320757,TRX_N-00919-64993020,2024-04-09T11:55:30,Galdakao,expenses,food,-105.7,-34303.17
buyer_4,Jorge,50,ES82209578084093320757,TRX_N-00920-93872633,2024-04-10T16:00:21,Galdakao,expenses,cash,-100.0,-34403.17
buyer_4,Jorge,50,ES82209578084093320757,TRX_N-00921-28962151,2024-04-10T15:58:46,Galdakao,expenses,children,-178.97,-34582.14
buyer_4,Jorge,50,ES82209578084093320757,TRX_N-00922-05059843,2024-04-13T08:07:46,Galdakao,expenses,education,-44.47,-34626.61
buyer_4,Jorge,50,ES82209578084093320757,TRX_N-00923-06298295,2024-04-15T09:56:09,Galdakao,expenses,transport,-69.82,-34696.43
buyer_4,Jorge,50,ES82209578084093320757,TRX_N-00924-97664988,2024-04-15T15:55:39,Galdakao,expenses,education,-53.09,-34749.52
buyer_4,Jorge,50,ES82209578084093320757,TRX_N-00925-83055987,2024-04-15T01:29:37,Galdakao,expenses,repairs,-32.98,-34782.5
buyer_4,Jorge,50,ES82209578084093320757,TRX_N-00926-62597249,2024-04-21T13:04:27,Galdakao,expenses,food,-90.42,-34872.92
buyer_4,Jorge,50,ES82209578084093320757,TRX_N-00927-63730887,2024-04-23T02:50:58,Galdakao,expenses,repairs,-237.16,-35110.08
buyer_4,Jorge,50,ES82209578084093320757,TRX_N-00928-85113151,2024-04-26T18:14:39,Galdakao,expenses,healthcare,-47.39,-35157.47
buyer_4,Jorge,50,ES82209578084093320757,TRX_N-00929-91028238,2024-04-27T08:52:44,Galdakao,expenses,transport,-62.46,-35219.93
buyer_4,Jorge,50,ES82209578084093320757,TRX_N-00930-20974362,2024-04-28T14:57:28,Zuia,expenses,transport,-78.49,-35298.42
buyer_4,Jorge,50,ES82209578084093320757,TRX_N-00931-90160940,2024-04-29T20:24:10,Galdakao,expenses,transport,-47.45,-35345.87
buyer_4,Jorge,50,ES82209578084093320757,TRX_N-00932-70423403,2024-04-29T21:34:53,Galdakao,expenses,children,-88.32,-35434.19
buyer_4,Jorge,50,ES82209578084093320757,TRX_N-00933-48999125,2024-04-30T08:54:01,Galdakao,expenses,transport,-82.81,-35517.0
buyer_4,Jorge,50,ES82209578084093320757,TRX_N-00934-54922916,2024-04-30T16:39:09,Galdakao,expenses,cash,-100.0,-35617.0
buyer_4,Jorge,50,ES82209578084093320757,TRX_N-00935-55124305,2024-05-01T08:48:36,Galdakao,incomes,salary,1459.99,-34157.01
buyer_4,Jorge,50,ES82209578084093320757,TRX_N-00936-66920480,2024-05-01T08:48:36,Galdakao,incomes,salary_partner,1506.05,-32650.96
buyer_4,Jorge,50,ES82209578084093320757,TRX_N-00937-00655184,2024-05-01T08:48:36,Galdakao,incomes,extra_income,218.64,-32432.32
buyer_4,Jorge,50,ES82209578084093320757,TRX_N-00938-20011320,2024-05-02T22:35:15,Leioa,expenses,repairs,-302.0,-32734.32
buyer_4,Jorge,50,ES82209578084093320757,TRX_N-00939-16128911,2024-05-04T06:39:47,Galdakao,expenses,mortgage,-979.09,-33713.41
buyer_4,Jorge,50,ES82209578084093320757,TRX_N-00940-99965337,2024-05-04T08:55:26,Galdakao,expenses,leisure,-26.31,-33739.72
buyer_4,Jorge,50,ES82209578084093320757,TRX_N-00941-87078283,2024-05-04T19:18:50,Galdakao,expenses,travel,-1689.5,-35429.22
buyer_4,Jorge,50,ES82209578084093320757,TRX_N-00942-83103248,2024-05-06T15:12:52,Galdakao,expenses,phone,-36.22,-35465.44
buyer_4,Jorge,50,ES82209578084093320757,TRX_N-00943-93471821,2024-05-06T15:59:26,Galdakao,expenses,food,-65.46,-35530.9
buyer_4,Jorge,50,ES82209578084093320757,TRX_N-00944-96624220,2024-05-07T08:47:36,Galdakao,expenses,electricity,-70.49,-35601.39
buyer_4,Jorge,50,ES82209578084093320757,TRX_N-00945-66122481,2024-05-08T18:48:23,Galdakao,expenses,water,-38.1,-35639.49
buyer_4,Jorge,50,ES82209578084093320757,TRX_N-00946-32110318,2024-05-08T11:01:36,Galdakao,expenses,gas,-44.39,-35683.88
buyer_4,Jorge,50,ES82209578084093320757,TRX_N-00947-48005819,2024-05-08T06:53:34,Galdakao,expenses,internet,-42.0,-35725.88
buyer_4,Jorge,50,ES82209578084093320757,TRX_N-00948-22430045,2024-05-09T17:06:40,Galdakao,expenses,transport,-71.3,-35797.18
buyer_4,Jorge,50,ES82209578084093320757,TRX_N-00949-00434178,2024-05-09T08:50:33,Galdakao,expenses,cash,-100.0,-35897.18
buyer_4,Jorge,50,ES82209578084093320757,TRX_N-00950-09781989,2024-05-10T19:50:39,Galdakao,expenses,transport,-73.64,-35970.82
buyer_4,Jorge,50,ES82209578084093320757,TRX_N-00951-63242489,2024-05-13T14:00:47,Hondarribia,expenses,food,-97.33,-36068.15
buyer_4,Jorge,50,ES82209578084093320757,TRX_N-00952-36686140,2024-05-14T10:26:38,Galdakao,expenses,food,-113.28,-36181.43
buyer_4,Jorge,50,ES82209578084093320757,TRX_N-00953-75129085,2024-05-14T16:38:10,Galdakao,expenses,leisure,-81.67,-36263.1
buyer_4,Jorge,50,ES82209578084093320757,TRX_N-00954-44370783,2024-05-15T13:52:02,Galdakao,expenses,leisure,-79.52,-36342.62
buyer_4,Jorge,50,ES82209578084093320757,TRX_N-00955-04173879,2024-05-16T15:28:04,Oyón-Oion,expenses,transport,-82.11,-36424.73
buyer_4,Jorge,50,ES82209578084093320757,TRX_N-00956-84950936,2024-05-16T03:29:43,Galdakao,expenses,education,-48.9,-36473.63
buyer_4,Jorge,50,ES82209578084093320757,TRX_N-00957-32546048,2024-05-17T13:53:36,Galdakao,expenses,appliances,-120.99,-36594.62
buyer_4,Jorge,50,ES82209578084093320757,TRX_N-00958-11201985,2024-05-18T11:14:50,Galdakao,expenses,leisure,-29.19,-36623.81
buyer_4,Jorge,50,ES82209578084093320757,TRX_N-00959-54774744,2024-05-18T08:44:55,Galdakao,expenses,children,-205.95,-36829.76
buyer_4,Jorge,50,ES82209578084093320757,TRX_N-00960-62183339,2024-05-19T19:57:40,Galdakao,expenses,transport,-81.89,-36911.65
buyer_4,Jorge,50,ES82209578084093320757,TRX_N-00961-63158182,2024-05-24T11:43:08,Galdakao,expenses,food,-118.3,-37029.95
buyer_4,Jorge,50,ES82209578084093320757,TRX_N-00962-23874097,2024-05-24T10:30:18,Galdakao,expenses,cash,-100.0,-37129.95
buyer_4,Jorge,50,ES82209578084093320757,TRX_N-00963-49457540,2024-05-24T12:43:37,Galdakao,expenses,travel,-491.08,-37621.03
buyer_4,Jorge,50,ES82209578084093320757,TRX_N-00964-21986136,2024-05-25T13:05:38,Galdakao,expenses,repairs,-326.89,-37947.92
buyer_4,Jorge,50,ES82209578084093320757,TRX_N-00965-77940776,2024-05-27T08:29:41,Hernani,expenses,cash,-100.0,-38047.92
buyer_4,Jorge,50,ES82209578084093320757,TRX_N-00966-40590849,2024-05-29T13:46:27,Galdakao,expenses,food,-109.08,-38157.0
buyer_4,Jorge,50,ES82209578084093320757,TRX_N-00967-15944447,2024-05-29T08:57:01,Galdakao,expenses,leisure,-26.42,-38183.42
buyer_4,Jorge,50,ES82209578084093320757,TRX_N-00968-33973690,2024-05-31T18:59:15,Galdakao,expenses,cash,-100.0,-38283.42
buyer_4,Jorge,50,ES82209578084093320757,TRX_N-00969-25642406,2024-06-01T11:22:59,Galdakao,incomes,salary,1459.99,-36823.43
buyer_4,Jorge,50,ES82209578084093320757,TRX_N-00970-85411266,2024-06-01T11:22:59,Galdakao,incomes,salary_partner,1506.05,-35317.38
buyer_4,Jorge,50,ES82209578084093320757,TRX_N-00971-88331740,2024-06-01T11:22:59,Galdakao,incomes,salary_bonus,1040.2,-34277.18
buyer_4,Jorge,50,ES82209578084093320757,TRX_N-00972-98989072,2024-06-01T11:22:59,Galdakao,incomes,salary_partner_bonus,1183.41,-33093.77
buyer_4,Jorge,50,ES82209578084093320757,TRX_N-00973-53865138,2024-06-01T12:42:09,Galdakao,expenses,cash,-100.0,-33193.77
buyer_4,Jorge,50,ES82209578084093320757,TRX_N-00974-33985379,2024-06-04T08:13:17,Galdakao,expenses,mortgage,-979.09,-34172.86
buyer_4,Jorge,50,ES82209578084093320757,TRX_N-00975-63615283,2024-06-04T16:06:04,Galdakao,expenses,children,-267.39,-34440.25
buyer_4,Jorge,50,ES82209578084093320757,TRX_N-00976-10435854,2024-06-05T09:02:41,Galdakao,expenses,electricity,-63.87,-34504.12
buyer_4,Jorge,50,ES82209578084093320757,TRX_N-00977-38236440,2024-06-05T19:20:20,Galdakao,expenses,phone,-39.45,-34543.57
buyer_4,Jorge,50,ES82209578084093320757,TRX_N-00978-20071083,2024-06-05T16:27:51,Galdakao,expenses,cash,-100.0,-34643.57
buyer_4,Jorge,50,ES82209578084093320757,TRX_N-00979-41886171,2024-06-05T16:19:38,Galdakao,expenses,repairs,-255.95,-34899.52
buyer_4,Jorge,50,ES82209578084093320757,TRX_N-00980-53822062,2024-06-06T18:49:44,Galdakao,expenses,appliances,-261.32,-35160.84
buyer_4,Jorge,50,ES82209578084093320757,TRX_N-00981-90076219,2024-06-07T08:20:09,Galdakao,expenses,transport,-81.67,-35242.51
buyer_4,Jorge,50,ES82209578084093320757,TRX_N-00982-00684249,2024-06-07T12:54:18,Galdakao,expenses,cash,-100.0,-35342.51
buyer_4,Jorge,50,ES82209578084093320757,TRX_N-00983-72970479,2024-06-08T12:17:04,Galdakao,expenses,water,-27.27,-35369.78
buyer_4,Jorge,50,ES82209578084093320757,TRX_N-00984-34849083,2024-06-08T21:30:21,Galdakao,expenses,gas,-74.55,-35444.33
buyer_4,Jorge,50,ES82209578084093320757,TRX_N-00985-06079279,2024-06-08T19:10:10,Galdakao,expenses,internet,-42.0,-35486.33
buyer_4,Jorge,50,ES82209578084093320757,TRX_N-00986-46069983,2024-06-09T23:12:34,Galdakao,expenses,leisure,-22.97,-35509.3
buyer_4,Jorge,50,ES82209578084093320757,TRX_N-00987-86704772,2024-06-09T18:28:00,Galdakao,expenses,cash,-100.0,-35609.3
buyer_4,Jorge,50,ES82209578084093320757,TRX_N-00988-07786514,2024-06-09T03:46:37,Galdakao,expenses,children,-153.66,-35762.96
buyer_4,Jorge,50,ES82209578084093320757,TRX_N-00989-18803066,2024-06-10T16:32:03,Galdakao,expenses,leisure,-79.75,-35842.71
buyer_4,Jorge,50,ES82209578084093320757,TRX_N-00990-51476960,2024-06-12T08:51:19,Galdakao,expenses,leisure,-54.37,-35897.08
buyer_4,Jorge,50,ES82209578084093320757,TRX_N-00991-21533492,2024-06-14T11:13:34,Galdakao,expenses,leisure,-27.99,-35925.07
buyer_4,Jorge,50,ES82209578084093320757,TRX_N-00992-57332599,2024-06-16T08:52:38,Galdakao,expenses,cash,-100.0,-36025.07
buyer_4,Jorge,50,ES82209578084093320757,TRX_N-00993-09780681,2024-06-18T16:29:37,Galdakao,expenses,leisure,-48.02,-36073.09
buyer_4,Jorge,50,ES82209578084093320757,TRX_N-00994-01147073,2024-06-18T15:15:11,Barakaldo,expenses,clothing,-50.25,-36123.34
buyer_4,Jorge,50,ES82209578084093320757,TRX_N-00995-97831602,2024-06-18T02:29:25,Galdakao,expenses,children,-138.4,-36261.74
buyer_4,Jorge,50,ES82209578084093320757,TRX_N-00996-80346404,2024-06-19T08:23:39,Galdakao,expenses,repairs,-174.62,-36436.36
buyer_4,Jorge,50,ES82209578084093320757,TRX_N-00997-59663070,2024-06-20T13:58:48,Galdakao,expenses,food,-114.17,-36550.53
buyer_4,Jorge,50,ES82209578084093320757,TRX_N-00998-40492756,2024-06-20T16:53:45,Galdakao,expenses,education,-57.74,-36608.27
buyer_4,Jorge,50,ES82209578084093320757,TRX_N-00999-00870470,2024-06-21T09:15:44,Galdakao,expenses,food,-123.84,-36732.11
buyer_4,Jorge,50,ES82209578084093320757,TRX_N-01000-71704230,2024-06-21T14:58:08,Galdakao,expenses,travel,-1563.61,-38295.72
buyer_4,Jorge,50,ES82209578084093320757,TRX_N-01001-02628550,2024-06-22T14:55:33,Galdakao,expenses,food,-84.16,-38379.88
buyer_4,Jorge,50,ES82209578084093320757,TRX_N-01002-56905408,2024-06-22T09:00:40,Galdakao,expenses,cash,-100.0,-38479.88
buyer_4,Jorge,50,ES82209578084093320757,TRX_N-01003-07791079,2024-06-23T12:51:27,Portugalete,expenses,clothing,-110.49,-38590.37
buyer_4,Jorge,50,ES82209578084093320757,TRX_N-01004-98477471,2024-06-25T14:53:42,Galdakao,expenses,education,-76.41,-38666.78
buyer_4,Jorge,50,ES82209578084093320757,TRX_N-01005-03030057,2024-06-25T14:50:55,Bermeo,expenses,cash,-100.0,-38766.78
buyer_4,Jorge,50,ES82209578084093320757,TRX_N-01006-41804607,2024-06-26T12:23:53,Galdakao,expenses,food,-92.81,-38859.59
buyer_4,Jorge,50,ES82209578084093320757,TRX_N-01007-24375986,2024-06-26T21:39:54,Galdakao,expenses,leisure,-22.03,-38881.62
buyer_4,Jorge,50,ES82209578084093320757,TRX_N-01008-39778266,2024-06-26T01:10:53,Galdakao,expenses,children,-129.05,-39010.67
buyer_4,Jorge,50,ES82209578084093320757,TRX_N-01009-86365581,2024-06-28T19:02:06,Portugalete,expenses,food,-74.45,-39085.12
buyer_4,Jorge,50,ES82209578084093320757,TRX_N-01010-79116718,2024-07-01T12:03:14,Galdakao,incomes,salary,1459.99,-37625.13
buyer_4,Jorge,50,ES82209578084093320757,TRX_N-01011-54657434,2024-07-01T12:03:14,Galdakao,incomes,salary_partner,1506.05,-36119.08
buyer_4,Jorge,50,ES82209578084093320757,TRX_N-01012-55352760,2024-07-01T09:59:06,Berango,expenses,leisure,-58.9,-36177.98
buyer_4,Jorge,50,ES82209578084093320757,TRX_N-01013-95747923,2024-07-03T02:12:14,Hernani,expenses,gifts,-559.43,-36737.41
buyer_4,Jorge,50,ES82209578084093320757,TRX_N-01014-52014118,2024-07-04T14:10:01,Galdakao,expenses,mortgage,-979.09,-37716.5
buyer_4,Jorge,50,ES82209578084093320757,TRX_N-01015-05996311,2024-07-04T22:38:25,Oyón-Oion,expenses,leisure,-34.28,-37750.78
buyer_4,Jorge,50,ES82209578084093320757,TRX_N-01016-33047059,2024-07-05T10:40:02,Galdakao,expenses,cash,-100.0,-37850.78
buyer_4,Jorge,50,ES82209578084093320757,TRX_N-01017-45118972,2024-07-06T19:00:25,Galdakao,expenses,electricity,-37.43,-37888.21
buyer_4,Jorge,50,ES82209578084093320757,TRX_N-01018-26662792,2024-07-07T16:56:26,Galdakao,expenses,gas,-69.91,-37958.12
buyer_4,Jorge,50,ES82209578084093320757,TRX_N-01019-69248197,2024-07-08T23:58:49,Galdakao,expenses,water,-35.25,-37993.37
buyer_4,Jorge,50,ES82209578084093320757,TRX_N-01020-01137280,2024-07-08T13:42:02,Galdakao,expenses,internet,-42.0,-38035.37
buyer_4,Jorge,50,ES82209578084093320757,TRX_N-01021-36646337,2024-07-08T06:40:51,Galdakao,expenses,phone,-36.88,-38072.25
buyer_4,Jorge,50,ES82209578084093320757,TRX_N-01022-26205786,2024-07-08T16:24:23,Galdakao,expenses,leisure,-71.09,-38143.34
buyer_4,Jorge,50,ES82209578084093320757,TRX_N-01023-21676243,2024-07-09T15:47:16,Galdakao,expenses,transport,-88.89,-38232.23
buyer_4,Jorge,50,ES82209578084093320757,TRX_N-01024-24525638,2024-07-09T19:11:37,Galdakao,expenses,cash,-100.0,-38332.23
buyer_4,Jorge,50,ES82209578084093320757,TRX_N-01025-60831781,2024-07-12T16:24:20,Galdakao,expenses,transport,-51.87,-38384.1
buyer_4,Jorge,50,ES82209578084093320757,TRX_N-01026-34229027,2024-07-13T10:26:44,Galdakao,expenses,transport,-64.92,-38449.02
buyer_4,Jorge,50,ES82209578084093320757,TRX_N-01027-84309169,2024-07-13T16:50:49,Galdakao,expenses,children,-88.88,-38537.9
buyer_4,Jorge,50,ES82209578084093320757,TRX_N-01028-02168813,2024-07-14T13:51:38,Galdakao,expenses,clothing,-136.83,-38674.73
buyer_4,Jorge,50,ES82209578084093320757,TRX_N-01029-26632691,2024-07-14T15:06:24,Galdakao,expenses,cash,-100.0,-38774.73
buyer_4,Jorge,50,ES82209578084093320757,TRX_N-01030-21902059,2024-07-16T14:12:56,Galdakao,expenses,transport,-77.8,-38852.53
buyer_4,Jorge,50,ES82209578084093320757,TRX_N-01031-08420717,2024-07-18T17:03:12,Galdakao,expenses,transport,-40.56,-38893.09
buyer_4,Jorge,50,ES82209578084093320757,TRX_N-01032-95888381,2024-07-18T15:28:15,Galdakao,expenses,education,-67.87,-38960.96
buyer_4,Jorge,50,ES82209578084093320757,TRX_N-01033-47088966,2024-07-20T09:09:26,Galdakao,expenses,children,-153.04,-39114.0
buyer_4,Jorge,50,ES82209578084093320757,TRX_N-01034-46431237,2024-07-21T14:25:55,Galdakao,expenses,leisure,-67.62,-39181.62
buyer_4,Jorge,50,ES82209578084093320757,TRX_N-01035-84103161,2024-07-21T12:51:06,Galdakao,expenses,clothing,-141.34,-39322.96
buyer_4,Jorge,50,ES82209578084093320757,TRX_N-01036-84004252,2024-07-21T10:23:16,Galdakao,expenses,cash,-100.0,-39422.96
buyer_4,Jorge,50,ES82209578084093320757,TRX_N-01037-78332881,2024-07-23T09:44:32,Galdakao,expenses,food,-60.32,-39483.28
buyer_4,Jorge,50,ES82209578084093320757,TRX_N-01038-67521106,2024-07-23T14:17:41,Galdakao,expenses,transport,-54.61,-39537.89
buyer_4,Jorge,50,ES82209578084093320757,TRX_N-01039-82885760,2024-07-23T12:36:16,Galdakao,expenses,leisure,-29.52,-39567.41
buyer_4,Jorge,50,ES82209578084093320757,TRX_N-01040-07382275,2024-07-23T16:17:46,Galdakao,expenses,clothing,-89.84,-39657.25
buyer_4,Jorge,50,ES82209578084093320757,TRX_N-01041-67174873,2024-07-25T08:09:25,Galdakao,expenses,cash,-100.0,-39757.25
buyer_4,Jorge,50,ES82209578084093320757,TRX_N-01042-69582965,2024-07-27T18:04:24,Errenteria,expenses,food,-73.85,-39831.1
buyer_4,Jorge,50,ES82209578084093320757,TRX_N-01043-85807827,2024-07-27T18:43:42,Galdakao,expenses,transport,-40.44,-39871.54
buyer_4,Jorge,50,ES82209578084093320757,TRX_N-01044-79752888,2024-07-29T03:22:28,Galdakao,expenses,leisure,-54.65,-39926.19
buyer_4,Jorge,50,ES82209578084093320757,TRX_N-01045-71320356,2024-07-29T12:40:05,Galdakao,expenses,cash,-100.0,-40026.19
buyer_4,Jorge,50,ES82209578084093320757,TRX_N-01046-55646506,2024-07-31T11:33:53,Galdakao,expenses,healthcare,-126.85,-40153.04
buyer_4,Jorge,50,ES82209578084093320757,TRX_N-01047-23369494,2024-07-31T23:24:07,Pasaia,expenses,cash,-100.0,-40253.04
buyer_4,Jorge,50,ES82209578084093320757,TRX_N-01048-19644442,2024-08-01T12:08:05,Galdakao,incomes,salary,1459.99,-38793.05
buyer_4,Jorge,50,ES82209578084093320757,TRX_N-01049-34647745,2024-08-01T12:08:05,Galdakao,incomes,salary_partner,1506.05,-37287.0
buyer_4,Jorge,50,ES82209578084093320757,TRX_N-01050-03033651,2024-08-01T12:08:05,Galdakao,incomes,extra_income,218.64,-37068.36
buyer_4,Jorge,50,ES82209578084093320757,TRX_N-01051-21131150,2024-08-01T08:06:46,Galdakao,expenses,food,-90.16,-37158.52
buyer_4,Jorge,50,ES82209578084093320757,TRX_N-01052-22745358,2024-08-01T19:18:00,Galdakao,expenses,cash,-100.0,-37258.52
buyer_4,Jorge,50,ES82209578084093320757,TRX_N-01053-02066341,2024-08-01T10:58:04,Galdakao,expenses,children,-128.13,-37386.65
buyer_4,Jorge,50,ES82209578084093320757,TRX_N-01054-74999643,2024-08-02T10:53:05,Galdakao,expenses,food,-109.7,-37496.35
buyer_4,Jorge,50,ES82209578084093320757,TRX_N-01055-67399566,2024-08-03T01:59:53,Galdakao,expenses,cash,-100.0,-37596.35
buyer_4,Jorge,50,ES82209578084093320757,TRX_N-01056-76361896,2024-08-03T19:49:42,Galdakao,expenses,gifts,-197.82,-37794.17
buyer_4,Jorge,50,ES82209578084093320757,TRX_N-01057-33534934,2024-08-04T07:14:53,Galdakao,expenses,mortgage,-979.09,-38773.26
buyer_4,Jorge,50,ES82209578084093320757,TRX_N-01058-99435059,2024-08-06T10:54:26,Galdakao,expenses,internet,-42.0,-38815.26
buyer_4,Jorge,50,ES82209578084093320757,TRX_N-01059-82406985,2024-08-06T16:20:45,Santurtzi,expenses,food,-64.73,-38879.99
buyer_4,Jorge,50,ES82209578084093320757,TRX_N-01060-04141795,2024-08-06T17:53:51,Galdakao,expenses,clothing,-159.0,-39038.99
buyer_4,Jorge,50,ES82209578084093320757,TRX_N-01061-30231651,2024-08-07T18:28:17,Galdakao,expenses,water,-40.5,-39079.49
buyer_4,Jorge,50,ES82209578084093320757,TRX_N-01062-52419914,2024-08-07T11:58:47,Galdakao,expenses,electricity,-24.63,-39104.12
buyer_4,Jorge,50,ES82209578084093320757,TRX_N-01063-64513523,2024-08-08T09:50:17,Galdakao,expenses,gas,-102.54,-39206.66
buyer_4,Jorge,50,ES82209578084093320757,TRX_N-01064-89086025,2024-08-08T20:18:40,Galdakao,expenses,phone,-35.6,-39242.26
buyer_4,Jorge,50,ES82209578084093320757,TRX_N-01065-48564915,2024-08-09T14:38:08,Galdakao,expenses,appliances,-139.54,-39381.8
buyer_4,Jorge,50,ES82209578084093320757,TRX_N-01066-17620744,2024-08-09T15:33:27,Irun,expenses,repairs,-176.42,-39558.22
buyer_4,Jorge,50,ES82209578084093320757,TRX_N-01067-92881834,2024-08-11T23:19:51,Galdakao,expenses,healthcare,-184.91,-39743.13
buyer_4,Jorge,50,ES82209578084093320757,TRX_N-01068-36776259,2024-08-14T16:31:07,Andoain,expenses,food,-67.16,-39810.29
buyer_4,Jorge,50,ES82209578084093320757,TRX_N-01069-29492354,2024-08-14T13:24:40,Galdakao,expenses,repairs,-94.68,-39904.97
buyer_4,Jorge,50,ES82209578084093320757,TRX_N-01070-01947634,2024-08-16T18:45:01,Galdakao,expenses,transport,-76.16,-39981.13
buyer_4,Jorge,50,ES82209578084093320757,TRX_N-01071-47910419,2024-08-16T15:55:06,Galdakao,expenses,education,-58.62,-40039.75
buyer_4,Jorge,50,ES82209578084093320757,TRX_N-01072-66344126,2024-08-19T16:11:20,Galdakao,expenses,travel,-1110.51,-41150.26
buyer_4,Jorge,50,ES82209578084093320757,TRX_N-01073-37202811,2024-08-21T08:33:20,Galdakao,expenses,food,-93.94,-41244.2
buyer_4,Jorge,50,ES82209578084093320757,TRX_N-01074-04443966,2024-08-21T20:16:42,Irun,expenses,gifts,-505.13,-41749.33
buyer_4,Jorge,50,ES82209578084093320757,TRX_N-01075-23825216,2024-08-22T17:39:06,Galdakao,expenses,clothing,-102.5,-41851.83
buyer_4,Jorge,50,ES82209578084093320757,TRX_N-01076-71024301,2024-08-23T21:38:31,Galdakao,expenses,healthcare,-173.23,-42025.06
buyer_4,Jorge,50,ES82209578084093320757,TRX_N-01077-10254624,2024-08-25T09:34:54,Galdakao,expenses,gifts,-331.92,-42356.98
buyer_4,Jorge,50,ES82209578084093320757,TRX_N-01078-53024965,2024-08-27T16:57:42,Galdakao,expenses,cash,-100.0,-42456.98
buyer_4,Jorge,50,ES82209578084093320757,TRX_N-01079-31847743,2024-08-28T14:50:28,Galdakao,expenses,children,-168.88,-42625.86
buyer_4,Jorge,50,ES82209578084093320757,TRX_N-01080-39101191,2024-08-29T06:36:38,Galdakao,expenses,leisure,-34.94,-42660.8
buyer_4,Jorge,50,ES82209578084093320757,TRX_N-01081-23758981,2024-08-30T21:26:53,Galdakao,expenses,food,-73.72,-42734.52
buyer_4,Jorge,50,ES82209578084093320757,TRX_N-01082-56142241,2024-08-30T19:30:21,Galdakao,expenses,leisure,-42.01,-42776.53
buyer_4,Jorge,50,ES82209578084093320757,TRX_N-01083-12298783,2024-08-30T19:50:20,Galdakao,expenses,clothing,-88.86,-42865.39
buyer_4,Jorge,50,ES82209578084093320757,TRX_N-01084-34690429,2024-08-30T08:50:12,Galdakao,expenses,appliances,-353.89,-43219.28
buyer_4,Jorge,50,ES82209578084093320757,TRX_N-01085-93791780,2024-08-31T17:09:40,Galdakao,expenses,repairs,-147.37,-43366.65
buyer_4,Jorge,50,ES82209578084093320757,TRX_N-01086-13722066,2024-08-31T13:44:45,Galdakao,expenses,gifts,-759.7,-44126.35
buyer_4,Jorge,50,ES82209578084093320757,TRX_N-01087-99484182,2024-09-01T19:22:08,Galdakao,incomes,salary,1459.99,-42666.36
buyer_4,Jorge,50,ES82209578084093320757,TRX_N-01088-06058910,2024-09-01T19:22:08,Galdakao,incomes,salary_partner,1506.05,-41160.31
buyer_4,Jorge,50,ES82209578084093320757,TRX_N-01089-93964781,2024-09-02T13:38:47,Galdakao,expenses,leisure,-48.01,-41208.32
buyer_4,Jorge,50,ES82209578084093320757,TRX_N-01090-91920903,2024-09-02T09:39:25,Galdakao,expenses,cash,-100.0,-41308.32
buyer_4,Jorge,50,ES82209578084093320757,TRX_N-01091-78451273,2024-09-03T08:56:15,Galdakao,expenses,leisure,-26.94,-41335.26
buyer_4,Jorge,50,ES82209578084093320757,TRX_N-01092-14333127,2024-09-04T20:56:21,Galdakao,expenses,mortgage,-979.09,-42314.35
buyer_4,Jorge,50,ES82209578084093320757,TRX_N-01093-51106991,2024-09-05T20:52:53,Galdakao,expenses,water,-38.35,-42352.7
buyer_4,Jorge,50,ES82209578084093320757,TRX_N-01094-50101836,2024-09-05T08:38:04,Galdakao,expenses,leisure,-31.69,-42384.39
buyer_4,Jorge,50,ES82209578084093320757,TRX_N-01095-52016143,2024-09-05T13:24:03,Iruña de Oca,expenses,gifts,-543.89,-42928.28
buyer_4,Jorge,50,ES82209578084093320757,TRX_N-01096-59038846,2024-09-06T09:19:22,Galdakao,expenses,internet,-42.0,-42970.28
buyer_4,Jorge,50,ES82209578084093320757,TRX_N-01097-63137161,2024-09-06T19:50:20,Galdakao,expenses,cash,-100.0,-43070.28
buyer_4,Jorge,50,ES82209578084093320757,TRX_N-01098-08196860,2024-09-07T03:19:29,Galdakao,expenses,gas,-69.39,-43139.67
buyer_4,Jorge,50,ES82209578084093320757,TRX_N-01099-89884168,2024-09-08T17:39:31,Galdakao,expenses,electricity,-36.12,-43175.79
buyer_4,Jorge,50,ES82209578084093320757,TRX_N-01100-17037326,2024-09-08T09:41:40,Galdakao,expenses,phone,-30.33,-43206.12
buyer_4,Jorge,50,ES82209578084093320757,TRX_N-01101-13853925,2024-09-08T16:55:12,Galdakao,expenses,cash,-100.0,-43306.12
buyer_4,Jorge,50,ES82209578084093320757,TRX_N-01102-02310731,2024-09-09T23:00:05,Galdakao,expenses,food,-63.39,-43369.51
buyer_4,Jorge,50,ES82209578084093320757,TRX_N-01103-23754339,2024-09-09T19:36:37,Galdakao,expenses,education,-53.95,-43423.46
buyer_4,Jorge,50,ES82209578084093320757,TRX_N-01104-77431781,2024-09-10T18:32:30,Pasaia,expenses,repairs,-176.47,-43599.93
buyer_4,Jorge,50,ES82209578084093320757,TRX_N-01105-30282340,2024-09-12T08:13:05,Zarautz,expenses,leisure,-69.18,-43669.11
buyer_4,Jorge,50,ES82209578084093320757,TRX_N-01106-15446883,2024-09-12T11:47:01,Galdakao,expenses,clothing,-51.37,-43720.48
buyer_4,Jorge,50,ES82209578084093320757,TRX_N-01107-56392941,2024-09-12T17:02:22,Galdakao,expenses,cash,-100.0,-43820.48
buyer_4,Jorge,50,ES82209578084093320757,TRX_N-01108-91353670,2024-09-13T17:06:01,Galdakao,expenses,cash,-100.0,-43920.48
buyer_4,Jorge,50,ES82209578084093320757,TRX_N-01109-27715437,2024-09-14T08:59:21,Iruña de Oca,expenses,leisure,-18.81,-43939.29
buyer_4,Jorge,50,ES82209578084093320757,TRX_N-01110-82040606,2024-09-14T18:12:20,Galdakao,expenses,appliances,-401.98,-44341.27
buyer_4,Jorge,50,ES82209578084093320757,TRX_N-01111-69164841,2024-09-15T09:34:51,Galdakao,expenses,healthcare,-53.93,-44395.2
buyer_4,Jorge,50,ES82209578084093320757,TRX_N-01112-73699844,2024-09-20T17:06:26,Galdakao,expenses,food,-124.33,-44519.53
buyer_4,Jorge,50,ES82209578084093320757,TRX_N-01113-54780323,2024-09-20T16:29:32,Galdakao,expenses,repairs,-204.62,-44724.15
buyer_4,Jorge,50,ES82209578084093320757,TRX_N-01114-92682865,2024-09-21T08:11:18,Oyón-Oion,expenses,leisure,-42.34,-44766.49
buyer_4,Jorge,50,ES82209578084093320757,TRX_N-01115-63649421,2024-09-22T10:46:05,Galdakao,expenses,education,-55.25,-44821.74
buyer_4,Jorge,50,ES82209578084093320757,TRX_N-01116-24771205,2024-09-23T05:55:04,Galdakao,expenses,cash,-100.0,-44921.74
buyer_4,Jorge,50,ES82209578084093320757,TRX_N-01117-37135788,2024-09-24T14:14:34,Galdakao,expenses,repairs,-298.1,-45219.84
buyer_4,Jorge,50,ES82209578084093320757,TRX_N-01118-19626332,2024-09-25T11:51:33,Galdakao,expenses,leisure,-58.25,-45278.09
buyer_4,Jorge,50,ES82209578084093320757,TRX_N-01119-90728174,2024-09-26T18:08:07,Galdakao,expenses,transport,-74.31,-45352.4
buyer_4,Jorge,50,ES82209578084093320757,TRX_N-01120-23348449,2024-09-26T09:04:48,Galdakao,expenses,leisure,-80.29,-45432.69
buyer_4,Jorge,50,ES82209578084093320757,TRX_N-01121-50227151,2024-09-26T12:01:42,Galdakao,expenses,cash,-100.0,-45532.69
buyer_4,Jorge,50,ES82209578084093320757,TRX_N-01122-20713613,2024-09-26T12:48:08,Labastida,expenses,gifts,-414.15,-45946.84
buyer_4,Jorge,50,ES82209578084093320757,TRX_N-01123-85821704,2024-09-27T19:56:58,Galdakao,expenses,cash,-100.0,-46046.84
buyer_4,Jorge,50,ES82209578084093320757,TRX_N-01124-25987550,2024-09-30T22:23:36,Galdakao,expenses,clothing,-150.9,-46197.74
buyer_4,Jorge,50,ES82209578084093320757,TRX_N-01125-33558232,2024-09-30T08:40:38,Galdakao,expenses,repairs,-308.35,-46506.09
buyer_4,Jorge,50,ES82209578084093320757,TRX_N-01126-76866008,2024-10-01T18:29:23,Galdakao,incomes,salary,1459.99,-45046.1
buyer_4,Jorge,50,ES82209578084093320757,TRX_N-01127-15278116,2024-10-01T18:29:23,Galdakao,incomes,salary_partner,1506.05,-43540.05
buyer_4,Jorge,50,ES82209578084093320757,TRX_N-01128-64021471,2024-10-03T05:40:03,Galdakao,expenses,transport,-80.96,-43621.01
buyer_4,Jorge,50,ES82209578084093320757,TRX_N-01129-80013668,2024-10-03T06:48:28,Galdakao,expenses,cash,-100.0,-43721.01
buyer_4,Jorge,50,ES82209578084093320757,TRX_N-01130-28788667,2024-10-04T16:00:23,Galdakao,expenses,mortgage,-979.09,-44700.1
buyer_4,Jorge,50,ES82209578084093320757,TRX_N-01131-32536331,2024-10-05T22:35:24,Galdakao,expenses,water,-43.9,-44744.0
buyer_4,Jorge,50,ES82209578084093320757,TRX_N-01132-47700517,2024-10-06T15:12:02,Galdakao,expenses,gas,-47.82,-44791.82
buyer_4,Jorge,50,ES82209578084093320757,TRX_N-01133-04613871,2024-10-06T15:37:40,Galdakao,expenses,internet,-42.0,-44833.82
buyer_4,Jorge,50,ES82209578084093320757,TRX_N-01134-31556438,2024-10-06T18:15:20,Arrasate,expenses,food,-120.15,-44953.97
buyer_4,Jorge,50,ES82209578084093320757,TRX_N-01135-51252008,2024-10-06T15:56:53,Galdakao,expenses,children,-97.51,-45051.48
buyer_4,Jorge,50,ES82209578084093320757,TRX_N-01136-93855149,2024-10-07T22:35:41,Galdakao,expenses,transport,-57.29,-45108.77
buyer_4,Jorge,50,ES82209578084093320757,TRX_N-01137-31814460,2024-10-08T01:04:33,Galdakao,expenses,electricity,-20.29,-45129.06
buyer_4,Jorge,50,ES82209578084093320757,TRX_N-01138-04075859,2024-10-08T09:42:02,Galdakao,expenses,phone,-36.83,-45165.89
buyer_4,Jorge,50,ES82209578084093320757,TRX_N-01139-08758279,2024-10-09T19:33:17,Galdakao,expenses,food,-116.2,-45282.09
buyer_4,Jorge,50,ES82209578084093320757,TRX_N-01140-49719614,2024-10-09T18:18:04,Andoain,expenses,cash,-100.0,-45382.09
buyer_4,Jorge,50,ES82209578084093320757,TRX_N-01141-74465414,2024-10-09T17:08:38,Galdakao,expenses,gifts,-801.89,-46183.98
buyer_5,Sara,30,ES41209551921252835913,TRX_N-00001-10507966,2022-01-01T00:40:32,Donostia,incomes,salary,1507.85,3195.62
buyer_5,Sara,30,ES41209551921252835913,TRX_N-00002-87901082,2022-01-01T00:40:32,Donostia,incomes,salary_partner,1346.62,4542.24
buyer_5,Sara,30,ES41209551921252835913,TRX_N-00003-56519671,2022-01-01T17:13:27,Donostia,expenses,clothing,-149.06,4393.18
buyer_5,Sara,30,ES41209551921252835913,TRX_N-00004-82124521,2022-01-02T15:09:41,Donostia,expenses,food,-104.9,4288.28
buyer_5,Sara,30,ES41209551921252835913,TRX_N-00005-29683551,2022-01-02T13:48:34,Donostia,expenses,transport,-47.01,4241.27
buyer_5,Sara,30,ES41209551921252835913,TRX_N-00006-23195993,2022-01-02T20:27:38,Llodio,expenses,leisure,-52.77,4188.5
buyer_5,Sara,30,ES41209551921252835913,TRX_N-00007-35462365,2022-01-02T15:44:27,Donostia,expenses,cash,-100.0,4088.5
buyer_5,Sara,30,ES41209551921252835913,TRX_N-00008-06440445,2022-01-04T03:06:04,Donostia,expenses,mortgage,-705.7,3382.8
buyer_5,Sara,30,ES41209551921252835913,TRX_N-00009-48659739,2022-01-04T17:35:39,Donostia,expenses,transport,-87.43,3295.37
buyer_5,Sara,30,ES41209551921252835913,TRX_N-00010-81064530,2022-01-05T03:12:33,Donostia,expenses,water,-21.09,3274.28
buyer_5,Sara,30,ES41209551921252835913,TRX_N-00011-94375930,2022-01-05T17:55:12,Donostia,expenses,food,-85.5,3188.78
buyer_5,Sara,30,ES41209551921252835913,TRX_N-00012-54451986,2022-01-05T08:30:21,Donostia,expenses,transport,-76.48,3112.3
buyer_5,Sara,30,ES41209551921252835913,TRX_N-00013-28116304,2022-01-06T11:50:01,Donostia,expenses,internet,-42.0,3070.3
buyer_5,Sara,30,ES41209551921252835913,TRX_N-00014-06349061,2022-01-07T13:34:54,Donostia,expenses,electricity,-32.46,3037.84
buyer_5,Sara,30,ES41209551921252835913,TRX_N-00015-15391636,2022-01-07T16:49:27,Donostia,expenses,gas,-71.88,2965.96
buyer_5,Sara,30,ES41209551921252835913,TRX_N-00016-57573894,2022-01-08T12:17:57,Donostia,expenses,phone,-31.57,2934.39
buyer_5,Sara,30,ES41209551921252835913,TRX_N-00017-85433627,2022-01-09T16:47:27,Donostia,expenses,travel,-1336.96,1597.43
buyer_5,Sara,30,ES41209551921252835913,TRX_N-00018-79882762,2022-01-09T18:23:08,Donostia,expenses,children,-216.11,1381.32
buyer_5,Sara,30,ES41209551921252835913,TRX_N-00019-11247704,2022-01-10T14:50:41,Pasaia,expenses,food,-65.11,1316.21
buyer_5,Sara,30,ES41209551921252835913,TRX_N-00020-85950897,2022-01-10T14:36:28,Donostia,expenses,children,-93.36,1222.85
buyer_5,Sara,30,ES41209551921252835913,TRX_N-00021-46207905,2022-01-11T11:56:12,Donostia,expenses,leisure,-53.42,1169.43
buyer_5,Sara,30,ES41209551921252835913,TRX_N-00022-56352900,2022-01-12T13:35:29,Donostia,expenses,gifts,-309.07,860.36
buyer_5,Sara,30,ES41209551921252835913,TRX_N-00023-05345574,2022-01-15T20:58:14,Andoain,expenses,food,-80.27,780.09
buyer_5,Sara,30,ES41209551921252835913,TRX_N-00024-71896664,2022-01-16T14:24:45,Donostia,expenses,repairs,-210.33,569.76
buyer_5,Sara,30,ES41209551921252835913,TRX_N-00025-81513813,2022-01-17T23:26:43,Donostia,expenses,cash,-100.0,469.76
buyer_5,Sara,30,ES41209551921252835913,TRX_N-00026-45071415,2022-01-18T09:10:22,Donostia,expenses,transport,-64.98,404.78
buyer_5,Sara,30,ES41209551921252835913,TRX_N-00027-19503953,2022-01-18T00:40:19,Donostia,expenses,clothing,-111.36,293.42
buyer_5,Sara,30,ES41209551921252835913,TRX_N-00028-29087232,2022-01-19T11:19:14,Donostia,expenses,transport,-50.25,243.17
buyer_5,Sara,30,ES41209551921252835913,TRX_N-00029-10501987,2022-01-21T14:28:08,Donostia,expenses,food,-67.32,175.85
buyer_5,Sara,30,ES41209551921252835913,TRX_N-00030-21328286,2022-01-21T16:40:39,Donostia,expenses,leisure,-55.41,120.44
buyer_5,Sara,30,ES41209551921252835913,TRX_N-00031-61118724,2022-01-23T13:44:18,Donostia,expenses,leisure,-50.53,69.91
buyer_5,Sara,30,ES41209551921252835913,TRX_N-00032-51361597,2022-01-23T06:02:20,Donostia,expenses,appliances,-376.78,-306.87
buyer_5,Sara,30,ES41209551921252835913,TRX_N-00033-14992463,2022-01-24T14:14:15,Donostia,expenses,transport,-44.01,-350.88
buyer_5,Sara,30,ES41209551921252835913,TRX_N-00034-74912029,2022-01-24T12:25:27,Donostia,expenses,leisure,-50.77,-401.65
buyer_5,Sara,30,ES41209551921252835913,TRX_N-00035-31824525,2022-01-26T17:35:45,Donostia,expenses,leisure,-23.16,-424.81
buyer_5,Sara,30,ES41209551921252835913,TRX_N-00036-38782616,2022-01-26T15:42:16,Labastida,expenses,education,-46.18,-470.99
buyer_5,Sara,30,ES41209551921252835913,TRX_N-00037-25523984,2022-01-26T13:26:10,Donostia,expenses,repairs,-306.95,-777.94
buyer_5,Sara,30,ES41209551921252835913,TRX_N-00038-99983441,2022-01-27T06:56:55,Donostia,expenses,appliances,-354.87,-1132.81
buyer_5,Sara,30,ES41209551921252835913,TRX_N-00039-83292994,2022-01-28T19:18:23,Donostia,expenses,food,-63.68,-1196.49
buyer_5,Sara,30,ES41209551921252835913,TRX_N-00040-12387438,2022-01-30T20:34:12,Donostia,expenses,transport,-56.79,-1253.28
buyer_5,Sara,30,ES41209551921252835913,TRX_N-00041-24931530,2022-01-30T07:39:55,Donostia,expenses,leisure,-76.81,-1330.09
buyer_5,Sara,30,ES41209551921252835913,TRX_N-00042-07414027,2022-01-30T12:53:13,Donostia,expenses,children,-128.25,-1458.34
buyer_5,Sara,30,ES41209551921252835913,TRX_N-00043-07493163,2022-01-31T12:27:18,Donostia,expenses,food,-111.04,-1569.38
buyer_5,Sara,30,ES41209551921252835913,TRX_N-00044-37638030,2022-02-01T16:52:26,Donostia,incomes,salary,1507.85,-61.53
buyer_5,Sara,30,ES41209551921252835913,TRX_N-00045-51190460,2022-02-01T16:52:26,Donostia,incomes,salary_partner,1346.62,1285.09
buyer_5,Sara,30,ES41209551921252835913,TRX_N-00046-56051959,2022-02-02T12:06:31,Donostia,expenses,children,-134.73,1150.36
buyer_5,Sara,30,ES41209551921252835913,TRX_N-00047-41515660,2022-02-03T20:12:07,Donostia,expenses,food,-63.77,1086.59
buyer_5,Sara,30,ES41209551921252835913,TRX_N-00048-30420365,2022-02-03T15:26:21,Donostia,expenses,transport,-41.36,1045.23
buyer_5,Sara,30,ES41209551921252835913,TRX_N-00049-14107233,2022-02-04T10:22:42,Donostia,expenses,mortgage,-705.7,339.53
buyer_5,Sara,30,ES41209551921252835913,TRX_N-00050-81040655,2022-02-04T16:17:57,Donostia,expenses,clothing,-150.98,188.55
buyer_5,Sara,30,ES41209551921252835913,TRX_N-00051-97398715,2022-02-05T09:42:42,Donostia,expenses,water,-26.39,162.16
buyer_5,Sara,30,ES41209551921252835913,TRX_N-00052-45098876,2022-02-06T15:32:42,Donostia,expenses,internet,-42.0,120.16
buyer_5,Sara,30,ES41209551921252835913,TRX_N-00053-23477853,2022-02-06T23:21:29,Donostia,expenses,phone,-35.81,84.35
buyer_5,Sara,30,ES41209551921252835913,TRX_N-00054-18884247,2022-02-06T14:24:13,Donostia,expenses,food,-71.88,12.47
buyer_5,Sara,30,ES41209551921252835913,TRX_N-00055-37436431,2022-02-08T20:00:36,Donostia,expenses,electricity,-39.23,-26.76
buyer_5,Sara,30,ES41209551921252835913,TRX_N-00056-84377641,2022-02-08T17:52:44,Donostia,expenses,gas,-58.5,-85.26
buyer_5,Sara,30,ES41209551921252835913,TRX_N-00057-93060341,2022-02-08T07:35:37,Donostia,expenses,cash,-100.0,-185.26
buyer_5,Sara,30,ES41209551921252835913,TRX_N-00058-44436239,2022-02-09T09:02:19,Donostia,expenses,children,-246.01,-431.27
buyer_5,Sara,30,ES41209551921252835913,TRX_N-00059-80119611,2022-02-10T09:24:06,Donostia,expenses,transport,-50.73,-482.0
buyer_5,Sara,30,ES41209551921252835913,TRX_N-00060-19485249,2022-02-10T18:23:30,Donostia,expenses,children,-91.74,-573.74
buyer_5,Sara,30,ES41209551921252835913,TRX_N-00061-70513587,2022-02-12T11:21:29,Donostia,expenses,children,-134.84,-708.58
buyer_5,Sara,30,ES41209551921252835913,TRX_N-00062-42910347,2022-02-13T09:03:18,Donostia,expenses,cash,-100.0,-808.58
buyer_5,Sara,30,ES41209551921252835913,TRX_N-00063-81831223,2022-02-14T08:58:26,Donostia,expenses,healthcare,-63.05,-871.63
buyer_5,Sara,30,ES41209551921252835913,TRX_N-00064-65706593,2022-02-14T15:01:16,Getxo,expenses,cash,-100.0,-971.63
buyer_5,Sara,30,ES41209551921252835913,TRX_N-00065-62613645,2022-02-15T12:54:48,Bilbao,expenses,leisure,-71.44,-1043.07
buyer_5,Sara,30,ES41209551921252835913,TRX_N-00066-79661697,2022-02-16T08:31:38,Donostia,expenses,transport,-43.35,-1086.42
buyer_5,Sara,30,ES41209551921252835913,TRX_N-00067-37758521,2022-02-18T20:02:28,Zuia,expenses,leisure,-32.13,-1118.55
buyer_5,Sara,30,ES41209551921252835913,TRX_N-00068-96249513,2022-02-20T11:26:03,Donostia,expenses,cash,-100.0,-1218.55
buyer_5,Sara,30,ES41209551921252835913,TRX_N-00069-25971584,2022-02-22T10:11:04,Donostia,expenses,cash,-100.0,-1318.55
buyer_5,Sara,30,ES41209551921252835913,TRX_N-00070-89147514,2022-02-24T11:00:54,Donostia,expenses,transport,-49.08,-1367.63
buyer_5,Sara,30,ES41209551921252835913,TRX_N-00071-82680802,2022-02-25T09:31:01,Donostia,expenses,transport,-85.28,-1452.91
buyer_5,Sara,30,ES41209551921252835913,TRX_N-00072-15402781,2022-02-25T16:55:37,Donostia,expenses,children,-111.28,-1564.19
buyer_5,Sara,30,ES41209551921252835913,TRX_N-00073-72297982,2022-02-26T13:16:57,Donostia,expenses,food,-60.84,-1625.03
buyer_5,Sara,30,ES41209551921252835913,TRX_N-00074-02188924,2022-03-01T15:54:07,Donostia,incomes,salary,1507.85,-117.18
buyer_5,Sara,30,ES41209551921252835913,TRX_N-00075-69777014,2022-03-01T15:54:07,Donostia,incomes,salary_partner,1346.62,1229.44
buyer_5,Sara,30,ES41209551921252835913,TRX_N-00076-86667406,2022-03-01T18:21:08,Hernani,expenses,leisure,-21.9,1207.54
buyer_5,Sara,30,ES41209551921252835913,TRX_N-00077-07211127,2022-03-02T09:49:03,Donostia,expenses,cash,-100.0,1107.54
buyer_5,Sara,30,ES41209551921252835913,TRX_N-00078-39321560,2022-03-04T18:14:04,Donostia,expenses,mortgage,-705.7,401.84
buyer_5,Sara,30,ES41209551921252835913,TRX_N-00079-80080280,2022-03-04T12:31:22,Donostia,expenses,clothing,-51.82,350.02
buyer_5,Sara,30,ES41209551921252835913,TRX_N-00080-55024486,2022-03-04T13:56:40,Donostia,expenses,gifts,-410.67,-60.65
buyer_5,Sara,30,ES41209551921252835913,TRX_N-00081-76194080,2022-03-05T11:19:23,Donostia,expenses,water,-25.19,-85.84
buyer_5,Sara,30,ES41209551921252835913,TRX_N-00082-90789854,2022-03-05T08:09:56,Donostia,expenses,internet,-42.0,-127.84
buyer_5,Sara,30,ES41209551921252835913,TRX_N-00083-46793780,2022-03-05T15:19:30,Donostia,expenses,cash,-100.0,-227.84
buyer_5,Sara,30,ES41209551921252835913,TRX_N-00084-29874248,2022-03-06T08:00:20,Donostia,expenses,electricity,-62.78,-290.62
buyer_5,Sara,30,ES41209551921252835913,TRX_N-00085-87946391,2022-03-06T20:22:54,Donostia,expenses,gas,-50.1,-340.72
buyer_5,Sara,30,ES41209551921252835913,TRX_N-00086-32290546,2022-03-06T15:44:52,Donostia,expenses,clothing,-102.17,-442.89
buyer_5,Sara,30,ES41209551921252835913,TRX_N-00087-75777753,2022-03-07T08:39:14,Donostia,expenses,phone,-40.45,-483.34
buyer_5,Sara,30,ES41209551921252835913,TRX_N-00088-18167621,2022-03-08T09:19:47,Donostia,expenses,leisure,-66.69,-550.03
buyer_5,Sara,30,ES41209551921252835913,TRX_N-00089-18230996,2022-03-10T10:44:45,Donostia,expenses,food,-102.95,-652.98
buyer_5,Sara,30,ES41209551921252835913,TRX_N-00090-67761930,2022-03-11T13:12:41,Donostia,expenses,transport,-65.31,-718.29
buyer_5,Sara,30,ES41209551921252835913,TRX_N-00091-42547655,2022-03-11T13:35:07,Donostia,expenses,education,-52.34,-770.63
buyer_5,Sara,30,ES41209551921252835913,TRX_N-00092-90041192,2022-03-16T09:45:41,Donostia,expenses,cash,-100.0,-870.63
buyer_5,Sara,30,ES41209551921252835913,TRX_N-00093-39587095,2022-03-17T13:46:23,Donostia,expenses,transport,-87.27,-957.9
buyer_5,Sara,30,ES41209551921252835913,TRX_N-00094-19373015,2022-03-19T04:15:03,Donostia,expenses,gifts,-518.3,-1476.2
buyer_5,Sara,30,ES41209551921252835913,TRX_N-00095-63245352,2022-03-19T11:37:53,Donostia,expenses,children,-154.85,-1631.05
buyer_5,Sara,30,ES41209551921252835913,TRX_N-00096-98773258,2022-03-22T21:50:11,Donostia,expenses,gifts,-577.23,-2208.28
buyer_5,Sara,30,ES41209551921252835913,TRX_N-00097-97027587,2022-03-24T09:44:35,Donostia,expenses,clothing,-95.59,-2303.87
buyer_5,Sara,30,ES41209551921252835913,TRX_N-00098-85429345,2022-03-25T16:11:21,Donostia,expenses,children,-91.97,-2395.84
buyer_5,Sara,30,ES41209551921252835913,TRX_N-00099-68863382,2022-03-26T22:55:03,Donostia,expenses,leisure,-61.39,-2457.23
buyer_5,Sara,30,ES41209551921252835913,TRX_N-00100-19831501,2022-03-27T09:30:43,Oyón-Oion,expenses,transport,-76.95,-2534.18
buyer_5,Sara,30,ES41209551921252835913,TRX_N-00101-15241603,2022-03-28T20:55:45,Errenteria,expenses,food,-73.02,-2607.2
buyer_5,Sara,30,ES41209551921252835913,TRX_N-00102-38725476,2022-03-29T18:13:19,Donostia,expenses,leisure,-75.08,-2682.28
buyer_5,Sara,30,ES41209551921252835913,TRX_N-00103-63839007,2022-03-29T09:53:14,Donostia,expenses,children,-253.26,-2935.54
buyer_5,Sara,30,ES41209551921252835913,TRX_N-00104-39312406,2022-03-30T19:41:48,Donostia,expenses,food,-75.27,-3010.81
buyer_5,Sara,30,ES41209551921252835913,TRX_N-00105-11663860,2022-03-30T10:35:58,Donostia,expenses,cash,-100.0,-3110.81
buyer_5,Sara,30,ES41209551921252835913,TRX_N-00106-94938240,2022-04-01T20:32:18,Donostia,incomes,salary,1507.85,-1602.96
buyer_5,Sara,30,ES41209551921252835913,TRX_N-00107-04579533,2022-04-01T20:32:18,Donostia,incomes,salary_partner,1346.62,-256.34
buyer_5,Sara,30,ES41209551921252835913,TRX_N-00108-51750828,2022-04-01T20:32:18,Donostia,incomes,extra_income,230.49,-25.85
buyer_5,Sara,30,ES41209551921252835913,TRX_N-00109-66336509,2022-04-02T06:04:58,Donostia,expenses,gifts,-331.67,-357.52
buyer_5,Sara,30,ES41209551921252835913,TRX_N-00110-99632275,2022-04-04T01:59:35,Donostia,expenses,mortgage,-705.7,-1063.22
buyer_5,Sara,30,ES41209551921252835913,TRX_N-00111-16443774,2022-04-04T09:44:26,Donostia,expenses,clothing,-147.86,-1211.08
buyer_5,Sara,30,ES41209551921252835913,TRX_N-00112-62323953,2022-04-04T12:08:54,Donostia,expenses,cash,-100.0,-1311.08
buyer_5,Sara,30,ES41209551921252835913,TRX_N-00113-20769574,2022-04-05T16:40:55,Donostia,expenses,electricity,-69.27,-1380.35
buyer_5,Sara,30,ES41209551921252835913,TRX_N-00114-52256333,2022-04-05T19:47:00,Donostia,expenses,appliances,-85.03,-1465.38
buyer_5,Sara,30,ES41209551921252835913,TRX_N-00115-97280422,2022-04-06T22:32:03,Donostia,expenses,leisure,-36.4,-1501.78
buyer_5,Sara,30,ES41209551921252835913,TRX_N-00116-67999468,2022-04-07T18:17:23,Donostia,expenses,water,-38.3,-1540.08
buyer_5,Sara,30,ES41209551921252835913,TRX_N-00117-36813684,2022-04-07T20:26:03,Donostia,expenses,phone,-35.81,-1575.89
buyer_5,Sara,30,ES41209551921252835913,TRX_N-00118-32549106,2022-04-07T13:19:49,Donostia,expenses,healthcare,-61.57,-1637.46
buyer_5,Sara,30,ES41209551921252835913,TRX_N-00119-72452117,2022-04-07T19:17:31,Donostia,expenses,cash,-100.0,-1737.46
buyer_5,Sara,30,ES41209551921252835913,TRX_N-00120-11295216,2022-04-08T08:17:02,Donostia,expenses,internet,-42.0,-1779.46
buyer_5,Sara,30,ES41209551921252835913,TRX_N-00121-86824987,2022-04-08T14:54:10,Donostia,expenses,gas,-99.68,-1879.14
buyer_5,Sara,30,ES41209551921252835913,TRX_N-00122-28917541,2022-04-08T22:48:44,Amurrio,expenses,transport,-80.04,-1959.18
buyer_5,Sara,30,ES41209551921252835913,TRX_N-00123-49730976,2022-04-09T14:04:46,Donostia,expenses,cash,-100.0,-2059.18
buyer_5,Sara,30,ES41209551921252835913,TRX_N-00124-20627087,2022-04-11T17:05:10,Donostia,expenses,healthcare,-110.89,-2170.07
buyer_5,Sara,30,ES41209551921252835913,TRX_N-00125-07092589,2022-04-12T14:32:48,Donostia,expenses,healthcare,-77.57,-2247.64
buyer_5,Sara,30,ES41209551921252835913,TRX_N-00126-37381191,2022-04-12T07:41:07,Donostia,expenses,cash,-100.0,-2347.64
buyer_5,Sara,30,ES41209551921252835913,TRX_N-00127-26441537,2022-04-14T17:04:00,Donostia,expenses,leisure,-53.57,-2401.21
buyer_5,Sara,30,ES41209551921252835913,TRX_N-00128-69826694,2022-04-15T11:17:56,Donostia,expenses,gifts,-808.81,-3210.02
buyer_5,Sara,30,ES41209551921252835913,TRX_N-00129-82575433,2022-04-17T15:51:08,Donostia,expenses,appliances,-116.0,-3326.02
buyer_5,Sara,30,ES41209551921252835913,TRX_N-00130-11533555,2022-04-18T20:47:58,Donostia,expenses,education,-50.3,-3376.32
buyer_5,Sara,30,ES41209551921252835913,TRX_N-00131-45378388,2022-04-19T07:11:11,Donostia,expenses,food,-114.01,-3490.33
buyer_5,Sara,30,ES41209551921252835913,TRX_N-00132-95789836,2022-04-21T15:21:06,Donostia,expenses,leisure,-33.09,-3523.42
buyer_5,Sara,30,ES41209551921252835913,TRX_N-00133-98391990,2022-04-22T07:12:11,Elciego,expenses,transport,-60.52,-3583.94
buyer_5,Sara,30,ES41209551921252835913,TRX_N-00134-12792258,2022-04-25T17:20:23,Donostia,expenses,leisure,-79.43,-3663.37
buyer_5,Sara,30,ES41209551921252835913,TRX_N-00135-40705466,2022-04-26T11:13:05,Donostia,expenses,cash,-100.0,-3763.37
buyer_5,Sara,30,ES41209551921252835913,TRX_N-00136-57096071,2022-04-26T13:44:32,Donostia,expenses,travel,-509.63,-4273.0
buyer_5,Sara,30,ES41209551921252835913,TRX_N-00137-82760806,2022-04-27T18:14:27,Leioa,expenses,food,-112.22,-4385.22
buyer_5,Sara,30,ES41209551921252835913,TRX_N-00138-46900906,2022-04-28T19:23:27,Donostia,expenses,cash,-100.0,-4485.22
buyer_5,Sara,30,ES41209551921252835913,TRX_N-00139-38520982,2022-04-29T17:35:56,Donostia,expenses,gifts,-547.98,-5033.2
buyer_5,Sara,30,ES41209551921252835913,TRX_N-00140-24828507,2022-04-29T16:05:16,Donostia,expenses,children,-113.4,-5146.6
buyer_5,Sara,30,ES41209551921252835913,TRX_N-00141-87221650,2022-04-30T08:29:02,Donostia,expenses,food,-123.0,-5269.6
buyer_5,Sara,30,ES41209551921252835913,TRX_N-00142-93738991,2022-05-01T11:02:31,Donostia,incomes,salary,1507.85,-3761.75
buyer_5,Sara,30,ES41209551921252835913,TRX_N-00143-58707404,2022-05-01T11:02:31,Donostia,incomes,salary_partner,1346.62,-2415.13
buyer_5,Sara,30,ES41209551921252835913,TRX_N-00144-02057164,2022-05-03T20:22:57,Labastida,expenses,cash,-100.0,-2515.13
buyer_5,Sara,30,ES41209551921252835913,TRX_N-00145-88337856,2022-05-04T19:52:55,Donostia,expenses,mortgage,-705.7,-3220.83
buyer_5,Sara,30,ES41209551921252835913,TRX_N-00146-48999087,2022-05-04T18:29:14,Donostia,expenses,leisure,-74.42,-3295.25
buyer_5,Sara,30,ES41209551921252835913,TRX_N-00147-27545712,2022-05-05T16:23:26,Donostia,expenses,gas,-82.29,-3377.54
buyer_5,Sara,30,ES41209551921252835913,TRX_N-00148-56640977,2022-05-05T08:59:11,Donostia,expenses,transport,-72.66,-3450.2
buyer_5,Sara,30,ES41209551921252835913,TRX_N-00149-46871812,2022-05-05T11:20:25,Alegría-Dulantzi,expenses,clothing,-137.15,-3587.35
buyer_5,Sara,30,ES41209551921252835913,TRX_N-00150-33031581,2022-05-06T15:47:36,Donostia,expenses,water,-20.55,-3607.9
buyer_5,Sara,30,ES41209551921252835913,TRX_N-00151-40459301,2022-05-06T09:32:58,Donostia,expenses,gifts,-445.6,-4053.5
buyer_5,Sara,30,ES41209551921252835913,TRX_N-00152-30404871,2022-05-07T14:38:22,Donostia,expenses,food,-99.9,-4153.4
buyer_5,Sara,30,ES41209551921252835913,TRX_N-00153-61075205,2022-05-08T11:20:50,Donostia,expenses,electricity,-83.52,-4236.92
buyer_5,Sara,30,ES41209551921252835913,TRX_N-00154-60077789,2022-05-08T07:44:59,Donostia,expenses,phone,-30.23,-4267.15
buyer_5,Sara,30,ES41209551921252835913,TRX_N-00155-66441014,2022-05-08T18:54:22,Donostia,expenses,internet,-42.0,-4309.15
buyer_5,Sara,30,ES41209551921252835913,TRX_N-00156-81580408,2022-05-08T14:23:27,Donostia,expenses,transport,-47.8,-4356.95
buyer_5,Sara,30,ES41209551921252835913,TRX_N-00157-11416963,2022-05-08T15:12:35,Eibar,expenses,repairs,-270.23,-4627.18
buyer_5,Sara,30,ES41209551921252835913,TRX_N-00158-81835372,2022-05-10T19:28:55,Donostia,expenses,food,-122.52,-4749.7
buyer_5,Sara,30,ES41209551921252835913,TRX_N-00159-25364709,2022-05-11T09:28:10,Irun,expenses,leisure,-30.71,-4780.41
buyer_5,Sara,30,ES41209551921252835913,TRX_N-00160-43827709,2022-05-12T08:33:47,Donostia,expenses,education,-60.17,-4840.58
buyer_5,Sara,30,ES41209551921252835913,TRX_N-00161-39581445,2022-05-13T19:29:25,Donostia,expenses,travel,-317.35,-5157.93
buyer_5,Sara,30,ES41209551921252835913,TRX_N-00162-60813412,2022-05-13T19:22:39,Donostia,expenses,appliances,-117.27,-5275.2
buyer_5,Sara,30,ES41209551921252835913,TRX_N-00163-60247312,2022-05-14T14:00:44,Berango,expenses,food,-61.86,-5337.06
buyer_5,Sara,30,ES41209551921252835913,TRX_N-00164-62604425,2022-05-15T14:28:43,Donostia,expenses,education,-76.66,-5413.72
buyer_5,Sara,30,ES41209551921252835913,TRX_N-00165-95541372,2022-05-16T13:33:55,Donostia,expenses,leisure,-37.76,-5451.48
buyer_5,Sara,30,ES41209551921252835913,TRX_N-00166-80101947,2022-05-17T20:23:59,Donostia,expenses,cash,-100.0,-5551.48
buyer_5,Sara,30,ES41209551921252835913,TRX_N-00167-07965329,2022-05-17T12:05:10,Errenteria,expenses,appliances,-138.64,-5690.12
buyer_5,Sara,30,ES41209551921252835913,TRX_N-00168-01102833,2022-05-18T18:35:30,Donostia,expenses,leisure,-22.84,-5712.96
buyer_5,Sara,30,ES41209551921252835913,TRX_N-00169-51811626,2022-05-19T17:47:33,Donostia,expenses,children,-131.17,-5844.13
buyer_5,Sara,30,ES41209551921252835913,TRX_N-00170-47405491,2022-05-21T14:53:33,Donostia,expenses,cash,-100.0,-5944.13
buyer_5,Sara,30,ES41209551921252835913,TRX_N-00171-73117655,2022-05-23T15:55:20,Erandio,expenses,food,-66.06,-6010.19
buyer_5,Sara,30,ES41209551921252835913,TRX_N-00172-00213655,2022-05-23T12:31:17,Donostia,expenses,leisure,-63.36,-6073.55
buyer_5,Sara,30,ES41209551921252835913,TRX_N-00173-23333391,2022-05-23T08:37:46,Donostia,expenses,cash,-100.0,-6173.55
buyer_5,Sara,30,ES41209551921252835913,TRX_N-00174-58268776,2022-05-26T15:07:21,Vitoria-Gasteiz,expenses,transport,-88.07,-6261.62
buyer_5,Sara,30,ES41209551921252835913,TRX_N-00175-91470744,2022-05-27T12:46:44,Donostia,expenses,cash,-100.0,-6361.62
buyer_5,Sara,30,ES41209551921252835913,TRX_N-00176-43685674,2022-05-27T08:09:35,Donostia,expenses,appliances,-98.67,-6460.29
buyer_5,Sara,30,ES41209551921252835913,TRX_N-00177-16202248,2022-05-29T08:04:02,Labastida,expenses,repairs,-319.22,-6779.51
buyer_5,Sara,30,ES41209551921252835913,TRX_N-00178-56150680,2022-06-01T19:48:54,Donostia,incomes,salary,1507.85,-5271.66
buyer_5,Sara,30,ES41209551921252835913,TRX_N-00179-03006726,2022-06-01T19:48:54,Donostia,incomes,salary_partner,1346.62,-3925.04
buyer_5,Sara,30,ES41209551921252835913,TRX_N-00180-97108452,2022-06-01T19:48:54,Donostia,incomes,salary_bonus,1108.08,-2816.96
buyer_5,Sara,30,ES41209551921252835913,TRX_N-00181-01202691,2022-06-01T19:48:54,Donostia,incomes,salary_partner_bonus,1041.89,-1775.07
buyer_5,Sara,30,ES41209551921252835913,TRX_N-00182-80427544,2022-06-01T21:14:24,Donostia,expenses,education,-42.99,-1818.06
buyer_5,Sara,30,ES41209551921252835913,TRX_N-00183-24284331,2022-06-01T13:18:13,Donostia,expenses,cash,-100.0,-1918.06
buyer_5,Sara,30,ES41209551921252835913,TRX_N-00184-61513614,2022-06-02T19:47:10,Donostia,expenses,repairs,-213.62,-2131.68
buyer_5,Sara,30,ES41209551921252835913,TRX_N-00185-37184933,2022-06-04T18:05:58,Donostia,expenses,mortgage,-705.7,-2837.38
buyer_5,Sara,30,ES41209551921252835913,TRX_N-00186-52781505,2022-06-04T15:10:34,Donostia,expenses,leisure,-62.45,-2899.83
buyer_5,Sara,30,ES41209551921252835913,TRX_N-00187-69710651,2022-06-04T12:56:12,Donostia,expenses,cash,-100.0,-2999.83
buyer_5,Sara,30,ES41209551921252835913,TRX_N-00188-38519808,2022-06-05T10:15:33,Donostia,expenses,water,-20.11,-3019.94
buyer_5,Sara,30,ES41209551921252835913,TRX_N-00189-15901867,2022-06-05T20:46:19,Donostia,expenses,gas,-47.44,-3067.38
buyer_5,Sara,30,ES41209551921252835913,TRX_N-00190-68332703,2022-06-06T12:30:11,Donostia,expenses,cash,-100.0,-3167.38
buyer_5,Sara,30,ES41209551921252835913,TRX_N-00191-47107534,2022-06-06T11:59:11,Donostia,expenses,repairs,-279.14,-3446.52
buyer_5,Sara,30,ES41209551921252835913,TRX_N-00192-07831303,2022-06-06T11:11:49,Donostia,expenses,gifts,-699.76,-4146.28
buyer_5,Sara,30,ES41209551921252835913,TRX_N-00193-59299851,2022-06-07T17:39:48,Donostia,expenses,electricity,-21.36,-4167.64
buyer_5,Sara,30,ES41209551921252835913,TRX_N-00194-13140515,2022-06-07T21:34:35,Berango,expenses,food,-101.06,-4268.7
buyer_5,Sara,30,ES41209551921252835913,TRX_N-00195-11408652,2022-06-07T04:20:04,Donostia,expenses,leisure,-75.21,-4343.91
buyer_5,Sara,30,ES41209551921252835913,TRX_N-00196-21054749,2022-06-07T19:20:39,Donostia,expenses,education,-57.31,-4401.22
buyer_5,Sara,30,ES41209551921252835913,TRX_N-00197-76602544,2022-06-08T09:10:22,Donostia,expenses,phone,-31.64,-4432.86
buyer_5,Sara,30,ES41209551921252835913,TRX_N-00198-68187259,2022-06-08T15:01:50,Donostia,expenses,internet,-42.0,-4474.86
buyer_5,Sara,30,ES41209551921252835913,TRX_N-00199-07219482,2022-06-13T13:36:34,Donostia,expenses,gifts,-339.36,-4814.22
buyer_5,Sara,30,ES41209551921252835913,TRX_N-00200-97510646,2022-06-15T10:45:20,Elciego,expenses,clothing,-114.53,-4928.75
buyer_5,Sara,30,ES41209551921252835913,TRX_N-00201-35629499,2022-06-15T15:44:47,Donostia,expenses,gifts,-275.93,-5204.68
buyer_5,Sara,30,ES41209551921252835913,TRX_N-00202-94285275,2022-06-16T18:14:51,Donostia,expenses,transport,-68.64,-5273.32
buyer_5,Sara,30,ES41209551921252835913,TRX_N-00203-58972838,2022-06-17T21:31:04,Donostia,expenses,food,-82.52,-5355.84
buyer_5,Sara,30,ES41209551921252835913,TRX_N-00204-89610416,2022-06-23T04:59:57,Donostia,expenses,leisure,-57.89,-5413.73
buyer_5,Sara,30,ES41209551921252835913,TRX_N-00205-34534356,2022-06-25T18:35:01,Donostia,expenses,food,-72.63,-5486.36
buyer_5,Sara,30,ES41209551921252835913,TRX_N-00206-13963672,2022-06-26T03:06:50,Donostia,expenses,transport,-60.02,-5546.38
buyer_5,Sara,30,ES41209551921252835913,TRX_N-00207-84588613,2022-06-27T13:59:32,Donostia,expenses,leisure,-23.18,-5569.56
buyer_5,Sara,30,ES41209551921252835913,TRX_N-00208-97821398,2022-07-01T12:44:25,Donostia,incomes,salary,1507.85,-4061.71
buyer_5,Sara,30,ES41209551921252835913,TRX_N-00209-95155692,2022-07-01T12:44:25,Donostia,incomes,salary_partner,1346.62,-2715.09
buyer_5,Sara,30,ES41209551921252835913,TRX_N-00210-39388686,2022-07-01T12:44:25,Donostia,incomes,extra_income,230.49,-2484.6
buyer_5,Sara,30,ES41209551921252835913,TRX_N-00211-78973414,2022-07-01T08:14:48,Irun,expenses,gifts,-521.11,-3005.71
buyer_5,Sara,30,ES41209551921252835913,TRX_N-00212-06493356,2022-07-02T18:13:48,Durango,expenses,food,-83.62,-3089.33
buyer_5,Sara,30,ES41209551921252835913,TRX_N-00213-34492560,2022-07-04T11:32:30,Donostia,expenses,mortgage,-705.7,-3795.03
buyer_5,Sara,30,ES41209551921252835913,TRX_N-00214-52611163,2022-07-05T15:52:21,Donostia,expenses,gas,-66.04,-3861.07
buyer_5,Sara,30,ES41209551921252835913,TRX_N-00215-54240353,2022-07-05T16:28:12,Donostia,expenses,internet,-42.0,-3903.07
buyer_5,Sara,30,ES41209551921252835913,TRX_N-00216-37557857,2022-07-05T09:13:48,Donostia,expenses,cash,-100.0,-4003.07
buyer_5,Sara,30,ES41209551921252835913,TRX_N-00217-17333091,2022-07-06T10:04:28,Donostia,expenses,phone,-33.57,-4036.64
buyer_5,Sara,30,ES41209551921252835913,TRX_N-00218-51942640,2022-07-06T10:51:12,Donostia,expenses,food,-119.46,-4156.1
buyer_5,Sara,30,ES41209551921252835913,TRX_N-00219-39445320,2022-07-07T13:05:35,Donostia,expenses,electricity,-28.59,-4184.69
buyer_5,Sara,30,ES41209551921252835913,TRX_N-00220-08892763,2022-07-08T23:08:02,Donostia,expenses,water,-29.53,-4214.22
buyer_5,Sara,30,ES41209551921252835913,TRX_N-00221-08698226,2022-07-09T15:08:08,Donostia,expenses,food,-112.57,-4326.79
buyer_5,Sara,30,ES41209551921252835913,TRX_N-00222-82799622,2022-07-09T23:23:05,Donostia,expenses,leisure,-37.6,-4364.39
buyer_5,Sara,30,ES41209551921252835913,TRX_N-00223-66347118,2022-07-15T13:28:31,Mungia,expenses,cash,-100.0,-4464.39
buyer_5,Sara,30,ES41209551921252835913,TRX_N-00224-85653012,2022-07-17T20:43:45,Hernani,expenses,food,-120.46,-4584.85
buyer_5,Sara,30,ES41209551921252835913,TRX_N-00225-32633783,2022-07-18T09:48:14,Donostia,expenses,clothing,-159.09,-4743.94
buyer_5,Sara,30,ES41209551921252835913,TRX_N-00226-98993172,2022-07-20T10:16:52,Donostia,expenses,leisure,-58.16,-4802.1
buyer_5,Sara,30,ES41209551921252835913,TRX_N-00227-02007398,2022-07-20T20:14:26,Donostia,expenses,cash,-100.0,-4902.1
buyer_5,Sara,30,ES41209551921252835913,TRX_N-00228-10864359,2022-07-24T00:50:05,Donostia,expenses,food,-68.15,-4970.25
buyer_5,Sara,30,ES41209551921252835913,TRX_N-00229-42053011,2022-07-25T20:44:47,Barakaldo,expenses,food,-105.24,-5075.49
buyer_5,Sara,30,ES41209551921252835913,TRX_N-00230-09894293,2022-07-25T16:38:22,Donostia,expenses,clothing,-76.04,-5151.53
buyer_5,Sara,30,ES41209551921252835913,TRX_N-00231-92311282,2022-07-28T17:48:06,Donostia,expenses,food,-120.41,-5271.94
buyer_5,Sara,30,ES41209551921252835913,TRX_N-00232-99624505,2022-07-28T20:07:32,Donostia,expenses,children,-125.83,-5397.77
buyer_5,Sara,30,ES41209551921252835913,TRX_N-00233-51389772,2022-07-29T08:23:08,Donostia,expenses,transport,-48.07,-5445.84
buyer_5,Sara,30,ES41209551921252835913,TRX_N-00234-67934265,2022-07-31T13:36:00,Donostia,expenses,food,-79.15,-5524.99
buyer_5,Sara,30,ES41209551921252835913,TRX_N-00235-74942372,2022-08-01T10:01:33,Donostia,incomes,salary,1507.85,-4017.14
buyer_5,Sara,30,ES41209551921252835913,TRX_N-00236-27258600,2022-08-01T10:01:33,Donostia,incomes,salary_partner,1346.62,-2670.52
buyer_5,Sara,30,ES41209551921252835913,TRX_N-00237-51135926,2022-08-02T11:39:10,Donostia,expenses,cash,-100.0,-2770.52
buyer_5,Sara,30,ES41209551921252835913,TRX_N-00238-56590639,2022-08-04T12:38:18,Donostia,expenses,mortgage,-705.7,-3476.22
buyer_5,Sara,30,ES41209551921252835913,TRX_N-00239-17614311,2022-08-04T13:07:59,Durango,expenses,repairs,-121.58,-3597.8
buyer_5,Sara,30,ES41209551921252835913,TRX_N-00240-03781648,2022-08-05T12:50:08,Donostia,expenses,gas,-107.26,-3705.06
buyer_5,Sara,30,ES41209551921252835913,TRX_N-00241-38231574,2022-08-05T19:57:35,Donostia,expenses,phone,-33.51,-3738.57
buyer_5,Sara,30,ES41209551921252835913,TRX_N-00242-16374982,2022-08-06T18:40:11,Donostia,expenses,internet,-42.0,-3780.57
buyer_5,Sara,30,ES41209551921252835913,TRX_N-00243-10612875,2022-08-07T08:24:09,Donostia,expenses,leisure,-73.59,-3854.16
buyer_5,Sara,30,ES41209551921252835913,TRX_N-00244-59112590,2022-08-07T19:39:03,Donostia,expenses,healthcare,-89.34,-3943.5
buyer_5,Sara,30,ES41209551921252835913,TRX_N-00245-38659292,2022-08-08T00:56:08,Donostia,expenses,water,-23.99,-3967.49
buyer_5,Sara,30,ES41209551921252835913,TRX_N-00246-71057380,2022-08-08T09:42:03,Donostia,expenses,electricity,-58.49,-4025.98
buyer_5,Sara,30,ES41209551921252835913,TRX_N-00247-00012300,2022-08-08T13:43:15,Donostia,expenses,food,-100.87,-4126.85
buyer_5,Sara,30,ES41209551921252835913,TRX_N-00248-77195050,2022-08-09T08:05:56,Donostia,expenses,transport,-71.18,-4198.03
buyer_5,Sara,30,ES41209551921252835913,TRX_N-00249-07662915,2022-08-09T13:29:59,Donostia,expenses,gifts,-289.36,-4487.39
buyer_5,Sara,30,ES41209551921252835913,TRX_N-00250-66018993,2022-08-10T09:03:57,Vitoria-Gasteiz,expenses,leisure,-74.61,-4562.0
buyer_5,Sara,30,ES41209551921252835913,TRX_N-00251-06514477,2022-08-10T20:27:13,Donostia,expenses,children,-210.24,-4772.24
buyer_5,Sara,30,ES41209551921252835913,TRX_N-00252-84311789,2022-08-11T15:30:20,Donostia,expenses,gifts,-718.03,-5490.27
buyer_5,Sara,30,ES41209551921252835913,TRX_N-00253-22617928,2022-08-12T23:38:08,Donostia,expenses,leisure,-55.28,-5545.55
buyer_5,Sara,30,ES41209551921252835913,TRX_N-00254-27214231,2022-08-13T13:31:29,Donostia,expenses,cash,-100.0,-5645.55
buyer_5,Sara,30,ES41209551921252835913,TRX_N-00255-36882849,2022-08-14T20:51:27,Donostia,expenses,cash,-100.0,-5745.55
buyer_5,Sara,30,ES41209551921252835913,TRX_N-00256-49529462,2022-08-17T19:39:49,Bermeo,expenses,cash,-100.0,-5845.55
buyer_5,Sara,30,ES41209551921252835913,TRX_N-00257-28699328,2022-08-19T07:29:43,Donostia,expenses,transport,-56.64,-5902.19
buyer_5,Sara,30,ES41209551921252835913,TRX_N-00258-04798793,2022-08-19T19:20:40,Donostia,expenses,cash,-100.0,-6002.19
buyer_5,Sara,30,ES41209551921252835913,TRX_N-00259-98896661,2022-08-20T18:22:43,Donostia,expenses,leisure,-62.29,-6064.48
buyer_5,Sara,30,ES41209551921252835913,TRX_N-00260-03764109,2022-08-21T08:37:49,Donostia,expenses,cash,-100.0,-6164.48
buyer_5,Sara,30,ES41209551921252835913,TRX_N-00261-03862016,2022-08-22T08:39:20,Donostia,expenses,food,-110.96,-6275.44
buyer_5,Sara,30,ES41209551921252835913,TRX_N-00262-14901147,2022-08-25T15:20:19,Donostia,expenses,children,-247.42,-6522.86
buyer_5,Sara,30,ES41209551921252835913,TRX_N-00263-83066074,2022-08-27T12:12:00,Donostia,expenses,healthcare,-144.64,-6667.5
buyer_5,Sara,30,ES41209551921252835913,TRX_N-00264-98211361,2022-08-29T08:51:56,Donostia,expenses,leisure,-41.57,-6709.07
buyer_5,Sara,30,ES41209551921252835913,TRX_N-00265-83987571,2022-08-31T19:08:19,Donostia,expenses,leisure,-84.97,-6794.04
buyer_5,Sara,30,ES41209551921252835913,TRX_N-00266-08035419,2022-09-01T13:24:28,Donostia,incomes,salary,1507.85,-5286.19
buyer_5,Sara,30,ES41209551921252835913,TRX_N-00267-79727520,2022-09-01T13:24:28,Donostia,incomes,salary_partner,1346.62,-3939.57
buyer_5,Sara,30,ES41209551921252835913,TRX_N-00268-57964129,2022-09-02T20:05:42,Donostia,expenses,food,-113.95,-4053.52
buyer_5,Sara,30,ES41209551921252835913,TRX_N-00269-55512683,2022-09-02T17:02:31,Berango,expenses,leisure,-68.47,-4121.99
buyer_5,Sara,30,ES41209551921252835913,TRX_N-00270-98212999,2022-09-03T13:14:44,Donostia,expenses,repairs,-76.88,-4198.87
buyer_5,Sara,30,ES41209551921252835913,TRX_N-00271-36360043,2022-09-04T12:25:03,Donostia,expenses,mortgage,-705.7,-4904.57
buyer_5,Sara,30,ES41209551921252835913,TRX_N-00272-78103926,2022-09-04T19:48:53,Portugalete,expenses,leisure,-41.53,-4946.1
buyer_5,Sara,30,ES41209551921252835913,TRX_N-00273-90037972,2022-09-05T16:56:15,Donostia,expenses,phone,-33.86,-4979.96
buyer_5,Sara,30,ES41209551921252835913,TRX_N-00274-43206596,2022-09-05T18:27:16,Amurrio,expenses,leisure,-36.7,-5016.66
buyer_5,Sara,30,ES41209551921252835913,TRX_N-00275-87975071,2022-09-06T20:25:06,Donostia,expenses,electricity,-77.34,-5094.0
buyer_5,Sara,30,ES41209551921252835913,TRX_N-00276-82271388,2022-09-06T09:02:24,Donostia,expenses,gas,-82.07,-5176.07
buyer_5,Sara,30,ES41209551921252835913,TRX_N-00277-08193344,2022-09-07T08:20:44,Donostia,expenses,water,-21.86,-5197.93
buyer_5,Sara,30,ES41209551921252835913,TRX_N-00278-44446485,2022-09-07T16:38:25,Donostia,expenses,internet,-42.0,-5239.93
buyer_5,Sara,30,ES41209551921252835913,TRX_N-00279-85780401,2022-09-08T00:52:24,Lasarte-Oria,expenses,food,-76.82,-5316.75
buyer_5,Sara,30,ES41209551921252835913,TRX_N-00280-34335473,2022-09-10T04:38:34,Donostia,expenses,cash,-100.0,-5416.75
buyer_5,Sara,30,ES41209551921252835913,TRX_N-00281-40272482,2022-09-11T18:08:59,Donostia,expenses,clothing,-75.45,-5492.2
buyer_5,Sara,30,ES41209551921252835913,TRX_N-00282-00997738,2022-09-12T13:48:43,Irun,expenses,transport,-40.7,-5532.9
buyer_5,Sara,30,ES41209551921252835913,TRX_N-00283-23571351,2022-09-12T20:04:13,Bermeo,expenses,travel,-1717.84,-7250.74
buyer_5,Sara,30,ES41209551921252835913,TRX_N-00284-26812508,2022-09-13T17:04:48,Donostia,expenses,healthcare,-129.14,-7379.88
buyer_5,Sara,30,ES41209551921252835913,TRX_N-00285-30478399,2022-09-13T19:02:27,Donostia,expenses,appliances,-81.01,-7460.89
buyer_5,Sara,30,ES41209551921252835913,TRX_N-00286-17444194,2022-09-14T11:44:07,Donostia,expenses,food,-76.18,-7537.07
buyer_5,Sara,30,ES41209551921252835913,TRX_N-00287-63365879,2022-09-14T11:32:37,Donostia,expenses,appliances,-194.04,-7731.11
buyer_5,Sara,30,ES41209551921252835913,TRX_N-00288-21703836,2022-09-14T23:14:41,Donostia,expenses,repairs,-271.74,-8002.85
buyer_5,Sara,30,ES41209551921252835913,TRX_N-00289-69171757,2022-09-17T13:41:53,Donostia,expenses,transport,-75.03,-8077.88
buyer_5,Sara,30,ES41209551921252835913,TRX_N-00290-38734663,2022-09-18T18:45:34,Donostia,expenses,cash,-100.0,-8177.88
buyer_5,Sara,30,ES41209551921252835913,TRX_N-00291-07615213,2022-09-19T01:12:59,Donostia,expenses,leisure,-69.85,-8247.73
buyer_5,Sara,30,ES41209551921252835913,TRX_N-00292-81201256,2022-09-19T08:08:25,Donostia,expenses,cash,-100.0,-8347.73
buyer_5,Sara,30,ES41209551921252835913,TRX_N-00293-37565103,2022-09-21T07:58:11,Donostia,expenses,leisure,-25.29,-8373.02
buyer_5,Sara,30,ES41209551921252835913,TRX_N-00294-79943434,2022-09-21T19:01:02,Donostia,expenses,repairs,-298.63,-8671.65
buyer_5,Sara,30,ES41209551921252835913,TRX_N-00295-91446728,2022-09-22T11:23:01,Donostia,expenses,appliances,-224.35,-8896.0
buyer_5,Sara,30,ES41209551921252835913,TRX_N-00296-21807076,2022-09-23T15:30:34,Donostia,expenses,food,-101.07,-8997.07
buyer_5,Sara,30,ES41209551921252835913,TRX_N-00297-02488763,2022-09-26T19:37:48,Donostia,expenses,leisure,-57.52,-9054.59
buyer_5,Sara,30,ES41209551921252835913,TRX_N-00298-16785969,2022-09-28T14:51:32,Donostia,expenses,cash,-100.0,-9154.59
buyer_5,Sara,30,ES41209551921252835913,TRX_N-00299-65427497,2022-09-29T17:51:12,Donostia,expenses,cash,-100.0,-9254.59
buyer_5,Sara,30,ES41209551921252835913,TRX_N-00300-02347336,2022-10-01T14:52:21,Donostia,incomes,salary,1507.85,-7746.74
buyer_5,Sara,30,ES41209551921252835913,TRX_N-00301-61750859,2022-10-01T14:52:21,Donostia,incomes,salary_partner,1346.62,-6400.12
buyer_5,Sara,30,ES41209551921252835913,TRX_N-00302-86791336,2022-10-01T14:52:21,Donostia,incomes,extra_income,230.49,-6169.63
buyer_5,Sara,30,ES41209551921252835913,TRX_N-00303-87595871,2022-10-03T15:23:11,Donostia,expenses,transport,-59.25,-6228.88
buyer_5,Sara,30,ES41209551921252835913,TRX_N-00304-53671536,2022-10-04T21:01:29,Donostia,expenses,mortgage,-705.7,-6934.58
buyer_5,Sara,30,ES41209551921252835913,TRX_N-00305-41758096,2022-10-05T02:49:30,Donostia,expenses,water,-31.81,-6966.39
buyer_5,Sara,30,ES41209551921252835913,TRX_N-00306-02780247,2022-10-06T16:35:43,Donostia,expenses,internet,-42.0,-7008.39
buyer_5,Sara,30,ES41209551921252835913,TRX_N-00307-83051018,2022-10-06T03:33:18,Donostia,expenses,food,-110.88,-7119.27
buyer_5,Sara,30,ES41209551921252835913,TRX_N-00308-80188264,2022-10-08T09:08:12,Donostia,expenses,electricity,-54.47,-7173.74
buyer_5,Sara,30,ES41209551921252835913,TRX_N-00309-34999250,2022-10-08T08:08:02,Donostia,expenses,gas,-94.85,-7268.59
buyer_5,Sara,30,ES41209551921252835913,TRX_N-00310-72772594,2022-10-08T15:42:51,Donostia,expenses,phone,-41.82,-7310.41
buyer_5,Sara,30,ES41209551921252835913,TRX_N-00311-15496003,2022-10-09T17:20:30,Donostia,expenses,food,-122.07,-7432.48
buyer_5,Sara,30,ES41209551921252835913,TRX_N-00312-36186560,2022-10-09T21:46:11,Donostia,expenses,healthcare,-125.12,-7557.6
buyer_5,Sara,30,ES41209551921252835913,TRX_N-00313-23710856,2022-10-16T15:04:27,Donostia,expenses,transport,-87.08,-7644.68
buyer_5,Sara,30,ES41209551921252835913,TRX_N-00314-90979318,2022-10-18T14:26:44,Donostia,expenses,food,-74.51,-7719.19
buyer_5,Sara,30,ES41209551921252835913,TRX_N-00315-43708853,2022-10-18T13:40:43,Berango,expenses,clothing,-111.93,-7831.12
buyer_5,Sara,30,ES41209551921252835913,TRX_N-00316-69057736,2022-10-18T14:59:34,Donostia,expenses,healthcare,-103.24,-7934.36
buyer_5,Sara,30,ES41209551921252835913,TRX_N-00317-78913615,2022-10-19T17:47:10,Donostia,expenses,education,-76.58,-8010.94
buyer_5,Sara,30,ES41209551921252835913,TRX_N-00318-88660294,2022-10-21T13:19:45,Donostia,expenses,food,-115.54,-8126.48
buyer_5,Sara,30,ES41209551921252835913,TRX_N-00319-30371513,2022-10-23T16:31:30,Donostia,expenses,transport,-85.01,-8211.49
buyer_5,Sara,30,ES41209551921252835913,TRX_N-00320-36682313,2022-10-26T15:13:17,Donostia,expenses,gifts,-191.6,-8403.09
buyer_5,Sara,30,ES41209551921252835913,TRX_N-00321-86381210,2022-10-29T12:37:05,Donostia,expenses,repairs,-53.15,-8456.24
buyer_5,Sara,30,ES41209551921252835913,TRX_N-00322-48088293,2022-10-31T19:48:21,Donostia,expenses,food,-67.24,-8523.48
buyer_5,Sara,30,ES41209551921252835913,TRX_N-00323-04764365,2022-10-31T18:05:36,Donostia,expenses,gifts,-103.73,-8627.21
buyer_5,Sara,30,ES41209551921252835913,TRX_N-00324-31039784,2022-11-01T14:05:30,Donostia,incomes,salary,1507.85,-7119.36
buyer_5,Sara,30,ES41209551921252835913,TRX_N-00325-56403877,2022-11-01T14:05:30,Donostia,incomes,salary_partner,1346.62,-5772.74
buyer_5,Sara,30,ES41209551921252835913,TRX_N-00326-90024367,2022-11-02T02:06:50,Donostia,expenses,clothing,-63.48,-5836.22
buyer_5,Sara,30,ES41209551921252835913,TRX_N-00327-92878224,2022-11-02T14:02:28,Donostia,expenses,repairs,-148.21,-5984.43
buyer_5,Sara,30,ES41209551921252835913,TRX_N-00328-35067142,2022-11-03T18:19:15,Donostia,expenses,food,-96.42,-6080.85
buyer_5,Sara,30,ES41209551921252835913,TRX_N-00329-26799811,2022-11-03T20:57:45,Galdakao,expenses,repairs,-86.2,-6167.05
buyer_5,Sara,30,ES41209551921252835913,TRX_N-00330-20325166,2022-11-04T16:54:28,Donostia,expenses,mortgage,-705.7,-6872.75
buyer_5,Sara,30,ES41209551921252835913,TRX_N-00331-81524860,2022-11-05T15:17:10,Donostia,expenses,internet,-42.0,-6914.75
buyer_5,Sara,30,ES41209551921252835913,TRX_N-00332-97183557,2022-11-05T16:37:12,Donostia,expenses,cash,-100.0,-7014.75
buyer_5,Sara,30,ES41209551921252835913,TRX_N-00333-10547650,2022-11-06T16:11:06,Donostia,expenses,water,-42.51,-7057.26
buyer_5,Sara,30,ES41209551921252835913,TRX_N-00334-96376396,2022-11-06T14:12:46,Errenteria,expenses,cash,-100.0,-7157.26
buyer_5,Sara,30,ES41209551921252835913,TRX_N-00335-08841822,2022-11-08T16:07:24,Donostia,expenses,electricity,-59.65,-7216.91
buyer_5,Sara,30,ES41209551921252835913,TRX_N-00336-62914037,2022-11-08T17:31:37,Donostia,expenses,gas,-58.76,-7275.67
buyer_5,Sara,30,ES41209551921252835913,TRX_N-00337-61667612,2022-11-08T16:14:25,Donostia,expenses,phone,-43.1,-7318.77
buyer_5,Sara,30,ES41209551921252835913,TRX_N-00338-49113617,2022-11-08T22:09:22,Donostia,expenses,leisure,-75.9,-7394.67
buyer_5,Sara,30,ES41209551921252835913,TRX_N-00339-70778114,2022-11-09T12:15:19,Donostia,expenses,clothing,-72.17,-7466.84
buyer_5,Sara,30,ES41209551921252835913,TRX_N-00340-96310235,2022-11-09T19:19:10,Donostia,expenses,children,-155.66,-7622.5
buyer_5,Sara,30,ES41209551921252835913,TRX_N-00341-36870694,2022-11-10T18:14:53,Donostia,expenses,healthcare,-40.1,-7662.6
buyer_5,Sara,30,ES41209551921252835913,TRX_N-00342-99668922,2022-11-11T22:36:45,Llodio,expenses,travel,-394.99,-8057.59
buyer_5,Sara,30,ES41209551921252835913,TRX_N-00343-60276960,2022-11-16T09:20:29,Pasaia,expenses,transport,-53.61,-8111.2
buyer_5,Sara,30,ES41209551921252835913,TRX_N-00344-80926411,2022-11-16T14:54:53,Leioa,expenses,leisure,-21.71,-8132.91
buyer_5,Sara,30,ES41209551921252835913,TRX_N-00345-26962940,2022-11-16T09:11:11,Donostia,expenses,healthcare,-138.78,-8271.69
buyer_5,Sara,30,ES41209551921252835913,TRX_N-00346-22151858,2022-11-16T06:08:07,Donostia,expenses,cash,-100.0,-8371.69
buyer_5,Sara,30,ES41209551921252835913,TRX_N-00347-41321658,2022-11-17T10:06:06,Donostia,expenses,transport,-80.57,-8452.26
buyer_5,Sara,30,ES41209551921252835913,TRX_N-00348-91200789,2022-11-18T17:35:12,Donostia,expenses,food,-88.47,-8540.73
buyer_5,Sara,30,ES41209551921252835913,TRX_N-00349-94268997,2022-11-23T11:40:07,Berango,expenses,healthcare,-187.66,-8728.39
buyer_5,Sara,30,ES41209551921252835913,TRX_N-00350-11317912,2022-11-26T13:43:14,Donostia,expenses,leisure,-25.52,-8753.91
buyer_5,Sara,30,ES41209551921252835913,TRX_N-00351-14471404,2022-11-27T18:51:14,Donostia,expenses,leisure,-28.52,-8782.43
buyer_5,Sara,30,ES41209551921252835913,TRX_N-00352-51956205,2022-11-28T20:24:27,Donostia,expenses,appliances,-361.14,-9143.57
buyer_5,Sara,30,ES41209551921252835913,TRX_N-00353-06278322,2022-11-29T13:00:38,Donostia,expenses,transport,-46.12,-9189.69
buyer_5,Sara,30,ES41209551921252835913,TRX_N-00354-85273252,2022-11-30T15:03:42,Oyón-Oion,expenses,food,-80.66,-9270.35
buyer_5,Sara,30,ES41209551921252835913,TRX_N-00355-53609674,2022-11-30T12:30:43,Llodio,expenses,transport,-45.01,-9315.36
buyer_5,Sara,30,ES41209551921252835913,TRX_N-00356-27212616,2022-11-30T13:37:30,Donostia,expenses,gifts,-624.78,-9940.14
buyer_5,Sara,30,ES41209551921252835913,TRX_N-00357-60556205,2022-12-01T16:40:49,Donostia,incomes,salary,1507.85,-8432.29
buyer_5,Sara,30,ES41209551921252835913,TRX_N-00358-21714087,2022-12-01T16:40:49,Donostia,incomes,salary_partner,1346.62,-7085.67
buyer_5,Sara,30,ES41209551921252835913,TRX_N-00359-68158292,2022-12-01T16:40:49,Donostia,incomes,salary_bonus,1097.13,-5988.54
buyer_5,Sara,30,ES41209551921252835913,TRX_N-00360-54735781,2022-12-01T16:40:49,Donostia,incomes,salary_partner_bonus,960.56,-5027.98
buyer_5,Sara,30,ES41209551921252835913,TRX_N-00361-00444987,2022-12-02T11:50:36,Donostia,expenses,leisure,-18.07,-5046.05
buyer_5,Sara,30,ES41209551921252835913,TRX_N-00362-87629916,2022-12-02T13:46:25,Donostia,expenses,cash,-100.0,-5146.05
buyer_5,Sara,30,ES41209551921252835913,TRX_N-00363-35109323,2022-12-03T12:24:32,Donostia,expenses,transport,-87.03,-5233.08
buyer_5,Sara,30,ES41209551921252835913,TRX_N-00364-60077622,2022-12-03T20:30:55,Donostia,expenses,education,-65.88,-5298.96
buyer_5,Sara,30,ES41209551921252835913,TRX_N-00365-23528875,2022-12-04T06:11:04,Donostia,expenses,mortgage,-705.7,-6004.66
buyer_5,Sara,30,ES41209551921252835913,TRX_N-00366-56247604,2022-12-05T18:31:12,Donostia,expenses,electricity,-58.53,-6063.19
buyer_5,Sara,30,ES41209551921252835913,TRX_N-00367-91430896,2022-12-05T13:27:44,Donostia,expenses,phone,-33.28,-6096.47
buyer_5,Sara,30,ES41209551921252835913,TRX_N-00368-51049260,2022-12-06T16:02:33,Mungia,expenses,cash,-100.0,-6196.47
buyer_5,Sara,30,ES41209551921252835913,TRX_N-00369-28098904,2022-12-07T14:53:03,Donostia,expenses,internet,-42.0,-6238.47
buyer_5,Sara,30,ES41209551921252835913,TRX_N-00370-71921914,2022-12-07T18:05:36,Donostia,expenses,transport,-44.45,-6282.92
buyer_5,Sara,30,ES41209551921252835913,TRX_N-00371-69234375,2022-12-08T18:10:50,Donostia,expenses,water,-22.38,-6305.3
buyer_5,Sara,30,ES41209551921252835913,TRX_N-00372-27738109,2022-12-08T09:07:42,Donostia,expenses,gas,-98.34,-6403.64
buyer_5,Sara,30,ES41209551921252835913,TRX_N-00373-37609236,2022-12-08T12:48:19,Donostia,expenses,food,-72.02,-6475.66
buyer_5,Sara,30,ES41209551921252835913,TRX_N-00374-25053992,2022-12-09T11:23:15,Donostia,expenses,food,-98.81,-6574.47
buyer_5,Sara,30,ES41209551921252835913,TRX_N-00375-43855986,2022-12-10T16:42:35,Donostia,expenses,healthcare,-87.89,-6662.36
buyer_5,Sara,30,ES41209551921252835913,TRX_N-00376-05672662,2022-12-10T17:00:04,Donostia,expenses,cash,-100.0,-6762.36
buyer_5,Sara,30,ES41209551921252835913,TRX_N-00377-39408402,2022-12-11T15:03:25,Durango,expenses,repairs,-192.38,-6954.74
buyer_5,Sara,30,ES41209551921252835913,TRX_N-00378-98211211,2022-12-11T19:34:02,Donostia,expenses,children,-110.94,-7065.68
buyer_5,Sara,30,ES41209551921252835913,TRX_N-00379-74124627,2022-12-12T18:50:37,Donostia,expenses,healthcare,-124.94,-7190.62
buyer_5,Sara,30,ES41209551921252835913,TRX_N-00380-70341120,2022-12-13T09:11:37,Donostia,expenses,education,-62.04,-7252.66
buyer_5,Sara,30,ES41209551921252835913,TRX_N-00381-04436884,2022-12-15T20:47:36,Donostia,expenses,cash,-100.0,-7352.66
buyer_5,Sara,30,ES41209551921252835913,TRX_N-00382-61489060,2022-12-16T14:31:53,Donostia,expenses,cash,-100.0,-7452.66
buyer_5,Sara,30,ES41209551921252835913,TRX_N-00383-53745903,2022-12-16T05:35:13,Santurtzi,expenses,gifts,-505.93,-7958.59
buyer_5,Sara,30,ES41209551921252835913,TRX_N-00384-93809300,2022-12-17T03:08:34,Donostia,expenses,cash,-100.0,-8058.59
buyer_5,Sara,30,ES41209551921252835913,TRX_N-00385-27819357,2022-12-18T13:33:10,Donostia,expenses,transport,-41.72,-8100.31
buyer_5,Sara,30,ES41209551921252835913,TRX_N-00386-11594875,2022-12-18T12:59:35,Llodio,expenses,clothing,-57.06,-8157.37
buyer_5,Sara,30,ES41209551921252835913,TRX_N-00387-76246690,2022-12-22T10:47:38,Donostia,expenses,food,-86.51,-8243.88
buyer_5,Sara,30,ES41209551921252835913,TRX_N-00388-07431453,2022-12-23T10:27:04,Donostia,expenses,leisure,-83.15,-8327.03
buyer_5,Sara,30,ES41209551921252835913,TRX_N-00389-88904237,2022-12-23T18:55:58,Donostia,expenses,repairs,-143.92,-8470.95
buyer_5,Sara,30,ES41209551921252835913,TRX_N-00390-87106503,2022-12-28T12:21:21,Hernani,expenses,healthcare,-84.39,-8555.34
buyer_5,Sara,30,ES41209551921252835913,TRX_N-00391-87568058,2022-12-28T14:53:38,Donostia,expenses,cash,-100.0,-8655.34
buyer_5,Sara,30,ES41209551921252835913,TRX_N-00392-53658019,2022-12-31T17:23:36,Donostia,expenses,leisure,-32.09,-8687.43
buyer_5,Sara,30,ES41209551921252835913,TRX_N-00393-55533546,2022-12-31T17:26:23,Donostia,expenses,gifts,-93.98,-8781.41
buyer_5,Sara,30,ES41209551921252835913,TRX_N-00394-15938616,2022-12-31T19:05:15,Donostia,expenses,children,-267.18,-9048.59
buyer_5,Sara,30,ES41209551921252835913,TRX_N-00395-04153535,2023-01-01T18:13:48,Donostia,incomes,salary,1556.06,-7492.53
buyer_5,Sara,30,ES41209551921252835913,TRX_N-00396-36237371,2023-01-01T18:13:48,Donostia,incomes,salary_partner,1389.67,-6102.86
buyer_5,Sara,30,ES41209551921252835913,TRX_N-00397-91700199,2023-01-01T18:13:48,Donostia,incomes,extra_income,230.49,-5872.37
buyer_5,Sara,30,ES41209551921252835913,TRX_N-00398-54704022,2023-01-02T11:15:39,Donostia,expenses,clothing,-132.74,-6005.11
buyer_5,Sara,30,ES41209551921252835913,TRX_N-00399-08576360,2023-01-02T18:45:47,Donostia,expenses,appliances,-192.06,-6197.17
buyer_5,Sara,30,ES41209551921252835913,TRX_N-00400-15203556,2023-01-02T01:54:08,Donostia,expenses,gifts,-809.71,-7006.88
buyer_5,Sara,30,ES41209551921252835913,TRX_N-00401-41392900,2023-01-03T20:02:28,Donostia,expenses,cash,-100.0,-7106.88
buyer_5,Sara,30,ES41209551921252835913,TRX_N-00402-22625789,2023-01-04T18:36:04,Donostia,expenses,mortgage,-705.7,-7812.58
buyer_5,Sara,30,ES41209551921252835913,TRX_N-00403-35620792,2023-01-05T08:11:55,Donostia,expenses,water,-40.46,-7853.04
buyer_5,Sara,30,ES41209551921252835913,TRX_N-00404-17538260,2023-01-05T21:53:29,Donostia,expenses,gas,-53.69,-7906.73
buyer_5,Sara,30,ES41209551921252835913,TRX_N-00405-36438530,2023-01-05T16:03:25,Donostia,expenses,internet,-42.0,-7948.73
buyer_5,Sara,30,ES41209551921252835913,TRX_N-00406-95601052,2023-01-05T13:09:16,Donostia,expenses,phone,-41.68,-7990.41
buyer_5,Sara,30,ES41209551921252835913,TRX_N-00407-06193133,2023-01-06T16:17:12,Donostia,expenses,clothing,-142.96,-8133.37
buyer_5,Sara,30,ES41209551921252835913,TRX_N-00408-68369808,2023-01-08T02:24:01,Donostia,expenses,electricity,-82.99,-8216.36
buyer_5,Sara,30,ES41209551921252835913,TRX_N-00409-67385889,2023-01-10T13:21:35,Donostia,expenses,transport,-66.71,-8283.07
buyer_5,Sara,30,ES41209551921252835913,TRX_N-00410-44954429,2023-01-11T17:40:22,Salvatierra/Agurain,expenses,food,-77.0,-8360.07
buyer_5,Sara,30,ES41209551921252835913,TRX_N-00411-56721861,2023-01-12T13:39:50,Donostia,expenses,leisure,-75.58,-8435.65
buyer_5,Sara,30,ES41209551921252835913,TRX_N-00412-01227608,2023-01-12T17:01:05,Donostia,expenses,cash,-100.0,-8535.65
buyer_5,Sara,30,ES41209551921252835913,TRX_N-00413-14888072,2023-01-14T00:33:51,Donostia,expenses,transport,-48.04,-8583.69
buyer_5,Sara,30,ES41209551921252835913,TRX_N-00414-39932902,2023-01-16T11:52:29,Zarautz,expenses,cash,-100.0,-8683.69
buyer_5,Sara,30,ES41209551921252835913,TRX_N-00415-66677545,2023-01-18T18:13:08,Donostia,expenses,leisure,-83.96,-8767.65
buyer_5,Sara,30,ES41209551921252835913,TRX_N-00416-96795146,2023-01-18T23:00:31,Hernani,expenses,clothing,-64.61,-8832.26
buyer_5,Sara,30,ES41209551921252835913,TRX_N-00417-98771522,2023-01-19T17:13:27,Donostia,expenses,cash,-100.0,-8932.26
buyer_5,Sara,30,ES41209551921252835913,TRX_N-00418-23868856,2023-01-20T10:51:57,Donostia,expenses,gifts,-459.02,-9391.28
buyer_5,Sara,30,ES41209551921252835913,TRX_N-00419-87106949,2023-01-21T18:50:16,Donostia,expenses,leisure,-28.81,-9420.09
buyer_5,Sara,30,ES41209551921252835913,TRX_N-00420-87303073,2023-01-21T05:20:04,Donostia,expenses,children,-134.63,-9554.72
buyer_5,Sara,30,ES41209551921252835913,TRX_N-00421-82617324,2023-01-22T10:43:22,Donostia,expenses,cash,-100.0,-9654.72
buyer_5,Sara,30,ES41209551921252835913,TRX_N-00422-57052833,2023-01-23T22:10:48,Donostia,expenses,food,-62.46,-9717.18
buyer_5,Sara,30,ES41209551921252835913,TRX_N-00423-54280017,2023-01-23T08:36:56,Donostia,expenses,cash,-100.0,-9817.18
buyer_5,Sara,30,ES41209551921252835913,TRX_N-00424-16399083,2023-01-24T12:55:16,Donostia,expenses,transport,-61.79,-9878.97
buyer_5,Sara,30,ES41209551921252835913,TRX_N-00425-68517829,2023-01-25T14:05:50,Donostia,expenses,leisure,-60.57,-9939.54
buyer_5,Sara,30,ES41209551921252835913,TRX_N-00426-53515157,2023-01-25T18:49:31,Donostia,expenses,cash,-100.0,-10039.54
buyer_5,Sara,30,ES41209551921252835913,TRX_N-00427-35603466,2023-01-26T03:06:05,Donostia,expenses,transport,-71.31,-10110.85
buyer_5,Sara,30,ES41209551921252835913,TRX_N-00428-88362392,2023-01-26T12:48:35,Donostia,expenses,repairs,-283.47,-10394.32
buyer_5,Sara,30,ES41209551921252835913,TRX_N-00429-07555854,2023-01-27T10:02:38,Donostia,expenses,repairs,-246.39,-10640.71
buyer_5,Sara,30,ES41209551921252835913,TRX_N-00430-43525528,2023-01-28T16:32:04,Donostia,expenses,transport,-71.31,-10712.02
buyer_5,Sara,30,ES41209551921252835913,TRX_N-00431-28315014,2023-01-29T04:07:54,Erandio,expenses,repairs,-71.25,-10783.27
buyer_5,Sara,30,ES41209551921252835913,TRX_N-00432-72940055,2023-01-30T21:21:57,Donostia,expenses,transport,-56.22,-10839.49
buyer_5,Sara,30,ES41209551921252835913,TRX_N-00433-72747510,2023-01-30T17:36:46,Llodio,expenses,leisure,-73.42,-10912.91
buyer_5,Sara,30,ES41209551921252835913,TRX_N-00434-53017327,2023-01-31T19:46:14,Donostia,expenses,cash,-100.0,-11012.91
buyer_5,Sara,30,ES41209551921252835913,TRX_N-00435-61738083,2023-02-01T13:41:25,Donostia,incomes,salary,1556.06,-9456.85
buyer_5,Sara,30,ES41209551921252835913,TRX_N-00436-71923131,2023-02-01T13:41:25,Donostia,incomes,salary_partner,1389.67,-8067.18
buyer_5,Sara,30,ES41209551921252835913,TRX_N-00437-44598151,2023-02-04T17:43:27,Donostia,expenses,mortgage,-705.7,-8772.88
buyer_5,Sara,30,ES41209551921252835913,TRX_N-00438-19185764,2023-02-04T20:49:00,Donostia,expenses,clothing,-74.2,-8847.08
buyer_5,Sara,30,ES41209551921252835913,TRX_N-00439-38325750,2023-02-04T10:11:46,Donostia,expenses,children,-213.96,-9061.04
buyer_5,Sara,30,ES41209551921252835913,TRX_N-00440-99023821,2023-02-05T16:02:40,Donostia,expenses,electricity,-25.28,-9086.32
buyer_5,Sara,30,ES41209551921252835913,TRX_N-00441-21384321,2023-02-05T08:00:06,Donostia,expenses,gas,-88.43,-9174.75
buyer_5,Sara,30,ES41209551921252835913,TRX_N-00442-68240880,2023-02-05T18:29:52,Andoain,expenses,clothing,-128.81,-9303.56
buyer_5,Sara,30,ES41209551921252835913,TRX_N-00443-53887131,2023-02-05T15:14:42,Irun,expenses,cash,-100.0,-9403.56
buyer_5,Sara,30,ES41209551921252835913,TRX_N-00444-06286928,2023-02-06T16:31:27,Donostia,expenses,phone,-31.47,-9435.03
buyer_5,Sara,30,ES41209551921252835913,TRX_N-00445-52479572,2023-02-06T11:18:54,Donostia,expenses,food,-71.98,-9507.01
buyer_5,Sara,30,ES41209551921252835913,TRX_N-00446-01199682,2023-02-07T09:59:15,Donostia,expenses,internet,-42.0,-9549.01
buyer_5,Sara,30,ES41209551921252835913,TRX_N-00447-52971927,2023-02-07T18:43:22,Donostia,expenses,transport,-45.94,-9594.95
buyer_5,Sara,30,ES41209551921252835913,TRX_N-00448-33924535,2023-02-08T18:21:01,Donostia,expenses,water,-42.34,-9637.29
buyer_5,Sara,30,ES41209551921252835913,TRX_N-00449-21117966,2023-02-08T17:30:37,Donostia,expenses,leisure,-68.05,-9705.34
buyer_5,Sara,30,ES41209551921252835913,TRX_N-00450-43434548,2023-02-10T11:58:59,Donostia,expenses,transport,-41.02,-9746.36
buyer_5,Sara,30,ES41209551921252835913,TRX_N-00451-98463109,2023-02-10T12:35:48,Donostia,expenses,cash,-100.0,-9846.36
buyer_5,Sara,30,ES41209551921252835913,TRX_N-00452-43954587,2023-02-10T18:53:19,Donostia,expenses,gifts,-784.51,-10630.87
buyer_5,Sara,30,ES41209551921252835913,TRX_N-00453-05285310,2023-02-11T16:42:13,Mungia,expenses,appliances,-193.01,-10823.88
buyer_5,Sara,30,ES41209551921252835913,TRX_N-00454-40804999,2023-02-13T15:46:03,Donostia,expenses,food,-117.28,-10941.16
buyer_5,Sara,30,ES41209551921252835913,TRX_N-00455-46296509,2023-02-13T14:17:47,Donostia,expenses,gifts,-677.67,-11618.83
buyer_5,Sara,30,ES41209551921252835913,TRX_N-00456-83713492,2023-02-15T19:34:08,Donostia,expenses,appliances,-176.53,-11795.36
buyer_5,Sara,30,ES41209551921252835913,TRX_N-00457-89327087,2023-02-17T13:11:59,Donostia,expenses,leisure,-29.64,-11825.0
buyer_5,Sara,30,ES41209551921252835913,TRX_N-00458-66216501,2023-02-20T20:02:25,Donostia,expenses,food,-77.57,-11902.57
buyer_5,Sara,30,ES41209551921252835913,TRX_N-00459-37963341,2023-02-20T08:57:15,Donostia,expenses,leisure,-65.5,-11968.07
buyer_5,Sara,30,ES41209551921252835913,TRX_N-00460-00814349,2023-02-20T16:13:08,Pasaia,expenses,travel,-755.19,-12723.26
buyer_5,Sara,30,ES41209551921252835913,TRX_N-00461-75589866,2023-02-20T23:50:08,Donostia,expenses,gifts,-208.77,-12932.03
buyer_5,Sara,30,ES41209551921252835913,TRX_N-00462-39896099,2023-02-21T03:24:59,Donostia,expenses,gifts,-587.97,-13520.0
buyer_5,Sara,30,ES41209551921252835913,TRX_N-00463-42600230,2023-02-22T10:58:45,Galdakao,expenses,transport,-66.27,-13586.27
buyer_5,Sara,30,ES41209551921252835913,TRX_N-00464-41829046,2023-02-23T15:37:02,Donostia,expenses,food,-121.78,-13708.05
buyer_5,Sara,30,ES41209551921252835913,TRX_N-00465-18652184,2023-02-23T14:03:55,Donostia,expenses,gifts,-58.07,-13766.12
buyer_5,Sara,30,ES41209551921252835913,TRX_N-00466-18338502,2023-02-25T11:40:54,Hernani,expenses,transport,-45.9,-13812.02
buyer_5,Sara,30,ES41209551921252835913,TRX_N-00467-88701401,2023-02-27T18:43:54,Donostia,expenses,food,-92.75,-13904.77
buyer_5,Sara,30,ES41209551921252835913,TRX_N-00468-31674938,2023-02-27T15:26:38,Donostia,expenses,education,-52.97,-13957.74
buyer_5,Sara,30,ES41209551921252835913,TRX_N-00469-80762324,2023-02-27T00:42:32,Errenteria,expenses,cash,-100.0,-14057.74
buyer_5,Sara,30,ES41209551921252835913,TRX_N-00470-77907526,2023-02-27T17:25:50,Donostia,expenses,appliances,-199.07,-14256.81
buyer_5,Sara,30,ES41209551921252835913,TRX_N-00471-81749141,2023-02-28T15:17:56,Donostia,expenses,food,-117.06,-14373.87
buyer_5,Sara,30,ES41209551921252835913,TRX_N-00472-56053870,2023-02-28T16:24:38,Donostia,expenses,healthcare,-67.08,-14440.95
buyer_5,Sara,30,ES41209551921252835913,TRX_N-00473-48810222,2023-02-28T11:44:23,Donostia,expenses,cash,-100.0,-14540.95
buyer_5,Sara,30,ES41209551921252835913,TRX_N-00474-93173656,2023-03-01T20:08:47,Donostia,incomes,salary,1556.06,-12984.89
buyer_5,Sara,30,ES41209551921252835913,TRX_N-00475-18475287,2023-03-01T20:08:47,Donostia,incomes,salary_partner,1389.67,-11595.22
buyer_5,Sara,30,ES41209551921252835913,TRX_N-00476-77408667,2023-03-01T10:09:07,Donostia,expenses,repairs,-112.51,-11707.73
buyer_5,Sara,30,ES41209551921252835913,TRX_N-00477-45151222,2023-03-01T04:48:59,Donostia,expenses,gifts,-84.2,-11791.93
buyer_5,Sara,30,ES41209551921252835913,TRX_N-00478-19560900,2023-03-04T12:56:42,Donostia,expenses,mortgage,-705.7,-12497.63
buyer_5,Sara,30,ES41209551921252835913,TRX_N-00479-46776202,2023-03-04T12:09:45,Donostia,expenses,food,-67.73,-12565.36
buyer_5,Sara,30,ES41209551921252835913,TRX_N-00480-72247428,2023-03-05T11:25:09,Donostia,expenses,electricity,-28.32,-12593.68
buyer_5,Sara,30,ES41209551921252835913,TRX_N-00481-14615887,2023-03-05T13:28:21,Donostia,expenses,healthcare,-52.32,-12646.0
buyer_5,Sara,30,ES41209551921252835913,TRX_N-00482-15453495,2023-03-06T16:10:43,Donostia,expenses,clothing,-156.0,-12802.0
buyer_5,Sara,30,ES41209551921252835913,TRX_N-00483-30081537,2023-03-07T12:33:04,Donostia,expenses,internet,-42.0,-12844.0
buyer_5,Sara,30,ES41209551921252835913,TRX_N-00484-31208380,2023-03-07T18:23:01,Donostia,expenses,leisure,-39.54,-12883.54
buyer_5,Sara,30,ES41209551921252835913,TRX_N-00485-67442928,2023-03-07T11:50:07,Errenteria,expenses,repairs,-259.41,-13142.95
buyer_5,Sara,30,ES41209551921252835913,TRX_N-00486-56701346,2023-03-08T15:02:05,Donostia,expenses,water,-39.7,-13182.65
buyer_5,Sara,30,ES41209551921252835913,TRX_N-00487-88472892,2023-03-08T19:43:45,Donostia,expenses,gas,-104.31,-13286.96
buyer_5,Sara,30,ES41209551921252835913,TRX_N-00488-62713142,2023-03-08T18:57:34,Donostia,expenses,phone,-44.95,-13331.91
buyer_5,Sara,30,ES41209551921252835913,TRX_N-00489-70636426,2023-03-09T14:09:45,Donostia,expenses,transport,-56.18,-13388.09
buyer_5,Sara,30,ES41209551921252835913,TRX_N-00490-12215018,2023-03-11T03:37:27,Donostia,expenses,transport,-45.74,-13433.83
buyer_5,Sara,30,ES41209551921252835913,TRX_N-00491-85930370,2023-03-12T11:45:20,Donostia,expenses,transport,-74.21,-13508.04
buyer_5,Sara,30,ES41209551921252835913,TRX_N-00492-60960522,2023-03-13T20:30:47,Donostia,expenses,appliances,-319.0,-13827.04
buyer_5,Sara,30,ES41209551921252835913,TRX_N-00493-17633749,2023-03-14T08:31:47,Donostia,expenses,leisure,-37.55,-13864.59
buyer_5,Sara,30,ES41209551921252835913,TRX_N-00494-17627691,2023-03-15T12:38:59,Zuia,expenses,clothing,-141.02,-14005.61
buyer_5,Sara,30,ES41209551921252835913,TRX_N-00495-38773530,2023-03-16T20:24:58,Donostia,expenses,leisure,-58.67,-14064.28
buyer_5,Sara,30,ES41209551921252835913,TRX_N-00496-33289292,2023-03-17T13:31:48,Donostia,expenses,appliances,-100.62,-14164.9
buyer_5,Sara,30,ES41209551921252835913,TRX_N-00497-82864035,2023-03-18T21:14:13,Donostia,expenses,cash,-100.0,-14264.9
buyer_5,Sara,30,ES41209551921252835913,TRX_N-00498-34257148,2023-03-19T16:12:39,Llodio,expenses,food,-99.97,-14364.87
buyer_5,Sara,30,ES41209551921252835913,TRX_N-00499-76414381,2023-03-20T10:54:56,Donostia,expenses,education,-68.65,-14433.52
buyer_5,Sara,30,ES41209551921252835913,TRX_N-00500-56301088,2023-03-22T18:43:08,Zuia,expenses,food,-78.39,-14511.91
buyer_5,Sara,30,ES41209551921252835913,TRX_N-00501-70614873,2023-03-22T03:38:18,Donostia,expenses,transport,-75.68,-14587.59
buyer_5,Sara,30,ES41209551921252835913,TRX_N-00502-12197048,2023-03-22T18:18:08,Donostia,expenses,healthcare,-135.9,-14723.49
buyer_5,Sara,30,ES41209551921252835913,TRX_N-00503-01376164,2023-03-25T13:29:59,Donostia,expenses,food,-120.67,-14844.16
buyer_5,Sara,30,ES41209551921252835913,TRX_N-00504-60079019,2023-03-25T20:23:01,Donostia,expenses,travel,-1145.82,-15989.98
buyer_5,Sara,30,ES41209551921252835913,TRX_N-00505-33369910,2023-03-26T11:57:03,Donostia,expenses,transport,-50.48,-16040.46
buyer_5,Sara,30,ES41209551921252835913,TRX_N-00506-30768296,2023-03-27T10:58:56,Donostia,expenses,healthcare,-163.5,-16203.96
buyer_5,Sara,30,ES41209551921252835913,TRX_N-00507-16015327,2023-03-28T19:29:34,Portugalete,expenses,transport,-55.01,-16258.97
buyer_5,Sara,30,ES41209551921252835913,TRX_N-00508-29919339,2023-03-30T09:50:56,Donostia,expenses,leisure,-43.63,-16302.6
buyer_5,Sara,30,ES41209551921252835913,TRX_N-00509-68725405,2023-03-30T08:19:33,Donostia,expenses,cash,-100.0,-16402.6
buyer_5,Sara,30,ES41209551921252835913,TRX_N-00510-95530435,2023-04-01T15:07:14,Donostia,incomes,salary,1556.06,-14846.54
buyer_5,Sara,30,ES41209551921252835913,TRX_N-00511-64550745,2023-04-01T15:07:14,Donostia,incomes,salary_partner,1389.67,-13456.87
buyer_5,Sara,30,ES41209551921252835913,TRX_N-00512-59486558,2023-04-01T15:07:14,Donostia,incomes,extra_income,230.49,-13226.38
buyer_5,Sara,30,ES41209551921252835913,TRX_N-00513-48320465,2023-04-01T08:46:04,Donostia,expenses,cash,-100.0,-13326.38
buyer_5,Sara,30,ES41209551921252835913,TRX_N-00514-52527258,2023-04-01T14:25:09,Donostia,expenses,travel,-674.49,-14000.87
buyer_5,Sara,30,ES41209551921252835913,TRX_N-00515-47544227,2023-04-03T15:16:11,Donostia,expenses,leisure,-44.57,-14045.44
buyer_5,Sara,30,ES41209551921252835913,TRX_N-00516-18757994,2023-04-03T14:15:57,Donostia,expenses,gifts,-78.28,-14123.72
buyer_5,Sara,30,ES41209551921252835913,TRX_N-00517-60461367,2023-04-04T14:02:59,Donostia,expenses,mortgage,-705.7,-14829.42
buyer_5,Sara,30,ES41209551921252835913,TRX_N-00518-91483946,2023-04-04T19:04:28,Donostia,expenses,gifts,-660.95,-15490.37
buyer_5,Sara,30,ES41209551921252835913,TRX_N-00519-84003304,2023-04-05T22:55:10,Donostia,expenses,transport,-71.19,-15561.56
buyer_5,Sara,30,ES41209551921252835913,TRX_N-00520-37693670,2023-04-07T10:12:53,Donostia,expenses,electricity,-21.77,-15583.33
buyer_5,Sara,30,ES41209551921252835913,TRX_N-00521-70321385,2023-04-07T22:56:39,Donostia,expenses,gas,-98.02,-15681.35
buyer_5,Sara,30,ES41209551921252835913,TRX_N-00522-77191991,2023-04-08T21:12:21,Donostia,expenses,water,-39.82,-15721.17
buyer_5,Sara,30,ES41209551921252835913,TRX_N-00523-95763510,2023-04-08T12:42:23,Donostia,expenses,internet,-42.0,-15763.17
buyer_5,Sara,30,ES41209551921252835913,TRX_N-00524-71128248,2023-04-08T18:06:39,Donostia,expenses,phone,-40.52,-15803.69
buyer_5,Sara,30,ES41209551921252835913,TRX_N-00525-24637424,2023-04-08T08:49:15,Lasarte-Oria,expenses,healthcare,-110.26,-15913.95
buyer_5,Sara,30,ES41209551921252835913,TRX_N-00526-51340276,2023-04-08T17:30:18,Donostia,expenses,cash,-100.0,-16013.95
buyer_5,Sara,30,ES41209551921252835913,TRX_N-00527-55873781,2023-04-09T16:51:44,Sopela,expenses,food,-123.13,-16137.08
buyer_5,Sara,30,ES41209551921252835913,TRX_N-00528-11839195,2023-04-10T10:36:42,Erandio,expenses,food,-119.74,-16256.82
buyer_5,Sara,30,ES41209551921252835913,TRX_N-00529-51443500,2023-04-11T20:17:38,Donostia,expenses,leisure,-74.31,-16331.13
buyer_5,Sara,30,ES41209551921252835913,TRX_N-00530-96097664,2023-04-11T18:10:24,Donostia,expenses,travel,-1691.33,-18022.46
buyer_5,Sara,30,ES41209551921252835913,TRX_N-00531-80945230,2023-04-15T02:26:51,Donostia,expenses,education,-47.19,-18069.65
buyer_5,Sara,30,ES41209551921252835913,TRX_N-00532-58727488,2023-04-17T14:31:09,Donostia,expenses,transport,-75.85,-18145.5
buyer_5,Sara,30,ES41209551921252835913,TRX_N-00533-01366022,2023-04-17T06:10:51,Hernani,expenses,cash,-100.0,-18245.5
buyer_5,Sara,30,ES41209551921252835913,TRX_N-00534-06978622,2023-04-18T17:36:42,Donostia,expenses,food,-113.47,-18358.97
buyer_5,Sara,30,ES41209551921252835913,TRX_N-00535-23501589,2023-04-18T15:12:05,Donostia,expenses,cash,-100.0,-18458.97
buyer_5,Sara,30,ES41209551921252835913,TRX_N-00536-54209761,2023-04-20T21:53:46,Donostia,expenses,food,-72.99,-18531.96
buyer_5,Sara,30,ES41209551921252835913,TRX_N-00537-93931141,2023-04-21T05:07:10,Mungia,expenses,cash,-100.0,-18631.96
buyer_5,Sara,30,ES41209551921252835913,TRX_N-00538-87576313,2023-04-23T12:14:13,Donostia,expenses,clothing,-101.98,-18733.94
buyer_5,Sara,30,ES41209551921252835913,TRX_N-00539-71028038,2023-04-24T19:26:43,Donostia,expenses,repairs,-295.23,-19029.17
buyer_5,Sara,30,ES41209551921252835913,TRX_N-00540-61873308,2023-04-25T11:33:25,Donostia,expenses,cash,-100.0,-19129.17
buyer_5,Sara,30,ES41209551921252835913,TRX_N-00541-26067280,2023-04-26T21:44:10,Donostia,expenses,food,-61.29,-19190.46
buyer_5,Sara,30,ES41209551921252835913,TRX_N-00542-97677479,2023-04-26T14:19:00,Donostia,expenses,cash,-100.0,-19290.46
buyer_5,Sara,30,ES41209551921252835913,TRX_N-00543-73889140,2023-04-27T09:38:56,Donostia,expenses,cash,-100.0,-19390.46
buyer_5,Sara,30,ES41209551921252835913,TRX_N-00544-49460671,2023-04-28T19:14:34,Donostia,expenses,cash,-100.0,-19490.46
buyer_5,Sara,30,ES41209551921252835913,TRX_N-00545-51037998,2023-04-30T14:24:20,Donostia,expenses,appliances,-121.1,-19611.56
buyer_5,Sara,30,ES41209551921252835913,TRX_N-00546-05125678,2023-05-01T12:26:59,Donostia,incomes,salary,1556.06,-18055.5
buyer_5,Sara,30,ES41209551921252835913,TRX_N-00547-62624745,2023-05-01T12:26:59,Donostia,incomes,salary_partner,1389.67,-16665.83
buyer_5,Sara,30,ES41209551921252835913,TRX_N-00548-20702992,2023-05-03T23:49:50,Donostia,expenses,healthcare,-77.8,-16743.63
buyer_5,Sara,30,ES41209551921252835913,TRX_N-00549-82145678,2023-05-03T09:28:20,Donostia,expenses,gifts,-785.28,-17528.91
buyer_5,Sara,30,ES41209551921252835913,TRX_N-00550-33862505,2023-05-04T10:11:15,Donostia,expenses,mortgage,-705.7,-18234.61
buyer_5,Sara,30,ES41209551921252835913,TRX_N-00551-31084054,2023-05-05T16:20:39,Donostia,expenses,education,-72.11,-18306.72
buyer_5,Sara,30,ES41209551921252835913,TRX_N-00552-00121643,2023-05-06T16:41:10,Donostia,expenses,water,-24.74,-18331.46
buyer_5,Sara,30,ES41209551921252835913,TRX_N-00553-12054624,2023-05-06T06:48:28,Donostia,expenses,electricity,-22.56,-18354.02
buyer_5,Sara,30,ES41209551921252835913,TRX_N-00554-09781559,2023-05-06T10:40:45,Donostia,expenses,internet,-42.0,-18396.02
buyer_5,Sara,30,ES41209551921252835913,TRX_N-00555-33517989,2023-05-06T01:39:42,Donostia,expenses,transport,-68.36,-18464.38
buyer_5,Sara,30,ES41209551921252835913,TRX_N-00556-61031373,2023-05-06T13:56:49,Pasaia,expenses,leisure,-31.04,-18495.42
buyer_5,Sara,30,ES41209551921252835913,TRX_N-00557-77503978,2023-05-07T13:32:49,Donostia,expenses,gas,-94.83,-18590.25
buyer_5,Sara,30,ES41209551921252835913,TRX_N-00558-99673874,2023-05-07T16:27:49,Donostia,expenses,food,-98.66,-18688.91
buyer_5,Sara,30,ES41209551921252835913,TRX_N-00559-22037393,2023-05-08T14:26:11,Donostia,expenses,phone,-42.67,-18731.58
buyer_5,Sara,30,ES41209551921252835913,TRX_N-00560-40453132,2023-05-08T14:32:24,Donostia,expenses,food,-112.25,-18843.83
buyer_5,Sara,30,ES41209551921252835913,TRX_N-00561-28989195,2023-05-08T08:59:28,Donostia,expenses,transport,-85.9,-18929.73
buyer_5,Sara,30,ES41209551921252835913,TRX_N-00562-83513420,2023-05-09T14:56:47,Donostia,expenses,transport,-70.53,-19000.26
buyer_5,Sara,30,ES41209551921252835913,TRX_N-00563-23326401,2023-05-11T07:12:14,Donostia,expenses,healthcare,-89.78,-19090.04
buyer_5,Sara,30,ES41209551921252835913,TRX_N-00564-62619019,2023-05-13T09:30:01,Portugalete,expenses,leisure,-82.68,-19172.72
buyer_5,Sara,30,ES41209551921252835913,TRX_N-00565-00352977,2023-05-13T19:40:02,Donostia,expenses,cash,-100.0,-19272.72
buyer_5,Sara,30,ES41209551921252835913,TRX_N-00566-77334416,2023-05-14T13:40:54,Donostia,expenses,cash,-100.0,-19372.72
buyer_5,Sara,30,ES41209551921252835913,TRX_N-00567-64558002,2023-05-15T10:04:48,Donostia,expenses,clothing,-145.81,-19518.53
buyer_5,Sara,30,ES41209551921252835913,TRX_N-00568-84172635,2023-05-16T10:59:45,Donostia,expenses,transport,-77.86,-19596.39
buyer_5,Sara,30,ES41209551921252835913,TRX_N-00569-02596788,2023-05-16T17:43:03,Donostia,expenses,healthcare,-186.18,-19782.57
buyer_5,Sara,30,ES41209551921252835913,TRX_N-00570-09079138,2023-05-17T19:16:01,Donostia,expenses,leisure,-83.38,-19865.95
buyer_5,Sara,30,ES41209551921252835913,TRX_N-00571-41349554,2023-05-18T20:18:36,Donostia,expenses,leisure,-46.07,-19912.02
buyer_5,Sara,30,ES41209551921252835913,TRX_N-00572-97352794,2023-05-19T17:08:42,Donostia,expenses,transport,-54.57,-19966.59
buyer_5,Sara,30,ES41209551921252835913,TRX_N-00573-55926542,2023-05-22T14:07:20,Donostia,expenses,education,-60.16,-20026.75
buyer_5,Sara,30,ES41209551921252835913,TRX_N-00574-68880564,2023-05-23T20:11:50,Donostia,expenses,travel,-504.65,-20531.4
buyer_5,Sara,30,ES41209551921252835913,TRX_N-00575-69371631,2023-05-24T16:59:15,Donostia,expenses,cash,-100.0,-20631.4
buyer_5,Sara,30,ES41209551921252835913,TRX_N-00576-53247407,2023-05-26T20:24:35,Bermeo,expenses,leisure,-47.1,-20678.5
buyer_5,Sara,30,ES41209551921252835913,TRX_N-00577-01303393,2023-05-28T12:19:05,Donostia,expenses,repairs,-143.12,-20821.62
buyer_5,Sara,30,ES41209551921252835913,TRX_N-00578-97829385,2023-05-30T12:13:19,Pasaia,expenses,gifts,-826.95,-21648.57
buyer_5,Sara,30,ES41209551921252835913,TRX_N-00579-82652619,2023-05-31T17:37:19,Donostia,expenses,food,-99.85,-21748.42
buyer_5,Sara,30,ES41209551921252835913,TRX_N-00580-48323851,2023-05-31T11:03:40,Bermeo,expenses,transport,-67.41,-21815.83
buyer_5,Sara,30,ES41209551921252835913,TRX_N-00581-07924675,2023-06-01T16:51:36,Donostia,incomes,salary,1556.06,-20259.77
buyer_5,Sara,30,ES41209551921252835913,TRX_N-00582-19933510,2023-06-01T16:51:36,Donostia,incomes,salary_partner,1389.67,-18870.1
buyer_5,Sara,30,ES41209551921252835913,TRX_N-00583-13269830,2023-06-01T16:51:36,Donostia,incomes,salary_bonus,1189.82,-17680.28
buyer_5,Sara,30,ES41209551921252835913,TRX_N-00584-93065859,2023-06-01T16:51:36,Donostia,incomes,salary_partner_bonus,989.51,-16690.77
buyer_5,Sara,30,ES41209551921252835913,TRX_N-00585-01430897,2023-06-02T04:02:27,Sestao,expenses,cash,-100.0,-16790.77
buyer_5,Sara,30,ES41209551921252835913,TRX_N-00586-98521838,2023-06-03T21:55:34,Donostia,expenses,repairs,-31.47,-16822.24
buyer_5,Sara,30,ES41209551921252835913,TRX_N-00587-22443499,2023-06-04T15:11:48,Donostia,expenses,mortgage,-705.7,-17527.94
buyer_5,Sara,30,ES41209551921252835913,TRX_N-00588-21413072,2023-06-04T20:32:53,Donostia,expenses,children,-223.56,-17751.5
buyer_5,Sara,30,ES41209551921252835913,TRX_N-00589-45426487,2023-06-05T15:44:28,Donostia,expenses,water,-36.22,-17787.72
buyer_5,Sara,30,ES41209551921252835913,TRX_N-00590-59226673,2023-06-05T20:02:10,Donostia,expenses,clothing,-89.78,-17877.5
buyer_5,Sara,30,ES41209551921252835913,TRX_N-00591-26405682,2023-06-06T13:56:50,Donostia,expenses,food,-90.69,-17968.19
buyer_5,Sara,30,ES41209551921252835913,TRX_N-00592-55179922,2023-06-07T18:38:28,Donostia,expenses,electricity,-87.17,-18055.36
buyer_5,Sara,30,ES41209551921252835913,TRX_N-00593-32014680,2023-06-07T20:51:43,Donostia,expenses,internet,-42.0,-18097.36
buyer_5,Sara,30,ES41209551921252835913,TRX_N-00594-17458252,2023-06-07T11:46:31,Mungia,expenses,transport,-72.64,-18170.0
buyer_5,Sara,30,ES41209551921252835913,TRX_N-00595-56872566,2023-06-07T16:34:24,Vitoria-Gasteiz,expenses,travel,-1280.98,-19450.98
buyer_5,Sara,30,ES41209551921252835913,TRX_N-00596-53472359,2023-06-08T16:07:55,Donostia,expenses,gas,-108.89,-19559.87
buyer_5,Sara,30,ES41209551921252835913,TRX_N-00597-79916403,2023-06-08T19:09:20,Donostia,expenses,phone,-36.85,-19596.72
buyer_5,Sara,30,ES41209551921252835913,TRX_N-00598-44932518,2023-06-08T08:01:41,Alegría-Dulantzi,expenses,cash,-100.0,-19696.72
buyer_5,Sara,30,ES41209551921252835913,TRX_N-00599-54322897,2023-06-09T04:43:24,Donostia,expenses,food,-116.68,-19813.4
buyer_5,Sara,30,ES41209551921252835913,TRX_N-00600-47775872,2023-06-09T15:24:06,Elciego,expenses,clothing,-146.62,-19960.02
buyer_5,Sara,30,ES41209551921252835913,TRX_N-00601-67901498,2023-06-15T09:59:01,Donostia,expenses,leisure,-35.83,-19995.85
buyer_5,Sara,30,ES41209551921252835913,TRX_N-00602-40307861,2023-06-18T15:09:23,Donostia,expenses,cash,-100.0,-20095.85
buyer_5,Sara,30,ES41209551921252835913,TRX_N-00603-27937729,2023-06-20T17:49:53,Donostia,expenses,leisure,-52.13,-20147.98
buyer_5,Sara,30,ES41209551921252835913,TRX_N-00604-49107818,2023-06-20T13:31:21,Amurrio,expenses,healthcare,-68.64,-20216.62
buyer_5,Sara,30,ES41209551921252835913,TRX_N-00605-85852740,2023-06-20T22:24:28,Donostia,expenses,cash,-100.0,-20316.62
buyer_5,Sara,30,ES41209551921252835913,TRX_N-00606-06661873,2023-06-20T17:08:12,Donostia,expenses,travel,-1317.7,-21634.32
buyer_5,Sara,30,ES41209551921252835913,TRX_N-00607-58114301,2023-06-22T08:06:06,Donostia,expenses,leisure,-50.53,-21684.85
buyer_5,Sara,30,ES41209551921252835913,TRX_N-00608-53944241,2023-06-24T22:29:27,Donostia,expenses,cash,-100.0,-21784.85
buyer_5,Sara,30,ES41209551921252835913,TRX_N-00609-39913680,2023-06-26T18:30:11,Getxo,expenses,food,-64.43,-21849.28
buyer_5,Sara,30,ES41209551921252835913,TRX_N-00610-32200861,2023-06-26T13:05:03,Getxo,expenses,education,-49.49,-21898.77
buyer_5,Sara,30,ES41209551921252835913,TRX_N-00611-34150687,2023-06-27T14:40:22,Donostia,expenses,leisure,-37.06,-21935.83
buyer_5,Sara,30,ES41209551921252835913,TRX_N-00612-50962646,2023-06-29T02:49:37,Donostia,expenses,food,-67.88,-22003.71
buyer_5,Sara,30,ES41209551921252835913,TRX_N-00613-57666223,2023-06-29T09:10:33,Donostia,expenses,leisure,-52.7,-22056.41
buyer_5,Sara,30,ES41209551921252835913,TRX_N-00614-77516811,2023-06-29T20:21:22,Donostia,expenses,children,-167.78,-22224.19
buyer_5,Sara,30,ES41209551921252835913,TRX_N-00615-61777327,2023-06-30T10:32:09,Donostia,expenses,food,-96.2,-22320.39
buyer_5,Sara,30,ES41209551921252835913,TRX_N-00616-39600485,2023-06-30T08:06:09,Donostia,expenses,transport,-52.04,-22372.43
buyer_5,Sara,30,ES41209551921252835913,TRX_N-00617-19125229,2023-07-01T16:04:54,Donostia,incomes,salary,1556.06,-20816.37
buyer_5,Sara,30,ES41209551921252835913,TRX_N-00618-83733683,2023-07-01T16:04:54,Donostia,incomes,salary_partner,1389.67,-19426.7
buyer_5,Sara,30,ES41209551921252835913,TRX_N-00619-53861010,2023-07-02T20:28:53,Irun,expenses,food,-81.71,-19508.41
buyer_5,Sara,30,ES41209551921252835913,TRX_N-00620-40270702,2023-07-03T06:02:22,Donostia,expenses,transport,-77.53,-19585.94
buyer_5,Sara,30,ES41209551921252835913,TRX_N-00621-89999209,2023-07-03T18:08:30,Elciego,expenses,leisure,-70.97,-19656.91
buyer_5,Sara,30,ES41209551921252835913,TRX_N-00622-09038438,2023-07-04T14:18:17,Donostia,expenses,mortgage,-705.7,-20362.61
buyer_5,Sara,30,ES41209551921252835913,TRX_N-00623-56283872,2023-07-04T08:29:56,Salvatierra/Agurain,expenses,cash,-100.0,-20462.61
buyer_5,Sara,30,ES41209551921252835913,TRX_N-00624-22969229,2023-07-05T14:09:34,Donostia,expenses,water,-34.46,-20497.07
buyer_5,Sara,30,ES41209551921252835913,TRX_N-00625-61124366,2023-07-05T22:27:10,Donostia,expenses,gas,-49.64,-20546.71
buyer_5,Sara,30,ES41209551921252835913,TRX_N-00626-99188948,2023-07-05T20:53:03,Donostia,expenses,internet,-42.0,-20588.71
buyer_5,Sara,30,ES41209551921252835913,TRX_N-00627-57233606,2023-07-05T08:11:36,Donostia,expenses,phone,-31.88,-20620.59
buyer_5,Sara,30,ES41209551921252835913,TRX_N-00628-78987888,2023-07-06T21:16:06,Donostia,expenses,cash,-100.0,-20720.59
buyer_5,Sara,30,ES41209551921252835913,TRX_N-00629-72461629,2023-07-08T19:27:35,Donostia,expenses,electricity,-33.66,-20754.25
buyer_5,Sara,30,ES41209551921252835913,TRX_N-00630-89168183,2023-07-10T11:14:45,Donostia,expenses,appliances,-151.6,-20905.85
buyer_5,Sara,30,ES41209551921252835913,TRX_N-00631-40501842,2023-07-11T17:23:49,Donostia,expenses,cash,-100.0,-21005.85
buyer_5,Sara,30,ES41209551921252835913,TRX_N-00632-65279184,2023-07-12T10:38:07,Bilbao,expenses,cash,-100.0,-21105.85
buyer_5,Sara,30,ES41209551921252835913,TRX_N-00633-75056188,2023-07-13T09:39:54,Leioa,expenses,leisure,-68.42,-21174.27
buyer_5,Sara,30,ES41209551921252835913,TRX_N-00634-63311553,2023-07-16T17:06:04,Lasarte-Oria,expenses,food,-67.26,-21241.53
buyer_5,Sara,30,ES41209551921252835913,TRX_N-00635-16869342,2023-07-16T14:09:18,Sopela,expenses,cash,-100.0,-21341.53
buyer_5,Sara,30,ES41209551921252835913,TRX_N-00636-90395453,2023-07-17T18:42:22,Donostia,expenses,travel,-357.03,-21698.56
buyer_5,Sara,30,ES41209551921252835913,TRX_N-00637-29162653,2023-07-19T20:43:38,Donostia,expenses,transport,-80.94,-21779.5
buyer_5,Sara,30,ES41209551921252835913,TRX_N-00638-99980674,2023-07-19T11:29:49,Donostia,expenses,leisure,-51.51,-21831.01
buyer_5,Sara,30,ES41209551921252835913,TRX_N-00639-94189623,2023-07-19T10:59:15,Donostia,expenses,repairs,-42.53,-21873.54
buyer_5,Sara,30,ES41209551921252835913,TRX_N-00640-05689136,2023-07-20T11:47:08,Erandio,expenses,leisure,-19.91,-21893.45
buyer_5,Sara,30,ES41209551921252835913,TRX_N-00641-88036503,2023-07-22T15:15:52,Donostia,expenses,education,-60.9,-21954.35
buyer_5,Sara,30,ES41209551921252835913,TRX_N-00642-68210858,2023-07-24T08:51:24,Donostia,expenses,food,-100.86,-22055.21
buyer_5,Sara,30,ES41209551921252835913,TRX_N-00643-32669395,2023-07-24T23:46:04,Donostia,expenses,leisure,-74.91,-22130.12
buyer_5,Sara,30,ES41209551921252835913,TRX_N-00644-12682655,2023-07-25T20:37:50,Elciego,expenses,transport,-60.56,-22190.68
buyer_5,Sara,30,ES41209551921252835913,TRX_N-00645-59949344,2023-07-27T19:58:37,Zuia,expenses,repairs,-125.3,-22315.98
buyer_5,Sara,30,ES41209551921252835913,TRX_N-00646-23245894,2023-07-27T20:41:23,Donostia,expenses,children,-191.55,-22507.53
buyer_5,Sara,30,ES41209551921252835913,TRX_N-00647-23205104,2023-07-28T19:39:37,Basauri,expenses,leisure,-82.94,-22590.47
buyer_5,Sara,30,ES41209551921252835913,TRX_N-00648-43292223,2023-07-28T09:28:14,Donostia,expenses,gifts,-760.13,-23350.6
buyer_5,Sara,30,ES41209551921252835913,TRX_N-00649-92163531,2023-08-01T09:46:00,Donostia,incomes,salary,1556.06,-21794.54
buyer_5,Sara,30,ES41209551921252835913,TRX_N-00650-92744340,2023-08-01T09:46:00,Donostia,incomes,salary_partner,1389.67,-20404.87
buyer_5,Sara,30,ES41209551921252835913,TRX_N-00651-11979703,2023-08-01T09:46:00,Donostia,incomes,extra_income,230.49,-20174.38
buyer_5,Sara,30,ES41209551921252835913,TRX_N-00652-91858034,2023-08-01T13:45:56,Donostia,expenses,transport,-41.37,-20215.75
buyer_5,Sara,30,ES41209551921252835913,TRX_N-00653-05779638,2023-08-03T11:58:09,Donostia,expenses,cash,-100.0,-20315.75
buyer_5,Sara,30,ES41209551921252835913,TRX_N-00654-66005126,2023-08-04T09:44:34,Donostia,expenses,mortgage,-705.7,-21021.45
buyer_5,Sara,30,ES41209551921252835913,TRX_N-00655-45954520,2023-08-04T12:57:02,Donostia,expenses,food,-63.66,-21085.11
buyer_5,Sara,30,ES41209551921252835913,TRX_N-00656-72744699,2023-08-04T16:46:32,Donostia,expenses,transport,-85.27,-21170.38
buyer_5,Sara,30,ES41209551921252835913,TRX_N-00657-98191087,2023-08-04T19:52:02,Donostia,expenses,clothing,-114.37,-21284.75
buyer_5,Sara,30,ES41209551921252835913,TRX_N-00658-95169668,2023-08-05T13:35:39,Donostia,expenses,clothing,-57.51,-21342.26
buyer_5,Sara,30,ES41209551921252835913,TRX_N-00659-59012445,2023-08-06T21:31:33,Donostia,expenses,gas,-113.68,-21455.94
buyer_5,Sara,30,ES41209551921252835913,TRX_N-00660-29177131,2023-08-06T11:43:34,Donostia,expenses,phone,-41.39,-21497.33
buyer_5,Sara,30,ES41209551921252835913,TRX_N-00661-86132694,2023-08-06T18:30:59,Donostia,expenses,food,-116.82,-21614.15
buyer_5,Sara,30,ES41209551921252835913,TRX_N-00662-50997399,2023-08-07T12:36:08,Donostia,expenses,transport,-55.5,-21669.65
buyer_5,Sara,30,ES41209551921252835913,TRX_N-00663-78168219,2023-08-08T20:21:43,Donostia,expenses,electricity,-82.75,-21752.4
buyer_5,Sara,30,ES41209551921252835913,TRX_N-00664-82975839,2023-08-08T15:31:21,Donostia,expenses,internet,-42.0,-21794.4
buyer_5,Sara,30,ES41209551921252835913,TRX_N-00665-52641476,2023-08-08T20:19:51,Donostia,expenses,water,-42.73,-21837.13
buyer_5,Sara,30,ES41209551921252835913,TRX_N-00666-09446878,2023-08-09T16:05:40,Donostia,expenses,education,-75.78,-21912.91
buyer_5,Sara,30,ES41209551921252835913,TRX_N-00667-19485055,2023-08-09T11:18:58,Donostia,expenses,repairs,-324.82,-22237.73
buyer_5,Sara,30,ES41209551921252835913,TRX_N-00668-86537706,2023-08-10T22:07:32,Donostia,expenses,travel,-1215.11,-23452.84
buyer_5,Sara,30,ES41209551921252835913,TRX_N-00669-32590503,2023-08-10T08:26:35,Donostia,expenses,repairs,-41.36,-23494.2
buyer_5,Sara,30,ES41209551921252835913,TRX_N-00670-50779925,2023-08-12T13:37:19,Donostia,expenses,leisure,-54.54,-23548.74
buyer_5,Sara,30,ES41209551921252835913,TRX_N-00671-91017268,2023-08-12T09:02:03,Donostia,expenses,cash,-100.0,-23648.74
buyer_5,Sara,30,ES41209551921252835913,TRX_N-00672-47172802,2023-08-12T13:38:32,Irun,expenses,repairs,-53.61,-23702.35
buyer_5,Sara,30,ES41209551921252835913,TRX_N-00673-24752747,2023-08-14T14:26:42,Donostia,expenses,clothing,-58.32,-23760.67
buyer_5,Sara,30,ES41209551921252835913,TRX_N-00674-28748204,2023-08-14T18:39:01,Donostia,expenses,cash,-100.0,-23860.67
buyer_5,Sara,30,ES41209551921252835913,TRX_N-00675-05565084,2023-08-15T18:26:31,Donostia,expenses,leisure,-35.24,-23895.91
buyer_5,Sara,30,ES41209551921252835913,TRX_N-00676-32787953,2023-08-16T15:25:08,Donostia,expenses,appliances,-227.13,-24123.04
buyer_5,Sara,30,ES41209551921252835913,TRX_N-00677-59655617,2023-08-17T19:16:07,Donostia,expenses,education,-53.88,-24176.92
buyer_5,Sara,30,ES41209551921252835913,TRX_N-00678-09233033,2023-08-17T17:19:31,Donostia,expenses,cash,-100.0,-24276.92
buyer_5,Sara,30,ES41209551921252835913,TRX_N-00679-23985840,2023-08-17T20:23:14,Santurtzi,expenses,repairs,-279.66,-24556.58
buyer_5,Sara,30,ES41209551921252835913,TRX_N-00680-09399117,2023-08-18T08:58:23,Donostia,expenses,clothing,-131.66,-24688.24
buyer_5,Sara,30,ES41209551921252835913,TRX_N-00681-39357908,2023-08-18T18:00:36,Donostia,expenses,cash,-100.0,-24788.24
buyer_5,Sara,30,ES41209551921252835913,TRX_N-00682-60609146,2023-08-18T08:58:05,Donostia,expenses,gifts,-27.77,-24816.01
buyer_5,Sara,30,ES41209551921252835913,TRX_N-00683-98787786,2023-08-20T15:52:18,Donostia,expenses,food,-72.51,-24888.52
buyer_5,Sara,30,ES41209551921252835913,TRX_N-00684-38261438,2023-08-20T20:11:17,Donostia,expenses,transport,-48.68,-24937.2
buyer_5,Sara,30,ES41209551921252835913,TRX_N-00685-57391796,2023-08-20T16:01:03,Bermeo,expenses,leisure,-81.38,-25018.58
buyer_5,Sara,30,ES41209551921252835913,TRX_N-00686-23333879,2023-08-20T20:29:38,Donostia,expenses,gifts,-176.29,-25194.87
buyer_5,Sara,30,ES41209551921252835913,TRX_N-00687-00771277,2023-08-21T22:04:28,Donostia,expenses,food,-114.85,-25309.72
buyer_5,Sara,30,ES41209551921252835913,TRX_N-00688-12615031,2023-08-25T23:00:12,Leioa,expenses,cash,-100.0,-25409.72
buyer_5,Sara,30,ES41209551921252835913,TRX_N-00689-19834605,2023-08-25T12:10:42,Donostia,expenses,repairs,-59.72,-25469.44
buyer_5,Sara,30,ES41209551921252835913,TRX_N-00690-12626673,2023-08-26T14:55:42,Donostia,expenses,cash,-100.0,-25569.44
buyer_5,Sara,30,ES41209551921252835913,TRX_N-00691-90688628,2023-08-30T03:58:54,Donostia,expenses,clothing,-136.79,-25706.23
buyer_5,Sara,30,ES41209551921252835913,TRX_N-00692-38209546,2023-08-30T17:53:54,Leioa,expenses,cash,-100.0,-25806.23
buyer_5,Sara,30,ES41209551921252835913,TRX_N-00693-76067403,2023-09-01T10:06:41,Donostia,incomes,salary,1556.06,-24250.17
buyer_5,Sara,30,ES41209551921252835913,TRX_N-00694-47552409,2023-09-01T10:06:41,Donostia,incomes,salary_partner,1389.67,-22860.5
buyer_5,Sara,30,ES41209551921252835913,TRX_N-00695-74700426,2023-09-02T17:17:17,Hernani,expenses,healthcare,-64.31,-22924.81
buyer_5,Sara,30,ES41209551921252835913,TRX_N-00696-97273052,2023-09-03T11:38:49,Donostia,expenses,transport,-63.44,-22988.25
buyer_5,Sara,30,ES41209551921252835913,TRX_N-00697-13339032,2023-09-03T04:06:04,Donostia,expenses,leisure,-41.04,-23029.29
buyer_5,Sara,30,ES41209551921252835913,TRX_N-00698-37453878,2023-09-04T08:59:22,Donostia,expenses,mortgage,-705.7,-23734.99
buyer_5,Sara,30,ES41209551921252835913,TRX_N-00699-38182962,2023-09-04T03:01:51,Donostia,expenses,leisure,-71.8,-23806.79
buyer_5,Sara,30,ES41209551921252835913,TRX_N-00700-97417449,2023-09-04T08:15:36,Irun,expenses,appliances,-383.41,-24190.2
buyer_5,Sara,30,ES41209551921252835913,TRX_N-00701-73864799,2023-09-05T17:39:24,Donostia,expenses,water,-39.54,-24229.74
buyer_5,Sara,30,ES41209551921252835913,TRX_N-00702-96324323,2023-09-05T09:25:57,Donostia,expenses,internet,-42.0,-24271.74
buyer_5,Sara,30,ES41209551921252835913,TRX_N-00703-54363137,2023-09-07T13:22:52,Donostia,expenses,transport,-88.89,-24360.63
buyer_5,Sara,30,ES41209551921252835913,TRX_N-00704-34437036,2023-09-07T13:25:05,Donostia,expenses,children,-133.46,-24494.09
buyer_5,Sara,30,ES41209551921252835913,TRX_N-00705-17007609,2023-09-08T21:38:37,Donostia,expenses,electricity,-32.63,-24526.72
buyer_5,Sara,30,ES41209551921252835913,TRX_N-00706-06270603,2023-09-08T08:53:52,Donostia,expenses,gas,-45.06,-24571.78
buyer_5,Sara,30,ES41209551921252835913,TRX_N-00707-71339493,2023-09-08T03:00:03,Donostia,expenses,phone,-32.06,-24603.84
buyer_5,Sara,30,ES41209551921252835913,TRX_N-00708-03847581,2023-09-08T13:28:05,Donostia,expenses,repairs,-130.75,-24734.59
buyer_5,Sara,30,ES41209551921252835913,TRX_N-00709-33477932,2023-09-08T10:48:51,Donostia,expenses,children,-225.96,-24960.55
buyer_5,Sara,30,ES41209551921252835913,TRX_N-00710-25786816,2023-09-09T22:34:33,Donostia,expenses,transport,-82.81,-25043.36
buyer_5,Sara,30,ES41209551921252835913,TRX_N-00711-46165804,2023-09-09T11:46:26,Donostia,expenses,leisure,-84.14,-25127.5
buyer_5,Sara,30,ES41209551921252835913,TRX_N-00712-75733383,2023-09-09T14:17:14,Portugalete,expenses,repairs,-79.19,-25206.69
buyer_5,Sara,30,ES41209551921252835913,TRX_N-00713-97193402,2023-09-10T11:20:56,Hondarribia,expenses,repairs,-220.32,-25427.01
buyer_5,Sara,30,ES41209551921252835913,TRX_N-00714-55925146,2023-09-12T17:57:43,Donostia,expenses,food,-111.13,-25538.14
buyer_5,Sara,30,ES41209551921252835913,TRX_N-00715-62809255,2023-09-12T01:35:52,Donostia,expenses,leisure,-56.83,-25594.97
buyer_5,Sara,30,ES41209551921252835913,TRX_N-00716-93321468,2023-09-13T17:15:56,Donostia,expenses,food,-70.4,-25665.37
buyer_5,Sara,30,ES41209551921252835913,TRX_N-00717-41592779,2023-09-15T08:06:49,Donostia,expenses,education,-57.72,-25723.09
buyer_5,Sara,30,ES41209551921252835913,TRX_N-00718-03000319,2023-09-16T08:51:45,Donostia,expenses,food,-84.13,-25807.22
buyer_5,Sara,30,ES41209551921252835913,TRX_N-00719-95547571,2023-09-20T10:51:37,Donostia,expenses,clothing,-78.47,-25885.69
buyer_5,Sara,30,ES41209551921252835913,TRX_N-00720-52217613,2023-09-20T17:55:07,Donostia,expenses,cash,-100.0,-25985.69
buyer_5,Sara,30,ES41209551921252835913,TRX_N-00721-02181232,2023-09-22T17:12:44,Donostia,expenses,education,-77.58,-26063.27
buyer_5,Sara,30,ES41209551921252835913,TRX_N-00722-90145004,2023-09-24T20:29:15,Donostia,expenses,food,-71.98,-26135.25
buyer_5,Sara,30,ES41209551921252835913,TRX_N-00723-29795204,2023-09-25T08:02:05,Leioa,expenses,travel,-302.39,-26437.64
buyer_5,Sara,30,ES41209551921252835913,TRX_N-00724-30320595,2023-09-26T05:41:16,Donostia,expenses,food,-86.13,-26523.77
buyer_5,Sara,30,ES41209551921252835913,TRX_N-00725-23231193,2023-09-29T20:51:36,Donostia,expenses,food,-70.89,-26594.66
buyer_5,Sara,30,ES41209551921252835913,TRX_N-00726-72698001,2023-09-29T23:09:57,Donostia,expenses,transport,-56.62,-26651.28
buyer_5,Sara,30,ES41209551921252835913,TRX_N-00727-51424543,2023-10-01T20:03:23,Donostia,incomes,salary,1556.06,-25095.22
buyer_5,Sara,30,ES41209551921252835913,TRX_N-00728-38144596,2023-10-01T20:03:23,Donostia,incomes,salary_partner,1389.67,-23705.55
buyer_5,Sara,30,ES41209551921252835913,TRX_N-00729-12422231,2023-10-01T13:47:34,Donostia,expenses,food,-106.56,-23812.11
buyer_5,Sara,30,ES41209551921252835913,TRX_N-00730-23877667,2023-10-02T11:49:24,Llodio,expenses,transport,-61.55,-23873.66
buyer_5,Sara,30,ES41209551921252835913,TRX_N-00731-03587364,2023-10-02T13:03:56,Donostia,expenses,healthcare,-155.05,-24028.71
buyer_5,Sara,30,ES41209551921252835913,TRX_N-00732-07033400,2023-10-03T13:06:57,Donostia,expenses,cash,-100.0,-24128.71
buyer_5,Sara,30,ES41209551921252835913,TRX_N-00733-06741856,2023-10-04T17:29:42,Donostia,expenses,mortgage,-705.7,-24834.41
buyer_5,Sara,30,ES41209551921252835913,TRX_N-00734-04886896,2023-10-05T22:16:58,Donostia,expenses,electricity,-83.8,-24918.21
buyer_5,Sara,30,ES41209551921252835913,TRX_N-00735-40918760,2023-10-05T16:57:05,Donostia,expenses,gas,-82.75,-25000.96
buyer_5,Sara,30,ES41209551921252835913,TRX_N-00736-08827084,2023-10-05T08:56:41,Donostia,expenses,internet,-42.0,-25042.96
buyer_5,Sara,30,ES41209551921252835913,TRX_N-00737-35515264,2023-10-05T16:25:45,Donostia,expenses,phone,-33.01,-25075.97
buyer_5,Sara,30,ES41209551921252835913,TRX_N-00738-66439083,2023-10-05T15:26:11,Hondarribia,expenses,cash,-100.0,-25175.97
buyer_5,Sara,30,ES41209551921252835913,TRX_N-00739-36858842,2023-10-07T17:44:58,Donostia,expenses,water,-44.26,-25220.23
buyer_5,Sara,30,ES41209551921252835913,TRX_N-00740-54941732,2023-10-08T17:32:33,Donostia,expenses,cash,-100.0,-25320.23
buyer_5,Sara,30,ES41209551921252835913,TRX_N-00741-42042819,2023-10-09T23:50:27,Donostia,expenses,food,-69.86,-25390.09
buyer_5,Sara,30,ES41209551921252835913,TRX_N-00742-07637894,2023-10-10T09:25:23,Elciego,expenses,clothing,-103.43,-25493.52
buyer_5,Sara,30,ES41209551921252835913,TRX_N-00743-54441214,2023-10-10T14:35:36,Donostia,expenses,cash,-100.0,-25593.52
buyer_5,Sara,30,ES41209551921252835913,TRX_N-00744-75518456,2023-10-10T08:05:08,Donostia,expenses,children,-99.43,-25692.95
buyer_5,Sara,30,ES41209551921252835913,TRX_N-00745-20898817,2023-10-11T13:42:33,Donostia,expenses,repairs,-49.68,-25742.63
buyer_5,Sara,30,ES41209551921252835913,TRX_N-00746-67555779,2023-10-12T09:51:09,Donostia,expenses,appliances,-142.73,-25885.36
buyer_5,Sara,30,ES41209551921252835913,TRX_N-00747-24489389,2023-10-13T17:48:49,Donostia,expenses,gifts,-362.38,-26247.74
buyer_5,Sara,30,ES41209551921252835913,TRX_N-00748-40677873,2023-10-17T09:06:56,Donostia,expenses,food,-72.73,-26320.47
buyer_5,Sara,30,ES41209551921252835913,TRX_N-00749-24418308,2023-10-17T16:32:18,Donostia,expenses,children,-209.88,-26530.35
buyer_5,Sara,30,ES41209551921252835913,TRX_N-00750-58864682,2023-10-18T12:24:33,Donostia,expenses,appliances,-218.61,-26748.96
buyer_5,Sara,30,ES41209551921252835913,TRX_N-00751-98872846,2023-10-20T20:51:13,Donostia,expenses,appliances,-152.06,-26901.02
buyer_5,Sara,30,ES41209551921252835913,TRX_N-00752-42388607,2023-10-21T19:28:09,Donostia,expenses,repairs,-113.78,-27014.8
buyer_5,Sara,30,ES41209551921252835913,TRX_N-00753-76619634,2023-10-28T20:30:23,Donostia,expenses,appliances,-156.18,-27170.98
buyer_5,Sara,30,ES41209551921252835913,TRX_N-00754-40663965,2023-10-31T08:53:46,Donostia,expenses,repairs,-261.25,-27432.23
buyer_5,Sara,30,ES41209551921252835913,TRX_N-00755-09880873,2023-11-01T10:57:43,Donostia,incomes,salary,1556.06,-25876.17
buyer_5,Sara,30,ES41209551921252835913,TRX_N-00756-79821362,2023-11-01T10:57:43,Donostia,incomes,salary_partner,1389.67,-24486.5
buyer_5,Sara,30,ES41209551921252835913,TRX_N-00757-01725498,2023-11-01T17:47:16,Donostia,expenses,transport,-57.19,-24543.69
buyer_5,Sara,30,ES41209551921252835913,TRX_N-00758-88999061,2023-11-02T15:42:23,Donostia,expenses,repairs,-214.02,-24757.71
buyer_5,Sara,30,ES41209551921252835913,TRX_N-00759-42282825,2023-11-03T05:04:49,Donostia,expenses,transport,-43.32,-24801.03
buyer_5,Sara,30,ES41209551921252835913,TRX_N-00760-90564369,2023-11-04T05:03:27,Donostia,expenses,mortgage,-705.7,-25506.73
buyer_5,Sara,30,ES41209551921252835913,TRX_N-00761-39503466,2023-11-05T20:39:21,Donostia,expenses,electricity,-35.65,-25542.38
buyer_5,Sara,30,ES41209551921252835913,TRX_N-00762-93760493,2023-11-05T17:49:57,Donostia,expenses,food,-96.66,-25639.04
buyer_5,Sara,30,ES41209551921252835913,TRX_N-00763-72869922,2023-11-06T15:33:25,Donostia,expenses,gas,-91.14,-25730.18
buyer_5,Sara,30,ES41209551921252835913,TRX_N-00764-99473447,2023-11-06T13:51:03,Donostia,expenses,phone,-39.05,-25769.23
buyer_5,Sara,30,ES41209551921252835913,TRX_N-00765-16029601,2023-11-08T16:11:41,Donostia,expenses,water,-41.21,-25810.44
buyer_5,Sara,30,ES41209551921252835913,TRX_N-00766-67690990,2023-11-08T06:12:29,Donostia,expenses,internet,-42.0,-25852.44
buyer_5,Sara,30,ES41209551921252835913,TRX_N-00767-71019894,2023-11-08T12:54:38,Donostia,expenses,children,-172.14,-26024.58
buyer_5,Sara,30,ES41209551921252835913,TRX_N-00768-65728179,2023-11-11T15:05:12,Andoain,expenses,cash,-100.0,-26124.58
buyer_5,Sara,30,ES41209551921252835913,TRX_N-00769-89792563,2023-11-12T07:27:52,Donostia,expenses,healthcare,-113.92,-26238.5
buyer_5,Sara,30,ES41209551921252835913,TRX_N-00770-45030787,2023-11-14T21:13:37,Donostia,expenses,healthcare,-151.8,-26390.3
buyer_5,Sara,30,ES41209551921252835913,TRX_N-00771-93726287,2023-11-15T16:49:19,Donostia,expenses,education,-77.26,-26467.56
buyer_5,Sara,30,ES41209551921252835913,TRX_N-00772-20394259,2023-11-16T15:44:33,Donostia,expenses,cash,-100.0,-26567.56
buyer_5,Sara,30,ES41209551921252835913,TRX_N-00773-69791162,2023-11-16T16:23:23,Donostia,expenses,children,-277.99,-26845.55
buyer_5,Sara,30,ES41209551921252835913,TRX_N-00774-10701150,2023-11-17T19:07:57,Donostia,expenses,repairs,-202.09,-27047.64
buyer_5,Sara,30,ES41209551921252835913,TRX_N-00775-71625681,2023-11-18T16:35:17,Donostia,expenses,food,-60.6,-27108.24
buyer_5,Sara,30,ES41209551921252835913,TRX_N-00776-11208230,2023-11-19T19:32:51,Donostia,expenses,leisure,-19.46,-27127.7
buyer_5,Sara,30,ES41209551921252835913,TRX_N-00777-74903788,2023-11-19T11:54:32,Donostia,expenses,appliances,-333.48,-27461.18
buyer_5,Sara,30,ES41209551921252835913,TRX_N-00778-57545488,2023-11-20T13:01:37,Donostia,expenses,transport,-69.87,-27531.05
buyer_5,Sara,30,ES41209551921252835913,TRX_N-00779-22949303,2023-11-20T19:55:18,Donostia,expenses,leisure,-70.47,-27601.52
buyer_5,Sara,30,ES41209551921252835913,TRX_N-00780-88890337,2023-11-22T19:21:17,Donostia,expenses,food,-96.54,-27698.06
buyer_5,Sara,30,ES41209551921252835913,TRX_N-00781-50772902,2023-11-22T17:14:38,Donostia,expenses,leisure,-62.45,-27760.51
buyer_5,Sara,30,ES41209551921252835913,TRX_N-00782-90806684,2023-11-22T18:59:14,Donostia,expenses,clothing,-59.65,-27820.16
buyer_5,Sara,30,ES41209551921252835913,TRX_N-00783-02968680,2023-11-22T10:24:46,Donostia,expenses,repairs,-197.62,-28017.78
buyer_5,Sara,30,ES41209551921252835913,TRX_N-00784-85974940,2023-11-23T17:26:15,Donostia,expenses,cash,-100.0,-28117.78
buyer_5,Sara,30,ES41209551921252835913,TRX_N-00785-38132621,2023-11-26T12:24:37,Barakaldo,expenses,food,-74.22,-28192.0
buyer_5,Sara,30,ES41209551921252835913,TRX_N-00786-22817080,2023-11-27T17:16:13,Donostia,expenses,transport,-51.17,-28243.17
buyer_5,Sara,30,ES41209551921252835913,TRX_N-00787-93541773,2023-11-27T19:57:07,Donostia,expenses,leisure,-70.88,-28314.05
buyer_5,Sara,30,ES41209551921252835913,TRX_N-00788-26569924,2023-11-27T22:05:31,Donostia,expenses,cash,-100.0,-28414.05
buyer_5,Sara,30,ES41209551921252835913,TRX_N-00789-79267838,2023-11-30T19:22:58,Donostia,expenses,leisure,-54.59,-28468.64
buyer_5,Sara,30,ES41209551921252835913,TRX_N-00790-00241572,2023-12-01T13:56:55,Donostia,incomes,salary,1556.06,-26912.58
buyer_5,Sara,30,ES41209551921252835913,TRX_N-00791-69372550,2023-12-01T13:56:55,Donostia,incomes,salary_partner,1389.67,-25522.91
buyer_5,Sara,30,ES41209551921252835913,TRX_N-00792-93116815,2023-12-01T13:56:55,Donostia,incomes,extra_income,230.49,-25292.42
buyer_5,Sara,30,ES41209551921252835913,TRX_N-00793-45849017,2023-12-01T13:56:55,Donostia,incomes,salary_bonus,1200.98,-24091.44
buyer_5,Sara,30,ES41209551921252835913,TRX_N-00794-24422322,2023-12-01T13:56:55,Donostia,incomes,salary_partner_bonus,1029.97,-23061.47
buyer_5,Sara,30,ES41209551921252835913,TRX_N-00795-24786962,2023-12-02T08:54:18,Llodio,expenses,food,-105.73,-23167.2
buyer_5,Sara,30,ES41209551921252835913,TRX_N-00796-58155714,2023-12-02T13:35:16,Donostia,expenses,cash,-100.0,-23267.2
buyer_5,Sara,30,ES41209551921252835913,TRX_N-00797-52608591,2023-12-03T14:11:22,Donostia,expenses,cash,-100.0,-23367.2
buyer_5,Sara,30,ES41209551921252835913,TRX_N-00798-16676353,2023-12-03T17:32:55,Donostia,expenses,children,-222.9,-23590.1
buyer_5,Sara,30,ES41209551921252835913,TRX_N-00799-53199317,2023-12-04T10:47:51,Donostia,expenses,mortgage,-705.7,-24295.8
buyer_5,Sara,30,ES41209551921252835913,TRX_N-00800-65796062,2023-12-05T18:15:18,Donostia,expenses,electricity,-81.47,-24377.27
buyer_5,Sara,30,ES41209551921252835913,TRX_N-00801-50878657,2023-12-06T01:44:19,Donostia,expenses,gas,-78.49,-24455.76
buyer_5,Sara,30,ES41209551921252835913,TRX_N-00802-61980399,2023-12-07T13:04:47,Donostia,expenses,water,-35.34,-24491.1
buyer_5,Sara,30,ES41209551921252835913,TRX_N-00803-47497404,2023-12-07T10:06:31,Donostia,expenses,internet,-42.0,-24533.1
buyer_5,Sara,30,ES41209551921252835913,TRX_N-00804-26344352,2023-12-07T08:51:59,Sopela,expenses,food,-118.5,-24651.6
buyer_5,Sara,30,ES41209551921252835913,TRX_N-00805-60544116,2023-12-07T13:07:28,Donostia,expenses,cash,-100.0,-24751.6
buyer_5,Sara,30,ES41209551921252835913,TRX_N-00806-58781107,2023-12-08T11:31:47,Donostia,expenses,phone,-41.83,-24793.43
buyer_5,Sara,30,ES41209551921252835913,TRX_N-00807-24325975,2023-12-08T21:39:53,Donostia,expenses,education,-55.86,-24849.29
buyer_5,Sara,30,ES41209551921252835913,TRX_N-00808-05759345,2023-12-08T11:27:47,Donostia,expenses,repairs,-245.45,-25094.74
buyer_5,Sara,30,ES41209551921252835913,TRX_N-00809-69135097,2023-12-09T21:21:31,Donostia,expenses,cash,-100.0,-25194.74
buyer_5,Sara,30,ES41209551921252835913,TRX_N-00810-36329990,2023-12-10T14:31:55,Donostia,expenses,food,-80.66,-25275.4
buyer_5,Sara,30,ES41209551921252835913,TRX_N-00811-00253056,2023-12-10T19:30:54,Hondarribia,expenses,transport,-84.54,-25359.94
buyer_5,Sara,30,ES41209551921252835913,TRX_N-00812-40939189,2023-12-10T06:28:10,Donostia,expenses,cash,-100.0,-25459.94
buyer_5,Sara,30,ES41209551921252835913,TRX_N-00813-21952282,2023-12-11T13:57:37,Donostia,expenses,clothing,-100.83,-25560.77
buyer_5,Sara,30,ES41209551921252835913,TRX_N-00814-52934686,2023-12-11T11:10:02,Donostia,expenses,children,-263.82,-25824.59
buyer_5,Sara,30,ES41209551921252835913,TRX_N-00815-98444640,2023-12-13T08:42:49,Donostia,expenses,leisure,-75.86,-25900.45
buyer_5,Sara,30,ES41209551921252835913,TRX_N-00816-21813982,2023-12-14T12:20:35,Donostia,expenses,clothing,-157.32,-26057.77
buyer_5,Sara,30,ES41209551921252835913,TRX_N-00817-07703464,2023-12-16T02:48:30,Donostia,expenses,leisure,-70.14,-26127.91
buyer_5,Sara,30,ES41209551921252835913,TRX_N-00818-77766761,2023-12-16T09:51:03,Donostia,expenses,healthcare,-67.47,-26195.38
buyer_5,Sara,30,ES41209551921252835913,TRX_N-00819-43069708,2023-12-17T19:28:18,Donostia,expenses,clothing,-78.27,-26273.65
buyer_5,Sara,30,ES41209551921252835913,TRX_N-00820-04458827,2023-12-19T13:14:01,Donostia,expenses,gifts,-773.82,-27047.47
buyer_5,Sara,30,ES41209551921252835913,TRX_N-00821-29149306,2023-12-22T17:40:39,Donostia,expenses,leisure,-38.53,-27086.0
buyer_5,Sara,30,ES41209551921252835913,TRX_N-00822-87965413,2023-12-23T15:58:46,Donostia,expenses,food,-111.44,-27197.44
buyer_5,Sara,30,ES41209551921252835913,TRX_N-00823-79009575,2023-12-23T08:50:05,Donostia,expenses,leisure,-35.88,-27233.32
buyer_5,Sara,30,ES41209551921252835913,TRX_N-00824-21762960,2023-12-24T10:07:30,Hernani,expenses,food,-108.7,-27342.02
buyer_5,Sara,30,ES41209551921252835913,TRX_N-00825-09322983,2023-12-25T04:44:03,Donostia,expenses,education,-74.86,-27416.88
buyer_5,Sara,30,ES41209551921252835913,TRX_N-00826-63208077,2023-12-26T16:26:12,Donostia,expenses,food,-94.28,-27511.16
buyer_5,Sara,30,ES41209551921252835913,TRX_N-00827-91734617,2023-12-26T15:42:29,Donostia,expenses,gifts,-111.66,-27622.82
buyer_5,Sara,30,ES41209551921252835913,TRX_N-00828-15873548,2023-12-31T01:09:33,Donostia,expenses,repairs,-226.08,-27848.9
buyer_5,Sara,30,ES41209551921252835913,TRX_N-00829-05180184,2024-01-01T19:10:58,Donostia,incomes,salary,1610.29,-26238.61
buyer_5,Sara,30,ES41209551921252835913,TRX_N-00830-84856542,2024-01-01T19:10:58,Donostia,incomes,salary_partner,1438.1,-24800.51
buyer_5,Sara,30,ES41209551921252835913,TRX_N-00831-78619467,2024-01-01T13:04:15,Berango,expenses,leisure,-67.82,-24868.33
buyer_5,Sara,30,ES41209551921252835913,TRX_N-00832-34290008,2024-01-02T16:06:09,Donostia,expenses,cash,-100.0,-24968.33
buyer_5,Sara,30,ES41209551921252835913,TRX_N-00833-67354451,2024-01-02T20:57:13,Donostia,expenses,children,-113.47,-25081.8
buyer_5,Sara,30,ES41209551921252835913,TRX_N-00834-39762117,2024-01-03T15:17:07,Donostia,expenses,cash,-100.0,-25181.8
buyer_5,Sara,30,ES41209551921252835913,TRX_N-00835-79404286,2024-01-04T15:42:40,Donostia,expenses,mortgage,-705.7,-25887.5
buyer_5,Sara,30,ES41209551921252835913,TRX_N-00836-70727527,2024-01-05T13:16:13,Donostia,expenses,electricity,-43.86,-25931.36
buyer_5,Sara,30,ES41209551921252835913,TRX_N-00837-48627697,2024-01-05T13:38:01,Donostia,expenses,gas,-61.83,-25993.19
buyer_5,Sara,30,ES41209551921252835913,TRX_N-00838-01089592,2024-01-05T10:02:06,Donostia,expenses,internet,-42.0,-26035.19
buyer_5,Sara,30,ES41209551921252835913,TRX_N-00839-52974112,2024-01-05T09:18:17,Donostia,expenses,phone,-40.7,-26075.89
buyer_5,Sara,30,ES41209551921252835913,TRX_N-00840-67223878,2024-01-06T11:26:11,Donostia,expenses,water,-24.2,-26100.09
buyer_5,Sara,30,ES41209551921252835913,TRX_N-00841-06694622,2024-01-06T17:06:31,Donostia,expenses,leisure,-27.37,-26127.46
buyer_5,Sara,30,ES41209551921252835913,TRX_N-00842-22990989,2024-01-06T15:24:38,Donostia,expenses,children,-160.6,-26288.06
buyer_5,Sara,30,ES41209551921252835913,TRX_N-00843-98919897,2024-01-07T16:56:42,Donostia,expenses,cash,-100.0,-26388.06
buyer_5,Sara,30,ES41209551921252835913,TRX_N-00844-30660361,2024-01-09T06:25:51,Donostia,expenses,clothing,-94.25,-26482.31
buyer_5,Sara,30,ES41209551921252835913,TRX_N-00845-11548198,2024-01-13T08:39:18,Donostia,expenses,transport,-64.55,-26546.86
buyer_5,Sara,30,ES41209551921252835913,TRX_N-00846-86960559,2024-01-15T21:00:38,Donostia,expenses,leisure,-47.98,-26594.84
buyer_5,Sara,30,ES41209551921252835913,TRX_N-00847-20554762,2024-01-15T20:16:02,Donostia,expenses,repairs,-127.92,-26722.76
buyer_5,Sara,30,ES41209551921252835913,TRX_N-00848-05502598,2024-01-17T23:48:38,Donostia,expenses,leisure,-81.7,-26804.46
buyer_5,Sara,30,ES41209551921252835913,TRX_N-00849-47375301,2024-01-18T19:08:00,Donostia,expenses,cash,-100.0,-26904.46
buyer_5,Sara,30,ES41209551921252835913,TRX_N-00850-28702143,2024-01-19T23:33:29,Donostia,expenses,clothing,-94.24,-26998.7
buyer_5,Sara,30,ES41209551921252835913,TRX_N-00851-44293585,2024-01-19T18:43:53,Donostia,expenses,education,-45.79,-27044.49
buyer_5,Sara,30,ES41209551921252835913,TRX_N-00852-51783427,2024-01-20T16:01:53,Donostia,expenses,transport,-64.86,-27109.35
buyer_5,Sara,30,ES41209551921252835913,TRX_N-00853-29140259,2024-01-21T15:53:06,Donostia,expenses,transport,-69.36,-27178.71
buyer_5,Sara,30,ES41209551921252835913,TRX_N-00854-04397429,2024-01-21T10:19:51,Donostia,expenses,children,-55.22,-27233.93
buyer_5,Sara,30,ES41209551921252835913,TRX_N-00855-02804492,2024-01-22T15:59:04,Donostia,expenses,food,-119.89,-27353.82
buyer_5,Sara,30,ES41209551921252835913,TRX_N-00856-20471776,2024-01-24T17:09:36,Donostia,expenses,food,-99.89,-27453.71
buyer_5,Sara,30,ES41209551921252835913,TRX_N-00857-51194503,2024-01-25T09:52:31,Donostia,expenses,food,-119.11,-27572.82
buyer_5,Sara,30,ES41209551921252835913,TRX_N-00858-38094056,2024-01-25T08:56:04,Amurrio,expenses,cash,-100.0,-27672.82
buyer_5,Sara,30,ES41209551921252835913,TRX_N-00859-83481935,2024-01-26T20:45:30,Donostia,expenses,food,-112.44,-27785.26
buyer_5,Sara,30,ES41209551921252835913,TRX_N-00860-11145848,2024-01-26T13:06:15,Mungia,expenses,cash,-100.0,-27885.26
buyer_5,Sara,30,ES41209551921252835913,TRX_N-00861-02447733,2024-01-27T20:16:22,Donostia,expenses,cash,-100.0,-27985.26
buyer_5,Sara,30,ES41209551921252835913,TRX_N-00862-30199418,2024-01-27T23:47:12,Donostia,expenses,appliances,-400.44,-28385.7
buyer_5,Sara,30,ES41209551921252835913,TRX_N-00863-17583724,2024-01-28T20:49:46,Donostia,expenses,leisure,-30.27,-28415.97
buyer_5,Sara,30,ES41209551921252835913,TRX_N-00864-44676268,2024-01-30T14:30:07,Donostia,expenses,children,-270.77,-28686.74
buyer_5,Sara,30,ES41209551921252835913,TRX_N-00865-70454697,2024-01-31T22:56:07,Sestao,expenses,food,-69.52,-28756.26
buyer_5,Sara,30,ES41209551921252835913,TRX_N-00866-65375559,2024-02-01T16:14:03,Donostia,incomes,salary,1610.29,-27145.97
buyer_5,Sara,30,ES41209551921252835913,TRX_N-00867-69313852,2024-02-01T16:14:03,Donostia,incomes,salary_partner,1438.1,-25707.87
buyer_5,Sara,30,ES41209551921252835913,TRX_N-00868-69825840,2024-02-02T13:10:42,Donostia,expenses,repairs,-216.11,-25923.98
buyer_5,Sara,30,ES41209551921252835913,TRX_N-00869-38356256,2024-02-04T10:52:38,Donostia,expenses,mortgage,-705.7,-26629.68
buyer_5,Sara,30,ES41209551921252835913,TRX_N-00870-90842670,2024-02-04T11:44:32,Donostia,expenses,travel,-919.75,-27549.43
buyer_5,Sara,30,ES41209551921252835913,TRX_N-00871-05641514,2024-02-04T13:28:17,Pasaia,expenses,repairs,-285.5,-27834.93
buyer_5,Sara,30,ES41209551921252835913,TRX_N-00872-26706458,2024-02-06T10:14:49,Donostia,expenses,internet,-42.0,-27876.93
buyer_5,Sara,30,ES41209551921252835913,TRX_N-00873-22993855,2024-02-07T14:51:37,Erandio,expenses,repairs,-135.82,-28012.75
buyer_5,Sara,30,ES41209551921252835913,TRX_N-00874-03633001,2024-02-08T15:42:24,Donostia,expenses,electricity,-44.95,-28057.7
buyer_5,Sara,30,ES41209551921252835913,TRX_N-00875-00799983,2024-02-08T14:26:46,Donostia,expenses,water,-21.69,-28079.39
buyer_5,Sara,30,ES41209551921252835913,TRX_N-00876-07988405,2024-02-08T14:06:32,Donostia,expenses,gas,-75.21,-28154.6
buyer_5,Sara,30,ES41209551921252835913,TRX_N-00877-71260375,2024-02-08T11:10:12,Donostia,expenses,phone,-36.89,-28191.49
buyer_5,Sara,30,ES41209551921252835913,TRX_N-00878-54063671,2024-02-08T15:23:36,Donostia,expenses,healthcare,-145.28,-28336.77
buyer_5,Sara,30,ES41209551921252835913,TRX_N-00879-28386307,2024-02-09T13:29:59,Donostia,expenses,leisure,-24.88,-28361.65
buyer_5,Sara,30,ES41209551921252835913,TRX_N-00880-22034836,2024-02-12T20:53:33,Donostia,expenses,food,-121.38,-28483.03
buyer_5,Sara,30,ES41209551921252835913,TRX_N-00881-13815532,2024-02-12T17:12:02,Donostia,expenses,children,-50.76,-28533.79
buyer_5,Sara,30,ES41209551921252835913,TRX_N-00882-48394343,2024-02-13T15:51:56,Elciego,expenses,transport,-59.65,-28593.44
buyer_5,Sara,30,ES41209551921252835913,TRX_N-00883-91166156,2024-02-13T11:02:10,Donostia,expenses,cash,-100.0,-28693.44
buyer_5,Sara,30,ES41209551921252835913,TRX_N-00884-15182132,2024-02-14T11:54:37,Donostia,expenses,clothing,-87.2,-28780.64
buyer_5,Sara,30,ES41209551921252835913,TRX_N-00885-59784795,2024-02-16T23:08:06,Vitoria-Gasteiz,expenses,transport,-58.29,-28838.93
buyer_5,Sara,30,ES41209551921252835913,TRX_N-00886-34081911,2024-02-17T14:51:31,Donostia,expenses,cash,-100.0,-28938.93
buyer_5,Sara,30,ES41209551921252835913,TRX_N-00887-80287059,2024-02-18T16:50:07,Sopela,expenses,appliances,-139.5,-29078.43
buyer_5,Sara,30,ES41209551921252835913,TRX_N-00888-52313810,2024-02-23T19:01:09,Bermeo,expenses,food,-114.48,-29192.91
buyer_5,Sara,30,ES41209551921252835913,TRX_N-00889-19788634,2024-02-25T08:53:08,Bilbao,expenses,cash,-100.0,-29292.91
buyer_5,Sara,30,ES41209551921252835913,TRX_N-00890-92402502,2024-02-27T10:10:58,Donostia,expenses,cash,-100.0,-29392.91
buyer_5,Sara,30,ES41209551921252835913,TRX_N-00891-24290442,2024-02-28T17:54:37,Salvatierra/Agurain,expenses,education,-76.77,-29469.68
buyer_5,Sara,30,ES41209551921252835913,TRX_N-00892-70483183,2024-03-01T18:44:58,Donostia,incomes,salary,1610.29,-27859.39
buyer_5,Sara,30,ES41209551921252835913,TRX_N-00893-91315495,2024-03-01T18:44:58,Donostia,incomes,salary_partner,1438.1,-26421.29
buyer_5,Sara,30,ES41209551921252835913,TRX_N-00894-24469700,2024-03-01T18:44:58,Donostia,incomes,extra_income,230.49,-26190.8
buyer_5,Sara,30,ES41209551921252835913,TRX_N-00895-65674318,2024-03-01T08:03:58,Donostia,expenses,leisure,-20.64,-26211.44
buyer_5,Sara,30,ES41209551921252835913,TRX_N-00896-19948650,2024-03-02T13:06:16,Donostia,expenses,food,-103.37,-26314.81
buyer_5,Sara,30,ES41209551921252835913,TRX_N-00897-09540519,2024-03-02T08:17:56,Donostia,expenses,leisure,-78.62,-26393.43
buyer_5,Sara,30,ES41209551921252835913,TRX_N-00898-25340327,2024-03-03T11:10:34,Donostia,expenses,food,-114.43,-26507.86
buyer_5,Sara,30,ES41209551921252835913,TRX_N-00899-78583966,2024-03-04T20:25:16,Donostia,expenses,mortgage,-705.7,-27213.56
buyer_5,Sara,30,ES41209551921252835913,TRX_N-00900-02703107,2024-03-04T18:57:20,Donostia,expenses,repairs,-297.01,-27510.57
buyer_5,Sara,30,ES41209551921252835913,TRX_N-00901-05405913,2024-03-05T01:17:11,Donostia,expenses,water,-30.62,-27541.19
buyer_5,Sara,30,ES41209551921252835913,TRX_N-00902-26784033,2024-03-05T01:17:39,Donostia,expenses,education,-77.06,-27618.25
buyer_5,Sara,30,ES41209551921252835913,TRX_N-00903-57477903,2024-03-06T10:02:25,Donostia,expenses,gas,-105.87,-27724.12
buyer_5,Sara,30,ES41209551921252835913,TRX_N-00904-99804181,2024-03-06T00:50:26,Donostia,expenses,phone,-38.81,-27762.93
buyer_5,Sara,30,ES41209551921252835913,TRX_N-00905-61119023,2024-03-08T18:38:32,Donostia,expenses,electricity,-80.77,-27843.7
buyer_5,Sara,30,ES41209551921252835913,TRX_N-00906-87305954,2024-03-08T05:21:34,Donostia,expenses,internet,-42.0,-27885.7
buyer_5,Sara,30,ES41209551921252835913,TRX_N-00907-98031389,2024-03-08T15:18:44,Donostia,expenses,food,-114.88,-28000.58
buyer_5,Sara,30,ES41209551921252835913,TRX_N-00908-73320699,2024-03-10T15:08:06,Donostia,expenses,healthcare,-105.75,-28106.33
buyer_5,Sara,30,ES41209551921252835913,TRX_N-00909-92824226,2024-03-10T17:30:03,Donostia,expenses,education,-72.25,-28178.58
buyer_5,Sara,30,ES41209551921252835913,TRX_N-00910-03447243,2024-03-11T17:45:41,Barakaldo,expenses,food,-84.16,-28262.74
buyer_5,Sara,30,ES41209551921252835913,TRX_N-00911-77212960,2024-03-11T17:58:43,Donostia,expenses,transport,-66.95,-28329.69
buyer_5,Sara,30,ES41209551921252835913,TRX_N-00912-96873088,2024-03-12T14:05:56,Berango,expenses,food,-105.58,-28435.27
buyer_5,Sara,30,ES41209551921252835913,TRX_N-00913-45203839,2024-03-15T15:39:38,Donostia,expenses,transport,-74.83,-28510.1
buyer_5,Sara,30,ES41209551921252835913,TRX_N-00914-91036093,2024-03-20T19:47:08,Portugalete,expenses,clothing,-73.03,-28583.13
buyer_5,Sara,30,ES41209551921252835913,TRX_N-00915-89614232,2024-03-21T20:15:48,Pasaia,expenses,clothing,-58.35,-28641.48
buyer_5,Sara,30,ES41209551921252835913,TRX_N-00916-86253021,2024-03-21T16:40:22,Donostia,expenses,cash,-100.0,-28741.48
buyer_5,Sara,30,ES41209551921252835913,TRX_N-00917-46235172,2024-03-22T05:26:27,Erandio,expenses,education,-51.35,-28792.83
buyer_5,Sara,30,ES41209551921252835913,TRX_N-00918-15905109,2024-03-22T21:06:24,Donostia,expenses,children,-181.5,-28974.33
buyer_5,Sara,30,ES41209551921252835913,TRX_N-00919-92746594,2024-03-23T09:28:08,Donostia,expenses,leisure,-22.97,-28997.3
buyer_5,Sara,30,ES41209551921252835913,TRX_N-00920-25232677,2024-03-24T19:31:17,Donostia,expenses,repairs,-28.03,-29025.33
buyer_5,Sara,30,ES41209551921252835913,TRX_N-00921-38837950,2024-03-25T17:40:26,Donostia,expenses,leisure,-79.05,-29104.38
buyer_5,Sara,30,ES41209551921252835913,TRX_N-00922-24267835,2024-03-26T11:59:13,Donostia,expenses,leisure,-56.89,-29161.27
buyer_5,Sara,30,ES41209551921252835913,TRX_N-00923-73365114,2024-03-26T05:31:01,Donostia,expenses,gifts,-30.56,-29191.83
buyer_5,Sara,30,ES41209551921252835913,TRX_N-00924-88323071,2024-03-27T08:08:28,Donostia,expenses,cash,-100.0,-29291.83
buyer_5,Sara,30,ES41209551921252835913,TRX_N-00925-11033408,2024-03-30T19:12:40,Donostia,expenses,clothing,-124.99,-29416.82
buyer_5,Sara,30,ES41209551921252835913,TRX_N-00926-37145187,2024-03-31T15:11:37,Donostia,expenses,clothing,-140.73,-29557.55
buyer_5,Sara,30,ES41209551921252835913,TRX_N-00927-52300918,2024-04-01T17:58:19,Donostia,incomes,salary,1610.29,-27947.26
buyer_5,Sara,30,ES41209551921252835913,TRX_N-00928-44795722,2024-04-01T17:58:19,Donostia,incomes,salary_partner,1438.1,-26509.16
buyer_5,Sara,30,ES41209551921252835913,TRX_N-00929-65850088,2024-04-01T10:43:30,Donostia,expenses,food,-100.48,-26609.64
buyer_5,Sara,30,ES41209551921252835913,TRX_N-00930-62545729,2024-04-02T16:26:48,Donostia,expenses,children,-213.96,-26823.6
buyer_5,Sara,30,ES41209551921252835913,TRX_N-00931-09083374,2024-04-04T09:44:21,Donostia,expenses,mortgage,-705.7,-27529.3
buyer_5,Sara,30,ES41209551921252835913,TRX_N-00932-20098585,2024-04-05T13:50:28,Donostia,expenses,phone,-42.12,-27571.42
buyer_5,Sara,30,ES41209551921252835913,TRX_N-00933-83753997,2024-04-05T18:44:28,Arrasate,expenses,transport,-59.58,-27631.0
buyer_5,Sara,30,ES41209551921252835913,TRX_N-00934-05115741,2024-04-05T17:59:27,Donostia,expenses,education,-46.01,-27677.01
buyer_5,Sara,30,ES41209551921252835913,TRX_N-00935-53564987,2024-04-06T15:56:38,Donostia,expenses,leisure,-20.66,-27697.67
buyer_5,Sara,30,ES41209551921252835913,TRX_N-00936-72692324,2024-04-07T19:19:33,Donostia,expenses,cash,-100.0,-27797.67
buyer_5,Sara,30,ES41209551921252835913,TRX_N-00937-49973245,2024-04-08T08:37:45,Donostia,expenses,electricity,-61.25,-27858.92
buyer_5,Sara,30,ES41209551921252835913,TRX_N-00938-68535927,2024-04-08T16:27:49,Donostia,expenses,water,-29.1,-27888.02
buyer_5,Sara,30,ES41209551921252835913,TRX_N-00939-23525516,2024-04-08T17:55:14,Donostia,expenses,gas,-76.31,-27964.33
buyer_5,Sara,30,ES41209551921252835913,TRX_N-00940-53286945,2024-04-08T17:42:51,Donostia,expenses,internet,-42.0,-28006.33
buyer_5,Sara,30,ES41209551921252835913,TRX_N-00941-21609394,2024-04-10T23:27:01,Donostia,expenses,leisure,-33.39,-28039.72
buyer_5,Sara,30,ES41209551921252835913,TRX_N-00942-83114220,2024-04-11T18:21:08,Donostia,expenses,gifts,-796.16,-28835.88
buyer_5,Sara,30,ES41209551921252835913,TRX_N-00943-56677861,2024-04-12T18:51:07,Donostia,expenses,clothing,-88.28,-28924.16
buyer_5,Sara,30,ES41209551921252835913,TRX_N-00944-09553243,2024-04-12T18:52:48,Donostia,expenses,cash,-100.0,-29024.16
buyer_5,Sara,30,ES41209551921252835913,TRX_N-00945-99430256,2024-04-13T16:39:20,Leioa,expenses,leisure,-35.04,-29059.2
buyer_5,Sara,30,ES41209551921252835913,TRX_N-00946-94232595,2024-04-13T08:00:46,Donostia,expenses,cash,-100.0,-29159.2
buyer_5,Sara,30,ES41209551921252835913,TRX_N-00947-59689350,2024-04-14T11:57:09,Donostia,expenses,leisure,-64.87,-29224.07
buyer_5,Sara,30,ES41209551921252835913,TRX_N-00948-47952502,2024-04-19T17:53:01,Donostia,expenses,leisure,-44.42,-29268.49
buyer_5,Sara,30,ES41209551921252835913,TRX_N-00949-92994940,2024-04-20T18:49:54,Donostia,expenses,leisure,-23.52,-29292.01
buyer_5,Sara,30,ES41209551921252835913,TRX_N-00950-62647941,2024-04-21T19:45:33,Donostia,expenses,food,-64.0,-29356.01
buyer_5,Sara,30,ES41209551921252835913,TRX_N-00951-32363193,2024-04-25T12:27:43,Donostia,expenses,leisure,-76.48,-29432.49
buyer_5,Sara,30,ES41209551921252835913,TRX_N-00952-23581341,2024-04-25T11:05:53,Donostia,expenses,cash,-100.0,-29532.49
buyer_5,Sara,30,ES41209551921252835913,TRX_N-00953-97856353,2024-04-27T07:08:21,Donostia,expenses,appliances,-81.53,-29614.02
buyer_5,Sara,30,ES41209551921252835913,TRX_N-00954-03267475,2024-04-30T18:32:49,Donostia,expenses,appliances,-410.41,-30024.43
buyer_5,Sara,30,ES41209551921252835913,TRX_N-00955-06159200,2024-05-01T16:23:02,Donostia,incomes,salary,1610.29,-28414.14
buyer_5,Sara,30,ES41209551921252835913,TRX_N-00956-55160961,2024-05-01T16:23:02,Donostia,incomes,salary_partner,1438.1,-26976.04
buyer_5,Sara,30,ES41209551921252835913,TRX_N-00957-83976012,2024-05-01T19:13:30,Donostia,expenses,repairs,-208.88,-27184.92
buyer_5,Sara,30,ES41209551921252835913,TRX_N-00958-76107627,2024-05-02T17:43:05,Donostia,expenses,education,-50.46,-27235.38
buyer_5,Sara,30,ES41209551921252835913,TRX_N-00959-45143643,2024-05-02T19:24:09,Zuia,expenses,cash,-100.0,-27335.38
buyer_5,Sara,30,ES41209551921252835913,TRX_N-00960-67922225,2024-05-04T15:23:02,Donostia,expenses,mortgage,-705.7,-28041.08
buyer_5,Sara,30,ES41209551921252835913,TRX_N-00961-77035985,2024-05-04T19:08:11,Donostia,expenses,education,-48.06,-28089.14
buyer_5,Sara,30,ES41209551921252835913,TRX_N-00962-89818707,2024-05-05T11:50:01,Donostia,expenses,water,-20.16,-28109.3
buyer_5,Sara,30,ES41209551921252835913,TRX_N-00963-26470828,2024-05-05T12:03:38,Donostia,expenses,internet,-42.0,-28151.3
buyer_5,Sara,30,ES41209551921252835913,TRX_N-00964-25512558,2024-05-05T16:55:44,Donostia,expenses,food,-89.63,-28240.93
buyer_5,Sara,30,ES41209551921252835913,TRX_N-00965-03960939,2024-05-06T10:30:54,Donostia,expenses,phone,-40.97,-28281.9
buyer_5,Sara,30,ES41209551921252835913,TRX_N-00966-20492033,2024-05-06T14:26:26,Donostia,expenses,leisure,-66.69,-28348.59
buyer_5,Sara,30,ES41209551921252835913,TRX_N-00967-56658375,2024-05-06T00:47:11,Donostia,expenses,education,-47.01,-28395.6
buyer_5,Sara,30,ES41209551921252835913,TRX_N-00968-58136378,2024-05-07T22:45:01,Donostia,expenses,gas,-35.77,-28431.37
buyer_5,Sara,30,ES41209551921252835913,TRX_N-00969-51868916,2024-05-07T08:22:34,Donostia,expenses,leisure,-73.57,-28504.94
buyer_5,Sara,30,ES41209551921252835913,TRX_N-00970-64014054,2024-05-08T14:45:28,Donostia,expenses,electricity,-54.73,-28559.67
buyer_5,Sara,30,ES41209551921252835913,TRX_N-00971-03834183,2024-05-10T11:37:31,Donostia,expenses,leisure,-77.37,-28637.04
buyer_5,Sara,30,ES41209551921252835913,TRX_N-00972-20546995,2024-05-11T16:38:56,Donostia,expenses,education,-49.73,-28686.77
buyer_5,Sara,30,ES41209551921252835913,TRX_N-00973-35073302,2024-05-12T11:25:45,Donostia,expenses,food,-60.15,-28746.92
buyer_5,Sara,30,ES41209551921252835913,TRX_N-00974-86236685,2024-05-12T15:32:09,Donostia,expenses,leisure,-28.03,-28774.95
buyer_5,Sara,30,ES41209551921252835913,TRX_N-00975-65725675,2024-05-12T19:42:41,Donostia,expenses,gifts,-208.92,-28983.87
buyer_5,Sara,30,ES41209551921252835913,TRX_N-00976-31050037,2024-05-14T17:20:39,Donostia,expenses,repairs,-187.72,-29171.59
buyer_5,Sara,30,ES41209551921252835913,TRX_N-00977-07548998,2024-05-15T20:11:51,Donostia,expenses,cash,-100.0,-29271.59
buyer_5,Sara,30,ES41209551921252835913,TRX_N-00978-47244465,2024-05-16T11:34:39,Galdakao,expenses,leisure,-74.01,-29345.6
buyer_5,Sara,30,ES41209551921252835913,TRX_N-00979-72892089,2024-05-23T12:02:30,Donostia,expenses,repairs,-77.32,-29422.92
buyer_5,Sara,30,ES41209551921252835913,TRX_N-00980-94735474,2024-05-24T16:27:01,Donostia,expenses,transport,-41.28,-29464.2
buyer_5,Sara,30,ES41209551921252835913,TRX_N-00981-33781784,2024-05-24T11:57:12,Donostia,expenses,leisure,-56.34,-29520.54
buyer_5,Sara,30,ES41209551921252835913,TRX_N-00982-56626659,2024-05-25T09:38:27,Iruña de Oca,expenses,cash,-100.0,-29620.54
buyer_5,Sara,30,ES41209551921252835913,TRX_N-00983-20811798,2024-05-27T20:26:35,Donostia,expenses,leisure,-52.62,-29673.16
buyer_5,Sara,30,ES41209551921252835913,TRX_N-00984-50626139,2024-05-30T12:46:36,Donostia,expenses,education,-43.16,-29716.32
buyer_5,Sara,30,ES41209551921252835913,TRX_N-00985-47829338,2024-05-30T19:57:43,Berango,expenses,gifts,-409.28,-30125.6
buyer_5,Sara,30,ES41209551921252835913,TRX_N-00986-25840719,2024-05-31T09:06:36,Donostia,expenses,cash,-100.0,-30225.6
buyer_5,Sara,30,ES41209551921252835913,TRX_N-00987-78769264,2024-06-01T14:20:17,Donostia,incomes,salary,1610.29,-28615.31
buyer_5,Sara,30,ES41209551921252835913,TRX_N-00988-27417517,2024-06-01T14:20:17,Donostia,incomes,salary_partner,1438.1,-27177.21
buyer_5,Sara,30,ES41209551921252835913,TRX_N-00989-15783024,2024-06-01T14:20:17,Donostia,incomes,extra_income,230.49,-26946.72
buyer_5,Sara,30,ES41209551921252835913,TRX_N-00990-80933769,2024-06-01T14:20:17,Donostia,incomes,salary_bonus,1274.83,-25671.89
buyer_5,Sara,30,ES41209551921252835913,TRX_N-00991-93575074,2024-06-01T14:20:17,Donostia,incomes,salary_partner_bonus,1142.52,-24529.37
buyer_5,Sara,30,ES41209551921252835913,TRX_N-00992-52044215,2024-06-01T14:13:27,Donostia,expenses,leisure,-18.35,-24547.72
buyer_5,Sara,30,ES41209551921252835913,TRX_N-00993-48917660,2024-06-01T09:22:20,Donostia,expenses,cash,-100.0,-24647.72
buyer_5,Sara,30,ES41209551921252835913,TRX_N-00994-79824830,2024-06-02T10:54:46,Donostia,expenses,repairs,-129.93,-24777.65
buyer_5,Sara,30,ES41209551921252835913,TRX_N-00995-05482101,2024-06-03T12:03:22,Donostia,expenses,food,-67.55,-24845.2
buyer_5,Sara,30,ES41209551921252835913,TRX_N-00996-86926962,2024-06-03T16:25:39,Durango,expenses,leisure,-64.98,-24910.18
buyer_5,Sara,30,ES41209551921252835913,TRX_N-00997-82425382,2024-06-03T06:16:35,Donostia,expenses,travel,-1245.78,-26155.96
buyer_5,Sara,30,ES41209551921252835913,TRX_N-00998-70063913,2024-06-04T15:58:23,Donostia,expenses,mortgage,-705.7,-26861.66
buyer_5,Sara,30,ES41209551921252835913,TRX_N-00999-62586158,2024-06-05T10:02:38,Donostia,expenses,cash,-100.0,-26961.66
buyer_5,Sara,30,ES41209551921252835913,TRX_N-01000-64554129,2024-06-05T20:25:27,Donostia,expenses,travel,-772.41,-27734.07
buyer_5,Sara,30,ES41209551921252835913,TRX_N-01001-39985476,2024-06-06T18:01:49,Donostia,expenses,electricity,-88.09,-27822.16
buyer_5,Sara,30,ES41209551921252835913,TRX_N-01002-95133961,2024-06-07T17:53:02,Donostia,expenses,leisure,-71.74,-27893.9
buyer_5,Sara,30,ES41209551921252835913,TRX_N-01003-86797816,2024-06-07T13:22:40,Donostia,expenses,clothing,-114.17,-28008.07
buyer_5,Sara,30,ES41209551921252835913,TRX_N-01004-18291516,2024-06-08T10:36:33,Donostia,expenses,water,-27.61,-28035.68
buyer_5,Sara,30,ES41209551921252835913,TRX_N-01005-65471526,2024-06-08T21:23:13,Donostia,expenses,gas,-31.85,-28067.53
buyer_5,Sara,30,ES41209551921252835913,TRX_N-01006-57728784,2024-06-08T13:49:28,Donostia,expenses,internet,-42.0,-28109.53
buyer_5,Sara,30,ES41209551921252835913,TRX_N-01007-30870861,2024-06-08T00:43:07,Donostia,expenses,phone,-39.36,-28148.89
buyer_5,Sara,30,ES41209551921252835913,TRX_N-01008-98402250,2024-06-11T18:18:05,Donostia,expenses,food,-91.21,-28240.1
buyer_5,Sara,30,ES41209551921252835913,TRX_N-01009-59882818,2024-06-11T22:50:07,Oyón-Oion,expenses,transport,-74.57,-28314.67
buyer_5,Sara,30,ES41209551921252835913,TRX_N-01010-79969227,2024-06-12T16:21:59,Donostia,expenses,food,-93.12,-28407.79
buyer_5,Sara,30,ES41209551921252835913,TRX_N-01011-67520305,2024-06-13T12:47:02,Donostia,expenses,cash,-100.0,-28507.79
buyer_5,Sara,30,ES41209551921252835913,TRX_N-01012-66033570,2024-06-14T19:15:43,Sestao,expenses,transport,-45.68,-28553.47
buyer_5,Sara,30,ES41209551921252835913,TRX_N-01013-42222151,2024-06-15T14:27:05,Donostia,expenses,food,-121.94,-28675.41
buyer_5,Sara,30,ES41209551921252835913,TRX_N-01014-11639962,2024-06-16T08:50:12,Donostia,expenses,food,-116.28,-28791.69
buyer_5,Sara,30,ES41209551921252835913,TRX_N-01015-74164738,2024-06-17T13:59:29,Donostia,expenses,transport,-52.84,-28844.53
buyer_5,Sara,30,ES41209551921252835913,TRX_N-01016-76373670,2024-06-20T17:42:52,Donostia,expenses,cash,-100.0,-28944.53
buyer_5,Sara,30,ES41209551921252835913,TRX_N-01017-86464740,2024-06-22T10:45:49,Donostia,expenses,healthcare,-38.12,-28982.65
buyer_5,Sara,30,ES41209551921252835913,TRX_N-01018-23123053,2024-06-22T14:32:53,Donostia,expenses,repairs,-318.03,-29300.68
buyer_5,Sara,30,ES41209551921252835913,TRX_N-01019-50064017,2024-06-25T11:19:26,Donostia,expenses,repairs,-228.96,-29529.64
buyer_5,Sara,30,ES41209551921252835913,TRX_N-01020-88351873,2024-06-30T15:07:30,Donostia,expenses,repairs,-98.27,-29627.91
buyer_5,Sara,30,ES41209551921252835913,TRX_N-01021-95993852,2024-07-01T17:03:05,Donostia,incomes,salary,1610.29,-28017.62
buyer_5,Sara,30,ES41209551921252835913,TRX_N-01022-10417413,2024-07-01T17:03:05,Donostia,incomes,salary_partner,1438.1,-26579.52
buyer_5,Sara,30,ES41209551921252835913,TRX_N-01023-09468415,2024-07-01T16:46:59,Donostia,expenses,food,-97.1,-26676.62
buyer_5,Sara,30,ES41209551921252835913,TRX_N-01024-60713430,2024-07-02T12:51:08,Vitoria-Gasteiz,expenses,leisure,-63.51,-26740.13
buyer_5,Sara,30,ES41209551921252835913,TRX_N-01025-70345587,2024-07-03T13:15:06,Donostia,expenses,clothing,-154.72,-26894.85
buyer_5,Sara,30,ES41209551921252835913,TRX_N-01026-67389885,2024-07-03T10:49:50,Donostia,expenses,cash,-100.0,-26994.85
buyer_5,Sara,30,ES41209551921252835913,TRX_N-01027-03469109,2024-07-04T17:54:27,Donostia,expenses,mortgage,-705.7,-27700.55
buyer_5,Sara,30,ES41209551921252835913,TRX_N-01028-80203889,2024-07-05T15:28:18,Donostia,expenses,phone,-31.89,-27732.44
buyer_5,Sara,30,ES41209551921252835913,TRX_N-01029-33396917,2024-07-05T19:33:47,Donostia,expenses,clothing,-73.66,-27806.1
buyer_5,Sara,30,ES41209551921252835913,TRX_N-01030-82103336,2024-07-06T13:37:48,Donostia,expenses,water,-26.2,-27832.3
buyer_5,Sara,30,ES41209551921252835913,TRX_N-01031-81541374,2024-07-06T18:20:45,Donostia,expenses,internet,-42.0,-27874.3
buyer_5,Sara,30,ES41209551921252835913,TRX_N-01032-40521409,2024-07-06T13:36:10,Donostia,expenses,transport,-45.83,-27920.13
buyer_5,Sara,30,ES41209551921252835913,TRX_N-01033-16681337,2024-07-06T05:31:01,Donostia,expenses,cash,-100.0,-28020.13
buyer_5,Sara,30,ES41209551921252835913,TRX_N-01034-37173398,2024-07-06T06:56:26,Donostia,expenses,repairs,-241.25,-28261.38
buyer_5,Sara,30,ES41209551921252835913,TRX_N-01035-36615286,2024-07-07T03:22:26,Donostia,expenses,gas,-97.5,-28358.88
buyer_5,Sara,30,ES41209551921252835913,TRX_N-01036-72014614,2024-07-07T15:32:17,Donostia,expenses,food,-70.63,-28429.51
buyer_5,Sara,30,ES41209551921252835913,TRX_N-01037-18464006,2024-07-08T21:02:05,Donostia,expenses,electricity,-87.0,-28516.51
buyer_5,Sara,30,ES41209551921252835913,TRX_N-01038-72831615,2024-07-10T04:30:57,Donostia,expenses,leisure,-78.41,-28594.92
buyer_5,Sara,30,ES41209551921252835913,TRX_N-01039-82130677,2024-07-12T23:24:05,Donostia,expenses,leisure,-33.65,-28628.57
buyer_5,Sara,30,ES41209551921252835913,TRX_N-01040-54110746,2024-07-13T19:55:47,Donostia,expenses,repairs,-85.8,-28714.37
buyer_5,Sara,30,ES41209551921252835913,TRX_N-01041-54696969,2024-07-15T13:59:29,Erandio,expenses,food,-68.92,-28783.29
buyer_5,Sara,30,ES41209551921252835913,TRX_N-01042-67048936,2024-07-16T18:37:37,Donostia,expenses,gifts,-662.03,-29445.32
buyer_5,Sara,30,ES41209551921252835913,TRX_N-01043-74884840,2024-07-19T04:11:25,Zuia,expenses,cash,-100.0,-29545.32
buyer_5,Sara,30,ES41209551921252835913,TRX_N-01044-18200310,2024-07-20T21:04:59,Donostia,expenses,leisure,-58.06,-29603.38
buyer_5,Sara,30,ES41209551921252835913,TRX_N-01045-01970196,2024-07-22T16:00:19,Donostia,expenses,cash,-100.0,-29703.38
buyer_5,Sara,30,ES41209551921252835913,TRX_N-01046-46472707,2024-07-23T15:20:55,Donostia,expenses,cash,-100.0,-29803.38
buyer_5,Sara,30,ES41209551921252835913,TRX_N-01047-32633917,2024-07-24T09:40:32,Pasaia,expenses,food,-71.81,-29875.19
buyer_5,Sara,30,ES41209551921252835913,TRX_N-01048-86283244,2024-07-24T13:31:47,Donostia,expenses,transport,-88.39,-29963.58
buyer_5,Sara,30,ES41209551921252835913,TRX_N-01049-45348003,2024-07-25T08:21:17,Donostia,expenses,clothing,-57.33,-30020.91
buyer_5,Sara,30,ES41209551921252835913,TRX_N-01050-17432212,2024-07-26T13:53:58,Pasaia,expenses,repairs,-197.06,-30217.97
buyer_5,Sara,30,ES41209551921252835913,TRX_N-01051-98270065,2024-07-27T12:24:41,Donostia,expenses,food,-116.76,-30334.73
buyer_5,Sara,30,ES41209551921252835913,TRX_N-01052-09391597,2024-07-28T15:17:28,Donostia,expenses,repairs,-196.98,-30531.71
buyer_5,Sara,30,ES41209551921252835913,TRX_N-01053-55028986,2024-07-30T10:09:06,Donostia,expenses,transport,-54.39,-30586.1
buyer_5,Sara,30,ES41209551921252835913,TRX_N-01054-11570424,2024-07-30T19:03:09,Donostia,expenses,clothing,-87.35,-30673.45
buyer_5,Sara,30,ES41209551921252835913,TRX_N-01055-79454129,2024-08-01T15:04:34,Donostia,incomes,salary,1610.29,-29063.16
buyer_5,Sara,30,ES41209551921252835913,TRX_N-01056-90944295,2024-08-01T15:04:34,Donostia,incomes,salary_partner,1438.1,-27625.06
buyer_5,Sara,30,ES41209551921252835913,TRX_N-01057-52324442,2024-08-01T20:24:08,Bilbao,expenses,food,-102.86,-27727.92
buyer_5,Sara,30,ES41209551921252835913,TRX_N-01058-49886294,2024-08-01T20:41:01,Donostia,expenses,cash,-100.0,-27827.92
buyer_5,Sara,30,ES41209551921252835913,TRX_N-01059-52726381,2024-08-01T08:53:14,Donostia,expenses,appliances,-345.82,-28173.74
buyer_5,Sara,30,ES41209551921252835913,TRX_N-01060-86109611,2024-08-02T23:21:28,Donostia,expenses,food,-86.58,-28260.32
buyer_5,Sara,30,ES41209551921252835913,TRX_N-01061-27153830,2024-08-02T02:44:36,Donostia,expenses,clothing,-109.59,-28369.91
buyer_5,Sara,30,ES41209551921252835913,TRX_N-01062-62830271,2024-08-03T14:45:17,Donostia,expenses,leisure,-71.0,-28440.91
buyer_5,Sara,30,ES41209551921252835913,TRX_N-01063-00905184,2024-08-03T08:10:58,Donostia,expenses,cash,-100.0,-28540.91
buyer_5,Sara,30,ES41209551921252835913,TRX_N-01064-93080114,2024-08-04T20:40:08,Donostia,expenses,mortgage,-705.7,-29246.61
buyer_5,Sara,30,ES41209551921252835913,TRX_N-01065-42380881,2024-08-05T20:41:36,Donostia,expenses,water,-42.11,-29288.72
buyer_5,Sara,30,ES41209551921252835913,TRX_N-01066-06504712,2024-08-05T19:39:15,Donostia,expenses,electricity,-79.42,-29368.14
buyer_5,Sara,30,ES41209551921252835913,TRX_N-01067-20012682,2024-08-05T19:29:48,Donostia,expenses,internet,-42.0,-29410.14
buyer_5,Sara,30,ES41209551921252835913,TRX_N-01068-11973363,2024-08-05T06:52:48,Donostia,expenses,phone,-34.11,-29444.25
buyer_5,Sara,30,ES41209551921252835913,TRX_N-01069-54254372,2024-08-05T15:33:11,Donostia,expenses,children,-165.7,-29609.95
buyer_5,Sara,30,ES41209551921252835913,TRX_N-01070-27648902,2024-08-08T18:17:31,Donostia,expenses,gas,-60.29,-29670.24
buyer_5,Sara,30,ES41209551921252835913,TRX_N-01071-43537102,2024-08-08T13:07:44,Donostia,expenses,transport,-57.78,-29728.02
buyer_5,Sara,30,ES41209551921252835913,TRX_N-01072-89816986,2024-08-12T09:52:48,Donostia,expenses,cash,-100.0,-29828.02
buyer_5,Sara,30,ES41209551921252835913,TRX_N-01073-17916769,2024-08-13T09:48:28,Donostia,expenses,clothing,-49.02,-29877.04
buyer_5,Sara,30,ES41209551921252835913,TRX_N-01074-12039651,2024-08-15T03:22:40,Donostia,expenses,cash,-100.0,-29977.04
buyer_5,Sara,30,ES41209551921252835913,TRX_N-01075-38473308,2024-08-16T15:57:03,Donostia,expenses,cash,-100.0,-30077.04
buyer_5,Sara,30,ES41209551921252835913,TRX_N-01076-79371007,2024-08-17T13:10:35,Donostia,expenses,travel,-600.95,-30677.99
buyer_5,Sara,30,ES41209551921252835913,TRX_N-01077-90641920,2024-08-19T02:35:46,Basauri,expenses,repairs,-241.89,-30919.88
buyer_5,Sara,30,ES41209551921252835913,TRX_N-01078-32750355,2024-08-21T10:06:50,Donostia,expenses,food,-96.83,-31016.71
buyer_5,Sara,30,ES41209551921252835913,TRX_N-01079-53397224,2024-08-22T20:33:36,Donostia,expenses,leisure,-64.08,-31080.79
buyer_5,Sara,30,ES41209551921252835913,TRX_N-01080-36923559,2024-08-22T08:33:26,Oyón-Oion,expenses,repairs,-311.17,-31391.96
buyer_5,Sara,30,ES41209551921252835913,TRX_N-01081-12302951,2024-08-23T08:06:52,Donostia,expenses,food,-70.33,-31462.29
buyer_5,Sara,30,ES41209551921252835913,TRX_N-01082-10314088,2024-08-23T15:32:07,Donostia,expenses,leisure,-46.79,-31509.08
buyer_5,Sara,30,ES41209551921252835913,TRX_N-01083-16639713,2024-08-24T18:36:56,Donostia,expenses,food,-78.6,-31587.68
buyer_5,Sara,30,ES41209551921252835913,TRX_N-01084-14581858,2024-08-25T11:19:02,Donostia,expenses,food,-115.95,-31703.63
buyer_5,Sara,30,ES41209551921252835913,TRX_N-01085-64634590,2024-08-25T13:28:22,Basauri,expenses,leisure,-25.1,-31728.73
buyer_5,Sara,30,ES41209551921252835913,TRX_N-01086-23984475,2024-08-27T09:04:04,Donostia,expenses,food,-70.61,-31799.34
buyer_5,Sara,30,ES41209551921252835913,TRX_N-01087-54086288,2024-08-28T15:56:31,Donostia,expenses,clothing,-130.01,-31929.35
buyer_5,Sara,30,ES41209551921252835913,TRX_N-01088-58381403,2024-08-28T15:19:39,Donostia,expenses,repairs,-230.65,-32160.0
buyer_5,Sara,30,ES41209551921252835913,TRX_N-01089-21516525,2024-08-30T15:42:17,Donostia,expenses,leisure,-68.24,-32228.24
buyer_5,Sara,30,ES41209551921252835913,TRX_N-01090-08103328,2024-08-30T10:53:14,Donostia,expenses,repairs,-144.08,-32372.32
buyer_5,Sara,30,ES41209551921252835913,TRX_N-01091-27400822,2024-08-31T16:29:55,Donostia,expenses,food,-107.05,-32479.37
buyer_5,Sara,30,ES41209551921252835913,TRX_N-01092-75377256,2024-08-31T16:53:46,Donostia,expenses,leisure,-76.92,-32556.29
buyer_5,Sara,30,ES41209551921252835913,TRX_N-01093-18354711,2024-09-01T12:29:00,Donostia,incomes,salary,1610.29,-30946.0
buyer_5,Sara,30,ES41209551921252835913,TRX_N-01094-29558697,2024-09-01T12:29:00,Donostia,incomes,salary_partner,1438.1,-29507.9
buyer_5,Sara,30,ES41209551921252835913,TRX_N-01095-58938288,2024-09-01T12:29:00,Donostia,incomes,extra_income,230.49,-29277.41
buyer_5,Sara,30,ES41209551921252835913,TRX_N-01096-22763276,2024-09-01T10:25:58,Donostia,expenses,cash,-100.0,-29377.41
buyer_5,Sara,30,ES41209551921252835913,TRX_N-01097-13701981,2024-09-03T18:19:30,Donostia,expenses,repairs,-259.14,-29636.55
buyer_5,Sara,30,ES41209551921252835913,TRX_N-01098-76327398,2024-09-04T11:12:48,Donostia,expenses,mortgage,-705.7,-30342.25
buyer_5,Sara,30,ES41209551921252835913,TRX_N-01099-11055387,2024-09-05T11:23:44,Donostia,expenses,water,-39.78,-30382.03
buyer_5,Sara,30,ES41209551921252835913,TRX_N-01100-55959506,2024-09-05T16:08:04,Portugalete,expenses,leisure,-78.49,-30460.52
buyer_5,Sara,30,ES41209551921252835913,TRX_N-01101-78194799,2024-09-05T10:45:08,Donostia,expenses,healthcare,-66.58,-30527.1
buyer_5,Sara,30,ES41209551921252835913,TRX_N-01102-28625565,2024-09-05T16:55:13,Bilbao,expenses,education,-77.3,-30604.4
buyer_5,Sara,30,ES41209551921252835913,TRX_N-01103-90016330,2024-09-06T12:56:44,Donostia,expenses,cash,-100.0,-30704.4
buyer_5,Sara,30,ES41209551921252835913,TRX_N-01104-47070480,2024-09-07T15:22:06,Donostia,expenses,gas,-39.3,-30743.7
buyer_5,Sara,30,ES41209551921252835913,TRX_N-01105-63235307,2024-09-08T05:33:30,Donostia,expenses,phone,-33.43,-30777.13
buyer_5,Sara,30,ES41209551921252835913,TRX_N-01106-74053072,2024-09-08T14:16:52,Donostia,expenses,electricity,-87.7,-30864.83
buyer_5,Sara,30,ES41209551921252835913,TRX_N-01107-92981109,2024-09-08T12:01:29,Donostia,expenses,internet,-42.0,-30906.83
buyer_5,Sara,30,ES41209551921252835913,TRX_N-01108-62653513,2024-09-09T17:08:58,Donostia,expenses,education,-67.69,-30974.52
buyer_5,Sara,30,ES41209551921252835913,TRX_N-01109-81965748,2024-09-10T20:25:27,Donostia,expenses,food,-99.0,-31073.52
buyer_5,Sara,30,ES41209551921252835913,TRX_N-01110-21372566,2024-09-10T11:06:48,Donostia,expenses,gifts,-423.44,-31496.96
buyer_5,Sara,30,ES41209551921252835913,TRX_N-01111-04439818,2024-09-11T16:00:30,Donostia,expenses,education,-47.35,-31544.31
buyer_5,Sara,30,ES41209551921252835913,TRX_N-01112-08235031,2024-09-11T08:21:42,Donostia,expenses,cash,-100.0,-31644.31
buyer_5,Sara,30,ES41209551921252835913,TRX_N-01113-53935997,2024-09-11T18:13:22,Donostia,expenses,children,-77.61,-31721.92
buyer_5,Sara,30,ES41209551921252835913,TRX_N-01114-62991847,2024-09-12T13:08:43,Hernani,expenses,leisure,-71.45,-31793.37
buyer_5,Sara,30,ES41209551921252835913,TRX_N-01115-59172913,2024-09-14T19:44:39,Donostia,expenses,repairs,-38.63,-31832.0
buyer_5,Sara,30,ES41209551921252835913,TRX_N-01116-89654968,2024-09-14T08:49:06,Donostia,expenses,gifts,-434.78,-32266.78
buyer_5,Sara,30,ES41209551921252835913,TRX_N-01117-99946002,2024-09-15T20:30:15,Errenteria,expenses,food,-106.69,-32373.47
buyer_5,Sara,30,ES41209551921252835913,TRX_N-01118-78496478,2024-09-16T20:15:25,Donostia,expenses,appliances,-188.6,-32562.07
buyer_5,Sara,30,ES41209551921252835913,TRX_N-01119-38200854,2024-09-17T19:20:46,Donostia,expenses,food,-79.97,-32642.04
buyer_5,Sara,30,ES41209551921252835913,TRX_N-01120-36848558,2024-09-17T10:14:26,Sopela,expenses,clothing,-108.29,-32750.33
buyer_5,Sara,30,ES41209551921252835913,TRX_N-01121-26326320,2024-09-17T10:17:46,Donostia,expenses,repairs,-260.14,-33010.47
buyer_5,Sara,30,ES41209551921252835913,TRX_N-01122-39004330,2024-09-18T20:29:46,Donostia,expenses,leisure,-74.74,-33085.21
buyer_5,Sara,30,ES41209551921252835913,TRX_N-01123-40340150,2024-09-19T09:47:51,Andoain,expenses,cash,-100.0,-33185.21
buyer_5,Sara,30,ES41209551921252835913,TRX_N-01124-87713771,2024-09-19T20:09:07,Donostia,expenses,appliances,-375.83,-33561.04
buyer_5,Sara,30,ES41209551921252835913,TRX_N-01125-26212080,2024-09-20T14:50:59,Donostia,expenses,cash,-100.0,-33661.04
buyer_5,Sara,30,ES41209551921252835913,TRX_N-01126-77343708,2024-09-21T17:36:35,Donostia,expenses,food,-87.73,-33748.77
buyer_5,Sara,30,ES41209551921252835913,TRX_N-01127-72981241,2024-09-24T20:31:09,Donostia,expenses,gifts,-418.7,-34167.47
buyer_5,Sara,30,ES41209551921252835913,TRX_N-01128-23887444,2024-09-25T23:15:19,Donostia,expenses,leisure,-63.86,-34231.33
buyer_5,Sara,30,ES41209551921252835913,TRX_N-01129-65726432,2024-09-27T13:32:42,Hondarribia,expenses,food,-114.77,-34346.1
buyer_5,Sara,30,ES41209551921252835913,TRX_N-01130-85803200,2024-09-29T11:54:22,Donostia,expenses,food,-83.34,-34429.44
buyer_5,Sara,30,ES41209551921252835913,TRX_N-01131-23162258,2024-09-29T12:02:45,Donostia,expenses,transport,-59.99,-34489.43
buyer_5,Sara,30,ES41209551921252835913,TRX_N-01132-01391848,2024-09-29T08:09:28,Donostia,expenses,healthcare,-121.84,-34611.27
buyer_5,Sara,30,ES41209551921252835913,TRX_N-01133-71548263,2024-10-01T13:09:30,Donostia,incomes,salary,1610.29,-33000.98
buyer_5,Sara,30,ES41209551921252835913,TRX_N-01134-90922946,2024-10-01T13:09:30,Donostia,incomes,salary_partner,1438.1,-31562.88
buyer_5,Sara,30,ES41209551921252835913,TRX_N-01135-97918308,2024-10-04T19:09:15,Donostia,expenses,mortgage,-705.7,-32268.58
buyer_5,Sara,30,ES41209551921252835913,TRX_N-01136-68741801,2024-10-04T10:14:29,Donostia,expenses,cash,-100.0,-32368.58
buyer_5,Sara,30,ES41209551921252835913,TRX_N-01137-01319429,2024-10-05T18:34:58,Donostia,expenses,gas,-72.74,-32441.32
buyer_5,Sara,30,ES41209551921252835913,TRX_N-01138-49540226,2024-10-06T09:36:55,Donostia,expenses,leisure,-22.83,-32464.15
buyer_5,Sara,30,ES41209551921252835913,TRX_N-01139-97814313,2024-10-06T09:54:05,Donostia,expenses,gifts,-223.36,-32687.51
buyer_5,Sara,30,ES41209551921252835913,TRX_N-01140-32640302,2024-10-08T15:16:15,Donostia,expenses,electricity,-41.3,-32728.81
buyer_5,Sara,30,ES41209551921252835913,TRX_N-01141-71871338,2024-10-08T18:37:20,Donostia,expenses,water,-28.57,-32757.38
buyer_5,Sara,30,ES41209551921252835913,TRX_N-01142-69026504,2024-10-08T08:53:17,Donostia,expenses,internet,-42.0,-32799.38
buyer_5,Sara,30,ES41209551921252835913,TRX_N-01143-67912426,2024-10-08T12:24:50,Donostia,expenses,phone,-35.31,-32834.69
buyer_5,Sara,30,ES41209551921252835913,TRX_N-01144-86085835,2024-10-08T12:57:45,Donostia,expenses,clothing,-126.57,-32961.26
buyer_5,Sara,30,ES41209551921252835913,TRX_N-01145-24350037,2024-10-09T12:50:15,Errenteria,expenses,cash,-100.0,-33061.26
buyer_6,Manuel,45,ES29209555094272945666,TRX_N-00001-55491815,2022-01-01T11:58:06,Vitoria-Gasteiz,incomes,salary,1301.77,2970.71
buyer_6,Manuel,45,ES29209555094272945666,TRX_N-00002-70755967,2022-01-01T11:58:06,Vitoria-Gasteiz,incomes,salary_partner,1218.02,4188.73
buyer_6,Manuel,45,ES29209555094272945666,TRX_N-00003-46505798,2022-01-03T05:59:32,Vitoria-Gasteiz,expenses,education,-64.63,4124.1
buyer_6,Manuel,45,ES29209555094272945666,TRX_N-00004-55198161,2022-01-04T09:18:40,Vitoria-Gasteiz,expenses,mortgage,-925.72,3198.38
buyer_6,Manuel,45,ES29209555094272945666,TRX_N-00005-46046637,2022-01-04T12:56:54,Mungia,expenses,repairs,-38.86,3159.52
buyer_6,Manuel,45,ES29209555094272945666,TRX_N-00006-93841336,2022-01-06T18:55:13,Vitoria-Gasteiz,expenses,transport,-82.4,3077.12
buyer_6,Manuel,45,ES29209555094272945666,TRX_N-00007-92442740,2022-01-07T10:26:09,Vitoria-Gasteiz,expenses,water,-24.67,3052.45
buyer_6,Manuel,45,ES29209555094272945666,TRX_N-00008-16242747,2022-01-07T18:41:38,Vitoria-Gasteiz,expenses,electricity,-88.13,2964.32
buyer_6,Manuel,45,ES29209555094272945666,TRX_N-00009-61610674,2022-01-07T19:00:14,Vitoria-Gasteiz,expenses,internet,-42.0,2922.32
buyer_6,Manuel,45,ES29209555094272945666,TRX_N-00010-61657667,2022-01-08T01:43:25,Vitoria-Gasteiz,expenses,gas,-112.53,2809.79
buyer_6,Manuel,45,ES29209555094272945666,TRX_N-00011-93515613,2022-01-08T16:08:24,Vitoria-Gasteiz,expenses,phone,-41.27,2768.52
buyer_6,Manuel,45,ES29209555094272945666,TRX_N-00012-93115398,2022-01-08T12:56:33,Vitoria-Gasteiz,expenses,cash,-100.0,2668.52
buyer_6,Manuel,45,ES29209555094272945666,TRX_N-00013-88652679,2022-01-12T17:58:27,Vitoria-Gasteiz,expenses,repairs,-217.21,2451.31
buyer_6,Manuel,45,ES29209555094272945666,TRX_N-00014-85187797,2022-01-15T06:26:41,Vitoria-Gasteiz,expenses,cash,-100.0,2351.31
buyer_6,Manuel,45,ES29209555094272945666,TRX_N-00015-61037780,2022-01-17T22:22:39,Vitoria-Gasteiz,expenses,food,-124.61,2226.7
buyer_6,Manuel,45,ES29209555094272945666,TRX_N-00016-11254927,2022-01-17T15:39:56,Vitoria-Gasteiz,expenses,transport,-42.13,2184.57
buyer_6,Manuel,45,ES29209555094272945666,TRX_N-00017-92297386,2022-01-17T06:03:51,Vitoria-Gasteiz,expenses,education,-46.64,2137.93
buyer_6,Manuel,45,ES29209555094272945666,TRX_N-00018-39352383,2022-01-19T08:58:19,Vitoria-Gasteiz,expenses,children,-140.89,1997.04
buyer_6,Manuel,45,ES29209555094272945666,TRX_N-00019-62789042,2022-01-20T09:18:16,Vitoria-Gasteiz,expenses,cash,-100.0,1897.04
buyer_6,Manuel,45,ES29209555094272945666,TRX_N-00020-45145194,2022-01-22T16:37:26,Errenteria,expenses,food,-71.66,1825.38
buyer_6,Manuel,45,ES29209555094272945666,TRX_N-00021-28156932,2022-01-23T18:37:24,Vitoria-Gasteiz,expenses,gifts,-143.72,1681.66
buyer_6,Manuel,45,ES29209555094272945666,TRX_N-00022-58056461,2022-01-24T00:53:54,Vitoria-Gasteiz,expenses,food,-82.11,1599.55
buyer_6,Manuel,45,ES29209555094272945666,TRX_N-00023-19588591,2022-01-24T13:34:43,Vitoria-Gasteiz,expenses,clothing,-121.17,1478.38
buyer_6,Manuel,45,ES29209555094272945666,TRX_N-00024-40992695,2022-01-25T08:18:26,Vitoria-Gasteiz,expenses,food,-107.03,1371.35
buyer_6,Manuel,45,ES29209555094272945666,TRX_N-00025-53819483,2022-01-27T13:41:40,Vitoria-Gasteiz,expenses,cash,-100.0,1271.35
buyer_6,Manuel,45,ES29209555094272945666,TRX_N-00026-56483018,2022-01-28T14:46:06,Vitoria-Gasteiz,expenses,cash,-100.0,1171.35
buyer_6,Manuel,45,ES29209555094272945666,TRX_N-00027-32071925,2022-01-29T08:23:26,Vitoria-Gasteiz,expenses,cash,-100.0,1071.35
buyer_6,Manuel,45,ES29209555094272945666,TRX_N-00028-00473713,2022-01-31T10:21:33,Vitoria-Gasteiz,expenses,food,-99.45,971.9
buyer_6,Manuel,45,ES29209555094272945666,TRX_N-00029-13640054,2022-01-31T17:35:29,Vitoria-Gasteiz,expenses,children,-74.18,897.72
buyer_6,Manuel,45,ES29209555094272945666,TRX_N-00030-05743232,2022-02-01T20:04:47,Vitoria-Gasteiz,incomes,salary,1301.77,2199.49
buyer_6,Manuel,45,ES29209555094272945666,TRX_N-00031-71297373,2022-02-01T20:04:47,Vitoria-Gasteiz,incomes,salary_partner,1218.02,3417.51
buyer_6,Manuel,45,ES29209555094272945666,TRX_N-00032-99430820,2022-02-02T19:59:05,Vitoria-Gasteiz,expenses,leisure,-82.67,3334.84
buyer_6,Manuel,45,ES29209555094272945666,TRX_N-00033-20569278,2022-02-03T05:03:50,Vitoria-Gasteiz,expenses,education,-44.36,3290.48
buyer_6,Manuel,45,ES29209555094272945666,TRX_N-00034-55636548,2022-02-03T14:49:12,Vitoria-Gasteiz,expenses,repairs,-69.68,3220.8
buyer_6,Manuel,45,ES29209555094272945666,TRX_N-00035-28163715,2022-02-04T09:09:18,Vitoria-Gasteiz,expenses,mortgage,-925.72,2295.08
buyer_6,Manuel,45,ES29209555094272945666,TRX_N-00036-85032748,2022-02-05T13:34:38,Vitoria-Gasteiz,expenses,gas,-53.59,2241.49
buyer_6,Manuel,45,ES29209555094272945666,TRX_N-00037-16918926,2022-02-05T22:01:14,Vitoria-Gasteiz,expenses,education,-65.53,2175.96
buyer_6,Manuel,45,ES29209555094272945666,TRX_N-00038-36216346,2022-02-06T01:42:23,Vitoria-Gasteiz,expenses,electricity,-58.42,2117.54
buyer_6,Manuel,45,ES29209555094272945666,TRX_N-00039-25084951,2022-02-06T09:40:36,Santurtzi,expenses,food,-110.93,2006.61
buyer_6,Manuel,45,ES29209555094272945666,TRX_N-00040-80119975,2022-02-06T22:31:48,Vitoria-Gasteiz,expenses,repairs,-126.97,1879.64
buyer_6,Manuel,45,ES29209555094272945666,TRX_N-00041-68590698,2022-02-07T11:55:50,Vitoria-Gasteiz,expenses,transport,-83.71,1795.93
buyer_6,Manuel,45,ES29209555094272945666,TRX_N-00042-96845813,2022-02-08T23:46:27,Vitoria-Gasteiz,expenses,water,-35.53,1760.4
buyer_6,Manuel,45,ES29209555094272945666,TRX_N-00043-07968009,2022-02-08T07:47:51,Vitoria-Gasteiz,expenses,internet,-42.0,1718.4
buyer_6,Manuel,45,ES29209555094272945666,TRX_N-00044-77093195,2022-02-08T21:44:42,Vitoria-Gasteiz,expenses,phone,-38.69,1679.71
buyer_6,Manuel,45,ES29209555094272945666,TRX_N-00045-22851719,2022-02-10T19:10:25,Vitoria-Gasteiz,expenses,food,-87.76,1591.95
buyer_6,Manuel,45,ES29209555094272945666,TRX_N-00046-59728034,2022-02-14T10:39:48,Vitoria-Gasteiz,expenses,leisure,-66.6,1525.35
buyer_6,Manuel,45,ES29209555094272945666,TRX_N-00047-10538456,2022-02-14T20:24:42,Vitoria-Gasteiz,expenses,repairs,-188.26,1337.09
buyer_6,Manuel,45,ES29209555094272945666,TRX_N-00048-21920372,2022-02-15T15:30:07,Vitoria-Gasteiz,expenses,clothing,-139.38,1197.71
buyer_6,Manuel,45,ES29209555094272945666,TRX_N-00049-74689816,2022-02-16T15:26:02,Basauri,expenses,cash,-100.0,1097.71
buyer_6,Manuel,45,ES29209555094272945666,TRX_N-00050-23795247,2022-02-16T18:56:05,Vitoria-Gasteiz,expenses,gifts,-780.34,317.37
buyer_6,Manuel,45,ES29209555094272945666,TRX_N-00051-77474053,2022-02-17T08:52:25,Vitoria-Gasteiz,expenses,food,-116.05,201.32
buyer_6,Manuel,45,ES29209555094272945666,TRX_N-00052-52478467,2022-02-17T14:09:32,Vitoria-Gasteiz,expenses,repairs,-65.4,135.92
buyer_6,Manuel,45,ES29209555094272945666,TRX_N-00053-85258581,2022-02-20T16:45:43,Donostia,expenses,leisure,-59.59,76.33
buyer_6,Manuel,45,ES29209555094272945666,TRX_N-00054-79268392,2022-02-21T12:10:40,Alegría-Dulantzi,expenses,healthcare,-138.94,-62.61
buyer_6,Manuel,45,ES29209555094272945666,TRX_N-00055-32942157,2022-02-23T20:45:09,Getxo,expenses,healthcare,-41.58,-104.19
buyer_6,Manuel,45,ES29209555094272945666,TRX_N-00056-48992989,2022-02-23T02:28:37,Vitoria-Gasteiz,expenses,education,-74.54,-178.73
buyer_6,Manuel,45,ES29209555094272945666,TRX_N-00057-09504721,2022-02-26T15:41:52,Vitoria-Gasteiz,expenses,food,-67.0,-245.73
buyer_6,Manuel,45,ES29209555094272945666,TRX_N-00058-68410502,2022-02-27T08:09:25,Vitoria-Gasteiz,expenses,gifts,-754.37,-1000.1
buyer_6,Manuel,45,ES29209555094272945666,TRX_N-00059-59110602,2022-02-28T19:53:16,Vitoria-Gasteiz,expenses,travel,-979.8,-1979.9
buyer_6,Manuel,45,ES29209555094272945666,TRX_N-00060-17980639,2022-03-01T11:55:47,Vitoria-Gasteiz,incomes,salary,1301.77,-678.13
buyer_6,Manuel,45,ES29209555094272945666,TRX_N-00061-21073927,2022-03-01T11:55:47,Vitoria-Gasteiz,incomes,salary_partner,1218.02,539.89
buyer_6,Manuel,45,ES29209555094272945666,TRX_N-00062-65214562,2022-03-01T14:26:16,Vitoria-Gasteiz,expenses,food,-94.13,445.76
buyer_6,Manuel,45,ES29209555094272945666,TRX_N-00063-29171307,2022-03-01T17:54:23,Vitoria-Gasteiz,expenses,leisure,-66.94,378.82
buyer_6,Manuel,45,ES29209555094272945666,TRX_N-00064-33970633,2022-03-01T05:18:53,Durango,expenses,repairs,-102.68,276.14
buyer_6,Manuel,45,ES29209555094272945666,TRX_N-00065-99169792,2022-03-02T17:24:08,Elciego,expenses,repairs,-130.12,146.02
buyer_6,Manuel,45,ES29209555094272945666,TRX_N-00066-79195329,2022-03-03T23:30:24,Vitoria-Gasteiz,expenses,cash,-100.0,46.02
buyer_6,Manuel,45,ES29209555094272945666,TRX_N-00067-77227851,2022-03-04T22:01:40,Vitoria-Gasteiz,expenses,mortgage,-925.72,-879.7
buyer_6,Manuel,45,ES29209555094272945666,TRX_N-00068-06064396,2022-03-04T18:42:09,Pasaia,expenses,cash,-100.0,-979.7
buyer_6,Manuel,45,ES29209555094272945666,TRX_N-00069-34110552,2022-03-04T08:23:05,Eibar,expenses,gifts,-833.72,-1813.42
buyer_6,Manuel,45,ES29209555094272945666,TRX_N-00070-64467637,2022-03-05T12:07:18,Vitoria-Gasteiz,expenses,phone,-39.73,-1853.15
buyer_6,Manuel,45,ES29209555094272945666,TRX_N-00071-25538361,2022-03-07T12:29:40,Vitoria-Gasteiz,expenses,electricity,-53.05,-1906.2
buyer_6,Manuel,45,ES29209555094272945666,TRX_N-00072-23687537,2022-03-07T14:00:24,Vitoria-Gasteiz,expenses,gas,-89.38,-1995.58
buyer_6,Manuel,45,ES29209555094272945666,TRX_N-00073-60194274,2022-03-07T13:28:40,Vitoria-Gasteiz,expenses,leisure,-42.12,-2037.7
buyer_6,Manuel,45,ES29209555094272945666,TRX_N-00074-28272145,2022-03-08T18:39:11,Vitoria-Gasteiz,expenses,water,-28.23,-2065.93
buyer_6,Manuel,45,ES29209555094272945666,TRX_N-00075-08619816,2022-03-08T09:10:23,Vitoria-Gasteiz,expenses,internet,-42.0,-2107.93
buyer_6,Manuel,45,ES29209555094272945666,TRX_N-00076-49804160,2022-03-08T14:41:04,Vitoria-Gasteiz,expenses,leisure,-57.05,-2164.98
buyer_6,Manuel,45,ES29209555094272945666,TRX_N-00077-92534514,2022-03-11T15:40:05,Vitoria-Gasteiz,expenses,transport,-46.97,-2211.95
buyer_6,Manuel,45,ES29209555094272945666,TRX_N-00078-75229818,2022-03-14T18:30:11,Vitoria-Gasteiz,expenses,food,-103.15,-2315.1
buyer_6,Manuel,45,ES29209555094272945666,TRX_N-00079-91353593,2022-03-14T15:46:30,Vitoria-Gasteiz,expenses,repairs,-111.41,-2426.51
buyer_6,Manuel,45,ES29209555094272945666,TRX_N-00080-70875384,2022-03-15T09:40:38,Hernani,expenses,appliances,-151.9,-2578.41
buyer_6,Manuel,45,ES29209555094272945666,TRX_N-00081-22992518,2022-03-16T10:45:16,Vitoria-Gasteiz,expenses,clothing,-147.39,-2725.8
buyer_6,Manuel,45,ES29209555094272945666,TRX_N-00082-98139083,2022-03-18T10:20:22,Vitoria-Gasteiz,expenses,cash,-100.0,-2825.8
buyer_6,Manuel,45,ES29209555094272945666,TRX_N-00083-35228804,2022-03-18T11:53:50,Vitoria-Gasteiz,expenses,children,-77.97,-2903.77
buyer_6,Manuel,45,ES29209555094272945666,TRX_N-00084-38834846,2022-03-19T15:51:21,Vitoria-Gasteiz,expenses,food,-121.46,-3025.23
buyer_6,Manuel,45,ES29209555094272945666,TRX_N-00085-72744684,2022-03-19T13:42:27,Basauri,expenses,clothing,-47.35,-3072.58
buyer_6,Manuel,45,ES29209555094272945666,TRX_N-00086-26275516,2022-03-24T10:08:04,Vitoria-Gasteiz,expenses,food,-82.31,-3154.89
buyer_6,Manuel,45,ES29209555094272945666,TRX_N-00087-92515600,2022-03-27T19:01:24,Irun,expenses,leisure,-26.15,-3181.04
buyer_6,Manuel,45,ES29209555094272945666,TRX_N-00088-46904839,2022-03-27T12:33:29,Vitoria-Gasteiz,expenses,cash,-100.0,-3281.04
buyer_6,Manuel,45,ES29209555094272945666,TRX_N-00089-16024844,2022-03-28T10:33:48,Vitoria-Gasteiz,expenses,leisure,-22.18,-3303.22
buyer_6,Manuel,45,ES29209555094272945666,TRX_N-00090-01275835,2022-03-28T20:02:23,Vitoria-Gasteiz,expenses,healthcare,-45.14,-3348.36
buyer_6,Manuel,45,ES29209555094272945666,TRX_N-00091-00424808,2022-03-30T11:47:49,Vitoria-Gasteiz,expenses,leisure,-29.83,-3378.19
buyer_6,Manuel,45,ES29209555094272945666,TRX_N-00092-99217377,2022-03-31T19:12:11,Vitoria-Gasteiz,expenses,healthcare,-65.7,-3443.89
buyer_6,Manuel,45,ES29209555094272945666,TRX_N-00093-84240761,2022-03-31T20:45:56,Vitoria-Gasteiz,expenses,repairs,-300.55,-3744.44
buyer_6,Manuel,45,ES29209555094272945666,TRX_N-00094-15203547,2022-04-01T11:49:42,Vitoria-Gasteiz,incomes,salary,1301.77,-2442.67
buyer_6,Manuel,45,ES29209555094272945666,TRX_N-00095-86002244,2022-04-01T11:49:42,Vitoria-Gasteiz,incomes,salary_partner,1218.02,-1224.65
buyer_6,Manuel,45,ES29209555094272945666,TRX_N-00096-56536658,2022-04-01T11:49:42,Vitoria-Gasteiz,incomes,extra_income,247.42,-977.23
buyer_6,Manuel,45,ES29209555094272945666,TRX_N-00097-13298254,2022-04-01T17:08:15,Galdakao,expenses,food,-82.28,-1059.51
buyer_6,Manuel,45,ES29209555094272945666,TRX_N-00098-39527656,2022-04-01T20:18:06,Vitoria-Gasteiz,expenses,clothing,-148.27,-1207.78
buyer_6,Manuel,45,ES29209555094272945666,TRX_N-00099-01328280,2022-04-04T20:15:21,Vitoria-Gasteiz,expenses,mortgage,-925.72,-2133.5
buyer_6,Manuel,45,ES29209555094272945666,TRX_N-00100-94089153,2022-04-05T15:44:07,Vitoria-Gasteiz,expenses,water,-28.92,-2162.42
buyer_6,Manuel,45,ES29209555094272945666,TRX_N-00101-77334108,2022-04-05T11:23:15,Vitoria-Gasteiz,expenses,phone,-37.82,-2200.24
buyer_6,Manuel,45,ES29209555094272945666,TRX_N-00102-46886356,2022-04-06T08:23:23,Vitoria-Gasteiz,expenses,food,-97.23,-2297.47
buyer_6,Manuel,45,ES29209555094272945666,TRX_N-00103-44012515,2022-04-07T14:02:08,Vitoria-Gasteiz,expenses,gas,-44.35,-2341.82
buyer_6,Manuel,45,ES29209555094272945666,TRX_N-00104-97807425,2022-04-07T17:11:45,Vitoria-Gasteiz,expenses,appliances,-298.16,-2639.98
buyer_6,Manuel,45,ES29209555094272945666,TRX_N-00105-56497642,2022-04-08T14:49:47,Vitoria-Gasteiz,expenses,electricity,-55.21,-2695.19
buyer_6,Manuel,45,ES29209555094272945666,TRX_N-00106-51268077,2022-04-08T09:59:55,Vitoria-Gasteiz,expenses,internet,-42.0,-2737.19
buyer_6,Manuel,45,ES29209555094272945666,TRX_N-00107-34318645,2022-04-08T17:03:56,Vitoria-Gasteiz,expenses,food,-122.51,-2859.7
buyer_6,Manuel,45,ES29209555094272945666,TRX_N-00108-19173126,2022-04-09T16:09:12,Vitoria-Gasteiz,expenses,food,-95.53,-2955.23
buyer_6,Manuel,45,ES29209555094272945666,TRX_N-00109-61228140,2022-04-09T08:34:54,Vitoria-Gasteiz,expenses,cash,-100.0,-3055.23
buyer_6,Manuel,45,ES29209555094272945666,TRX_N-00110-35278535,2022-04-10T09:11:42,Vitoria-Gasteiz,expenses,transport,-63.11,-3118.34
buyer_6,Manuel,45,ES29209555094272945666,TRX_N-00111-44386916,2022-04-11T10:18:42,Vitoria-Gasteiz,expenses,leisure,-69.02,-3187.36
buyer_6,Manuel,45,ES29209555094272945666,TRX_N-00112-16144951,2022-04-11T18:31:04,Vitoria-Gasteiz,expenses,cash,-100.0,-3287.36
buyer_6,Manuel,45,ES29209555094272945666,TRX_N-00113-08459869,2022-04-12T19:15:32,Vitoria-Gasteiz,expenses,repairs,-269.2,-3556.56
buyer_6,Manuel,45,ES29209555094272945666,TRX_N-00114-31601188,2022-04-17T08:31:17,Vitoria-Gasteiz,expenses,food,-63.83,-3620.39
buyer_6,Manuel,45,ES29209555094272945666,TRX_N-00115-50007128,2022-04-17T10:38:21,Vitoria-Gasteiz,expenses,leisure,-21.18,-3641.57
buyer_6,Manuel,45,ES29209555094272945666,TRX_N-00116-03124167,2022-04-20T19:30:33,Vitoria-Gasteiz,expenses,food,-101.22,-3742.79
buyer_6,Manuel,45,ES29209555094272945666,TRX_N-00117-06220908,2022-04-20T09:10:32,Vitoria-Gasteiz,expenses,transport,-41.33,-3784.12
buyer_6,Manuel,45,ES29209555094272945666,TRX_N-00118-36687562,2022-04-20T09:23:58,Galdakao,expenses,leisure,-36.18,-3820.3
buyer_6,Manuel,45,ES29209555094272945666,TRX_N-00119-76079934,2022-04-21T12:02:47,Vitoria-Gasteiz,expenses,food,-106.68,-3926.98
buyer_6,Manuel,45,ES29209555094272945666,TRX_N-00120-43584638,2022-04-21T08:12:46,Vitoria-Gasteiz,expenses,transport,-53.55,-3980.53
buyer_6,Manuel,45,ES29209555094272945666,TRX_N-00121-87043780,2022-04-21T13:11:03,Hondarribia,expenses,repairs,-298.94,-4279.47
buyer_6,Manuel,45,ES29209555094272945666,TRX_N-00122-54662816,2022-04-23T19:29:22,Vitoria-Gasteiz,expenses,education,-76.15,-4355.62
buyer_6,Manuel,45,ES29209555094272945666,TRX_N-00123-10158081,2022-04-24T11:00:03,Vitoria-Gasteiz,expenses,appliances,-158.32,-4513.94
buyer_6,Manuel,45,ES29209555094272945666,TRX_N-00124-86694986,2022-04-25T14:19:28,Vitoria-Gasteiz,expenses,education,-70.87,-4584.81
buyer_6,Manuel,45,ES29209555094272945666,TRX_N-00125-01910939,2022-04-26T07:33:31,Vitoria-Gasteiz,expenses,cash,-100.0,-4684.81
buyer_6,Manuel,45,ES29209555094272945666,TRX_N-00126-82389904,2022-04-27T08:18:13,Vitoria-Gasteiz,expenses,food,-113.95,-4798.76
buyer_6,Manuel,45,ES29209555094272945666,TRX_N-00127-77074915,2022-04-28T23:14:46,Vitoria-Gasteiz,expenses,transport,-73.99,-4872.75
buyer_6,Manuel,45,ES29209555094272945666,TRX_N-00128-56716193,2022-04-29T08:52:13,Vitoria-Gasteiz,expenses,appliances,-129.99,-5002.74
buyer_6,Manuel,45,ES29209555094272945666,TRX_N-00129-49060005,2022-05-01T12:28:16,Vitoria-Gasteiz,incomes,salary,1301.77,-3700.97
buyer_6,Manuel,45,ES29209555094272945666,TRX_N-00130-69723159,2022-05-01T12:28:16,Vitoria-Gasteiz,incomes,salary_partner,1218.02,-2482.95
buyer_6,Manuel,45,ES29209555094272945666,TRX_N-00131-13645593,2022-05-03T15:40:44,Vitoria-Gasteiz,expenses,food,-77.32,-2560.27
buyer_6,Manuel,45,ES29209555094272945666,TRX_N-00132-68677510,2022-05-03T14:00:05,Donostia,expenses,repairs,-229.96,-2790.23
buyer_6,Manuel,45,ES29209555094272945666,TRX_N-00133-90924590,2022-05-04T16:09:21,Vitoria-Gasteiz,expenses,mortgage,-925.72,-3715.95
buyer_6,Manuel,45,ES29209555094272945666,TRX_N-00134-19340086,2022-05-04T13:18:54,Vitoria-Gasteiz,expenses,food,-113.64,-3829.59
buyer_6,Manuel,45,ES29209555094272945666,TRX_N-00135-36668336,2022-05-04T18:45:04,Vitoria-Gasteiz,expenses,repairs,-235.23,-4064.82
buyer_6,Manuel,45,ES29209555094272945666,TRX_N-00136-90119453,2022-05-05T09:07:14,Vitoria-Gasteiz,expenses,water,-20.4,-4085.22
buyer_6,Manuel,45,ES29209555094272945666,TRX_N-00137-95464173,2022-05-05T15:29:49,Vitoria-Gasteiz,expenses,gas,-67.46,-4152.68
buyer_6,Manuel,45,ES29209555094272945666,TRX_N-00138-51891328,2022-05-05T11:03:26,Vitoria-Gasteiz,expenses,internet,-42.0,-4194.68
buyer_6,Manuel,45,ES29209555094272945666,TRX_N-00139-77305122,2022-05-06T17:48:45,Vitoria-Gasteiz,expenses,electricity,-61.33,-4256.01
buyer_6,Manuel,45,ES29209555094272945666,TRX_N-00140-05498165,2022-05-06T08:15:01,Vitoria-Gasteiz,expenses,healthcare,-126.78,-4382.79
buyer_6,Manuel,45,ES29209555094272945666,TRX_N-00141-57002676,2022-05-06T08:46:58,Oyón-Oion,expenses,repairs,-177.87,-4560.66
buyer_6,Manuel,45,ES29209555094272945666,TRX_N-00142-12593629,2022-05-07T09:43:49,Vitoria-Gasteiz,expenses,phone,-40.84,-4601.5
buyer_6,Manuel,45,ES29209555094272945666,TRX_N-00143-23656663,2022-05-08T18:08:45,Vitoria-Gasteiz,expenses,children,-90.93,-4692.43
buyer_6,Manuel,45,ES29209555094272945666,TRX_N-00144-41055199,2022-05-09T16:35:18,Vitoria-Gasteiz,expenses,cash,-100.0,-4792.43
buyer_6,Manuel,45,ES29209555094272945666,TRX_N-00145-42090800,2022-05-10T19:20:27,Vitoria-Gasteiz,expenses,gifts,-58.83,-4851.26
buyer_6,Manuel,45,ES29209555094272945666,TRX_N-00146-29464069,2022-05-11T18:14:13,Vitoria-Gasteiz,expenses,cash,-100.0,-4951.26
buyer_6,Manuel,45,ES29209555094272945666,TRX_N-00147-34355276,2022-05-12T10:51:04,Vitoria-Gasteiz,expenses,food,-75.73,-5026.99
buyer_6,Manuel,45,ES29209555094272945666,TRX_N-00148-67063294,2022-05-13T14:51:21,Donostia,expenses,cash,-100.0,-5126.99
buyer_6,Manuel,45,ES29209555094272945666,TRX_N-00149-91873856,2022-05-13T23:00:07,Vitoria-Gasteiz,expenses,travel,-550.76,-5677.75
buyer_6,Manuel,45,ES29209555094272945666,TRX_N-00150-77545424,2022-05-16T15:02:44,Vitoria-Gasteiz,expenses,food,-81.71,-5759.46
buyer_6,Manuel,45,ES29209555094272945666,TRX_N-00151-21712440,2022-05-16T20:59:29,Vitoria-Gasteiz,expenses,clothing,-47.06,-5806.52
buyer_6,Manuel,45,ES29209555094272945666,TRX_N-00152-72928436,2022-05-19T19:21:05,Vitoria-Gasteiz,expenses,clothing,-88.14,-5894.66
buyer_6,Manuel,45,ES29209555094272945666,TRX_N-00153-25212210,2022-05-20T18:21:35,Vitoria-Gasteiz,expenses,cash,-100.0,-5994.66
buyer_6,Manuel,45,ES29209555094272945666,TRX_N-00154-09806368,2022-05-21T08:42:53,Alegría-Dulantzi,expenses,transport,-85.18,-6079.84
buyer_6,Manuel,45,ES29209555094272945666,TRX_N-00155-67644844,2022-05-21T11:06:33,Vitoria-Gasteiz,expenses,clothing,-86.01,-6165.85
buyer_6,Manuel,45,ES29209555094272945666,TRX_N-00156-12865760,2022-05-22T10:58:41,Vitoria-Gasteiz,expenses,gifts,-583.06,-6748.91
buyer_6,Manuel,45,ES29209555094272945666,TRX_N-00157-26408684,2022-05-23T15:08:41,Vitoria-Gasteiz,expenses,food,-98.71,-6847.62
buyer_6,Manuel,45,ES29209555094272945666,TRX_N-00158-59969889,2022-05-24T12:22:43,Vitoria-Gasteiz,expenses,food,-97.59,-6945.21
buyer_6,Manuel,45,ES29209555094272945666,TRX_N-00159-58585547,2022-05-25T16:29:36,Vitoria-Gasteiz,expenses,gifts,-710.53,-7655.74
buyer_6,Manuel,45,ES29209555094272945666,TRX_N-00160-31263441,2022-05-26T18:21:07,Vitoria-Gasteiz,expenses,appliances,-361.96,-8017.7
buyer_6,Manuel,45,ES29209555094272945666,TRX_N-00161-86068579,2022-05-28T15:28:24,Vitoria-Gasteiz,expenses,cash,-100.0,-8117.7
buyer_6,Manuel,45,ES29209555094272945666,TRX_N-00162-64248010,2022-05-29T15:36:46,Vitoria-Gasteiz,expenses,transport,-76.56,-8194.26
buyer_6,Manuel,45,ES29209555094272945666,TRX_N-00163-38136615,2022-05-29T14:43:20,Vitoria-Gasteiz,expenses,leisure,-40.62,-8234.88
buyer_6,Manuel,45,ES29209555094272945666,TRX_N-00164-33107453,2022-05-30T08:59:13,Vitoria-Gasteiz,expenses,clothing,-122.07,-8356.95
buyer_6,Manuel,45,ES29209555094272945666,TRX_N-00165-51981284,2022-05-31T10:04:20,Vitoria-Gasteiz,expenses,travel,-715.1,-9072.05
buyer_6,Manuel,45,ES29209555094272945666,TRX_N-00166-41350266,2022-06-01T14:36:28,Vitoria-Gasteiz,incomes,salary,1301.77,-7770.28
buyer_6,Manuel,45,ES29209555094272945666,TRX_N-00167-96123648,2022-06-01T14:36:28,Vitoria-Gasteiz,incomes,salary_partner,1218.02,-6552.26
buyer_6,Manuel,45,ES29209555094272945666,TRX_N-00168-78139039,2022-06-01T14:36:28,Vitoria-Gasteiz,incomes,salary_bonus,922.26,-5630.0
buyer_6,Manuel,45,ES29209555094272945666,TRX_N-00169-02195812,2022-06-01T14:36:28,Vitoria-Gasteiz,incomes,salary_partner_bonus,925.51,-4704.49
buyer_6,Manuel,45,ES29209555094272945666,TRX_N-00170-04579566,2022-06-01T07:12:25,Vitoria-Gasteiz,expenses,leisure,-36.08,-4740.57
buyer_6,Manuel,45,ES29209555094272945666,TRX_N-00171-76626574,2022-06-03T16:11:54,Durango,expenses,leisure,-65.17,-4805.74
buyer_6,Manuel,45,ES29209555094272945666,TRX_N-00172-97105825,2022-06-04T16:23:42,Vitoria-Gasteiz,expenses,mortgage,-925.72,-5731.46
buyer_6,Manuel,45,ES29209555094272945666,TRX_N-00173-97074951,2022-06-04T20:48:50,Vitoria-Gasteiz,expenses,repairs,-88.48,-5819.94
buyer_6,Manuel,45,ES29209555094272945666,TRX_N-00174-12655057,2022-06-05T11:43:15,Vitoria-Gasteiz,expenses,water,-34.92,-5854.86
buyer_6,Manuel,45,ES29209555094272945666,TRX_N-00175-40568729,2022-06-06T13:34:50,Vitoria-Gasteiz,expenses,internet,-42.0,-5896.86
buyer_6,Manuel,45,ES29209555094272945666,TRX_N-00176-73185495,2022-06-06T21:47:50,Vitoria-Gasteiz,expenses,transport,-43.29,-5940.15
buyer_6,Manuel,45,ES29209555094272945666,TRX_N-00177-99766633,2022-06-06T21:43:56,Vitoria-Gasteiz,expenses,clothing,-134.4,-6074.55
buyer_6,Manuel,45,ES29209555094272945666,TRX_N-00178-55603069,2022-06-07T10:19:45,Vitoria-Gasteiz,expenses,food,-72.18,-6146.73
buyer_6,Manuel,45,ES29209555094272945666,TRX_N-00179-45243385,2022-06-07T13:13:10,Vitoria-Gasteiz,expenses,transport,-87.43,-6234.16
buyer_6,Manuel,45,ES29209555094272945666,TRX_N-00180-82734395,2022-06-08T15:15:08,Vitoria-Gasteiz,expenses,electricity,-31.71,-6265.87
buyer_6,Manuel,45,ES29209555094272945666,TRX_N-00181-17031627,2022-06-08T18:56:29,Vitoria-Gasteiz,expenses,gas,-77.16,-6343.03
buyer_6,Manuel,45,ES29209555094272945666,TRX_N-00182-26915257,2022-06-08T10:32:38,Vitoria-Gasteiz,expenses,phone,-30.2,-6373.23
buyer_6,Manuel,45,ES29209555094272945666,TRX_N-00183-86731089,2022-06-08T08:07:07,Vitoria-Gasteiz,expenses,clothing,-114.42,-6487.65
buyer_6,Manuel,45,ES29209555094272945666,TRX_N-00184-47143231,2022-06-09T20:07:02,Vitoria-Gasteiz,expenses,food,-110.41,-6598.06
buyer_6,Manuel,45,ES29209555094272945666,TRX_N-00185-05202279,2022-06-10T08:35:48,Vitoria-Gasteiz,expenses,transport,-69.78,-6667.84
buyer_6,Manuel,45,ES29209555094272945666,TRX_N-00186-16474956,2022-06-10T14:22:56,Vitoria-Gasteiz,expenses,leisure,-66.93,-6734.77
buyer_6,Manuel,45,ES29209555094272945666,TRX_N-00187-17663967,2022-06-10T16:38:21,Vitoria-Gasteiz,expenses,education,-59.79,-6794.56
buyer_6,Manuel,45,ES29209555094272945666,TRX_N-00188-78583285,2022-06-11T11:08:17,Leioa,expenses,food,-93.58,-6888.14
buyer_6,Manuel,45,ES29209555094272945666,TRX_N-00189-41118381,2022-06-12T11:19:27,Irun,expenses,healthcare,-92.64,-6980.78
buyer_6,Manuel,45,ES29209555094272945666,TRX_N-00190-61072162,2022-06-12T19:17:32,Vitoria-Gasteiz,expenses,repairs,-234.5,-7215.28
buyer_6,Manuel,45,ES29209555094272945666,TRX_N-00191-78100673,2022-06-13T13:52:38,Vitoria-Gasteiz,expenses,education,-62.83,-7278.11
buyer_6,Manuel,45,ES29209555094272945666,TRX_N-00192-26208091,2022-06-14T16:01:44,Vitoria-Gasteiz,expenses,repairs,-110.04,-7388.15
buyer_6,Manuel,45,ES29209555094272945666,TRX_N-00193-57292203,2022-06-15T14:16:24,Galdakao,expenses,food,-83.67,-7471.82
buyer_6,Manuel,45,ES29209555094272945666,TRX_N-00194-33904056,2022-06-16T11:15:16,Vitoria-Gasteiz,expenses,food,-117.56,-7589.38
buyer_6,Manuel,45,ES29209555094272945666,TRX_N-00195-59884514,2022-06-16T14:17:46,Vitoria-Gasteiz,expenses,transport,-62.93,-7652.31
buyer_6,Manuel,45,ES29209555094272945666,TRX_N-00196-57815007,2022-06-17T10:00:06,Vitoria-Gasteiz,expenses,leisure,-74.55,-7726.86
buyer_6,Manuel,45,ES29209555094272945666,TRX_N-00197-77830580,2022-06-17T11:02:56,Vitoria-Gasteiz,expenses,cash,-100.0,-7826.86
buyer_6,Manuel,45,ES29209555094272945666,TRX_N-00198-48104276,2022-06-19T12:32:53,Vitoria-Gasteiz,expenses,leisure,-33.66,-7860.52
buyer_6,Manuel,45,ES29209555094272945666,TRX_N-00199-13795230,2022-06-20T10:15:09,Vitoria-Gasteiz,expenses,food,-73.34,-7933.86
buyer_6,Manuel,45,ES29209555094272945666,TRX_N-00200-74561520,2022-06-21T14:46:32,Andoain,expenses,leisure,-23.84,-7957.7
buyer_6,Manuel,45,ES29209555094272945666,TRX_N-00201-57357671,2022-06-21T05:04:14,Oyón-Oion,expenses,gifts,-292.72,-8250.42
buyer_6,Manuel,45,ES29209555094272945666,TRX_N-00202-82124954,2022-06-23T16:15:39,Vitoria-Gasteiz,expenses,cash,-100.0,-8350.42
buyer_6,Manuel,45,ES29209555094272945666,TRX_N-00203-94663449,2022-06-24T14:47:06,Vitoria-Gasteiz,expenses,transport,-79.83,-8430.25
buyer_6,Manuel,45,ES29209555094272945666,TRX_N-00204-14507242,2022-06-24T22:34:42,Vitoria-Gasteiz,expenses,leisure,-79.47,-8509.72
buyer_6,Manuel,45,ES29209555094272945666,TRX_N-00205-77570169,2022-07-01T15:27:10,Vitoria-Gasteiz,incomes,salary,1301.77,-7207.95
buyer_6,Manuel,45,ES29209555094272945666,TRX_N-00206-44500405,2022-07-01T15:27:10,Vitoria-Gasteiz,incomes,salary_partner,1218.02,-5989.93
buyer_6,Manuel,45,ES29209555094272945666,TRX_N-00207-62516556,2022-07-01T15:27:10,Vitoria-Gasteiz,incomes,extra_income,247.42,-5742.51
buyer_6,Manuel,45,ES29209555094272945666,TRX_N-00208-91053792,2022-07-03T20:20:19,Vitoria-Gasteiz,expenses,cash,-100.0,-5842.51
buyer_6,Manuel,45,ES29209555094272945666,TRX_N-00209-28496751,2022-07-04T23:56:26,Vitoria-Gasteiz,expenses,mortgage,-925.72,-6768.23
buyer_6,Manuel,45,ES29209555094272945666,TRX_N-00210-03023174,2022-07-06T23:21:23,Vitoria-Gasteiz,expenses,phone,-37.02,-6805.25
buyer_6,Manuel,45,ES29209555094272945666,TRX_N-00211-95185777,2022-07-07T18:46:41,Vitoria-Gasteiz,expenses,electricity,-71.56,-6876.81
buyer_6,Manuel,45,ES29209555094272945666,TRX_N-00212-66754406,2022-07-07T17:04:53,Vitoria-Gasteiz,expenses,internet,-42.0,-6918.81
buyer_6,Manuel,45,ES29209555094272945666,TRX_N-00213-77529210,2022-07-07T16:52:56,Oyón-Oion,expenses,healthcare,-115.98,-7034.79
buyer_6,Manuel,45,ES29209555094272945666,TRX_N-00214-47857568,2022-07-07T14:25:50,Vitoria-Gasteiz,expenses,gifts,-700.54,-7735.33
buyer_6,Manuel,45,ES29209555094272945666,TRX_N-00215-89912275,2022-07-08T18:18:44,Vitoria-Gasteiz,expenses,gas,-78.16,-7813.49
buyer_6,Manuel,45,ES29209555094272945666,TRX_N-00216-91218096,2022-07-08T18:00:53,Vitoria-Gasteiz,expenses,water,-31.54,-7845.03
buyer_6,Manuel,45,ES29209555094272945666,TRX_N-00217-90750896,2022-07-09T11:26:44,Vitoria-Gasteiz,expenses,leisure,-58.42,-7903.45
buyer_6,Manuel,45,ES29209555094272945666,TRX_N-00218-50424444,2022-07-12T15:35:02,Vitoria-Gasteiz,expenses,leisure,-57.5,-7960.95
buyer_6,Manuel,45,ES29209555094272945666,TRX_N-00219-18790773,2022-07-12T23:46:40,Vitoria-Gasteiz,expenses,children,-161.31,-8122.26
buyer_6,Manuel,45,ES29209555094272945666,TRX_N-00220-15139730,2022-07-13T09:53:58,Zarautz,expenses,food,-111.66,-8233.92
buyer_6,Manuel,45,ES29209555094272945666,TRX_N-00221-60064132,2022-07-13T11:19:25,Vitoria-Gasteiz,expenses,education,-67.92,-8301.84
buyer_6,Manuel,45,ES29209555094272945666,TRX_N-00222-46209797,2022-07-14T13:50:57,Vitoria-Gasteiz,expenses,cash,-100.0,-8401.84
buyer_6,Manuel,45,ES29209555094272945666,TRX_N-00223-12537445,2022-07-21T18:13:29,Vitoria-Gasteiz,expenses,gifts,-518.57,-8920.41
buyer_6,Manuel,45,ES29209555094272945666,TRX_N-00224-48548889,2022-07-22T10:16:54,Hondarribia,expenses,food,-64.75,-8985.16
buyer_6,Manuel,45,ES29209555094272945666,TRX_N-00225-78644460,2022-07-22T00:50:30,Vitoria-Gasteiz,expenses,healthcare,-113.62,-9098.78
buyer_6,Manuel,45,ES29209555094272945666,TRX_N-00226-08996953,2022-07-23T13:38:43,Vitoria-Gasteiz,expenses,food,-62.22,-9161.0
buyer_6,Manuel,45,ES29209555094272945666,TRX_N-00227-03023085,2022-07-23T01:33:20,Vitoria-Gasteiz,expenses,transport,-41.95,-9202.95
buyer_6,Manuel,45,ES29209555094272945666,TRX_N-00228-98640961,2022-07-23T13:36:30,Vitoria-Gasteiz,expenses,clothing,-84.78,-9287.73
buyer_6,Manuel,45,ES29209555094272945666,TRX_N-00229-86862070,2022-07-23T15:10:47,Vitoria-Gasteiz,expenses,cash,-100.0,-9387.73
buyer_6,Manuel,45,ES29209555094272945666,TRX_N-00230-73459311,2022-07-25T17:00:13,Vitoria-Gasteiz,expenses,gifts,-781.51,-10169.24
buyer_6,Manuel,45,ES29209555094272945666,TRX_N-00231-57221187,2022-07-25T17:57:00,Vitoria-Gasteiz,expenses,children,-182.18,-10351.42
buyer_6,Manuel,45,ES29209555094272945666,TRX_N-00232-59211459,2022-07-26T13:09:45,Vitoria-Gasteiz,expenses,repairs,-214.91,-10566.33
buyer_6,Manuel,45,ES29209555094272945666,TRX_N-00233-83652964,2022-07-27T16:40:47,Vitoria-Gasteiz,expenses,children,-69.17,-10635.5
buyer_6,Manuel,45,ES29209555094272945666,TRX_N-00234-67895080,2022-07-29T16:33:51,Vitoria-Gasteiz,expenses,leisure,-19.04,-10654.54
buyer_6,Manuel,45,ES29209555094272945666,TRX_N-00235-38847362,2022-07-30T03:38:55,Vitoria-Gasteiz,expenses,food,-67.3,-10721.84
buyer_6,Manuel,45,ES29209555094272945666,TRX_N-00236-23923625,2022-07-30T18:55:54,Vitoria-Gasteiz,expenses,cash,-100.0,-10821.84
buyer_6,Manuel,45,ES29209555094272945666,TRX_N-00237-73353466,2022-07-31T18:51:44,Andoain,expenses,food,-93.89,-10915.73
buyer_6,Manuel,45,ES29209555094272945666,TRX_N-00238-39741237,2022-08-01T11:02:31,Vitoria-Gasteiz,incomes,salary,1301.77,-9613.96
buyer_6,Manuel,45,ES29209555094272945666,TRX_N-00239-31423944,2022-08-01T11:02:31,Vitoria-Gasteiz,incomes,salary_partner,1218.02,-8395.94
buyer_6,Manuel,45,ES29209555094272945666,TRX_N-00240-43551346,2022-08-01T19:45:02,Vitoria-Gasteiz,expenses,food,-92.57,-8488.51
buyer_6,Manuel,45,ES29209555094272945666,TRX_N-00241-24725553,2022-08-02T08:29:20,Vitoria-Gasteiz,expenses,clothing,-138.87,-8627.38
buyer_6,Manuel,45,ES29209555094272945666,TRX_N-00242-78338800,2022-08-04T16:24:12,Vitoria-Gasteiz,expenses,mortgage,-925.72,-9553.1
buyer_6,Manuel,45,ES29209555094272945666,TRX_N-00243-15086165,2022-08-05T17:11:19,Vitoria-Gasteiz,expenses,internet,-42.0,-9595.1
buyer_6,Manuel,45,ES29209555094272945666,TRX_N-00244-05077136,2022-08-06T10:08:19,Vitoria-Gasteiz,expenses,gas,-89.72,-9684.82
buyer_6,Manuel,45,ES29209555094272945666,TRX_N-00245-80849583,2022-08-07T19:07:57,Vitoria-Gasteiz,expenses,food,-109.09,-9793.91
buyer_6,Manuel,45,ES29209555094272945666,TRX_N-00246-36622835,2022-08-08T17:08:26,Vitoria-Gasteiz,expenses,phone,-37.73,-9831.64
buyer_6,Manuel,45,ES29209555094272945666,TRX_N-00247-40074710,2022-08-08T12:30:17,Vitoria-Gasteiz,expenses,water,-33.93,-9865.57
buyer_6,Manuel,45,ES29209555094272945666,TRX_N-00248-66197148,2022-08-08T13:54:03,Vitoria-Gasteiz,expenses,electricity,-30.51,-9896.08
buyer_6,Manuel,45,ES29209555094272945666,TRX_N-00249-37043060,2022-08-08T08:47:03,Vitoria-Gasteiz,expenses,leisure,-73.15,-9969.23
buyer_6,Manuel,45,ES29209555094272945666,TRX_N-00250-62611845,2022-08-08T08:14:56,Vitoria-Gasteiz,expenses,children,-202.76,-10171.99
buyer_6,Manuel,45,ES29209555094272945666,TRX_N-00251-63600737,2022-08-09T01:29:16,Vitoria-Gasteiz,expenses,leisure,-54.77,-10226.76
buyer_6,Manuel,45,ES29209555094272945666,TRX_N-00252-07881872,2022-08-10T10:11:58,Amurrio,expenses,education,-63.1,-10289.86
buyer_6,Manuel,45,ES29209555094272945666,TRX_N-00253-37122990,2022-08-12T19:25:14,Vitoria-Gasteiz,expenses,children,-188.38,-10478.24
buyer_6,Manuel,45,ES29209555094272945666,TRX_N-00254-79747317,2022-08-13T14:35:04,Sopela,expenses,leisure,-41.51,-10519.75
buyer_6,Manuel,45,ES29209555094272945666,TRX_N-00255-81854808,2022-08-14T13:31:27,Vitoria-Gasteiz,expenses,appliances,-261.02,-10780.77
buyer_6,Manuel,45,ES29209555094272945666,TRX_N-00256-60788696,2022-08-15T08:07:54,Vitoria-Gasteiz,expenses,leisure,-42.37,-10823.14
buyer_6,Manuel,45,ES29209555094272945666,TRX_N-00257-83908331,2022-08-16T16:57:14,Basauri,expenses,cash,-100.0,-10923.14
buyer_6,Manuel,45,ES29209555094272945666,TRX_N-00258-71005631,2022-08-18T14:13:09,Lasarte-Oria,expenses,food,-89.76,-11012.9
buyer_6,Manuel,45,ES29209555094272945666,TRX_N-00259-90961350,2022-08-21T06:48:36,Vitoria-Gasteiz,expenses,leisure,-19.15,-11032.05
buyer_6,Manuel,45,ES29209555094272945666,TRX_N-00260-87764909,2022-08-23T14:49:19,Vitoria-Gasteiz,expenses,cash,-100.0,-11132.05
buyer_6,Manuel,45,ES29209555094272945666,TRX_N-00261-63482325,2022-08-24T20:02:09,Vitoria-Gasteiz,expenses,food,-116.17,-11248.22
buyer_6,Manuel,45,ES29209555094272945666,TRX_N-00262-82385960,2022-08-24T16:19:01,Vitoria-Gasteiz,expenses,children,-229.34,-11477.56
buyer_6,Manuel,45,ES29209555094272945666,TRX_N-00263-13300331,2022-08-26T15:03:33,Vitoria-Gasteiz,expenses,cash,-100.0,-11577.56
buyer_6,Manuel,45,ES29209555094272945666,TRX_N-00264-63626109,2022-08-26T10:29:50,Getxo,expenses,appliances,-348.67,-11926.23
buyer_6,Manuel,45,ES29209555094272945666,TRX_N-00265-27255638,2022-08-26T16:34:14,Portugalete,expenses,repairs,-216.97,-12143.2
buyer_6,Manuel,45,ES29209555094272945666,TRX_N-00266-02766335,2022-08-29T17:00:27,Hondarribia,expenses,food,-85.82,-12229.02
buyer_6,Manuel,45,ES29209555094272945666,TRX_N-00267-09341992,2022-08-29T14:40:35,Vitoria-Gasteiz,expenses,children,-96.76,-12325.78
buyer_6,Manuel,45,ES29209555094272945666,TRX_N-00268-18792182,2022-08-30T18:28:32,Zarautz,expenses,food,-94.15,-12419.93
buyer_6,Manuel,45,ES29209555094272945666,TRX_N-00269-47477197,2022-08-30T12:10:02,Berango,expenses,cash,-100.0,-12519.93
buyer_6,Manuel,45,ES29209555094272945666,TRX_N-00270-67513810,2022-08-31T15:33:27,Vitoria-Gasteiz,expenses,cash,-100.0,-12619.93
buyer_6,Manuel,45,ES29209555094272945666,TRX_N-00271-13766693,2022-09-01T08:57:33,Vitoria-Gasteiz,incomes,salary,1301.77,-11318.16
buyer_6,Manuel,45,ES29209555094272945666,TRX_N-00272-48991294,2022-09-01T08:57:33,Vitoria-Gasteiz,incomes,salary_partner,1218.02,-10100.14
buyer_6,Manuel,45,ES29209555094272945666,TRX_N-00273-10396793,2022-09-01T08:05:35,Vitoria-Gasteiz,expenses,food,-72.16,-10172.3
buyer_6,Manuel,45,ES29209555094272945666,TRX_N-00274-45508827,2022-09-01T13:02:45,Vitoria-Gasteiz,expenses,repairs,-204.8,-10377.1
buyer_6,Manuel,45,ES29209555094272945666,TRX_N-00275-07631074,2022-09-03T17:14:31,Vitoria-Gasteiz,expenses,cash,-100.0,-10477.1
buyer_6,Manuel,45,ES29209555094272945666,TRX_N-00276-25758150,2022-09-04T17:19:10,Vitoria-Gasteiz,expenses,mortgage,-925.72,-11402.82
buyer_6,Manuel,45,ES29209555094272945666,TRX_N-00277-03460062,2022-09-04T03:55:21,Vitoria-Gasteiz,expenses,education,-74.31,-11477.13
buyer_6,Manuel,45,ES29209555094272945666,TRX_N-00278-60311921,2022-09-06T20:22:18,Portugalete,expenses,food,-105.63,-11582.76
buyer_6,Manuel,45,ES29209555094272945666,TRX_N-00279-48533484,2022-09-06T13:27:41,Oyón-Oion,expenses,transport,-51.21,-11633.97
buyer_6,Manuel,45,ES29209555094272945666,TRX_N-00280-76857732,2022-09-07T14:31:35,Vitoria-Gasteiz,expenses,electricity,-70.11,-11704.08
buyer_6,Manuel,45,ES29209555094272945666,TRX_N-00281-85732491,2022-09-08T14:32:50,Vitoria-Gasteiz,expenses,gas,-88.92,-11793.0
buyer_6,Manuel,45,ES29209555094272945666,TRX_N-00282-21011776,2022-09-08T16:42:10,Vitoria-Gasteiz,expenses,water,-21.01,-11814.01
buyer_6,Manuel,45,ES29209555094272945666,TRX_N-00283-45560689,2022-09-08T20:35:49,Vitoria-Gasteiz,expenses,internet,-42.0,-11856.01
buyer_6,Manuel,45,ES29209555094272945666,TRX_N-00284-43607918,2022-09-08T20:37:19,Vitoria-Gasteiz,expenses,phone,-40.32,-11896.33
buyer_6,Manuel,45,ES29209555094272945666,TRX_N-00285-30053096,2022-09-10T17:20:47,Vitoria-Gasteiz,expenses,food,-98.37,-11994.7
buyer_6,Manuel,45,ES29209555094272945666,TRX_N-00286-27149797,2022-09-11T19:26:18,Portugalete,expenses,food,-81.07,-12075.77
buyer_6,Manuel,45,ES29209555094272945666,TRX_N-00287-26689215,2022-09-12T20:20:58,Vitoria-Gasteiz,expenses,repairs,-297.03,-12372.8
buyer_6,Manuel,45,ES29209555094272945666,TRX_N-00288-54614683,2022-09-15T13:48:19,Vitoria-Gasteiz,expenses,leisure,-41.49,-12414.29
buyer_6,Manuel,45,ES29209555094272945666,TRX_N-00289-00016401,2022-09-15T10:14:00,Vitoria-Gasteiz,expenses,cash,-100.0,-12514.29
buyer_6,Manuel,45,ES29209555094272945666,TRX_N-00290-22431755,2022-09-15T08:31:36,Llodio,expenses,gifts,-736.01,-13250.3
buyer_6,Manuel,45,ES29209555094272945666,TRX_N-00291-74991553,2022-09-16T16:02:50,Vitoria-Gasteiz,expenses,food,-71.47,-13321.77
buyer_6,Manuel,45,ES29209555094272945666,TRX_N-00292-13915154,2022-09-16T05:25:01,Vitoria-Gasteiz,expenses,healthcare,-84.46,-13406.23
buyer_6,Manuel,45,ES29209555094272945666,TRX_N-00293-60546210,2022-09-17T12:51:07,Vitoria-Gasteiz,expenses,leisure,-67.74,-13473.97
buyer_6,Manuel,45,ES29209555094272945666,TRX_N-00294-08117427,2022-09-17T14:23:27,Vitoria-Gasteiz,expenses,cash,-100.0,-13573.97
buyer_6,Manuel,45,ES29209555094272945666,TRX_N-00295-33188845,2022-09-20T20:27:45,Vitoria-Gasteiz,expenses,leisure,-69.87,-13643.84
buyer_6,Manuel,45,ES29209555094272945666,TRX_N-00296-54476326,2022-09-20T17:21:39,Vitoria-Gasteiz,expenses,healthcare,-69.54,-13713.38
buyer_6,Manuel,45,ES29209555094272945666,TRX_N-00297-63762349,2022-09-21T20:25:19,Elciego,expenses,food,-115.47,-13828.85
buyer_6,Manuel,45,ES29209555094272945666,TRX_N-00298-15415547,2022-09-21T16:19:36,Vitoria-Gasteiz,expenses,leisure,-74.96,-13903.81
buyer_6,Manuel,45,ES29209555094272945666,TRX_N-00299-57692694,2022-09-22T21:17:18,Vitoria-Gasteiz,expenses,food,-119.48,-14023.29
buyer_6,Manuel,45,ES29209555094272945666,TRX_N-00300-73326146,2022-09-22T08:25:57,Vitoria-Gasteiz,expenses,transport,-84.58,-14107.87
buyer_6,Manuel,45,ES29209555094272945666,TRX_N-00301-83467653,2022-09-22T14:04:35,Bilbao,expenses,leisure,-21.53,-14129.4
buyer_6,Manuel,45,ES29209555094272945666,TRX_N-00302-05618233,2022-09-22T19:04:39,Lasarte-Oria,expenses,gifts,-292.42,-14421.82
buyer_6,Manuel,45,ES29209555094272945666,TRX_N-00303-19646577,2022-09-24T10:55:48,Vitoria-Gasteiz,expenses,cash,-100.0,-14521.82
buyer_6,Manuel,45,ES29209555094272945666,TRX_N-00304-10869868,2022-09-25T18:10:33,Barakaldo,expenses,food,-101.27,-14623.09
buyer_6,Manuel,45,ES29209555094272945666,TRX_N-00305-39033102,2022-09-25T09:24:40,Vitoria-Gasteiz,expenses,transport,-59.4,-14682.49
buyer_6,Manuel,45,ES29209555094272945666,TRX_N-00306-44198829,2022-09-26T20:07:38,Vitoria-Gasteiz,expenses,food,-101.79,-14784.28
buyer_6,Manuel,45,ES29209555094272945666,TRX_N-00307-78843636,2022-09-27T09:56:51,Vitoria-Gasteiz,expenses,cash,-100.0,-14884.28
buyer_6,Manuel,45,ES29209555094272945666,TRX_N-00308-52622146,2022-09-30T10:05:16,Vitoria-Gasteiz,expenses,appliances,-260.18,-15144.46
buyer_6,Manuel,45,ES29209555094272945666,TRX_N-00309-17196822,2022-09-30T22:23:37,Vitoria-Gasteiz,expenses,gifts,-658.53,-15802.99
buyer_6,Manuel,45,ES29209555094272945666,TRX_N-00310-79795211,2022-10-01T09:23:44,Vitoria-Gasteiz,incomes,salary,1301.77,-14501.22
buyer_6,Manuel,45,ES29209555094272945666,TRX_N-00311-23072295,2022-10-01T09:23:44,Vitoria-Gasteiz,incomes,salary_partner,1218.02,-13283.2
buyer_6,Manuel,45,ES29209555094272945666,TRX_N-00312-41133650,2022-10-01T13:43:34,Vitoria-Gasteiz,expenses,education,-64.6,-13347.8
buyer_6,Manuel,45,ES29209555094272945666,TRX_N-00313-93132063,2022-10-01T21:58:52,Vitoria-Gasteiz,expenses,travel,-940.35,-14288.15
buyer_6,Manuel,45,ES29209555094272945666,TRX_N-00314-72265253,2022-10-02T11:21:21,Vitoria-Gasteiz,expenses,transport,-47.3,-14335.45
buyer_6,Manuel,45,ES29209555094272945666,TRX_N-00315-13370136,2022-10-02T17:14:54,Vitoria-Gasteiz,expenses,children,-111.59,-14447.04
buyer_6,Manuel,45,ES29209555094272945666,TRX_N-00316-38904575,2022-10-03T20:36:56,Vitoria-Gasteiz,expenses,food,-77.23,-14524.27
buyer_6,Manuel,45,ES29209555094272945666,TRX_N-00317-53636495,2022-10-04T10:30:56,Vitoria-Gasteiz,expenses,mortgage,-925.72,-15449.99
buyer_6,Manuel,45,ES29209555094272945666,TRX_N-00318-18016044,2022-10-05T17:05:30,Vitoria-Gasteiz,expenses,cash,-100.0,-15549.99
buyer_6,Manuel,45,ES29209555094272945666,TRX_N-00319-24526503,2022-10-06T22:20:35,Vitoria-Gasteiz,expenses,phone,-40.76,-15590.75
buyer_6,Manuel,45,ES29209555094272945666,TRX_N-00320-96689817,2022-10-07T15:04:12,Vitoria-Gasteiz,expenses,internet,-42.0,-15632.75
buyer_6,Manuel,45,ES29209555094272945666,TRX_N-00321-78157066,2022-10-08T10:21:52,Vitoria-Gasteiz,expenses,water,-27.14,-15659.89
buyer_6,Manuel,45,ES29209555094272945666,TRX_N-00322-00976058,2022-10-08T12:03:18,Vitoria-Gasteiz,expenses,electricity,-36.98,-15696.87
buyer_6,Manuel,45,ES29209555094272945666,TRX_N-00323-96318642,2022-10-08T11:36:58,Vitoria-Gasteiz,expenses,gas,-71.94,-15768.81
buyer_6,Manuel,45,ES29209555094272945666,TRX_N-00324-57221207,2022-10-09T08:46:38,Vitoria-Gasteiz,expenses,food,-96.97,-15865.78
buyer_6,Manuel,45,ES29209555094272945666,TRX_N-00325-26377567,2022-10-09T22:28:46,Vitoria-Gasteiz,expenses,transport,-85.48,-15951.26
buyer_6,Manuel,45,ES29209555094272945666,TRX_N-00326-64985884,2022-10-09T09:44:51,Vitoria-Gasteiz,expenses,education,-55.83,-16007.09
buyer_6,Manuel,45,ES29209555094272945666,TRX_N-00327-23443794,2022-10-11T21:30:18,Vitoria-Gasteiz,expenses,food,-106.81,-16113.9
buyer_6,Manuel,45,ES29209555094272945666,TRX_N-00328-20333129,2022-10-11T05:13:47,Vitoria-Gasteiz,expenses,leisure,-73.1,-16187.0
buyer_6,Manuel,45,ES29209555094272945666,TRX_N-00329-36195273,2022-10-12T09:51:00,Barakaldo,expenses,transport,-87.05,-16274.05
buyer_6,Manuel,45,ES29209555094272945666,TRX_N-00330-45429007,2022-10-12T10:29:36,Vitoria-Gasteiz,expenses,cash,-100.0,-16374.05
buyer_6,Manuel,45,ES29209555094272945666,TRX_N-00331-60700328,2022-10-13T13:22:01,Vitoria-Gasteiz,expenses,transport,-48.54,-16422.59
buyer_6,Manuel,45,ES29209555094272945666,TRX_N-00332-76685506,2022-10-13T08:16:00,Vitoria-Gasteiz,expenses,leisure,-54.54,-16477.13
buyer_6,Manuel,45,ES29209555094272945666,TRX_N-00333-39508678,2022-10-13T09:23:53,Vitoria-Gasteiz,expenses,cash,-100.0,-16577.13
buyer_6,Manuel,45,ES29209555094272945666,TRX_N-00334-15860764,2022-10-18T11:40:16,Vitoria-Gasteiz,expenses,gifts,-466.59,-17043.72
buyer_6,Manuel,45,ES29209555094272945666,TRX_N-00335-10960463,2022-10-22T08:19:31,Llodio,expenses,transport,-41.91,-17085.63
buyer_6,Manuel,45,ES29209555094272945666,TRX_N-00336-27812606,2022-10-24T18:02:33,Berango,expenses,gifts,-299.78,-17385.41
buyer_6,Manuel,45,ES29209555094272945666,TRX_N-00337-07551366,2022-10-25T12:23:39,Vitoria-Gasteiz,expenses,food,-89.9,-17475.31
buyer_6,Manuel,45,ES29209555094272945666,TRX_N-00338-82101500,2022-10-27T00:19:17,Vitoria-Gasteiz,expenses,education,-76.84,-17552.15
buyer_6,Manuel,45,ES29209555094272945666,TRX_N-00339-63012062,2022-10-28T21:12:58,Vitoria-Gasteiz,expenses,repairs,-151.2,-17703.35
buyer_6,Manuel,45,ES29209555094272945666,TRX_N-00340-11056940,2022-10-30T09:29:44,Vitoria-Gasteiz,expenses,leisure,-75.76,-17779.11
buyer_6,Manuel,45,ES29209555094272945666,TRX_N-00341-69675104,2022-10-31T08:28:05,Mungia,expenses,healthcare,-156.72,-17935.83
buyer_6,Manuel,45,ES29209555094272945666,TRX_N-00342-24887204,2022-11-01T18:23:20,Vitoria-Gasteiz,incomes,salary,1301.77,-16634.06
buyer_6,Manuel,45,ES29209555094272945666,TRX_N-00343-40956643,2022-11-01T18:23:20,Vitoria-Gasteiz,incomes,salary_partner,1218.02,-15416.04
buyer_6,Manuel,45,ES29209555094272945666,TRX_N-00344-47860682,2022-11-01T18:23:20,Vitoria-Gasteiz,incomes,extra_income,247.42,-15168.62
buyer_6,Manuel,45,ES29209555094272945666,TRX_N-00345-02229958,2022-11-01T17:00:26,Vitoria-Gasteiz,expenses,repairs,-295.59,-15464.21
buyer_6,Manuel,45,ES29209555094272945666,TRX_N-00346-34382515,2022-11-04T17:58:18,Vitoria-Gasteiz,expenses,mortgage,-925.72,-16389.93
buyer_6,Manuel,45,ES29209555094272945666,TRX_N-00347-90312215,2022-11-04T21:42:36,Vitoria-Gasteiz,expenses,transport,-71.03,-16460.96
buyer_6,Manuel,45,ES29209555094272945666,TRX_N-00348-67252479,2022-11-05T12:54:23,Vitoria-Gasteiz,expenses,water,-31.79,-16492.75
buyer_6,Manuel,45,ES29209555094272945666,TRX_N-00349-29566478,2022-11-05T16:38:36,Vitoria-Gasteiz,expenses,phone,-32.32,-16525.07
buyer_6,Manuel,45,ES29209555094272945666,TRX_N-00350-71835274,2022-11-05T13:03:54,Vitoria-Gasteiz,expenses,education,-52.07,-16577.14
buyer_6,Manuel,45,ES29209555094272945666,TRX_N-00351-15131420,2022-11-05T10:20:19,Vitoria-Gasteiz,expenses,cash,-100.0,-16677.14
buyer_6,Manuel,45,ES29209555094272945666,TRX_N-00352-77129567,2022-11-06T12:45:00,Vitoria-Gasteiz,expenses,electricity,-30.45,-16707.59
buyer_6,Manuel,45,ES29209555094272945666,TRX_N-00353-12929229,2022-11-06T20:33:15,Vitoria-Gasteiz,expenses,gas,-104.23,-16811.82
buyer_6,Manuel,45,ES29209555094272945666,TRX_N-00354-00807430,2022-11-08T15:50:07,Vitoria-Gasteiz,expenses,internet,-42.0,-16853.82
buyer_6,Manuel,45,ES29209555094272945666,TRX_N-00355-01699169,2022-11-10T12:37:34,Vitoria-Gasteiz,expenses,cash,-100.0,-16953.82
buyer_6,Manuel,45,ES29209555094272945666,TRX_N-00356-62034567,2022-11-11T02:44:13,Vitoria-Gasteiz,expenses,transport,-52.1,-17005.92
buyer_6,Manuel,45,ES29209555094272945666,TRX_N-00357-48212680,2022-11-12T21:12:50,Vitoria-Gasteiz,expenses,cash,-100.0,-17105.92
buyer_6,Manuel,45,ES29209555094272945666,TRX_N-00358-25821533,2022-11-13T18:15:35,Vitoria-Gasteiz,expenses,leisure,-23.51,-17129.43
buyer_6,Manuel,45,ES29209555094272945666,TRX_N-00359-44894706,2022-11-13T16:08:13,Vitoria-Gasteiz,expenses,healthcare,-187.28,-17316.71
buyer_6,Manuel,45,ES29209555094272945666,TRX_N-00360-01711897,2022-11-15T19:44:18,Galdakao,expenses,transport,-56.89,-17373.6
buyer_6,Manuel,45,ES29209555094272945666,TRX_N-00361-98741375,2022-11-15T08:36:35,Llodio,expenses,leisure,-64.72,-17438.32
buyer_6,Manuel,45,ES29209555094272945666,TRX_N-00362-00696252,2022-11-18T11:35:32,Bermeo,expenses,healthcare,-47.74,-17486.06
buyer_6,Manuel,45,ES29209555094272945666,TRX_N-00363-13691404,2022-11-18T10:05:22,Vitoria-Gasteiz,expenses,cash,-100.0,-17586.06
buyer_6,Manuel,45,ES29209555094272945666,TRX_N-00364-79244101,2022-11-19T19:10:41,Vitoria-Gasteiz,expenses,leisure,-74.52,-17660.58
buyer_6,Manuel,45,ES29209555094272945666,TRX_N-00365-15017536,2022-11-20T22:01:22,Vitoria-Gasteiz,expenses,leisure,-39.72,-17700.3
buyer_6,Manuel,45,ES29209555094272945666,TRX_N-00366-90647339,2022-11-21T09:13:41,Hondarribia,expenses,leisure,-66.55,-17766.85
buyer_6,Manuel,45,ES29209555094272945666,TRX_N-00367-35306405,2022-11-21T17:25:57,Vitoria-Gasteiz,expenses,children,-166.95,-17933.8
buyer_6,Manuel,45,ES29209555094272945666,TRX_N-00368-35349056,2022-11-22T08:51:48,Vitoria-Gasteiz,expenses,children,-255.66,-18189.46
buyer_6,Manuel,45,ES29209555094272945666,TRX_N-00369-73447872,2022-11-24T08:31:19,Vitoria-Gasteiz,expenses,appliances,-367.09,-18556.55
buyer_6,Manuel,45,ES29209555094272945666,TRX_N-00370-97215635,2022-11-25T16:40:35,Vitoria-Gasteiz,expenses,clothing,-141.93,-18698.48
buyer_6,Manuel,45,ES29209555094272945666,TRX_N-00371-00522466,2022-11-28T18:03:56,Vitoria-Gasteiz,expenses,cash,-100.0,-18798.48
buyer_6,Manuel,45,ES29209555094272945666,TRX_N-00372-56733316,2022-11-30T15:14:07,Vitoria-Gasteiz,expenses,transport,-86.98,-18885.46
buyer_6,Manuel,45,ES29209555094272945666,TRX_N-00373-13028615,2022-12-01T17:29:27,Vitoria-Gasteiz,incomes,salary,1301.77,-17583.69
buyer_6,Manuel,45,ES29209555094272945666,TRX_N-00374-36205263,2022-12-01T17:29:27,Vitoria-Gasteiz,incomes,salary_partner,1218.02,-16365.67
buyer_6,Manuel,45,ES29209555094272945666,TRX_N-00375-88287432,2022-12-01T17:29:27,Vitoria-Gasteiz,incomes,salary_bonus,915.5,-15450.17
buyer_6,Manuel,45,ES29209555094272945666,TRX_N-00376-44131415,2022-12-01T17:29:27,Vitoria-Gasteiz,incomes,salary_partner_bonus,924.0,-14526.17
buyer_6,Manuel,45,ES29209555094272945666,TRX_N-00377-63392498,2022-12-02T09:29:14,Vitoria-Gasteiz,expenses,transport,-73.1,-14599.27
buyer_6,Manuel,45,ES29209555094272945666,TRX_N-00378-29140058,2022-12-02T21:39:51,Vitoria-Gasteiz,expenses,leisure,-80.66,-14679.93
buyer_6,Manuel,45,ES29209555094272945666,TRX_N-00379-07142626,2022-12-03T18:49:50,Vitoria-Gasteiz,expenses,cash,-100.0,-14779.93
buyer_6,Manuel,45,ES29209555094272945666,TRX_N-00380-65943289,2022-12-04T16:12:40,Vitoria-Gasteiz,expenses,mortgage,-925.72,-15705.65
buyer_6,Manuel,45,ES29209555094272945666,TRX_N-00381-87619869,2022-12-05T10:46:22,Vitoria-Gasteiz,expenses,transport,-50.67,-15756.32
buyer_6,Manuel,45,ES29209555094272945666,TRX_N-00382-63830598,2022-12-06T09:01:44,Vitoria-Gasteiz,expenses,gas,-74.14,-15830.46
buyer_6,Manuel,45,ES29209555094272945666,TRX_N-00383-06554198,2022-12-06T15:50:15,Vitoria-Gasteiz,expenses,phone,-33.03,-15863.49
buyer_6,Manuel,45,ES29209555094272945666,TRX_N-00384-62037824,2022-12-06T21:16:14,Vitoria-Gasteiz,expenses,travel,-1441.82,-17305.31
buyer_6,Manuel,45,ES29209555094272945666,TRX_N-00385-73324063,2022-12-07T11:43:43,Vitoria-Gasteiz,expenses,internet,-42.0,-17347.31
buyer_6,Manuel,45,ES29209555094272945666,TRX_N-00386-58827253,2022-12-07T11:06:09,Vitoria-Gasteiz,expenses,leisure,-29.96,-17377.27
buyer_6,Manuel,45,ES29209555094272945666,TRX_N-00387-08347829,2022-12-07T00:28:45,Zuia,expenses,cash,-100.0,-17477.27
buyer_6,Manuel,45,ES29209555094272945666,TRX_N-00388-86789160,2022-12-08T20:31:17,Vitoria-Gasteiz,expenses,water,-32.8,-17510.07
buyer_6,Manuel,45,ES29209555094272945666,TRX_N-00389-32036389,2022-12-08T08:33:01,Vitoria-Gasteiz,expenses,electricity,-85.28,-17595.35
buyer_6,Manuel,45,ES29209555094272945666,TRX_N-00390-52929840,2022-12-08T21:03:54,Vitoria-Gasteiz,expenses,food,-103.38,-17698.73
buyer_6,Manuel,45,ES29209555094272945666,TRX_N-00391-70243819,2022-12-09T12:26:03,Vitoria-Gasteiz,expenses,cash,-100.0,-17798.73
buyer_6,Manuel,45,ES29209555094272945666,TRX_N-00392-45269591,2022-12-10T12:18:34,Vitoria-Gasteiz,expenses,food,-96.35,-17895.08
buyer_6,Manuel,45,ES29209555094272945666,TRX_N-00393-54231804,2022-12-11T08:03:32,Vitoria-Gasteiz,expenses,leisure,-64.99,-17960.07
buyer_6,Manuel,45,ES29209555094272945666,TRX_N-00394-78958130,2022-12-11T10:56:41,Vitoria-Gasteiz,expenses,appliances,-216.16,-18176.23
buyer_6,Manuel,45,ES29209555094272945666,TRX_N-00395-31327360,2022-12-12T10:33:19,Hernani,expenses,cash,-100.0,-18276.23
buyer_6,Manuel,45,ES29209555094272945666,TRX_N-00396-37612240,2022-12-14T13:05:31,Vitoria-Gasteiz,expenses,gifts,-370.85,-18647.08
buyer_6,Manuel,45,ES29209555094272945666,TRX_N-00397-13081603,2022-12-15T10:53:21,Vitoria-Gasteiz,expenses,gifts,-712.4,-19359.48
buyer_6,Manuel,45,ES29209555094272945666,TRX_N-00398-59001774,2022-12-16T14:03:52,Vitoria-Gasteiz,expenses,leisure,-63.72,-19423.2
buyer_6,Manuel,45,ES29209555094272945666,TRX_N-00399-08478205,2022-12-17T14:38:53,Sestao,expenses,cash,-100.0,-19523.2
buyer_6,Manuel,45,ES29209555094272945666,TRX_N-00400-99615382,2022-12-17T08:03:21,Vitoria-Gasteiz,expenses,children,-117.19,-19640.39
buyer_6,Manuel,45,ES29209555094272945666,TRX_N-00401-78072321,2022-12-18T08:27:56,Vitoria-Gasteiz,expenses,cash,-100.0,-19740.39
buyer_6,Manuel,45,ES29209555094272945666,TRX_N-00402-03438725,2022-12-19T23:29:04,Vitoria-Gasteiz,expenses,repairs,-56.4,-19796.79
buyer_6,Manuel,45,ES29209555094272945666,TRX_N-00403-12199568,2022-12-20T20:30:07,Vitoria-Gasteiz,expenses,education,-73.09,-19869.88
buyer_6,Manuel,45,ES29209555094272945666,TRX_N-00404-33987037,2022-12-20T13:19:50,Mungia,expenses,cash,-100.0,-19969.88
buyer_6,Manuel,45,ES29209555094272945666,TRX_N-00405-76173211,2022-12-20T08:40:05,Errenteria,expenses,gifts,-419.45,-20389.33
buyer_6,Manuel,45,ES29209555094272945666,TRX_N-00406-34843736,2022-12-21T10:18:53,Labastida,expenses,leisure,-26.82,-20416.15
buyer_6,Manuel,45,ES29209555094272945666,TRX_N-00407-33791441,2022-12-21T23:24:09,Sopela,expenses,cash,-100.0,-20516.15
buyer_6,Manuel,45,ES29209555094272945666,TRX_N-00408-24727538,2022-12-21T14:03:36,Leioa,expenses,repairs,-136.18,-20652.33
buyer_6,Manuel,45,ES29209555094272945666,TRX_N-00409-49447220,2022-12-22T12:11:28,Lasarte-Oria,expenses,appliances,-251.3,-20903.63
buyer_6,Manuel,45,ES29209555094272945666,TRX_N-00410-20796248,2022-12-22T09:49:25,Vitoria-Gasteiz,expenses,repairs,-259.17,-21162.8
buyer_6,Manuel,45,ES29209555094272945666,TRX_N-00411-82971955,2022-12-23T12:13:31,Vitoria-Gasteiz,expenses,transport,-68.89,-21231.69
buyer_6,Manuel,45,ES29209555094272945666,TRX_N-00412-01593949,2022-12-23T21:42:47,Vitoria-Gasteiz,expenses,appliances,-381.79,-21613.48
buyer_6,Manuel,45,ES29209555094272945666,TRX_N-00413-33460786,2022-12-25T10:04:56,Vitoria-Gasteiz,expenses,food,-68.62,-21682.1
buyer_6,Manuel,45,ES29209555094272945666,TRX_N-00414-70002277,2022-12-25T13:31:49,Vitoria-Gasteiz,expenses,cash,-100.0,-21782.1
buyer_6,Manuel,45,ES29209555094272945666,TRX_N-00415-64107209,2022-12-27T11:45:06,Vitoria-Gasteiz,expenses,cash,-100.0,-21882.1
buyer_6,Manuel,45,ES29209555094272945666,TRX_N-00416-18163526,2022-12-28T13:18:06,Vitoria-Gasteiz,expenses,food,-64.42,-21946.52
buyer_6,Manuel,45,ES29209555094272945666,TRX_N-00417-79425535,2022-12-28T17:58:30,Vitoria-Gasteiz,expenses,leisure,-50.14,-21996.66
buyer_6,Manuel,45,ES29209555094272945666,TRX_N-00418-33522044,2022-12-30T15:00:48,Vitoria-Gasteiz,expenses,transport,-85.49,-22082.15
buyer_6,Manuel,45,ES29209555094272945666,TRX_N-00419-01003588,2022-12-30T20:22:17,Vitoria-Gasteiz,expenses,leisure,-72.04,-22154.19
buyer_6,Manuel,45,ES29209555094272945666,TRX_N-00420-23042408,2023-01-01T18:16:10,Vitoria-Gasteiz,incomes,salary,1332.44,-20821.75
buyer_6,Manuel,45,ES29209555094272945666,TRX_N-00421-68078813,2023-01-01T18:16:10,Vitoria-Gasteiz,incomes,salary_partner,1246.72,-19575.03
buyer_6,Manuel,45,ES29209555094272945666,TRX_N-00422-35536913,2023-01-01T18:25:47,Hernani,expenses,food,-70.63,-19645.66
buyer_6,Manuel,45,ES29209555094272945666,TRX_N-00423-53244520,2023-01-01T12:18:07,Vitoria-Gasteiz,expenses,transport,-68.97,-19714.63
buyer_6,Manuel,45,ES29209555094272945666,TRX_N-00424-06187251,2023-01-02T17:46:36,Vitoria-Gasteiz,expenses,cash,-100.0,-19814.63
buyer_6,Manuel,45,ES29209555094272945666,TRX_N-00425-16014828,2023-01-03T17:02:15,Vitoria-Gasteiz,expenses,cash,-100.0,-19914.63
buyer_6,Manuel,45,ES29209555094272945666,TRX_N-00426-60760241,2023-01-03T16:05:45,Alegría-Dulantzi,expenses,gifts,-821.26,-20735.89
buyer_6,Manuel,45,ES29209555094272945666,TRX_N-00427-83038512,2023-01-04T17:07:36,Vitoria-Gasteiz,expenses,mortgage,-925.72,-21661.61
buyer_6,Manuel,45,ES29209555094272945666,TRX_N-00428-48701619,2023-01-05T02:55:49,Vitoria-Gasteiz,expenses,internet,-42.0,-21703.61
buyer_6,Manuel,45,ES29209555094272945666,TRX_N-00429-52976133,2023-01-05T16:35:34,Vitoria-Gasteiz,expenses,food,-107.81,-21811.42
buyer_6,Manuel,45,ES29209555094272945666,TRX_N-00430-11972353,2023-01-06T21:15:07,Vitoria-Gasteiz,expenses,electricity,-72.98,-21884.4
buyer_6,Manuel,45,ES29209555094272945666,TRX_N-00431-48907063,2023-01-06T11:16:26,Vitoria-Gasteiz,expenses,gas,-112.86,-21997.26
buyer_6,Manuel,45,ES29209555094272945666,TRX_N-00432-29195469,2023-01-06T09:40:40,Vitoria-Gasteiz,expenses,clothing,-156.37,-22153.63
buyer_6,Manuel,45,ES29209555094272945666,TRX_N-00433-22939509,2023-01-06T08:15:45,Vitoria-Gasteiz,expenses,cash,-100.0,-22253.63
buyer_6,Manuel,45,ES29209555094272945666,TRX_N-00434-47783324,2023-01-06T15:02:06,Vitoria-Gasteiz,expenses,children,-140.25,-22393.88
buyer_6,Manuel,45,ES29209555094272945666,TRX_N-00435-46888490,2023-01-07T15:53:31,Vitoria-Gasteiz,expenses,phone,-37.65,-22431.53
buyer_6,Manuel,45,ES29209555094272945666,TRX_N-00436-29740080,2023-01-08T13:35:21,Vitoria-Gasteiz,expenses,water,-42.21,-22473.74
buyer_6,Manuel,45,ES29209555094272945666,TRX_N-00437-38127445,2023-01-08T11:58:27,Vitoria-Gasteiz,expenses,cash,-100.0,-22573.74
buyer_6,Manuel,45,ES29209555094272945666,TRX_N-00438-97798704,2023-01-08T13:08:35,Vitoria-Gasteiz,expenses,repairs,-250.62,-22824.36
buyer_6,Manuel,45,ES29209555094272945666,TRX_N-00439-65399136,2023-01-10T15:43:01,Vitoria-Gasteiz,expenses,repairs,-287.73,-23112.09
buyer_6,Manuel,45,ES29209555094272945666,TRX_N-00440-39703910,2023-01-11T18:43:18,Vitoria-Gasteiz,expenses,cash,-100.0,-23212.09
buyer_6,Manuel,45,ES29209555094272945666,TRX_N-00441-56432593,2023-01-13T08:36:36,Vitoria-Gasteiz,expenses,cash,-100.0,-23312.09
buyer_6,Manuel,45,ES29209555094272945666,TRX_N-00442-81703983,2023-01-15T09:10:56,Vitoria-Gasteiz,expenses,food,-108.99,-23421.08
buyer_6,Manuel,45,ES29209555094272945666,TRX_N-00443-78481126,2023-01-17T18:18:13,Getxo,expenses,transport,-50.03,-23471.11
buyer_6,Manuel,45,ES29209555094272945666,TRX_N-00444-64061438,2023-01-17T11:28:40,Vitoria-Gasteiz,expenses,cash,-100.0,-23571.11
buyer_6,Manuel,45,ES29209555094272945666,TRX_N-00445-55196382,2023-01-18T17:28:22,Vitoria-Gasteiz,expenses,transport,-81.82,-23652.93
buyer_6,Manuel,45,ES29209555094272945666,TRX_N-00446-60193883,2023-01-21T08:53:34,Labastida,expenses,leisure,-38.87,-23691.8
buyer_6,Manuel,45,ES29209555094272945666,TRX_N-00447-66189855,2023-01-21T12:58:57,Vitoria-Gasteiz,expenses,healthcare,-91.33,-23783.13
buyer_6,Manuel,45,ES29209555094272945666,TRX_N-00448-49252164,2023-01-23T10:14:47,Vitoria-Gasteiz,expenses,food,-85.95,-23869.08
buyer_6,Manuel,45,ES29209555094272945666,TRX_N-00449-07430838,2023-01-23T02:56:34,Vitoria-Gasteiz,expenses,cash,-100.0,-23969.08
buyer_6,Manuel,45,ES29209555094272945666,TRX_N-00450-98356770,2023-01-24T14:58:27,Vitoria-Gasteiz,expenses,gifts,-465.12,-24434.2
buyer_6,Manuel,45,ES29209555094272945666,TRX_N-00451-72136545,2023-01-25T16:08:09,Vitoria-Gasteiz,expenses,cash,-100.0,-24534.2
buyer_6,Manuel,45,ES29209555094272945666,TRX_N-00452-59717858,2023-01-26T16:12:53,Vitoria-Gasteiz,expenses,food,-94.2,-24628.4
buyer_6,Manuel,45,ES29209555094272945666,TRX_N-00453-55822834,2023-01-26T10:34:43,Vitoria-Gasteiz,expenses,clothing,-103.79,-24732.19
buyer_6,Manuel,45,ES29209555094272945666,TRX_N-00454-75143857,2023-01-31T23:49:45,Vitoria-Gasteiz,expenses,transport,-55.07,-24787.26
buyer_6,Manuel,45,ES29209555094272945666,TRX_N-00455-52137384,2023-02-01T08:48:57,Vitoria-Gasteiz,incomes,salary,1332.44,-23454.82
buyer_6,Manuel,45,ES29209555094272945666,TRX_N-00456-25702226,2023-02-01T08:48:57,Vitoria-Gasteiz,incomes,salary_partner,1246.72,-22208.1
buyer_6,Manuel,45,ES29209555094272945666,TRX_N-00457-65643990,2023-02-01T08:48:57,Vitoria-Gasteiz,incomes,extra_income,247.42,-21960.68
buyer_6,Manuel,45,ES29209555094272945666,TRX_N-00458-09610546,2023-02-01T17:19:34,Bermeo,expenses,leisure,-61.36,-22022.04
buyer_6,Manuel,45,ES29209555094272945666,TRX_N-00459-87118621,2023-02-01T21:13:21,Vitoria-Gasteiz,expenses,clothing,-150.41,-22172.45
buyer_6,Manuel,45,ES29209555094272945666,TRX_N-00460-97572648,2023-02-03T12:41:32,Vitoria-Gasteiz,expenses,cash,-100.0,-22272.45
buyer_6,Manuel,45,ES29209555094272945666,TRX_N-00461-24984845,2023-02-04T10:42:51,Vitoria-Gasteiz,expenses,mortgage,-925.72,-23198.17
buyer_6,Manuel,45,ES29209555094272945666,TRX_N-00462-05938251,2023-02-04T20:50:29,Vitoria-Gasteiz,expenses,cash,-100.0,-23298.17
buyer_6,Manuel,45,ES29209555094272945666,TRX_N-00463-80141106,2023-02-05T10:42:20,Vitoria-Gasteiz,expenses,food,-89.93,-23388.1
buyer_6,Manuel,45,ES29209555094272945666,TRX_N-00464-70257192,2023-02-05T09:21:46,Vitoria-Gasteiz,expenses,travel,-416.7,-23804.8
buyer_6,Manuel,45,ES29209555094272945666,TRX_N-00465-05436143,2023-02-05T17:45:05,Vitoria-Gasteiz,expenses,children,-263.42,-24068.22
buyer_6,Manuel,45,ES29209555094272945666,TRX_N-00466-97298622,2023-02-06T12:49:51,Vitoria-Gasteiz,expenses,internet,-42.0,-24110.22
buyer_6,Manuel,45,ES29209555094272945666,TRX_N-00467-55963457,2023-02-07T11:49:22,Vitoria-Gasteiz,expenses,electricity,-27.56,-24137.78
buyer_6,Manuel,45,ES29209555094272945666,TRX_N-00468-79756376,2023-02-08T23:31:09,Vitoria-Gasteiz,expenses,water,-43.84,-24181.62
buyer_6,Manuel,45,ES29209555094272945666,TRX_N-00469-87629183,2023-02-08T02:26:36,Vitoria-Gasteiz,expenses,gas,-40.34,-24221.96
buyer_6,Manuel,45,ES29209555094272945666,TRX_N-00470-47384348,2023-02-08T09:38:45,Vitoria-Gasteiz,expenses,phone,-42.78,-24264.74
buyer_6,Manuel,45,ES29209555094272945666,TRX_N-00471-25806572,2023-02-08T14:52:29,Sestao,expenses,food,-98.1,-24362.84
buyer_6,Manuel,45,ES29209555094272945666,TRX_N-00472-43115193,2023-02-08T18:32:04,Vitoria-Gasteiz,expenses,travel,-1679.88,-26042.72
buyer_6,Manuel,45,ES29209555094272945666,TRX_N-00473-53318776,2023-02-09T12:06:04,Vitoria-Gasteiz,expenses,gifts,-277.05,-26319.77
buyer_6,Manuel,45,ES29209555094272945666,TRX_N-00474-52837773,2023-02-09T16:35:07,Vitoria-Gasteiz,expenses,children,-107.05,-26426.82
buyer_6,Manuel,45,ES29209555094272945666,TRX_N-00475-97390512,2023-02-12T11:41:34,Vitoria-Gasteiz,expenses,food,-102.1,-26528.92
buyer_6,Manuel,45,ES29209555094272945666,TRX_N-00476-81901822,2023-02-12T16:30:44,Vitoria-Gasteiz,expenses,children,-164.13,-26693.05
buyer_6,Manuel,45,ES29209555094272945666,TRX_N-00477-69505164,2023-02-15T02:16:01,Vitoria-Gasteiz,expenses,leisure,-48.48,-26741.53
buyer_6,Manuel,45,ES29209555094272945666,TRX_N-00478-66753124,2023-02-16T23:42:35,Vitoria-Gasteiz,expenses,transport,-89.05,-26830.58
buyer_6,Manuel,45,ES29209555094272945666,TRX_N-00479-50274251,2023-02-16T14:38:29,Leioa,expenses,cash,-100.0,-26930.58
buyer_6,Manuel,45,ES29209555094272945666,TRX_N-00480-22696390,2023-02-16T14:34:11,Vitoria-Gasteiz,expenses,appliances,-225.94,-27156.52
buyer_6,Manuel,45,ES29209555094272945666,TRX_N-00481-58460738,2023-02-17T19:06:25,Vitoria-Gasteiz,expenses,repairs,-138.54,-27295.06
buyer_6,Manuel,45,ES29209555094272945666,TRX_N-00482-97780161,2023-02-19T08:58:20,Vitoria-Gasteiz,expenses,repairs,-261.74,-27556.8
buyer_6,Manuel,45,ES29209555094272945666,TRX_N-00483-75358982,2023-02-21T17:21:54,Vitoria-Gasteiz,expenses,food,-106.3,-27663.1
buyer_6,Manuel,45,ES29209555094272945666,TRX_N-00484-16621242,2023-02-21T20:07:55,Vitoria-Gasteiz,expenses,education,-76.53,-27739.63
buyer_6,Manuel,45,ES29209555094272945666,TRX_N-00485-65580303,2023-02-21T16:00:10,Vitoria-Gasteiz,expenses,cash,-100.0,-27839.63
buyer_6,Manuel,45,ES29209555094272945666,TRX_N-00486-61320944,2023-02-22T13:03:29,Vitoria-Gasteiz,expenses,transport,-52.64,-27892.27
buyer_6,Manuel,45,ES29209555094272945666,TRX_N-00487-63451611,2023-02-25T08:58:30,Vitoria-Gasteiz,expenses,food,-85.53,-27977.8
buyer_6,Manuel,45,ES29209555094272945666,TRX_N-00488-55277693,2023-02-25T16:01:54,Vitoria-Gasteiz,expenses,healthcare,-104.37,-28082.17
buyer_6,Manuel,45,ES29209555094272945666,TRX_N-00489-03117757,2023-02-25T15:20:56,Vitoria-Gasteiz,expenses,cash,-100.0,-28182.17
buyer_6,Manuel,45,ES29209555094272945666,TRX_N-00490-95237185,2023-02-25T12:31:24,Vitoria-Gasteiz,expenses,gifts,-357.87,-28540.04
buyer_6,Manuel,45,ES29209555094272945666,TRX_N-00491-08433361,2023-02-27T07:04:26,Vitoria-Gasteiz,expenses,education,-43.9,-28583.94
buyer_6,Manuel,45,ES29209555094272945666,TRX_N-00492-43745882,2023-02-27T17:43:32,Vitoria-Gasteiz,expenses,cash,-100.0,-28683.94
buyer_6,Manuel,45,ES29209555094272945666,TRX_N-00493-07262056,2023-02-28T10:59:28,Vitoria-Gasteiz,expenses,education,-63.7,-28747.64
buyer_6,Manuel,45,ES29209555094272945666,TRX_N-00494-62436783,2023-03-01T09:04:37,Vitoria-Gasteiz,incomes,salary,1332.44,-27415.2
buyer_6,Manuel,45,ES29209555094272945666,TRX_N-00495-03349569,2023-03-01T09:04:37,Vitoria-Gasteiz,incomes,salary_partner,1246.72,-26168.48
buyer_6,Manuel,45,ES29209555094272945666,TRX_N-00496-21536359,2023-03-01T12:37:46,Llodio,expenses,gifts,-731.48,-26899.96
buyer_6,Manuel,45,ES29209555094272945666,TRX_N-00497-84814505,2023-03-03T15:19:07,Vitoria-Gasteiz,expenses,clothing,-141.67,-27041.63
buyer_6,Manuel,45,ES29209555094272945666,TRX_N-00498-37481424,2023-03-03T09:58:40,Vitoria-Gasteiz,expenses,cash,-100.0,-27141.63
buyer_6,Manuel,45,ES29209555094272945666,TRX_N-00499-00899780,2023-03-04T17:38:27,Vitoria-Gasteiz,expenses,mortgage,-925.72,-28067.35
buyer_6,Manuel,45,ES29209555094272945666,TRX_N-00500-05967230,2023-03-04T18:50:54,Vitoria-Gasteiz,expenses,food,-99.04,-28166.39
buyer_6,Manuel,45,ES29209555094272945666,TRX_N-00501-14620464,2023-03-05T08:58:14,Vitoria-Gasteiz,expenses,gas,-45.29,-28211.68
buyer_6,Manuel,45,ES29209555094272945666,TRX_N-00502-61818011,2023-03-05T03:22:13,Leioa,expenses,leisure,-71.31,-28282.99
buyer_6,Manuel,45,ES29209555094272945666,TRX_N-00503-59256379,2023-03-05T05:18:32,Vitoria-Gasteiz,expenses,education,-61.94,-28344.93
buyer_6,Manuel,45,ES29209555094272945666,TRX_N-00504-36044781,2023-03-06T10:48:58,Vitoria-Gasteiz,expenses,internet,-42.0,-28386.93
buyer_6,Manuel,45,ES29209555094272945666,TRX_N-00505-89216954,2023-03-06T17:14:28,Vitoria-Gasteiz,expenses,phone,-37.42,-28424.35
buyer_6,Manuel,45,ES29209555094272945666,TRX_N-00506-37160342,2023-03-06T10:38:51,Vitoria-Gasteiz,expenses,food,-91.49,-28515.84
buyer_6,Manuel,45,ES29209555094272945666,TRX_N-00507-11732494,2023-03-06T17:29:34,Vitoria-Gasteiz,expenses,cash,-100.0,-28615.84
buyer_6,Manuel,45,ES29209555094272945666,TRX_N-00508-44846814,2023-03-06T16:18:11,Vitoria-Gasteiz,expenses,repairs,-320.75,-28936.59
buyer_6,Manuel,45,ES29209555094272945666,TRX_N-00509-60074923,2023-03-07T17:13:32,Vitoria-Gasteiz,expenses,water,-34.4,-28970.99
buyer_6,Manuel,45,ES29209555094272945666,TRX_N-00510-05234081,2023-03-07T19:23:15,Vitoria-Gasteiz,expenses,food,-98.55,-29069.54
buyer_6,Manuel,45,ES29209555094272945666,TRX_N-00511-03089602,2023-03-07T12:54:17,Donostia,expenses,repairs,-316.45,-29385.99
buyer_6,Manuel,45,ES29209555094272945666,TRX_N-00512-36707728,2023-03-08T05:23:01,Vitoria-Gasteiz,expenses,electricity,-63.39,-29449.38
buyer_6,Manuel,45,ES29209555094272945666,TRX_N-00513-13721448,2023-03-09T15:49:56,Bilbao,expenses,food,-61.48,-29510.86
buyer_6,Manuel,45,ES29209555094272945666,TRX_N-00514-70976059,2023-03-09T08:48:32,Vitoria-Gasteiz,expenses,transport,-48.51,-29559.37
buyer_6,Manuel,45,ES29209555094272945666,TRX_N-00515-09201492,2023-03-11T14:51:18,Vitoria-Gasteiz,expenses,education,-70.68,-29630.05
buyer_6,Manuel,45,ES29209555094272945666,TRX_N-00516-29508173,2023-03-12T09:08:03,Vitoria-Gasteiz,expenses,leisure,-80.47,-29710.52
buyer_6,Manuel,45,ES29209555094272945666,TRX_N-00517-61831291,2023-03-12T19:32:26,Vitoria-Gasteiz,expenses,education,-61.47,-29771.99
buyer_6,Manuel,45,ES29209555094272945666,TRX_N-00518-54742448,2023-03-13T15:13:17,Vitoria-Gasteiz,expenses,appliances,-390.87,-30162.86
buyer_6,Manuel,45,ES29209555094272945666,TRX_N-00519-97168017,2023-03-14T16:39:46,Vitoria-Gasteiz,expenses,travel,-1750.97,-31913.83
buyer_6,Manuel,45,ES29209555094272945666,TRX_N-00520-96994873,2023-03-15T00:37:49,Vitoria-Gasteiz,expenses,appliances,-154.49,-32068.32
buyer_6,Manuel,45,ES29209555094272945666,TRX_N-00521-12804404,2023-03-15T18:02:05,Getxo,expenses,repairs,-67.77,-32136.09
buyer_6,Manuel,45,ES29209555094272945666,TRX_N-00522-02965055,2023-03-16T08:01:34,Vitoria-Gasteiz,expenses,appliances,-121.4,-32257.49
buyer_6,Manuel,45,ES29209555094272945666,TRX_N-00523-17500440,2023-03-17T15:10:07,Vitoria-Gasteiz,expenses,gifts,-233.66,-32491.15
buyer_6,Manuel,45,ES29209555094272945666,TRX_N-00524-97120039,2023-03-18T13:53:08,Sestao,expenses,food,-112.08,-32603.23
buyer_6,Manuel,45,ES29209555094272945666,TRX_N-00525-87060338,2023-03-18T08:55:18,Vitoria-Gasteiz,expenses,children,-77.37,-32680.6
buyer_6,Manuel,45,ES29209555094272945666,TRX_N-00526-51088872,2023-03-19T08:47:18,Vitoria-Gasteiz,expenses,gifts,-807.04,-33487.64
buyer_6,Manuel,45,ES29209555094272945666,TRX_N-00527-49069747,2023-03-20T07:34:28,Vitoria-Gasteiz,expenses,food,-85.92,-33573.56
buyer_6,Manuel,45,ES29209555094272945666,TRX_N-00528-27949486,2023-03-21T13:48:54,Vitoria-Gasteiz,expenses,appliances,-137.22,-33710.78
buyer_6,Manuel,45,ES29209555094272945666,TRX_N-00529-95810941,2023-03-21T09:31:31,Vitoria-Gasteiz,expenses,children,-52.91,-33763.69
buyer_6,Manuel,45,ES29209555094272945666,TRX_N-00530-73314563,2023-03-22T15:32:27,Vitoria-Gasteiz,expenses,leisure,-63.37,-33827.06
buyer_6,Manuel,45,ES29209555094272945666,TRX_N-00531-42917001,2023-03-26T18:24:41,Vitoria-Gasteiz,expenses,transport,-74.22,-33901.28
buyer_6,Manuel,45,ES29209555094272945666,TRX_N-00532-84903534,2023-03-26T13:03:41,Sopela,expenses,travel,-1633.79,-35535.07
buyer_6,Manuel,45,ES29209555094272945666,TRX_N-00533-03511153,2023-03-29T20:55:07,Sestao,expenses,gifts,-516.15,-36051.22
buyer_6,Manuel,45,ES29209555094272945666,TRX_N-00534-35165820,2023-03-31T12:47:47,Vitoria-Gasteiz,expenses,transport,-68.29,-36119.51
buyer_6,Manuel,45,ES29209555094272945666,TRX_N-00535-83997401,2023-04-01T16:50:54,Vitoria-Gasteiz,incomes,salary,1332.44,-34787.07
buyer_6,Manuel,45,ES29209555094272945666,TRX_N-00536-66992642,2023-04-01T16:50:54,Vitoria-Gasteiz,incomes,salary_partner,1246.72,-33540.35
buyer_6,Manuel,45,ES29209555094272945666,TRX_N-00537-50441106,2023-04-01T13:27:40,Vitoria-Gasteiz,expenses,clothing,-53.83,-33594.18
buyer_6,Manuel,45,ES29209555094272945666,TRX_N-00538-11577048,2023-04-02T01:36:35,Vitoria-Gasteiz,expenses,food,-70.7,-33664.88
buyer_6,Manuel,45,ES29209555094272945666,TRX_N-00539-35536317,2023-04-03T04:11:25,Vitoria-Gasteiz,expenses,transport,-71.67,-33736.55
buyer_6,Manuel,45,ES29209555094272945666,TRX_N-00540-95547131,2023-04-03T22:57:39,Vitoria-Gasteiz,expenses,leisure,-34.98,-33771.53
buyer_6,Manuel,45,ES29209555094272945666,TRX_N-00541-93301348,2023-04-03T15:51:42,Vitoria-Gasteiz,expenses,repairs,-236.41,-34007.94
buyer_6,Manuel,45,ES29209555094272945666,TRX_N-00542-08382342,2023-04-04T18:25:24,Vitoria-Gasteiz,expenses,mortgage,-925.72,-34933.66
buyer_6,Manuel,45,ES29209555094272945666,TRX_N-00543-13565568,2023-04-04T20:49:11,Vitoria-Gasteiz,expenses,food,-65.25,-34998.91
buyer_6,Manuel,45,ES29209555094272945666,TRX_N-00544-64013742,2023-04-04T09:50:35,Vitoria-Gasteiz,expenses,transport,-79.28,-35078.19
buyer_6,Manuel,45,ES29209555094272945666,TRX_N-00545-10316266,2023-04-04T14:18:13,Vitoria-Gasteiz,expenses,leisure,-84.68,-35162.87
buyer_6,Manuel,45,ES29209555094272945666,TRX_N-00546-91898316,2023-04-05T02:45:17,Vitoria-Gasteiz,expenses,water,-37.12,-35199.99
buyer_6,Manuel,45,ES29209555094272945666,TRX_N-00547-12534752,2023-04-05T16:43:50,Vitoria-Gasteiz,expenses,electricity,-62.34,-35262.33
buyer_6,Manuel,45,ES29209555094272945666,TRX_N-00548-24242936,2023-04-05T13:49:54,Vitoria-Gasteiz,expenses,internet,-42.0,-35304.33
buyer_6,Manuel,45,ES29209555094272945666,TRX_N-00549-11782980,2023-04-08T20:23:08,Vitoria-Gasteiz,expenses,gas,-57.68,-35362.01
buyer_6,Manuel,45,ES29209555094272945666,TRX_N-00550-17898156,2023-04-08T10:17:21,Vitoria-Gasteiz,expenses,phone,-41.96,-35403.97
buyer_6,Manuel,45,ES29209555094272945666,TRX_N-00551-42247591,2023-04-09T09:01:12,Vitoria-Gasteiz,expenses,education,-74.34,-35478.31
buyer_6,Manuel,45,ES29209555094272945666,TRX_N-00552-35012536,2023-04-10T11:34:00,Vitoria-Gasteiz,expenses,gifts,-517.06,-35995.37
buyer_6,Manuel,45,ES29209555094272945666,TRX_N-00553-95276372,2023-04-11T11:05:42,Vitoria-Gasteiz,expenses,transport,-57.35,-36052.72
buyer_6,Manuel,45,ES29209555094272945666,TRX_N-00554-19023409,2023-04-13T11:09:41,Iruña de Oca,expenses,leisure,-52.15,-36104.87
buyer_6,Manuel,45,ES29209555094272945666,TRX_N-00555-87120818,2023-04-14T08:30:08,Vitoria-Gasteiz,expenses,education,-51.41,-36156.28
buyer_6,Manuel,45,ES29209555094272945666,TRX_N-00556-44512788,2023-04-14T16:13:10,Vitoria-Gasteiz,expenses,cash,-100.0,-36256.28
buyer_6,Manuel,45,ES29209555094272945666,TRX_N-00557-53975978,2023-04-15T21:09:49,Vitoria-Gasteiz,expenses,children,-252.74,-36509.02
buyer_6,Manuel,45,ES29209555094272945666,TRX_N-00558-84646889,2023-04-16T11:05:10,Vitoria-Gasteiz,expenses,children,-125.76,-36634.78
buyer_6,Manuel,45,ES29209555094272945666,TRX_N-00559-62152143,2023-04-17T12:43:41,Vitoria-Gasteiz,expenses,transport,-65.33,-36700.11
buyer_6,Manuel,45,ES29209555094272945666,TRX_N-00560-77331101,2023-04-19T16:15:50,Vitoria-Gasteiz,expenses,leisure,-41.79,-36741.9
buyer_6,Manuel,45,ES29209555094272945666,TRX_N-00561-43384236,2023-04-26T08:51:53,Vitoria-Gasteiz,expenses,transport,-81.63,-36823.53
buyer_6,Manuel,45,ES29209555094272945666,TRX_N-00562-70098791,2023-04-28T09:36:37,Vitoria-Gasteiz,expenses,gifts,-802.86,-37626.39
buyer_6,Manuel,45,ES29209555094272945666,TRX_N-00563-44305177,2023-04-28T16:54:26,Vitoria-Gasteiz,expenses,children,-118.06,-37744.45
buyer_6,Manuel,45,ES29209555094272945666,TRX_N-00564-11459444,2023-04-29T12:35:30,Elciego,expenses,cash,-100.0,-37844.45
buyer_6,Manuel,45,ES29209555094272945666,TRX_N-00565-89403895,2023-04-29T12:02:29,Vitoria-Gasteiz,expenses,repairs,-77.86,-37922.31
buyer_6,Manuel,45,ES29209555094272945666,TRX_N-00566-87702683,2023-04-30T08:17:06,Vitoria-Gasteiz,expenses,transport,-80.58,-38002.89
buyer_6,Manuel,45,ES29209555094272945666,TRX_N-00567-53649930,2023-04-30T19:02:36,Bilbao,expenses,cash,-100.0,-38102.89
buyer_6,Manuel,45,ES29209555094272945666,TRX_N-00568-94806178,2023-05-01T17:14:25,Vitoria-Gasteiz,incomes,salary,1332.44,-36770.45
buyer_6,Manuel,45,ES29209555094272945666,TRX_N-00569-63095317,2023-05-01T17:14:25,Vitoria-Gasteiz,incomes,salary_partner,1246.72,-35523.73
buyer_6,Manuel,45,ES29209555094272945666,TRX_N-00570-13154469,2023-05-01T14:47:54,Vitoria-Gasteiz,expenses,food,-62.57,-35586.3
buyer_6,Manuel,45,ES29209555094272945666,TRX_N-00571-70102211,2023-05-01T09:42:01,Vitoria-Gasteiz,expenses,transport,-40.27,-35626.57
buyer_6,Manuel,45,ES29209555094272945666,TRX_N-00572-29932118,2023-05-02T17:27:52,Vitoria-Gasteiz,expenses,cash,-100.0,-35726.57
buyer_6,Manuel,45,ES29209555094272945666,TRX_N-00573-40633652,2023-05-04T20:25:13,Vitoria-Gasteiz,expenses,mortgage,-925.72,-36652.29
buyer_6,Manuel,45,ES29209555094272945666,TRX_N-00574-33968750,2023-05-04T08:48:50,Vitoria-Gasteiz,expenses,food,-65.9,-36718.19
buyer_6,Manuel,45,ES29209555094272945666,TRX_N-00575-00642077,2023-05-05T15:08:06,Vitoria-Gasteiz,expenses,phone,-36.56,-36754.75
buyer_6,Manuel,45,ES29209555094272945666,TRX_N-00576-83786536,2023-05-05T22:22:57,Vitoria-Gasteiz,expenses,leisure,-52.06,-36806.81
buyer_6,Manuel,45,ES29209555094272945666,TRX_N-00577-68670045,2023-05-05T20:59:56,Vitoria-Gasteiz,expenses,cash,-100.0,-36906.81
buyer_6,Manuel,45,ES29209555094272945666,TRX_N-00578-76489945,2023-05-05T01:29:44,Vitoria-Gasteiz,expenses,repairs,-150.73,-37057.54
buyer_6,Manuel,45,ES29209555094272945666,TRX_N-00579-95735960,2023-05-05T17:05:15,Vitoria-Gasteiz,expenses,children,-171.78,-37229.32
buyer_6,Manuel,45,ES29209555094272945666,TRX_N-00580-41556576,2023-05-06T19:28:52,Vitoria-Gasteiz,expenses,water,-20.43,-37249.75
buyer_6,Manuel,45,ES29209555094272945666,TRX_N-00581-82890050,2023-05-06T10:27:27,Vitoria-Gasteiz,expenses,gas,-114.18,-37363.93
buyer_6,Manuel,45,ES29209555094272945666,TRX_N-00582-23033555,2023-05-06T13:58:13,Vitoria-Gasteiz,expenses,transport,-89.44,-37453.37
buyer_6,Manuel,45,ES29209555094272945666,TRX_N-00583-03735795,2023-05-06T22:56:26,Vitoria-Gasteiz,expenses,children,-100.37,-37553.74
buyer_6,Manuel,45,ES29209555094272945666,TRX_N-00584-54288437,2023-05-07T19:45:49,Salvatierra/Agurain,expenses,leisure,-47.31,-37601.05
buyer_6,Manuel,45,ES29209555094272945666,TRX_N-00585-88639056,2023-05-07T15:33:47,Vitoria-Gasteiz,expenses,repairs,-78.46,-37679.51
buyer_6,Manuel,45,ES29209555094272945666,TRX_N-00586-98787802,2023-05-08T17:59:12,Vitoria-Gasteiz,expenses,electricity,-49.96,-37729.47
buyer_6,Manuel,45,ES29209555094272945666,TRX_N-00587-37835440,2023-05-08T20:39:44,Vitoria-Gasteiz,expenses,internet,-42.0,-37771.47
buyer_6,Manuel,45,ES29209555094272945666,TRX_N-00588-58583908,2023-05-09T22:16:03,Basauri,expenses,food,-97.14,-37868.61
buyer_6,Manuel,45,ES29209555094272945666,TRX_N-00589-95381095,2023-05-10T18:00:07,Vitoria-Gasteiz,expenses,food,-98.41,-37967.02
buyer_6,Manuel,45,ES29209555094272945666,TRX_N-00590-16005903,2023-05-10T15:49:42,Vitoria-Gasteiz,expenses,transport,-62.61,-38029.63
buyer_6,Manuel,45,ES29209555094272945666,TRX_N-00591-55610415,2023-05-10T08:07:41,Vitoria-Gasteiz,expenses,appliances,-381.39,-38411.02
buyer_6,Manuel,45,ES29209555094272945666,TRX_N-00592-72736728,2023-05-14T12:23:11,Vitoria-Gasteiz,expenses,cash,-100.0,-38511.02
buyer_6,Manuel,45,ES29209555094272945666,TRX_N-00593-52695090,2023-05-14T15:45:15,Vitoria-Gasteiz,expenses,children,-129.39,-38640.41
buyer_6,Manuel,45,ES29209555094272945666,TRX_N-00594-92443491,2023-05-15T17:31:20,Vitoria-Gasteiz,expenses,food,-119.15,-38759.56
buyer_6,Manuel,45,ES29209555094272945666,TRX_N-00595-18075248,2023-05-17T18:10:17,Vitoria-Gasteiz,expenses,food,-114.21,-38873.77
buyer_6,Manuel,45,ES29209555094272945666,TRX_N-00596-94321993,2023-05-19T13:45:08,Vitoria-Gasteiz,expenses,transport,-71.97,-38945.74
buyer_6,Manuel,45,ES29209555094272945666,TRX_N-00597-91173020,2023-05-19T11:06:53,Vitoria-Gasteiz,expenses,cash,-100.0,-39045.74
buyer_6,Manuel,45,ES29209555094272945666,TRX_N-00598-70578856,2023-05-22T02:07:36,Vitoria-Gasteiz,expenses,food,-104.66,-39150.4
buyer_6,Manuel,45,ES29209555094272945666,TRX_N-00599-00932341,2023-05-24T03:54:22,Barakaldo,expenses,cash,-100.0,-39250.4
buyer_6,Manuel,45,ES29209555094272945666,TRX_N-00600-03939437,2023-05-24T08:17:39,Vitoria-Gasteiz,expenses,appliances,-401.48,-39651.88
buyer_6,Manuel,45,ES29209555094272945666,TRX_N-00601-63537029,2023-05-25T18:21:36,Vitoria-Gasteiz,expenses,food,-95.47,-39747.35
buyer_6,Manuel,45,ES29209555094272945666,TRX_N-00602-17158365,2023-05-25T17:18:20,Vitoria-Gasteiz,expenses,healthcare,-142.55,-39889.9
buyer_6,Manuel,45,ES29209555094272945666,TRX_N-00603-96738000,2023-05-25T08:23:48,Vitoria-Gasteiz,expenses,repairs,-157.68,-40047.58
buyer_6,Manuel,45,ES29209555094272945666,TRX_N-00604-70220506,2023-05-27T21:48:04,Vitoria-Gasteiz,expenses,food,-78.05,-40125.63
buyer_6,Manuel,45,ES29209555094272945666,TRX_N-00605-35951483,2023-05-27T16:38:41,Vitoria-Gasteiz,expenses,transport,-75.47,-40201.1
buyer_6,Manuel,45,ES29209555094272945666,TRX_N-00606-26149068,2023-05-29T10:59:27,Vitoria-Gasteiz,expenses,gifts,-566.55,-40767.65
buyer_6,Manuel,45,ES29209555094272945666,TRX_N-00607-48332826,2023-05-30T03:01:04,Vitoria-Gasteiz,expenses,leisure,-55.73,-40823.38
buyer_6,Manuel,45,ES29209555094272945666,TRX_N-00608-40588934,2023-05-30T10:26:55,Vitoria-Gasteiz,expenses,cash,-100.0,-40923.38
buyer_6,Manuel,45,ES29209555094272945666,TRX_N-00609-76132616,2023-05-31T19:12:54,Vitoria-Gasteiz,expenses,food,-68.21,-40991.59
buyer_6,Manuel,45,ES29209555094272945666,TRX_N-00610-22119394,2023-06-01T23:13:19,Vitoria-Gasteiz,incomes,salary,1332.44,-39659.15
buyer_6,Manuel,45,ES29209555094272945666,TRX_N-00611-23043396,2023-06-01T23:13:19,Vitoria-Gasteiz,incomes,salary_partner,1246.72,-38412.43
buyer_6,Manuel,45,ES29209555094272945666,TRX_N-00612-26350055,2023-06-01T23:13:19,Vitoria-Gasteiz,incomes,extra_income,247.42,-38165.01
buyer_6,Manuel,45,ES29209555094272945666,TRX_N-00613-56654920,2023-06-01T23:13:19,Vitoria-Gasteiz,incomes,salary_bonus,995.6,-37169.41
buyer_6,Manuel,45,ES29209555094272945666,TRX_N-00614-43150473,2023-06-01T23:13:19,Vitoria-Gasteiz,incomes,salary_partner_bonus,927.85,-36241.56
buyer_6,Manuel,45,ES29209555094272945666,TRX_N-00615-36229034,2023-06-02T11:40:24,Oyón-Oion,expenses,repairs,-180.75,-36422.31
buyer_6,Manuel,45,ES29209555094272945666,TRX_N-00616-59374913,2023-06-03T18:06:10,Vitoria-Gasteiz,expenses,appliances,-404.03,-36826.34
buyer_6,Manuel,45,ES29209555094272945666,TRX_N-00617-50637209,2023-06-04T09:36:39,Vitoria-Gasteiz,expenses,mortgage,-925.72,-37752.06
buyer_6,Manuel,45,ES29209555094272945666,TRX_N-00618-51919318,2023-06-05T12:10:03,Vitoria-Gasteiz,expenses,internet,-42.0,-37794.06
buyer_6,Manuel,45,ES29209555094272945666,TRX_N-00619-67653074,2023-06-06T15:18:53,Vitoria-Gasteiz,expenses,electricity,-58.56,-37852.62
buyer_6,Manuel,45,ES29209555094272945666,TRX_N-00620-73208374,2023-06-06T14:05:09,Vitoria-Gasteiz,expenses,phone,-38.27,-37890.89
buyer_6,Manuel,45,ES29209555094272945666,TRX_N-00621-92686654,2023-06-06T11:51:42,Vitoria-Gasteiz,expenses,food,-87.87,-37978.76
buyer_6,Manuel,45,ES29209555094272945666,TRX_N-00622-16162960,2023-06-07T14:21:53,Vitoria-Gasteiz,expenses,food,-94.55,-38073.31
buyer_6,Manuel,45,ES29209555094272945666,TRX_N-00623-70824529,2023-06-07T11:50:39,Vitoria-Gasteiz,expenses,children,-252.87,-38326.18
buyer_6,Manuel,45,ES29209555094272945666,TRX_N-00624-80803079,2023-06-08T15:55:49,Vitoria-Gasteiz,expenses,gas,-57.8,-38383.98
buyer_6,Manuel,45,ES29209555094272945666,TRX_N-00625-47737875,2023-06-08T12:15:21,Vitoria-Gasteiz,expenses,water,-31.24,-38415.22
buyer_6,Manuel,45,ES29209555094272945666,TRX_N-00626-13321384,2023-06-09T16:38:06,Vitoria-Gasteiz,expenses,transport,-40.64,-38455.86
buyer_6,Manuel,45,ES29209555094272945666,TRX_N-00627-66279472,2023-06-12T20:34:05,Vitoria-Gasteiz,expenses,cash,-100.0,-38555.86
buyer_6,Manuel,45,ES29209555094272945666,TRX_N-00628-58308698,2023-06-13T21:34:52,Vitoria-Gasteiz,expenses,repairs,-169.62,-38725.48
buyer_6,Manuel,45,ES29209555094272945666,TRX_N-00629-79696081,2023-06-16T11:08:06,Vitoria-Gasteiz,expenses,healthcare,-147.52,-38873.0
buyer_6,Manuel,45,ES29209555094272945666,TRX_N-00630-24498348,2023-06-16T10:10:47,Vitoria-Gasteiz,expenses,cash,-100.0,-38973.0
buyer_6,Manuel,45,ES29209555094272945666,TRX_N-00631-75098888,2023-06-17T15:04:01,Vitoria-Gasteiz,expenses,transport,-89.55,-39062.55
buyer_6,Manuel,45,ES29209555094272945666,TRX_N-00632-48732667,2023-06-18T02:05:23,Vitoria-Gasteiz,expenses,transport,-75.02,-39137.57
buyer_6,Manuel,45,ES29209555094272945666,TRX_N-00633-27092923,2023-06-18T10:53:16,Vitoria-Gasteiz,expenses,cash,-100.0,-39237.57
buyer_6,Manuel,45,ES29209555094272945666,TRX_N-00634-66858556,2023-06-19T07:28:28,Vitoria-Gasteiz,expenses,leisure,-80.82,-39318.39
buyer_6,Manuel,45,ES29209555094272945666,TRX_N-00635-00293899,2023-06-21T12:58:10,Vitoria-Gasteiz,expenses,food,-121.93,-39440.32
buyer_6,Manuel,45,ES29209555094272945666,TRX_N-00636-76349190,2023-06-21T10:43:04,Vitoria-Gasteiz,expenses,transport,-69.61,-39509.93
buyer_6,Manuel,45,ES29209555094272945666,TRX_N-00637-55792539,2023-06-21T09:22:34,Vitoria-Gasteiz,expenses,healthcare,-189.5,-39699.43
buyer_6,Manuel,45,ES29209555094272945666,TRX_N-00638-07067559,2023-06-22T13:17:16,Vitoria-Gasteiz,expenses,healthcare,-67.09,-39766.52
buyer_6,Manuel,45,ES29209555094272945666,TRX_N-00639-33625322,2023-06-24T18:03:58,Vitoria-Gasteiz,expenses,cash,-100.0,-39866.52
buyer_6,Manuel,45,ES29209555094272945666,TRX_N-00640-51544170,2023-06-24T15:21:20,Vitoria-Gasteiz,expenses,children,-71.59,-39938.11
buyer_6,Manuel,45,ES29209555094272945666,TRX_N-00641-15232060,2023-06-25T04:26:57,Vitoria-Gasteiz,expenses,cash,-100.0,-40038.11
buyer_6,Manuel,45,ES29209555094272945666,TRX_N-00642-67492453,2023-06-26T07:51:53,Vitoria-Gasteiz,expenses,food,-123.2,-40161.31
buyer_6,Manuel,45,ES29209555094272945666,TRX_N-00643-78008048,2023-06-27T16:16:14,Vitoria-Gasteiz,expenses,healthcare,-173.75,-40335.06
buyer_6,Manuel,45,ES29209555094272945666,TRX_N-00644-35647519,2023-06-27T11:31:54,Vitoria-Gasteiz,expenses,education,-71.95,-40407.01
buyer_6,Manuel,45,ES29209555094272945666,TRX_N-00645-35417157,2023-06-29T12:13:09,Vitoria-Gasteiz,expenses,leisure,-43.48,-40450.49
buyer_6,Manuel,45,ES29209555094272945666,TRX_N-00646-39208892,2023-06-29T15:44:26,Vitoria-Gasteiz,expenses,healthcare,-39.07,-40489.56
buyer_6,Manuel,45,ES29209555094272945666,TRX_N-00647-09041894,2023-07-01T14:46:41,Vitoria-Gasteiz,incomes,salary,1332.44,-39157.12
buyer_6,Manuel,45,ES29209555094272945666,TRX_N-00648-24968150,2023-07-01T14:46:41,Vitoria-Gasteiz,incomes,salary_partner,1246.72,-37910.4
buyer_6,Manuel,45,ES29209555094272945666,TRX_N-00649-09197806,2023-07-02T01:29:09,Vitoria-Gasteiz,expenses,cash,-100.0,-38010.4
buyer_6,Manuel,45,ES29209555094272945666,TRX_N-00650-61682759,2023-07-02T14:38:19,Vitoria-Gasteiz,expenses,appliances,-90.06,-38100.46
buyer_6,Manuel,45,ES29209555094272945666,TRX_N-00651-89928623,2023-07-03T09:42:49,Vitoria-Gasteiz,expenses,cash,-100.0,-38200.46
buyer_6,Manuel,45,ES29209555094272945666,TRX_N-00652-30821006,2023-07-04T09:39:04,Vitoria-Gasteiz,expenses,mortgage,-925.72,-39126.18
buyer_6,Manuel,45,ES29209555094272945666,TRX_N-00653-41538908,2023-07-04T19:49:11,Vitoria-Gasteiz,expenses,food,-122.33,-39248.51
buyer_6,Manuel,45,ES29209555094272945666,TRX_N-00654-17545727,2023-07-04T15:41:22,Vitoria-Gasteiz,expenses,transport,-76.8,-39325.31
buyer_6,Manuel,45,ES29209555094272945666,TRX_N-00655-18236634,2023-07-04T20:52:12,Vitoria-Gasteiz,expenses,gifts,-424.88,-39750.19
buyer_6,Manuel,45,ES29209555094272945666,TRX_N-00656-74867443,2023-07-05T14:29:25,Vitoria-Gasteiz,expenses,gas,-41.99,-39792.18
buyer_6,Manuel,45,ES29209555094272945666,TRX_N-00657-49648967,2023-07-05T18:00:13,Vitoria-Gasteiz,expenses,internet,-42.0,-39834.18
buyer_6,Manuel,45,ES29209555094272945666,TRX_N-00658-18563128,2023-07-05T11:16:44,Vitoria-Gasteiz,expenses,food,-103.98,-39938.16
buyer_6,Manuel,45,ES29209555094272945666,TRX_N-00659-60322162,2023-07-06T12:50:55,Vitoria-Gasteiz,expenses,electricity,-48.02,-39986.18
buyer_6,Manuel,45,ES29209555094272945666,TRX_N-00660-48553736,2023-07-06T10:25:46,Vitoria-Gasteiz,expenses,phone,-39.68,-40025.86
buyer_6,Manuel,45,ES29209555094272945666,TRX_N-00661-78338885,2023-07-06T13:29:16,Irun,expenses,clothing,-135.7,-40161.56
buyer_6,Manuel,45,ES29209555094272945666,TRX_N-00662-74872698,2023-07-06T21:45:50,Vitoria-Gasteiz,expenses,cash,-100.0,-40261.56
buyer_6,Manuel,45,ES29209555094272945666,TRX_N-00663-30235179,2023-07-07T14:33:48,Vitoria-Gasteiz,expenses,healthcare,-71.08,-40332.64
buyer_6,Manuel,45,ES29209555094272945666,TRX_N-00664-94178696,2023-07-08T20:40:01,Vitoria-Gasteiz,expenses,water,-43.54,-40376.18
buyer_6,Manuel,45,ES29209555094272945666,TRX_N-00665-62760374,2023-07-08T17:49:39,Vitoria-Gasteiz,expenses,leisure,-32.79,-40408.97
buyer_6,Manuel,45,ES29209555094272945666,TRX_N-00666-27534775,2023-07-08T17:57:51,Vitoria-Gasteiz,expenses,children,-262.96,-40671.93
buyer_6,Manuel,45,ES29209555094272945666,TRX_N-00667-37171703,2023-07-09T12:23:05,Vitoria-Gasteiz,expenses,food,-65.94,-40737.87
buyer_6,Manuel,45,ES29209555094272945666,TRX_N-00668-07666025,2023-07-10T22:01:01,Vitoria-Gasteiz,expenses,cash,-100.0,-40837.87
buyer_6,Manuel,45,ES29209555094272945666,TRX_N-00669-46826827,2023-07-11T10:39:04,Portugalete,expenses,food,-97.08,-40934.95
buyer_6,Manuel,45,ES29209555094272945666,TRX_N-00670-39985593,2023-07-12T13:16:18,Vitoria-Gasteiz,expenses,appliances,-400.3,-41335.25
buyer_6,Manuel,45,ES29209555094272945666,TRX_N-00671-20802776,2023-07-15T14:54:39,Iruña de Oca,expenses,transport,-80.85,-41416.1
buyer_6,Manuel,45,ES29209555094272945666,TRX_N-00672-66019736,2023-07-23T14:51:57,Vitoria-Gasteiz,expenses,food,-64.21,-41480.31
buyer_6,Manuel,45,ES29209555094272945666,TRX_N-00673-44545166,2023-07-26T10:52:13,Vitoria-Gasteiz,expenses,cash,-100.0,-41580.31
buyer_6,Manuel,45,ES29209555094272945666,TRX_N-00674-80912534,2023-07-27T08:41:29,Vitoria-Gasteiz,expenses,leisure,-37.99,-41618.3
buyer_6,Manuel,45,ES29209555094272945666,TRX_N-00675-22109175,2023-07-30T15:31:40,Vitoria-Gasteiz,expenses,leisure,-48.88,-41667.18
buyer_6,Manuel,45,ES29209555094272945666,TRX_N-00676-99297857,2023-07-30T10:22:30,Vitoria-Gasteiz,expenses,cash,-100.0,-41767.18
buyer_6,Manuel,45,ES29209555094272945666,TRX_N-00677-30609529,2023-07-31T22:06:08,Vitoria-Gasteiz,expenses,transport,-48.51,-41815.69
buyer_6,Manuel,45,ES29209555094272945666,TRX_N-00678-26358453,2023-08-01T03:56:18,Vitoria-Gasteiz,incomes,salary,1332.44,-40483.25
buyer_6,Manuel,45,ES29209555094272945666,TRX_N-00679-51240589,2023-08-01T03:56:18,Vitoria-Gasteiz,incomes,salary_partner,1246.72,-39236.53
buyer_6,Manuel,45,ES29209555094272945666,TRX_N-00680-82922203,2023-08-01T17:34:46,Vitoria-Gasteiz,expenses,cash,-100.0,-39336.53
buyer_6,Manuel,45,ES29209555094272945666,TRX_N-00681-91703303,2023-08-03T12:54:44,Donostia,expenses,clothing,-54.31,-39390.84
buyer_6,Manuel,45,ES29209555094272945666,TRX_N-00682-96642415,2023-08-04T10:30:34,Vitoria-Gasteiz,expenses,mortgage,-925.72,-40316.56
buyer_6,Manuel,45,ES29209555094272945666,TRX_N-00683-75131839,2023-08-06T19:49:37,Vitoria-Gasteiz,expenses,electricity,-38.3,-40354.86
buyer_6,Manuel,45,ES29209555094272945666,TRX_N-00684-10412051,2023-08-06T22:42:29,Vitoria-Gasteiz,expenses,children,-273.96,-40628.82
buyer_6,Manuel,45,ES29209555094272945666,TRX_N-00685-45543290,2023-08-07T16:05:53,Vitoria-Gasteiz,expenses,water,-23.83,-40652.65
buyer_6,Manuel,45,ES29209555094272945666,TRX_N-00686-51261081,2023-08-07T20:35:53,Vitoria-Gasteiz,expenses,phone,-40.47,-40693.12
buyer_6,Manuel,45,ES29209555094272945666,TRX_N-00687-87879992,2023-08-08T16:00:23,Vitoria-Gasteiz,expenses,gas,-85.48,-40778.6
buyer_6,Manuel,45,ES29209555094272945666,TRX_N-00688-38968098,2023-08-08T11:29:09,Vitoria-Gasteiz,expenses,internet,-42.0,-40820.6
buyer_6,Manuel,45,ES29209555094272945666,TRX_N-00689-15983406,2023-08-08T00:45:59,Vitoria-Gasteiz,expenses,cash,-100.0,-40920.6
buyer_6,Manuel,45,ES29209555094272945666,TRX_N-00690-50938719,2023-08-08T03:11:42,Vitoria-Gasteiz,expenses,repairs,-179.66,-41100.26
buyer_6,Manuel,45,ES29209555094272945666,TRX_N-00691-73551414,2023-08-10T09:32:24,Vitoria-Gasteiz,expenses,transport,-87.1,-41187.36
buyer_6,Manuel,45,ES29209555094272945666,TRX_N-00692-25426710,2023-08-10T23:09:46,Vitoria-Gasteiz,expenses,cash,-100.0,-41287.36
buyer_6,Manuel,45,ES29209555094272945666,TRX_N-00693-53093547,2023-08-11T16:10:02,Elciego,expenses,food,-124.55,-41411.91
buyer_6,Manuel,45,ES29209555094272945666,TRX_N-00694-20000710,2023-08-11T16:53:53,Vitoria-Gasteiz,expenses,leisure,-32.14,-41444.05
buyer_6,Manuel,45,ES29209555094272945666,TRX_N-00695-82836176,2023-08-12T11:08:50,Elciego,expenses,repairs,-255.42,-41699.47
buyer_6,Manuel,45,ES29209555094272945666,TRX_N-00696-08451797,2023-08-13T18:02:12,Vitoria-Gasteiz,expenses,cash,-100.0,-41799.47
buyer_6,Manuel,45,ES29209555094272945666,TRX_N-00697-16401074,2023-08-14T13:28:44,Vitoria-Gasteiz,expenses,food,-102.59,-41902.06
buyer_6,Manuel,45,ES29209555094272945666,TRX_N-00698-51797612,2023-08-14T20:54:40,Vitoria-Gasteiz,expenses,cash,-100.0,-42002.06
buyer_6,Manuel,45,ES29209555094272945666,TRX_N-00699-23118245,2023-08-16T12:57:47,Vitoria-Gasteiz,expenses,transport,-87.54,-42089.6
buyer_6,Manuel,45,ES29209555094272945666,TRX_N-00700-27360613,2023-08-18T01:18:27,Vitoria-Gasteiz,expenses,clothing,-97.27,-42186.87
buyer_6,Manuel,45,ES29209555094272945666,TRX_N-00701-26430891,2023-08-21T17:12:01,Vitoria-Gasteiz,expenses,transport,-78.17,-42265.04
buyer_6,Manuel,45,ES29209555094272945666,TRX_N-00702-50347473,2023-08-24T20:59:11,Vitoria-Gasteiz,expenses,cash,-100.0,-42365.04
buyer_6,Manuel,45,ES29209555094272945666,TRX_N-00703-34249804,2023-08-27T07:23:10,Vitoria-Gasteiz,expenses,leisure,-36.81,-42401.85
buyer_6,Manuel,45,ES29209555094272945666,TRX_N-00704-61959497,2023-08-28T17:53:27,Vitoria-Gasteiz,expenses,transport,-65.69,-42467.54
buyer_6,Manuel,45,ES29209555094272945666,TRX_N-00705-52528304,2023-08-28T19:47:56,Vitoria-Gasteiz,expenses,cash,-100.0,-42567.54
buyer_6,Manuel,45,ES29209555094272945666,TRX_N-00706-08199677,2023-08-29T23:39:50,Vitoria-Gasteiz,expenses,food,-109.28,-42676.82
buyer_6,Manuel,45,ES29209555094272945666,TRX_N-00707-32442450,2023-08-31T08:12:57,Vitoria-Gasteiz,expenses,transport,-84.49,-42761.31
buyer_6,Manuel,45,ES29209555094272945666,TRX_N-00708-30193847,2023-08-31T08:39:47,Vitoria-Gasteiz,expenses,clothing,-121.71,-42883.02
buyer_6,Manuel,45,ES29209555094272945666,TRX_N-00709-48275441,2023-08-31T08:05:07,Vitoria-Gasteiz,expenses,cash,-100.0,-42983.02
buyer_6,Manuel,45,ES29209555094272945666,TRX_N-00710-17338408,2023-09-01T09:53:27,Vitoria-Gasteiz,incomes,salary,1332.44,-41650.58
buyer_6,Manuel,45,ES29209555094272945666,TRX_N-00711-73512802,2023-09-01T09:53:27,Vitoria-Gasteiz,incomes,salary_partner,1246.72,-40403.86
buyer_6,Manuel,45,ES29209555094272945666,TRX_N-00712-99627198,2023-09-02T17:45:00,Vitoria-Gasteiz,expenses,cash,-100.0,-40503.86
buyer_6,Manuel,45,ES29209555094272945666,TRX_N-00713-15703423,2023-09-03T16:17:18,Hernani,expenses,cash,-100.0,-40603.86
buyer_6,Manuel,45,ES29209555094272945666,TRX_N-00714-42481433,2023-09-03T06:07:39,Vitoria-Gasteiz,expenses,gifts,-355.1,-40958.96
buyer_6,Manuel,45,ES29209555094272945666,TRX_N-00715-90040013,2023-09-04T10:03:51,Vitoria-Gasteiz,expenses,mortgage,-925.72,-41884.68
buyer_6,Manuel,45,ES29209555094272945666,TRX_N-00716-97983276,2023-09-04T14:55:38,Vitoria-Gasteiz,expenses,food,-117.35,-42002.03
buyer_6,Manuel,45,ES29209555094272945666,TRX_N-00717-84842410,2023-09-05T21:49:50,Vitoria-Gasteiz,expenses,electricity,-34.86,-42036.89
buyer_6,Manuel,45,ES29209555094272945666,TRX_N-00718-46315839,2023-09-05T18:12:00,Vitoria-Gasteiz,expenses,phone,-43.23,-42080.12
buyer_6,Manuel,45,ES29209555094272945666,TRX_N-00719-49443771,2023-09-05T11:04:58,Vitoria-Gasteiz,expenses,leisure,-51.93,-42132.05
buyer_6,Manuel,45,ES29209555094272945666,TRX_N-00720-36298515,2023-09-05T10:06:39,Vitoria-Gasteiz,expenses,cash,-100.0,-42232.05
buyer_6,Manuel,45,ES29209555094272945666,TRX_N-00721-99931625,2023-09-06T16:21:38,Vitoria-Gasteiz,expenses,transport,-58.23,-42290.28
buyer_6,Manuel,45,ES29209555094272945666,TRX_N-00722-62285796,2023-09-07T13:32:54,Vitoria-Gasteiz,expenses,food,-85.1,-42375.38
buyer_6,Manuel,45,ES29209555094272945666,TRX_N-00723-33432643,2023-09-08T06:15:21,Vitoria-Gasteiz,expenses,water,-20.55,-42395.93
buyer_6,Manuel,45,ES29209555094272945666,TRX_N-00724-84568354,2023-09-08T12:50:12,Vitoria-Gasteiz,expenses,gas,-82.91,-42478.84
buyer_6,Manuel,45,ES29209555094272945666,TRX_N-00725-98676939,2023-09-08T18:17:35,Vitoria-Gasteiz,expenses,internet,-42.0,-42520.84
buyer_6,Manuel,45,ES29209555094272945666,TRX_N-00726-72923580,2023-09-08T02:00:14,Vitoria-Gasteiz,expenses,food,-74.29,-42595.13
buyer_6,Manuel,45,ES29209555094272945666,TRX_N-00727-99976279,2023-09-11T20:30:47,Vitoria-Gasteiz,expenses,transport,-56.26,-42651.39
buyer_6,Manuel,45,ES29209555094272945666,TRX_N-00728-29848326,2023-09-11T16:19:12,Vitoria-Gasteiz,expenses,healthcare,-148.64,-42800.03
buyer_6,Manuel,45,ES29209555094272945666,TRX_N-00729-21623690,2023-09-11T12:40:06,Berango,expenses,travel,-1299.18,-44099.21
buyer_6,Manuel,45,ES29209555094272945666,TRX_N-00730-12714730,2023-09-12T12:24:20,Vitoria-Gasteiz,expenses,travel,-1168.47,-45267.68
buyer_6,Manuel,45,ES29209555094272945666,TRX_N-00731-97445527,2023-09-15T14:54:07,Vitoria-Gasteiz,expenses,gifts,-762.75,-46030.43
buyer_6,Manuel,45,ES29209555094272945666,TRX_N-00732-59072841,2023-09-16T13:01:02,Vitoria-Gasteiz,expenses,cash,-100.0,-46130.43
buyer_6,Manuel,45,ES29209555094272945666,TRX_N-00733-54383628,2023-09-18T18:14:13,Vitoria-Gasteiz,expenses,cash,-100.0,-46230.43
buyer_6,Manuel,45,ES29209555094272945666,TRX_N-00734-56485240,2023-09-18T20:14:28,Vitoria-Gasteiz,expenses,gifts,-696.29,-46926.72
buyer_6,Manuel,45,ES29209555094272945666,TRX_N-00735-86527355,2023-09-20T11:12:43,Vitoria-Gasteiz,expenses,transport,-88.19,-47014.91
buyer_6,Manuel,45,ES29209555094272945666,TRX_N-00736-67688563,2023-09-21T21:46:58,Vitoria-Gasteiz,expenses,food,-75.42,-47090.33
buyer_6,Manuel,45,ES29209555094272945666,TRX_N-00737-04394456,2023-09-23T20:34:18,Vitoria-Gasteiz,expenses,transport,-63.35,-47153.68
buyer_6,Manuel,45,ES29209555094272945666,TRX_N-00738-34108504,2023-09-24T03:20:01,Vitoria-Gasteiz,expenses,transport,-88.53,-47242.21
buyer_6,Manuel,45,ES29209555094272945666,TRX_N-00739-75408344,2023-09-27T10:54:23,Vitoria-Gasteiz,expenses,healthcare,-124.88,-47367.09
buyer_6,Manuel,45,ES29209555094272945666,TRX_N-00740-26817855,2023-09-27T08:28:21,Vitoria-Gasteiz,expenses,education,-70.21,-47437.3
buyer_6,Manuel,45,ES29209555094272945666,TRX_N-00741-46538986,2023-09-28T15:44:05,Vitoria-Gasteiz,expenses,clothing,-114.56,-47551.86
buyer_6,Manuel,45,ES29209555094272945666,TRX_N-00742-81371479,2023-09-29T12:05:18,Vitoria-Gasteiz,expenses,cash,-100.0,-47651.86
buyer_6,Manuel,45,ES29209555094272945666,TRX_N-00743-75813100,2023-10-01T10:17:22,Vitoria-Gasteiz,incomes,salary,1332.44,-46319.42
buyer_6,Manuel,45,ES29209555094272945666,TRX_N-00744-07824028,2023-10-01T10:17:22,Vitoria-Gasteiz,incomes,salary_partner,1246.72,-45072.7
buyer_6,Manuel,45,ES29209555094272945666,TRX_N-00745-47195753,2023-10-01T10:17:22,Vitoria-Gasteiz,incomes,extra_income,247.42,-44825.28
buyer_6,Manuel,45,ES29209555094272945666,TRX_N-00746-66569627,2023-10-01T05:29:57,Vitoria-Gasteiz,expenses,gifts,-228.78,-45054.06
buyer_6,Manuel,45,ES29209555094272945666,TRX_N-00747-07708287,2023-10-04T12:26:54,Vitoria-Gasteiz,expenses,mortgage,-925.72,-45979.78
buyer_6,Manuel,45,ES29209555094272945666,TRX_N-00748-55099515,2023-10-04T19:07:49,Vitoria-Gasteiz,expenses,food,-98.03,-46077.81
buyer_6,Manuel,45,ES29209555094272945666,TRX_N-00749-61013562,2023-10-05T17:15:23,Vitoria-Gasteiz,expenses,water,-24.76,-46102.57
buyer_6,Manuel,45,ES29209555094272945666,TRX_N-00750-99349355,2023-10-05T16:23:21,Vitoria-Gasteiz,expenses,food,-77.72,-46180.29
buyer_6,Manuel,45,ES29209555094272945666,TRX_N-00751-70974016,2023-10-05T11:04:57,Vitoria-Gasteiz,expenses,cash,-100.0,-46280.29
buyer_6,Manuel,45,ES29209555094272945666,TRX_N-00752-52502807,2023-10-06T17:08:32,Vitoria-Gasteiz,expenses,internet,-42.0,-46322.29
buyer_6,Manuel,45,ES29209555094272945666,TRX_N-00753-65117229,2023-10-06T09:23:38,Basauri,expenses,leisure,-74.95,-46397.24
buyer_6,Manuel,45,ES29209555094272945666,TRX_N-00754-33826746,2023-10-07T20:17:55,Vitoria-Gasteiz,expenses,phone,-32.76,-46430.0
buyer_6,Manuel,45,ES29209555094272945666,TRX_N-00755-35500904,2023-10-07T13:47:14,Vitoria-Gasteiz,expenses,repairs,-299.05,-46729.05
buyer_6,Manuel,45,ES29209555094272945666,TRX_N-00756-55211533,2023-10-08T13:11:06,Vitoria-Gasteiz,expenses,electricity,-51.55,-46780.6
buyer_6,Manuel,45,ES29209555094272945666,TRX_N-00757-82846880,2023-10-08T13:06:42,Vitoria-Gasteiz,expenses,gas,-48.26,-46828.86
buyer_6,Manuel,45,ES29209555094272945666,TRX_N-00758-59713026,2023-10-08T21:34:23,Vitoria-Gasteiz,expenses,cash,-100.0,-46928.86
buyer_6,Manuel,45,ES29209555094272945666,TRX_N-00759-31404968,2023-10-10T11:11:51,Iruña de Oca,expenses,cash,-100.0,-47028.86
buyer_6,Manuel,45,ES29209555094272945666,TRX_N-00760-54147344,2023-10-11T10:41:53,Vitoria-Gasteiz,expenses,transport,-55.73,-47084.59
buyer_6,Manuel,45,ES29209555094272945666,TRX_N-00761-81562551,2023-10-15T05:05:29,Vitoria-Gasteiz,expenses,food,-107.44,-47192.03
buyer_6,Manuel,45,ES29209555094272945666,TRX_N-00762-95790472,2023-10-16T15:31:14,Vitoria-Gasteiz,expenses,clothing,-154.82,-47346.85
buyer_6,Manuel,45,ES29209555094272945666,TRX_N-00763-78079239,2023-10-17T15:49:12,Vitoria-Gasteiz,expenses,cash,-100.0,-47446.85
buyer_6,Manuel,45,ES29209555094272945666,TRX_N-00764-27160237,2023-10-19T10:53:43,Vitoria-Gasteiz,expenses,cash,-100.0,-47546.85
buyer_6,Manuel,45,ES29209555094272945666,TRX_N-00765-76978730,2023-10-19T11:01:40,Vitoria-Gasteiz,expenses,repairs,-208.27,-47755.12
buyer_6,Manuel,45,ES29209555094272945666,TRX_N-00766-54729403,2023-10-20T15:36:19,Vitoria-Gasteiz,expenses,food,-81.39,-47836.51
buyer_6,Manuel,45,ES29209555094272945666,TRX_N-00767-01032976,2023-10-20T10:10:05,Arrasate,expenses,cash,-100.0,-47936.51
buyer_6,Manuel,45,ES29209555094272945666,TRX_N-00768-05941511,2023-10-21T17:41:16,Vitoria-Gasteiz,expenses,leisure,-29.38,-47965.89
buyer_6,Manuel,45,ES29209555094272945666,TRX_N-00769-90646472,2023-10-21T20:34:41,Vitoria-Gasteiz,expenses,cash,-100.0,-48065.89
buyer_6,Manuel,45,ES29209555094272945666,TRX_N-00770-31746231,2023-10-21T01:52:39,Vitoria-Gasteiz,expenses,repairs,-29.12,-48095.01
buyer_6,Manuel,45,ES29209555094272945666,TRX_N-00771-45532580,2023-10-22T13:46:34,Vitoria-Gasteiz,expenses,transport,-47.6,-48142.61
buyer_6,Manuel,45,ES29209555094272945666,TRX_N-00772-41622972,2023-10-22T08:35:59,Vitoria-Gasteiz,expenses,repairs,-110.82,-48253.43
buyer_6,Manuel,45,ES29209555094272945666,TRX_N-00773-63099564,2023-10-23T16:53:18,Llodio,expenses,food,-75.62,-48329.05
buyer_6,Manuel,45,ES29209555094272945666,TRX_N-00774-02647375,2023-10-25T14:41:03,Vitoria-Gasteiz,expenses,repairs,-151.3,-48480.35
buyer_6,Manuel,45,ES29209555094272945666,TRX_N-00775-95542285,2023-10-26T00:09:50,Vitoria-Gasteiz,expenses,leisure,-58.83,-48539.18
buyer_6,Manuel,45,ES29209555094272945666,TRX_N-00776-46867157,2023-10-28T15:19:50,Vitoria-Gasteiz,expenses,repairs,-291.58,-48830.76
buyer_6,Manuel,45,ES29209555094272945666,TRX_N-00777-31009200,2023-10-29T20:19:50,Galdakao,expenses,transport,-87.98,-48918.74
buyer_6,Manuel,45,ES29209555094272945666,TRX_N-00778-69952843,2023-10-30T19:09:45,Vitoria-Gasteiz,expenses,children,-220.39,-49139.13
buyer_6,Manuel,45,ES29209555094272945666,TRX_N-00779-92558308,2023-10-31T19:33:19,Vitoria-Gasteiz,expenses,transport,-46.69,-49185.82
buyer_6,Manuel,45,ES29209555094272945666,TRX_N-00780-66068218,2023-11-01T13:43:51,Vitoria-Gasteiz,incomes,salary,1332.44,-47853.38
buyer_6,Manuel,45,ES29209555094272945666,TRX_N-00781-06963220,2023-11-01T13:43:51,Vitoria-Gasteiz,incomes,salary_partner,1246.72,-46606.66
buyer_6,Manuel,45,ES29209555094272945666,TRX_N-00782-35829933,2023-11-01T18:39:32,Vitoria-Gasteiz,expenses,children,-133.04,-46739.7
buyer_6,Manuel,45,ES29209555094272945666,TRX_N-00783-59932755,2023-11-02T11:09:03,Hondarribia,expenses,clothing,-107.72,-46847.42
buyer_6,Manuel,45,ES29209555094272945666,TRX_N-00784-08299004,2023-11-03T12:47:23,Vitoria-Gasteiz,expenses,repairs,-223.98,-47071.4
buyer_6,Manuel,45,ES29209555094272945666,TRX_N-00785-56147435,2023-11-03T12:54:06,Eibar,expenses,gifts,-475.13,-47546.53
buyer_6,Manuel,45,ES29209555094272945666,TRX_N-00786-38515153,2023-11-04T03:43:37,Vitoria-Gasteiz,expenses,mortgage,-925.72,-48472.25
buyer_6,Manuel,45,ES29209555094272945666,TRX_N-00787-00198332,2023-11-05T07:25:06,Vitoria-Gasteiz,expenses,water,-22.48,-48494.73
buyer_6,Manuel,45,ES29209555094272945666,TRX_N-00788-84263454,2023-11-05T19:31:07,Vitoria-Gasteiz,expenses,leisure,-33.17,-48527.9
buyer_6,Manuel,45,ES29209555094272945666,TRX_N-00789-81823120,2023-11-06T12:50:01,Vitoria-Gasteiz,expenses,phone,-36.06,-48563.96
buyer_6,Manuel,45,ES29209555094272945666,TRX_N-00790-09968902,2023-11-06T21:30:47,Vitoria-Gasteiz,expenses,transport,-54.76,-48618.72
buyer_6,Manuel,45,ES29209555094272945666,TRX_N-00791-33124459,2023-11-06T09:29:36,Vitoria-Gasteiz,expenses,leisure,-72.13,-48690.85
buyer_6,Manuel,45,ES29209555094272945666,TRX_N-00792-16155989,2023-11-06T14:36:57,Mungia,expenses,cash,-100.0,-48790.85
buyer_6,Manuel,45,ES29209555094272945666,TRX_N-00793-66548910,2023-11-06T19:56:35,Vitoria-Gasteiz,expenses,gifts,-638.13,-49428.98
buyer_6,Manuel,45,ES29209555094272945666,TRX_N-00794-87805866,2023-11-07T05:06:46,Vitoria-Gasteiz,expenses,internet,-42.0,-49470.98
buyer_6,Manuel,45,ES29209555094272945666,TRX_N-00795-01667993,2023-11-08T21:02:38,Vitoria-Gasteiz,expenses,electricity,-71.73,-49542.71
buyer_6,Manuel,45,ES29209555094272945666,TRX_N-00796-50185600,2023-11-08T09:26:01,Vitoria-Gasteiz,expenses,gas,-93.47,-49636.18
buyer_6,Manuel,45,ES29209555094272945666,TRX_N-00797-62985515,2023-11-08T22:58:46,Vitoria-Gasteiz,expenses,repairs,-307.89,-49944.07
buyer_6,Manuel,45,ES29209555094272945666,TRX_N-00798-70883716,2023-11-09T09:47:04,Llodio,expenses,education,-77.55,-50021.62
buyer_6,Manuel,45,ES29209555094272945666,TRX_N-00799-28233132,2023-11-09T18:40:09,Vitoria-Gasteiz,expenses,children,-154.71,-50176.33
buyer_6,Manuel,45,ES29209555094272945666,TRX_N-00800-46249522,2023-11-10T14:06:22,Vitoria-Gasteiz,expenses,food,-76.99,-50253.32
buyer_6,Manuel,45,ES29209555094272945666,TRX_N-00801-93875153,2023-11-11T20:05:12,Vitoria-Gasteiz,expenses,cash,-100.0,-50353.32
buyer_6,Manuel,45,ES29209555094272945666,TRX_N-00802-35192784,2023-11-12T19:38:20,Eibar,expenses,clothing,-82.08,-50435.4
buyer_6,Manuel,45,ES29209555094272945666,TRX_N-00803-22369026,2023-11-13T22:45:30,Zuia,expenses,cash,-100.0,-50535.4
buyer_6,Manuel,45,ES29209555094272945666,TRX_N-00804-80017802,2023-11-14T13:54:50,Vitoria-Gasteiz,expenses,cash,-100.0,-50635.4
buyer_6,Manuel,45,ES29209555094272945666,TRX_N-00805-41877758,2023-11-17T11:49:36,Vitoria-Gasteiz,expenses,food,-84.75,-50720.15
buyer_6,Manuel,45,ES29209555094272945666,TRX_N-00806-09166475,2023-11-17T20:23:17,Vitoria-Gasteiz,expenses,education,-47.65,-50767.8
buyer_6,Manuel,45,ES29209555094272945666,TRX_N-00807-62256388,2023-11-18T09:24:41,Vitoria-Gasteiz,expenses,leisure,-22.92,-50790.72
buyer_6,Manuel,45,ES29209555094272945666,TRX_N-00808-82194184,2023-11-19T12:04:33,Vitoria-Gasteiz,expenses,transport,-67.12,-50857.84
buyer_6,Manuel,45,ES29209555094272945666,TRX_N-00809-75090014,2023-11-21T06:57:03,Vitoria-Gasteiz,expenses,food,-93.47,-50951.31
buyer_6,Manuel,45,ES29209555094272945666,TRX_N-00810-38014193,2023-11-23T10:22:38,Vitoria-Gasteiz,expenses,appliances,-260.13,-51211.44
buyer_6,Manuel,45,ES29209555094272945666,TRX_N-00811-67949873,2023-11-26T09:15:15,Vitoria-Gasteiz,expenses,food,-76.36,-51287.8
buyer_6,Manuel,45,ES29209555094272945666,TRX_N-00812-71566584,2023-11-27T08:20:47,Erandio,expenses,clothing,-113.15,-51400.95
buyer_6,Manuel,45,ES29209555094272945666,TRX_N-00813-94107658,2023-11-29T04:37:33,Vitoria-Gasteiz,expenses,education,-66.31,-51467.26
buyer_6,Manuel,45,ES29209555094272945666,TRX_N-00814-12574527,2023-11-30T08:01:50,Durango,expenses,cash,-100.0,-51567.26
buyer_6,Manuel,45,ES29209555094272945666,TRX_N-00815-72543012,2023-12-01T17:19:04,Vitoria-Gasteiz,incomes,salary,1332.44,-50234.82
buyer_6,Manuel,45,ES29209555094272945666,TRX_N-00816-17893166,2023-12-01T17:19:04,Vitoria-Gasteiz,incomes,salary_partner,1246.72,-48988.1
buyer_6,Manuel,45,ES29209555094272945666,TRX_N-00817-93041760,2023-12-01T17:19:04,Vitoria-Gasteiz,incomes,salary_bonus,1060.47,-47927.63
buyer_6,Manuel,45,ES29209555094272945666,TRX_N-00818-94165736,2023-12-01T17:19:04,Vitoria-Gasteiz,incomes,salary_partner_bonus,941.48,-46986.15
buyer_6,Manuel,45,ES29209555094272945666,TRX_N-00819-44449835,2023-12-02T17:17:14,Vitoria-Gasteiz,expenses,transport,-43.77,-47029.92
buyer_6,Manuel,45,ES29209555094272945666,TRX_N-00820-53255952,2023-12-02T18:23:33,Vitoria-Gasteiz,expenses,cash,-100.0,-47129.92
buyer_6,Manuel,45,ES29209555094272945666,TRX_N-00821-53116610,2023-12-04T17:59:22,Vitoria-Gasteiz,expenses,mortgage,-925.72,-48055.64
buyer_6,Manuel,45,ES29209555094272945666,TRX_N-00822-09447698,2023-12-04T10:29:19,Vitoria-Gasteiz,expenses,transport,-71.34,-48126.98
buyer_6,Manuel,45,ES29209555094272945666,TRX_N-00823-36250942,2023-12-04T20:59:31,Sestao,expenses,leisure,-30.28,-48157.26
buyer_6,Manuel,45,ES29209555094272945666,TRX_N-00824-06812646,2023-12-05T17:42:12,Vitoria-Gasteiz,expenses,transport,-48.57,-48205.83
buyer_6,Manuel,45,ES29209555094272945666,TRX_N-00825-34276104,2023-12-06T20:01:02,Vitoria-Gasteiz,expenses,gas,-87.62,-48293.45
buyer_6,Manuel,45,ES29209555094272945666,TRX_N-00826-08050702,2023-12-06T09:40:40,Vitoria-Gasteiz,expenses,leisure,-75.33,-48368.78
buyer_6,Manuel,45,ES29209555094272945666,TRX_N-00827-56791115,2023-12-07T01:49:01,Vitoria-Gasteiz,expenses,internet,-42.0,-48410.78
buyer_6,Manuel,45,ES29209555094272945666,TRX_N-00828-77543598,2023-12-07T16:07:25,Vitoria-Gasteiz,expenses,travel,-1747.05,-50157.83
buyer_6,Manuel,45,ES29209555094272945666,TRX_N-00829-63564992,2023-12-08T09:47:43,Vitoria-Gasteiz,expenses,water,-33.25,-50191.08
buyer_6,Manuel,45,ES29209555094272945666,TRX_N-00830-50192679,2023-12-08T17:31:02,Vitoria-Gasteiz,expenses,electricity,-42.98,-50234.06
buyer_6,Manuel,45,ES29209555094272945666,TRX_N-00831-74988282,2023-12-08T13:42:14,Vitoria-Gasteiz,expenses,phone,-41.31,-50275.37
buyer_6,Manuel,45,ES29209555094272945666,TRX_N-00832-13690175,2023-12-10T12:50:02,Vitoria-Gasteiz,expenses,appliances,-227.02,-50502.39
buyer_6,Manuel,45,ES29209555094272945666,TRX_N-00833-56918873,2023-12-11T09:06:12,Vitoria-Gasteiz,expenses,cash,-100.0,-50602.39
buyer_6,Manuel,45,ES29209555094272945666,TRX_N-00834-82192408,2023-12-11T09:11:27,Vitoria-Gasteiz,expenses,gifts,-40.4,-50642.79
buyer_6,Manuel,45,ES29209555094272945666,TRX_N-00835-39176533,2023-12-12T16:09:23,Vitoria-Gasteiz,expenses,transport,-53.69,-50696.48
buyer_6,Manuel,45,ES29209555094272945666,TRX_N-00836-50095153,2023-12-12T19:32:42,Vitoria-Gasteiz,expenses,repairs,-171.39,-50867.87
buyer_6,Manuel,45,ES29209555094272945666,TRX_N-00837-02650438,2023-12-13T12:06:55,Irun,expenses,transport,-61.74,-50929.61
buyer_6,Manuel,45,ES29209555094272945666,TRX_N-00838-08270915,2023-12-14T15:42:36,Vitoria-Gasteiz,expenses,food,-112.8,-51042.41
buyer_6,Manuel,45,ES29209555094272945666,TRX_N-00839-10414269,2023-12-14T00:12:03,Vitoria-Gasteiz,expenses,education,-49.81,-51092.22
buyer_6,Manuel,45,ES29209555094272945666,TRX_N-00840-39667772,2023-12-15T13:52:53,Bilbao,expenses,food,-105.42,-51197.64
buyer_6,Manuel,45,ES29209555094272945666,TRX_N-00841-14419718,2023-12-17T14:42:17,Vitoria-Gasteiz,expenses,cash,-100.0,-51297.64
buyer_6,Manuel,45,ES29209555094272945666,TRX_N-00842-62996132,2023-12-18T19:00:44,Vitoria-Gasteiz,expenses,transport,-54.65,-51352.29
buyer_6,Manuel,45,ES29209555094272945666,TRX_N-00843-18688796,2023-12-18T20:10:52,Vitoria-Gasteiz,expenses,cash,-100.0,-51452.29
buyer_6,Manuel,45,ES29209555094272945666,TRX_N-00844-72953792,2023-12-19T14:05:59,Vitoria-Gasteiz,expenses,healthcare,-145.32,-51597.61
buyer_6,Manuel,45,ES29209555094272945666,TRX_N-00845-97452464,2023-12-19T23:27:27,Vitoria-Gasteiz,expenses,cash,-100.0,-51697.61
buyer_6,Manuel,45,ES29209555094272945666,TRX_N-00846-29059070,2023-12-19T15:52:53,Vitoria-Gasteiz,expenses,repairs,-163.49,-51861.1
buyer_6,Manuel,45,ES29209555094272945666,TRX_N-00847-46365910,2023-12-20T21:36:31,Vitoria-Gasteiz,expenses,clothing,-110.62,-51971.72
buyer_6,Manuel,45,ES29209555094272945666,TRX_N-00848-40586295,2023-12-21T14:10:36,Vitoria-Gasteiz,expenses,food,-92.19,-52063.91
buyer_6,Manuel,45,ES29209555094272945666,TRX_N-00849-63496502,2023-12-24T09:26:16,Vitoria-Gasteiz,expenses,transport,-43.32,-52107.23
buyer_6,Manuel,45,ES29209555094272945666,TRX_N-00850-39863864,2023-12-24T23:26:17,Alegría-Dulantzi,expenses,cash,-100.0,-52207.23
buyer_6,Manuel,45,ES29209555094272945666,TRX_N-00851-64618167,2023-12-24T23:00:59,Vitoria-Gasteiz,expenses,appliances,-294.11,-52501.34
buyer_6,Manuel,45,ES29209555094272945666,TRX_N-00852-14386047,2023-12-25T10:10:44,Vitoria-Gasteiz,expenses,transport,-63.77,-52565.11
buyer_6,Manuel,45,ES29209555094272945666,TRX_N-00853-97213304,2023-12-28T22:32:39,Vitoria-Gasteiz,expenses,clothing,-115.98,-52681.09
buyer_6,Manuel,45,ES29209555094272945666,TRX_N-00854-42818191,2023-12-28T12:58:55,Vitoria-Gasteiz,expenses,education,-59.56,-52740.65
buyer_6,Manuel,45,ES29209555094272945666,TRX_N-00855-28092670,2023-12-28T15:41:06,Vitoria-Gasteiz,expenses,cash,-100.0,-52840.65
buyer_6,Manuel,45,ES29209555094272945666,TRX_N-00856-96451413,2023-12-30T10:28:14,Vitoria-Gasteiz,expenses,gifts,-583.31,-53423.96
buyer_6,Manuel,45,ES29209555094272945666,TRX_N-00857-63810181,2023-12-31T08:34:39,Vitoria-Gasteiz,expenses,transport,-76.15,-53500.11
buyer_6,Manuel,45,ES29209555094272945666,TRX_N-00858-90534019,2024-01-01T08:27:04,Vitoria-Gasteiz,incomes,salary,1376.71,-52123.4
buyer_6,Manuel,45,ES29209555094272945666,TRX_N-00859-81324483,2024-01-01T08:27:04,Vitoria-Gasteiz,incomes,salary_partner,1288.14,-50835.26
buyer_6,Manuel,45,ES29209555094272945666,TRX_N-00860-84094967,2024-01-01T17:57:00,Vitoria-Gasteiz,expenses,leisure,-58.0,-50893.26
buyer_6,Manuel,45,ES29209555094272945666,TRX_N-00861-94423247,2024-01-01T16:57:23,Vitoria-Gasteiz,expenses,appliances,-152.38,-51045.64
buyer_6,Manuel,45,ES29209555094272945666,TRX_N-00862-12022606,2024-01-01T16:28:26,Vitoria-Gasteiz,expenses,repairs,-289.52,-51335.16
buyer_6,Manuel,45,ES29209555094272945666,TRX_N-00863-27467677,2024-01-03T11:42:53,Vitoria-Gasteiz,expenses,food,-101.48,-51436.64
buyer_6,Manuel,45,ES29209555094272945666,TRX_N-00864-78153332,2024-01-03T09:42:43,Vitoria-Gasteiz,expenses,cash,-100.0,-51536.64
buyer_6,Manuel,45,ES29209555094272945666,TRX_N-00865-95825814,2024-01-03T17:47:17,Vitoria-Gasteiz,expenses,appliances,-385.68,-51922.32
buyer_6,Manuel,45,ES29209555094272945666,TRX_N-00866-23753850,2024-01-03T19:25:35,Vitoria-Gasteiz,expenses,repairs,-139.53,-52061.85
buyer_6,Manuel,45,ES29209555094272945666,TRX_N-00867-01277694,2024-01-04T13:30:07,Vitoria-Gasteiz,expenses,mortgage,-925.72,-52987.57
buyer_6,Manuel,45,ES29209555094272945666,TRX_N-00868-35444950,2024-01-05T20:22:00,Vitoria-Gasteiz,expenses,water,-44.07,-53031.64
buyer_6,Manuel,45,ES29209555094272945666,TRX_N-00869-98816752,2024-01-05T02:14:13,Vitoria-Gasteiz,expenses,gas,-102.48,-53134.12
buyer_6,Manuel,45,ES29209555094272945666,TRX_N-00870-31146709,2024-01-05T16:10:22,Vitoria-Gasteiz,expenses,internet,-42.0,-53176.12
buyer_6,Manuel,45,ES29209555094272945666,TRX_N-00871-03948625,2024-01-05T16:49:51,Vitoria-Gasteiz,expenses,transport,-40.88,-53217.0
buyer_6,Manuel,45,ES29209555094272945666,TRX_N-00872-52371388,2024-01-05T08:10:11,Vitoria-Gasteiz,expenses,clothing,-64.52,-53281.52
buyer_6,Manuel,45,ES29209555094272945666,TRX_N-00873-38606229,2024-01-06T13:09:59,Vitoria-Gasteiz,expenses,phone,-33.69,-53315.21
buyer_6,Manuel,45,ES29209555094272945666,TRX_N-00874-98554967,2024-01-06T01:04:46,Vitoria-Gasteiz,expenses,travel,-1671.05,-54986.26
buyer_6,Manuel,45,ES29209555094272945666,TRX_N-00875-65071265,2024-01-07T15:49:47,Vitoria-Gasteiz,expenses,food,-88.62,-55074.88
buyer_6,Manuel,45,ES29209555094272945666,TRX_N-00876-00848548,2024-01-08T10:34:09,Vitoria-Gasteiz,expenses,electricity,-50.03,-55124.91
buyer_6,Manuel,45,ES29209555094272945666,TRX_N-00877-21276710,2024-01-08T06:12:29,Arrasate,expenses,cash,-100.0,-55224.91
buyer_6,Manuel,45,ES29209555094272945666,TRX_N-00878-19554457,2024-01-10T16:31:26,Leioa,expenses,leisure,-18.77,-55243.68
buyer_6,Manuel,45,ES29209555094272945666,TRX_N-00879-73339486,2024-01-10T07:00:19,Vitoria-Gasteiz,expenses,education,-60.41,-55304.09
buyer_6,Manuel,45,ES29209555094272945666,TRX_N-00880-44833353,2024-01-10T14:12:05,Vitoria-Gasteiz,expenses,children,-200.23,-55504.32
buyer_6,Manuel,45,ES29209555094272945666,TRX_N-00881-76078768,2024-01-11T15:47:54,Irun,expenses,leisure,-39.54,-55543.86
buyer_6,Manuel,45,ES29209555094272945666,TRX_N-00882-12657470,2024-01-13T19:24:00,Vitoria-Gasteiz,expenses,cash,-100.0,-55643.86
buyer_6,Manuel,45,ES29209555094272945666,TRX_N-00883-20927196,2024-01-15T12:21:08,Vitoria-Gasteiz,expenses,food,-100.66,-55744.52
buyer_6,Manuel,45,ES29209555094272945666,TRX_N-00884-91712047,2024-01-17T20:54:01,Vitoria-Gasteiz,expenses,clothing,-120.45,-55864.97
buyer_6,Manuel,45,ES29209555094272945666,TRX_N-00885-89278014,2024-01-17T19:56:54,Vitoria-Gasteiz,expenses,cash,-100.0,-55964.97
buyer_6,Manuel,45,ES29209555094272945666,TRX_N-00886-81050504,2024-01-18T13:56:44,Errenteria,expenses,healthcare,-57.24,-56022.21
buyer_6,Manuel,45,ES29209555094272945666,TRX_N-00887-94773370,2024-01-20T10:50:12,Vitoria-Gasteiz,expenses,food,-119.84,-56142.05
buyer_6,Manuel,45,ES29209555094272945666,TRX_N-00888-35731316,2024-01-20T19:33:20,Vitoria-Gasteiz,expenses,leisure,-30.04,-56172.09
buyer_6,Manuel,45,ES29209555094272945666,TRX_N-00889-27771736,2024-01-20T13:59:18,Vitoria-Gasteiz,expenses,education,-55.53,-56227.62
buyer_6,Manuel,45,ES29209555094272945666,TRX_N-00890-06722339,2024-01-20T15:18:38,Vitoria-Gasteiz,expenses,cash,-100.0,-56327.62
buyer_6,Manuel,45,ES29209555094272945666,TRX_N-00891-85719562,2024-01-20T16:27:38,Vitoria-Gasteiz,expenses,children,-75.35,-56402.97
buyer_6,Manuel,45,ES29209555094272945666,TRX_N-00892-43527782,2024-01-21T13:53:12,Vitoria-Gasteiz,expenses,food,-89.8,-56492.77
buyer_6,Manuel,45,ES29209555094272945666,TRX_N-00893-00110050,2024-01-21T23:08:46,Vitoria-Gasteiz,expenses,cash,-100.0,-56592.77
buyer_6,Manuel,45,ES29209555094272945666,TRX_N-00894-59953205,2024-01-24T12:37:50,Vitoria-Gasteiz,expenses,healthcare,-67.0,-56659.77
buyer_6,Manuel,45,ES29209555094272945666,TRX_N-00895-33659177,2024-01-25T17:11:42,Vitoria-Gasteiz,expenses,transport,-41.72,-56701.49
buyer_6,Manuel,45,ES29209555094272945666,TRX_N-00896-33917230,2024-01-26T11:42:10,Vitoria-Gasteiz,expenses,food,-124.54,-56826.03
buyer_6,Manuel,45,ES29209555094272945666,TRX_N-00897-30278690,2024-01-27T06:06:37,Vitoria-Gasteiz,expenses,food,-72.43,-56898.46
buyer_6,Manuel,45,ES29209555094272945666,TRX_N-00898-77957160,2024-02-01T21:10:22,Vitoria-Gasteiz,incomes,salary,1376.71,-55521.75
buyer_6,Manuel,45,ES29209555094272945666,TRX_N-00899-42236273,2024-02-01T21:10:22,Vitoria-Gasteiz,incomes,salary_partner,1288.14,-54233.61
buyer_6,Manuel,45,ES29209555094272945666,TRX_N-00900-05290173,2024-02-01T21:10:22,Vitoria-Gasteiz,incomes,extra_income,247.42,-53986.19
buyer_6,Manuel,45,ES29209555094272945666,TRX_N-00901-39229780,2024-02-01T15:48:30,Donostia,expenses,transport,-52.02,-54038.21
buyer_6,Manuel,45,ES29209555094272945666,TRX_N-00902-36499923,2024-02-01T17:42:22,Vitoria-Gasteiz,expenses,gifts,-155.68,-54193.89
buyer_6,Manuel,45,ES29209555094272945666,TRX_N-00903-90479488,2024-02-03T23:57:23,Vitoria-Gasteiz,expenses,cash,-100.0,-54293.89
buyer_6,Manuel,45,ES29209555094272945666,TRX_N-00904-09397646,2024-02-04T22:37:03,Vitoria-Gasteiz,expenses,mortgage,-925.72,-55219.61
buyer_6,Manuel,45,ES29209555094272945666,TRX_N-00905-46218483,2024-02-05T09:28:59,Vitoria-Gasteiz,expenses,electricity,-38.29,-55257.9
buyer_6,Manuel,45,ES29209555094272945666,TRX_N-00906-51810076,2024-02-06T10:46:07,Vitoria-Gasteiz,expenses,gas,-48.92,-55306.82
buyer_6,Manuel,45,ES29209555094272945666,TRX_N-00907-51153903,2024-02-06T09:23:32,Vitoria-Gasteiz,expenses,leisure,-44.19,-55351.01
buyer_6,Manuel,45,ES29209555094272945666,TRX_N-00908-13804938,2024-02-07T08:07:53,Vitoria-Gasteiz,expenses,water,-28.7,-55379.71
buyer_6,Manuel,45,ES29209555094272945666,TRX_N-00909-09655439,2024-02-07T10:38:28,Vitoria-Gasteiz,expenses,internet,-42.0,-55421.71
buyer_6,Manuel,45,ES29209555094272945666,TRX_N-00910-92557059,2024-02-07T18:20:26,Vitoria-Gasteiz,expenses,phone,-40.2,-55461.91
buyer_6,Manuel,45,ES29209555094272945666,TRX_N-00911-71729027,2024-02-08T20:19:39,Vitoria-Gasteiz,expenses,food,-111.48,-55573.39
buyer_6,Manuel,45,ES29209555094272945666,TRX_N-00912-98055670,2024-02-08T13:43:21,Labastida,expenses,cash,-100.0,-55673.39
buyer_6,Manuel,45,ES29209555094272945666,TRX_N-00913-45850657,2024-02-11T16:49:45,Bilbao,expenses,transport,-75.14,-55748.53
buyer_6,Manuel,45,ES29209555094272945666,TRX_N-00914-69570010,2024-02-12T13:10:09,Berango,expenses,food,-82.48,-55831.01
buyer_6,Manuel,45,ES29209555094272945666,TRX_N-00915-57220974,2024-02-12T14:01:17,Vitoria-Gasteiz,expenses,cash,-100.0,-55931.01
buyer_6,Manuel,45,ES29209555094272945666,TRX_N-00916-33784372,2024-02-13T18:53:49,Vitoria-Gasteiz,expenses,cash,-100.0,-56031.01
buyer_6,Manuel,45,ES29209555094272945666,TRX_N-00917-67437828,2024-02-15T18:06:15,Vitoria-Gasteiz,expenses,education,-70.21,-56101.22
buyer_6,Manuel,45,ES29209555094272945666,TRX_N-00918-95675476,2024-02-20T11:38:38,Vitoria-Gasteiz,expenses,cash,-100.0,-56201.22
buyer_6,Manuel,45,ES29209555094272945666,TRX_N-00919-33723473,2024-02-23T12:47:39,Vitoria-Gasteiz,expenses,appliances,-343.18,-56544.4
buyer_6,Manuel,45,ES29209555094272945666,TRX_N-00920-91549339,2024-02-26T15:41:23,Vitoria-Gasteiz,expenses,healthcare,-153.1,-56697.5
buyer_6,Manuel,45,ES29209555094272945666,TRX_N-00921-97091746,2024-02-26T17:36:14,Vitoria-Gasteiz,expenses,cash,-100.0,-56797.5
buyer_6,Manuel,45,ES29209555094272945666,TRX_N-00922-29447965,2024-02-26T19:57:12,Vitoria-Gasteiz,expenses,children,-81.21,-56878.71
buyer_6,Manuel,45,ES29209555094272945666,TRX_N-00923-04210158,2024-02-29T13:18:13,Vitoria-Gasteiz,expenses,leisure,-48.27,-56926.98
buyer_6,Manuel,45,ES29209555094272945666,TRX_N-00924-90918594,2024-03-01T10:53:18,Vitoria-Gasteiz,incomes,salary,1376.71,-55550.27
buyer_6,Manuel,45,ES29209555094272945666,TRX_N-00925-63094022,2024-03-01T10:53:18,Vitoria-Gasteiz,incomes,salary_partner,1288.14,-54262.13
buyer_6,Manuel,45,ES29209555094272945666,TRX_N-00926-39909632,2024-03-01T16:42:46,Vitoria-Gasteiz,expenses,gifts,-692.47,-54954.6
buyer_6,Manuel,45,ES29209555094272945666,TRX_N-00927-08994059,2024-03-02T17:31:12,Vitoria-Gasteiz,expenses,cash,-100.0,-55054.6
buyer_6,Manuel,45,ES29209555094272945666,TRX_N-00928-84138271,2024-03-03T17:50:28,Vitoria-Gasteiz,expenses,healthcare,-167.51,-55222.11
buyer_6,Manuel,45,ES29209555094272945666,TRX_N-00929-29240977,2024-03-04T09:02:34,Vitoria-Gasteiz,expenses,mortgage,-925.72,-56147.83
buyer_6,Manuel,45,ES29209555094272945666,TRX_N-00930-87574605,2024-03-04T10:15:09,Vitoria-Gasteiz,expenses,cash,-100.0,-56247.83
buyer_6,Manuel,45,ES29209555094272945666,TRX_N-00931-18877140,2024-03-05T08:23:47,Vitoria-Gasteiz,expenses,electricity,-74.07,-56321.9
buyer_6,Manuel,45,ES29209555094272945666,TRX_N-00932-71545125,2024-03-06T17:14:46,Vitoria-Gasteiz,expenses,phone,-31.9,-56353.8
buyer_6,Manuel,45,ES29209555094272945666,TRX_N-00933-83710770,2024-03-06T10:33:55,Vitoria-Gasteiz,expenses,cash,-100.0,-56453.8
buyer_6,Manuel,45,ES29209555094272945666,TRX_N-00934-41526591,2024-03-07T12:10:33,Vitoria-Gasteiz,expenses,water,-29.64,-56483.44
buyer_6,Manuel,45,ES29209555094272945666,TRX_N-00935-14309339,2024-03-07T16:34:33,Vitoria-Gasteiz,expenses,food,-114.13,-56597.57
buyer_6,Manuel,45,ES29209555094272945666,TRX_N-00936-40222936,2024-03-08T01:35:55,Vitoria-Gasteiz,expenses,gas,-88.7,-56686.27
buyer_6,Manuel,45,ES29209555094272945666,TRX_N-00937-74971405,2024-03-08T12:54:27,Vitoria-Gasteiz,expenses,internet,-42.0,-56728.27
buyer_6,Manuel,45,ES29209555094272945666,TRX_N-00938-27868152,2024-03-08T10:28:04,Vitoria-Gasteiz,expenses,leisure,-20.68,-56748.95
buyer_6,Manuel,45,ES29209555094272945666,TRX_N-00939-37151260,2024-03-08T13:36:21,Vitoria-Gasteiz,expenses,children,-186.41,-56935.36
buyer_6,Manuel,45,ES29209555094272945666,TRX_N-00940-09506439,2024-03-10T19:08:01,Vitoria-Gasteiz,expenses,cash,-100.0,-57035.36
buyer_6,Manuel,45,ES29209555094272945666,TRX_N-00941-55009440,2024-03-10T02:27:18,Vitoria-Gasteiz,expenses,repairs,-186.45,-57221.81
buyer_6,Manuel,45,ES29209555094272945666,TRX_N-00942-86751410,2024-03-10T21:57:42,Vitoria-Gasteiz,expenses,gifts,-86.79,-57308.6
buyer_6,Manuel,45,ES29209555094272945666,TRX_N-00943-49019065,2024-03-11T11:59:12,Vitoria-Gasteiz,expenses,appliances,-89.72,-57398.32
buyer_6,Manuel,45,ES29209555094272945666,TRX_N-00944-52297882,2024-03-12T10:34:41,Vitoria-Gasteiz,expenses,cash,-100.0,-57498.32
buyer_6,Manuel,45,ES29209555094272945666,TRX_N-00945-15627822,2024-03-12T15:00:26,Donostia,expenses,appliances,-323.22,-57821.54
buyer_6,Manuel,45,ES29209555094272945666,TRX_N-00946-36584959,2024-03-14T10:55:49,Vitoria-Gasteiz,expenses,food,-114.08,-57935.62
buyer_6,Manuel,45,ES29209555094272945666,TRX_N-00947-31983528,2024-03-14T13:13:19,Vitoria-Gasteiz,expenses,transport,-55.34,-57990.96
buyer_6,Manuel,45,ES29209555094272945666,TRX_N-00948-61619137,2024-03-14T15:51:31,Vitoria-Gasteiz,expenses,education,-77.62,-58068.58
buyer_6,Manuel,45,ES29209555094272945666,TRX_N-00949-24459717,2024-03-15T20:40:32,Vitoria-Gasteiz,expenses,food,-81.23,-58149.81
buyer_6,Manuel,45,ES29209555094272945666,TRX_N-00950-09280900,2024-03-17T10:43:33,Vitoria-Gasteiz,expenses,food,-99.37,-58249.18
buyer_6,Manuel,45,ES29209555094272945666,TRX_N-00951-81849522,2024-03-19T06:36:32,Bermeo,expenses,cash,-100.0,-58349.18
buyer_6,Manuel,45,ES29209555094272945666,TRX_N-00952-23548246,2024-03-20T07:04:31,Vitoria-Gasteiz,expenses,food,-78.59,-58427.77
buyer_6,Manuel,45,ES29209555094272945666,TRX_N-00953-14009413,2024-03-21T10:18:00,Oyón-Oion,expenses,transport,-56.41,-58484.18
buyer_6,Manuel,45,ES29209555094272945666,TRX_N-00954-78578436,2024-03-28T09:29:55,Vitoria-Gasteiz,expenses,cash,-100.0,-58584.18
buyer_6,Manuel,45,ES29209555094272945666,TRX_N-00955-54708773,2024-03-30T08:30:05,Vitoria-Gasteiz,expenses,food,-84.96,-58669.14
buyer_6,Manuel,45,ES29209555094272945666,TRX_N-00956-12939893,2024-03-30T07:05:11,Vitoria-Gasteiz,expenses,transport,-79.46,-58748.6
buyer_6,Manuel,45,ES29209555094272945666,TRX_N-00957-12951123,2024-04-01T08:45:50,Vitoria-Gasteiz,incomes,salary,1376.71,-57371.89
buyer_6,Manuel,45,ES29209555094272945666,TRX_N-00958-34325770,2024-04-01T08:45:50,Vitoria-Gasteiz,incomes,salary_partner,1288.14,-56083.75
buyer_6,Manuel,45,ES29209555094272945666,TRX_N-00959-82741062,2024-04-02T08:16:01,Vitoria-Gasteiz,expenses,repairs,-167.26,-56251.01
buyer_6,Manuel,45,ES29209555094272945666,TRX_N-00960-21225306,2024-04-03T10:39:34,Vitoria-Gasteiz,expenses,cash,-100.0,-56351.01
buyer_6,Manuel,45,ES29209555094272945666,TRX_N-00961-85321305,2024-04-03T08:15:55,Vitoria-Gasteiz,expenses,gifts,-296.25,-56647.26
buyer_6,Manuel,45,ES29209555094272945666,TRX_N-00962-30892515,2024-04-04T17:52:50,Vitoria-Gasteiz,expenses,mortgage,-925.72,-57572.98
buyer_6,Manuel,45,ES29209555094272945666,TRX_N-00963-95852611,2024-04-04T08:25:54,Alegría-Dulantzi,expenses,clothing,-101.68,-57674.66
buyer_6,Manuel,45,ES29209555094272945666,TRX_N-00964-67627463,2024-04-05T14:43:33,Vitoria-Gasteiz,expenses,electricity,-61.59,-57736.25
buyer_6,Manuel,45,ES29209555094272945666,TRX_N-00965-05688382,2024-04-06T11:41:31,Vitoria-Gasteiz,expenses,phone,-44.38,-57780.63
buyer_6,Manuel,45,ES29209555094272945666,TRX_N-00966-96234524,2024-04-07T20:48:32,Vitoria-Gasteiz,expenses,repairs,-194.23,-57974.86
buyer_6,Manuel,45,ES29209555094272945666,TRX_N-00967-45820587,2024-04-08T11:52:18,Vitoria-Gasteiz,expenses,gas,-104.06,-58078.92
buyer_6,Manuel,45,ES29209555094272945666,TRX_N-00968-70170212,2024-04-08T20:38:51,Vitoria-Gasteiz,expenses,water,-34.07,-58112.99
buyer_6,Manuel,45,ES29209555094272945666,TRX_N-00969-69698796,2024-04-08T12:42:24,Vitoria-Gasteiz,expenses,internet,-42.0,-58154.99
buyer_6,Manuel,45,ES29209555094272945666,TRX_N-00970-62247794,2024-04-08T23:05:36,Vitoria-Gasteiz,expenses,food,-101.8,-58256.79
buyer_6,Manuel,45,ES29209555094272945666,TRX_N-00971-14865263,2024-04-08T12:54:27,Vitoria-Gasteiz,expenses,gifts,-253.06,-58509.85
buyer_6,Manuel,45,ES29209555094272945666,TRX_N-00972-23159245,2024-04-09T13:40:35,Salvatierra/Agurain,expenses,food,-87.89,-58597.74
buyer_6,Manuel,45,ES29209555094272945666,TRX_N-00973-62964030,2024-04-09T10:10:14,Vitoria-Gasteiz,expenses,transport,-52.55,-58650.29
buyer_6,Manuel,45,ES29209555094272945666,TRX_N-00974-24177133,2024-04-14T12:17:07,Vitoria-Gasteiz,expenses,food,-110.01,-58760.3
buyer_6,Manuel,45,ES29209555094272945666,TRX_N-00975-95170766,2024-04-15T19:58:12,Vitoria-Gasteiz,expenses,transport,-77.49,-58837.79
buyer_6,Manuel,45,ES29209555094272945666,TRX_N-00976-60004266,2024-04-15T15:03:50,Vitoria-Gasteiz,expenses,leisure,-56.9,-58894.69
buyer_6,Manuel,45,ES29209555094272945666,TRX_N-00977-79976085,2024-04-16T09:20:34,Vitoria-Gasteiz,expenses,clothing,-45.89,-58940.58
buyer_6,Manuel,45,ES29209555094272945666,TRX_N-00978-47525397,2024-04-17T18:50:11,Vitoria-Gasteiz,expenses,food,-91.61,-59032.19
buyer_6,Manuel,45,ES29209555094272945666,TRX_N-00979-57282162,2024-04-18T09:36:02,Vitoria-Gasteiz,expenses,leisure,-81.99,-59114.18
buyer_6,Manuel,45,ES29209555094272945666,TRX_N-00980-07246336,2024-04-18T07:45:08,Vitoria-Gasteiz,expenses,clothing,-71.45,-59185.63
buyer_6,Manuel,45,ES29209555094272945666,TRX_N-00981-66628373,2024-04-19T15:54:38,Vitoria-Gasteiz,expenses,gifts,-666.44,-59852.07
buyer_6,Manuel,45,ES29209555094272945666,TRX_N-00982-48778079,2024-04-20T12:44:35,Erandio,expenses,cash,-100.0,-59952.07
buyer_6,Manuel,45,ES29209555094272945666,TRX_N-00983-76009313,2024-04-22T18:55:27,Eibar,expenses,transport,-70.89,-60022.96
buyer_6,Manuel,45,ES29209555094272945666,TRX_N-00984-89524653,2024-04-22T16:51:50,Vitoria-Gasteiz,expenses,cash,-100.0,-60122.96
buyer_6,Manuel,45,ES29209555094272945666,TRX_N-00985-24366085,2024-04-23T09:49:40,Vitoria-Gasteiz,expenses,food,-103.66,-60226.62
buyer_6,Manuel,45,ES29209555094272945666,TRX_N-00986-73694156,2024-04-24T16:38:42,Vitoria-Gasteiz,expenses,food,-104.78,-60331.4
buyer_6,Manuel,45,ES29209555094272945666,TRX_N-00987-11600038,2024-04-28T03:07:18,Vitoria-Gasteiz,expenses,cash,-100.0,-60431.4
buyer_6,Manuel,45,ES29209555094272945666,TRX_N-00988-86259360,2024-04-29T23:51:24,Vitoria-Gasteiz,expenses,cash,-100.0,-60531.4
buyer_6,Manuel,45,ES29209555094272945666,TRX_N-00989-11970485,2024-05-01T23:26:35,Vitoria-Gasteiz,incomes,salary,1376.71,-59154.69
buyer_6,Manuel,45,ES29209555094272945666,TRX_N-00990-46235102,2024-05-01T23:26:35,Vitoria-Gasteiz,incomes,salary_partner,1288.14,-57866.55
buyer_6,Manuel,45,ES29209555094272945666,TRX_N-00991-86860566,2024-05-01T23:26:35,Vitoria-Gasteiz,incomes,extra_income,247.42,-57619.13
buyer_6,Manuel,45,ES29209555094272945666,TRX_N-00992-98611217,2024-05-01T15:42:22,Vitoria-Gasteiz,expenses,leisure,-54.71,-57673.84
buyer_6,Manuel,45,ES29209555094272945666,TRX_N-00993-79648515,2024-05-04T17:50:20,Vitoria-Gasteiz,expenses,mortgage,-925.72,-58599.56
buyer_6,Manuel,45,ES29209555094272945666,TRX_N-00994-41947170,2024-05-05T16:34:02,Vitoria-Gasteiz,expenses,water,-34.8,-58634.36
buyer_6,Manuel,45,ES29209555094272945666,TRX_N-00995-37817143,2024-05-05T13:10:05,Vitoria-Gasteiz,expenses,phone,-42.92,-58677.28
buyer_6,Manuel,45,ES29209555094272945666,TRX_N-00996-49331734,2024-05-05T03:11:01,Vitoria-Gasteiz,expenses,food,-79.03,-58756.31
buyer_6,Manuel,45,ES29209555094272945666,TRX_N-00997-37193021,2024-05-05T17:44:38,Vitoria-Gasteiz,expenses,children,-110.44,-58866.75
buyer_6,Manuel,45,ES29209555094272945666,TRX_N-00998-63190806,2024-05-06T13:09:34,Vitoria-Gasteiz,expenses,education,-60.54,-58927.29
buyer_6,Manuel,45,ES29209555094272945666,TRX_N-00999-72631477,2024-05-07T11:14:04,Vitoria-Gasteiz,expenses,internet,-42.0,-58969.29
buyer_6,Manuel,45,ES29209555094272945666,TRX_N-01000-74655402,2024-05-07T19:43:35,Vitoria-Gasteiz,expenses,cash,-100.0,-59069.29
buyer_6,Manuel,45,ES29209555094272945666,TRX_N-01001-83746568,2024-05-07T13:50:48,Vitoria-Gasteiz,expenses,repairs,-255.37,-59324.66
buyer_6,Manuel,45,ES29209555094272945666,TRX_N-01002-54088070,2024-05-07T11:01:17,Vitoria-Gasteiz,expenses,children,-88.27,-59412.93
buyer_6,Manuel,45,ES29209555094272945666,TRX_N-01003-53955558,2024-05-08T14:53:25,Vitoria-Gasteiz,expenses,electricity,-45.98,-59458.91
buyer_6,Manuel,45,ES29209555094272945666,TRX_N-01004-70526326,2024-05-08T19:24:21,Vitoria-Gasteiz,expenses,gas,-69.36,-59528.27
buyer_6,Manuel,45,ES29209555094272945666,TRX_N-01005-44502967,2024-05-14T08:43:41,Vitoria-Gasteiz,expenses,leisure,-72.31,-59600.58
buyer_6,Manuel,45,ES29209555094272945666,TRX_N-01006-47464992,2024-05-15T09:38:24,Vitoria-Gasteiz,expenses,repairs,-187.07,-59787.65
buyer_6,Manuel,45,ES29209555094272945666,TRX_N-01007-54562530,2024-05-17T18:44:57,Basauri,expenses,transport,-53.81,-59841.46
buyer_6,Manuel,45,ES29209555094272945666,TRX_N-01008-30133721,2024-05-19T16:56:25,Vitoria-Gasteiz,expenses,repairs,-234.35,-60075.81
buyer_6,Manuel,45,ES29209555094272945666,TRX_N-01009-30093879,2024-05-20T14:39:57,Vitoria-Gasteiz,expenses,cash,-100.0,-60175.81
buyer_6,Manuel,45,ES29209555094272945666,TRX_N-01010-97703155,2024-05-21T18:20:51,Vitoria-Gasteiz,expenses,food,-86.19,-60262.0
buyer_6,Manuel,45,ES29209555094272945666,TRX_N-01011-41536731,2024-05-21T04:02:04,Vitoria-Gasteiz,expenses,repairs,-330.87,-60592.87
buyer_6,Manuel,45,ES29209555094272945666,TRX_N-01012-17577785,2024-05-22T02:45:42,Vitoria-Gasteiz,expenses,transport,-45.63,-60638.5
buyer_6,Manuel,45,ES29209555094272945666,TRX_N-01013-70282513,2024-05-22T17:19:06,Vitoria-Gasteiz,expenses,leisure,-72.04,-60710.54
buyer_6,Manuel,45,ES29209555094272945666,TRX_N-01014-45019833,2024-05-22T23:07:32,Vitoria-Gasteiz,expenses,gifts,-30.51,-60741.05
buyer_6,Manuel,45,ES29209555094272945666,TRX_N-01015-62032080,2024-05-24T20:57:17,Vitoria-Gasteiz,expenses,food,-102.5,-60843.55
buyer_6,Manuel,45,ES29209555094272945666,TRX_N-01016-56613681,2024-05-24T10:24:13,Vitoria-Gasteiz,expenses,transport,-58.05,-60901.6
buyer_6,Manuel,45,ES29209555094272945666,TRX_N-01017-56047370,2024-05-25T00:57:34,Vitoria-Gasteiz,expenses,education,-58.98,-60960.58
buyer_6,Manuel,45,ES29209555094272945666,TRX_N-01018-76757153,2024-05-25T09:15:29,Santurtzi,expenses,cash,-100.0,-61060.58
buyer_6,Manuel,45,ES29209555094272945666,TRX_N-01019-13724942,2024-05-25T19:20:22,Vitoria-Gasteiz,expenses,gifts,-563.35,-61623.93
buyer_6,Manuel,45,ES29209555094272945666,TRX_N-01020-32408299,2024-05-27T06:06:58,Vitoria-Gasteiz,expenses,children,-145.34,-61769.27
buyer_6,Manuel,45,ES29209555094272945666,TRX_N-01021-35510222,2024-05-29T22:05:56,Vitoria-Gasteiz,expenses,food,-114.13,-61883.4
buyer_6,Manuel,45,ES29209555094272945666,TRX_N-01022-01023149,2024-05-30T23:53:33,Vitoria-Gasteiz,expenses,leisure,-76.7,-61960.1
buyer_6,Manuel,45,ES29209555094272945666,TRX_N-01023-93223189,2024-05-31T14:59:51,Vitoria-Gasteiz,expenses,food,-65.94,-62026.04
buyer_6,Manuel,45,ES29209555094272945666,TRX_N-01024-01403342,2024-06-01T20:10:07,Vitoria-Gasteiz,incomes,salary,1376.71,-60649.33
buyer_6,Manuel,45,ES29209555094272945666,TRX_N-01025-76481734,2024-06-01T20:10:07,Vitoria-Gasteiz,incomes,salary_partner,1288.14,-59361.19
buyer_6,Manuel,45,ES29209555094272945666,TRX_N-01026-39816255,2024-06-01T20:10:07,Vitoria-Gasteiz,incomes,salary_bonus,1082.9,-58278.29
buyer_6,Manuel,45,ES29209555094272945666,TRX_N-01027-43584734,2024-06-01T20:10:07,Vitoria-Gasteiz,incomes,salary_partner_bonus,906.91,-57371.38
buyer_6,Manuel,45,ES29209555094272945666,TRX_N-01028-70638685,2024-06-02T11:42:40,Vitoria-Gasteiz,expenses,leisure,-24.56,-57395.94
buyer_6,Manuel,45,ES29209555094272945666,TRX_N-01029-47281238,2024-06-02T05:03:52,Vitoria-Gasteiz,expenses,appliances,-251.3,-57647.24
buyer_6,Manuel,45,ES29209555094272945666,TRX_N-01030-46404672,2024-06-03T08:13:51,Vitoria-Gasteiz,expenses,cash,-100.0,-57747.24
buyer_6,Manuel,45,ES29209555094272945666,TRX_N-01031-60537878,2024-06-04T09:50:42,Vitoria-Gasteiz,expenses,mortgage,-925.72,-58672.96
buyer_6,Manuel,45,ES29209555094272945666,TRX_N-01032-82548513,2024-06-04T06:18:38,Vitoria-Gasteiz,expenses,food,-91.03,-58763.99
buyer_6,Manuel,45,ES29209555094272945666,TRX_N-01033-93395937,2024-06-05T02:41:04,Vitoria-Gasteiz,expenses,water,-40.3,-58804.29
buyer_6,Manuel,45,ES29209555094272945666,TRX_N-01034-20354067,2024-06-05T21:12:00,Vitoria-Gasteiz,expenses,clothing,-55.17,-58859.46
buyer_6,Manuel,45,ES29209555094272945666,TRX_N-01035-59943733,2024-06-06T16:44:48,Vitoria-Gasteiz,expenses,electricity,-37.28,-58896.74
buyer_6,Manuel,45,ES29209555094272945666,TRX_N-01036-55371437,2024-06-06T10:52:06,Vitoria-Gasteiz,expenses,education,-65.71,-58962.45
buyer_6,Manuel,45,ES29209555094272945666,TRX_N-01037-56076018,2024-06-07T20:23:19,Vitoria-Gasteiz,expenses,gifts,-337.23,-59299.68
buyer_6,Manuel,45,ES29209555094272945666,TRX_N-01038-42718846,2024-06-08T05:07:57,Vitoria-Gasteiz,expenses,gas,-53.96,-59353.64
buyer_6,Manuel,45,ES29209555094272945666,TRX_N-01039-75505862,2024-06-08T05:16:02,Vitoria-Gasteiz,expenses,internet,-42.0,-59395.64
buyer_6,Manuel,45,ES29209555094272945666,TRX_N-01040-45517192,2024-06-08T19:06:44,Vitoria-Gasteiz,expenses,phone,-34.16,-59429.8
buyer_6,Manuel,45,ES29209555094272945666,TRX_N-01041-33806507,2024-06-09T09:36:06,Vitoria-Gasteiz,expenses,repairs,-84.75,-59514.55
buyer_6,Manuel,45,ES29209555094272945666,TRX_N-01042-40658125,2024-06-10T14:07:41,Vitoria-Gasteiz,expenses,food,-102.41,-59616.96
buyer_6,Manuel,45,ES29209555094272945666,TRX_N-01043-91594320,2024-06-11T20:57:36,Santurtzi,expenses,cash,-100.0,-59716.96
buyer_6,Manuel,45,ES29209555094272945666,TRX_N-01044-34744197,2024-06-12T13:51:25,Vitoria-Gasteiz,expenses,clothing,-61.81,-59778.77
buyer_6,Manuel,45,ES29209555094272945666,TRX_N-01045-58896805,2024-06-12T14:00:26,Vitoria-Gasteiz,expenses,gifts,-398.7,-60177.47
buyer_6,Manuel,45,ES29209555094272945666,TRX_N-01046-68365110,2024-06-12T09:40:18,Vitoria-Gasteiz,expenses,children,-223.7,-60401.17
buyer_6,Manuel,45,ES29209555094272945666,TRX_N-01047-16448017,2024-06-14T17:09:00,Vitoria-Gasteiz,expenses,leisure,-55.55,-60456.72
buyer_6,Manuel,45,ES29209555094272945666,TRX_N-01048-32807539,2024-06-14T21:42:16,Vitoria-Gasteiz,expenses,cash,-100.0,-60556.72
buyer_6,Manuel,45,ES29209555094272945666,TRX_N-01049-42197930,2024-06-15T02:33:15,Vitoria-Gasteiz,expenses,food,-78.67,-60635.39
buyer_6,Manuel,45,ES29209555094272945666,TRX_N-01050-65510499,2024-06-15T13:27:58,Vitoria-Gasteiz,expenses,cash,-100.0,-60735.39
buyer_6,Manuel,45,ES29209555094272945666,TRX_N-01051-68799091,2024-06-16T17:58:52,Bermeo,expenses,food,-74.09,-60809.48
buyer_6,Manuel,45,ES29209555094272945666,TRX_N-01052-09874022,2024-06-17T19:46:35,Vitoria-Gasteiz,expenses,cash,-100.0,-60909.48
buyer_6,Manuel,45,ES29209555094272945666,TRX_N-01053-64704177,2024-06-18T15:57:02,Vitoria-Gasteiz,expenses,food,-77.76,-60987.24
buyer_6,Manuel,45,ES29209555094272945666,TRX_N-01054-50191731,2024-06-18T16:13:49,Vitoria-Gasteiz,expenses,cash,-100.0,-61087.24
buyer_6,Manuel,45,ES29209555094272945666,TRX_N-01055-59229902,2024-06-20T13:42:14,Vitoria-Gasteiz,expenses,children,-228.07,-61315.31
buyer_6,Manuel,45,ES29209555094272945666,TRX_N-01056-58785880,2024-06-21T14:11:58,Vitoria-Gasteiz,expenses,leisure,-84.84,-61400.15
buyer_6,Manuel,45,ES29209555094272945666,TRX_N-01057-81249380,2024-06-22T20:08:29,Vitoria-Gasteiz,expenses,leisure,-50.46,-61450.61
buyer_6,Manuel,45,ES29209555094272945666,TRX_N-01058-38702191,2024-06-22T11:06:42,Sestao,expenses,cash,-100.0,-61550.61
buyer_6,Manuel,45,ES29209555094272945666,TRX_N-01059-84526143,2024-06-23T22:47:35,Vitoria-Gasteiz,expenses,leisure,-32.89,-61583.5
buyer_6,Manuel,45,ES29209555094272945666,TRX_N-01060-76918855,2024-06-23T10:48:49,Vitoria-Gasteiz,expenses,gifts,-50.07,-61633.57
buyer_6,Manuel,45,ES29209555094272945666,TRX_N-01061-86890284,2024-06-24T14:22:29,Vitoria-Gasteiz,expenses,gifts,-725.4,-62358.97
buyer_6,Manuel,45,ES29209555094272945666,TRX_N-01062-75794343,2024-06-26T16:42:03,Vitoria-Gasteiz,expenses,leisure,-59.45,-62418.42
buyer_6,Manuel,45,ES29209555094272945666,TRX_N-01063-44999017,2024-06-27T22:59:56,Vitoria-Gasteiz,expenses,food,-76.3,-62494.72
buyer_6,Manuel,45,ES29209555094272945666,TRX_N-01064-41981786,2024-06-28T20:17:41,Santurtzi,expenses,food,-79.65,-62574.37
buyer_6,Manuel,45,ES29209555094272945666,TRX_N-01065-26683038,2024-06-28T12:36:34,Vitoria-Gasteiz,expenses,repairs,-163.7,-62738.07
buyer_6,Manuel,45,ES29209555094272945666,TRX_N-01066-15058906,2024-06-28T13:09:39,Vitoria-Gasteiz,expenses,children,-140.01,-62878.08
buyer_6,Manuel,45,ES29209555094272945666,TRX_N-01067-64694230,2024-07-01T21:28:55,Vitoria-Gasteiz,incomes,salary,1376.71,-61501.37
buyer_6,Manuel,45,ES29209555094272945666,TRX_N-01068-40826173,2024-07-01T21:28:55,Vitoria-Gasteiz,incomes,salary_partner,1288.14,-60213.23
buyer_6,Manuel,45,ES29209555094272945666,TRX_N-01069-27556630,2024-07-03T01:27:27,Vitoria-Gasteiz,expenses,gifts,-199.13,-60412.36
buyer_6,Manuel,45,ES29209555094272945666,TRX_N-01070-05264138,2024-07-04T13:38:58,Vitoria-Gasteiz,expenses,mortgage,-925.72,-61338.08
buyer_6,Manuel,45,ES29209555094272945666,TRX_N-01071-30103856,2024-07-04T17:13:33,Vitoria-Gasteiz,expenses,leisure,-42.65,-61380.73
buyer_6,Manuel,45,ES29209555094272945666,TRX_N-01072-13694059,2024-07-05T18:00:32,Vitoria-Gasteiz,expenses,electricity,-49.68,-61430.41
buyer_6,Manuel,45,ES29209555094272945666,TRX_N-01073-25347258,2024-07-06T12:41:27,Vitoria-Gasteiz,expenses,water,-35.2,-61465.61
buyer_6,Manuel,45,ES29209555094272945666,TRX_N-01074-24352249,2024-07-06T14:27:36,Vitoria-Gasteiz,expenses,phone,-38.3,-61503.91
buyer_6,Manuel,45,ES29209555094272945666,TRX_N-01075-25604936,2024-07-07T16:08:25,Vitoria-Gasteiz,expenses,gas,-69.79,-61573.7
buyer_6,Manuel,45,ES29209555094272945666,TRX_N-01076-99722166,2024-07-07T19:01:17,Vitoria-Gasteiz,expenses,cash,-100.0,-61673.7
buyer_6,Manuel,45,ES29209555094272945666,TRX_N-01077-36889746,2024-07-08T14:21:09,Vitoria-Gasteiz,expenses,internet,-42.0,-61715.7
buyer_6,Manuel,45,ES29209555094272945666,TRX_N-01078-35333442,2024-07-08T06:37:12,Vitoria-Gasteiz,expenses,cash,-100.0,-61815.7
buyer_6,Manuel,45,ES29209555094272945666,TRX_N-01079-62994261,2024-07-10T09:59:36,Vitoria-Gasteiz,expenses,repairs,-317.52,-62133.22
buyer_6,Manuel,45,ES29209555094272945666,TRX_N-01080-39082155,2024-07-13T08:56:34,Vitoria-Gasteiz,expenses,transport,-81.09,-62214.31
buyer_6,Manuel,45,ES29209555094272945666,TRX_N-01081-44001461,2024-07-13T08:31:29,Vitoria-Gasteiz,expenses,education,-66.05,-62280.36
buyer_6,Manuel,45,ES29209555094272945666,TRX_N-01082-22799535,2024-07-13T08:55:41,Vitoria-Gasteiz,expenses,gifts,-54.56,-62334.92
buyer_6,Manuel,45,ES29209555094272945666,TRX_N-01083-82611881,2024-07-14T14:17:08,Vitoria-Gasteiz,expenses,education,-69.73,-62404.65
buyer_6,Manuel,45,ES29209555094272945666,TRX_N-01084-59639613,2024-07-16T21:14:47,Vitoria-Gasteiz,expenses,cash,-100.0,-62504.65
buyer_6,Manuel,45,ES29209555094272945666,TRX_N-01085-83557502,2024-07-17T16:21:07,Vitoria-Gasteiz,expenses,gifts,-360.05,-62864.7
buyer_6,Manuel,45,ES29209555094272945666,TRX_N-01086-59399181,2024-07-18T10:00:04,Vitoria-Gasteiz,expenses,cash,-100.0,-62964.7
buyer_6,Manuel,45,ES29209555094272945666,TRX_N-01087-32443030,2024-07-19T12:31:16,Vitoria-Gasteiz,expenses,leisure,-54.02,-63018.72
buyer_6,Manuel,45,ES29209555094272945666,TRX_N-01088-20841204,2024-07-21T10:01:34,Vitoria-Gasteiz,expenses,clothing,-155.55,-63174.27
buyer_6,Manuel,45,ES29209555094272945666,TRX_N-01089-13336249,2024-07-21T17:01:13,Errenteria,expenses,repairs,-190.52,-63364.79
buyer_6,Manuel,45,ES29209555094272945666,TRX_N-01090-12510781,2024-07-22T11:18:08,Andoain,expenses,cash,-100.0,-63464.79
buyer_6,Manuel,45,ES29209555094272945666,TRX_N-01091-07092482,2024-07-26T20:18:09,Vitoria-Gasteiz,expenses,leisure,-70.32,-63535.11
buyer_6,Manuel,45,ES29209555094272945666,TRX_N-01092-05970679,2024-07-26T03:18:47,Vitoria-Gasteiz,expenses,cash,-100.0,-63635.11
buyer_6,Manuel,45,ES29209555094272945666,TRX_N-01093-37321949,2024-07-26T06:33:36,Vitoria-Gasteiz,expenses,gifts,-250.59,-63885.7
buyer_6,Manuel,45,ES29209555094272945666,TRX_N-01094-75650629,2024-07-28T14:56:18,Vitoria-Gasteiz,expenses,leisure,-61.1,-63946.8
buyer_6,Manuel,45,ES29209555094272945666,TRX_N-01095-31589569,2024-07-28T10:18:36,Leioa,expenses,cash,-100.0,-64046.8
buyer_6,Manuel,45,ES29209555094272945666,TRX_N-01096-05666071,2024-07-29T16:21:01,Vitoria-Gasteiz,expenses,healthcare,-92.24,-64139.04
buyer_6,Manuel,45,ES29209555094272945666,TRX_N-01097-76601518,2024-07-30T12:33:27,Basauri,expenses,gifts,-661.14,-64800.18
buyer_6,Manuel,45,ES29209555094272945666,TRX_N-01098-90790046,2024-07-31T19:18:18,Sestao,expenses,food,-68.31,-64868.49
buyer_6,Manuel,45,ES29209555094272945666,TRX_N-01099-84289024,2024-07-31T13:03:45,Vitoria-Gasteiz,expenses,healthcare,-178.62,-65047.11
buyer_6,Manuel,45,ES29209555094272945666,TRX_N-01100-29579033,2024-08-01T16:43:02,Vitoria-Gasteiz,incomes,salary,1376.71,-63670.4
buyer_6,Manuel,45,ES29209555094272945666,TRX_N-01101-61583426,2024-08-01T16:43:02,Vitoria-Gasteiz,incomes,salary_partner,1288.14,-62382.26
buyer_6,Manuel,45,ES29209555094272945666,TRX_N-01102-56489725,2024-08-01T11:22:39,Vitoria-Gasteiz,expenses,gifts,-650.01,-63032.27
buyer_6,Manuel,45,ES29209555094272945666,TRX_N-01103-14502277,2024-08-03T09:01:27,Vitoria-Gasteiz,expenses,food,-65.77,-63098.04
buyer_6,Manuel,45,ES29209555094272945666,TRX_N-01104-79445968,2024-08-04T18:22:56,Vitoria-Gasteiz,expenses,mortgage,-925.72,-64023.76
buyer_6,Manuel,45,ES29209555094272945666,TRX_N-01105-90868123,2024-08-04T12:42:33,Vitoria-Gasteiz,expenses,leisure,-59.05,-64082.81
buyer_6,Manuel,45,ES29209555094272945666,TRX_N-01106-82735730,2024-08-05T09:09:06,Vitoria-Gasteiz,expenses,water,-36.75,-64119.56
buyer_6,Manuel,45,ES29209555094272945666,TRX_N-01107-61027783,2024-08-05T14:54:03,Vitoria-Gasteiz,expenses,electricity,-59.0,-64178.56
buyer_6,Manuel,45,ES29209555094272945666,TRX_N-01108-16324642,2024-08-05T16:16:59,Vitoria-Gasteiz,expenses,gifts,-816.89,-64995.45
buyer_6,Manuel,45,ES29209555094272945666,TRX_N-01109-74581670,2024-08-06T10:30:59,Vitoria-Gasteiz,expenses,leisure,-23.64,-65019.09
buyer_6,Manuel,45,ES29209555094272945666,TRX_N-01110-43526761,2024-08-07T11:03:40,Vitoria-Gasteiz,expenses,gas,-58.85,-65077.94
buyer_6,Manuel,45,ES29209555094272945666,TRX_N-01111-74740688,2024-08-08T15:23:29,Vitoria-Gasteiz,expenses,internet,-42.0,-65119.94
buyer_6,Manuel,45,ES29209555094272945666,TRX_N-01112-71635528,2024-08-08T04:53:56,Vitoria-Gasteiz,expenses,phone,-41.68,-65161.62
buyer_6,Manuel,45,ES29209555094272945666,TRX_N-01113-49583985,2024-08-08T09:41:16,Vitoria-Gasteiz,expenses,transport,-48.57,-65210.19
buyer_6,Manuel,45,ES29209555094272945666,TRX_N-01114-81238272,2024-08-12T06:16:08,Iruña de Oca,expenses,food,-115.47,-65325.66
buyer_6,Manuel,45,ES29209555094272945666,TRX_N-01115-74123319,2024-08-12T23:28:14,Vitoria-Gasteiz,expenses,leisure,-78.92,-65404.58
buyer_6,Manuel,45,ES29209555094272945666,TRX_N-01116-59555540,2024-08-13T15:19:36,Zarautz,expenses,clothing,-149.83,-65554.41
buyer_6,Manuel,45,ES29209555094272945666,TRX_N-01117-77000415,2024-08-14T16:13:09,Vitoria-Gasteiz,expenses,food,-112.27,-65666.68
buyer_6,Manuel,45,ES29209555094272945666,TRX_N-01118-54014883,2024-08-15T16:03:00,Vitoria-Gasteiz,expenses,transport,-81.19,-65747.87
buyer_6,Manuel,45,ES29209555094272945666,TRX_N-01119-63692220,2024-08-15T23:58:33,Vitoria-Gasteiz,expenses,cash,-100.0,-65847.87
buyer_6,Manuel,45,ES29209555094272945666,TRX_N-01120-85013189,2024-08-18T01:58:09,Vitoria-Gasteiz,expenses,repairs,-280.69,-66128.56
buyer_6,Manuel,45,ES29209555094272945666,TRX_N-01121-90170526,2024-08-21T13:17:02,Vitoria-Gasteiz,expenses,repairs,-294.71,-66423.27
buyer_6,Manuel,45,ES29209555094272945666,TRX_N-01122-96280683,2024-08-22T09:04:32,Bermeo,expenses,cash,-100.0,-66523.27
buyer_6,Manuel,45,ES29209555094272945666,TRX_N-01123-64744195,2024-08-22T11:54:32,Bilbao,expenses,repairs,-156.75,-66680.02
buyer_6,Manuel,45,ES29209555094272945666,TRX_N-01124-16200935,2024-08-23T09:07:22,Vitoria-Gasteiz,expenses,food,-122.25,-66802.27
buyer_6,Manuel,45,ES29209555094272945666,TRX_N-01125-70007346,2024-08-24T13:31:44,Vitoria-Gasteiz,expenses,cash,-100.0,-66902.27
buyer_6,Manuel,45,ES29209555094272945666,TRX_N-01126-48445203,2024-08-24T17:30:50,Vitoria-Gasteiz,expenses,children,-253.5,-67155.77
buyer_6,Manuel,45,ES29209555094272945666,TRX_N-01127-08133274,2024-08-26T00:44:21,Basauri,expenses,gifts,-831.09,-67986.86
buyer_6,Manuel,45,ES29209555094272945666,TRX_N-01128-87084384,2024-08-28T14:52:50,Vitoria-Gasteiz,expenses,food,-82.97,-68069.83
buyer_6,Manuel,45,ES29209555094272945666,TRX_N-01129-13934115,2024-08-28T19:06:18,Vitoria-Gasteiz,expenses,repairs,-254.86,-68324.69
buyer_6,Manuel,45,ES29209555094272945666,TRX_N-01130-03149500,2024-08-30T12:45:44,Vitoria-Gasteiz,expenses,food,-60.12,-68384.81
buyer_6,Manuel,45,ES29209555094272945666,TRX_N-01131-83076118,2024-08-31T14:23:06,Vitoria-Gasteiz,expenses,food,-112.34,-68497.15
buyer_6,Manuel,45,ES29209555094272945666,TRX_N-01132-07497294,2024-09-01T13:20:42,Vitoria-Gasteiz,incomes,salary,1376.71,-67120.44
buyer_6,Manuel,45,ES29209555094272945666,TRX_N-01133-82265893,2024-09-01T13:20:42,Vitoria-Gasteiz,incomes,salary_partner,1288.14,-65832.3
buyer_6,Manuel,45,ES29209555094272945666,TRX_N-01134-01160995,2024-09-01T13:20:42,Vitoria-Gasteiz,incomes,extra_income,247.42,-65584.88
buyer_6,Manuel,45,ES29209555094272945666,TRX_N-01135-47592776,2024-09-02T13:30:02,Vitoria-Gasteiz,expenses,children,-109.08,-65693.96
buyer_6,Manuel,45,ES29209555094272945666,TRX_N-01136-01770764,2024-09-04T20:14:04,Vitoria-Gasteiz,expenses,mortgage,-925.72,-66619.68
buyer_6,Manuel,45,ES29209555094272945666,TRX_N-01137-37128705,2024-09-05T08:02:54,Vitoria-Gasteiz,expenses,water,-37.5,-66657.18
buyer_6,Manuel,45,ES29209555094272945666,TRX_N-01138-56828733,2024-09-05T14:29:49,Vitoria-Gasteiz,expenses,gas,-102.0,-66759.18
buyer_6,Manuel,45,ES29209555094272945666,TRX_N-01139-24878181,2024-09-06T15:31:00,Vitoria-Gasteiz,expenses,phone,-37.32,-66796.5
buyer_6,Manuel,45,ES29209555094272945666,TRX_N-01140-32821500,2024-09-06T14:32:04,Vitoria-Gasteiz,expenses,transport,-41.6,-66838.1
buyer_6,Manuel,45,ES29209555094272945666,TRX_N-01141-58457047,2024-09-07T17:58:06,Vitoria-Gasteiz,expenses,internet,-42.0,-66880.1
buyer_6,Manuel,45,ES29209555094272945666,TRX_N-01142-92481399,2024-09-08T16:17:05,Vitoria-Gasteiz,expenses,electricity,-68.34,-66948.44
buyer_6,Manuel,45,ES29209555094272945666,TRX_N-01143-83548902,2024-09-09T10:00:37,Vitoria-Gasteiz,expenses,food,-119.04,-67067.48
buyer_6,Manuel,45,ES29209555094272945666,TRX_N-01144-70785544,2024-09-09T05:44:06,Vitoria-Gasteiz,expenses,cash,-100.0,-67167.48
buyer_6,Manuel,45,ES29209555094272945666,TRX_N-01145-37547747,2024-09-09T15:57:27,Vitoria-Gasteiz,expenses,gifts,-445.83,-67613.31
buyer_6,Manuel,45,ES29209555094272945666,TRX_N-01146-47998732,2024-09-10T13:33:03,Vitoria-Gasteiz,expenses,healthcare,-186.38,-67799.69
buyer_6,Manuel,45,ES29209555094272945666,TRX_N-01147-87456326,2024-09-11T08:15:24,Getxo,expenses,repairs,-59.41,-67859.1
buyer_6,Manuel,45,ES29209555094272945666,TRX_N-01148-52434102,2024-09-12T14:31:41,Getxo,expenses,leisure,-65.06,-67924.16
buyer_6,Manuel,45,ES29209555094272945666,TRX_N-01149-61242879,2024-09-12T10:40:35,Iruña de Oca,expenses,cash,-100.0,-68024.16
buyer_6,Manuel,45,ES29209555094272945666,TRX_N-01150-22890118,2024-09-13T04:06:24,Vitoria-Gasteiz,expenses,leisure,-83.61,-68107.77
buyer_6,Manuel,45,ES29209555094272945666,TRX_N-01151-17558284,2024-09-16T13:22:39,Vitoria-Gasteiz,expenses,food,-88.84,-68196.61
buyer_6,Manuel,45,ES29209555094272945666,TRX_N-01152-86078323,2024-09-16T20:40:38,Vitoria-Gasteiz,expenses,cash,-100.0,-68296.61
buyer_6,Manuel,45,ES29209555094272945666,TRX_N-01153-99494766,2024-09-16T14:40:25,Vitoria-Gasteiz,expenses,appliances,-205.11,-68501.72
buyer_6,Manuel,45,ES29209555094272945666,TRX_N-01154-84542431,2024-09-17T14:20:20,Vitoria-Gasteiz,expenses,transport,-81.79,-68583.51
buyer_6,Manuel,45,ES29209555094272945666,TRX_N-01155-62009900,2024-09-17T14:21:14,Vitoria-Gasteiz,expenses,education,-56.93,-68640.44
buyer_6,Manuel,45,ES29209555094272945666,TRX_N-01156-40559717,2024-09-19T19:12:01,Portugalete,expenses,food,-89.25,-68729.69
buyer_6,Manuel,45,ES29209555094272945666,TRX_N-01157-27119029,2024-09-19T09:22:32,Barakaldo,expenses,cash,-100.0,-68829.69
buyer_6,Manuel,45,ES29209555094272945666,TRX_N-01158-41946572,2024-09-20T17:32:18,Sopela,expenses,education,-57.49,-68887.18
buyer_6,Manuel,45,ES29209555094272945666,TRX_N-01159-83956053,2024-09-23T08:51:36,Vitoria-Gasteiz,expenses,cash,-100.0,-68987.18
buyer_6,Manuel,45,ES29209555094272945666,TRX_N-01160-61575884,2024-09-23T13:11:29,Zarautz,expenses,gifts,-739.48,-69726.66
buyer_6,Manuel,45,ES29209555094272945666,TRX_N-01161-66853190,2024-09-29T19:19:44,Vitoria-Gasteiz,expenses,gifts,-31.48,-69758.14
buyer_6,Manuel,45,ES29209555094272945666,TRX_N-01162-97429971,2024-09-30T22:02:50,Vitoria-Gasteiz,expenses,food,-60.44,-69818.58
buyer_6,Manuel,45,ES29209555094272945666,TRX_N-01163-10538160,2024-09-30T04:44:21,Basauri,expenses,cash,-100.0,-69918.58
buyer_6,Manuel,45,ES29209555094272945666,TRX_N-01164-71945746,2024-10-01T06:53:41,Vitoria-Gasteiz,incomes,salary,1376.71,-68541.87
buyer_6,Manuel,45,ES29209555094272945666,TRX_N-01165-82765911,2024-10-01T06:53:41,Vitoria-Gasteiz,incomes,salary_partner,1288.14,-67253.73
buyer_6,Manuel,45,ES29209555094272945666,TRX_N-01166-01221315,2024-10-01T18:10:07,Vitoria-Gasteiz,expenses,transport,-41.42,-67295.15
buyer_6,Manuel,45,ES29209555094272945666,TRX_N-01167-44111893,2024-10-02T17:43:30,Vitoria-Gasteiz,expenses,cash,-100.0,-67395.15
buyer_6,Manuel,45,ES29209555094272945666,TRX_N-01168-00582688,2024-10-03T20:07:26,Vitoria-Gasteiz,expenses,repairs,-206.16,-67601.31
buyer_6,Manuel,45,ES29209555094272945666,TRX_N-01169-98342153,2024-10-04T16:26:50,Vitoria-Gasteiz,expenses,mortgage,-925.72,-68527.03
buyer_6,Manuel,45,ES29209555094272945666,TRX_N-01170-46092213,2024-10-04T14:47:20,Vitoria-Gasteiz,expenses,cash,-100.0,-68627.03
buyer_6,Manuel,45,ES29209555094272945666,TRX_N-01171-16016175,2024-10-05T13:42:57,Vitoria-Gasteiz,expenses,electricity,-46.75,-68673.78
buyer_6,Manuel,45,ES29209555094272945666,TRX_N-01172-97745224,2024-10-05T23:03:02,Vitoria-Gasteiz,expenses,gas,-74.76,-68748.54
buyer_6,Manuel,45,ES29209555094272945666,TRX_N-01173-29152770,2024-10-05T20:17:00,Vitoria-Gasteiz,expenses,food,-112.68,-68861.22
buyer_6,Manuel,45,ES29209555094272945666,TRX_N-01174-19183736,2024-10-05T14:23:06,Vitoria-Gasteiz,expenses,children,-201.09,-69062.31
buyer_6,Manuel,45,ES29209555094272945666,TRX_N-01175-67657947,2024-10-07T06:11:33,Vitoria-Gasteiz,expenses,water,-26.98,-69089.29
buyer_6,Manuel,45,ES29209555094272945666,TRX_N-01176-90761511,2024-10-07T23:33:18,Vitoria-Gasteiz,expenses,repairs,-310.92,-69400.21
buyer_6,Manuel,45,ES29209555094272945666,TRX_N-01177-96638378,2024-10-08T10:24:42,Vitoria-Gasteiz,expenses,internet,-42.0,-69442.21
buyer_6,Manuel,45,ES29209555094272945666,TRX_N-01178-75270052,2024-10-08T19:02:01,Vitoria-Gasteiz,expenses,phone,-41.96,-69484.17
buyer_6,Manuel,45,ES29209555094272945666,TRX_N-01179-83305222,2024-10-08T11:06:47,Vitoria-Gasteiz,expenses,children,-169.47,-69653.64
buyer_7,María,56,ES12209529607663493637,TRX_N-00001-60524782,2022-01-01T09:41:46,Portugalete,incomes,salary,1508.12,3068.79
buyer_7,María,56,ES12209529607663493637,TRX_N-00002-79972411,2022-01-01T09:41:46,Portugalete,incomes,salary_partner,1548.46,4617.25
buyer_7,María,56,ES12209529607663493637,TRX_N-00003-57404587,2022-01-01T11:25:55,Labastida,expenses,transport,-65.42,4551.83
buyer_7,María,56,ES12209529607663493637,TRX_N-00004-75734840,2022-01-01T09:27:21,Portugalete,expenses,children,-119.38,4432.45
buyer_7,María,56,ES12209529607663493637,TRX_N-00005-02779925,2022-01-02T12:06:07,Berango,expenses,cash,-100.0,4332.45
buyer_7,María,56,ES12209529607663493637,TRX_N-00006-43391860,2022-01-04T15:27:29,Portugalete,expenses,mortgage,-717.72,3614.73
buyer_7,María,56,ES12209529607663493637,TRX_N-00007-32667999,2022-01-05T09:49:24,Portugalete,expenses,gas,-45.8,3568.93
buyer_7,María,56,ES12209529607663493637,TRX_N-00008-78878093,2022-01-05T19:06:25,Portugalete,expenses,phone,-34.87,3534.06
buyer_7,María,56,ES12209529607663493637,TRX_N-00009-31829691,2022-01-05T11:37:27,Getxo,expenses,cash,-100.0,3434.06
buyer_7,María,56,ES12209529607663493637,TRX_N-00010-55467926,2022-01-05T13:17:15,Portugalete,expenses,appliances,-390.74,3043.32
buyer_7,María,56,ES12209529607663493637,TRX_N-00011-75090729,2022-01-05T16:16:35,Portugalete,expenses,children,-268.71,2774.61
buyer_7,María,56,ES12209529607663493637,TRX_N-00012-72315382,2022-01-06T10:23:17,Portugalete,expenses,cash,-100.0,2674.61
buyer_7,María,56,ES12209529607663493637,TRX_N-00013-22034315,2022-01-07T17:45:53,Portugalete,expenses,transport,-40.12,2634.49
buyer_7,María,56,ES12209529607663493637,TRX_N-00014-67710019,2022-01-07T12:10:10,Portugalete,expenses,appliances,-257.29,2377.2
buyer_7,María,56,ES12209529607663493637,TRX_N-00015-87997383,2022-01-07T15:34:29,Portugalete,expenses,gifts,-211.97,2165.23
buyer_7,María,56,ES12209529607663493637,TRX_N-00016-91561240,2022-01-08T09:03:36,Portugalete,expenses,water,-21.11,2144.12
buyer_7,María,56,ES12209529607663493637,TRX_N-00017-97565206,2022-01-08T08:36:17,Portugalete,expenses,electricity,-32.1,2112.02
buyer_7,María,56,ES12209529607663493637,TRX_N-00018-85618391,2022-01-08T10:10:28,Portugalete,expenses,internet,-42.0,2070.02
buyer_7,María,56,ES12209529607663493637,TRX_N-00019-10853789,2022-01-09T20:04:56,Irun,expenses,food,-69.61,2000.41
buyer_7,María,56,ES12209529607663493637,TRX_N-00020-16886140,2022-01-12T09:43:06,Portugalete,expenses,children,-95.68,1904.73
buyer_7,María,56,ES12209529607663493637,TRX_N-00021-48533525,2022-01-13T11:39:26,Portugalete,expenses,transport,-40.47,1864.26
buyer_7,María,56,ES12209529607663493637,TRX_N-00022-15209907,2022-01-13T20:30:38,Vitoria-Gasteiz,expenses,cash,-100.0,1764.26
buyer_7,María,56,ES12209529607663493637,TRX_N-00023-81419450,2022-01-13T04:49:16,Portugalete,expenses,repairs,-224.69,1539.57
buyer_7,María,56,ES12209529607663493637,TRX_N-00024-49895453,2022-01-14T16:02:38,Portugalete,expenses,children,-65.16,1474.41
buyer_7,María,56,ES12209529607663493637,TRX_N-00025-42306810,2022-01-15T19:09:19,Portugalete,expenses,transport,-68.54,1405.87
buyer_7,María,56,ES12209529607663493637,TRX_N-00026-06496130,2022-01-15T16:43:20,Bermeo,expenses,cash,-100.0,1305.87
buyer_7,María,56,ES12209529607663493637,TRX_N-00027-32600969,2022-01-15T09:32:31,Portugalete,expenses,children,-76.02,1229.85
buyer_7,María,56,ES12209529607663493637,TRX_N-00028-66778994,2022-01-17T19:48:48,Portugalete,expenses,leisure,-18.33,1211.52
buyer_7,María,56,ES12209529607663493637,TRX_N-00029-79297497,2022-01-17T14:59:35,Portugalete,expenses,repairs,-193.48,1018.04
buyer_7,María,56,ES12209529607663493637,TRX_N-00030-16543194,2022-01-18T18:43:54,Portugalete,expenses,food,-83.93,934.11
buyer_7,María,56,ES12209529607663493637,TRX_N-00031-36136005,2022-01-19T14:06:05,Portugalete,expenses,appliances,-363.27,570.84
buyer_7,María,56,ES12209529607663493637,TRX_N-00032-80564539,2022-01-20T13:23:56,Portugalete,expenses,gifts,-47.0,523.84
buyer_7,María,56,ES12209529607663493637,TRX_N-00033-20115883,2022-01-21T19:47:19,Hondarribia,expenses,food,-68.48,455.36
buyer_7,María,56,ES12209529607663493637,TRX_N-00034-90737465,2022-01-21T22:03:05,Barakaldo,expenses,cash,-100.0,355.36
buyer_7,María,56,ES12209529607663493637,TRX_N-00035-54488923,2022-01-22T12:24:13,Portugalete,expenses,food,-81.69,273.67
buyer_7,María,56,ES12209529607663493637,TRX_N-00036-27605954,2022-01-22T14:36:12,Sopela,expenses,education,-56.05,217.62
buyer_7,María,56,ES12209529607663493637,TRX_N-00037-50592526,2022-01-25T12:01:59,Portugalete,expenses,cash,-100.0,117.62
buyer_7,María,56,ES12209529607663493637,TRX_N-00038-65503455,2022-01-25T10:06:36,Portugalete,expenses,appliances,-311.41,-193.79
buyer_7,María,56,ES12209529607663493637,TRX_N-00039-76928761,2022-01-26T08:52:21,Portugalete,expenses,transport,-58.93,-252.72
buyer_7,María,56,ES12209529607663493637,TRX_N-00040-66041743,2022-01-26T13:33:03,Portugalete,expenses,children,-84.79,-337.51
buyer_7,María,56,ES12209529607663493637,TRX_N-00041-28192996,2022-01-28T20:02:52,Portugalete,expenses,food,-103.75,-441.26
buyer_7,María,56,ES12209529607663493637,TRX_N-00042-93545533,2022-01-28T11:17:34,Zarautz,expenses,leisure,-67.33,-508.59
buyer_7,María,56,ES12209529607663493637,TRX_N-00043-64679723,2022-01-28T23:12:45,Portugalete,expenses,education,-62.72,-571.31
buyer_7,María,56,ES12209529607663493637,TRX_N-00044-01425258,2022-01-28T07:06:39,Portugalete,expenses,appliances,-368.92,-940.23
buyer_7,María,56,ES12209529607663493637,TRX_N-00045-30874643,2022-01-29T15:10:17,Portugalete,expenses,gifts,-297.83,-1238.06
buyer_7,María,56,ES12209529607663493637,TRX_N-00046-91432254,2022-01-30T09:25:05,Portugalete,expenses,clothing,-155.86,-1393.92
buyer_7,María,56,ES12209529607663493637,TRX_N-00047-59951643,2022-02-01T12:44:21,Portugalete,incomes,salary,1508.12,114.2
buyer_7,María,56,ES12209529607663493637,TRX_N-00048-06616322,2022-02-01T12:44:21,Portugalete,incomes,salary_partner,1548.46,1662.66
buyer_7,María,56,ES12209529607663493637,TRX_N-00049-65450589,2022-02-02T18:08:37,Donostia,expenses,transport,-58.61,1604.05
buyer_7,María,56,ES12209529607663493637,TRX_N-00050-14185950,2022-02-02T23:28:09,Portugalete,expenses,children,-159.25,1444.8
buyer_7,María,56,ES12209529607663493637,TRX_N-00051-25116428,2022-02-03T15:44:08,Oyón-Oion,expenses,food,-64.65,1380.15
buyer_7,María,56,ES12209529607663493637,TRX_N-00052-33422596,2022-02-03T13:39:45,Portugalete,expenses,transport,-47.77,1332.38
buyer_7,María,56,ES12209529607663493637,TRX_N-00053-34356259,2022-02-03T12:28:35,Zarautz,expenses,appliances,-270.51,1061.87
buyer_7,María,56,ES12209529607663493637,TRX_N-00054-59188960,2022-02-04T11:12:08,Portugalete,expenses,mortgage,-717.72,344.15
buyer_7,María,56,ES12209529607663493637,TRX_N-00055-02760222,2022-02-04T21:46:44,Portugalete,expenses,leisure,-74.45,269.7
buyer_7,María,56,ES12209529607663493637,TRX_N-00056-37544846,2022-02-04T11:15:31,Portugalete,expenses,clothing,-57.98,211.72
buyer_7,María,56,ES12209529607663493637,TRX_N-00057-67564166,2022-02-04T10:27:13,Portugalete,expenses,cash,-100.0,111.72
buyer_7,María,56,ES12209529607663493637,TRX_N-00058-93686674,2022-02-05T10:07:23,Portugalete,expenses,phone,-33.39,78.33
buyer_7,María,56,ES12209529607663493637,TRX_N-00059-30119341,2022-02-05T09:37:26,Portugalete,expenses,appliances,-151.46,-73.13
buyer_7,María,56,ES12209529607663493637,TRX_N-00060-34677893,2022-02-06T10:18:02,Portugalete,expenses,water,-35.06,-108.19
buyer_7,María,56,ES12209529607663493637,TRX_N-00061-55463945,2022-02-06T12:45:44,Portugalete,expenses,electricity,-56.91,-165.1
buyer_7,María,56,ES12209529607663493637,TRX_N-00062-44954297,2022-02-06T12:51:41,Portugalete,expenses,transport,-47.32,-212.42
buyer_7,María,56,ES12209529607663493637,TRX_N-00063-14585321,2022-02-06T11:54:35,Irun,expenses,healthcare,-182.45,-394.87
buyer_7,María,56,ES12209529607663493637,TRX_N-00064-07576790,2022-02-06T08:48:23,Portugalete,expenses,cash,-100.0,-494.87
buyer_7,María,56,ES12209529607663493637,TRX_N-00065-85438985,2022-02-06T18:05:48,Portugalete,expenses,repairs,-216.3,-711.17
buyer_7,María,56,ES12209529607663493637,TRX_N-00066-74654281,2022-02-07T13:08:30,Portugalete,expenses,internet,-42.0,-753.17
buyer_7,María,56,ES12209529607663493637,TRX_N-00067-70936247,2022-02-08T17:00:08,Portugalete,expenses,gas,-33.43,-786.6
buyer_7,María,56,ES12209529607663493637,TRX_N-00068-56119939,2022-02-08T11:12:29,Portugalete,expenses,leisure,-78.13,-864.73
buyer_7,María,56,ES12209529607663493637,TRX_N-00069-59716748,2022-02-08T19:32:00,Portugalete,expenses,cash,-100.0,-964.73
buyer_7,María,56,ES12209529607663493637,TRX_N-00070-68576707,2022-02-08T09:54:16,Hondarribia,expenses,gifts,-520.74,-1485.47
buyer_7,María,56,ES12209529607663493637,TRX_N-00071-60561659,2022-02-09T14:14:51,Portugalete,expenses,leisure,-42.88,-1528.35
buyer_7,María,56,ES12209529607663493637,TRX_N-00072-13651135,2022-02-09T16:56:51,Portugalete,expenses,cash,-100.0,-1628.35
buyer_7,María,56,ES12209529607663493637,TRX_N-00073-67309540,2022-02-09T16:42:28,Portugalete,expenses,repairs,-295.6,-1923.95
buyer_7,María,56,ES12209529607663493637,TRX_N-00074-75568677,2022-02-10T13:43:27,Portugalete,expenses,clothing,-103.74,-2027.69
buyer_7,María,56,ES12209529607663493637,TRX_N-00075-45832493,2022-02-10T20:37:55,Portugalete,expenses,children,-162.44,-2190.13
buyer_7,María,56,ES12209529607663493637,TRX_N-00076-25762321,2022-02-12T13:52:33,Portugalete,expenses,cash,-100.0,-2290.13
buyer_7,María,56,ES12209529607663493637,TRX_N-00077-34710529,2022-02-13T13:24:30,Portugalete,expenses,leisure,-69.17,-2359.3
buyer_7,María,56,ES12209529607663493637,TRX_N-00078-05823888,2022-02-18T08:01:00,Elciego,expenses,food,-93.45,-2452.75
buyer_7,María,56,ES12209529607663493637,TRX_N-00079-00467876,2022-02-20T15:14:26,Portugalete,expenses,food,-117.84,-2570.59
buyer_7,María,56,ES12209529607663493637,TRX_N-00080-09419419,2022-02-20T10:07:39,Portugalete,expenses,cash,-100.0,-2670.59
buyer_7,María,56,ES12209529607663493637,TRX_N-00081-87061424,2022-02-23T15:46:10,Portugalete,expenses,repairs,-106.65,-2777.24
buyer_7,María,56,ES12209529607663493637,TRX_N-00082-75139477,2022-02-24T20:22:23,Portugalete,expenses,travel,-711.64,-3488.88
buyer_7,María,56,ES12209529607663493637,TRX_N-00083-06777169,2022-02-26T08:50:44,Bilbao,expenses,leisure,-23.1,-3511.98
buyer_7,María,56,ES12209529607663493637,TRX_N-00084-41359341,2022-02-26T10:13:39,Portugalete,expenses,clothing,-133.56,-3645.54
buyer_7,María,56,ES12209529607663493637,TRX_N-00085-49004577,2022-03-01T15:52:49,Portugalete,incomes,salary,1508.12,-2137.42
buyer_7,María,56,ES12209529607663493637,TRX_N-00086-76730762,2022-03-01T15:52:49,Portugalete,incomes,salary_partner,1548.46,-588.96
buyer_7,María,56,ES12209529607663493637,TRX_N-00087-61741805,2022-03-01T15:52:49,Portugalete,incomes,extra_income,243.65,-345.31
buyer_7,María,56,ES12209529607663493637,TRX_N-00088-42446512,2022-03-04T19:38:16,Portugalete,expenses,mortgage,-717.72,-1063.03
buyer_7,María,56,ES12209529607663493637,TRX_N-00089-84678837,2022-03-05T13:38:00,Portugalete,expenses,phone,-41.95,-1104.98
buyer_7,María,56,ES12209529607663493637,TRX_N-00090-94227691,2022-03-05T16:21:33,Portugalete,expenses,transport,-87.85,-1192.83
buyer_7,María,56,ES12209529607663493637,TRX_N-00091-96050191,2022-03-05T18:04:54,Portugalete,expenses,leisure,-38.02,-1230.85
buyer_7,María,56,ES12209529607663493637,TRX_N-00092-90403753,2022-03-06T08:17:20,Portugalete,expenses,water,-30.74,-1261.59
buyer_7,María,56,ES12209529607663493637,TRX_N-00093-20627185,2022-03-06T19:05:25,Portugalete,expenses,electricity,-64.22,-1325.81
buyer_7,María,56,ES12209529607663493637,TRX_N-00094-68262615,2022-03-06T15:52:35,Portugalete,expenses,food,-63.11,-1388.92
buyer_7,María,56,ES12209529607663493637,TRX_N-00095-34883763,2022-03-08T02:47:11,Portugalete,expenses,gas,-35.73,-1424.65
buyer_7,María,56,ES12209529607663493637,TRX_N-00096-69506581,2022-03-08T13:25:05,Portugalete,expenses,internet,-42.0,-1466.65
buyer_7,María,56,ES12209529607663493637,TRX_N-00097-48218431,2022-03-10T09:58:06,Portugalete,expenses,food,-107.18,-1573.83
buyer_7,María,56,ES12209529607663493637,TRX_N-00098-47780505,2022-03-10T09:15:53,Portugalete,expenses,leisure,-46.23,-1620.06
buyer_7,María,56,ES12209529607663493637,TRX_N-00099-02788343,2022-03-11T13:10:27,Portugalete,expenses,healthcare,-103.6,-1723.66
buyer_7,María,56,ES12209529607663493637,TRX_N-00100-06133224,2022-03-13T16:35:52,Portugalete,expenses,repairs,-196.58,-1920.24
buyer_7,María,56,ES12209529607663493637,TRX_N-00101-20897365,2022-03-14T15:56:17,Zuia,expenses,cash,-100.0,-2020.24
buyer_7,María,56,ES12209529607663493637,TRX_N-00102-32251989,2022-03-16T17:37:52,Portugalete,expenses,food,-86.89,-2107.13
buyer_7,María,56,ES12209529607663493637,TRX_N-00103-29683035,2022-03-16T12:27:58,Portugalete,expenses,leisure,-38.32,-2145.45
buyer_7,María,56,ES12209529607663493637,TRX_N-00104-62918159,2022-03-19T16:58:21,Portugalete,expenses,leisure,-53.6,-2199.05
buyer_7,María,56,ES12209529607663493637,TRX_N-00105-71792651,2022-03-19T18:03:25,Portugalete,expenses,cash,-100.0,-2299.05
buyer_7,María,56,ES12209529607663493637,TRX_N-00106-81686569,2022-03-20T09:27:57,Portugalete,expenses,cash,-100.0,-2399.05
buyer_7,María,56,ES12209529607663493637,TRX_N-00107-89099381,2022-03-20T13:15:55,Galdakao,expenses,travel,-998.91,-3397.96
buyer_7,María,56,ES12209529607663493637,TRX_N-00108-61648026,2022-03-23T17:10:45,Portugalete,expenses,clothing,-87.75,-3485.71
buyer_7,María,56,ES12209529607663493637,TRX_N-00109-52280819,2022-03-24T13:33:02,Portugalete,expenses,food,-71.73,-3557.44
buyer_7,María,56,ES12209529607663493637,TRX_N-00110-74761896,2022-03-26T20:33:28,Portugalete,expenses,food,-113.83,-3671.27
buyer_7,María,56,ES12209529607663493637,TRX_N-00111-87344199,2022-03-30T16:49:47,Portugalete,expenses,healthcare,-93.83,-3765.1
buyer_7,María,56,ES12209529607663493637,TRX_N-00112-27048379,2022-03-31T15:03:38,Portugalete,expenses,transport,-46.84,-3811.94
buyer_7,María,56,ES12209529607663493637,TRX_N-00113-71821813,2022-04-01T09:54:06,Portugalete,incomes,salary,1508.12,-2303.82
buyer_7,María,56,ES12209529607663493637,TRX_N-00114-20742518,2022-04-01T09:54:06,Portugalete,incomes,salary_partner,1548.46,-755.36
buyer_7,María,56,ES12209529607663493637,TRX_N-00115-45596338,2022-04-04T15:57:53,Portugalete,expenses,mortgage,-717.72,-1473.08
buyer_7,María,56,ES12209529607663493637,TRX_N-00116-40010000,2022-04-04T23:57:00,Portugalete,expenses,leisure,-78.03,-1551.11
buyer_7,María,56,ES12209529607663493637,TRX_N-00117-35598395,2022-04-05T15:36:17,Portugalete,expenses,internet,-42.0,-1593.11
buyer_7,María,56,ES12209529607663493637,TRX_N-00118-97299479,2022-04-06T19:26:19,Portugalete,expenses,electricity,-84.98,-1678.09
buyer_7,María,56,ES12209529607663493637,TRX_N-00119-62691082,2022-04-06T12:47:19,Portugalete,expenses,gas,-59.5,-1737.59
buyer_7,María,56,ES12209529607663493637,TRX_N-00120-06505416,2022-04-08T16:39:10,Portugalete,expenses,water,-36.98,-1774.57
buyer_7,María,56,ES12209529607663493637,TRX_N-00121-55636922,2022-04-08T02:35:25,Portugalete,expenses,phone,-41.1,-1815.67
buyer_7,María,56,ES12209529607663493637,TRX_N-00122-93081139,2022-04-08T13:20:16,Portugalete,expenses,cash,-100.0,-1915.67
buyer_7,María,56,ES12209529607663493637,TRX_N-00123-71235469,2022-04-08T05:26:34,Portugalete,expenses,repairs,-73.43,-1989.1
buyer_7,María,56,ES12209529607663493637,TRX_N-00124-95754939,2022-04-10T11:13:39,Portugalete,expenses,transport,-46.22,-2035.32
buyer_7,María,56,ES12209529607663493637,TRX_N-00125-52266097,2022-04-10T12:54:28,Portugalete,expenses,cash,-100.0,-2135.32
buyer_7,María,56,ES12209529607663493637,TRX_N-00126-61240633,2022-04-12T08:24:53,Portugalete,expenses,children,-65.1,-2200.42
buyer_7,María,56,ES12209529607663493637,TRX_N-00127-64115833,2022-04-14T13:01:41,Portugalete,expenses,education,-63.62,-2264.04
buyer_7,María,56,ES12209529607663493637,TRX_N-00128-47061521,2022-04-15T09:23:41,Portugalete,expenses,leisure,-58.52,-2322.56
buyer_7,María,56,ES12209529607663493637,TRX_N-00129-59365903,2022-04-17T08:58:36,Portugalete,expenses,repairs,-258.64,-2581.2
buyer_7,María,56,ES12209529607663493637,TRX_N-00130-05969787,2022-04-19T13:39:44,Hondarribia,expenses,food,-83.85,-2665.05
buyer_7,María,56,ES12209529607663493637,TRX_N-00131-85849648,2022-04-19T10:50:21,Portugalete,expenses,education,-53.82,-2718.87
buyer_7,María,56,ES12209529607663493637,TRX_N-00132-29761910,2022-04-19T09:16:45,Portugalete,expenses,repairs,-228.12,-2946.99
buyer_7,María,56,ES12209529607663493637,TRX_N-00133-02688650,2022-04-20T08:17:13,Portugalete,expenses,cash,-100.0,-3046.99
buyer_7,María,56,ES12209529607663493637,TRX_N-00134-12073990,2022-04-22T11:50:13,Alegría-Dulantzi,expenses,travel,-1407.7,-4454.69
buyer_7,María,56,ES12209529607663493637,TRX_N-00135-68634548,2022-04-24T12:18:51,Hondarribia,expenses,cash,-100.0,-4554.69
buyer_7,María,56,ES12209529607663493637,TRX_N-00136-76578210,2022-04-25T17:50:56,Portugalete,expenses,food,-97.53,-4652.22
buyer_7,María,56,ES12209529607663493637,TRX_N-00137-36019715,2022-04-25T10:33:43,Portugalete,expenses,repairs,-144.42,-4796.64
buyer_7,María,56,ES12209529607663493637,TRX_N-00138-18423391,2022-04-27T11:00:14,Portugalete,expenses,gifts,-761.71,-5558.35
buyer_7,María,56,ES12209529607663493637,TRX_N-00139-37082417,2022-04-28T10:15:02,Portugalete,expenses,gifts,-508.82,-6067.17
buyer_7,María,56,ES12209529607663493637,TRX_N-00140-91577773,2022-04-29T16:29:00,Portugalete,expenses,food,-86.41,-6153.58
buyer_7,María,56,ES12209529607663493637,TRX_N-00141-13020604,2022-05-01T00:18:58,Portugalete,incomes,salary,1508.12,-4645.46
buyer_7,María,56,ES12209529607663493637,TRX_N-00142-05383448,2022-05-01T00:18:58,Portugalete,incomes,salary_partner,1548.46,-3097.0
buyer_7,María,56,ES12209529607663493637,TRX_N-00143-25424722,2022-05-02T18:25:13,Portugalete,expenses,food,-108.79,-3205.79
buyer_7,María,56,ES12209529607663493637,TRX_N-00144-33735365,2022-05-02T20:02:24,Portugalete,expenses,clothing,-85.86,-3291.65
buyer_7,María,56,ES12209529607663493637,TRX_N-00145-32297804,2022-05-02T22:28:37,Portugalete,expenses,repairs,-122.41,-3414.06
buyer_7,María,56,ES12209529607663493637,TRX_N-00146-65243051,2022-05-04T16:38:06,Portugalete,expenses,mortgage,-717.72,-4131.78
buyer_7,María,56,ES12209529607663493637,TRX_N-00147-35011552,2022-05-04T09:51:08,Andoain,expenses,cash,-100.0,-4231.78
buyer_7,María,56,ES12209529607663493637,TRX_N-00148-54610958,2022-05-05T15:16:08,Portugalete,expenses,phone,-38.66,-4270.44
buyer_7,María,56,ES12209529607663493637,TRX_N-00149-44040208,2022-05-06T17:35:01,Portugalete,expenses,internet,-42.0,-4312.44
buyer_7,María,56,ES12209529607663493637,TRX_N-00150-41099960,2022-05-06T12:42:26,Portugalete,expenses,clothing,-117.15,-4429.59
buyer_7,María,56,ES12209529607663493637,TRX_N-00151-22618508,2022-05-07T23:57:30,Portugalete,expenses,electricity,-36.43,-4466.02
buyer_7,María,56,ES12209529607663493637,TRX_N-00152-01324498,2022-05-08T08:25:45,Portugalete,expenses,gas,-46.34,-4512.36
buyer_7,María,56,ES12209529607663493637,TRX_N-00153-55305302,2022-05-08T09:38:45,Portugalete,expenses,water,-32.82,-4545.18
buyer_7,María,56,ES12209529607663493637,TRX_N-00154-77469096,2022-05-08T16:13:41,Portugalete,expenses,food,-105.35,-4650.53
buyer_7,María,56,ES12209529607663493637,TRX_N-00155-83535940,2022-05-08T11:19:46,Portugalete,expenses,cash,-100.0,-4750.53
buyer_7,María,56,ES12209529607663493637,TRX_N-00156-96530058,2022-05-09T05:21:35,Portugalete,expenses,leisure,-61.58,-4812.11
buyer_7,María,56,ES12209529607663493637,TRX_N-00157-93474354,2022-05-09T12:38:54,Elciego,expenses,appliances,-203.67,-5015.78
buyer_7,María,56,ES12209529607663493637,TRX_N-00158-64839071,2022-05-10T20:46:25,Portugalete,expenses,appliances,-239.26,-5255.04
buyer_7,María,56,ES12209529607663493637,TRX_N-00159-54016418,2022-05-11T20:29:53,Portugalete,expenses,food,-96.11,-5351.15
buyer_7,María,56,ES12209529607663493637,TRX_N-00160-77415018,2022-05-13T10:55:41,Portugalete,expenses,food,-86.16,-5437.31
buyer_7,María,56,ES12209529607663493637,TRX_N-00161-00608664,2022-05-14T06:50:40,Zuia,expenses,food,-80.82,-5518.13
buyer_7,María,56,ES12209529607663493637,TRX_N-00162-32035551,2022-05-14T08:50:37,Portugalete,expenses,cash,-100.0,-5618.13
buyer_7,María,56,ES12209529607663493637,TRX_N-00163-05844440,2022-05-18T20:25:21,Portugalete,expenses,gifts,-410.64,-6028.77
buyer_7,María,56,ES12209529607663493637,TRX_N-00164-26135815,2022-05-19T10:22:19,Portugalete,expenses,repairs,-114.17,-6142.94
buyer_7,María,56,ES12209529607663493637,TRX_N-00165-73856329,2022-05-20T03:25:24,Portugalete,expenses,transport,-77.19,-6220.13
buyer_7,María,56,ES12209529607663493637,TRX_N-00166-03730691,2022-05-21T16:33:23,Portugalete,expenses,food,-118.26,-6338.39
buyer_7,María,56,ES12209529607663493637,TRX_N-00167-45038247,2022-05-21T20:07:59,Portugalete,expenses,cash,-100.0,-6438.39
buyer_7,María,56,ES12209529607663493637,TRX_N-00168-85135528,2022-05-22T19:58:44,Portugalete,expenses,gifts,-365.24,-6803.63
buyer_7,María,56,ES12209529607663493637,TRX_N-00169-74928048,2022-05-23T18:35:46,Arrasate,expenses,food,-78.52,-6882.15
buyer_7,María,56,ES12209529607663493637,TRX_N-00170-53865009,2022-05-23T18:11:58,Portugalete,expenses,repairs,-289.21,-7171.36
buyer_7,María,56,ES12209529607663493637,TRX_N-00171-26145578,2022-05-24T13:18:46,Portugalete,expenses,food,-94.0,-7265.36
buyer_7,María,56,ES12209529607663493637,TRX_N-00172-97005090,2022-05-24T12:23:25,Portugalete,expenses,clothing,-133.87,-7399.23
buyer_7,María,56,ES12209529607663493637,TRX_N-00173-35442161,2022-05-25T13:30:04,Portugalete,expenses,food,-123.16,-7522.39
buyer_7,María,56,ES12209529607663493637,TRX_N-00174-43937093,2022-05-27T16:29:07,Amurrio,expenses,food,-100.76,-7623.15
buyer_7,María,56,ES12209529607663493637,TRX_N-00175-05071916,2022-05-28T17:15:06,Portugalete,expenses,food,-117.72,-7740.87
buyer_7,María,56,ES12209529607663493637,TRX_N-00176-41635298,2022-06-01T23:14:42,Portugalete,incomes,salary,1508.12,-6232.75
buyer_7,María,56,ES12209529607663493637,TRX_N-00177-08448920,2022-06-01T23:14:42,Portugalete,incomes,salary_partner,1548.46,-4684.29
buyer_7,María,56,ES12209529607663493637,TRX_N-00178-36328970,2022-06-01T23:14:42,Portugalete,incomes,salary_bonus,1086.89,-3597.4
buyer_7,María,56,ES12209529607663493637,TRX_N-00179-93701273,2022-06-01T23:14:42,Portugalete,incomes,salary_partner_bonus,1106.64,-2490.76
buyer_7,María,56,ES12209529607663493637,TRX_N-00180-86961612,2022-06-01T18:34:29,Portugalete,expenses,clothing,-111.49,-2602.25
buyer_7,María,56,ES12209529607663493637,TRX_N-00181-91863175,2022-06-02T18:18:52,Elciego,expenses,appliances,-357.56,-2959.81
buyer_7,María,56,ES12209529607663493637,TRX_N-00182-59020887,2022-06-03T09:26:18,Portugalete,expenses,transport,-40.77,-3000.58
buyer_7,María,56,ES12209529607663493637,TRX_N-00183-54769170,2022-06-03T20:16:04,Portugalete,expenses,leisure,-66.36,-3066.94
buyer_7,María,56,ES12209529607663493637,TRX_N-00184-72413929,2022-06-04T08:11:10,Portugalete,expenses,mortgage,-717.72,-3784.66
buyer_7,María,56,ES12209529607663493637,TRX_N-00185-28467322,2022-06-05T15:01:16,Portugalete,expenses,water,-31.42,-3816.08
buyer_7,María,56,ES12209529607663493637,TRX_N-00186-68626142,2022-06-06T10:27:33,Portugalete,expenses,electricity,-32.27,-3848.35
buyer_7,María,56,ES12209529607663493637,TRX_N-00187-05759713,2022-06-06T16:03:32,Portugalete,expenses,gas,-95.29,-3943.64
buyer_7,María,56,ES12209529607663493637,TRX_N-00188-71273658,2022-06-06T23:03:17,Portugalete,expenses,phone,-44.9,-3988.54
buyer_7,María,56,ES12209529607663493637,TRX_N-00189-40731561,2022-06-06T01:06:55,Portugalete,expenses,transport,-66.17,-4054.71
buyer_7,María,56,ES12209529607663493637,TRX_N-00190-54606074,2022-06-08T11:36:34,Portugalete,expenses,internet,-42.0,-4096.71
buyer_7,María,56,ES12209529607663493637,TRX_N-00191-95358781,2022-06-08T11:39:46,Portugalete,expenses,food,-113.86,-4210.57
buyer_7,María,56,ES12209529607663493637,TRX_N-00192-97681110,2022-06-08T09:12:23,Portugalete,expenses,travel,-1341.67,-5552.24
buyer_7,María,56,ES12209529607663493637,TRX_N-00193-96664743,2022-06-08T18:11:42,Portugalete,expenses,repairs,-130.97,-5683.21
buyer_7,María,56,ES12209529607663493637,TRX_N-00194-97266416,2022-06-10T10:30:32,Portugalete,expenses,education,-75.23,-5758.44
buyer_7,María,56,ES12209529607663493637,TRX_N-00195-29715563,2022-06-10T08:11:06,Iruña de Oca,expenses,travel,-525.03,-6283.47
buyer_7,María,56,ES12209529607663493637,TRX_N-00196-97813627,2022-06-13T23:59:23,Portugalete,expenses,transport,-73.99,-6357.46
buyer_7,María,56,ES12209529607663493637,TRX_N-00197-27346451,2022-06-14T21:28:14,Portugalete,expenses,education,-51.97,-6409.43
buyer_7,María,56,ES12209529607663493637,TRX_N-00198-90230486,2022-06-16T00:36:26,Portugalete,expenses,appliances,-198.06,-6607.49
buyer_7,María,56,ES12209529607663493637,TRX_N-00199-91675739,2022-06-17T17:25:29,Portugalete,expenses,food,-103.62,-6711.11
buyer_7,María,56,ES12209529607663493637,TRX_N-00200-80869965,2022-06-17T13:57:22,Portugalete,expenses,education,-77.55,-6788.66
buyer_7,María,56,ES12209529607663493637,TRX_N-00201-55625530,2022-06-17T22:18:04,Pasaia,expenses,cash,-100.0,-6888.66
buyer_7,María,56,ES12209529607663493637,TRX_N-00202-14081198,2022-06-18T20:20:35,Portugalete,expenses,food,-68.74,-6957.4
buyer_7,María,56,ES12209529607663493637,TRX_N-00203-65156380,2022-06-19T17:11:36,Arrasate,expenses,transport,-41.18,-6998.58
buyer_7,María,56,ES12209529607663493637,TRX_N-00204-69555844,2022-06-20T17:40:51,Portugalete,expenses,leisure,-81.54,-7080.12
buyer_7,María,56,ES12209529607663493637,TRX_N-00205-22775358,2022-06-20T09:08:52,Donostia,expenses,appliances,-217.66,-7297.78
buyer_7,María,56,ES12209529607663493637,TRX_N-00206-37056937,2022-06-20T10:32:28,Portugalete,expenses,children,-268.24,-7566.02
buyer_7,María,56,ES12209529607663493637,TRX_N-00207-31513188,2022-06-21T11:45:44,Portugalete,expenses,education,-59.24,-7625.26
buyer_7,María,56,ES12209529607663493637,TRX_N-00208-20314530,2022-06-22T03:13:38,Portugalete,expenses,leisure,-79.53,-7704.79
buyer_7,María,56,ES12209529607663493637,TRX_N-00209-21726956,2022-06-22T03:52:07,Portugalete,expenses,gifts,-278.68,-7983.47
buyer_7,María,56,ES12209529607663493637,TRX_N-00210-49129832,2022-06-25T02:52:06,Portugalete,expenses,transport,-43.3,-8026.77
buyer_7,María,56,ES12209529607663493637,TRX_N-00211-73673655,2022-06-25T08:45:04,Portugalete,expenses,gifts,-670.34,-8697.11
buyer_7,María,56,ES12209529607663493637,TRX_N-00212-02559020,2022-06-26T16:15:23,Portugalete,expenses,education,-67.2,-8764.31
buyer_7,María,56,ES12209529607663493637,TRX_N-00213-92077679,2022-06-28T20:25:57,Oyón-Oion,expenses,transport,-79.98,-8844.29
buyer_7,María,56,ES12209529607663493637,TRX_N-00214-07822623,2022-06-28T08:28:58,Portugalete,expenses,clothing,-157.41,-9001.7
buyer_7,María,56,ES12209529607663493637,TRX_N-00215-74855695,2022-06-29T03:01:56,Labastida,expenses,leisure,-79.57,-9081.27
buyer_7,María,56,ES12209529607663493637,TRX_N-00216-54603826,2022-06-29T22:50:25,Elciego,expenses,cash,-100.0,-9181.27
buyer_7,María,56,ES12209529607663493637,TRX_N-00217-10807648,2022-06-30T18:55:16,Elciego,expenses,transport,-46.65,-9227.92
buyer_7,María,56,ES12209529607663493637,TRX_N-00218-38291992,2022-07-01T20:46:24,Portugalete,incomes,salary,1508.12,-7719.8
buyer_7,María,56,ES12209529607663493637,TRX_N-00219-88857562,2022-07-01T20:46:24,Portugalete,incomes,salary_partner,1548.46,-6171.34
buyer_7,María,56,ES12209529607663493637,TRX_N-00220-34583334,2022-07-01T20:46:24,Portugalete,incomes,extra_income,243.65,-5927.69
buyer_7,María,56,ES12209529607663493637,TRX_N-00221-28119766,2022-07-01T18:51:45,Portugalete,expenses,transport,-45.53,-5973.22
buyer_7,María,56,ES12209529607663493637,TRX_N-00222-52084531,2022-07-02T11:36:17,Portugalete,expenses,food,-82.12,-6055.34
buyer_7,María,56,ES12209529607663493637,TRX_N-00223-25411838,2022-07-03T12:23:15,Portugalete,expenses,leisure,-40.52,-6095.86
buyer_7,María,56,ES12209529607663493637,TRX_N-00224-08342940,2022-07-04T09:55:00,Portugalete,expenses,mortgage,-717.72,-6813.58
buyer_7,María,56,ES12209529607663493637,TRX_N-00225-28401428,2022-07-04T18:18:37,Portugalete,expenses,transport,-60.33,-6873.91
buyer_7,María,56,ES12209529607663493637,TRX_N-00226-78303726,2022-07-05T19:07:21,Portugalete,expenses,phone,-40.47,-6914.38
buyer_7,María,56,ES12209529607663493637,TRX_N-00227-23769951,2022-07-08T19:44:17,Portugalete,expenses,water,-41.56,-6955.94
buyer_7,María,56,ES12209529607663493637,TRX_N-00228-40096890,2022-07-08T20:17:46,Portugalete,expenses,electricity,-88.83,-7044.77
buyer_7,María,56,ES12209529607663493637,TRX_N-00229-94805452,2022-07-08T19:13:49,Portugalete,expenses,gas,-34.77,-7079.54
buyer_7,María,56,ES12209529607663493637,TRX_N-00230-17865002,2022-07-08T10:41:43,Portugalete,expenses,internet,-42.0,-7121.54
buyer_7,María,56,ES12209529607663493637,TRX_N-00231-90000388,2022-07-08T14:22:05,Portugalete,expenses,healthcare,-61.74,-7183.28
buyer_7,María,56,ES12209529607663493637,TRX_N-00232-62453835,2022-07-10T08:40:42,Portugalete,expenses,cash,-100.0,-7283.28
buyer_7,María,56,ES12209529607663493637,TRX_N-00233-03200067,2022-07-10T09:25:02,Portugalete,expenses,gifts,-123.09,-7406.37
buyer_7,María,56,ES12209529607663493637,TRX_N-00234-94200388,2022-07-11T10:33:59,Portugalete,expenses,clothing,-48.39,-7454.76
buyer_7,María,56,ES12209529607663493637,TRX_N-00235-47101977,2022-07-11T23:28:24,Portugalete,expenses,cash,-100.0,-7554.76
buyer_7,María,56,ES12209529607663493637,TRX_N-00236-90961837,2022-07-12T16:37:50,Portugalete,expenses,transport,-56.7,-7611.46
buyer_7,María,56,ES12209529607663493637,TRX_N-00237-20563685,2022-07-12T15:19:56,Bermeo,expenses,repairs,-189.26,-7800.72
buyer_7,María,56,ES12209529607663493637,TRX_N-00238-34360814,2022-07-14T12:14:28,Portugalete,expenses,children,-158.73,-7959.45
buyer_7,María,56,ES12209529607663493637,TRX_N-00239-31046181,2022-07-16T20:12:23,Portugalete,expenses,healthcare,-125.22,-8084.67
buyer_7,María,56,ES12209529607663493637,TRX_N-00240-69910814,2022-07-17T19:34:11,Portugalete,expenses,clothing,-106.79,-8191.46
buyer_7,María,56,ES12209529607663493637,TRX_N-00241-46894100,2022-07-18T19:35:38,Portugalete,expenses,food,-115.8,-8307.26
buyer_7,María,56,ES12209529607663493637,TRX_N-00242-88156511,2022-07-18T19:48:08,Portugalete,expenses,leisure,-33.67,-8340.93
buyer_7,María,56,ES12209529607663493637,TRX_N-00243-45036571,2022-07-18T11:31:55,Portugalete,expenses,cash,-100.0,-8440.93
buyer_7,María,56,ES12209529607663493637,TRX_N-00244-13724038,2022-07-19T14:45:38,Portugalete,expenses,cash,-100.0,-8540.93
buyer_7,María,56,ES12209529607663493637,TRX_N-00245-89326593,2022-07-20T13:41:36,Portugalete,expenses,gifts,-388.77,-8929.7
buyer_7,María,56,ES12209529607663493637,TRX_N-00246-92035580,2022-07-20T09:47:38,Portugalete,expenses,children,-126.75,-9056.45
buyer_7,María,56,ES12209529607663493637,TRX_N-00247-30309043,2022-07-21T11:39:55,Portugalete,expenses,food,-90.98,-9147.43
buyer_7,María,56,ES12209529607663493637,TRX_N-00248-32959436,2022-07-21T08:44:22,Portugalete,expenses,cash,-100.0,-9247.43
buyer_7,María,56,ES12209529607663493637,TRX_N-00249-33165920,2022-07-23T15:47:22,Portugalete,expenses,food,-102.44,-9349.87
buyer_7,María,56,ES12209529607663493637,TRX_N-00250-98084634,2022-07-30T18:28:22,Portugalete,expenses,food,-96.33,-9446.2
buyer_7,María,56,ES12209529607663493637,TRX_N-00251-65049419,2022-07-30T02:43:36,Portugalete,expenses,leisure,-65.21,-9511.41
buyer_7,María,56,ES12209529607663493637,TRX_N-00252-71675817,2022-07-31T19:26:14,Portugalete,expenses,cash,-100.0,-9611.41
buyer_7,María,56,ES12209529607663493637,TRX_N-00253-82481550,2022-08-01T15:24:38,Portugalete,incomes,salary,1508.12,-8103.29
buyer_7,María,56,ES12209529607663493637,TRX_N-00254-30866755,2022-08-01T15:24:38,Portugalete,incomes,salary_partner,1548.46,-6554.83
buyer_7,María,56,ES12209529607663493637,TRX_N-00255-42457299,2022-08-01T20:14:41,Portugalete,expenses,clothing,-124.82,-6679.65
buyer_7,María,56,ES12209529607663493637,TRX_N-00256-14574031,2022-08-03T15:29:34,Portugalete,expenses,food,-94.35,-6774.0
buyer_7,María,56,ES12209529607663493637,TRX_N-00257-64801793,2022-08-03T20:53:32,Portugalete,expenses,transport,-45.88,-6819.88
buyer_7,María,56,ES12209529607663493637,TRX_N-00258-89737623,2022-08-04T21:10:24,Portugalete,expenses,mortgage,-717.72,-7537.6
buyer_7,María,56,ES12209529607663493637,TRX_N-00259-18069233,2022-08-04T18:48:43,Portugalete,expenses,gifts,-67.79,-7605.39
buyer_7,María,56,ES12209529607663493637,TRX_N-00260-71374253,2022-08-05T18:21:21,Portugalete,expenses,water,-27.29,-7632.68
buyer_7,María,56,ES12209529607663493637,TRX_N-00261-34975576,2022-08-05T12:34:04,Portugalete,expenses,gas,-38.36,-7671.04
buyer_7,María,56,ES12209529607663493637,TRX_N-00262-18539969,2022-08-05T18:38:31,Portugalete,expenses,healthcare,-59.9,-7730.94
buyer_7,María,56,ES12209529607663493637,TRX_N-00263-19330079,2022-08-06T11:08:01,Portugalete,expenses,internet,-42.0,-7772.94
buyer_7,María,56,ES12209529607663493637,TRX_N-00264-51959031,2022-08-06T18:59:09,Portugalete,expenses,leisure,-56.46,-7829.4
buyer_7,María,56,ES12209529607663493637,TRX_N-00265-18264683,2022-08-07T10:56:32,Portugalete,expenses,electricity,-84.13,-7913.53
buyer_7,María,56,ES12209529607663493637,TRX_N-00266-80179164,2022-08-07T00:33:12,Salvatierra/Agurain,expenses,clothing,-112.52,-8026.05
buyer_7,María,56,ES12209529607663493637,TRX_N-00267-84055041,2022-08-08T10:19:02,Portugalete,expenses,phone,-38.58,-8064.63
buyer_7,María,56,ES12209529607663493637,TRX_N-00268-33990265,2022-08-08T12:08:06,Portugalete,expenses,transport,-55.95,-8120.58
buyer_7,María,56,ES12209529607663493637,TRX_N-00269-83876489,2022-08-08T08:14:53,Portugalete,expenses,leisure,-69.88,-8190.46
buyer_7,María,56,ES12209529607663493637,TRX_N-00270-49471684,2022-08-10T22:24:17,Vitoria-Gasteiz,expenses,appliances,-122.69,-8313.15
buyer_7,María,56,ES12209529607663493637,TRX_N-00271-50633346,2022-08-11T18:44:00,Portugalete,expenses,leisure,-34.65,-8347.8
buyer_7,María,56,ES12209529607663493637,TRX_N-00272-74024445,2022-08-11T11:23:11,Portugalete,expenses,children,-153.67,-8501.47
buyer_7,María,56,ES12209529607663493637,TRX_N-00273-23171372,2022-08-12T13:01:58,Portugalete,expenses,transport,-69.53,-8571.0
buyer_7,María,56,ES12209529607663493637,TRX_N-00274-24685735,2022-08-12T09:45:13,Eibar,expenses,education,-64.3,-8635.3
buyer_7,María,56,ES12209529607663493637,TRX_N-00275-63167037,2022-08-14T20:02:20,Portugalete,expenses,leisure,-72.62,-8707.92
buyer_7,María,56,ES12209529607663493637,TRX_N-00276-51718978,2022-08-14T17:59:03,Portugalete,expenses,cash,-100.0,-8807.92
buyer_7,María,56,ES12209529607663493637,TRX_N-00277-60269384,2022-08-15T11:13:42,Portugalete,expenses,leisure,-28.27,-8836.19
buyer_7,María,56,ES12209529607663493637,TRX_N-00278-21089438,2022-08-15T13:53:25,Portugalete,expenses,cash,-100.0,-8936.19
buyer_7,María,56,ES12209529607663493637,TRX_N-00279-62195623,2022-08-16T07:22:52,Portugalete,expenses,clothing,-53.38,-8989.57
buyer_7,María,56,ES12209529607663493637,TRX_N-00280-97793693,2022-08-17T08:25:26,Portugalete,expenses,transport,-53.67,-9043.24
buyer_7,María,56,ES12209529607663493637,TRX_N-00281-12405831,2022-08-17T16:29:58,Portugalete,expenses,cash,-100.0,-9143.24
buyer_7,María,56,ES12209529607663493637,TRX_N-00282-00205464,2022-08-18T15:22:17,Portugalete,expenses,transport,-69.96,-9213.2
buyer_7,María,56,ES12209529607663493637,TRX_N-00283-07531078,2022-08-18T17:09:47,Portugalete,expenses,gifts,-821.56,-10034.76
buyer_7,María,56,ES12209529607663493637,TRX_N-00284-52194589,2022-08-19T23:49:55,Portugalete,expenses,food,-110.86,-10145.62
buyer_7,María,56,ES12209529607663493637,TRX_N-00285-32739638,2022-08-21T09:44:20,Portugalete,expenses,leisure,-80.99,-10226.61
buyer_7,María,56,ES12209529607663493637,TRX_N-00286-28456589,2022-08-21T10:52:54,Portugalete,expenses,appliances,-387.99,-10614.6
buyer_7,María,56,ES12209529607663493637,TRX_N-00287-63404993,2022-08-23T15:35:37,Portugalete,expenses,leisure,-44.85,-10659.45
buyer_7,María,56,ES12209529607663493637,TRX_N-00288-01887370,2022-08-23T18:35:28,Portugalete,expenses,repairs,-147.67,-10807.12
buyer_7,María,56,ES12209529607663493637,TRX_N-00289-15631400,2022-08-25T17:51:06,Portugalete,expenses,food,-74.33,-10881.45
buyer_7,María,56,ES12209529607663493637,TRX_N-00290-39843091,2022-08-25T17:56:35,Portugalete,expenses,leisure,-50.0,-10931.45
buyer_7,María,56,ES12209529607663493637,TRX_N-00291-01579133,2022-08-26T10:07:51,Portugalete,expenses,transport,-45.48,-10976.93
buyer_7,María,56,ES12209529607663493637,TRX_N-00292-39879900,2022-08-27T18:07:54,Portugalete,expenses,healthcare,-154.13,-11131.06
buyer_7,María,56,ES12209529607663493637,TRX_N-00293-48920022,2022-08-28T11:17:19,Portugalete,expenses,food,-112.9,-11243.96
buyer_7,María,56,ES12209529607663493637,TRX_N-00294-06687615,2022-08-28T23:43:21,Portugalete,expenses,cash,-100.0,-11343.96
buyer_7,María,56,ES12209529607663493637,TRX_N-00295-40214182,2022-08-29T22:04:44,Alegría-Dulantzi,expenses,clothing,-68.52,-11412.48
buyer_7,María,56,ES12209529607663493637,TRX_N-00296-85133349,2022-08-29T12:29:42,Portugalete,expenses,appliances,-291.91,-11704.39
buyer_7,María,56,ES12209529607663493637,TRX_N-00297-49471226,2022-08-30T17:16:30,Portugalete,expenses,cash,-100.0,-11804.39
buyer_7,María,56,ES12209529607663493637,TRX_N-00298-91491400,2022-08-30T20:21:27,Portugalete,expenses,gifts,-528.49,-12332.88
buyer_7,María,56,ES12209529607663493637,TRX_N-00299-09162857,2022-08-31T17:33:57,Portugalete,expenses,clothing,-91.93,-12424.81
buyer_7,María,56,ES12209529607663493637,TRX_N-00300-13186596,2022-08-31T13:34:09,Portugalete,expenses,education,-78.83,-12503.64
buyer_7,María,56,ES12209529607663493637,TRX_N-00301-68442353,2022-09-01T13:31:39,Portugalete,incomes,salary,1508.12,-10995.52
buyer_7,María,56,ES12209529607663493637,TRX_N-00302-97245805,2022-09-01T13:31:39,Portugalete,incomes,salary_partner,1548.46,-9447.06
buyer_7,María,56,ES12209529607663493637,TRX_N-00303-67056018,2022-09-02T09:00:40,Portugalete,expenses,healthcare,-47.34,-9494.4
buyer_7,María,56,ES12209529607663493637,TRX_N-00304-41467932,2022-09-02T00:12:11,Andoain,expenses,gifts,-252.49,-9746.89
buyer_7,María,56,ES12209529607663493637,TRX_N-00305-19950362,2022-09-03T17:18:29,Portugalete,expenses,cash,-100.0,-9846.89
buyer_7,María,56,ES12209529607663493637,TRX_N-00306-71299281,2022-09-03T19:44:11,Portugalete,expenses,gifts,-467.25,-10314.14
buyer_7,María,56,ES12209529607663493637,TRX_N-00307-91524826,2022-09-04T17:56:20,Portugalete,expenses,mortgage,-717.72,-11031.86
buyer_7,María,56,ES12209529607663493637,TRX_N-00308-21324832,2022-09-05T11:00:55,Portugalete,expenses,phone,-30.37,-11062.23
buyer_7,María,56,ES12209529607663493637,TRX_N-00309-16116138,2022-09-05T16:38:35,Portugalete,expenses,leisure,-50.84,-11113.07
buyer_7,María,56,ES12209529607663493637,TRX_N-00310-97290925,2022-09-05T14:42:41,Portugalete,expenses,appliances,-380.07,-11493.14
buyer_7,María,56,ES12209529607663493637,TRX_N-00311-97698054,2022-09-07T07:20:25,Portugalete,expenses,cash,-100.0,-11593.14
buyer_7,María,56,ES12209529607663493637,TRX_N-00312-39035345,2022-09-07T09:27:17,Portugalete,expenses,repairs,-62.67,-11655.81
buyer_7,María,56,ES12209529607663493637,TRX_N-00313-33286418,2022-09-08T12:30:59,Portugalete,expenses,water,-23.14,-11678.95
buyer_7,María,56,ES12209529607663493637,TRX_N-00314-65448276,2022-09-08T08:29:23,Portugalete,expenses,electricity,-36.45,-11715.4
buyer_7,María,56,ES12209529607663493637,TRX_N-00315-96390710,2022-09-08T16:29:02,Portugalete,expenses,gas,-37.94,-11753.34
buyer_7,María,56,ES12209529607663493637,TRX_N-00316-12804601,2022-09-08T11:57:33,Portugalete,expenses,internet,-42.0,-11795.34
buyer_7,María,56,ES12209529607663493637,TRX_N-00317-08314650,2022-09-08T19:20:58,Portugalete,expenses,transport,-60.23,-11855.57
buyer_7,María,56,ES12209529607663493637,TRX_N-00318-76887321,2022-09-09T16:34:18,Portugalete,expenses,transport,-52.84,-11908.41
buyer_7,María,56,ES12209529607663493637,TRX_N-00319-05690248,2022-09-09T17:02:18,Portugalete,expenses,children,-62.54,-11970.95
buyer_7,María,56,ES12209529607663493637,TRX_N-00320-97680005,2022-09-10T13:55:21,Donostia,expenses,repairs,-311.22,-12282.17
buyer_7,María,56,ES12209529607663493637,TRX_N-00321-88150924,2022-09-12T17:20:28,Hernani,expenses,education,-62.73,-12344.9
buyer_7,María,56,ES12209529607663493637,TRX_N-00322-76050873,2022-09-12T15:22:43,Portugalete,expenses,repairs,-177.8,-12522.7
buyer_7,María,56,ES12209529607663493637,TRX_N-00323-56840446,2022-09-13T11:13:24,Portugalete,expenses,cash,-100.0,-12622.7
buyer_7,María,56,ES12209529607663493637,TRX_N-00324-90842962,2022-09-13T13:42:59,Portugalete,expenses,gifts,-544.09,-13166.79
buyer_7,María,56,ES12209529607663493637,TRX_N-00325-53528722,2022-09-14T21:11:17,Portugalete,expenses,food,-82.02,-13248.81
buyer_7,María,56,ES12209529607663493637,TRX_N-00326-74268990,2022-09-14T17:11:11,Portugalete,expenses,cash,-100.0,-13348.81
buyer_7,María,56,ES12209529607663493637,TRX_N-00327-99184872,2022-09-15T05:46:03,Portugalete,expenses,food,-113.08,-13461.89
buyer_7,María,56,ES12209529607663493637,TRX_N-00328-12610006,2022-09-15T16:06:30,Irun,expenses,transport,-51.18,-13513.07
buyer_7,María,56,ES12209529607663493637,TRX_N-00329-29849365,2022-09-15T14:57:05,Portugalete,expenses,leisure,-67.21,-13580.28
buyer_7,María,56,ES12209529607663493637,TRX_N-00330-53851328,2022-09-15T11:35:07,Portugalete,expenses,gifts,-242.93,-13823.21
buyer_7,María,56,ES12209529607663493637,TRX_N-00331-48061396,2022-09-16T20:02:33,Portugalete,expenses,leisure,-45.35,-13868.56
buyer_7,María,56,ES12209529607663493637,TRX_N-00332-07031816,2022-09-16T12:51:38,Portugalete,expenses,cash,-100.0,-13968.56
buyer_7,María,56,ES12209529607663493637,TRX_N-00333-00747681,2022-09-16T15:53:26,Portugalete,expenses,gifts,-354.48,-14323.04
buyer_7,María,56,ES12209529607663493637,TRX_N-00334-21143016,2022-09-18T12:06:03,Portugalete,expenses,food,-124.82,-14447.86
buyer_7,María,56,ES12209529607663493637,TRX_N-00335-66578015,2022-09-18T08:46:02,Portugalete,expenses,gifts,-156.67,-14604.53
buyer_7,María,56,ES12209529607663493637,TRX_N-00336-35537683,2022-09-20T15:18:19,Portugalete,expenses,healthcare,-88.92,-14693.45
buyer_7,María,56,ES12209529607663493637,TRX_N-00337-92624727,2022-09-21T08:47:17,Portugalete,expenses,leisure,-35.34,-14728.79
buyer_7,María,56,ES12209529607663493637,TRX_N-00338-34817440,2022-09-21T10:11:48,Portugalete,expenses,healthcare,-66.22,-14795.01
buyer_7,María,56,ES12209529607663493637,TRX_N-00339-55951610,2022-09-22T11:21:02,Portugalete,expenses,food,-110.09,-14905.1
buyer_7,María,56,ES12209529607663493637,TRX_N-00340-54183762,2022-09-23T12:33:29,Portugalete,expenses,food,-78.46,-14983.56
buyer_7,María,56,ES12209529607663493637,TRX_N-00341-30319254,2022-09-23T16:48:27,Portugalete,expenses,cash,-100.0,-15083.56
buyer_7,María,56,ES12209529607663493637,TRX_N-00342-05426561,2022-09-24T14:51:14,Portugalete,expenses,clothing,-84.0,-15167.56
buyer_7,María,56,ES12209529607663493637,TRX_N-00343-48416704,2022-09-26T22:23:08,Galdakao,expenses,cash,-100.0,-15267.56
buyer_7,María,56,ES12209529607663493637,TRX_N-00344-96501648,2022-09-29T15:01:41,Portugalete,expenses,food,-105.51,-15373.07
buyer_7,María,56,ES12209529607663493637,TRX_N-00345-71879954,2022-09-29T20:22:40,Leioa,expenses,healthcare,-169.88,-15542.95
buyer_7,María,56,ES12209529607663493637,TRX_N-00346-65701342,2022-09-30T17:36:07,Portugalete,expenses,cash,-100.0,-15642.95
buyer_7,María,56,ES12209529607663493637,TRX_N-00347-32742453,2022-10-01T05:15:25,Portugalete,incomes,salary,1508.12,-14134.83
buyer_7,María,56,ES12209529607663493637,TRX_N-00348-55449968,2022-10-01T05:15:25,Portugalete,incomes,salary_partner,1548.46,-12586.37
buyer_7,María,56,ES12209529607663493637,TRX_N-00349-01481827,2022-10-01T14:59:20,Barakaldo,expenses,cash,-100.0,-12686.37
buyer_7,María,56,ES12209529607663493637,TRX_N-00350-26660764,2022-10-02T13:23:44,Barakaldo,expenses,healthcare,-68.11,-12754.48
buyer_7,María,56,ES12209529607663493637,TRX_N-00351-09846686,2022-10-03T13:17:02,Portugalete,expenses,leisure,-30.04,-12784.52
buyer_7,María,56,ES12209529607663493637,TRX_N-00352-83268274,2022-10-04T10:49:30,Portugalete,expenses,mortgage,-717.72,-13502.24
buyer_7,María,56,ES12209529607663493637,TRX_N-00353-70502037,2022-10-05T01:09:48,Portugalete,expenses,food,-76.33,-13578.57
buyer_7,María,56,ES12209529607663493637,TRX_N-00354-13248341,2022-10-06T10:43:57,Portugalete,expenses,electricity,-23.79,-13602.36
buyer_7,María,56,ES12209529607663493637,TRX_N-00355-48349529,2022-10-06T16:47:47,Portugalete,expenses,internet,-42.0,-13644.36
buyer_7,María,56,ES12209529607663493637,TRX_N-00356-77230180,2022-10-06T11:46:48,Portugalete,expenses,food,-120.44,-13764.8
buyer_7,María,56,ES12209529607663493637,TRX_N-00357-06494476,2022-10-06T03:17:46,Portugalete,expenses,cash,-100.0,-13864.8
buyer_7,María,56,ES12209529607663493637,TRX_N-00358-07420229,2022-10-07T16:09:03,Portugalete,expenses,phone,-38.11,-13902.91
buyer_7,María,56,ES12209529607663493637,TRX_N-00359-16615146,2022-10-07T19:41:36,Portugalete,expenses,food,-93.2,-13996.11
buyer_7,María,56,ES12209529607663493637,TRX_N-00360-71546963,2022-10-08T16:38:06,Portugalete,expenses,water,-20.85,-14016.96
buyer_7,María,56,ES12209529607663493637,TRX_N-00361-42551116,2022-10-08T10:48:02,Portugalete,expenses,gas,-95.94,-14112.9
buyer_7,María,56,ES12209529607663493637,TRX_N-00362-37567812,2022-10-09T22:13:37,Portugalete,expenses,gifts,-213.28,-14326.18
buyer_7,María,56,ES12209529607663493637,TRX_N-00363-27255156,2022-10-10T04:00:34,Portugalete,expenses,children,-84.37,-14410.55
buyer_7,María,56,ES12209529607663493637,TRX_N-00364-67621117,2022-10-11T16:34:25,Portugalete,expenses,cash,-100.0,-14510.55
buyer_7,María,56,ES12209529607663493637,TRX_N-00365-02612285,2022-10-12T14:48:13,Portugalete,expenses,transport,-52.87,-14563.42
buyer_7,María,56,ES12209529607663493637,TRX_N-00366-63378360,2022-10-14T23:22:06,Portugalete,expenses,food,-123.6,-14687.02
buyer_7,María,56,ES12209529607663493637,TRX_N-00367-74006033,2022-10-17T12:24:22,Portugalete,expenses,repairs,-131.26,-14818.28
buyer_7,María,56,ES12209529607663493637,TRX_N-00368-91815597,2022-10-17T15:16:30,Portugalete,expenses,children,-94.87,-14913.15
buyer_7,María,56,ES12209529607663493637,TRX_N-00369-69718097,2022-10-20T12:31:48,Portugalete,expenses,food,-76.97,-14990.12
buyer_7,María,56,ES12209529607663493637,TRX_N-00370-90015351,2022-10-20T10:16:40,Portugalete,expenses,cash,-100.0,-15090.12
buyer_7,María,56,ES12209529607663493637,TRX_N-00371-52274508,2022-10-21T18:08:48,Portugalete,expenses,food,-95.24,-15185.36
buyer_7,María,56,ES12209529607663493637,TRX_N-00372-34125721,2022-10-21T09:14:04,Portugalete,expenses,leisure,-35.97,-15221.33
buyer_7,María,56,ES12209529607663493637,TRX_N-00373-49081756,2022-10-21T08:48:34,Portugalete,expenses,cash,-100.0,-15321.33
buyer_7,María,56,ES12209529607663493637,TRX_N-00374-45984667,2022-10-23T15:13:03,Portugalete,expenses,cash,-100.0,-15421.33
buyer_7,María,56,ES12209529607663493637,TRX_N-00375-46826172,2022-10-24T07:13:08,Portugalete,expenses,food,-97.2,-15518.53
buyer_7,María,56,ES12209529607663493637,TRX_N-00376-46188279,2022-10-24T08:33:47,Portugalete,expenses,gifts,-647.7,-16166.23
buyer_7,María,56,ES12209529607663493637,TRX_N-00377-10281989,2022-10-25T19:01:33,Portugalete,expenses,cash,-100.0,-16266.23
buyer_7,María,56,ES12209529607663493637,TRX_N-00378-61269749,2022-10-27T18:56:41,Donostia,expenses,food,-73.19,-16339.42
buyer_7,María,56,ES12209529607663493637,TRX_N-00379-73750497,2022-10-27T16:50:43,Portugalete,expenses,education,-50.73,-16390.15
buyer_7,María,56,ES12209529607663493637,TRX_N-00380-79941738,2022-10-28T19:40:48,Portugalete,expenses,education,-46.41,-16436.56
buyer_7,María,56,ES12209529607663493637,TRX_N-00381-33971002,2022-10-28T04:23:14,Portugalete,expenses,cash,-100.0,-16536.56
buyer_7,María,56,ES12209529607663493637,TRX_N-00382-20149003,2022-10-30T09:32:33,Portugalete,expenses,cash,-100.0,-16636.56
buyer_7,María,56,ES12209529607663493637,TRX_N-00383-84593267,2022-11-01T11:10:05,Portugalete,incomes,salary,1508.12,-15128.44
buyer_7,María,56,ES12209529607663493637,TRX_N-00384-17124101,2022-11-01T11:10:05,Portugalete,incomes,salary_partner,1548.46,-13579.98
buyer_7,María,56,ES12209529607663493637,TRX_N-00385-08717158,2022-11-01T11:10:05,Portugalete,incomes,extra_income,243.65,-13336.33
buyer_7,María,56,ES12209529607663493637,TRX_N-00386-91811977,2022-11-02T20:27:44,Alegría-Dulantzi,expenses,transport,-46.85,-13383.18
buyer_7,María,56,ES12209529607663493637,TRX_N-00387-21546663,2022-11-03T20:14:57,Portugalete,expenses,food,-86.42,-13469.6
buyer_7,María,56,ES12209529607663493637,TRX_N-00388-36021395,2022-11-03T08:50:25,Portugalete,expenses,leisure,-80.33,-13549.93
buyer_7,María,56,ES12209529607663493637,TRX_N-00389-86994746,2022-11-03T18:26:44,Portugalete,expenses,cash,-100.0,-13649.93
buyer_7,María,56,ES12209529607663493637,TRX_N-00390-58718142,2022-11-03T19:47:04,Amurrio,expenses,repairs,-180.4,-13830.33
buyer_7,María,56,ES12209529607663493637,TRX_N-00391-59520107,2022-11-04T03:04:18,Portugalete,expenses,mortgage,-717.72,-14548.05
buyer_7,María,56,ES12209529607663493637,TRX_N-00392-76823671,2022-11-04T14:23:04,Zuia,expenses,food,-74.58,-14622.63
buyer_7,María,56,ES12209529607663493637,TRX_N-00393-52055421,2022-11-05T18:06:43,Portugalete,expenses,internet,-42.0,-14664.63
buyer_7,María,56,ES12209529607663493637,TRX_N-00394-19969426,2022-11-06T11:12:16,Portugalete,expenses,electricity,-57.74,-14722.37
buyer_7,María,56,ES12209529607663493637,TRX_N-00395-77200868,2022-11-06T09:06:35,Portugalete,expenses,food,-87.47,-14809.84
buyer_7,María,56,ES12209529607663493637,TRX_N-00396-21346684,2022-11-07T19:41:53,Portugalete,expenses,phone,-32.18,-14842.02
buyer_7,María,56,ES12209529607663493637,TRX_N-00397-65120530,2022-11-08T17:20:44,Portugalete,expenses,water,-31.73,-14873.75
buyer_7,María,56,ES12209529607663493637,TRX_N-00398-46308291,2022-11-08T13:43:20,Portugalete,expenses,gas,-114.17,-14987.92
buyer_7,María,56,ES12209529607663493637,TRX_N-00399-79785882,2022-11-09T13:29:50,Portugalete,expenses,food,-109.33,-15097.25
buyer_7,María,56,ES12209529607663493637,TRX_N-00400-73946405,2022-11-09T19:59:39,Portugalete,expenses,transport,-82.75,-15180.0
buyer_7,María,56,ES12209529607663493637,TRX_N-00401-28706764,2022-11-10T14:18:21,Portugalete,expenses,food,-122.07,-15302.07
buyer_7,María,56,ES12209529607663493637,TRX_N-00402-47349669,2022-11-10T11:00:52,Getxo,expenses,education,-65.9,-15367.97
buyer_7,María,56,ES12209529607663493637,TRX_N-00403-99826651,2022-11-11T12:50:55,Portugalete,expenses,appliances,-288.69,-15656.66
buyer_7,María,56,ES12209529607663493637,TRX_N-00404-06563775,2022-11-11T17:12:05,Portugalete,expenses,gifts,-468.88,-16125.54
buyer_7,María,56,ES12209529607663493637,TRX_N-00405-45117787,2022-11-15T17:01:15,Portugalete,expenses,leisure,-73.48,-16199.02
buyer_7,María,56,ES12209529607663493637,TRX_N-00406-40839386,2022-11-15T16:56:51,Portugalete,expenses,education,-50.56,-16249.58
buyer_7,María,56,ES12209529607663493637,TRX_N-00407-46287416,2022-11-15T17:20:34,Portugalete,expenses,appliances,-110.24,-16359.82
buyer_7,María,56,ES12209529607663493637,TRX_N-00408-67023470,2022-11-17T20:02:32,Portugalete,expenses,leisure,-43.67,-16403.49
buyer_7,María,56,ES12209529607663493637,TRX_N-00409-05838322,2022-11-19T09:18:03,Portugalete,expenses,healthcare,-47.03,-16450.52
buyer_7,María,56,ES12209529607663493637,TRX_N-00410-44232677,2022-11-21T14:25:02,Portugalete,expenses,gifts,-502.09,-16952.61
buyer_7,María,56,ES12209529607663493637,TRX_N-00411-61906398,2022-11-23T19:48:41,Portugalete,expenses,cash,-100.0,-17052.61
buyer_7,María,56,ES12209529607663493637,TRX_N-00412-89695325,2022-11-25T18:19:33,Portugalete,expenses,cash,-100.0,-17152.61
buyer_7,María,56,ES12209529607663493637,TRX_N-00413-69710486,2022-11-26T09:18:31,Portugalete,expenses,cash,-100.0,-17252.61
buyer_7,María,56,ES12209529607663493637,TRX_N-00414-91046557,2022-11-27T07:55:23,Leioa,expenses,repairs,-161.79,-17414.4
buyer_7,María,56,ES12209529607663493637,TRX_N-00415-84202083,2022-11-29T11:43:25,Portugalete,expenses,cash,-100.0,-17514.4
buyer_7,María,56,ES12209529607663493637,TRX_N-00416-56365882,2022-11-30T16:35:59,Portugalete,expenses,children,-85.82,-17600.22
buyer_7,María,56,ES12209529607663493637,TRX_N-00417-13314741,2022-12-01T12:34:05,Portugalete,incomes,salary,1508.12,-16092.1
buyer_7,María,56,ES12209529607663493637,TRX_N-00418-67544673,2022-12-01T12:34:05,Portugalete,incomes,salary_partner,1548.46,-14543.64
buyer_7,María,56,ES12209529607663493637,TRX_N-00419-98925563,2022-12-01T12:34:05,Portugalete,incomes,salary_bonus,1110.16,-13433.48
buyer_7,María,56,ES12209529607663493637,TRX_N-00420-73330288,2022-12-01T12:34:05,Portugalete,incomes,salary_partner_bonus,1142.64,-12290.84
buyer_7,María,56,ES12209529607663493637,TRX_N-00421-89175173,2022-12-01T07:56:05,Portugalete,expenses,leisure,-31.64,-12322.48
buyer_7,María,56,ES12209529607663493637,TRX_N-00422-63662293,2022-12-01T07:32:00,Portugalete,expenses,cash,-100.0,-12422.48
buyer_7,María,56,ES12209529607663493637,TRX_N-00423-70939024,2022-12-02T11:02:00,Portugalete,expenses,cash,-100.0,-12522.48
buyer_7,María,56,ES12209529607663493637,TRX_N-00424-05170871,2022-12-03T16:05:45,Portugalete,expenses,leisure,-84.87,-12607.35
buyer_7,María,56,ES12209529607663493637,TRX_N-00425-78041568,2022-12-04T15:16:36,Portugalete,expenses,mortgage,-717.72,-13325.07
buyer_7,María,56,ES12209529607663493637,TRX_N-00426-41537740,2022-12-05T03:29:17,Portugalete,expenses,internet,-42.0,-13367.07
buyer_7,María,56,ES12209529607663493637,TRX_N-00427-30222194,2022-12-05T10:21:30,Portugalete,expenses,phone,-39.13,-13406.2
buyer_7,María,56,ES12209529607663493637,TRX_N-00428-81465664,2022-12-05T17:32:28,Portugalete,expenses,leisure,-20.44,-13426.64
buyer_7,María,56,ES12209529607663493637,TRX_N-00429-40167702,2022-12-07T16:40:29,Portugalete,expenses,food,-69.87,-13496.51
buyer_7,María,56,ES12209529607663493637,TRX_N-00430-36578903,2022-12-07T10:59:58,Portugalete,expenses,cash,-100.0,-13596.51
buyer_7,María,56,ES12209529607663493637,TRX_N-00431-30817932,2022-12-08T18:06:35,Portugalete,expenses,water,-36.85,-13633.36
buyer_7,María,56,ES12209529607663493637,TRX_N-00432-31838698,2022-12-08T10:35:45,Portugalete,expenses,electricity,-29.17,-13662.53
buyer_7,María,56,ES12209529607663493637,TRX_N-00433-80369658,2022-12-08T19:04:18,Portugalete,expenses,gas,-60.33,-13722.86
buyer_7,María,56,ES12209529607663493637,TRX_N-00434-12434383,2022-12-08T08:19:55,Santurtzi,expenses,food,-110.28,-13833.14
buyer_7,María,56,ES12209529607663493637,TRX_N-00435-08804968,2022-12-10T21:30:09,Portugalete,expenses,cash,-100.0,-13933.14
buyer_7,María,56,ES12209529607663493637,TRX_N-00436-19076314,2022-12-11T12:20:39,Donostia,expenses,transport,-81.09,-14014.23
buyer_7,María,56,ES12209529607663493637,TRX_N-00437-83834527,2022-12-11T21:49:15,Portugalete,expenses,repairs,-329.18,-14343.41
buyer_7,María,56,ES12209529607663493637,TRX_N-00438-29450644,2022-12-13T16:01:56,Getxo,expenses,food,-113.9,-14457.31
buyer_7,María,56,ES12209529607663493637,TRX_N-00439-59395503,2022-12-15T12:24:41,Portugalete,expenses,cash,-100.0,-14557.31
buyer_7,María,56,ES12209529607663493637,TRX_N-00440-41999907,2022-12-16T12:53:08,Portugalete,expenses,transport,-81.48,-14638.79
buyer_7,María,56,ES12209529607663493637,TRX_N-00441-25655805,2022-12-18T15:48:56,Portugalete,expenses,food,-103.49,-14742.28
buyer_7,María,56,ES12209529607663493637,TRX_N-00442-08002750,2022-12-19T12:26:53,Oyón-Oion,expenses,leisure,-44.2,-14786.48
buyer_7,María,56,ES12209529607663493637,TRX_N-00443-90437181,2022-12-19T08:29:35,Portugalete,expenses,cash,-100.0,-14886.48
buyer_7,María,56,ES12209529607663493637,TRX_N-00444-60445549,2022-12-20T11:52:57,Sestao,expenses,cash,-100.0,-14986.48
buyer_7,María,56,ES12209529607663493637,TRX_N-00445-61081364,2022-12-21T16:19:41,Portugalete,expenses,cash,-100.0,-15086.48
buyer_7,María,56,ES12209529607663493637,TRX_N-00446-83221935,2022-12-22T15:21:07,Portugalete,expenses,cash,-100.0,-15186.48
buyer_7,María,56,ES12209529607663493637,TRX_N-00447-69577029,2022-12-24T12:30:38,Portugalete,expenses,transport,-76.05,-15262.53
buyer_7,María,56,ES12209529607663493637,TRX_N-00448-20255178,2022-12-24T13:48:43,Sopela,expenses,cash,-100.0,-15362.53
buyer_7,María,56,ES12209529607663493637,TRX_N-00449-93094315,2022-12-25T14:47:33,Portugalete,expenses,cash,-100.0,-15462.53
buyer_7,María,56,ES12209529607663493637,TRX_N-00450-44228105,2022-12-25T18:11:09,Lasarte-Oria,expenses,travel,-1070.93,-16533.46
buyer_7,María,56,ES12209529607663493637,TRX_N-00451-80462127,2022-12-25T16:33:39,Portugalete,expenses,repairs,-220.47,-16753.93
buyer_7,María,56,ES12209529607663493637,TRX_N-00452-07348971,2022-12-28T08:44:26,Portugalete,expenses,leisure,-20.43,-16774.36
buyer_7,María,56,ES12209529607663493637,TRX_N-00453-06656877,2022-12-29T05:47:34,Portugalete,expenses,clothing,-123.89,-16898.25
buyer_7,María,56,ES12209529607663493637,TRX_N-00454-63350640,2022-12-30T18:05:20,Eibar,expenses,repairs,-240.33,-17138.58
buyer_7,María,56,ES12209529607663493637,TRX_N-00455-93689014,2022-12-31T22:07:39,Portugalete,expenses,transport,-70.47,-17209.05
buyer_7,María,56,ES12209529607663493637,TRX_N-00456-09679959,2023-01-01T16:21:33,Portugalete,incomes,salary,1557.81,-15651.24
buyer_7,María,56,ES12209529607663493637,TRX_N-00457-19997480,2023-01-01T16:21:33,Portugalete,incomes,salary_partner,1599.48,-14051.76
buyer_7,María,56,ES12209529607663493637,TRX_N-00458-32970227,2023-01-01T16:10:08,Portugalete,expenses,food,-117.6,-14169.36
buyer_7,María,56,ES12209529607663493637,TRX_N-00459-74220727,2023-01-03T19:29:30,Portugalete,expenses,transport,-57.38,-14226.74
buyer_7,María,56,ES12209529607663493637,TRX_N-00460-71700283,2023-01-04T15:27:01,Portugalete,expenses,mortgage,-717.72,-14944.46
buyer_7,María,56,ES12209529607663493637,TRX_N-00461-21701942,2023-01-04T23:34:25,Portugalete,expenses,transport,-54.95,-14999.41
buyer_7,María,56,ES12209529607663493637,TRX_N-00462-22816950,2023-01-04T11:16:31,Portugalete,expenses,clothing,-130.17,-15129.58
buyer_7,María,56,ES12209529607663493637,TRX_N-00463-83906621,2023-01-05T18:08:49,Portugalete,expenses,internet,-42.0,-15171.58
buyer_7,María,56,ES12209529607663493637,TRX_N-00464-10175885,2023-01-06T20:40:44,Portugalete,expenses,electricity,-76.78,-15248.36
buyer_7,María,56,ES12209529607663493637,TRX_N-00465-60536289,2023-01-06T18:30:20,Portugalete,expenses,gas,-102.29,-15350.65
buyer_7,María,56,ES12209529607663493637,TRX_N-00466-72764064,2023-01-08T17:20:30,Portugalete,expenses,water,-22.2,-15372.85
buyer_7,María,56,ES12209529607663493637,TRX_N-00467-80915724,2023-01-08T06:10:44,Portugalete,expenses,phone,-31.39,-15404.24
buyer_7,María,56,ES12209529607663493637,TRX_N-00468-08878659,2023-01-08T10:57:37,Portugalete,expenses,cash,-100.0,-15504.24
buyer_7,María,56,ES12209529607663493637,TRX_N-00469-85877800,2023-01-09T22:29:43,Salvatierra/Agurain,expenses,repairs,-322.59,-15826.83
buyer_7,María,56,ES12209529607663493637,TRX_N-00470-25983495,2023-01-10T18:03:52,Alegría-Dulantzi,expenses,cash,-100.0,-15926.83
buyer_7,María,56,ES12209529607663493637,TRX_N-00471-16257868,2023-01-11T10:44:38,Portugalete,expenses,repairs,-213.53,-16140.36
buyer_7,María,56,ES12209529607663493637,TRX_N-00472-19534586,2023-01-13T08:19:14,Portugalete,expenses,gifts,-724.27,-16864.63
buyer_7,María,56,ES12209529607663493637,TRX_N-00473-68658668,2023-01-14T09:07:51,Portugalete,expenses,food,-96.05,-16960.68
buyer_7,María,56,ES12209529607663493637,TRX_N-00474-06848880,2023-01-15T20:15:04,Errenteria,expenses,repairs,-178.84,-17139.52
buyer_7,María,56,ES12209529607663493637,TRX_N-00475-69978075,2023-01-17T12:44:19,Portugalete,expenses,leisure,-61.37,-17200.89
buyer_7,María,56,ES12209529607663493637,TRX_N-00476-99394046,2023-01-19T19:38:41,Portugalete,expenses,healthcare,-73.35,-17274.24
buyer_7,María,56,ES12209529607663493637,TRX_N-00477-56510947,2023-01-21T18:19:30,Portugalete,expenses,transport,-77.04,-17351.28
buyer_7,María,56,ES12209529607663493637,TRX_N-00478-11392134,2023-01-21T19:22:45,Portugalete,expenses,cash,-100.0,-17451.28
buyer_7,María,56,ES12209529607663493637,TRX_N-00479-87656203,2023-01-22T17:04:16,Portugalete,expenses,transport,-79.74,-17531.02
buyer_7,María,56,ES12209529607663493637,TRX_N-00480-21723969,2023-01-22T20:50:42,Donostia,expenses,clothing,-159.62,-17690.64
buyer_7,María,56,ES12209529607663493637,TRX_N-00481-61326778,2023-01-22T09:29:46,Portugalete,expenses,repairs,-62.87,-17753.51
buyer_7,María,56,ES12209529607663493637,TRX_N-00482-15108809,2023-01-23T06:10:03,Portugalete,expenses,leisure,-54.66,-17808.17
buyer_7,María,56,ES12209529607663493637,TRX_N-00483-24512251,2023-01-23T08:33:43,Portugalete,expenses,clothing,-136.02,-17944.19
buyer_7,María,56,ES12209529607663493637,TRX_N-00484-85079709,2023-01-23T18:16:41,Portugalete,expenses,repairs,-130.69,-18074.88
buyer_7,María,56,ES12209529607663493637,TRX_N-00485-48927782,2023-01-24T18:44:56,Portugalete,expenses,travel,-930.9,-19005.78
buyer_7,María,56,ES12209529607663493637,TRX_N-00486-87144417,2023-01-24T19:03:24,Portugalete,expenses,repairs,-73.45,-19079.23
buyer_7,María,56,ES12209529607663493637,TRX_N-00487-90756424,2023-01-25T08:34:09,Andoain,expenses,leisure,-67.76,-19146.99
buyer_7,María,56,ES12209529607663493637,TRX_N-00488-12477415,2023-01-25T00:04:10,Portugalete,expenses,cash,-100.0,-19246.99
buyer_7,María,56,ES12209529607663493637,TRX_N-00489-06802167,2023-01-25T23:42:31,Portugalete,expenses,appliances,-216.46,-19463.45
buyer_7,María,56,ES12209529607663493637,TRX_N-00490-59152085,2023-01-25T13:32:16,Portugalete,expenses,children,-177.73,-19641.18
buyer_7,María,56,ES12209529607663493637,TRX_N-00491-93494838,2023-01-26T08:38:50,Portugalete,expenses,repairs,-323.48,-19964.66
buyer_7,María,56,ES12209529607663493637,TRX_N-00492-69125136,2023-01-28T15:55:08,Portugalete,expenses,leisure,-24.02,-19988.68
buyer_7,María,56,ES12209529607663493637,TRX_N-00493-83600119,2023-01-28T08:51:55,Zarautz,expenses,clothing,-82.45,-20071.13
buyer_7,María,56,ES12209529607663493637,TRX_N-00494-63180492,2023-01-28T18:10:29,Basauri,expenses,healthcare,-79.57,-20150.7
buyer_7,María,56,ES12209529607663493637,TRX_N-00495-64583799,2023-01-29T17:34:20,Berango,expenses,education,-63.89,-20214.59
buyer_7,María,56,ES12209529607663493637,TRX_N-00496-42919580,2023-01-29T18:50:45,Portugalete,expenses,cash,-100.0,-20314.59
buyer_7,María,56,ES12209529607663493637,TRX_N-00497-82779266,2023-01-31T15:36:04,Portugalete,expenses,leisure,-81.38,-20395.97
buyer_7,María,56,ES12209529607663493637,TRX_N-00498-19184579,2023-01-31T08:48:55,Portugalete,expenses,cash,-100.0,-20495.97
buyer_7,María,56,ES12209529607663493637,TRX_N-00499-67731224,2023-02-01T16:31:18,Portugalete,incomes,salary,1557.81,-18938.16
buyer_7,María,56,ES12209529607663493637,TRX_N-00500-16769387,2023-02-01T16:31:18,Portugalete,incomes,salary_partner,1599.48,-17338.68
buyer_7,María,56,ES12209529607663493637,TRX_N-00501-30482990,2023-02-01T16:31:18,Portugalete,incomes,extra_income,243.65,-17095.03
buyer_7,María,56,ES12209529607663493637,TRX_N-00502-28947205,2023-02-01T20:26:16,Labastida,expenses,food,-95.69,-17190.72
buyer_7,María,56,ES12209529607663493637,TRX_N-00503-45649291,2023-02-01T09:54:04,Portugalete,expenses,healthcare,-65.37,-17256.09
buyer_7,María,56,ES12209529607663493637,TRX_N-00504-34064413,2023-02-01T16:34:56,Portugalete,expenses,cash,-100.0,-17356.09
buyer_7,María,56,ES12209529607663493637,TRX_N-00505-49723954,2023-02-03T10:30:44,Portugalete,expenses,cash,-100.0,-17456.09
buyer_7,María,56,ES12209529607663493637,TRX_N-00506-41544328,2023-02-04T10:41:39,Portugalete,expenses,mortgage,-717.72,-18173.81
buyer_7,María,56,ES12209529607663493637,TRX_N-00507-91382609,2023-02-05T17:34:52,Portugalete,expenses,water,-32.42,-18206.23
buyer_7,María,56,ES12209529607663493637,TRX_N-00508-52855210,2023-02-05T10:22:24,Portugalete,expenses,electricity,-67.67,-18273.9
buyer_7,María,56,ES12209529607663493637,TRX_N-00509-55728918,2023-02-05T16:58:54,Portugalete,expenses,leisure,-46.33,-18320.23
buyer_7,María,56,ES12209529607663493637,TRX_N-00510-76834947,2023-02-05T21:16:37,Portugalete,expenses,cash,-100.0,-18420.23
buyer_7,María,56,ES12209529607663493637,TRX_N-00511-82631245,2023-02-06T17:04:18,Portugalete,expenses,food,-64.52,-18484.75
buyer_7,María,56,ES12209529607663493637,TRX_N-00512-03381450,2023-02-07T18:48:27,Portugalete,expenses,internet,-42.0,-18526.75
buyer_7,María,56,ES12209529607663493637,TRX_N-00513-20944128,2023-02-07T01:29:39,Pasaia,expenses,gifts,-801.23,-19327.98
buyer_7,María,56,ES12209529607663493637,TRX_N-00514-20556667,2023-02-08T08:51:37,Portugalete,expenses,gas,-87.1,-19415.08
buyer_7,María,56,ES12209529607663493637,TRX_N-00515-27287487,2023-02-08T19:29:24,Portugalete,expenses,phone,-31.92,-19447.0
buyer_7,María,56,ES12209529607663493637,TRX_N-00516-76342365,2023-02-08T14:54:46,Portugalete,expenses,food,-95.44,-19542.44
buyer_7,María,56,ES12209529607663493637,TRX_N-00517-50617937,2023-02-09T14:17:51,Portugalete,expenses,transport,-46.14,-19588.58
buyer_7,María,56,ES12209529607663493637,TRX_N-00518-91529313,2023-02-09T21:17:54,Bermeo,expenses,cash,-100.0,-19688.58
buyer_7,María,56,ES12209529607663493637,TRX_N-00519-77438168,2023-02-10T08:29:18,Hernani,expenses,food,-112.69,-19801.27
buyer_7,María,56,ES12209529607663493637,TRX_N-00520-93019459,2023-02-10T11:04:27,Portugalete,expenses,transport,-62.48,-19863.75
buyer_7,María,56,ES12209529607663493637,TRX_N-00521-38718613,2023-02-10T23:06:28,Arrasate,expenses,clothing,-70.88,-19934.63
buyer_7,María,56,ES12209529607663493637,TRX_N-00522-60528387,2023-02-13T10:45:14,Portugalete,expenses,clothing,-71.39,-20006.02
buyer_7,María,56,ES12209529607663493637,TRX_N-00523-73397990,2023-02-14T08:24:14,Portugalete,expenses,food,-120.63,-20126.65
buyer_7,María,56,ES12209529607663493637,TRX_N-00524-29434345,2023-02-15T16:04:40,Santurtzi,expenses,education,-77.87,-20204.52
buyer_7,María,56,ES12209529607663493637,TRX_N-00525-86604864,2023-02-15T00:20:49,Portugalete,expenses,travel,-985.92,-21190.44
buyer_7,María,56,ES12209529607663493637,TRX_N-00526-00709802,2023-02-16T18:59:11,Portugalete,expenses,food,-64.91,-21255.35
buyer_7,María,56,ES12209529607663493637,TRX_N-00527-15235488,2023-02-16T15:18:47,Portugalete,expenses,healthcare,-86.37,-21341.72
buyer_7,María,56,ES12209529607663493637,TRX_N-00528-08467966,2023-02-16T09:02:53,Portugalete,expenses,repairs,-279.65,-21621.37
buyer_7,María,56,ES12209529607663493637,TRX_N-00529-21418913,2023-02-16T13:10:14,Portugalete,expenses,children,-276.2,-21897.57
buyer_7,María,56,ES12209529607663493637,TRX_N-00530-81238685,2023-02-17T17:33:42,Portugalete,expenses,leisure,-20.28,-21917.85
buyer_7,María,56,ES12209529607663493637,TRX_N-00531-49002854,2023-02-17T17:46:38,Portugalete,expenses,children,-160.63,-22078.48
buyer_7,María,56,ES12209529607663493637,TRX_N-00532-83145994,2023-02-20T17:29:43,Zuia,expenses,cash,-100.0,-22178.48
buyer_7,María,56,ES12209529607663493637,TRX_N-00533-67661551,2023-02-21T08:50:00,Hondarribia,expenses,transport,-45.96,-22224.44
buyer_7,María,56,ES12209529607663493637,TRX_N-00534-63043685,2023-02-23T17:36:41,Portugalete,expenses,cash,-100.0,-22324.44
buyer_7,María,56,ES12209529607663493637,TRX_N-00535-85960890,2023-02-23T13:53:29,Portugalete,expenses,gifts,-466.82,-22791.26
buyer_7,María,56,ES12209529607663493637,TRX_N-00536-87168740,2023-02-24T17:56:45,Portugalete,expenses,gifts,-92.12,-22883.38
buyer_7,María,56,ES12209529607663493637,TRX_N-00537-91917256,2023-02-25T10:24:37,Getxo,expenses,travel,-936.33,-23819.71
buyer_7,María,56,ES12209529607663493637,TRX_N-00538-35167484,2023-03-01T11:47:53,Portugalete,incomes,salary,1557.81,-22261.9
buyer_7,María,56,ES12209529607663493637,TRX_N-00539-73834221,2023-03-01T11:47:53,Portugalete,incomes,salary_partner,1599.48,-20662.42
buyer_7,María,56,ES12209529607663493637,TRX_N-00540-84565461,2023-03-03T20:08:57,Portugalete,expenses,cash,-100.0,-20762.42
buyer_7,María,56,ES12209529607663493637,TRX_N-00541-19531822,2023-03-03T16:01:43,Portugalete,expenses,gifts,-334.12,-21096.54
buyer_7,María,56,ES12209529607663493637,TRX_N-00542-09550193,2023-03-04T18:46:31,Portugalete,expenses,mortgage,-717.72,-21814.26
buyer_7,María,56,ES12209529607663493637,TRX_N-00543-00012974,2023-03-05T08:48:02,Portugalete,expenses,food,-100.98,-21915.24
buyer_7,María,56,ES12209529607663493637,TRX_N-00544-76081817,2023-03-05T16:24:16,Portugalete,expenses,cash,-100.0,-22015.24
buyer_7,María,56,ES12209529607663493637,TRX_N-00545-60212304,2023-03-07T14:52:44,Portugalete,expenses,internet,-42.0,-22057.24
buyer_7,María,56,ES12209529607663493637,TRX_N-00546-51266265,2023-03-07T09:20:20,Portugalete,expenses,phone,-33.68,-22090.92
buyer_7,María,56,ES12209529607663493637,TRX_N-00547-88377219,2023-03-08T21:09:58,Portugalete,expenses,water,-31.63,-22122.55
buyer_7,María,56,ES12209529607663493637,TRX_N-00548-80155941,2023-03-08T20:54:57,Portugalete,expenses,electricity,-64.99,-22187.54
buyer_7,María,56,ES12209529607663493637,TRX_N-00549-69976265,2023-03-08T17:47:14,Portugalete,expenses,gas,-108.31,-22295.85
buyer_7,María,56,ES12209529607663493637,TRX_N-00550-65292704,2023-03-08T17:46:17,Portugalete,expenses,food,-89.46,-22385.31
buyer_7,María,56,ES12209529607663493637,TRX_N-00551-00093688,2023-03-08T00:23:27,Portugalete,expenses,transport,-56.13,-22441.44
buyer_7,María,56,ES12209529607663493637,TRX_N-00552-71028076,2023-03-08T09:49:32,Irun,expenses,leisure,-49.17,-22490.61
buyer_7,María,56,ES12209529607663493637,TRX_N-00553-18374544,2023-03-09T10:18:58,Portugalete,expenses,cash,-100.0,-22590.61
buyer_7,María,56,ES12209529607663493637,TRX_N-00554-66576858,2023-03-11T14:17:02,Portugalete,expenses,healthcare,-125.08,-22715.69
buyer_7,María,56,ES12209529607663493637,TRX_N-00555-23023555,2023-03-13T10:34:18,Portugalete,expenses,food,-77.6,-22793.29
buyer_7,María,56,ES12209529607663493637,TRX_N-00556-27009435,2023-03-13T19:23:55,Portugalete,expenses,transport,-57.38,-22850.67
buyer_7,María,56,ES12209529607663493637,TRX_N-00557-69394945,2023-03-13T17:50:58,Errenteria,expenses,repairs,-272.22,-23122.89
buyer_7,María,56,ES12209529607663493637,TRX_N-00558-98141079,2023-03-15T19:24:50,Portugalete,expenses,cash,-100.0,-23222.89
buyer_7,María,56,ES12209529607663493637,TRX_N-00559-94484348,2023-03-16T23:58:08,Portugalete,expenses,food,-81.89,-23304.78
buyer_7,María,56,ES12209529607663493637,TRX_N-00560-79141171,2023-03-16T10:40:14,Portugalete,expenses,healthcare,-61.3,-23366.08
buyer_7,María,56,ES12209529607663493637,TRX_N-00561-52108928,2023-03-17T16:41:12,Zarautz,expenses,repairs,-321.08,-23687.16
buyer_7,María,56,ES12209529607663493637,TRX_N-00562-27679955,2023-03-17T20:18:13,Portugalete,expenses,gifts,-656.45,-24343.61
buyer_7,María,56,ES12209529607663493637,TRX_N-00563-30309768,2023-03-20T14:54:48,Portugalete,expenses,food,-118.78,-24462.39
buyer_7,María,56,ES12209529607663493637,TRX_N-00564-40663753,2023-03-20T08:38:08,Portugalete,expenses,transport,-85.04,-24547.43
buyer_7,María,56,ES12209529607663493637,TRX_N-00565-04949963,2023-03-21T15:44:56,Portugalete,expenses,food,-64.61,-24612.04
buyer_7,María,56,ES12209529607663493637,TRX_N-00566-72042987,2023-03-21T09:52:55,Portugalete,expenses,appliances,-376.4,-24988.44
buyer_7,María,56,ES12209529607663493637,TRX_N-00567-45407715,2023-03-22T16:38:53,Portugalete,expenses,transport,-48.13,-25036.57
buyer_7,María,56,ES12209529607663493637,TRX_N-00568-90989183,2023-03-22T10:56:49,Portugalete,expenses,clothing,-93.77,-25130.34
buyer_7,María,56,ES12209529607663493637,TRX_N-00569-84338616,2023-03-23T03:00:26,Portugalete,expenses,gifts,-328.04,-25458.38
buyer_7,María,56,ES12209529607663493637,TRX_N-00570-37943623,2023-03-24T10:51:28,Portugalete,expenses,leisure,-70.47,-25528.85
buyer_7,María,56,ES12209529607663493637,TRX_N-00571-71699347,2023-03-24T17:30:50,Portugalete,expenses,repairs,-170.26,-25699.11
buyer_7,María,56,ES12209529607663493637,TRX_N-00572-39495538,2023-03-25T08:35:50,Portugalete,expenses,cash,-100.0,-25799.11
buyer_7,María,56,ES12209529607663493637,TRX_N-00573-42608295,2023-03-26T11:46:42,Donostia,expenses,gifts,-287.96,-26087.07
buyer_7,María,56,ES12209529607663493637,TRX_N-00574-13074223,2023-03-27T10:42:32,Portugalete,expenses,leisure,-42.1,-26129.17
buyer_7,María,56,ES12209529607663493637,TRX_N-00575-79473401,2023-03-28T18:25:48,Portugalete,expenses,food,-103.25,-26232.42
buyer_7,María,56,ES12209529607663493637,TRX_N-00576-75560321,2023-03-28T10:35:47,Portugalete,expenses,cash,-100.0,-26332.42
buyer_7,María,56,ES12209529607663493637,TRX_N-00577-92677231,2023-03-29T20:15:56,Portugalete,expenses,cash,-100.0,-26432.42
buyer_7,María,56,ES12209529607663493637,TRX_N-00578-22931483,2023-03-29T14:10:32,Portugalete,expenses,gifts,-643.8,-27076.22
buyer_7,María,56,ES12209529607663493637,TRX_N-00579-45905798,2023-03-30T02:16:45,Portugalete,expenses,transport,-60.91,-27137.13
buyer_7,María,56,ES12209529607663493637,TRX_N-00580-52840601,2023-03-30T16:21:48,Errenteria,expenses,leisure,-44.92,-27182.05
buyer_7,María,56,ES12209529607663493637,TRX_N-00581-79230269,2023-03-30T08:04:47,Sestao,expenses,gifts,-692.0,-27874.05
buyer_7,María,56,ES12209529607663493637,TRX_N-00582-07996694,2023-04-01T19:55:02,Portugalete,incomes,salary,1557.81,-26316.24
buyer_7,María,56,ES12209529607663493637,TRX_N-00583-87343448,2023-04-01T19:55:02,Portugalete,incomes,salary_partner,1599.48,-24716.76
buyer_7,María,56,ES12209529607663493637,TRX_N-00584-51137072,2023-04-01T19:28:59,Portugalete,expenses,education,-43.42,-24760.18
buyer_7,María,56,ES12209529607663493637,TRX_N-00585-01538389,2023-04-02T14:50:10,Portugalete,expenses,cash,-100.0,-24860.18
buyer_7,María,56,ES12209529607663493637,TRX_N-00586-55606708,2023-04-02T08:23:53,Portugalete,expenses,children,-75.71,-24935.89
buyer_7,María,56,ES12209529607663493637,TRX_N-00587-30181059,2023-04-03T10:22:53,Portugalete,expenses,food,-82.49,-25018.38
buyer_7,María,56,ES12209529607663493637,TRX_N-00588-21393380,2023-04-03T14:44:09,Portugalete,expenses,gifts,-640.83,-25659.21
buyer_7,María,56,ES12209529607663493637,TRX_N-00589-21713356,2023-04-04T14:33:47,Portugalete,expenses,mortgage,-717.72,-26376.93
buyer_7,María,56,ES12209529607663493637,TRX_N-00590-26813353,2023-04-04T11:34:06,Mungia,expenses,food,-106.78,-26483.71
buyer_7,María,56,ES12209529607663493637,TRX_N-00591-41296545,2023-04-05T17:42:56,Portugalete,expenses,electricity,-49.3,-26533.01
buyer_7,María,56,ES12209529607663493637,TRX_N-00592-70088685,2023-04-05T11:06:06,Portugalete,expenses,food,-124.16,-26657.17
buyer_7,María,56,ES12209529607663493637,TRX_N-00593-50484115,2023-04-05T17:59:15,Portugalete,expenses,appliances,-158.22,-26815.39
buyer_7,María,56,ES12209529607663493637,TRX_N-00594-82492190,2023-04-06T06:48:24,Portugalete,expenses,leisure,-27.96,-26843.35
buyer_7,María,56,ES12209529607663493637,TRX_N-00595-10182935,2023-04-06T20:59:19,Portugalete,expenses,cash,-100.0,-26943.35
buyer_7,María,56,ES12209529607663493637,TRX_N-00596-69911141,2023-04-06T16:49:13,Portugalete,expenses,gifts,-434.1,-27377.45
buyer_7,María,56,ES12209529607663493637,TRX_N-00597-77967859,2023-04-07T00:40:03,Portugalete,expenses,gas,-65.38,-27442.83
buyer_7,María,56,ES12209529607663493637,TRX_N-00598-39385611,2023-04-07T07:41:19,Portugalete,expenses,leisure,-27.41,-27470.24
buyer_7,María,56,ES12209529607663493637,TRX_N-00599-94653089,2023-04-07T17:11:35,Portugalete,expenses,cash,-100.0,-27570.24
buyer_7,María,56,ES12209529607663493637,TRX_N-00600-02678148,2023-04-08T20:52:41,Portugalete,expenses,internet,-42.0,-27612.24
buyer_7,María,56,ES12209529607663493637,TRX_N-00601-90080913,2023-04-08T15:21:46,Portugalete,expenses,water,-29.8,-27642.04
buyer_7,María,56,ES12209529607663493637,TRX_N-00602-37564883,2023-04-08T08:54:27,Portugalete,expenses,phone,-38.37,-27680.41
buyer_7,María,56,ES12209529607663493637,TRX_N-00603-62616050,2023-04-08T10:02:57,Portugalete,expenses,transport,-62.48,-27742.89
buyer_7,María,56,ES12209529607663493637,TRX_N-00604-85610883,2023-04-09T17:21:31,Portugalete,expenses,transport,-74.62,-27817.51
buyer_7,María,56,ES12209529607663493637,TRX_N-00605-43093124,2023-04-09T12:24:27,Donostia,expenses,education,-73.77,-27891.28
buyer_7,María,56,ES12209529607663493637,TRX_N-00606-04642406,2023-04-10T17:09:31,Portugalete,expenses,transport,-57.33,-27948.61
buyer_7,María,56,ES12209529607663493637,TRX_N-00607-98029511,2023-04-11T11:07:38,Portugalete,expenses,transport,-44.39,-27993.0
buyer_7,María,56,ES12209529607663493637,TRX_N-00608-90884287,2023-04-11T03:29:14,Bilbao,expenses,cash,-100.0,-28093.0
buyer_7,María,56,ES12209529607663493637,TRX_N-00609-27235232,2023-04-13T20:14:51,Portugalete,expenses,cash,-100.0,-28193.0
buyer_7,María,56,ES12209529607663493637,TRX_N-00610-09079656,2023-04-14T22:10:18,Portugalete,expenses,leisure,-47.41,-28240.41
buyer_7,María,56,ES12209529607663493637,TRX_N-00611-41625420,2023-04-16T18:33:16,Portugalete,expenses,food,-91.8,-28332.21
buyer_7,María,56,ES12209529607663493637,TRX_N-00612-58682779,2023-04-16T17:23:24,Portugalete,expenses,clothing,-63.66,-28395.87
buyer_7,María,56,ES12209529607663493637,TRX_N-00613-17433513,2023-04-16T12:04:23,Portugalete,expenses,repairs,-300.39,-28696.26
buyer_7,María,56,ES12209529607663493637,TRX_N-00614-17149350,2023-04-17T15:41:33,Portugalete,expenses,leisure,-75.93,-28772.19
buyer_7,María,56,ES12209529607663493637,TRX_N-00615-70565859,2023-04-20T02:18:40,Portugalete,expenses,leisure,-70.35,-28842.54
buyer_7,María,56,ES12209529607663493637,TRX_N-00616-50909255,2023-04-21T02:48:00,Portugalete,expenses,transport,-61.39,-28903.93
buyer_7,María,56,ES12209529607663493637,TRX_N-00617-62424232,2023-04-21T14:48:28,Portugalete,expenses,children,-252.17,-29156.1
buyer_7,María,56,ES12209529607663493637,TRX_N-00618-48590426,2023-04-22T13:19:36,Portugalete,expenses,appliances,-85.49,-29241.59
buyer_7,María,56,ES12209529607663493637,TRX_N-00619-45300032,2023-04-23T16:39:37,Portugalete,expenses,leisure,-68.19,-29309.78
buyer_7,María,56,ES12209529607663493637,TRX_N-00620-58077288,2023-04-23T21:56:21,Portugalete,expenses,education,-77.45,-29387.23
buyer_7,María,56,ES12209529607663493637,TRX_N-00621-95755103,2023-04-23T12:39:35,Portugalete,expenses,gifts,-92.48,-29479.71
buyer_7,María,56,ES12209529607663493637,TRX_N-00622-96641832,2023-04-25T15:41:28,Portugalete,expenses,leisure,-83.24,-29562.95
buyer_7,María,56,ES12209529607663493637,TRX_N-00623-97184149,2023-04-25T18:46:29,Portugalete,expenses,clothing,-60.13,-29623.08
buyer_7,María,56,ES12209529607663493637,TRX_N-00624-79892870,2023-04-26T09:21:45,Alegría-Dulantzi,expenses,transport,-40.28,-29663.36
buyer_7,María,56,ES12209529607663493637,TRX_N-00625-00086212,2023-04-26T18:42:09,Portugalete,expenses,leisure,-64.47,-29727.83
buyer_7,María,56,ES12209529607663493637,TRX_N-00626-57282310,2023-04-27T14:53:15,Portugalete,expenses,cash,-100.0,-29827.83
buyer_7,María,56,ES12209529607663493637,TRX_N-00627-75006045,2023-04-29T12:00:39,Portugalete,expenses,leisure,-79.39,-29907.22
buyer_7,María,56,ES12209529607663493637,TRX_N-00628-09174337,2023-04-29T18:51:33,Erandio,expenses,cash,-100.0,-30007.22
buyer_7,María,56,ES12209529607663493637,TRX_N-00629-66360456,2023-04-30T12:58:05,Portugalete,expenses,food,-103.57,-30110.79
buyer_7,María,56,ES12209529607663493637,TRX_N-00630-02111171,2023-04-30T16:31:54,Portugalete,expenses,leisure,-84.41,-30195.2
buyer_7,María,56,ES12209529607663493637,TRX_N-00631-80579461,2023-05-01T22:11:04,Portugalete,incomes,salary,1557.81,-28637.39
buyer_7,María,56,ES12209529607663493637,TRX_N-00632-80825610,2023-05-01T22:11:04,Portugalete,incomes,salary_partner,1599.48,-27037.91
buyer_7,María,56,ES12209529607663493637,TRX_N-00633-26489280,2023-05-01T22:11:04,Portugalete,incomes,extra_income,243.65,-26794.26
buyer_7,María,56,ES12209529607663493637,TRX_N-00634-83401860,2023-05-01T19:53:40,Portugalete,expenses,cash,-100.0,-26894.26
buyer_7,María,56,ES12209529607663493637,TRX_N-00635-36066725,2023-05-02T19:51:21,Portugalete,expenses,food,-74.13,-26968.39
buyer_7,María,56,ES12209529607663493637,TRX_N-00636-54413905,2023-05-02T09:44:40,Portugalete,expenses,leisure,-78.14,-27046.53
buyer_7,María,56,ES12209529607663493637,TRX_N-00637-94484401,2023-05-04T15:14:03,Portugalete,expenses,mortgage,-717.72,-27764.25
buyer_7,María,56,ES12209529607663493637,TRX_N-00638-65269744,2023-05-04T12:07:47,Portugalete,expenses,repairs,-327.03,-28091.28
buyer_7,María,56,ES12209529607663493637,TRX_N-00639-00782332,2023-05-05T11:27:34,Portugalete,expenses,gas,-70.77,-28162.05
buyer_7,María,56,ES12209529607663493637,TRX_N-00640-12817480,2023-05-05T20:07:06,Portugalete,expenses,phone,-37.91,-28199.96
buyer_7,María,56,ES12209529607663493637,TRX_N-00641-24060033,2023-05-05T13:30:23,Portugalete,expenses,gifts,-378.02,-28577.98
buyer_7,María,56,ES12209529607663493637,TRX_N-00642-51418824,2023-05-06T21:21:38,Portugalete,expenses,electricity,-55.53,-28633.51
buyer_7,María,56,ES12209529607663493637,TRX_N-00643-17133399,2023-05-07T17:10:36,Portugalete,expenses,water,-31.78,-28665.29
buyer_7,María,56,ES12209529607663493637,TRX_N-00644-96455873,2023-05-07T16:47:27,Portugalete,expenses,leisure,-40.42,-28705.71
buyer_7,María,56,ES12209529607663493637,TRX_N-00645-59937306,2023-05-08T12:24:53,Portugalete,expenses,internet,-42.0,-28747.71
buyer_7,María,56,ES12209529607663493637,TRX_N-00646-38665028,2023-05-11T18:32:54,Portugalete,expenses,food,-81.73,-28829.44
buyer_7,María,56,ES12209529607663493637,TRX_N-00647-29727492,2023-05-11T05:06:54,Portugalete,expenses,education,-51.56,-28881.0
buyer_7,María,56,ES12209529607663493637,TRX_N-00648-59062997,2023-05-12T12:02:17,Portugalete,expenses,transport,-84.33,-28965.33
buyer_7,María,56,ES12209529607663493637,TRX_N-00649-65461664,2023-05-13T19:20:44,Portugalete,expenses,appliances,-257.14,-29222.47
buyer_7,María,56,ES12209529607663493637,TRX_N-00650-74157617,2023-05-14T21:34:50,Bilbao,expenses,healthcare,-73.14,-29295.61
buyer_7,María,56,ES12209529607663493637,TRX_N-00651-75313141,2023-05-15T16:13:43,Portugalete,expenses,cash,-100.0,-29395.61
buyer_7,María,56,ES12209529607663493637,TRX_N-00652-00790803,2023-05-20T09:48:03,Portugalete,expenses,food,-113.33,-29508.94
buyer_7,María,56,ES12209529607663493637,TRX_N-00653-12546986,2023-05-20T20:50:07,Zarautz,expenses,cash,-100.0,-29608.94
buyer_7,María,56,ES12209529607663493637,TRX_N-00654-68703598,2023-05-21T19:59:39,Portugalete,expenses,leisure,-29.56,-29638.5
buyer_7,María,56,ES12209529607663493637,TRX_N-00655-62557198,2023-05-23T09:58:25,Berango,expenses,transport,-60.75,-29699.25
buyer_7,María,56,ES12209529607663493637,TRX_N-00656-97840449,2023-05-23T20:47:06,Lasarte-Oria,expenses,repairs,-264.95,-29964.2
buyer_7,María,56,ES12209529607663493637,TRX_N-00657-02628497,2023-05-23T12:49:13,Basauri,expenses,gifts,-653.46,-30617.66
buyer_7,María,56,ES12209529607663493637,TRX_N-00658-80808633,2023-05-25T09:05:46,Vitoria-Gasteiz,expenses,cash,-100.0,-30717.66
buyer_7,María,56,ES12209529607663493637,TRX_N-00659-58976047,2023-05-26T05:23:30,Portugalete,expenses,food,-111.63,-30829.29
buyer_7,María,56,ES12209529607663493637,TRX_N-00660-26208778,2023-05-27T14:29:12,Portugalete,expenses,clothing,-83.55,-30912.84
buyer_7,María,56,ES12209529607663493637,TRX_N-00661-39468987,2023-05-28T11:49:10,Portugalete,expenses,food,-108.5,-31021.34
buyer_7,María,56,ES12209529607663493637,TRX_N-00662-28566272,2023-05-28T20:57:14,Portugalete,expenses,leisure,-25.21,-31046.55
buyer_7,María,56,ES12209529607663493637,TRX_N-00663-80689208,2023-05-29T20:49:43,Portugalete,expenses,cash,-100.0,-31146.55
buyer_7,María,56,ES12209529607663493637,TRX_N-00664-97655766,2023-05-30T15:21:55,Portugalete,expenses,clothing,-126.05,-31272.6
buyer_7,María,56,ES12209529607663493637,TRX_N-00665-81688017,2023-06-01T20:54:36,Portugalete,incomes,salary,1557.81,-29714.79
buyer_7,María,56,ES12209529607663493637,TRX_N-00666-18061133,2023-06-01T20:54:36,Portugalete,incomes,salary_partner,1599.48,-28115.31
buyer_7,María,56,ES12209529607663493637,TRX_N-00667-63167643,2023-06-01T20:54:36,Portugalete,incomes,salary_bonus,1212.85,-26902.46
buyer_7,María,56,ES12209529607663493637,TRX_N-00668-52551948,2023-06-01T20:54:36,Portugalete,incomes,salary_partner_bonus,1224.77,-25677.69
buyer_7,María,56,ES12209529607663493637,TRX_N-00669-60158261,2023-06-02T08:40:07,Portugalete,expenses,healthcare,-90.77,-25768.46
buyer_7,María,56,ES12209529607663493637,TRX_N-00670-65179834,2023-06-03T15:45:38,Portugalete,expenses,clothing,-147.18,-25915.64
buyer_7,María,56,ES12209529607663493637,TRX_N-00671-83067027,2023-06-04T18:34:15,Portugalete,expenses,mortgage,-717.72,-26633.36
buyer_7,María,56,ES12209529607663493637,TRX_N-00672-94276455,2023-06-04T08:49:05,Portugalete,expenses,food,-119.14,-26752.5
buyer_7,María,56,ES12209529607663493637,TRX_N-00673-19023231,2023-06-04T20:45:42,Portugalete,expenses,healthcare,-67.94,-26820.44
buyer_7,María,56,ES12209529607663493637,TRX_N-00674-95721675,2023-06-05T11:38:09,Portugalete,expenses,electricity,-75.45,-26895.89
buyer_7,María,56,ES12209529607663493637,TRX_N-00675-52223955,2023-06-05T21:15:17,Bermeo,expenses,cash,-100.0,-26995.89
buyer_7,María,56,ES12209529607663493637,TRX_N-00676-59697987,2023-06-06T19:40:23,Durango,expenses,gifts,-556.33,-27552.22
buyer_7,María,56,ES12209529607663493637,TRX_N-00677-68486500,2023-06-07T08:11:52,Portugalete,expenses,education,-77.26,-27629.48
buyer_7,María,56,ES12209529607663493637,TRX_N-00678-41388500,2023-06-07T16:32:53,Santurtzi,expenses,cash,-100.0,-27729.48
buyer_7,María,56,ES12209529607663493637,TRX_N-00679-47218969,2023-06-08T13:10:52,Portugalete,expenses,water,-20.12,-27749.6
buyer_7,María,56,ES12209529607663493637,TRX_N-00680-52503264,2023-06-08T15:53:24,Portugalete,expenses,gas,-66.47,-27816.07
buyer_7,María,56,ES12209529607663493637,TRX_N-00681-66851512,2023-06-08T15:12:31,Portugalete,expenses,internet,-42.0,-27858.07
buyer_7,María,56,ES12209529607663493637,TRX_N-00682-80775697,2023-06-08T19:22:33,Portugalete,expenses,phone,-44.62,-27902.69
buyer_7,María,56,ES12209529607663493637,TRX_N-00683-79440496,2023-06-08T17:13:45,Portugalete,expenses,cash,-100.0,-28002.69
buyer_7,María,56,ES12209529607663493637,TRX_N-00684-89452084,2023-06-09T16:07:01,Portugalete,expenses,cash,-100.0,-28102.69
buyer_7,María,56,ES12209529607663493637,TRX_N-00685-75971559,2023-06-10T08:27:40,Portugalete,expenses,food,-68.27,-28170.96
buyer_7,María,56,ES12209529607663493637,TRX_N-00686-27575277,2023-06-11T18:02:51,Portugalete,expenses,leisure,-50.02,-28220.98
buyer_7,María,56,ES12209529607663493637,TRX_N-00687-24010490,2023-06-13T20:59:39,Portugalete,expenses,appliances,-328.24,-28549.22
buyer_7,María,56,ES12209529607663493637,TRX_N-00688-36731934,2023-06-15T01:49:01,Portugalete,expenses,food,-106.72,-28655.94
buyer_7,María,56,ES12209529607663493637,TRX_N-00689-64576433,2023-06-15T23:21:57,Portugalete,expenses,repairs,-261.16,-28917.1
buyer_7,María,56,ES12209529607663493637,TRX_N-00690-19979006,2023-06-16T12:13:55,Portugalete,expenses,food,-65.3,-28982.4
buyer_7,María,56,ES12209529607663493637,TRX_N-00691-46097654,2023-06-17T13:18:37,Portugalete,expenses,transport,-54.01,-29036.41
buyer_7,María,56,ES12209529607663493637,TRX_N-00692-69663340,2023-06-22T19:45:04,Portugalete,expenses,food,-88.46,-29124.87
buyer_7,María,56,ES12209529607663493637,TRX_N-00693-90962386,2023-06-23T21:07:02,Portugalete,expenses,leisure,-42.08,-29166.95
buyer_7,María,56,ES12209529607663493637,TRX_N-00694-75366080,2023-06-25T22:45:25,Eibar,expenses,travel,-1871.35,-31038.3
buyer_7,María,56,ES12209529607663493637,TRX_N-00695-16877891,2023-06-26T01:34:59,Portugalete,expenses,leisure,-63.35,-31101.65
buyer_7,María,56,ES12209529607663493637,TRX_N-00696-78838804,2023-06-28T04:00:48,Portugalete,expenses,repairs,-283.44,-31385.09
buyer_7,María,56,ES12209529607663493637,TRX_N-00697-52541093,2023-07-01T05:56:44,Portugalete,incomes,salary,1557.81,-29827.28
buyer_7,María,56,ES12209529607663493637,TRX_N-00698-72438909,2023-07-01T05:56:44,Portugalete,incomes,salary_partner,1599.48,-28227.8
buyer_7,María,56,ES12209529607663493637,TRX_N-00699-12260788,2023-07-01T13:22:53,Portugalete,expenses,transport,-75.8,-28303.6
buyer_7,María,56,ES12209529607663493637,TRX_N-00700-68483721,2023-07-02T12:12:41,Portugalete,expenses,transport,-64.27,-28367.87
buyer_7,María,56,ES12209529607663493637,TRX_N-00701-03053353,2023-07-04T17:17:41,Portugalete,expenses,mortgage,-717.72,-29085.59
buyer_7,María,56,ES12209529607663493637,TRX_N-00702-42005429,2023-07-05T19:41:21,Portugalete,expenses,internet,-42.0,-29127.59
buyer_7,María,56,ES12209529607663493637,TRX_N-00703-61350235,2023-07-05T08:16:50,Portugalete,expenses,food,-106.04,-29233.63
buyer_7,María,56,ES12209529607663493637,TRX_N-00704-70413928,2023-07-05T10:06:43,Portugalete,expenses,transport,-76.17,-29309.8
buyer_7,María,56,ES12209529607663493637,TRX_N-00705-27087965,2023-07-06T08:02:53,Portugalete,expenses,education,-72.23,-29382.03
buyer_7,María,56,ES12209529607663493637,TRX_N-00706-64333195,2023-07-06T09:46:40,Portugalete,expenses,gifts,-321.0,-29703.03
buyer_7,María,56,ES12209529607663493637,TRX_N-00707-83550598,2023-07-07T08:19:49,Portugalete,expenses,electricity,-86.9,-29789.93
buyer_7,María,56,ES12209529607663493637,TRX_N-00708-10539256,2023-07-07T19:32:34,Portugalete,expenses,phone,-37.81,-29827.74
buyer_7,María,56,ES12209529607663493637,TRX_N-00709-41982800,2023-07-07T04:14:49,Portugalete,expenses,cash,-100.0,-29927.74
buyer_7,María,56,ES12209529607663493637,TRX_N-00710-78856506,2023-07-08T18:25:32,Portugalete,expenses,water,-26.27,-29954.01
buyer_7,María,56,ES12209529607663493637,TRX_N-00711-88494276,2023-07-08T14:12:33,Portugalete,expenses,gas,-70.32,-30024.33
buyer_7,María,56,ES12209529607663493637,TRX_N-00712-69244422,2023-07-08T12:28:28,Portugalete,expenses,healthcare,-141.38,-30165.71
buyer_7,María,56,ES12209529607663493637,TRX_N-00713-25698742,2023-07-09T02:10:24,Portugalete,expenses,repairs,-123.41,-30289.12
buyer_7,María,56,ES12209529607663493637,TRX_N-00714-74420283,2023-07-10T09:05:48,Portugalete,expenses,children,-268.12,-30557.24
buyer_7,María,56,ES12209529607663493637,TRX_N-00715-25600518,2023-07-12T20:01:55,Portugalete,expenses,gifts,-33.12,-30590.36
buyer_7,María,56,ES12209529607663493637,TRX_N-00716-83582694,2023-07-13T11:35:38,Berango,expenses,clothing,-70.69,-30661.05
buyer_7,María,56,ES12209529607663493637,TRX_N-00717-64154113,2023-07-13T15:00:18,Portugalete,expenses,healthcare,-54.79,-30715.84
buyer_7,María,56,ES12209529607663493637,TRX_N-00718-78110544,2023-07-13T21:44:16,Portugalete,expenses,cash,-100.0,-30815.84
buyer_7,María,56,ES12209529607663493637,TRX_N-00719-48231697,2023-07-14T12:53:23,Elciego,expenses,food,-114.84,-30930.68
buyer_7,María,56,ES12209529607663493637,TRX_N-00720-97684693,2023-07-15T01:33:22,Portugalete,expenses,transport,-53.49,-30984.17
buyer_7,María,56,ES12209529607663493637,TRX_N-00721-22206948,2023-07-15T20:12:43,Portugalete,expenses,cash,-100.0,-31084.17
buyer_7,María,56,ES12209529607663493637,TRX_N-00722-92816519,2023-07-15T13:11:01,Portugalete,expenses,children,-53.05,-31137.22
buyer_7,María,56,ES12209529607663493637,TRX_N-00723-47051625,2023-07-16T19:15:07,Portugalete,expenses,travel,-969.68,-32106.9
buyer_7,María,56,ES12209529607663493637,TRX_N-00724-48369817,2023-07-20T21:45:56,Portugalete,expenses,transport,-52.65,-32159.55
buyer_7,María,56,ES12209529607663493637,TRX_N-00725-46309848,2023-07-20T06:07:12,Portugalete,expenses,clothing,-88.49,-32248.04
buyer_7,María,56,ES12209529607663493637,TRX_N-00726-73436449,2023-07-21T16:42:58,Portugalete,expenses,cash,-100.0,-32348.04
buyer_7,María,56,ES12209529607663493637,TRX_N-00727-22632260,2023-07-23T13:13:12,Donostia,expenses,food,-89.66,-32437.7
buyer_7,María,56,ES12209529607663493637,TRX_N-00728-34381257,2023-07-23T09:55:23,Mungia,expenses,gifts,-281.5,-32719.2
buyer_7,María,56,ES12209529607663493637,TRX_N-00729-55345615,2023-07-26T18:27:00,Portugalete,expenses,transport,-84.69,-32803.89
buyer_7,María,56,ES12209529607663493637,TRX_N-00730-68620438,2023-07-29T09:00:46,Portugalete,expenses,gifts,-697.92,-33501.81
buyer_7,María,56,ES12209529607663493637,TRX_N-00731-29615949,2023-07-30T22:07:28,Portugalete,expenses,cash,-100.0,-33601.81
buyer_7,María,56,ES12209529607663493637,TRX_N-00732-12084878,2023-08-01T22:16:01,Portugalete,incomes,salary,1557.81,-32044.0
buyer_7,María,56,ES12209529607663493637,TRX_N-00733-53691912,2023-08-01T22:16:01,Portugalete,incomes,salary_partner,1599.48,-30444.52
buyer_7,María,56,ES12209529607663493637,TRX_N-00734-07952519,2023-08-01T22:16:01,Portugalete,incomes,extra_income,243.65,-30200.87
buyer_7,María,56,ES12209529607663493637,TRX_N-00735-21591506,2023-08-02T19:00:05,Portugalete,expenses,cash,-100.0,-30300.87
buyer_7,María,56,ES12209529607663493637,TRX_N-00736-35723399,2023-08-03T20:50:15,Portugalete,expenses,transport,-79.69,-30380.56
buyer_7,María,56,ES12209529607663493637,TRX_N-00737-88602882,2023-08-04T13:00:38,Portugalete,expenses,mortgage,-717.72,-31098.28
buyer_7,María,56,ES12209529607663493637,TRX_N-00738-43418497,2023-08-05T16:58:38,Portugalete,expenses,phone,-31.66,-31129.94
buyer_7,María,56,ES12209529607663493637,TRX_N-00739-14763942,2023-08-05T20:05:55,Portugalete,expenses,education,-78.94,-31208.88
buyer_7,María,56,ES12209529607663493637,TRX_N-00740-68269459,2023-08-05T10:50:44,Portugalete,expenses,gifts,-464.6,-31673.48
buyer_7,María,56,ES12209529607663493637,TRX_N-00741-54933850,2023-08-06T13:03:18,Portugalete,expenses,internet,-42.0,-31715.48
buyer_7,María,56,ES12209529607663493637,TRX_N-00742-08982423,2023-08-07T04:04:15,Portugalete,expenses,electricity,-46.49,-31761.97
buyer_7,María,56,ES12209529607663493637,TRX_N-00743-45004044,2023-08-07T18:41:37,Portugalete,expenses,gas,-63.91,-31825.88
buyer_7,María,56,ES12209529607663493637,TRX_N-00744-42120371,2023-08-07T16:08:33,Portugalete,expenses,healthcare,-109.19,-31935.07
buyer_7,María,56,ES12209529607663493637,TRX_N-00745-98810289,2023-08-08T22:59:59,Portugalete,expenses,water,-35.35,-31970.42
buyer_7,María,56,ES12209529607663493637,TRX_N-00746-40138188,2023-08-08T22:36:16,Portugalete,expenses,leisure,-34.67,-32005.09
buyer_7,María,56,ES12209529607663493637,TRX_N-00747-42275010,2023-08-09T03:26:52,Portugalete,expenses,transport,-59.06,-32064.15
buyer_7,María,56,ES12209529607663493637,TRX_N-00748-06867586,2023-08-10T13:43:26,Portugalete,expenses,travel,-1761.91,-33826.06
buyer_7,María,56,ES12209529607663493637,TRX_N-00749-80497626,2023-08-11T13:13:12,Portugalete,expenses,food,-123.76,-33949.82
buyer_7,María,56,ES12209529607663493637,TRX_N-00750-12421371,2023-08-11T16:56:38,Portugalete,expenses,clothing,-63.07,-34012.89
buyer_7,María,56,ES12209529607663493637,TRX_N-00751-38720384,2023-08-18T08:41:49,Mungia,expenses,food,-89.48,-34102.37
buyer_7,María,56,ES12209529607663493637,TRX_N-00752-67353057,2023-08-19T13:33:32,Portugalete,expenses,transport,-85.69,-34188.06
buyer_7,María,56,ES12209529607663493637,TRX_N-00753-01628394,2023-08-22T17:15:43,Portugalete,expenses,transport,-69.76,-34257.82
buyer_7,María,56,ES12209529607663493637,TRX_N-00754-88138025,2023-08-24T20:29:21,Portugalete,expenses,leisure,-64.73,-34322.55
buyer_7,María,56,ES12209529607663493637,TRX_N-00755-84716302,2023-08-25T08:41:56,Portugalete,expenses,food,-89.92,-34412.47
buyer_7,María,56,ES12209529607663493637,TRX_N-00756-16895008,2023-08-25T16:52:05,Portugalete,expenses,leisure,-46.31,-34458.78
buyer_7,María,56,ES12209529607663493637,TRX_N-00757-13516733,2023-08-25T15:27:02,Portugalete,expenses,cash,-100.0,-34558.78
buyer_7,María,56,ES12209529607663493637,TRX_N-00758-33740902,2023-08-27T09:26:10,Donostia,expenses,cash,-100.0,-34658.78
buyer_7,María,56,ES12209529607663493637,TRX_N-00759-08865867,2023-08-28T14:21:54,Portugalete,expenses,transport,-82.58,-34741.36
buyer_7,María,56,ES12209529607663493637,TRX_N-00760-28187339,2023-08-28T19:31:34,Portugalete,expenses,leisure,-31.0,-34772.36
buyer_7,María,56,ES12209529607663493637,TRX_N-00761-42199662,2023-08-28T18:22:54,Portugalete,expenses,gifts,-692.54,-35464.9
buyer_7,María,56,ES12209529607663493637,TRX_N-00762-46146404,2023-08-29T11:41:30,Portugalete,expenses,food,-71.98,-35536.88
buyer_7,María,56,ES12209529607663493637,TRX_N-00763-47228224,2023-08-29T16:55:04,Amurrio,expenses,cash,-100.0,-35636.88
buyer_7,María,56,ES12209529607663493637,TRX_N-00764-18829184,2023-08-31T12:55:25,Portugalete,expenses,leisure,-45.53,-35682.41
buyer_7,María,56,ES12209529607663493637,TRX_N-00765-94746068,2023-08-31T10:38:44,Portugalete,expenses,gifts,-523.01,-36205.42
buyer_7,María,56,ES12209529607663493637,TRX_N-00766-10346070,2023-09-01T12:56:18,Portugalete,incomes,salary,1557.81,-34647.61
buyer_7,María,56,ES12209529607663493637,TRX_N-00767-29246731,2023-09-01T12:56:18,Portugalete,incomes,salary_partner,1599.48,-33048.13
buyer_7,María,56,ES12209529607663493637,TRX_N-00768-71170635,2023-09-01T13:58:41,Portugalete,expenses,transport,-71.92,-33120.05
buyer_7,María,56,ES12209529607663493637,TRX_N-00769-73416984,2023-09-01T21:57:46,Portugalete,expenses,leisure,-68.92,-33188.97
buyer_7,María,56,ES12209529607663493637,TRX_N-00770-14158125,2023-09-01T17:02:44,Portugalete,expenses,travel,-892.45,-34081.42
buyer_7,María,56,ES12209529607663493637,TRX_N-00771-95361818,2023-09-02T20:56:32,Portugalete,expenses,gifts,-92.41,-34173.83
buyer_7,María,56,ES12209529607663493637,TRX_N-00772-02527999,2023-09-03T05:00:02,Portugalete,expenses,cash,-100.0,-34273.83
buyer_7,María,56,ES12209529607663493637,TRX_N-00773-61752169,2023-09-04T15:27:22,Portugalete,expenses,mortgage,-717.72,-34991.55
buyer_7,María,56,ES12209529607663493637,TRX_N-00774-38226036,2023-09-04T10:50:03,Portugalete,expenses,food,-107.69,-35099.24
buyer_7,María,56,ES12209529607663493637,TRX_N-00775-51342000,2023-09-05T11:05:38,Portugalete,expenses,leisure,-81.77,-35181.01
buyer_7,María,56,ES12209529607663493637,TRX_N-00776-65543234,2023-09-06T06:21:17,Portugalete,expenses,phone,-31.96,-35212.97
buyer_7,María,56,ES12209529607663493637,TRX_N-00777-67302702,2023-09-06T12:42:37,Portugalete,expenses,food,-115.62,-35328.59
buyer_7,María,56,ES12209529607663493637,TRX_N-00778-78740050,2023-09-06T18:11:46,Portugalete,expenses,repairs,-261.98,-35590.57
buyer_7,María,56,ES12209529607663493637,TRX_N-00779-03334664,2023-09-07T16:34:25,Portugalete,expenses,food,-97.44,-35688.01
buyer_7,María,56,ES12209529607663493637,TRX_N-00780-58907281,2023-09-07T10:22:47,Portugalete,expenses,transport,-58.24,-35746.25
buyer_7,María,56,ES12209529607663493637,TRX_N-00781-79126596,2023-09-07T18:51:27,Portugalete,expenses,cash,-100.0,-35846.25
buyer_7,María,56,ES12209529607663493637,TRX_N-00782-87598595,2023-09-07T10:23:05,Zarautz,expenses,repairs,-211.43,-36057.68
buyer_7,María,56,ES12209529607663493637,TRX_N-00783-86500979,2023-09-08T19:40:33,Portugalete,expenses,water,-39.78,-36097.46
buyer_7,María,56,ES12209529607663493637,TRX_N-00784-85643640,2023-09-08T18:05:09,Portugalete,expenses,electricity,-34.16,-36131.62
buyer_7,María,56,ES12209529607663493637,TRX_N-00785-39287220,2023-09-08T18:10:46,Portugalete,expenses,gas,-113.24,-36244.86
buyer_7,María,56,ES12209529607663493637,TRX_N-00786-91169216,2023-09-08T15:20:05,Portugalete,expenses,internet,-42.0,-36286.86
buyer_7,María,56,ES12209529607663493637,TRX_N-00787-76094182,2023-09-09T14:20:54,Portugalete,expenses,food,-77.16,-36364.02
buyer_7,María,56,ES12209529607663493637,TRX_N-00788-15959551,2023-09-09T12:03:38,Portugalete,expenses,repairs,-177.27,-36541.29
buyer_7,María,56,ES12209529607663493637,TRX_N-00789-79904859,2023-09-10T03:00:35,Portugalete,expenses,cash,-100.0,-36641.29
buyer_7,María,56,ES12209529607663493637,TRX_N-00790-09928345,2023-09-11T13:01:29,Amurrio,expenses,transport,-82.92,-36724.21
buyer_7,María,56,ES12209529607663493637,TRX_N-00791-40454618,2023-09-12T16:14:51,Santurtzi,expenses,education,-59.63,-36783.84
buyer_7,María,56,ES12209529607663493637,TRX_N-00792-20457134,2023-09-12T11:28:53,Portugalete,expenses,repairs,-297.01,-37080.85
buyer_7,María,56,ES12209529607663493637,TRX_N-00793-62066568,2023-09-13T08:33:51,Basauri,expenses,transport,-44.48,-37125.33
buyer_7,María,56,ES12209529607663493637,TRX_N-00794-77680087,2023-09-13T20:51:31,Portugalete,expenses,cash,-100.0,-37225.33
buyer_7,María,56,ES12209529607663493637,TRX_N-00795-14883692,2023-09-17T17:15:05,Portugalete,expenses,cash,-100.0,-37325.33
buyer_7,María,56,ES12209529607663493637,TRX_N-00796-50338552,2023-09-18T17:51:18,Portugalete,expenses,healthcare,-157.41,-37482.74
buyer_7,María,56,ES12209529607663493637,TRX_N-00797-72861849,2023-09-18T12:42:03,Portugalete,expenses,education,-50.07,-37532.81
buyer_7,María,56,ES12209529607663493637,TRX_N-00798-42668324,2023-09-20T16:54:46,Portugalete,expenses,cash,-100.0,-37632.81
buyer_7,María,56,ES12209529607663493637,TRX_N-00799-11594527,2023-09-26T15:20:54,Portugalete,expenses,transport,-44.22,-37677.03
buyer_7,María,56,ES12209529607663493637,TRX_N-00800-15782190,2023-09-27T12:28:00,Vitoria-Gasteiz,expenses,cash,-100.0,-37777.03
buyer_7,María,56,ES12209529607663493637,TRX_N-00801-92390498,2023-09-28T12:09:08,Portugalete,expenses,food,-113.14,-37890.17
buyer_7,María,56,ES12209529607663493637,TRX_N-00802-50939428,2023-09-30T20:53:02,Portugalete,expenses,education,-64.6,-37954.77
buyer_7,María,56,ES12209529607663493637,TRX_N-00803-19174215,2023-10-01T23:38:39,Portugalete,incomes,salary,1557.81,-36396.96
buyer_7,María,56,ES12209529607663493637,TRX_N-00804-04373581,2023-10-01T23:38:39,Portugalete,incomes,salary_partner,1599.48,-34797.48
buyer_7,María,56,ES12209529607663493637,TRX_N-00805-81838676,2023-10-01T07:47:51,Portugalete,expenses,food,-95.45,-34892.93
buyer_7,María,56,ES12209529607663493637,TRX_N-00806-93459584,2023-10-02T19:31:02,Portugalete,expenses,clothing,-134.76,-35027.69
buyer_7,María,56,ES12209529607663493637,TRX_N-00807-14606540,2023-10-03T09:12:11,Portugalete,expenses,leisure,-32.1,-35059.79
buyer_7,María,56,ES12209529607663493637,TRX_N-00808-78268085,2023-10-04T21:56:33,Portugalete,expenses,mortgage,-717.72,-35777.51
buyer_7,María,56,ES12209529607663493637,TRX_N-00809-10328713,2023-10-04T17:03:46,Elciego,expenses,healthcare,-182.96,-35960.47
buyer_7,María,56,ES12209529607663493637,TRX_N-00810-35644520,2023-10-04T16:43:41,Portugalete,expenses,cash,-100.0,-36060.47
buyer_7,María,56,ES12209529607663493637,TRX_N-00811-75228819,2023-10-05T16:02:04,Portugalete,expenses,water,-21.64,-36082.11
buyer_7,María,56,ES12209529607663493637,TRX_N-00812-91500155,2023-10-05T13:33:36,Portugalete,expenses,gas,-36.98,-36119.09
buyer_7,María,56,ES12209529607663493637,TRX_N-00813-62576693,2023-10-06T21:09:57,Portugalete,expenses,food,-94.63,-36213.72
buyer_7,María,56,ES12209529607663493637,TRX_N-00814-42971666,2023-10-06T08:08:34,Portugalete,expenses,leisure,-63.21,-36276.93
buyer_7,María,56,ES12209529607663493637,TRX_N-00815-80792471,2023-10-07T20:57:01,Bilbao,expenses,transport,-68.86,-36345.79
buyer_7,María,56,ES12209529607663493637,TRX_N-00816-59162122,2023-10-08T10:14:16,Portugalete,expenses,internet,-42.0,-36387.79
buyer_7,María,56,ES12209529607663493637,TRX_N-00817-32483387,2023-10-08T09:05:07,Portugalete,expenses,electricity,-64.58,-36452.37
buyer_7,María,56,ES12209529607663493637,TRX_N-00818-04027249,2023-10-08T12:37:35,Portugalete,expenses,phone,-43.66,-36496.03
buyer_7,María,56,ES12209529607663493637,TRX_N-00819-15837328,2023-10-08T15:32:52,Portugalete,expenses,food,-118.32,-36614.35
buyer_7,María,56,ES12209529607663493637,TRX_N-00820-73381994,2023-10-10T20:12:27,Portugalete,expenses,transport,-48.83,-36663.18
buyer_7,María,56,ES12209529607663493637,TRX_N-00821-48488892,2023-10-10T14:17:27,Portugalete,expenses,cash,-100.0,-36763.18
buyer_7,María,56,ES12209529607663493637,TRX_N-00822-85228411,2023-10-15T13:48:21,Portugalete,expenses,gifts,-698.51,-37461.69
buyer_7,María,56,ES12209529607663493637,TRX_N-00823-36237489,2023-10-17T15:18:15,Portugalete,expenses,cash,-100.0,-37561.69
buyer_7,María,56,ES12209529607663493637,TRX_N-00824-87549350,2023-10-18T01:53:31,Portugalete,expenses,clothing,-81.5,-37643.19
buyer_7,María,56,ES12209529607663493637,TRX_N-00825-04979263,2023-10-19T11:29:20,Portugalete,expenses,transport,-84.49,-37727.68
buyer_7,María,56,ES12209529607663493637,TRX_N-00826-29915905,2023-10-21T17:37:55,Portugalete,expenses,transport,-74.1,-37801.78
buyer_7,María,56,ES12209529607663493637,TRX_N-00827-31533326,2023-10-21T15:42:22,Portugalete,expenses,cash,-100.0,-37901.78
buyer_7,María,56,ES12209529607663493637,TRX_N-00828-96328941,2023-10-22T12:28:18,Portugalete,expenses,food,-97.7,-37999.48
buyer_7,María,56,ES12209529607663493637,TRX_N-00829-17299785,2023-10-22T05:12:33,Portugalete,expenses,cash,-100.0,-38099.48
buyer_7,María,56,ES12209529607663493637,TRX_N-00830-10266185,2023-10-24T19:03:42,Portugalete,expenses,education,-57.13,-38156.61
buyer_7,María,56,ES12209529607663493637,TRX_N-00831-86096584,2023-10-24T22:05:25,Portugalete,expenses,gifts,-193.0,-38349.61
buyer_7,María,56,ES12209529607663493637,TRX_N-00832-41575247,2023-10-27T10:29:23,Portugalete,expenses,transport,-55.63,-38405.24
buyer_7,María,56,ES12209529607663493637,TRX_N-00833-87742810,2023-10-28T11:06:42,Portugalete,expenses,children,-279.01,-38684.25
buyer_7,María,56,ES12209529607663493637,TRX_N-00834-55450284,2023-10-29T22:12:36,Portugalete,expenses,cash,-100.0,-38784.25
buyer_7,María,56,ES12209529607663493637,TRX_N-00835-86775880,2023-10-31T13:30:05,Portugalete,expenses,education,-44.51,-38828.76
buyer_7,María,56,ES12209529607663493637,TRX_N-00836-75124471,2023-10-31T12:17:13,Portugalete,expenses,cash,-100.0,-38928.76
buyer_7,María,56,ES12209529607663493637,TRX_N-00837-07761499,2023-10-31T17:09:05,Portugalete,expenses,children,-53.82,-38982.58
buyer_7,María,56,ES12209529607663493637,TRX_N-00838-28174545,2023-11-01T20:57:04,Portugalete,incomes,salary,1557.81,-37424.77
buyer_7,María,56,ES12209529607663493637,TRX_N-00839-37657040,2023-11-01T20:57:04,Portugalete,incomes,salary_partner,1599.48,-35825.29
buyer_7,María,56,ES12209529607663493637,TRX_N-00840-99641342,2023-11-01T20:57:04,Portugalete,incomes,extra_income,243.65,-35581.64
buyer_7,María,56,ES12209529607663493637,TRX_N-00841-95147149,2023-11-02T19:21:29,Portugalete,expenses,leisure,-50.21,-35631.85
buyer_7,María,56,ES12209529607663493637,TRX_N-00842-59193567,2023-11-02T12:14:37,Portugalete,expenses,cash,-100.0,-35731.85
buyer_7,María,56,ES12209529607663493637,TRX_N-00843-90183515,2023-11-03T18:29:58,Portugalete,expenses,food,-110.0,-35841.85
buyer_7,María,56,ES12209529607663493637,TRX_N-00844-54672871,2023-11-03T19:06:53,Portugalete,expenses,transport,-84.39,-35926.24
buyer_7,María,56,ES12209529607663493637,TRX_N-00845-70199993,2023-11-04T03:00:26,Portugalete,expenses,mortgage,-717.72,-36643.96
buyer_7,María,56,ES12209529607663493637,TRX_N-00846-33006780,2023-11-05T13:34:30,Portugalete,expenses,electricity,-48.15,-36692.11
buyer_7,María,56,ES12209529607663493637,TRX_N-00847-76555382,2023-11-06T12:44:25,Portugalete,expenses,internet,-42.0,-36734.11
buyer_7,María,56,ES12209529607663493637,TRX_N-00848-72902424,2023-11-06T18:37:09,Portugalete,expenses,transport,-77.47,-36811.58
buyer_7,María,56,ES12209529607663493637,TRX_N-00849-95397120,2023-11-07T13:21:44,Portugalete,expenses,leisure,-25.83,-36837.41
buyer_7,María,56,ES12209529607663493637,TRX_N-00850-37024022,2023-11-08T11:08:23,Portugalete,expenses,gas,-71.27,-36908.68
buyer_7,María,56,ES12209529607663493637,TRX_N-00851-98064691,2023-11-08T13:32:28,Portugalete,expenses,water,-39.92,-36948.6
buyer_7,María,56,ES12209529607663493637,TRX_N-00852-94271633,2023-11-08T12:22:12,Portugalete,expenses,phone,-32.84,-36981.44
buyer_7,María,56,ES12209529607663493637,TRX_N-00853-05908104,2023-11-10T14:21:02,Eibar,expenses,food,-77.58,-37059.02
buyer_7,María,56,ES12209529607663493637,TRX_N-00854-00738267,2023-11-10T18:00:45,Andoain,expenses,cash,-100.0,-37159.02
buyer_7,María,56,ES12209529607663493637,TRX_N-00855-54046029,2023-11-11T09:55:34,Portugalete,expenses,food,-77.31,-37236.33
buyer_7,María,56,ES12209529607663493637,TRX_N-00856-08999837,2023-11-11T16:50:11,Portugalete,expenses,leisure,-52.19,-37288.52
buyer_7,María,56,ES12209529607663493637,TRX_N-00857-74401213,2023-11-11T11:29:49,Portugalete,expenses,cash,-100.0,-37388.52
buyer_7,María,56,ES12209529607663493637,TRX_N-00858-51188147,2023-11-12T15:35:52,Portugalete,expenses,cash,-100.0,-37488.52
buyer_7,María,56,ES12209529607663493637,TRX_N-00859-06244261,2023-11-12T11:58:19,Getxo,expenses,appliances,-330.1,-37818.62
buyer_7,María,56,ES12209529607663493637,TRX_N-00860-37963504,2023-11-13T08:48:59,Sopela,expenses,appliances,-235.31,-38053.93
buyer_7,María,56,ES12209529607663493637,TRX_N-00861-79134561,2023-11-14T20:02:59,Portugalete,expenses,repairs,-263.65,-38317.58
buyer_7,María,56,ES12209529607663493637,TRX_N-00862-95351966,2023-11-15T20:52:01,Portugalete,expenses,leisure,-38.07,-38355.65
buyer_7,María,56,ES12209529607663493637,TRX_N-00863-07854322,2023-11-16T03:46:38,Portugalete,expenses,cash,-100.0,-38455.65
buyer_7,María,56,ES12209529607663493637,TRX_N-00864-61922107,2023-11-17T11:57:50,Portugalete,expenses,gifts,-826.71,-39282.36
buyer_7,María,56,ES12209529607663493637,TRX_N-00865-99126624,2023-11-18T11:37:00,Portugalete,expenses,transport,-76.66,-39359.02
buyer_7,María,56,ES12209529607663493637,TRX_N-00866-36807557,2023-11-20T09:55:30,Portugalete,expenses,food,-117.48,-39476.5
buyer_7,María,56,ES12209529607663493637,TRX_N-00867-02674667,2023-11-20T00:41:59,Portugalete,expenses,cash,-100.0,-39576.5
buyer_7,María,56,ES12209529607663493637,TRX_N-00868-50123586,2023-11-21T12:39:41,Portugalete,expenses,food,-119.94,-39696.44
buyer_7,María,56,ES12209529607663493637,TRX_N-00869-61417457,2023-11-22T13:55:24,Portugalete,expenses,cash,-100.0,-39796.44
buyer_7,María,56,ES12209529607663493637,TRX_N-00870-15786104,2023-11-24T11:43:23,Portugalete,expenses,leisure,-48.51,-39844.95
buyer_7,María,56,ES12209529607663493637,TRX_N-00871-08124979,2023-11-25T13:21:23,Portugalete,expenses,food,-91.47,-39936.42
buyer_7,María,56,ES12209529607663493637,TRX_N-00872-25840625,2023-11-26T18:35:22,Arrasate,expenses,gifts,-644.41,-40580.83
buyer_7,María,56,ES12209529607663493637,TRX_N-00873-15227734,2023-11-26T13:06:07,Portugalete,expenses,children,-279.24,-40860.07
buyer_7,María,56,ES12209529607663493637,TRX_N-00874-57735521,2023-11-27T19:31:45,Portugalete,expenses,healthcare,-62.48,-40922.55
buyer_7,María,56,ES12209529607663493637,TRX_N-00875-03352492,2023-11-29T20:54:52,Portugalete,expenses,cash,-100.0,-41022.55
buyer_7,María,56,ES12209529607663493637,TRX_N-00876-35054295,2023-12-01T16:29:34,Portugalete,incomes,salary,1557.81,-39464.74
buyer_7,María,56,ES12209529607663493637,TRX_N-00877-43894239,2023-12-01T16:29:34,Portugalete,incomes,salary_partner,1599.48,-37865.26
buyer_7,María,56,ES12209529607663493637,TRX_N-00878-16928350,2023-12-01T16:29:34,Portugalete,incomes,salary_bonus,1139.75,-36725.51
buyer_7,María,56,ES12209529607663493637,TRX_N-00879-13244489,2023-12-01T16:29:34,Portugalete,incomes,salary_partner_bonus,1259.7,-35465.81
buyer_7,María,56,ES12209529607663493637,TRX_N-00880-69330432,2023-12-01T03:14:39,Durango,expenses,repairs,-116.39,-35582.2
buyer_7,María,56,ES12209529607663493637,TRX_N-00881-41263169,2023-12-02T13:41:57,Portugalete,expenses,gifts,-33.93,-35616.13
buyer_7,María,56,ES12209529607663493637,TRX_N-00882-79711185,2023-12-04T14:40:51,Portugalete,expenses,mortgage,-717.72,-36333.85
buyer_7,María,56,ES12209529607663493637,TRX_N-00883-44988147,2023-12-05T17:10:15,Portugalete,expenses,gas,-93.04,-36426.89
buyer_7,María,56,ES12209529607663493637,TRX_N-00884-04061150,2023-12-06T21:24:23,Portugalete,expenses,electricity,-72.68,-36499.57
buyer_7,María,56,ES12209529607663493637,TRX_N-00885-23866470,2023-12-06T19:57:38,Portugalete,expenses,internet,-42.0,-36541.57
buyer_7,María,56,ES12209529607663493637,TRX_N-00886-65078771,2023-12-06T08:17:29,Portugalete,expenses,phone,-38.18,-36579.75
buyer_7,María,56,ES12209529607663493637,TRX_N-00887-25305742,2023-12-06T14:33:48,Portugalete,expenses,clothing,-77.68,-36657.43
buyer_7,María,56,ES12209529607663493637,TRX_N-00888-61793953,2023-12-07T09:52:55,Portugalete,expenses,food,-83.03,-36740.46
buyer_7,María,56,ES12209529607663493637,TRX_N-00889-93539679,2023-12-07T20:27:35,Portugalete,expenses,leisure,-71.23,-36811.69
buyer_7,María,56,ES12209529607663493637,TRX_N-00890-48907221,2023-12-08T15:04:33,Portugalete,expenses,water,-41.37,-36853.06
buyer_7,María,56,ES12209529607663493637,TRX_N-00891-79700570,2023-12-08T18:22:04,Portugalete,expenses,food,-72.19,-36925.25
buyer_7,María,56,ES12209529607663493637,TRX_N-00892-20160645,2023-12-08T18:20:46,Portugalete,expenses,repairs,-230.65,-37155.9
buyer_7,María,56,ES12209529607663493637,TRX_N-00893-59178183,2023-12-08T17:32:32,Portugalete,expenses,children,-50.7,-37206.6
buyer_7,María,56,ES12209529607663493637,TRX_N-00894-29979160,2023-12-09T09:27:25,Portugalete,expenses,transport,-63.01,-37269.61
buyer_7,María,56,ES12209529607663493637,TRX_N-00895-46193141,2023-12-10T15:27:57,Portugalete,expenses,cash,-100.0,-37369.61
buyer_7,María,56,ES12209529607663493637,TRX_N-00896-41155779,2023-12-11T10:21:56,Mungia,expenses,clothing,-117.06,-37486.67
buyer_7,María,56,ES12209529607663493637,TRX_N-00897-28370427,2023-12-12T05:14:44,Portugalete,expenses,leisure,-21.48,-37508.15
buyer_7,María,56,ES12209529607663493637,TRX_N-00898-02447047,2023-12-12T07:09:06,Portugalete,expenses,cash,-100.0,-37608.15
buyer_7,María,56,ES12209529607663493637,TRX_N-00899-33247965,2023-12-13T09:01:58,Portugalete,expenses,children,-172.95,-37781.1
buyer_7,María,56,ES12209529607663493637,TRX_N-00900-99728577,2023-12-17T16:27:37,Portugalete,expenses,food,-90.29,-37871.39
buyer_7,María,56,ES12209529607663493637,TRX_N-00901-07782206,2023-12-19T17:47:57,Erandio,expenses,food,-121.07,-37992.46
buyer_7,María,56,ES12209529607663493637,TRX_N-00902-15871371,2023-12-19T08:52:08,Portugalete,expenses,repairs,-274.34,-38266.8
buyer_7,María,56,ES12209529607663493637,TRX_N-00903-18491555,2023-12-20T11:32:57,Portugalete,expenses,leisure,-20.49,-38287.29
buyer_7,María,56,ES12209529607663493637,TRX_N-00904-86579724,2023-12-20T04:53:34,Portugalete,expenses,appliances,-326.47,-38613.76
buyer_7,María,56,ES12209529607663493637,TRX_N-00905-46962665,2023-12-22T13:27:06,Portugalete,expenses,food,-97.33,-38711.09
buyer_7,María,56,ES12209529607663493637,TRX_N-00906-03022014,2023-12-24T11:53:12,Lasarte-Oria,expenses,leisure,-43.73,-38754.82
buyer_7,María,56,ES12209529607663493637,TRX_N-00907-91422878,2023-12-26T14:13:25,Portugalete,expenses,leisure,-77.18,-38832.0
buyer_7,María,56,ES12209529607663493637,TRX_N-00908-73516941,2023-12-26T02:17:13,Portugalete,expenses,gifts,-828.2,-39660.2
buyer_7,María,56,ES12209529607663493637,TRX_N-00909-21759653,2023-12-26T13:14:04,Portugalete,expenses,children,-98.96,-39759.16
buyer_7,María,56,ES12209529607663493637,TRX_N-00910-21019947,2023-12-28T20:25:18,Zarautz,expenses,clothing,-123.03,-39882.19
buyer_7,María,56,ES12209529607663493637,TRX_N-00911-68584997,2023-12-29T15:56:56,Portugalete,expenses,food,-74.22,-39956.41
buyer_7,María,56,ES12209529607663493637,TRX_N-00912-13766125,2024-01-01T23:48:30,Portugalete,incomes,salary,1615.92,-38340.49
buyer_7,María,56,ES12209529607663493637,TRX_N-00913-04676570,2024-01-01T23:48:30,Portugalete,incomes,salary_partner,1659.15,-36681.34
buyer_7,María,56,ES12209529607663493637,TRX_N-00914-88280377,2024-01-04T06:49:13,Portugalete,expenses,mortgage,-717.72,-37399.06
buyer_7,María,56,ES12209529607663493637,TRX_N-00915-88334495,2024-01-04T18:08:44,Portugalete,expenses,transport,-55.51,-37454.57
buyer_7,María,56,ES12209529607663493637,TRX_N-00916-73957492,2024-01-05T10:23:47,Portugalete,expenses,electricity,-30.55,-37485.12
buyer_7,María,56,ES12209529607663493637,TRX_N-00917-91793759,2024-01-05T16:09:02,Portugalete,expenses,internet,-42.0,-37527.12
buyer_7,María,56,ES12209529607663493637,TRX_N-00918-36832168,2024-01-05T10:58:10,Portugalete,expenses,phone,-39.7,-37566.82
buyer_7,María,56,ES12209529607663493637,TRX_N-00919-38840225,2024-01-05T10:03:44,Zarautz,expenses,education,-74.23,-37641.05
buyer_7,María,56,ES12209529607663493637,TRX_N-00920-32312372,2024-01-06T06:32:47,Portugalete,expenses,transport,-69.21,-37710.26
buyer_7,María,56,ES12209529607663493637,TRX_N-00921-32334683,2024-01-06T22:34:12,Mungia,expenses,cash,-100.0,-37810.26
buyer_7,María,56,ES12209529607663493637,TRX_N-00922-28342455,2024-01-07T02:30:47,Portugalete,expenses,water,-40.73,-37850.99
buyer_7,María,56,ES12209529607663493637,TRX_N-00923-65044622,2024-01-08T11:43:12,Portugalete,expenses,gas,-92.9,-37943.89
buyer_7,María,56,ES12209529607663493637,TRX_N-00924-93089329,2024-01-08T13:02:13,Llodio,expenses,education,-69.97,-38013.86
buyer_7,María,56,ES12209529607663493637,TRX_N-00925-92560756,2024-01-10T10:18:58,Oyón-Oion,expenses,food,-101.44,-38115.3
buyer_7,María,56,ES12209529607663493637,TRX_N-00926-24333554,2024-01-10T10:34:29,Iruña de Oca,expenses,clothing,-82.89,-38198.19
buyer_7,María,56,ES12209529607663493637,TRX_N-00927-99708412,2024-01-10T16:46:20,Portugalete,expenses,gifts,-125.59,-38323.78
buyer_7,María,56,ES12209529607663493637,TRX_N-00928-18868285,2024-01-11T10:38:29,Portugalete,expenses,food,-95.4,-38419.18
buyer_7,María,56,ES12209529607663493637,TRX_N-00929-93282011,2024-01-12T05:39:44,Portugalete,expenses,cash,-100.0,-38519.18
buyer_7,María,56,ES12209529607663493637,TRX_N-00930-83143624,2024-01-13T20:29:19,Portugalete,expenses,transport,-78.38,-38597.56
buyer_7,María,56,ES12209529607663493637,TRX_N-00931-50513213,2024-01-13T19:45:29,Portugalete,expenses,cash,-100.0,-38697.56
buyer_7,María,56,ES12209529607663493637,TRX_N-00932-06755512,2024-01-15T09:00:25,Oyón-Oion,expenses,food,-115.59,-38813.15
buyer_7,María,56,ES12209529607663493637,TRX_N-00933-32855014,2024-01-16T14:17:07,Portugalete,expenses,education,-61.37,-38874.52
buyer_7,María,56,ES12209529607663493637,TRX_N-00934-52486213,2024-01-17T10:34:14,Portugalete,expenses,gifts,-224.46,-39098.98
buyer_7,María,56,ES12209529607663493637,TRX_N-00935-67214452,2024-01-17T08:21:30,Portugalete,expenses,children,-110.26,-39209.24
buyer_7,María,56,ES12209529607663493637,TRX_N-00936-96788373,2024-01-23T13:42:36,Portugalete,expenses,repairs,-238.42,-39447.66
buyer_7,María,56,ES12209529607663493637,TRX_N-00937-60954627,2024-01-24T20:46:45,Portugalete,expenses,healthcare,-92.63,-39540.29
buyer_7,María,56,ES12209529607663493637,TRX_N-00938-68400238,2024-01-24T20:34:10,Portugalete,expenses,appliances,-275.1,-39815.39
buyer_7,María,56,ES12209529607663493637,TRX_N-00939-36476205,2024-01-25T17:45:42,Berango,expenses,cash,-100.0,-39915.39
buyer_7,María,56,ES12209529607663493637,TRX_N-00940-24367774,2024-01-25T18:54:40,Portugalete,expenses,repairs,-309.5,-40224.89
buyer_7,María,56,ES12209529607663493637,TRX_N-00941-52648617,2024-01-26T01:11:16,Portugalete,expenses,cash,-100.0,-40324.89
buyer_7,María,56,ES12209529607663493637,TRX_N-00942-80080246,2024-01-26T17:36:18,Portugalete,expenses,children,-206.51,-40531.4
buyer_7,María,56,ES12209529607663493637,TRX_N-00943-23735757,2024-01-28T09:47:51,Portugalete,expenses,gifts,-673.37,-41204.77
buyer_7,María,56,ES12209529607663493637,TRX_N-00944-31217638,2024-01-29T10:41:13,Portugalete,expenses,transport,-72.57,-41277.34
buyer_7,María,56,ES12209529607663493637,TRX_N-00945-10092168,2024-01-29T13:21:08,Portugalete,expenses,leisure,-79.75,-41357.09
buyer_7,María,56,ES12209529607663493637,TRX_N-00946-88715043,2024-01-30T11:45:08,Portugalete,expenses,food,-61.64,-41418.73
buyer_7,María,56,ES12209529607663493637,TRX_N-00947-05219362,2024-02-01T02:24:52,Portugalete,incomes,salary,1615.92,-39802.81
buyer_7,María,56,ES12209529607663493637,TRX_N-00948-49296345,2024-02-01T02:24:52,Portugalete,incomes,salary_partner,1659.15,-38143.66
buyer_7,María,56,ES12209529607663493637,TRX_N-00949-96009891,2024-02-02T12:12:04,Portugalete,expenses,food,-65.68,-38209.34
buyer_7,María,56,ES12209529607663493637,TRX_N-00950-24383324,2024-02-02T19:41:52,Portugalete,expenses,cash,-100.0,-38309.34
buyer_7,María,56,ES12209529607663493637,TRX_N-00951-10794573,2024-02-03T21:22:57,Portugalete,expenses,leisure,-54.28,-38363.62
buyer_7,María,56,ES12209529607663493637,TRX_N-00952-23825938,2024-02-04T15:08:50,Portugalete,expenses,mortgage,-717.72,-39081.34
buyer_7,María,56,ES12209529607663493637,TRX_N-00953-58214988,2024-02-05T17:22:37,Portugalete,expenses,repairs,-206.02,-39287.36
buyer_7,María,56,ES12209529607663493637,TRX_N-00954-30095241,2024-02-06T08:26:18,Portugalete,expenses,electricity,-22.39,-39309.75
buyer_7,María,56,ES12209529607663493637,TRX_N-00955-63453162,2024-02-06T19:38:57,Portugalete,expenses,phone,-32.41,-39342.16
buyer_7,María,56,ES12209529607663493637,TRX_N-00956-32616943,2024-02-06T09:26:23,Portugalete,expenses,food,-65.43,-39407.59
buyer_7,María,56,ES12209529607663493637,TRX_N-00957-78232981,2024-02-06T20:57:43,Portugalete,expenses,transport,-55.83,-39463.42
buyer_7,María,56,ES12209529607663493637,TRX_N-00958-47351067,2024-02-06T19:10:31,Portugalete,expenses,leisure,-75.37,-39538.79
buyer_7,María,56,ES12209529607663493637,TRX_N-00959-26385835,2024-02-06T08:41:04,Elciego,expenses,cash,-100.0,-39638.79
buyer_7,María,56,ES12209529607663493637,TRX_N-00960-72894173,2024-02-07T20:13:10,Portugalete,expenses,food,-118.49,-39757.28
buyer_7,María,56,ES12209529607663493637,TRX_N-00961-90644405,2024-02-08T20:20:08,Portugalete,expenses,gas,-64.5,-39821.78
buyer_7,María,56,ES12209529607663493637,TRX_N-00962-89074673,2024-02-08T18:05:31,Portugalete,expenses,water,-24.25,-39846.03
buyer_7,María,56,ES12209529607663493637,TRX_N-00963-25713896,2024-02-08T11:14:53,Portugalete,expenses,internet,-42.0,-39888.03
buyer_7,María,56,ES12209529607663493637,TRX_N-00964-82281558,2024-02-11T16:08:26,Portugalete,expenses,leisure,-79.81,-39967.84
buyer_7,María,56,ES12209529607663493637,TRX_N-00965-53687194,2024-02-11T08:31:44,Portugalete,expenses,cash,-100.0,-40067.84
buyer_7,María,56,ES12209529607663493637,TRX_N-00966-31585042,2024-02-12T09:13:49,Portugalete,expenses,repairs,-140.22,-40208.06
buyer_7,María,56,ES12209529607663493637,TRX_N-00967-77849997,2024-02-13T16:52:27,Portugalete,expenses,leisure,-66.48,-40274.54
buyer_7,María,56,ES12209529607663493637,TRX_N-00968-16756718,2024-02-16T08:15:55,Portugalete,expenses,food,-77.42,-40351.96
buyer_7,María,56,ES12209529607663493637,TRX_N-00969-36385988,2024-02-17T17:32:22,Berango,expenses,cash,-100.0,-40451.96
buyer_7,María,56,ES12209529607663493637,TRX_N-00970-53959447,2024-02-18T18:49:58,Portugalete,expenses,leisure,-54.34,-40506.3
buyer_7,María,56,ES12209529607663493637,TRX_N-00971-99725704,2024-02-19T15:18:07,Portugalete,expenses,clothing,-149.58,-40655.88
buyer_7,María,56,ES12209529607663493637,TRX_N-00972-67920087,2024-02-21T06:10:47,Portugalete,expenses,travel,-1645.59,-42301.47
buyer_7,María,56,ES12209529607663493637,TRX_N-00973-24007180,2024-02-23T13:58:30,Portugalete,expenses,gifts,-348.46,-42649.93
buyer_7,María,56,ES12209529607663493637,TRX_N-00974-17947642,2024-02-26T09:54:46,Portugalete,expenses,cash,-100.0,-42749.93
buyer_7,María,56,ES12209529607663493637,TRX_N-00975-47916234,2024-02-28T12:26:26,Portugalete,expenses,cash,-100.0,-42849.93
buyer_7,María,56,ES12209529607663493637,TRX_N-00976-76254208,2024-03-01T06:06:13,Portugalete,incomes,salary,1615.92,-41234.01
buyer_7,María,56,ES12209529607663493637,TRX_N-00977-75092048,2024-03-01T06:06:13,Portugalete,incomes,salary_partner,1659.15,-39574.86
buyer_7,María,56,ES12209529607663493637,TRX_N-00978-28161567,2024-03-01T06:06:13,Portugalete,incomes,extra_income,243.65,-39331.21
buyer_7,María,56,ES12209529607663493637,TRX_N-00979-33978341,2024-03-02T21:02:48,Portugalete,expenses,leisure,-18.82,-39350.03
buyer_7,María,56,ES12209529607663493637,TRX_N-00980-20232554,2024-03-02T17:13:51,Portugalete,expenses,cash,-100.0,-39450.03
buyer_7,María,56,ES12209529607663493637,TRX_N-00981-80632517,2024-03-02T01:27:50,Portugalete,expenses,repairs,-118.11,-39568.14
buyer_7,María,56,ES12209529607663493637,TRX_N-00982-13267845,2024-03-03T14:44:13,Portugalete,expenses,food,-96.23,-39664.37
buyer_7,María,56,ES12209529607663493637,TRX_N-00983-93749496,2024-03-04T09:19:44,Portugalete,expenses,mortgage,-717.72,-40382.09
buyer_7,María,56,ES12209529607663493637,TRX_N-00984-52638513,2024-03-04T09:38:18,Portugalete,expenses,cash,-100.0,-40482.09
buyer_7,María,56,ES12209529607663493637,TRX_N-00985-73540455,2024-03-04T09:08:54,Portugalete,expenses,repairs,-99.77,-40581.86
buyer_7,María,56,ES12209529607663493637,TRX_N-00986-46801299,2024-03-05T10:23:35,Portugalete,expenses,water,-32.07,-40613.93
buyer_7,María,56,ES12209529607663493637,TRX_N-00987-81591778,2024-03-05T08:21:10,Portugalete,expenses,food,-71.66,-40685.59
buyer_7,María,56,ES12209529607663493637,TRX_N-00988-60941308,2024-03-05T13:15:15,Portugalete,expenses,education,-51.61,-40737.2
buyer_7,María,56,ES12209529607663493637,TRX_N-00989-27548316,2024-03-06T18:10:07,Portugalete,expenses,cash,-100.0,-40837.2
buyer_7,María,56,ES12209529607663493637,TRX_N-00990-76799230,2024-03-07T15:28:20,Portugalete,expenses,electricity,-26.18,-40863.38
buyer_7,María,56,ES12209529607663493637,TRX_N-00991-80737545,2024-03-07T00:28:11,Portugalete,expenses,leisure,-77.58,-40940.96
buyer_7,María,56,ES12209529607663493637,TRX_N-00992-36223119,2024-03-07T07:27:51,Portugalete,expenses,cash,-100.0,-41040.96
buyer_7,María,56,ES12209529607663493637,TRX_N-00993-71117509,2024-03-08T15:27:15,Portugalete,expenses,gas,-70.92,-41111.88
buyer_7,María,56,ES12209529607663493637,TRX_N-00994-54111467,2024-03-08T16:31:17,Portugalete,expenses,internet,-42.0,-41153.88
buyer_7,María,56,ES12209529607663493637,TRX_N-00995-34468398,2024-03-08T19:21:09,Portugalete,expenses,phone,-31.82,-41185.7
buyer_7,María,56,ES12209529607663493637,TRX_N-00996-62832923,2024-03-09T15:16:06,Portugalete,expenses,cash,-100.0,-41285.7
buyer_7,María,56,ES12209529607663493637,TRX_N-00997-96224055,2024-03-10T12:24:24,Portugalete,expenses,transport,-55.23,-41340.93
buyer_7,María,56,ES12209529607663493637,TRX_N-00998-51537259,2024-03-10T07:14:17,Portugalete,expenses,children,-77.46,-41418.39
buyer_7,María,56,ES12209529607663493637,TRX_N-00999-28659339,2024-03-14T22:33:11,Portugalete,expenses,food,-106.62,-41525.01
buyer_7,María,56,ES12209529607663493637,TRX_N-01000-98221204,2024-03-14T16:34:12,Portugalete,expenses,clothing,-90.43,-41615.44
buyer_7,María,56,ES12209529607663493637,TRX_N-01001-59647896,2024-03-17T12:10:41,Portugalete,expenses,appliances,-231.7,-41847.14
buyer_7,María,56,ES12209529607663493637,TRX_N-01002-38089908,2024-03-18T15:19:05,Portugalete,expenses,food,-74.61,-41921.75
buyer_7,María,56,ES12209529607663493637,TRX_N-01003-46300458,2024-03-18T20:18:36,Portugalete,expenses,repairs,-328.97,-42250.72
buyer_7,María,56,ES12209529607663493637,TRX_N-01004-01140610,2024-03-19T11:44:27,Portugalete,expenses,transport,-42.83,-42293.55
buyer_7,María,56,ES12209529607663493637,TRX_N-01005-76636274,2024-03-19T19:21:59,Portugalete,expenses,leisure,-39.63,-42333.18
buyer_7,María,56,ES12209529607663493637,TRX_N-01006-52713676,2024-03-19T12:10:56,Mungia,expenses,cash,-100.0,-42433.18
buyer_7,María,56,ES12209529607663493637,TRX_N-01007-61407003,2024-03-19T08:28:42,Portugalete,expenses,repairs,-291.75,-42724.93
buyer_7,María,56,ES12209529607663493637,TRX_N-01008-20410794,2024-03-20T16:09:54,Portugalete,expenses,cash,-100.0,-42824.93
buyer_7,María,56,ES12209529607663493637,TRX_N-01009-08211816,2024-03-20T07:38:56,Portugalete,expenses,appliances,-300.72,-43125.65
buyer_7,María,56,ES12209529607663493637,TRX_N-01010-87170528,2024-03-21T16:31:58,Portugalete,expenses,clothing,-83.97,-43209.62
buyer_7,María,56,ES12209529607663493637,TRX_N-01011-90987616,2024-03-21T17:43:10,Portugalete,expenses,cash,-100.0,-43309.62
buyer_7,María,56,ES12209529607663493637,TRX_N-01012-61730343,2024-03-22T20:14:08,Portugalete,expenses,food,-74.01,-43383.63
buyer_7,María,56,ES12209529607663493637,TRX_N-01013-66561947,2024-03-24T16:06:37,Portugalete,expenses,repairs,-272.01,-43655.64
buyer_7,María,56,ES12209529607663493637,TRX_N-01014-35486340,2024-03-25T11:41:56,Portugalete,expenses,children,-82.84,-43738.48
buyer_7,María,56,ES12209529607663493637,TRX_N-01015-79339004,2024-03-26T16:08:28,Portugalete,expenses,food,-109.3,-43847.78
buyer_7,María,56,ES12209529607663493637,TRX_N-01016-31087437,2024-03-29T08:47:09,Portugalete,expenses,food,-92.78,-43940.56
buyer_7,María,56,ES12209529607663493637,TRX_N-01017-79715697,2024-03-29T10:01:01,Portugalete,expenses,cash,-100.0,-44040.56
buyer_7,María,56,ES12209529607663493637,TRX_N-01018-25955602,2024-03-30T14:54:00,Portugalete,expenses,cash,-100.0,-44140.56
buyer_7,María,56,ES12209529607663493637,TRX_N-01019-36663796,2024-03-31T11:13:27,Portugalete,expenses,children,-100.45,-44241.01
buyer_7,María,56,ES12209529607663493637,TRX_N-01020-72334841,2024-04-01T13:32:27,Portugalete,incomes,salary,1615.92,-42625.09
buyer_7,María,56,ES12209529607663493637,TRX_N-01021-01486999,2024-04-01T13:32:27,Portugalete,incomes,salary_partner,1659.15,-40965.94
buyer_7,María,56,ES12209529607663493637,TRX_N-01022-00329668,2024-04-01T16:35:07,Portugalete,expenses,food,-114.32,-41080.26
buyer_7,María,56,ES12209529607663493637,TRX_N-01023-57671481,2024-04-02T20:14:03,Portugalete,expenses,leisure,-38.96,-41119.22
buyer_7,María,56,ES12209529607663493637,TRX_N-01024-58958392,2024-04-04T09:39:19,Portugalete,expenses,mortgage,-717.72,-41836.94
buyer_7,María,56,ES12209529607663493637,TRX_N-01025-31326026,2024-04-04T13:42:33,Portugalete,expenses,healthcare,-125.29,-41962.23
buyer_7,María,56,ES12209529607663493637,TRX_N-01026-27743634,2024-04-05T03:53:42,Portugalete,expenses,phone,-34.16,-41996.39
buyer_7,María,56,ES12209529607663493637,TRX_N-01027-38994920,2024-04-05T08:32:32,Santurtzi,expenses,transport,-45.8,-42042.19
buyer_7,María,56,ES12209529607663493637,TRX_N-01028-27859949,2024-04-06T13:38:38,Portugalete,expenses,leisure,-54.55,-42096.74
buyer_7,María,56,ES12209529607663493637,TRX_N-01029-04461115,2024-04-07T05:55:16,Portugalete,expenses,electricity,-76.24,-42172.98
buyer_7,María,56,ES12209529607663493637,TRX_N-01030-78768407,2024-04-07T10:58:12,Portugalete,expenses,gifts,-780.99,-42953.97
buyer_7,María,56,ES12209529607663493637,TRX_N-01031-88607482,2024-04-08T14:04:35,Portugalete,expenses,water,-27.05,-42981.02
buyer_7,María,56,ES12209529607663493637,TRX_N-01032-81818326,2024-04-08T16:11:04,Portugalete,expenses,gas,-107.7,-43088.72
buyer_7,María,56,ES12209529607663493637,TRX_N-01033-04249368,2024-04-08T09:41:05,Portugalete,expenses,internet,-42.0,-43130.72
buyer_7,María,56,ES12209529607663493637,TRX_N-01034-25050750,2024-04-09T09:50:53,Portugalete,expenses,clothing,-126.76,-43257.48
buyer_7,María,56,ES12209529607663493637,TRX_N-01035-51064813,2024-04-11T12:12:04,Portugalete,expenses,food,-78.83,-43336.31
buyer_7,María,56,ES12209529607663493637,TRX_N-01036-32769444,2024-04-11T17:29:47,Donostia,expenses,leisure,-41.82,-43378.13
buyer_7,María,56,ES12209529607663493637,TRX_N-01037-16307159,2024-04-12T09:53:42,Portugalete,expenses,food,-99.45,-43477.58
buyer_7,María,56,ES12209529607663493637,TRX_N-01038-90182233,2024-04-14T08:45:05,Portugalete,expenses,repairs,-66.66,-43544.24
buyer_7,María,56,ES12209529607663493637,TRX_N-01039-25576370,2024-04-18T12:35:30,Portugalete,expenses,food,-62.42,-43606.66
buyer_7,María,56,ES12209529607663493637,TRX_N-01040-07139508,2024-04-18T18:46:58,Portugalete,expenses,healthcare,-57.24,-43663.9
buyer_7,María,56,ES12209529607663493637,TRX_N-01041-92048999,2024-04-19T12:44:19,Portugalete,expenses,healthcare,-83.46,-43747.36
buyer_7,María,56,ES12209529607663493637,TRX_N-01042-86203817,2024-04-19T22:23:26,Labastida,expenses,cash,-100.0,-43847.36
buyer_7,María,56,ES12209529607663493637,TRX_N-01043-83692240,2024-04-23T12:57:42,Portugalete,expenses,transport,-54.92,-43902.28
buyer_7,María,56,ES12209529607663493637,TRX_N-01044-20468801,2024-04-23T17:14:25,Portugalete,expenses,education,-77.31,-43979.59
buyer_7,María,56,ES12209529607663493637,TRX_N-01045-74631035,2024-04-23T15:24:11,Portugalete,expenses,cash,-100.0,-44079.59
buyer_7,María,56,ES12209529607663493637,TRX_N-01046-66515942,2024-04-24T22:09:47,Arrasate,expenses,leisure,-42.07,-44121.66
buyer_7,María,56,ES12209529607663493637,TRX_N-01047-78008502,2024-04-24T16:13:01,Llodio,expenses,cash,-100.0,-44221.66
buyer_7,María,56,ES12209529607663493637,TRX_N-01048-33122613,2024-04-25T23:28:31,Oyón-Oion,expenses,clothing,-133.53,-44355.19
buyer_7,María,56,ES12209529607663493637,TRX_N-01049-92317737,2024-04-26T17:23:34,Portugalete,expenses,clothing,-94.65,-44449.84
buyer_7,María,56,ES12209529607663493637,TRX_N-01050-92212045,2024-04-28T18:07:09,Portugalete,expenses,leisure,-26.1,-44475.94
buyer_7,María,56,ES12209529607663493637,TRX_N-01051-74719636,2024-04-30T19:15:19,Portugalete,expenses,education,-49.8,-44525.74
buyer_7,María,56,ES12209529607663493637,TRX_N-01052-65680086,2024-04-30T12:49:35,Portugalete,expenses,cash,-100.0,-44625.74
buyer_7,María,56,ES12209529607663493637,TRX_N-01053-72679576,2024-05-01T12:32:13,Portugalete,incomes,salary,1615.92,-43009.82
buyer_7,María,56,ES12209529607663493637,TRX_N-01054-58691297,2024-05-01T12:32:13,Portugalete,incomes,salary_partner,1659.15,-41350.67
buyer_7,María,56,ES12209529607663493637,TRX_N-01055-20742175,2024-05-01T20:31:15,Pasaia,expenses,food,-66.2,-41416.87
buyer_7,María,56,ES12209529607663493637,TRX_N-01056-62562164,2024-05-01T21:42:35,Portugalete,expenses,leisure,-25.29,-41442.16
buyer_7,María,56,ES12209529607663493637,TRX_N-01057-31060119,2024-05-04T20:17:08,Portugalete,expenses,mortgage,-717.72,-42159.88
buyer_7,María,56,ES12209529607663493637,TRX_N-01058-30642083,2024-05-04T16:18:13,Portugalete,expenses,repairs,-100.17,-42260.05
buyer_7,María,56,ES12209529607663493637,TRX_N-01059-63032591,2024-05-05T18:00:21,Portugalete,expenses,phone,-42.4,-42302.45
buyer_7,María,56,ES12209529607663493637,TRX_N-01060-05737079,2024-05-05T20:31:14,Portugalete,expenses,food,-78.38,-42380.83
buyer_7,María,56,ES12209529607663493637,TRX_N-01061-42266669,2024-05-05T12:13:02,Portugalete,expenses,cash,-100.0,-42480.83
buyer_7,María,56,ES12209529607663493637,TRX_N-01062-19691756,2024-05-06T09:53:44,Portugalete,expenses,cash,-100.0,-42580.83
buyer_7,María,56,ES12209529607663493637,TRX_N-01063-73433546,2024-05-07T17:29:40,Salvatierra/Agurain,expenses,cash,-100.0,-42680.83
buyer_7,María,56,ES12209529607663493637,TRX_N-01064-24484681,2024-05-08T12:12:34,Portugalete,expenses,gas,-107.32,-42788.15
buyer_7,María,56,ES12209529607663493637,TRX_N-01065-31568443,2024-05-08T20:47:40,Portugalete,expenses,water,-37.62,-42825.77
buyer_7,María,56,ES12209529607663493637,TRX_N-01066-18158951,2024-05-08T08:08:31,Portugalete,expenses,electricity,-20.96,-42846.73
buyer_7,María,56,ES12209529607663493637,TRX_N-01067-98308687,2024-05-08T16:05:33,Portugalete,expenses,internet,-42.0,-42888.73
buyer_7,María,56,ES12209529607663493637,TRX_N-01068-22160532,2024-05-09T10:42:43,Portugalete,expenses,leisure,-66.56,-42955.29
buyer_7,María,56,ES12209529607663493637,TRX_N-01069-10921314,2024-05-09T14:36:42,Portugalete,expenses,cash,-100.0,-43055.29
buyer_7,María,56,ES12209529607663493637,TRX_N-01070-36121198,2024-05-12T12:01:37,Portugalete,expenses,food,-84.83,-43140.12
buyer_7,María,56,ES12209529607663493637,TRX_N-01071-97259069,2024-05-12T18:30:04,Lasarte-Oria,expenses,clothing,-124.31,-43264.43
buyer_7,María,56,ES12209529607663493637,TRX_N-01072-49106968,2024-05-14T08:13:42,Portugalete,expenses,leisure,-79.85,-43344.28
buyer_7,María,56,ES12209529607663493637,TRX_N-01073-44020205,2024-05-14T03:03:36,Durango,expenses,cash,-100.0,-43444.28
buyer_7,María,56,ES12209529607663493637,TRX_N-01074-66482232,2024-05-14T09:25:59,Portugalete,expenses,children,-62.04,-43506.32
buyer_7,María,56,ES12209529607663493637,TRX_N-01075-63791002,2024-05-18T08:52:18,Portugalete,expenses,clothing,-45.47,-43551.79
buyer_7,María,56,ES12209529607663493637,TRX_N-01076-00895174,2024-05-18T21:42:42,Portugalete,expenses,healthcare,-161.16,-43712.95
buyer_7,María,56,ES12209529607663493637,TRX_N-01077-55218959,2024-05-20T13:51:48,Portugalete,expenses,transport,-75.16,-43788.11
buyer_7,María,56,ES12209529607663493637,TRX_N-01078-94545123,2024-05-20T14:46:19,Eibar,expenses,cash,-100.0,-43888.11
buyer_7,María,56,ES12209529607663493637,TRX_N-01079-56953986,2024-05-21T18:02:51,Portugalete,expenses,cash,-100.0,-43988.11
buyer_7,María,56,ES12209529607663493637,TRX_N-01080-93332733,2024-05-22T13:17:44,Portugalete,expenses,gifts,-616.01,-44604.12
buyer_7,María,56,ES12209529607663493637,TRX_N-01081-27850463,2024-05-25T13:14:29,Donostia,expenses,education,-53.88,-44658.0
buyer_7,María,56,ES12209529607663493637,TRX_N-01082-35841774,2024-05-29T00:59:10,Portugalete,expenses,transport,-56.89,-44714.89
buyer_7,María,56,ES12209529607663493637,TRX_N-01083-31371556,2024-05-29T08:13:14,Portugalete,expenses,clothing,-120.5,-44835.39
buyer_7,María,56,ES12209529607663493637,TRX_N-01084-27986809,2024-05-31T16:48:33,Portugalete,expenses,food,-96.59,-44931.98
buyer_7,María,56,ES12209529607663493637,TRX_N-01085-03321355,2024-06-01T14:05:36,Portugalete,incomes,salary,1615.92,-43316.06
buyer_7,María,56,ES12209529607663493637,TRX_N-01086-02444343,2024-06-01T14:05:36,Portugalete,incomes,salary_partner,1659.15,-41656.91
buyer_7,María,56,ES12209529607663493637,TRX_N-01087-05860958,2024-06-01T14:05:36,Portugalete,incomes,extra_income,243.65,-41413.26
buyer_7,María,56,ES12209529607663493637,TRX_N-01088-70087606,2024-06-01T14:05:36,Portugalete,incomes,salary_bonus,1201.81,-40211.45
buyer_7,María,56,ES12209529607663493637,TRX_N-01089-60131628,2024-06-01T14:05:36,Portugalete,incomes,salary_partner_bonus,1303.17,-38908.28
buyer_7,María,56,ES12209529607663493637,TRX_N-01090-79957273,2024-06-01T17:35:59,Portugalete,expenses,cash,-100.0,-39008.28
buyer_7,María,56,ES12209529607663493637,TRX_N-01091-63628406,2024-06-02T02:55:13,Portugalete,expenses,education,-54.86,-39063.14
buyer_7,María,56,ES12209529607663493637,TRX_N-01092-66200432,2024-06-03T05:28:48,Portugalete,expenses,transport,-47.07,-39110.21
buyer_7,María,56,ES12209529607663493637,TRX_N-01093-04090744,2024-06-04T12:06:56,Portugalete,expenses,mortgage,-717.72,-39827.93
buyer_7,María,56,ES12209529607663493637,TRX_N-01094-22850073,2024-06-05T23:33:47,Portugalete,expenses,phone,-35.46,-39863.39
buyer_7,María,56,ES12209529607663493637,TRX_N-01095-50997071,2024-06-05T20:00:58,Leioa,expenses,transport,-74.75,-39938.14
buyer_7,María,56,ES12209529607663493637,TRX_N-01096-74062611,2024-06-06T14:28:26,Portugalete,expenses,water,-21.84,-39959.98
buyer_7,María,56,ES12209529607663493637,TRX_N-01097-96067085,2024-06-06T03:09:46,Portugalete,expenses,food,-85.61,-40045.59
buyer_7,María,56,ES12209529607663493637,TRX_N-01098-21027413,2024-06-07T12:34:31,Vitoria-Gasteiz,expenses,food,-67.38,-40112.97
buyer_7,María,56,ES12209529607663493637,TRX_N-01099-86862634,2024-06-08T17:48:17,Portugalete,expenses,electricity,-67.74,-40180.71
buyer_7,María,56,ES12209529607663493637,TRX_N-01100-90225278,2024-06-08T20:15:57,Portugalete,expenses,gas,-110.6,-40291.31
buyer_7,María,56,ES12209529607663493637,TRX_N-01101-70783975,2024-06-08T19:17:36,Portugalete,expenses,internet,-42.0,-40333.31
buyer_7,María,56,ES12209529607663493637,TRX_N-01102-62897826,2024-06-08T08:40:33,Portugalete,expenses,leisure,-63.89,-40397.2
buyer_7,María,56,ES12209529607663493637,TRX_N-01103-01645778,2024-06-09T21:52:15,Portugalete,expenses,cash,-100.0,-40497.2
buyer_7,María,56,ES12209529607663493637,TRX_N-01104-22016332,2024-06-10T16:16:05,Andoain,expenses,transport,-81.09,-40578.29
buyer_7,María,56,ES12209529607663493637,TRX_N-01105-14623643,2024-06-12T18:21:16,Portugalete,expenses,cash,-100.0,-40678.29
buyer_7,María,56,ES12209529607663493637,TRX_N-01106-94161866,2024-06-13T12:32:17,Portugalete,expenses,appliances,-195.95,-40874.24
buyer_7,María,56,ES12209529607663493637,TRX_N-01107-04639595,2024-06-14T14:05:31,Iruña de Oca,expenses,food,-91.26,-40965.5
buyer_7,María,56,ES12209529607663493637,TRX_N-01108-13640908,2024-06-14T23:24:35,Galdakao,expenses,cash,-100.0,-41065.5
buyer_7,María,56,ES12209529607663493637,TRX_N-01109-22798487,2024-06-16T12:29:35,Portugalete,expenses,leisure,-41.66,-41107.16
buyer_7,María,56,ES12209529607663493637,TRX_N-01110-42739969,2024-06-18T17:43:33,Portugalete,expenses,food,-103.06,-41210.22
buyer_7,María,56,ES12209529607663493637,TRX_N-01111-82318209,2024-06-19T22:53:47,Portugalete,expenses,leisure,-53.5,-41263.72
buyer_7,María,56,ES12209529607663493637,TRX_N-01112-67384726,2024-06-20T14:56:43,Portugalete,expenses,children,-250.36,-41514.08
buyer_7,María,56,ES12209529607663493637,TRX_N-01113-44826553,2024-06-22T13:00:25,Salvatierra/Agurain,expenses,repairs,-154.8,-41668.88
buyer_7,María,56,ES12209529607663493637,TRX_N-01114-75430929,2024-06-23T12:42:58,Portugalete,expenses,leisure,-55.63,-41724.51
buyer_7,María,56,ES12209529607663493637,TRX_N-01115-03901097,2024-06-24T13:56:20,Portugalete,expenses,children,-217.33,-41941.84
buyer_7,María,56,ES12209529607663493637,TRX_N-01116-40104839,2024-06-25T00:01:54,Portugalete,expenses,food,-86.45,-42028.29
buyer_7,María,56,ES12209529607663493637,TRX_N-01117-10214822,2024-06-26T11:58:20,Portugalete,expenses,leisure,-50.38,-42078.67
buyer_7,María,56,ES12209529607663493637,TRX_N-01118-79963414,2024-06-27T11:59:26,Portugalete,expenses,repairs,-262.33,-42341.0
buyer_7,María,56,ES12209529607663493637,TRX_N-01119-07114895,2024-06-30T14:24:28,Portugalete,expenses,healthcare,-146.35,-42487.35
buyer_7,María,56,ES12209529607663493637,TRX_N-01120-39249459,2024-07-01T09:05:26,Portugalete,incomes,salary,1615.92,-40871.43
buyer_7,María,56,ES12209529607663493637,TRX_N-01121-12366020,2024-07-01T09:05:26,Portugalete,incomes,salary_partner,1659.15,-39212.28
buyer_7,María,56,ES12209529607663493637,TRX_N-01122-67907194,2024-07-01T07:42:41,Portugalete,expenses,leisure,-33.35,-39245.63
buyer_7,María,56,ES12209529607663493637,TRX_N-01123-78943461,2024-07-03T11:49:20,Portugalete,expenses,transport,-88.46,-39334.09
buyer_7,María,56,ES12209529607663493637,TRX_N-01124-12548161,2024-07-03T11:49:12,Portugalete,expenses,education,-47.16,-39381.25
buyer_7,María,56,ES12209529607663493637,TRX_N-01125-22056133,2024-07-03T22:47:40,Arrasate,expenses,cash,-100.0,-39481.25
buyer_7,María,56,ES12209529607663493637,TRX_N-01126-45916891,2024-07-03T14:01:13,Portugalete,expenses,repairs,-276.88,-39758.13
buyer_7,María,56,ES12209529607663493637,TRX_N-01127-36297728,2024-07-04T13:48:41,Portugalete,expenses,mortgage,-717.72,-40475.85
buyer_7,María,56,ES12209529607663493637,TRX_N-01128-58622905,2024-07-05T20:26:09,Portugalete,expenses,gas,-73.55,-40549.4
buyer_7,María,56,ES12209529607663493637,TRX_N-01129-22456192,2024-07-05T19:28:24,Portugalete,expenses,cash,-100.0,-40649.4
buyer_7,María,56,ES12209529607663493637,TRX_N-01130-38667703,2024-07-06T11:04:12,Portugalete,expenses,water,-22.59,-40671.99
buyer_7,María,56,ES12209529607663493637,TRX_N-01131-45792111,2024-07-06T09:14:23,Portugalete,expenses,electricity,-89.75,-40761.74
buyer_7,María,56,ES12209529607663493637,TRX_N-01132-47889998,2024-07-06T23:23:56,Portugalete,expenses,internet,-42.0,-40803.74
buyer_7,María,56,ES12209529607663493637,TRX_N-01133-09765864,2024-07-06T14:34:02,Portugalete,expenses,cash,-100.0,-40903.74
buyer_7,María,56,ES12209529607663493637,TRX_N-01134-01092151,2024-07-08T18:34:36,Portugalete,expenses,phone,-31.26,-40935.0
buyer_7,María,56,ES12209529607663493637,TRX_N-01135-25593027,2024-07-10T20:17:38,Durango,expenses,food,-107.48,-41042.48
buyer_7,María,56,ES12209529607663493637,TRX_N-01136-87016488,2024-07-11T20:01:25,Portugalete,expenses,repairs,-120.51,-41162.99
buyer_7,María,56,ES12209529607663493637,TRX_N-01137-13697299,2024-07-13T19:07:45,Portugalete,expenses,leisure,-77.27,-41240.26
buyer_7,María,56,ES12209529607663493637,TRX_N-01138-83154720,2024-07-15T15:33:42,Portugalete,expenses,transport,-41.08,-41281.34
buyer_7,María,56,ES12209529607663493637,TRX_N-01139-15997471,2024-07-15T19:23:25,Vitoria-Gasteiz,expenses,cash,-100.0,-41381.34
buyer_7,María,56,ES12209529607663493637,TRX_N-01140-02166654,2024-07-16T13:34:12,Bermeo,expenses,transport,-74.26,-41455.6
buyer_7,María,56,ES12209529607663493637,TRX_N-01141-19943405,2024-07-16T17:00:13,Portugalete,expenses,repairs,-227.65,-41683.25
buyer_7,María,56,ES12209529607663493637,TRX_N-01142-81821886,2024-07-17T10:48:17,Labastida,expenses,repairs,-139.76,-41823.01
buyer_7,María,56,ES12209529607663493637,TRX_N-01143-84711051,2024-07-19T16:47:59,Portugalete,expenses,cash,-100.0,-41923.01
buyer_7,María,56,ES12209529607663493637,TRX_N-01144-53957708,2024-07-19T03:05:07,Portugalete,expenses,children,-61.27,-41984.28
buyer_7,María,56,ES12209529607663493637,TRX_N-01145-04819393,2024-07-20T19:06:28,Hondarribia,expenses,leisure,-62.36,-42046.64
buyer_7,María,56,ES12209529607663493637,TRX_N-01146-72526980,2024-07-20T10:40:17,Portugalete,expenses,gifts,-37.92,-42084.56
buyer_7,María,56,ES12209529607663493637,TRX_N-01147-60823445,2024-07-21T11:58:38,Lasarte-Oria,expenses,gifts,-564.63,-42649.19
buyer_7,María,56,ES12209529607663493637,TRX_N-01148-80789889,2024-07-24T16:14:35,Portugalete,expenses,gifts,-97.23,-42746.42
buyer_7,María,56,ES12209529607663493637,TRX_N-01149-17602571,2024-07-25T08:03:00,Portugalete,expenses,children,-236.96,-42983.38
buyer_7,María,56,ES12209529607663493637,TRX_N-01150-92409519,2024-07-26T08:01:01,Andoain,expenses,transport,-79.87,-43063.25
buyer_7,María,56,ES12209529607663493637,TRX_N-01151-90839884,2024-07-26T09:50:45,Portugalete,expenses,cash,-100.0,-43163.25
buyer_7,María,56,ES12209529607663493637,TRX_N-01152-40861827,2024-07-27T21:22:19,Portugalete,expenses,cash,-100.0,-43263.25
buyer_7,María,56,ES12209529607663493637,TRX_N-01153-07784810,2024-07-28T06:36:18,Portugalete,expenses,food,-110.34,-43373.59
buyer_7,María,56,ES12209529607663493637,TRX_N-01154-62506445,2024-07-28T21:09:57,Portugalete,expenses,repairs,-154.91,-43528.5
buyer_7,María,56,ES12209529607663493637,TRX_N-01155-62616007,2024-07-29T10:31:58,Portugalete,expenses,transport,-60.55,-43589.05
buyer_7,María,56,ES12209529607663493637,TRX_N-01156-85105852,2024-07-30T15:04:45,Portugalete,expenses,food,-90.69,-43679.74
buyer_7,María,56,ES12209529607663493637,TRX_N-01157-15975725,2024-07-31T18:37:53,Portugalete,expenses,children,-56.4,-43736.14
buyer_7,María,56,ES12209529607663493637,TRX_N-01158-94669268,2024-08-01T16:04:50,Portugalete,incomes,salary,1615.92,-42120.22
buyer_7,María,56,ES12209529607663493637,TRX_N-01159-05375404,2024-08-01T16:04:50,Portugalete,incomes,salary_partner,1659.15,-40461.07
buyer_7,María,56,ES12209529607663493637,TRX_N-01160-68898955,2024-08-01T17:17:32,Portugalete,expenses,cash,-100.0,-40561.07
buyer_7,María,56,ES12209529607663493637,TRX_N-01161-58380487,2024-08-03T05:36:16,Portugalete,expenses,food,-111.76,-40672.83
buyer_7,María,56,ES12209529607663493637,TRX_N-01162-44831643,2024-08-03T09:33:37,Portugalete,expenses,transport,-72.9,-40745.73
buyer_7,María,56,ES12209529607663493637,TRX_N-01163-87635963,2024-08-03T13:00:18,Portugalete,expenses,leisure,-63.99,-40809.72
buyer_7,María,56,ES12209529607663493637,TRX_N-01164-99270475,2024-08-04T14:35:58,Portugalete,expenses,mortgage,-717.72,-41527.44
buyer_7,María,56,ES12209529607663493637,TRX_N-01165-36118514,2024-08-04T11:53:54,Bilbao,expenses,healthcare,-141.05,-41668.49
buyer_7,María,56,ES12209529607663493637,TRX_N-01166-25901698,2024-08-04T11:16:29,Portugalete,expenses,cash,-100.0,-41768.49
buyer_7,María,56,ES12209529607663493637,TRX_N-01167-67066238,2024-08-05T19:02:37,Portugalete,expenses,phone,-34.94,-41803.43
buyer_7,María,56,ES12209529607663493637,TRX_N-01168-69103152,2024-08-06T15:45:01,Portugalete,expenses,internet,-42.0,-41845.43
buyer_7,María,56,ES12209529607663493637,TRX_N-01169-21846239,2024-08-06T10:39:20,Portugalete,expenses,repairs,-183.35,-42028.78
buyer_7,María,56,ES12209529607663493637,TRX_N-01170-12785162,2024-08-07T16:50:03,Portugalete,expenses,electricity,-53.62,-42082.4
buyer_7,María,56,ES12209529607663493637,TRX_N-01171-96417656,2024-08-07T12:09:57,Portugalete,expenses,gas,-43.24,-42125.64
buyer_7,María,56,ES12209529607663493637,TRX_N-01172-99672423,2024-08-07T08:32:43,Portugalete,expenses,leisure,-47.4,-42173.04
buyer_7,María,56,ES12209529607663493637,TRX_N-01173-37372607,2024-08-08T20:03:03,Portugalete,expenses,water,-32.41,-42205.45
buyer_7,María,56,ES12209529607663493637,TRX_N-01174-04008601,2024-08-10T11:11:07,Portugalete,expenses,cash,-100.0,-42305.45
buyer_7,María,56,ES12209529607663493637,TRX_N-01175-75686466,2024-08-10T11:12:36,Portugalete,expenses,repairs,-64.39,-42369.84
buyer_7,María,56,ES12209529607663493637,TRX_N-01176-21714316,2024-08-11T12:39:45,Santurtzi,expenses,gifts,-738.32,-43108.16
buyer_7,María,56,ES12209529607663493637,TRX_N-01177-55797643,2024-08-12T19:21:59,Portugalete,expenses,repairs,-205.18,-43313.34
buyer_7,María,56,ES12209529607663493637,TRX_N-01178-29591509,2024-08-16T23:22:53,Portugalete,expenses,cash,-100.0,-43413.34
buyer_7,María,56,ES12209529607663493637,TRX_N-01179-76396720,2024-08-18T11:04:35,Portugalete,expenses,clothing,-57.43,-43470.77
buyer_7,María,56,ES12209529607663493637,TRX_N-01180-38584824,2024-08-18T12:14:09,Portugalete,expenses,cash,-100.0,-43570.77
buyer_7,María,56,ES12209529607663493637,TRX_N-01181-46519209,2024-08-19T13:40:54,Portugalete,expenses,cash,-100.0,-43670.77
buyer_7,María,56,ES12209529607663493637,TRX_N-01182-64039578,2024-08-21T08:10:29,Portugalete,expenses,transport,-79.72,-43750.49
buyer_7,María,56,ES12209529607663493637,TRX_N-01183-97595576,2024-08-22T18:08:12,Portugalete,expenses,food,-117.46,-43867.95
buyer_7,María,56,ES12209529607663493637,TRX_N-01184-56244747,2024-08-25T16:18:07,Portugalete,expenses,transport,-58.87,-43926.82
buyer_7,María,56,ES12209529607663493637,TRX_N-01185-07123881,2024-08-26T10:31:17,Llodio,expenses,leisure,-27.67,-43954.49
buyer_7,María,56,ES12209529607663493637,TRX_N-01186-69883056,2024-08-27T13:29:45,Portugalete,expenses,transport,-41.32,-43995.81
buyer_7,María,56,ES12209529607663493637,TRX_N-01187-98573831,2024-08-27T16:20:41,Portugalete,expenses,cash,-100.0,-44095.81
buyer_7,María,56,ES12209529607663493637,TRX_N-01188-08834091,2024-08-28T20:25:31,Portugalete,expenses,clothing,-56.89,-44152.7
buyer_7,María,56,ES12209529607663493637,TRX_N-01189-98758486,2024-08-31T10:14:19,Portugalete,expenses,food,-112.3,-44265.0
buyer_7,María,56,ES12209529607663493637,TRX_N-01190-91660678,2024-09-01T23:14:08,Portugalete,incomes,salary,1615.92,-42649.08
buyer_7,María,56,ES12209529607663493637,TRX_N-01191-92355622,2024-09-01T23:14:08,Portugalete,incomes,salary_partner,1659.15,-40989.93
buyer_7,María,56,ES12209529607663493637,TRX_N-01192-56401105,2024-09-01T19:27:24,Portugalete,expenses,clothing,-147.7,-41137.63
buyer_7,María,56,ES12209529607663493637,TRX_N-01193-56483616,2024-09-01T15:14:11,Portugalete,expenses,cash,-100.0,-41237.63
buyer_7,María,56,ES12209529607663493637,TRX_N-01194-60494006,2024-09-01T08:40:44,Portugalete,expenses,children,-208.24,-41445.87
buyer_7,María,56,ES12209529607663493637,TRX_N-01195-45222550,2024-09-02T19:51:06,Portugalete,expenses,healthcare,-93.29,-41539.16
buyer_7,María,56,ES12209529607663493637,TRX_N-01196-31165177,2024-09-02T12:39:53,Portugalete,expenses,cash,-100.0,-41639.16
buyer_7,María,56,ES12209529607663493637,TRX_N-01197-00107416,2024-09-03T04:39:12,Portugalete,expenses,transport,-64.45,-41703.61
buyer_7,María,56,ES12209529607663493637,TRX_N-01198-73115039,2024-09-04T11:31:54,Portugalete,expenses,mortgage,-717.72,-42421.33
buyer_7,María,56,ES12209529607663493637,TRX_N-01199-78837070,2024-09-04T15:58:06,Portugalete,expenses,food,-78.36,-42499.69
buyer_7,María,56,ES12209529607663493637,TRX_N-01200-64692159,2024-09-05T14:18:49,Portugalete,expenses,food,-80.86,-42580.55
buyer_7,María,56,ES12209529607663493637,TRX_N-01201-89299495,2024-09-05T22:38:32,Portugalete,expenses,clothing,-123.5,-42704.05
buyer_7,María,56,ES12209529607663493637,TRX_N-01202-63527033,2024-09-06T10:08:13,Portugalete,expenses,gas,-62.86,-42766.91
buyer_7,María,56,ES12209529607663493637,TRX_N-01203-50078245,2024-09-06T19:45:22,Portugalete,expenses,internet,-42.0,-42808.91
buyer_7,María,56,ES12209529607663493637,TRX_N-01204-50816814,2024-09-06T17:36:59,Portugalete,expenses,leisure,-73.25,-42882.16
buyer_7,María,56,ES12209529607663493637,TRX_N-01205-30858428,2024-09-06T03:13:05,Portugalete,expenses,children,-124.03,-43006.19
buyer_7,María,56,ES12209529607663493637,TRX_N-01206-30501875,2024-09-07T11:15:21,Portugalete,expenses,leisure,-78.31,-43084.5
buyer_7,María,56,ES12209529607663493637,TRX_N-01207-54653022,2024-09-08T10:44:22,Portugalete,expenses,water,-31.12,-43115.62
buyer_7,María,56,ES12209529607663493637,TRX_N-01208-92310691,2024-09-08T16:55:42,Portugalete,expenses,electricity,-21.58,-43137.2
buyer_7,María,56,ES12209529607663493637,TRX_N-01209-31259378,2024-09-08T12:22:25,Portugalete,expenses,phone,-31.67,-43168.87
buyer_7,María,56,ES12209529607663493637,TRX_N-01210-13964707,2024-09-08T10:37:54,Galdakao,expenses,food,-115.95,-43284.82
buyer_7,María,56,ES12209529607663493637,TRX_N-01211-41057433,2024-09-09T18:09:03,Portugalete,expenses,transport,-44.37,-43329.19
buyer_7,María,56,ES12209529607663493637,TRX_N-01212-52850231,2024-09-09T11:31:33,Portugalete,expenses,repairs,-43.61,-43372.8
buyer_7,María,56,ES12209529607663493637,TRX_N-01213-83401497,2024-09-13T17:18:27,Portugalete,expenses,cash,-100.0,-43472.8
buyer_7,María,56,ES12209529607663493637,TRX_N-01214-81575007,2024-09-15T21:25:47,Llodio,expenses,food,-121.14,-43593.94
buyer_7,María,56,ES12209529607663493637,TRX_N-01215-05446054,2024-09-16T08:11:46,Portugalete,expenses,appliances,-309.74,-43903.68
buyer_7,María,56,ES12209529607663493637,TRX_N-01216-35710446,2024-09-17T18:37:55,Portugalete,expenses,gifts,-351.95,-44255.63
buyer_7,María,56,ES12209529607663493637,TRX_N-01217-06871364,2024-09-18T08:35:44,Portugalete,expenses,cash,-100.0,-44355.63
buyer_7,María,56,ES12209529607663493637,TRX_N-01218-35694088,2024-09-20T18:57:26,Portugalete,expenses,leisure,-76.23,-44431.86
buyer_7,María,56,ES12209529607663493637,TRX_N-01219-04921226,2024-09-20T09:14:57,Portugalete,expenses,gifts,-640.08,-45071.94
buyer_7,María,56,ES12209529607663493637,TRX_N-01220-74687205,2024-09-21T08:44:15,Portugalete,expenses,leisure,-57.43,-45129.37
buyer_7,María,56,ES12209529607663493637,TRX_N-01221-42822219,2024-09-22T09:37:36,Portugalete,expenses,food,-88.05,-45217.42
buyer_7,María,56,ES12209529607663493637,TRX_N-01222-21232612,2024-09-22T15:55:22,Portugalete,expenses,clothing,-112.76,-45330.18
buyer_7,María,56,ES12209529607663493637,TRX_N-01223-61089283,2024-09-22T10:09:48,Portugalete,expenses,children,-86.05,-45416.23
buyer_7,María,56,ES12209529607663493637,TRX_N-01224-70174403,2024-09-23T09:35:10,Amurrio,expenses,transport,-74.91,-45491.14
buyer_7,María,56,ES12209529607663493637,TRX_N-01225-08657099,2024-09-23T05:15:14,Portugalete,expenses,gifts,-148.49,-45639.63
buyer_7,María,56,ES12209529607663493637,TRX_N-01226-46722439,2024-09-24T12:00:55,Portugalete,expenses,transport,-58.78,-45698.41
buyer_7,María,56,ES12209529607663493637,TRX_N-01227-02317840,2024-09-24T08:01:00,Portugalete,expenses,cash,-100.0,-45798.41
buyer_7,María,56,ES12209529607663493637,TRX_N-01228-56596722,2024-09-27T10:34:14,Portugalete,expenses,gifts,-567.59,-46366.0
buyer_7,María,56,ES12209529607663493637,TRX_N-01229-73134590,2024-10-01T14:42:33,Portugalete,incomes,salary,1615.92,-44750.08
buyer_7,María,56,ES12209529607663493637,TRX_N-01230-17199271,2024-10-01T14:42:33,Portugalete,incomes,salary_partner,1659.15,-43090.93
buyer_7,María,56,ES12209529607663493637,TRX_N-01231-72496122,2024-10-01T14:42:33,Portugalete,incomes,extra_income,243.65,-42847.28
buyer_7,María,56,ES12209529607663493637,TRX_N-01232-53414778,2024-10-01T17:38:49,Portugalete,expenses,repairs,-328.66,-43175.94
buyer_7,María,56,ES12209529607663493637,TRX_N-01233-68553509,2024-10-02T12:08:02,Portugalete,expenses,education,-65.02,-43240.96
buyer_7,María,56,ES12209529607663493637,TRX_N-01234-53818863,2024-10-02T18:39:26,Iruña de Oca,expenses,cash,-100.0,-43340.96
buyer_7,María,56,ES12209529607663493637,TRX_N-01235-18749827,2024-10-04T22:21:36,Portugalete,expenses,mortgage,-717.72,-44058.68
buyer_7,María,56,ES12209529607663493637,TRX_N-01236-23347884,2024-10-05T15:57:08,Portugalete,expenses,cash,-100.0,-44158.68
buyer_7,María,56,ES12209529607663493637,TRX_N-01237-36053591,2024-10-06T15:39:16,Portugalete,expenses,electricity,-51.31,-44209.99
buyer_7,María,56,ES12209529607663493637,TRX_N-01238-57529834,2024-10-06T15:38:20,Portugalete,expenses,gas,-43.25,-44253.24
buyer_7,María,56,ES12209529607663493637,TRX_N-01239-57840488,2024-10-06T08:40:02,Portugalete,expenses,clothing,-78.31,-44331.55
buyer_7,María,56,ES12209529607663493637,TRX_N-01240-87820649,2024-10-07T17:25:09,Portugalete,expenses,water,-38.35,-44369.9
buyer_7,María,56,ES12209529607663493637,TRX_N-01241-83161679,2024-10-07T14:23:06,Portugalete,expenses,food,-77.35,-44447.25
buyer_7,María,56,ES12209529607663493637,TRX_N-01242-25292957,2024-10-08T16:31:32,Portugalete,expenses,internet,-42.0,-44489.25
buyer_7,María,56,ES12209529607663493637,TRX_N-01243-36445300,2024-10-08T08:30:02,Portugalete,expenses,phone,-31.7,-44520.95
buyer_7,María,56,ES12209529607663493637,TRX_N-01244-74315151,2024-10-08T13:17:12,Andoain,expenses,travel,-1295.16,-45816.11
buyer_7,María,56,ES12209529607663493637,TRX_N-01245-63469483,2024-10-08T18:14:42,Portugalete,expenses,repairs,-118.7,-45934.81
buyer_7,María,56,ES12209529607663493637,TRX_N-01246-14839146,2024-10-09T10:10:20,Portugalete,expenses,food,-90.65,-46025.46
buyer_8,Antonio,45,ES18209590033460822675,TRX_N-00001-58072557,2022-01-01T20:23:05,Labastida,incomes,salary,1442.35,3140.14
buyer_8,Antonio,45,ES18209590033460822675,TRX_N-00002-12128493,2022-01-01T20:23:05,Labastida,incomes,salary_partner,1372.95,4513.09
buyer_8,Antonio,45,ES18209590033460822675,TRX_N-00003-17123016,2022-01-02T14:11:01,Labastida,expenses,transport,-86.3,4426.79
buyer_8,Antonio,45,ES18209590033460822675,TRX_N-00004-83503066,2022-01-02T20:04:51,Labastida,expenses,gifts,-117.04,4309.75
buyer_8,Antonio,45,ES18209590033460822675,TRX_N-00005-68494539,2022-01-04T07:30:21,Labastida,expenses,mortgage,-956.34,3353.41
buyer_8,Antonio,45,ES18209590033460822675,TRX_N-00006-25793673,2022-01-04T18:54:00,Sopela,expenses,food,-65.64,3287.77
buyer_8,Antonio,45,ES18209590033460822675,TRX_N-00007-54891800,2022-01-05T11:16:17,Labastida,expenses,gas,-103.01,3184.76
buyer_8,Antonio,45,ES18209590033460822675,TRX_N-00008-26121493,2022-01-06T10:48:06,Labastida,expenses,electricity,-85.21,3099.55
buyer_8,Antonio,45,ES18209590033460822675,TRX_N-00009-83746592,2022-01-06T09:09:23,Basauri,expenses,food,-89.47,3010.08
buyer_8,Antonio,45,ES18209590033460822675,TRX_N-00010-39109408,2022-01-07T09:28:52,Labastida,expenses,leisure,-53.76,2956.32
buyer_8,Antonio,45,ES18209590033460822675,TRX_N-00011-91266504,2022-01-08T13:22:30,Labastida,expenses,water,-41.7,2914.62
buyer_8,Antonio,45,ES18209590033460822675,TRX_N-00012-91448935,2022-01-08T13:00:10,Labastida,expenses,internet,-42.0,2872.62
buyer_8,Antonio,45,ES18209590033460822675,TRX_N-00013-07257092,2022-01-08T17:49:31,Labastida,expenses,phone,-32.67,2839.95
buyer_8,Antonio,45,ES18209590033460822675,TRX_N-00014-65841335,2022-01-09T13:30:53,Labastida,expenses,cash,-100.0,2739.95
buyer_8,Antonio,45,ES18209590033460822675,TRX_N-00015-46371748,2022-01-10T09:46:44,Labastida,expenses,repairs,-146.59,2593.36
buyer_8,Antonio,45,ES18209590033460822675,TRX_N-00016-99523256,2022-01-12T22:39:26,Labastida,expenses,food,-102.41,2490.95
buyer_8,Antonio,45,ES18209590033460822675,TRX_N-00017-10135422,2022-01-13T23:17:33,Labastida,expenses,education,-67.85,2423.1
buyer_8,Antonio,45,ES18209590033460822675,TRX_N-00018-69452230,2022-01-14T15:49:57,Labastida,expenses,education,-56.49,2366.61
buyer_8,Antonio,45,ES18209590033460822675,TRX_N-00019-18893985,2022-01-15T13:44:43,Labastida,expenses,leisure,-82.6,2284.01
buyer_8,Antonio,45,ES18209590033460822675,TRX_N-00020-09478468,2022-01-15T09:48:07,Donostia,expenses,clothing,-64.46,2219.55
buyer_8,Antonio,45,ES18209590033460822675,TRX_N-00021-87436860,2022-01-16T14:01:31,Labastida,expenses,healthcare,-57.32,2162.23
buyer_8,Antonio,45,ES18209590033460822675,TRX_N-00022-83547436,2022-01-16T14:19:16,Basauri,expenses,cash,-100.0,2062.23
buyer_8,Antonio,45,ES18209590033460822675,TRX_N-00023-57974742,2022-01-17T14:03:23,Labastida,expenses,healthcare,-81.94,1980.29
buyer_8,Antonio,45,ES18209590033460822675,TRX_N-00024-43806379,2022-01-18T22:16:16,Lasarte-Oria,expenses,leisure,-71.61,1908.68
buyer_8,Antonio,45,ES18209590033460822675,TRX_N-00025-85904745,2022-01-18T11:14:47,Labastida,expenses,cash,-100.0,1808.68
buyer_8,Antonio,45,ES18209590033460822675,TRX_N-00026-15624812,2022-01-20T23:40:05,Labastida,expenses,appliances,-416.25,1392.43
buyer_8,Antonio,45,ES18209590033460822675,TRX_N-00027-96693096,2022-01-20T17:34:18,Labastida,expenses,children,-249.85,1142.58
buyer_8,Antonio,45,ES18209590033460822675,TRX_N-00028-05702721,2022-01-21T08:17:53,Labastida,expenses,food,-88.17,1054.41
buyer_8,Antonio,45,ES18209590033460822675,TRX_N-00029-39125999,2022-01-21T05:38:09,Labastida,expenses,cash,-100.0,954.41
buyer_8,Antonio,45,ES18209590033460822675,TRX_N-00030-06044030,2022-01-21T15:30:14,Oyón-Oion,expenses,gifts,-647.45,306.96
buyer_8,Antonio,45,ES18209590033460822675,TRX_N-00031-59170595,2022-01-22T10:29:01,Irun,expenses,healthcare,-174.34,132.62
buyer_8,Antonio,45,ES18209590033460822675,TRX_N-00032-85697424,2022-01-24T17:10:21,Labastida,expenses,transport,-45.61,87.01
buyer_8,Antonio,45,ES18209590033460822675,TRX_N-00033-92956579,2022-01-24T14:52:08,Iruña de Oca,expenses,repairs,-273.5,-186.49
buyer_8,Antonio,45,ES18209590033460822675,TRX_N-00034-36705320,2022-01-26T16:08:59,Bilbao,expenses,food,-87.75,-274.24
buyer_8,Antonio,45,ES18209590033460822675,TRX_N-00035-29894523,2022-01-26T11:55:25,Labastida,expenses,cash,-100.0,-374.24
buyer_8,Antonio,45,ES18209590033460822675,TRX_N-00036-78283426,2022-01-27T03:16:09,Galdakao,expenses,food,-113.7,-487.94
buyer_8,Antonio,45,ES18209590033460822675,TRX_N-00037-82334113,2022-01-28T18:59:22,Labastida,expenses,cash,-100.0,-587.94
buyer_8,Antonio,45,ES18209590033460822675,TRX_N-00038-95659246,2022-01-29T17:57:43,Labastida,expenses,gifts,-127.62,-715.56
buyer_8,Antonio,45,ES18209590033460822675,TRX_N-00039-31981797,2022-02-01T19:40:09,Labastida,incomes,salary,1442.35,726.79
buyer_8,Antonio,45,ES18209590033460822675,TRX_N-00040-16574783,2022-02-01T19:40:09,Labastida,incomes,salary_partner,1372.95,2099.74
buyer_8,Antonio,45,ES18209590033460822675,TRX_N-00041-18565418,2022-02-01T20:10:11,Labastida,expenses,appliances,-294.82,1804.92
buyer_8,Antonio,45,ES18209590033460822675,TRX_N-00042-72879445,2022-02-03T10:12:18,Bermeo,expenses,food,-85.66,1719.26
buyer_8,Antonio,45,ES18209590033460822675,TRX_N-00043-25463454,2022-02-04T15:48:56,Labastida,expenses,mortgage,-956.34,762.92
buyer_8,Antonio,45,ES18209590033460822675,TRX_N-00044-58937815,2022-02-04T13:40:27,Labastida,expenses,food,-73.45,689.47
buyer_8,Antonio,45,ES18209590033460822675,TRX_N-00045-98577519,2022-02-04T08:13:45,Andoain,expenses,transport,-55.95,633.52
buyer_8,Antonio,45,ES18209590033460822675,TRX_N-00046-34758288,2022-02-05T14:40:46,Labastida,expenses,electricity,-39.29,594.23
buyer_8,Antonio,45,ES18209590033460822675,TRX_N-00047-20860662,2022-02-05T13:36:29,Labastida,expenses,children,-166.59,427.64
buyer_8,Antonio,45,ES18209590033460822675,TRX_N-00048-45429760,2022-02-06T19:17:17,Labastida,expenses,water,-42.1,385.54
buyer_8,Antonio,45,ES18209590033460822675,TRX_N-00049-46498496,2022-02-06T18:28:59,Labastida,expenses,leisure,-50.44,335.1
buyer_8,Antonio,45,ES18209590033460822675,TRX_N-00050-48715390,2022-02-07T17:44:35,Labastida,expenses,phone,-33.08,302.02
buyer_8,Antonio,45,ES18209590033460822675,TRX_N-00051-60787111,2022-02-08T14:20:45,Labastida,expenses,gas,-61.12,240.9
buyer_8,Antonio,45,ES18209590033460822675,TRX_N-00052-48731807,2022-02-08T13:56:59,Labastida,expenses,internet,-42.0,198.9
buyer_8,Antonio,45,ES18209590033460822675,TRX_N-00053-73229582,2022-02-08T11:51:52,Labastida,expenses,gifts,-149.25,49.65
buyer_8,Antonio,45,ES18209590033460822675,TRX_N-00054-11181198,2022-02-09T08:41:01,Labastida,expenses,clothing,-98.61,-48.96
buyer_8,Antonio,45,ES18209590033460822675,TRX_N-00055-36625143,2022-02-10T18:56:47,Labastida,expenses,cash,-100.0,-148.96
buyer_8,Antonio,45,ES18209590033460822675,TRX_N-00056-61132843,2022-02-10T17:47:21,Labastida,expenses,repairs,-35.38,-184.34
buyer_8,Antonio,45,ES18209590033460822675,TRX_N-00057-70978791,2022-02-12T12:26:41,Labastida,expenses,gifts,-602.77,-787.11
buyer_8,Antonio,45,ES18209590033460822675,TRX_N-00058-02267151,2022-02-13T16:27:48,Labastida,expenses,cash,-100.0,-887.11
buyer_8,Antonio,45,ES18209590033460822675,TRX_N-00059-72899304,2022-02-19T23:27:55,Labastida,expenses,appliances,-348.77,-1235.88
buyer_8,Antonio,45,ES18209590033460822675,TRX_N-00060-94645035,2022-02-20T12:30:02,Labastida,expenses,leisure,-63.19,-1299.07
buyer_8,Antonio,45,ES18209590033460822675,TRX_N-00061-02599211,2022-02-20T09:46:53,Labastida,expenses,cash,-100.0,-1399.07
buyer_8,Antonio,45,ES18209590033460822675,TRX_N-00062-69781753,2022-02-20T18:48:27,Arrasate,expenses,repairs,-62.55,-1461.62
buyer_8,Antonio,45,ES18209590033460822675,TRX_N-00063-75085716,2022-02-21T12:49:39,Labastida,expenses,transport,-74.69,-1536.31
buyer_8,Antonio,45,ES18209590033460822675,TRX_N-00064-08391608,2022-02-22T11:40:25,Labastida,expenses,leisure,-79.19,-1615.5
buyer_8,Antonio,45,ES18209590033460822675,TRX_N-00065-14647800,2022-02-23T18:30:46,Labastida,expenses,leisure,-80.61,-1696.11
buyer_8,Antonio,45,ES18209590033460822675,TRX_N-00066-84014240,2022-02-24T19:48:41,Barakaldo,expenses,cash,-100.0,-1796.11
buyer_8,Antonio,45,ES18209590033460822675,TRX_N-00067-25568308,2022-02-26T20:56:35,Labastida,expenses,gifts,-644.75,-2440.86
buyer_8,Antonio,45,ES18209590033460822675,TRX_N-00068-20419519,2022-02-27T12:39:32,Labastida,expenses,healthcare,-181.19,-2622.05
buyer_8,Antonio,45,ES18209590033460822675,TRX_N-00069-22959217,2022-02-27T18:43:47,Labastida,expenses,cash,-100.0,-2722.05
buyer_8,Antonio,45,ES18209590033460822675,TRX_N-00070-97705491,2022-02-28T02:00:08,Labastida,expenses,cash,-100.0,-2822.05
buyer_8,Antonio,45,ES18209590033460822675,TRX_N-00071-91700626,2022-03-01T12:08:09,Labastida,incomes,salary,1442.35,-1379.7
buyer_8,Antonio,45,ES18209590033460822675,TRX_N-00072-74548284,2022-03-01T12:08:09,Labastida,incomes,salary_partner,1372.95,-6.75
buyer_8,Antonio,45,ES18209590033460822675,TRX_N-00073-38161847,2022-03-01T19:34:25,Labastida,expenses,clothing,-132.6,-139.35
buyer_8,Antonio,45,ES18209590033460822675,TRX_N-00074-27684121,2022-03-03T15:07:09,Labastida,expenses,transport,-75.98,-215.33
buyer_8,Antonio,45,ES18209590033460822675,TRX_N-00075-39176566,2022-03-03T20:25:31,Labastida,expenses,clothing,-98.32,-313.65
buyer_8,Antonio,45,ES18209590033460822675,TRX_N-00076-43553444,2022-03-04T09:03:14,Labastida,expenses,mortgage,-956.34,-1269.99
buyer_8,Antonio,45,ES18209590033460822675,TRX_N-00077-51361768,2022-03-05T20:32:25,Labastida,expenses,water,-33.41,-1303.4
buyer_8,Antonio,45,ES18209590033460822675,TRX_N-00078-55692966,2022-03-05T18:24:48,Labastida,expenses,food,-66.35,-1369.75
buyer_8,Antonio,45,ES18209590033460822675,TRX_N-00079-27826494,2022-03-06T21:41:19,Errenteria,expenses,cash,-100.0,-1469.75
buyer_8,Antonio,45,ES18209590033460822675,TRX_N-00080-02702633,2022-03-06T04:34:38,Donostia,expenses,travel,-1291.85,-2761.6
buyer_8,Antonio,45,ES18209590033460822675,TRX_N-00081-79775581,2022-03-07T19:49:13,Labastida,expenses,gas,-58.68,-2820.28
buyer_8,Antonio,45,ES18209590033460822675,TRX_N-00082-31563236,2022-03-07T13:35:28,Santurtzi,expenses,food,-115.51,-2935.79
buyer_8,Antonio,45,ES18209590033460822675,TRX_N-00083-41053108,2022-03-08T15:33:22,Labastida,expenses,electricity,-43.75,-2979.54
buyer_8,Antonio,45,ES18209590033460822675,TRX_N-00084-07385296,2022-03-08T19:24:32,Labastida,expenses,internet,-42.0,-3021.54
buyer_8,Antonio,45,ES18209590033460822675,TRX_N-00085-31365407,2022-03-08T14:47:24,Labastida,expenses,phone,-39.6,-3061.14
buyer_8,Antonio,45,ES18209590033460822675,TRX_N-00086-26219999,2022-03-09T17:12:43,Labastida,expenses,cash,-100.0,-3161.14
buyer_8,Antonio,45,ES18209590033460822675,TRX_N-00087-35864180,2022-03-10T01:38:07,Labastida,expenses,cash,-100.0,-3261.14
buyer_8,Antonio,45,ES18209590033460822675,TRX_N-00088-37455026,2022-03-11T15:38:10,Labastida,expenses,healthcare,-159.1,-3420.24
buyer_8,Antonio,45,ES18209590033460822675,TRX_N-00089-65071334,2022-03-11T03:24:34,Labastida,expenses,cash,-100.0,-3520.24
buyer_8,Antonio,45,ES18209590033460822675,TRX_N-00090-94333413,2022-03-12T20:55:54,Labastida,expenses,cash,-100.0,-3620.24
buyer_8,Antonio,45,ES18209590033460822675,TRX_N-00091-59908012,2022-03-14T19:04:40,Labastida,expenses,food,-78.99,-3699.23
buyer_8,Antonio,45,ES18209590033460822675,TRX_N-00092-46254419,2022-03-16T09:58:38,Labastida,expenses,clothing,-95.56,-3794.79
buyer_8,Antonio,45,ES18209590033460822675,TRX_N-00093-92382450,2022-03-18T08:20:50,Portugalete,expenses,food,-96.95,-3891.74
buyer_8,Antonio,45,ES18209590033460822675,TRX_N-00094-57122750,2022-03-18T19:04:10,Labastida,expenses,cash,-100.0,-3991.74
buyer_8,Antonio,45,ES18209590033460822675,TRX_N-00095-47835165,2022-03-19T17:47:37,Labastida,expenses,leisure,-74.75,-4066.49
buyer_8,Antonio,45,ES18209590033460822675,TRX_N-00096-62676644,2022-03-21T15:49:24,Labastida,expenses,cash,-100.0,-4166.49
buyer_8,Antonio,45,ES18209590033460822675,TRX_N-00097-53518372,2022-03-22T09:01:43,Labastida,expenses,leisure,-67.86,-4234.35
buyer_8,Antonio,45,ES18209590033460822675,TRX_N-00098-50026581,2022-03-22T08:47:24,Labastida,expenses,cash,-100.0,-4334.35
buyer_8,Antonio,45,ES18209590033460822675,TRX_N-00099-43757445,2022-03-23T17:00:50,Labastida,expenses,leisure,-47.09,-4381.44
buyer_8,Antonio,45,ES18209590033460822675,TRX_N-00100-77697086,2022-03-24T20:04:09,Labastida,expenses,education,-45.73,-4427.17
buyer_8,Antonio,45,ES18209590033460822675,TRX_N-00101-76289981,2022-03-25T18:01:56,Leioa,expenses,food,-91.82,-4518.99
buyer_8,Antonio,45,ES18209590033460822675,TRX_N-00102-93770058,2022-03-25T11:06:07,Labastida,expenses,cash,-100.0,-4618.99
buyer_8,Antonio,45,ES18209590033460822675,TRX_N-00103-74878561,2022-03-26T21:08:04,Labastida,expenses,food,-108.04,-4727.03
buyer_8,Antonio,45,ES18209590033460822675,TRX_N-00104-81717938,2022-03-26T21:51:45,Labastida,expenses,transport,-83.01,-4810.04
buyer_8,Antonio,45,ES18209590033460822675,TRX_N-00105-93117918,2022-03-26T19:50:50,Labastida,expenses,education,-49.51,-4859.55
buyer_8,Antonio,45,ES18209590033460822675,TRX_N-00106-89870590,2022-03-26T11:27:35,Labastida,expenses,cash,-100.0,-4959.55
buyer_8,Antonio,45,ES18209590033460822675,TRX_N-00107-50774413,2022-03-27T19:55:28,Labastida,expenses,cash,-100.0,-5059.55
buyer_8,Antonio,45,ES18209590033460822675,TRX_N-00108-05566603,2022-04-01T10:03:37,Labastida,incomes,salary,1442.35,-3617.2
buyer_8,Antonio,45,ES18209590033460822675,TRX_N-00109-11012742,2022-04-01T10:03:37,Labastida,incomes,salary_partner,1372.95,-2244.25
buyer_8,Antonio,45,ES18209590033460822675,TRX_N-00110-73931990,2022-04-01T10:03:37,Labastida,incomes,extra_income,185.49,-2058.76
buyer_8,Antonio,45,ES18209590033460822675,TRX_N-00111-11703100,2022-04-02T22:27:42,Andoain,expenses,leisure,-28.92,-2087.68
buyer_8,Antonio,45,ES18209590033460822675,TRX_N-00112-31943748,2022-04-04T14:08:17,Labastida,expenses,mortgage,-956.34,-3044.02
buyer_8,Antonio,45,ES18209590033460822675,TRX_N-00113-16467238,2022-04-05T12:38:14,Labastida,expenses,water,-36.26,-3080.28
buyer_8,Antonio,45,ES18209590033460822675,TRX_N-00114-11684071,2022-04-05T08:30:12,Labastida,expenses,phone,-35.04,-3115.32
buyer_8,Antonio,45,ES18209590033460822675,TRX_N-00115-40559444,2022-04-06T17:08:52,Labastida,expenses,gas,-40.33,-3155.65
buyer_8,Antonio,45,ES18209590033460822675,TRX_N-00116-10063690,2022-04-06T10:05:34,Labastida,expenses,food,-93.25,-3248.9
buyer_8,Antonio,45,ES18209590033460822675,TRX_N-00117-47336485,2022-04-06T20:18:26,Sopela,expenses,clothing,-99.56,-3348.46
buyer_8,Antonio,45,ES18209590033460822675,TRX_N-00118-98469627,2022-04-06T21:31:56,Labastida,expenses,education,-51.89,-3400.35
buyer_8,Antonio,45,ES18209590033460822675,TRX_N-00119-29939542,2022-04-06T22:57:42,Labastida,expenses,gifts,-693.68,-4094.03
buyer_8,Antonio,45,ES18209590033460822675,TRX_N-00120-52121609,2022-04-07T15:00:16,Labastida,expenses,electricity,-63.95,-4157.98
buyer_8,Antonio,45,ES18209590033460822675,TRX_N-00121-18720177,2022-04-07T20:57:06,Labastida,expenses,healthcare,-111.6,-4269.58
buyer_8,Antonio,45,ES18209590033460822675,TRX_N-00122-18601821,2022-04-08T12:08:48,Labastida,expenses,internet,-42.0,-4311.58
buyer_8,Antonio,45,ES18209590033460822675,TRX_N-00123-67224461,2022-04-10T12:31:42,Labastida,expenses,gifts,-430.4,-4741.98
buyer_8,Antonio,45,ES18209590033460822675,TRX_N-00124-19466709,2022-04-11T15:22:50,Labastida,expenses,leisure,-70.43,-4812.41
buyer_8,Antonio,45,ES18209590033460822675,TRX_N-00125-37606760,2022-04-12T22:00:23,Labastida,expenses,food,-101.29,-4913.7
buyer_8,Antonio,45,ES18209590033460822675,TRX_N-00126-54709170,2022-04-12T17:15:09,Labastida,expenses,transport,-81.0,-4994.7
buyer_8,Antonio,45,ES18209590033460822675,TRX_N-00127-75269343,2022-04-13T12:27:09,Labastida,expenses,cash,-100.0,-5094.7
buyer_8,Antonio,45,ES18209590033460822675,TRX_N-00128-53635136,2022-04-15T19:01:18,Labastida,expenses,leisure,-41.74,-5136.44
buyer_8,Antonio,45,ES18209590033460822675,TRX_N-00129-50461380,2022-04-15T04:26:26,Labastida,expenses,clothing,-129.17,-5265.61
buyer_8,Antonio,45,ES18209590033460822675,TRX_N-00130-16942718,2022-04-18T09:28:00,Labastida,expenses,cash,-100.0,-5365.61
buyer_8,Antonio,45,ES18209590033460822675,TRX_N-00131-73707497,2022-04-19T09:32:13,Labastida,expenses,cash,-100.0,-5465.61
buyer_8,Antonio,45,ES18209590033460822675,TRX_N-00132-16762243,2022-04-20T17:44:25,Labastida,expenses,food,-68.24,-5533.85
buyer_8,Antonio,45,ES18209590033460822675,TRX_N-00133-30846654,2022-04-20T19:01:05,Labastida,expenses,appliances,-96.73,-5630.58
buyer_8,Antonio,45,ES18209590033460822675,TRX_N-00134-30507188,2022-04-22T08:52:29,Labastida,expenses,food,-62.67,-5693.25
buyer_8,Antonio,45,ES18209590033460822675,TRX_N-00135-22314975,2022-04-25T18:25:22,Labastida,expenses,leisure,-39.24,-5732.49
buyer_8,Antonio,45,ES18209590033460822675,TRX_N-00136-45842617,2022-04-30T05:54:53,Labastida,expenses,gifts,-323.84,-6056.33
buyer_8,Antonio,45,ES18209590033460822675,TRX_N-00137-67353010,2022-05-01T22:22:26,Labastida,incomes,salary,1442.35,-4613.98
buyer_8,Antonio,45,ES18209590033460822675,TRX_N-00138-74333299,2022-05-01T22:22:26,Labastida,incomes,salary_partner,1372.95,-3241.03
buyer_8,Antonio,45,ES18209590033460822675,TRX_N-00139-46944485,2022-05-01T04:47:26,Labastida,expenses,food,-85.07,-3326.1
buyer_8,Antonio,45,ES18209590033460822675,TRX_N-00140-87096281,2022-05-03T15:50:05,Labastida,expenses,cash,-100.0,-3426.1
buyer_8,Antonio,45,ES18209590033460822675,TRX_N-00141-26478333,2022-05-03T09:06:15,Labastida,expenses,children,-246.13,-3672.23
buyer_8,Antonio,45,ES18209590033460822675,TRX_N-00142-33320224,2022-05-04T08:03:21,Labastida,expenses,mortgage,-956.34,-4628.57
buyer_8,Antonio,45,ES18209590033460822675,TRX_N-00143-41730173,2022-05-05T11:54:59,Labastida,expenses,internet,-42.0,-4670.57
buyer_8,Antonio,45,ES18209590033460822675,TRX_N-00144-25868206,2022-05-06T18:46:09,Labastida,expenses,electricity,-25.76,-4696.33
buyer_8,Antonio,45,ES18209590033460822675,TRX_N-00145-14100610,2022-05-06T09:48:24,Labastida,expenses,phone,-39.51,-4735.84
buyer_8,Antonio,45,ES18209590033460822675,TRX_N-00146-98677601,2022-05-06T18:59:51,Labastida,expenses,leisure,-44.73,-4780.57
buyer_8,Antonio,45,ES18209590033460822675,TRX_N-00147-91121224,2022-05-07T21:57:51,Labastida,expenses,water,-34.17,-4814.74
buyer_8,Antonio,45,ES18209590033460822675,TRX_N-00148-74201931,2022-05-07T06:22:15,Barakaldo,expenses,leisure,-36.96,-4851.7
buyer_8,Antonio,45,ES18209590033460822675,TRX_N-00149-50053353,2022-05-07T13:36:12,Labastida,expenses,cash,-100.0,-4951.7
buyer_8,Antonio,45,ES18209590033460822675,TRX_N-00150-26108793,2022-05-08T21:23:55,Labastida,expenses,gas,-73.9,-5025.6
buyer_8,Antonio,45,ES18209590033460822675,TRX_N-00151-45378827,2022-05-08T10:18:25,Bilbao,expenses,food,-69.0,-5094.6
buyer_8,Antonio,45,ES18209590033460822675,TRX_N-00152-13231835,2022-05-08T18:46:49,Zuia,expenses,cash,-100.0,-5194.6
buyer_8,Antonio,45,ES18209590033460822675,TRX_N-00153-20233330,2022-05-08T09:22:38,Labastida,expenses,children,-126.18,-5320.78
buyer_8,Antonio,45,ES18209590033460822675,TRX_N-00154-94007966,2022-05-10T20:03:11,Labastida,expenses,food,-89.33,-5410.11
buyer_8,Antonio,45,ES18209590033460822675,TRX_N-00155-48785137,2022-05-12T16:17:03,Labastida,expenses,food,-70.15,-5480.26
buyer_8,Antonio,45,ES18209590033460822675,TRX_N-00156-67341802,2022-05-13T14:57:29,Labastida,expenses,transport,-78.84,-5559.1
buyer_8,Antonio,45,ES18209590033460822675,TRX_N-00157-51665236,2022-05-13T08:30:05,Labastida,expenses,leisure,-74.84,-5633.94
buyer_8,Antonio,45,ES18209590033460822675,TRX_N-00158-40734584,2022-05-14T18:48:37,Labastida,expenses,food,-74.0,-5707.94
buyer_8,Antonio,45,ES18209590033460822675,TRX_N-00159-36658615,2022-05-14T12:37:11,Labastida,expenses,gifts,-665.99,-6373.93
buyer_8,Antonio,45,ES18209590033460822675,TRX_N-00160-32980846,2022-05-15T16:35:06,Labastida,expenses,leisure,-20.82,-6394.75
buyer_8,Antonio,45,ES18209590033460822675,TRX_N-00161-47309418,2022-05-16T05:27:12,Andoain,expenses,food,-61.15,-6455.9
buyer_8,Antonio,45,ES18209590033460822675,TRX_N-00162-53767105,2022-05-17T09:59:01,Labastida,expenses,food,-79.97,-6535.87
buyer_8,Antonio,45,ES18209590033460822675,TRX_N-00163-90743542,2022-05-17T23:29:58,Labastida,expenses,transport,-41.88,-6577.75
buyer_8,Antonio,45,ES18209590033460822675,TRX_N-00164-02147359,2022-05-20T12:57:19,Labastida,expenses,leisure,-65.79,-6643.54
buyer_8,Antonio,45,ES18209590033460822675,TRX_N-00165-11513572,2022-05-21T17:10:25,Labastida,expenses,repairs,-162.37,-6805.91
buyer_8,Antonio,45,ES18209590033460822675,TRX_N-00166-80632820,2022-05-23T21:01:41,Labastida,expenses,transport,-89.66,-6895.57
buyer_8,Antonio,45,ES18209590033460822675,TRX_N-00167-94389680,2022-05-24T14:55:36,Getxo,expenses,cash,-100.0,-6995.57
buyer_8,Antonio,45,ES18209590033460822675,TRX_N-00168-39810716,2022-05-25T10:57:51,Labastida,expenses,education,-74.16,-7069.73
buyer_8,Antonio,45,ES18209590033460822675,TRX_N-00169-15571776,2022-05-27T12:40:53,Labastida,expenses,children,-81.24,-7150.97
buyer_8,Antonio,45,ES18209590033460822675,TRX_N-00170-56467589,2022-05-28T20:16:24,Labastida,expenses,cash,-100.0,-7250.97
buyer_8,Antonio,45,ES18209590033460822675,TRX_N-00171-84260915,2022-05-30T12:07:00,Labastida,expenses,leisure,-40.08,-7291.05
buyer_8,Antonio,45,ES18209590033460822675,TRX_N-00172-26902283,2022-05-30T14:45:39,Labastida,expenses,education,-47.23,-7338.28
buyer_8,Antonio,45,ES18209590033460822675,TRX_N-00173-97986447,2022-06-01T12:02:32,Labastida,incomes,salary,1442.35,-5895.93
buyer_8,Antonio,45,ES18209590033460822675,TRX_N-00174-01805389,2022-06-01T12:02:32,Labastida,incomes,salary_partner,1372.95,-4522.98
buyer_8,Antonio,45,ES18209590033460822675,TRX_N-00175-06244940,2022-06-01T12:02:32,Labastida,incomes,salary_bonus,1022.25,-3500.73
buyer_8,Antonio,45,ES18209590033460822675,TRX_N-00176-35354896,2022-06-01T12:02:32,Labastida,incomes,salary_partner_bonus,968.57,-2532.16
buyer_8,Antonio,45,ES18209590033460822675,TRX_N-00177-74327973,2022-06-01T09:15:27,Labastida,expenses,food,-79.71,-2611.87
buyer_8,Antonio,45,ES18209590033460822675,TRX_N-00178-82577683,2022-06-01T18:03:52,Labastida,expenses,leisure,-61.84,-2673.71
buyer_8,Antonio,45,ES18209590033460822675,TRX_N-00179-98164529,2022-06-01T19:29:53,Labastida,expenses,children,-119.83,-2793.54
buyer_8,Antonio,45,ES18209590033460822675,TRX_N-00180-76031577,2022-06-02T08:13:06,Oyón-Oion,expenses,food,-80.76,-2874.3
buyer_8,Antonio,45,ES18209590033460822675,TRX_N-00181-41104334,2022-06-02T10:12:32,Labastida,expenses,cash,-100.0,-2974.3
buyer_8,Antonio,45,ES18209590033460822675,TRX_N-00182-80186365,2022-06-02T23:53:28,Errenteria,expenses,gifts,-215.95,-3190.25
buyer_8,Antonio,45,ES18209590033460822675,TRX_N-00183-08477994,2022-06-03T15:27:48,Labastida,expenses,leisure,-72.96,-3263.21
buyer_8,Antonio,45,ES18209590033460822675,TRX_N-00184-18187588,2022-06-03T11:26:09,Labastida,expenses,appliances,-96.06,-3359.27
buyer_8,Antonio,45,ES18209590033460822675,TRX_N-00185-88215022,2022-06-04T12:45:33,Labastida,expenses,mortgage,-956.34,-4315.61
buyer_8,Antonio,45,ES18209590033460822675,TRX_N-00186-68541113,2022-06-04T19:32:27,Labastida,expenses,cash,-100.0,-4415.61
buyer_8,Antonio,45,ES18209590033460822675,TRX_N-00187-86354941,2022-06-05T11:39:01,Labastida,expenses,internet,-42.0,-4457.61
buyer_8,Antonio,45,ES18209590033460822675,TRX_N-00188-98726171,2022-06-05T22:15:30,Labastida,expenses,cash,-100.0,-4557.61
buyer_8,Antonio,45,ES18209590033460822675,TRX_N-00189-65919953,2022-06-05T18:31:21,Labastida,expenses,appliances,-267.95,-4825.56
buyer_8,Antonio,45,ES18209590033460822675,TRX_N-00190-12000755,2022-06-05T19:20:58,Labastida,expenses,repairs,-100.5,-4926.06
buyer_8,Antonio,45,ES18209590033460822675,TRX_N-00191-60621994,2022-06-06T14:02:52,Labastida,expenses,electricity,-74.69,-5000.75
buyer_8,Antonio,45,ES18209590033460822675,TRX_N-00192-46631342,2022-06-07T08:30:45,Labastida,expenses,gas,-109.74,-5110.49
buyer_8,Antonio,45,ES18209590033460822675,TRX_N-00193-06486505,2022-06-07T13:11:32,Donostia,expenses,transport,-81.73,-5192.22
buyer_8,Antonio,45,ES18209590033460822675,TRX_N-00194-76233819,2022-06-07T16:03:34,Labastida,expenses,cash,-100.0,-5292.22
buyer_8,Antonio,45,ES18209590033460822675,TRX_N-00195-91446915,2022-06-07T12:59:50,Labastida,expenses,gifts,-54.37,-5346.59
buyer_8,Antonio,45,ES18209590033460822675,TRX_N-00196-11546486,2022-06-07T15:16:10,Labastida,expenses,children,-131.71,-5478.3
buyer_8,Antonio,45,ES18209590033460822675,TRX_N-00197-15294967,2022-06-08T20:11:05,Labastida,expenses,water,-36.47,-5514.77
buyer_8,Antonio,45,ES18209590033460822675,TRX_N-00198-71573609,2022-06-08T10:32:54,Labastida,expenses,phone,-36.97,-5551.74
buyer_8,Antonio,45,ES18209590033460822675,TRX_N-00199-42701435,2022-06-08T16:58:42,Labastida,expenses,education,-58.76,-5610.5
buyer_8,Antonio,45,ES18209590033460822675,TRX_N-00200-54868875,2022-06-08T16:30:25,Labastida,expenses,repairs,-284.05,-5894.55
buyer_8,Antonio,45,ES18209590033460822675,TRX_N-00201-75220720,2022-06-11T20:38:38,Labastida,expenses,transport,-69.87,-5964.42
buyer_8,Antonio,45,ES18209590033460822675,TRX_N-00202-88505498,2022-06-12T01:46:46,Labastida,expenses,education,-55.64,-6020.06
buyer_8,Antonio,45,ES18209590033460822675,TRX_N-00203-11877003,2022-06-13T08:25:55,Labastida,expenses,transport,-63.42,-6083.48
buyer_8,Antonio,45,ES18209590033460822675,TRX_N-00204-47258139,2022-06-13T11:48:05,Labastida,expenses,repairs,-190.55,-6274.03
buyer_8,Antonio,45,ES18209590033460822675,TRX_N-00205-82674557,2022-06-14T21:35:44,Labastida,expenses,cash,-100.0,-6374.03
buyer_8,Antonio,45,ES18209590033460822675,TRX_N-00206-55805796,2022-06-16T11:01:20,Labastida,expenses,leisure,-75.16,-6449.19
buyer_8,Antonio,45,ES18209590033460822675,TRX_N-00207-41121002,2022-06-18T20:00:34,Labastida,expenses,leisure,-83.32,-6532.51
buyer_8,Antonio,45,ES18209590033460822675,TRX_N-00208-52879028,2022-06-19T09:08:15,Labastida,expenses,cash,-100.0,-6632.51
buyer_8,Antonio,45,ES18209590033460822675,TRX_N-00209-52523297,2022-06-20T16:03:16,Labastida,expenses,food,-121.04,-6753.55
buyer_8,Antonio,45,ES18209590033460822675,TRX_N-00210-06869925,2022-06-21T16:00:55,Labastida,expenses,food,-80.58,-6834.13
buyer_8,Antonio,45,ES18209590033460822675,TRX_N-00211-42763314,2022-06-21T23:09:52,Labastida,expenses,transport,-83.45,-6917.58
buyer_8,Antonio,45,ES18209590033460822675,TRX_N-00212-56411845,2022-06-23T19:03:31,Berango,expenses,food,-77.57,-6995.15
buyer_8,Antonio,45,ES18209590033460822675,TRX_N-00213-32963763,2022-06-24T15:08:46,Labastida,expenses,education,-69.58,-7064.73
buyer_8,Antonio,45,ES18209590033460822675,TRX_N-00214-23277702,2022-06-25T17:31:04,Labastida,expenses,food,-120.17,-7184.9
buyer_8,Antonio,45,ES18209590033460822675,TRX_N-00215-03641839,2022-06-26T15:42:38,Labastida,expenses,leisure,-30.49,-7215.39
buyer_8,Antonio,45,ES18209590033460822675,TRX_N-00216-12560453,2022-06-28T10:47:20,Labastida,expenses,food,-88.97,-7304.36
buyer_8,Antonio,45,ES18209590033460822675,TRX_N-00217-05745305,2022-06-29T22:20:13,Bilbao,expenses,transport,-76.41,-7380.77
buyer_8,Antonio,45,ES18209590033460822675,TRX_N-00218-30403301,2022-06-30T14:20:03,Oyón-Oion,expenses,leisure,-27.72,-7408.49
buyer_8,Antonio,45,ES18209590033460822675,TRX_N-00219-99272580,2022-06-30T07:02:33,Labastida,expenses,cash,-100.0,-7508.49
buyer_8,Antonio,45,ES18209590033460822675,TRX_N-00220-94908137,2022-06-30T14:14:59,Labastida,expenses,children,-182.11,-7690.6
buyer_8,Antonio,45,ES18209590033460822675,TRX_N-00221-12540638,2022-07-01T17:48:30,Labastida,incomes,salary,1442.35,-6248.25
buyer_8,Antonio,45,ES18209590033460822675,TRX_N-00222-18995886,2022-07-01T17:48:30,Labastida,incomes,salary_partner,1372.95,-4875.3
buyer_8,Antonio,45,ES18209590033460822675,TRX_N-00223-37036812,2022-07-01T17:48:30,Labastida,incomes,extra_income,185.49,-4689.81
buyer_8,Antonio,45,ES18209590033460822675,TRX_N-00224-81536236,2022-07-02T16:58:11,Getxo,expenses,transport,-58.55,-4748.36
buyer_8,Antonio,45,ES18209590033460822675,TRX_N-00225-68259988,2022-07-02T10:28:20,Labastida,expenses,children,-76.72,-4825.08
buyer_8,Antonio,45,ES18209590033460822675,TRX_N-00226-67126143,2022-07-03T11:21:47,Labastida,expenses,leisure,-46.02,-4871.1
buyer_8,Antonio,45,ES18209590033460822675,TRX_N-00227-72668444,2022-07-04T05:22:20,Labastida,expenses,mortgage,-956.34,-5827.44
buyer_8,Antonio,45,ES18209590033460822675,TRX_N-00228-75786042,2022-07-04T08:21:26,Labastida,expenses,repairs,-34.98,-5862.42
buyer_8,Antonio,45,ES18209590033460822675,TRX_N-00229-48730175,2022-07-05T16:03:34,Labastida,expenses,gas,-55.28,-5917.7
buyer_8,Antonio,45,ES18209590033460822675,TRX_N-00230-36365252,2022-07-06T18:47:45,Labastida,expenses,water,-41.07,-5958.77
buyer_8,Antonio,45,ES18209590033460822675,TRX_N-00231-25103662,2022-07-06T13:57:11,Labastida,expenses,electricity,-59.81,-6018.58
buyer_8,Antonio,45,ES18209590033460822675,TRX_N-00232-72887323,2022-07-07T16:55:37,Labastida,expenses,internet,-42.0,-6060.58
buyer_8,Antonio,45,ES18209590033460822675,TRX_N-00233-34881225,2022-07-08T13:57:40,Labastida,expenses,phone,-33.06,-6093.64
buyer_8,Antonio,45,ES18209590033460822675,TRX_N-00234-15121143,2022-07-08T21:22:33,Labastida,expenses,food,-92.94,-6186.58
buyer_8,Antonio,45,ES18209590033460822675,TRX_N-00235-80720382,2022-07-09T20:26:53,Labastida,expenses,children,-269.9,-6456.48
buyer_8,Antonio,45,ES18209590033460822675,TRX_N-00236-88537562,2022-07-10T21:00:43,Labastida,expenses,cash,-100.0,-6556.48
buyer_8,Antonio,45,ES18209590033460822675,TRX_N-00237-11800218,2022-07-11T11:39:19,Bilbao,expenses,gifts,-772.9,-7329.38
buyer_8,Antonio,45,ES18209590033460822675,TRX_N-00238-37355697,2022-07-13T11:03:42,Labastida,expenses,clothing,-89.39,-7418.77
buyer_8,Antonio,45,ES18209590033460822675,TRX_N-00239-83819872,2022-07-13T16:18:32,Labastida,expenses,children,-212.97,-7631.74
buyer_8,Antonio,45,ES18209590033460822675,TRX_N-00240-56929611,2022-07-14T20:26:16,Amurrio,expenses,healthcare,-80.94,-7712.68
buyer_8,Antonio,45,ES18209590033460822675,TRX_N-00241-55620859,2022-07-15T16:53:40,Labastida,expenses,transport,-85.57,-7798.25
buyer_8,Antonio,45,ES18209590033460822675,TRX_N-00242-28427085,2022-07-15T12:49:10,Labastida,expenses,clothing,-62.58,-7860.83
buyer_8,Antonio,45,ES18209590033460822675,TRX_N-00243-27350510,2022-07-15T18:08:46,Labastida,expenses,gifts,-845.45,-8706.28
buyer_8,Antonio,45,ES18209590033460822675,TRX_N-00244-77347379,2022-07-16T11:30:36,Galdakao,expenses,repairs,-196.97,-8903.25
buyer_8,Antonio,45,ES18209590033460822675,TRX_N-00245-65112876,2022-07-19T13:39:59,Labastida,expenses,leisure,-45.13,-8948.38
buyer_8,Antonio,45,ES18209590033460822675,TRX_N-00246-98194504,2022-07-20T12:04:05,Labastida,expenses,cash,-100.0,-9048.38
buyer_8,Antonio,45,ES18209590033460822675,TRX_N-00247-89811485,2022-07-21T08:47:11,Labastida,expenses,food,-78.36,-9126.74
buyer_8,Antonio,45,ES18209590033460822675,TRX_N-00248-01507237,2022-07-21T16:36:13,Labastida,expenses,leisure,-67.69,-9194.43
buyer_8,Antonio,45,ES18209590033460822675,TRX_N-00249-84385483,2022-07-21T12:45:23,Labastida,expenses,cash,-100.0,-9294.43
buyer_8,Antonio,45,ES18209590033460822675,TRX_N-00250-15156807,2022-07-24T17:36:25,Vitoria-Gasteiz,expenses,appliances,-233.22,-9527.65
buyer_8,Antonio,45,ES18209590033460822675,TRX_N-00251-50548201,2022-07-24T09:23:22,Labastida,expenses,repairs,-309.41,-9837.06
buyer_8,Antonio,45,ES18209590033460822675,TRX_N-00252-89380101,2022-07-25T11:15:05,Labastida,expenses,appliances,-388.64,-10225.7
buyer_8,Antonio,45,ES18209590033460822675,TRX_N-00253-84878617,2022-07-26T19:41:40,Oyón-Oion,expenses,transport,-43.37,-10269.07
buyer_8,Antonio,45,ES18209590033460822675,TRX_N-00254-74276102,2022-07-26T11:48:22,Labastida,expenses,clothing,-145.86,-10414.93
buyer_8,Antonio,45,ES18209590033460822675,TRX_N-00255-50360716,2022-07-26T10:29:14,Labastida,expenses,education,-51.09,-10466.02
buyer_8,Antonio,45,ES18209590033460822675,TRX_N-00256-04437517,2022-07-26T12:18:55,Labastida,expenses,children,-97.4,-10563.42
buyer_8,Antonio,45,ES18209590033460822675,TRX_N-00257-10418120,2022-07-30T19:33:35,Labastida,expenses,transport,-60.86,-10624.28
buyer_8,Antonio,45,ES18209590033460822675,TRX_N-00258-02445438,2022-07-31T10:38:55,Eibar,expenses,healthcare,-146.44,-10770.72
buyer_8,Antonio,45,ES18209590033460822675,TRX_N-00259-14835054,2022-08-01T12:46:50,Labastida,incomes,salary,1442.35,-9328.37
buyer_8,Antonio,45,ES18209590033460822675,TRX_N-00260-28531547,2022-08-01T12:46:50,Labastida,incomes,salary_partner,1372.95,-7955.42
buyer_8,Antonio,45,ES18209590033460822675,TRX_N-00261-00328992,2022-08-01T09:06:14,Labastida,expenses,leisure,-52.93,-8008.35
buyer_8,Antonio,45,ES18209590033460822675,TRX_N-00262-12484182,2022-08-02T00:39:05,Labastida,expenses,cash,-100.0,-8108.35
buyer_8,Antonio,45,ES18209590033460822675,TRX_N-00263-90959296,2022-08-04T14:01:39,Labastida,expenses,mortgage,-956.34,-9064.69
buyer_8,Antonio,45,ES18209590033460822675,TRX_N-00264-66610359,2022-08-04T08:12:10,Labastida,expenses,healthcare,-139.3,-9203.99
buyer_8,Antonio,45,ES18209590033460822675,TRX_N-00265-89059978,2022-08-05T16:48:21,Hernani,expenses,gifts,-695.82,-9899.81
buyer_8,Antonio,45,ES18209590033460822675,TRX_N-00266-78295508,2022-08-06T23:36:58,Labastida,expenses,electricity,-42.4,-9942.21
buyer_8,Antonio,45,ES18209590033460822675,TRX_N-00267-18335512,2022-08-06T23:07:54,Labastida,expenses,cash,-100.0,-10042.21
buyer_8,Antonio,45,ES18209590033460822675,TRX_N-00268-81804985,2022-08-08T13:35:54,Labastida,expenses,water,-21.48,-10063.69
buyer_8,Antonio,45,ES18209590033460822675,TRX_N-00269-01587732,2022-08-08T00:39:58,Labastida,expenses,gas,-100.82,-10164.51
buyer_8,Antonio,45,ES18209590033460822675,TRX_N-00270-85978560,2022-08-08T08:34:56,Labastida,expenses,internet,-42.0,-10206.51
buyer_8,Antonio,45,ES18209590033460822675,TRX_N-00271-39001272,2022-08-08T10:19:39,Labastida,expenses,phone,-43.72,-10250.23
buyer_8,Antonio,45,ES18209590033460822675,TRX_N-00272-93073359,2022-08-08T20:40:32,Labastida,expenses,transport,-54.38,-10304.61
buyer_8,Antonio,45,ES18209590033460822675,TRX_N-00273-89938417,2022-08-08T09:12:40,Leioa,expenses,leisure,-32.63,-10337.24
buyer_8,Antonio,45,ES18209590033460822675,TRX_N-00274-49272547,2022-08-08T13:30:08,Labastida,expenses,cash,-100.0,-10437.24
buyer_8,Antonio,45,ES18209590033460822675,TRX_N-00275-65153115,2022-08-09T13:08:36,Labastida,expenses,children,-183.6,-10620.84
buyer_8,Antonio,45,ES18209590033460822675,TRX_N-00276-15892046,2022-08-10T09:25:19,Mungia,expenses,travel,-641.23,-11262.07
buyer_8,Antonio,45,ES18209590033460822675,TRX_N-00277-98218300,2022-08-11T12:24:45,Labastida,expenses,repairs,-92.45,-11354.52
buyer_8,Antonio,45,ES18209590033460822675,TRX_N-00278-61569136,2022-08-13T19:28:07,Labastida,expenses,cash,-100.0,-11454.52
buyer_8,Antonio,45,ES18209590033460822675,TRX_N-00279-77948216,2022-08-14T18:27:31,Labastida,expenses,food,-64.98,-11519.5
buyer_8,Antonio,45,ES18209590033460822675,TRX_N-00280-09256054,2022-08-14T10:15:59,Barakaldo,expenses,transport,-43.68,-11563.18
buyer_8,Antonio,45,ES18209590033460822675,TRX_N-00281-31513169,2022-08-14T05:42:48,Labastida,expenses,leisure,-33.04,-11596.22
buyer_8,Antonio,45,ES18209590033460822675,TRX_N-00282-77754605,2022-08-15T09:29:40,Labastida,expenses,gifts,-780.24,-12376.46
buyer_8,Antonio,45,ES18209590033460822675,TRX_N-00283-66395660,2022-08-18T12:38:24,Labastida,expenses,food,-75.96,-12452.42
buyer_8,Antonio,45,ES18209590033460822675,TRX_N-00284-16925137,2022-08-18T08:46:45,Labastida,expenses,clothing,-122.63,-12575.05
buyer_8,Antonio,45,ES18209590033460822675,TRX_N-00285-55217233,2022-08-19T10:35:51,Lasarte-Oria,expenses,education,-54.92,-12629.97
buyer_8,Antonio,45,ES18209590033460822675,TRX_N-00286-18037887,2022-08-21T16:21:51,Labastida,expenses,leisure,-26.07,-12656.04
buyer_8,Antonio,45,ES18209590033460822675,TRX_N-00287-12253193,2022-08-23T21:08:28,Irun,expenses,clothing,-157.68,-12813.72
buyer_8,Antonio,45,ES18209590033460822675,TRX_N-00288-80019427,2022-08-23T10:49:44,Donostia,expenses,repairs,-277.45,-13091.17
buyer_8,Antonio,45,ES18209590033460822675,TRX_N-00289-08504612,2022-08-24T12:00:19,Labastida,expenses,repairs,-246.84,-13338.01
buyer_8,Antonio,45,ES18209590033460822675,TRX_N-00290-57787942,2022-08-24T15:57:19,Labastida,expenses,children,-241.05,-13579.06
buyer_8,Antonio,45,ES18209590033460822675,TRX_N-00291-87049648,2022-08-25T09:09:41,Labastida,expenses,repairs,-140.16,-13719.22
buyer_8,Antonio,45,ES18209590033460822675,TRX_N-00292-66123105,2022-08-26T16:53:48,Labastida,expenses,food,-114.9,-13834.12
buyer_8,Antonio,45,ES18209590033460822675,TRX_N-00293-91907470,2022-08-26T14:45:07,Labastida,expenses,repairs,-156.58,-13990.7
buyer_8,Antonio,45,ES18209590033460822675,TRX_N-00294-14107865,2022-08-27T20:03:58,Labastida,expenses,clothing,-90.85,-14081.55
buyer_8,Antonio,45,ES18209590033460822675,TRX_N-00295-32458837,2022-08-27T16:39:07,Labastida,expenses,cash,-100.0,-14181.55
buyer_8,Antonio,45,ES18209590033460822675,TRX_N-00296-96051028,2022-08-29T17:35:02,Labastida,expenses,clothing,-116.4,-14297.95
buyer_8,Antonio,45,ES18209590033460822675,TRX_N-00297-32547810,2022-08-29T17:47:05,Labastida,expenses,cash,-100.0,-14397.95
buyer_8,Antonio,45,ES18209590033460822675,TRX_N-00298-10981792,2022-08-30T16:04:22,Labastida,expenses,children,-221.92,-14619.87
buyer_8,Antonio,45,ES18209590033460822675,TRX_N-00299-01188890,2022-09-01T05:19:31,Labastida,incomes,salary,1442.35,-13177.52
buyer_8,Antonio,45,ES18209590033460822675,TRX_N-00300-97371963,2022-09-01T05:19:31,Labastida,incomes,salary_partner,1372.95,-11804.57
buyer_8,Antonio,45,ES18209590033460822675,TRX_N-00301-96931712,2022-09-01T17:23:31,Labastida,expenses,clothing,-67.31,-11871.88
buyer_8,Antonio,45,ES18209590033460822675,TRX_N-00302-95360452,2022-09-03T12:47:24,Labastida,expenses,healthcare,-178.71,-12050.59
buyer_8,Antonio,45,ES18209590033460822675,TRX_N-00303-62820591,2022-09-03T19:49:37,Labastida,expenses,cash,-100.0,-12150.59
buyer_8,Antonio,45,ES18209590033460822675,TRX_N-00304-22702997,2022-09-04T17:37:03,Labastida,expenses,mortgage,-956.34,-13106.93
buyer_8,Antonio,45,ES18209590033460822675,TRX_N-00305-99120208,2022-09-04T15:53:49,Labastida,expenses,food,-82.01,-13188.94
buyer_8,Antonio,45,ES18209590033460822675,TRX_N-00306-94184462,2022-09-04T16:59:29,Leioa,expenses,leisure,-55.44,-13244.38
buyer_8,Antonio,45,ES18209590033460822675,TRX_N-00307-89715499,2022-09-05T08:13:10,Labastida,expenses,internet,-42.0,-13286.38
buyer_8,Antonio,45,ES18209590033460822675,TRX_N-00308-49094047,2022-09-05T08:00:15,Labastida,expenses,phone,-34.5,-13320.88
buyer_8,Antonio,45,ES18209590033460822675,TRX_N-00309-16026038,2022-09-07T17:35:21,Labastida,expenses,cash,-100.0,-13420.88
buyer_8,Antonio,45,ES18209590033460822675,TRX_N-00310-27027740,2022-09-08T12:58:03,Labastida,expenses,water,-27.33,-13448.21
buyer_8,Antonio,45,ES18209590033460822675,TRX_N-00311-93779303,2022-09-08T05:11:35,Labastida,expenses,electricity,-55.51,-13503.72
buyer_8,Antonio,45,ES18209590033460822675,TRX_N-00312-86265418,2022-09-08T12:22:49,Labastida,expenses,gas,-93.98,-13597.7
buyer_8,Antonio,45,ES18209590033460822675,TRX_N-00313-42594230,2022-09-08T11:44:25,Bermeo,expenses,transport,-74.65,-13672.35
buyer_8,Antonio,45,ES18209590033460822675,TRX_N-00314-48836166,2022-09-10T13:31:37,Labastida,expenses,education,-73.72,-13746.07
buyer_8,Antonio,45,ES18209590033460822675,TRX_N-00315-94663959,2022-09-11T00:33:33,Labastida,expenses,healthcare,-104.42,-13850.49
buyer_8,Antonio,45,ES18209590033460822675,TRX_N-00316-31164794,2022-09-11T15:06:25,Labastida,expenses,education,-63.65,-13914.14
buyer_8,Antonio,45,ES18209590033460822675,TRX_N-00317-32846857,2022-09-14T18:50:56,Labastida,expenses,transport,-64.33,-13978.47
buyer_8,Antonio,45,ES18209590033460822675,TRX_N-00318-44691756,2022-09-14T14:26:03,Labastida,expenses,education,-62.39,-14040.86
buyer_8,Antonio,45,ES18209590033460822675,TRX_N-00319-77526979,2022-09-16T05:24:42,Labastida,expenses,food,-108.72,-14149.58
buyer_8,Antonio,45,ES18209590033460822675,TRX_N-00320-21590673,2022-09-16T16:05:28,Iruña de Oca,expenses,repairs,-210.85,-14360.43
buyer_8,Antonio,45,ES18209590033460822675,TRX_N-00321-57040772,2022-09-16T10:48:50,Labastida,expenses,children,-151.86,-14512.29
buyer_8,Antonio,45,ES18209590033460822675,TRX_N-00322-11982024,2022-09-17T22:14:09,Labastida,expenses,cash,-100.0,-14612.29
buyer_8,Antonio,45,ES18209590033460822675,TRX_N-00323-88060298,2022-09-18T19:04:35,Labastida,expenses,cash,-100.0,-14712.29
buyer_8,Antonio,45,ES18209590033460822675,TRX_N-00324-83824250,2022-09-20T13:19:54,Arrasate,expenses,education,-61.21,-14773.5
buyer_8,Antonio,45,ES18209590033460822675,TRX_N-00325-90317416,2022-09-20T14:36:56,Labastida,expenses,cash,-100.0,-14873.5
buyer_8,Antonio,45,ES18209590033460822675,TRX_N-00326-76342903,2022-09-21T17:03:28,Labastida,expenses,clothing,-110.22,-14983.72
buyer_8,Antonio,45,ES18209590033460822675,TRX_N-00327-49976508,2022-09-21T13:46:02,Bermeo,expenses,cash,-100.0,-15083.72
buyer_8,Antonio,45,ES18209590033460822675,TRX_N-00328-02533675,2022-09-24T18:42:56,Llodio,expenses,clothing,-75.94,-15159.66
buyer_8,Antonio,45,ES18209590033460822675,TRX_N-00329-20431122,2022-09-24T19:48:16,Labastida,expenses,cash,-100.0,-15259.66
buyer_8,Antonio,45,ES18209590033460822675,TRX_N-00330-18381713,2022-09-27T08:36:19,Labastida,expenses,food,-102.73,-15362.39
buyer_8,Antonio,45,ES18209590033460822675,TRX_N-00331-95127049,2022-09-28T17:11:08,Labastida,expenses,leisure,-79.0,-15441.39
buyer_8,Antonio,45,ES18209590033460822675,TRX_N-00332-21586199,2022-09-30T14:25:27,Labastida,expenses,cash,-100.0,-15541.39
buyer_8,Antonio,45,ES18209590033460822675,TRX_N-00333-29976926,2022-10-01T13:48:24,Labastida,incomes,salary,1442.35,-14099.04
buyer_8,Antonio,45,ES18209590033460822675,TRX_N-00334-79445216,2022-10-01T13:48:24,Labastida,incomes,salary_partner,1372.95,-12726.09
buyer_8,Antonio,45,ES18209590033460822675,TRX_N-00335-93753448,2022-10-01T13:48:24,Labastida,incomes,extra_income,185.49,-12540.6
buyer_8,Antonio,45,ES18209590033460822675,TRX_N-00336-56627884,2022-10-03T17:29:09,Labastida,expenses,cash,-100.0,-12640.6
buyer_8,Antonio,45,ES18209590033460822675,TRX_N-00337-60699403,2022-10-04T18:40:17,Labastida,expenses,mortgage,-956.34,-13596.94
buyer_8,Antonio,45,ES18209590033460822675,TRX_N-00338-02338932,2022-10-05T20:55:38,Labastida,expenses,transport,-45.15,-13642.09
buyer_8,Antonio,45,ES18209590033460822675,TRX_N-00339-91827722,2022-10-05T13:59:54,Labastida,expenses,leisure,-53.76,-13695.85
buyer_8,Antonio,45,ES18209590033460822675,TRX_N-00340-81681801,2022-10-06T17:18:16,Labastida,expenses,water,-20.97,-13716.82
buyer_8,Antonio,45,ES18209590033460822675,TRX_N-00341-69739040,2022-10-07T12:19:23,Labastida,expenses,electricity,-85.21,-13802.03
buyer_8,Antonio,45,ES18209590033460822675,TRX_N-00342-08827175,2022-10-07T14:58:44,Labastida,expenses,gas,-69.71,-13871.74
buyer_8,Antonio,45,ES18209590033460822675,TRX_N-00343-31980274,2022-10-07T13:26:42,Labastida,expenses,internet,-42.0,-13913.74
buyer_8,Antonio,45,ES18209590033460822675,TRX_N-00344-27038073,2022-10-08T11:20:42,Labastida,expenses,phone,-32.6,-13946.34
buyer_8,Antonio,45,ES18209590033460822675,TRX_N-00345-38882602,2022-10-08T19:23:32,Labastida,expenses,cash,-100.0,-14046.34
buyer_8,Antonio,45,ES18209590033460822675,TRX_N-00346-28874749,2022-10-09T17:53:09,Labastida,expenses,repairs,-100.7,-14147.04
buyer_8,Antonio,45,ES18209590033460822675,TRX_N-00347-96960610,2022-10-11T10:21:29,Labastida,expenses,leisure,-40.02,-14187.06
buyer_8,Antonio,45,ES18209590033460822675,TRX_N-00348-57907112,2022-10-12T09:48:59,Labastida,expenses,cash,-100.0,-14287.06
buyer_8,Antonio,45,ES18209590033460822675,TRX_N-00349-35713425,2022-10-16T04:49:08,Amurrio,expenses,food,-98.87,-14385.93
buyer_8,Antonio,45,ES18209590033460822675,TRX_N-00350-52662625,2022-10-16T08:47:44,Labastida,expenses,cash,-100.0,-14485.93
buyer_8,Antonio,45,ES18209590033460822675,TRX_N-00351-25057357,2022-10-18T15:47:39,Zarautz,expenses,cash,-100.0,-14585.93
buyer_8,Antonio,45,ES18209590033460822675,TRX_N-00352-85955957,2022-10-18T13:01:44,Labastida,expenses,repairs,-331.94,-14917.87
buyer_8,Antonio,45,ES18209590033460822675,TRX_N-00353-92130068,2022-10-20T11:34:53,Labastida,expenses,healthcare,-67.18,-14985.05
buyer_8,Antonio,45,ES18209590033460822675,TRX_N-00354-00688402,2022-10-21T09:10:25,Labastida,expenses,food,-96.01,-15081.06
buyer_8,Antonio,45,ES18209590033460822675,TRX_N-00355-17207111,2022-10-22T17:36:16,Labastida,expenses,food,-112.5,-15193.56
buyer_8,Antonio,45,ES18209590033460822675,TRX_N-00356-49374438,2022-10-22T11:52:57,Labastida,expenses,transport,-40.06,-15233.62
buyer_8,Antonio,45,ES18209590033460822675,TRX_N-00357-86173858,2022-10-22T18:50:48,Labastida,expenses,leisure,-52.98,-15286.6
buyer_8,Antonio,45,ES18209590033460822675,TRX_N-00358-14163624,2022-10-22T13:13:46,Labastida,expenses,repairs,-42.62,-15329.22
buyer_8,Antonio,45,ES18209590033460822675,TRX_N-00359-99958288,2022-10-23T08:12:57,Labastida,expenses,food,-68.66,-15397.88
buyer_8,Antonio,45,ES18209590033460822675,TRX_N-00360-07820145,2022-10-27T19:29:37,Labastida,expenses,repairs,-66.42,-15464.3
buyer_8,Antonio,45,ES18209590033460822675,TRX_N-00361-69430865,2022-10-28T18:41:19,Labastida,expenses,food,-91.56,-15555.86
buyer_8,Antonio,45,ES18209590033460822675,TRX_N-00362-43747109,2022-10-28T21:11:03,Labastida,expenses,repairs,-159.98,-15715.84
buyer_8,Antonio,45,ES18209590033460822675,TRX_N-00363-10007450,2022-10-29T08:39:08,Labastida,expenses,gifts,-420.64,-16136.48
buyer_8,Antonio,45,ES18209590033460822675,TRX_N-00364-26959921,2022-10-30T10:55:52,Labastida,expenses,repairs,-55.55,-16192.03
buyer_8,Antonio,45,ES18209590033460822675,TRX_N-00365-45938926,2022-10-31T21:04:16,Basauri,expenses,food,-84.47,-16276.5
buyer_8,Antonio,45,ES18209590033460822675,TRX_N-00366-21482486,2022-10-31T16:31:31,Labastida,expenses,repairs,-199.64,-16476.14
buyer_8,Antonio,45,ES18209590033460822675,TRX_N-00367-47447886,2022-11-01T05:04:54,Labastida,incomes,salary,1442.35,-15033.79
buyer_8,Antonio,45,ES18209590033460822675,TRX_N-00368-95891427,2022-11-01T05:04:54,Labastida,incomes,salary_partner,1372.95,-13660.84
buyer_8,Antonio,45,ES18209590033460822675,TRX_N-00369-19847533,2022-11-01T15:12:45,Labastida,expenses,cash,-100.0,-13760.84
buyer_8,Antonio,45,ES18209590033460822675,TRX_N-00370-52878343,2022-11-03T12:46:59,Labastida,expenses,gifts,-540.56,-14301.4
buyer_8,Antonio,45,ES18209590033460822675,TRX_N-00371-81693758,2022-11-03T17:52:45,Labastida,expenses,children,-169.6,-14471.0
buyer_8,Antonio,45,ES18209590033460822675,TRX_N-00372-31835935,2022-11-04T09:37:59,Labastida,expenses,mortgage,-956.34,-15427.34
buyer_8,Antonio,45,ES18209590033460822675,TRX_N-00373-54067174,2022-11-05T09:25:07,Labastida,expenses,water,-29.2,-15456.54
buyer_8,Antonio,45,ES18209590033460822675,TRX_N-00374-94765092,2022-11-05T11:57:48,Labastida,expenses,children,-153.51,-15610.05
buyer_8,Antonio,45,ES18209590033460822675,TRX_N-00375-21960826,2022-11-06T15:58:41,Labastida,expenses,electricity,-47.68,-15657.73
buyer_8,Antonio,45,ES18209590033460822675,TRX_N-00376-21060607,2022-11-06T01:33:34,Labastida,expenses,gas,-49.88,-15707.61
buyer_8,Antonio,45,ES18209590033460822675,TRX_N-00377-36323523,2022-11-07T18:06:03,Labastida,expenses,internet,-42.0,-15749.61
buyer_8,Antonio,45,ES18209590033460822675,TRX_N-00378-62198412,2022-11-08T19:19:21,Labastida,expenses,phone,-39.86,-15789.47
buyer_8,Antonio,45,ES18209590033460822675,TRX_N-00379-71230293,2022-11-08T02:29:44,Eibar,expenses,cash,-100.0,-15889.47
buyer_8,Antonio,45,ES18209590033460822675,TRX_N-00380-64194549,2022-11-09T12:48:47,Labastida,expenses,cash,-100.0,-15989.47
buyer_8,Antonio,45,ES18209590033460822675,TRX_N-00381-21934137,2022-11-09T20:26:26,Hernani,expenses,gifts,-766.98,-16756.45
buyer_8,Antonio,45,ES18209590033460822675,TRX_N-00382-98936416,2022-11-10T13:57:07,Labastida,expenses,transport,-79.03,-16835.48
buyer_8,Antonio,45,ES18209590033460822675,TRX_N-00383-93549972,2022-11-10T18:01:29,Labastida,expenses,appliances,-147.94,-16983.42
buyer_8,Antonio,45,ES18209590033460822675,TRX_N-00384-58397649,2022-11-13T16:01:25,Mungia,expenses,transport,-70.21,-17053.63
buyer_8,Antonio,45,ES18209590033460822675,TRX_N-00385-17708528,2022-11-17T03:50:41,Labastida,expenses,cash,-100.0,-17153.63
buyer_8,Antonio,45,ES18209590033460822675,TRX_N-00386-65766886,2022-11-17T16:06:55,Labastida,expenses,repairs,-60.92,-17214.55
buyer_8,Antonio,45,ES18209590033460822675,TRX_N-00387-23614768,2022-11-19T13:15:15,Labastida,expenses,leisure,-19.44,-17233.99
buyer_8,Antonio,45,ES18209590033460822675,TRX_N-00388-57353305,2022-11-20T13:03:25,Vitoria-Gasteiz,expenses,cash,-100.0,-17333.99
buyer_8,Antonio,45,ES18209590033460822675,TRX_N-00389-36447420,2022-11-27T16:50:36,Labastida,expenses,transport,-64.42,-17398.41
buyer_8,Antonio,45,ES18209590033460822675,TRX_N-00390-30017131,2022-11-27T13:07:40,Labastida,expenses,leisure,-63.37,-17461.78
buyer_8,Antonio,45,ES18209590033460822675,TRX_N-00391-76262777,2022-11-27T09:24:01,Andoain,expenses,appliances,-321.53,-17783.31
buyer_8,Antonio,45,ES18209590033460822675,TRX_N-00392-55082080,2022-11-29T19:34:12,Labastida,expenses,leisure,-42.04,-17825.35
buyer_8,Antonio,45,ES18209590033460822675,TRX_N-00393-99264442,2022-12-01T12:36:48,Labastida,incomes,salary,1442.35,-16383.0
buyer_8,Antonio,45,ES18209590033460822675,TRX_N-00394-33322170,2022-12-01T12:36:48,Labastida,incomes,salary_partner,1372.95,-15010.05
buyer_8,Antonio,45,ES18209590033460822675,TRX_N-00395-51650472,2022-12-01T12:36:48,Labastida,incomes,salary_bonus,1046.42,-13963.63
buyer_8,Antonio,45,ES18209590033460822675,TRX_N-00396-73455536,2022-12-01T12:36:48,Labastida,incomes,salary_partner_bonus,1067.01,-12896.62
buyer_8,Antonio,45,ES18209590033460822675,TRX_N-00397-45065521,2022-12-01T09:12:37,Labastida,expenses,education,-75.41,-12972.03
buyer_8,Antonio,45,ES18209590033460822675,TRX_N-00398-74201597,2022-12-04T20:11:07,Labastida,expenses,mortgage,-956.34,-13928.37
buyer_8,Antonio,45,ES18209590033460822675,TRX_N-00399-08413978,2022-12-04T09:10:45,Labastida,expenses,leisure,-21.58,-13949.95
buyer_8,Antonio,45,ES18209590033460822675,TRX_N-00400-76681295,2022-12-05T16:17:14,Labastida,expenses,food,-84.02,-14033.97
buyer_8,Antonio,45,ES18209590033460822675,TRX_N-00401-82651504,2022-12-05T13:17:18,Getxo,expenses,appliances,-91.08,-14125.05
buyer_8,Antonio,45,ES18209590033460822675,TRX_N-00402-32688650,2022-12-06T17:15:59,Labastida,expenses,electricity,-28.3,-14153.35
buyer_8,Antonio,45,ES18209590033460822675,TRX_N-00403-86607758,2022-12-06T19:10:21,Labastida,expenses,gas,-33.93,-14187.28
buyer_8,Antonio,45,ES18209590033460822675,TRX_N-00404-46609359,2022-12-06T12:42:42,Labastida,expenses,internet,-42.0,-14229.28
buyer_8,Antonio,45,ES18209590033460822675,TRX_N-00405-83609270,2022-12-07T13:51:28,Labastida,expenses,phone,-43.96,-14273.24
buyer_8,Antonio,45,ES18209590033460822675,TRX_N-00406-99253027,2022-12-08T21:16:02,Labastida,expenses,water,-40.61,-14313.85
buyer_8,Antonio,45,ES18209590033460822675,TRX_N-00407-84425924,2022-12-08T12:40:48,Donostia,expenses,repairs,-205.0,-14518.85
buyer_8,Antonio,45,ES18209590033460822675,TRX_N-00408-67222844,2022-12-09T00:10:35,Labastida,expenses,transport,-47.42,-14566.27
buyer_8,Antonio,45,ES18209590033460822675,TRX_N-00409-00991231,2022-12-09T08:22:23,Labastida,expenses,clothing,-62.66,-14628.93
buyer_8,Antonio,45,ES18209590033460822675,TRX_N-00410-46162754,2022-12-11T20:18:25,Labastida,expenses,transport,-71.18,-14700.11
buyer_8,Antonio,45,ES18209590033460822675,TRX_N-00411-83566323,2022-12-11T18:22:29,Labastida,expenses,gifts,-275.46,-14975.57
buyer_8,Antonio,45,ES18209590033460822675,TRX_N-00412-42174738,2022-12-13T19:03:09,Labastida,expenses,transport,-86.12,-15061.69
buyer_8,Antonio,45,ES18209590033460822675,TRX_N-00413-78179370,2022-12-14T13:27:42,Labastida,expenses,cash,-100.0,-15161.69
buyer_8,Antonio,45,ES18209590033460822675,TRX_N-00414-91499832,2022-12-15T19:00:55,Labastida,expenses,cash,-100.0,-15261.69
buyer_8,Antonio,45,ES18209590033460822675,TRX_N-00415-08134180,2022-12-17T08:02:35,Labastida,expenses,cash,-100.0,-15361.69
buyer_8,Antonio,45,ES18209590033460822675,TRX_N-00416-02320163,2022-12-18T12:30:22,Labastida,expenses,leisure,-42.9,-15404.59
buyer_8,Antonio,45,ES18209590033460822675,TRX_N-00417-08415506,2022-12-18T19:00:48,Labastida,expenses,children,-162.34,-15566.93
buyer_8,Antonio,45,ES18209590033460822675,TRX_N-00418-66193885,2022-12-19T11:23:12,Labastida,expenses,clothing,-136.44,-15703.37
buyer_8,Antonio,45,ES18209590033460822675,TRX_N-00419-66611190,2022-12-20T10:24:53,Labastida,expenses,repairs,-312.99,-16016.36
buyer_8,Antonio,45,ES18209590033460822675,TRX_N-00420-28486789,2022-12-21T13:19:34,Iruña de Oca,expenses,appliances,-340.94,-16357.3
buyer_8,Antonio,45,ES18209590033460822675,TRX_N-00421-22807803,2022-12-27T00:12:53,Labastida,expenses,leisure,-73.16,-16430.46
buyer_8,Antonio,45,ES18209590033460822675,TRX_N-00422-43875966,2022-12-29T08:26:29,Labastida,expenses,transport,-76.09,-16506.55
buyer_8,Antonio,45,ES18209590033460822675,TRX_N-00423-47525136,2022-12-29T10:41:46,Labastida,expenses,cash,-100.0,-16606.55
buyer_8,Antonio,45,ES18209590033460822675,TRX_N-00424-26285812,2022-12-29T02:45:25,Labastida,expenses,repairs,-323.49,-16930.04
buyer_8,Antonio,45,ES18209590033460822675,TRX_N-00425-68030395,2022-12-30T16:39:28,Labastida,expenses,food,-108.83,-17038.87
buyer_8,Antonio,45,ES18209590033460822675,TRX_N-00426-42286172,2022-12-31T08:31:51,Labastida,expenses,repairs,-267.97,-17306.84
buyer_8,Antonio,45,ES18209590033460822675,TRX_N-00427-68418730,2023-01-01T08:01:41,Labastida,incomes,salary,1495.59,-15811.25
buyer_8,Antonio,45,ES18209590033460822675,TRX_N-00428-94214059,2023-01-01T08:01:41,Labastida,incomes,salary_partner,1423.63,-14387.62
buyer_8,Antonio,45,ES18209590033460822675,TRX_N-00429-71473594,2023-01-01T07:48:54,Labastida,expenses,transport,-88.93,-14476.55
buyer_8,Antonio,45,ES18209590033460822675,TRX_N-00430-25303328,2023-01-03T19:51:25,Labastida,expenses,cash,-100.0,-14576.55
buyer_8,Antonio,45,ES18209590033460822675,TRX_N-00431-92155183,2023-01-04T04:12:09,Labastida,expenses,mortgage,-956.34,-15532.89
buyer_8,Antonio,45,ES18209590033460822675,TRX_N-00432-55775125,2023-01-04T14:27:43,Labastida,expenses,food,-121.34,-15654.23
buyer_8,Antonio,45,ES18209590033460822675,TRX_N-00433-87883844,2023-01-05T23:21:06,Labastida,expenses,clothing,-137.91,-15792.14
buyer_8,Antonio,45,ES18209590033460822675,TRX_N-00434-63623046,2023-01-07T19:04:30,Labastida,expenses,water,-43.82,-15835.96
buyer_8,Antonio,45,ES18209590033460822675,TRX_N-00435-68747769,2023-01-07T16:15:20,Labastida,expenses,gas,-36.23,-15872.19
buyer_8,Antonio,45,ES18209590033460822675,TRX_N-00436-66314028,2023-01-07T08:44:20,Labastida,expenses,phone,-35.8,-15907.99
buyer_8,Antonio,45,ES18209590033460822675,TRX_N-00437-89127827,2023-01-08T11:52:22,Labastida,expenses,electricity,-63.04,-15971.03
buyer_8,Antonio,45,ES18209590033460822675,TRX_N-00438-36221944,2023-01-08T23:54:51,Labastida,expenses,internet,-42.0,-16013.03
buyer_8,Antonio,45,ES18209590033460822675,TRX_N-00439-25315179,2023-01-08T15:59:59,Labastida,expenses,leisure,-38.3,-16051.33
buyer_8,Antonio,45,ES18209590033460822675,TRX_N-00440-10363447,2023-01-08T15:46:24,Labastida,expenses,children,-152.37,-16203.7
buyer_8,Antonio,45,ES18209590033460822675,TRX_N-00441-99057515,2023-01-10T15:57:43,Labastida,expenses,education,-76.06,-16279.76
buyer_8,Antonio,45,ES18209590033460822675,TRX_N-00442-03558237,2023-01-10T17:10:23,Labastida,expenses,cash,-100.0,-16379.76
buyer_8,Antonio,45,ES18209590033460822675,TRX_N-00443-66794344,2023-01-11T14:23:05,Labastida,expenses,healthcare,-105.37,-16485.13
buyer_8,Antonio,45,ES18209590033460822675,TRX_N-00444-35461601,2023-01-13T17:23:25,Labastida,expenses,food,-105.62,-16590.75
buyer_8,Antonio,45,ES18209590033460822675,TRX_N-00445-91023929,2023-01-14T08:07:57,Labastida,expenses,food,-74.99,-16665.74
buyer_8,Antonio,45,ES18209590033460822675,TRX_N-00446-35937403,2023-01-14T18:32:58,Labastida,expenses,transport,-49.38,-16715.12
buyer_8,Antonio,45,ES18209590033460822675,TRX_N-00447-12692207,2023-01-16T13:34:19,Labastida,expenses,food,-90.3,-16805.42
buyer_8,Antonio,45,ES18209590033460822675,TRX_N-00448-79272092,2023-01-16T07:09:34,Labastida,expenses,gifts,-828.51,-17633.93
buyer_8,Antonio,45,ES18209590033460822675,TRX_N-00449-53249678,2023-01-17T10:40:04,Labastida,expenses,repairs,-231.27,-17865.2
buyer_8,Antonio,45,ES18209590033460822675,TRX_N-00450-09005765,2023-01-17T16:20:35,Labastida,expenses,gifts,-706.57,-18571.77
buyer_8,Antonio,45,ES18209590033460822675,TRX_N-00451-20840934,2023-01-18T20:02:44,Labastida,expenses,clothing,-85.99,-18657.76
buyer_8,Antonio,45,ES18209590033460822675,TRX_N-00452-73451240,2023-01-19T20:38:11,Labastida,expenses,transport,-51.25,-18709.01
buyer_8,Antonio,45,ES18209590033460822675,TRX_N-00453-61537886,2023-01-19T00:54:15,Labastida,expenses,cash,-100.0,-18809.01
buyer_8,Antonio,45,ES18209590033460822675,TRX_N-00454-70384352,2023-01-20T11:19:29,Getxo,expenses,food,-89.26,-18898.27
buyer_8,Antonio,45,ES18209590033460822675,TRX_N-00455-11591966,2023-01-21T18:54:25,Labastida,expenses,food,-119.52,-19017.79
buyer_8,Antonio,45,ES18209590033460822675,TRX_N-00456-35113720,2023-01-22T05:51:46,Labastida,expenses,food,-120.25,-19138.04
buyer_8,Antonio,45,ES18209590033460822675,TRX_N-00457-73899283,2023-01-23T11:56:38,Labastida,expenses,leisure,-40.34,-19178.38
buyer_8,Antonio,45,ES18209590033460822675,TRX_N-00458-41731142,2023-01-24T13:13:28,Labastida,expenses,food,-89.19,-19267.57
buyer_8,Antonio,45,ES18209590033460822675,TRX_N-00459-99423465,2023-01-27T08:40:26,Hondarribia,expenses,leisure,-33.47,-19301.04
buyer_8,Antonio,45,ES18209590033460822675,TRX_N-00460-95609453,2023-01-27T08:05:02,Bilbao,expenses,cash,-100.0,-19401.04
buyer_8,Antonio,45,ES18209590033460822675,TRX_N-00461-19051908,2023-01-29T19:46:01,Labastida,expenses,food,-124.78,-19525.82
buyer_8,Antonio,45,ES18209590033460822675,TRX_N-00462-25903680,2023-01-29T11:11:46,Labastida,expenses,transport,-57.18,-19583.0
buyer_8,Antonio,45,ES18209590033460822675,TRX_N-00463-01960300,2023-01-30T09:01:18,Labastida,expenses,food,-82.78,-19665.78
buyer_8,Antonio,45,ES18209590033460822675,TRX_N-00464-59381801,2023-02-01T07:11:46,Labastida,incomes,salary,1495.59,-18170.19
buyer_8,Antonio,45,ES18209590033460822675,TRX_N-00465-73059837,2023-02-01T07:11:46,Labastida,incomes,salary_partner,1423.63,-16746.56
buyer_8,Antonio,45,ES18209590033460822675,TRX_N-00466-23993283,2023-02-01T07:11:46,Labastida,incomes,extra_income,185.49,-16561.07
buyer_8,Antonio,45,ES18209590033460822675,TRX_N-00467-63578693,2023-02-04T15:39:28,Labastida,expenses,mortgage,-956.34,-17517.41
buyer_8,Antonio,45,ES18209590033460822675,TRX_N-00468-78934397,2023-02-04T09:10:29,Labastida,expenses,appliances,-164.5,-17681.91
buyer_8,Antonio,45,ES18209590033460822675,TRX_N-00469-08699354,2023-02-05T21:53:41,Labastida,expenses,gas,-50.83,-17732.74
buyer_8,Antonio,45,ES18209590033460822675,TRX_N-00470-58866530,2023-02-06T13:33:32,Labastida,expenses,water,-41.41,-17774.15
buyer_8,Antonio,45,ES18209590033460822675,TRX_N-00471-79918837,2023-02-06T19:24:58,Labastida,expenses,internet,-42.0,-17816.15
buyer_8,Antonio,45,ES18209590033460822675,TRX_N-00472-67702261,2023-02-06T21:33:53,Labastida,expenses,education,-46.47,-17862.62
buyer_8,Antonio,45,ES18209590033460822675,TRX_N-00473-18054454,2023-02-07T10:12:38,Labastida,expenses,phone,-43.27,-17905.89
buyer_8,Antonio,45,ES18209590033460822675,TRX_N-00474-48489101,2023-02-07T11:52:16,Labastida,expenses,repairs,-64.31,-17970.2
buyer_8,Antonio,45,ES18209590033460822675,TRX_N-00475-15692745,2023-02-08T06:46:44,Labastida,expenses,electricity,-35.96,-18006.16
buyer_8,Antonio,45,ES18209590033460822675,TRX_N-00476-63546282,2023-02-08T14:42:25,Labastida,expenses,food,-112.25,-18118.41
buyer_8,Antonio,45,ES18209590033460822675,TRX_N-00477-25796678,2023-02-08T17:52:39,Labastida,expenses,transport,-69.57,-18187.98
buyer_8,Antonio,45,ES18209590033460822675,TRX_N-00478-22840315,2023-02-09T03:11:32,Labastida,expenses,cash,-100.0,-18287.98
buyer_8,Antonio,45,ES18209590033460822675,TRX_N-00479-33906062,2023-02-11T22:52:28,Labastida,expenses,transport,-63.64,-18351.62
buyer_8,Antonio,45,ES18209590033460822675,TRX_N-00480-81729745,2023-02-12T23:12:25,Labastida,expenses,leisure,-59.56,-18411.18
buyer_8,Antonio,45,ES18209590033460822675,TRX_N-00481-20799235,2023-02-12T19:20:04,Labastida,expenses,cash,-100.0,-18511.18
buyer_8,Antonio,45,ES18209590033460822675,TRX_N-00482-52593985,2023-02-13T10:42:53,Labastida,expenses,cash,-100.0,-18611.18
buyer_8,Antonio,45,ES18209590033460822675,TRX_N-00483-43937194,2023-02-15T13:19:17,Labastida,expenses,transport,-58.24,-18669.42
buyer_8,Antonio,45,ES18209590033460822675,TRX_N-00484-43567998,2023-02-18T10:39:41,Labastida,expenses,food,-119.53,-18788.95
buyer_8,Antonio,45,ES18209590033460822675,TRX_N-00485-85744707,2023-02-19T08:45:55,Labastida,expenses,transport,-87.83,-18876.78
buyer_8,Antonio,45,ES18209590033460822675,TRX_N-00486-07554221,2023-02-20T16:12:42,Labastida,expenses,transport,-61.56,-18938.34
buyer_8,Antonio,45,ES18209590033460822675,TRX_N-00487-55720987,2023-02-20T13:56:55,Zuia,expenses,cash,-100.0,-19038.34
buyer_8,Antonio,45,ES18209590033460822675,TRX_N-00488-76621318,2023-02-22T14:56:34,Alegría-Dulantzi,expenses,cash,-100.0,-19138.34
buyer_8,Antonio,45,ES18209590033460822675,TRX_N-00489-55349336,2023-02-23T19:40:17,Labastida,expenses,clothing,-55.0,-19193.34
buyer_8,Antonio,45,ES18209590033460822675,TRX_N-00490-47480406,2023-02-23T07:51:56,Zuia,expenses,cash,-100.0,-19293.34
buyer_8,Antonio,45,ES18209590033460822675,TRX_N-00491-36965882,2023-02-24T15:25:57,Labastida,expenses,transport,-72.11,-19365.45
buyer_8,Antonio,45,ES18209590033460822675,TRX_N-00492-10283513,2023-02-24T06:49:01,Amurrio,expenses,clothing,-106.23,-19471.68
buyer_8,Antonio,45,ES18209590033460822675,TRX_N-00493-11363261,2023-02-25T18:39:04,Labastida,expenses,leisure,-83.53,-19555.21
buyer_8,Antonio,45,ES18209590033460822675,TRX_N-00494-92200831,2023-02-26T20:45:10,Hondarribia,expenses,appliances,-166.71,-19721.92
buyer_8,Antonio,45,ES18209590033460822675,TRX_N-00495-17308775,2023-02-27T11:04:22,Labastida,expenses,leisure,-75.87,-19797.79
buyer_8,Antonio,45,ES18209590033460822675,TRX_N-00496-84197897,2023-02-28T19:01:59,Labastida,expenses,education,-58.73,-19856.52
buyer_8,Antonio,45,ES18209590033460822675,TRX_N-00497-47841011,2023-03-01T14:05:23,Labastida,incomes,salary,1495.59,-18360.93
buyer_8,Antonio,45,ES18209590033460822675,TRX_N-00498-14200811,2023-03-01T14:05:23,Labastida,incomes,salary_partner,1423.63,-16937.3
buyer_8,Antonio,45,ES18209590033460822675,TRX_N-00499-82470980,2023-03-03T13:26:43,Labastida,expenses,food,-123.35,-17060.65
buyer_8,Antonio,45,ES18209590033460822675,TRX_N-00500-42218962,2023-03-03T20:18:38,Labastida,expenses,repairs,-270.83,-17331.48
buyer_8,Antonio,45,ES18209590033460822675,TRX_N-00501-95628274,2023-03-04T13:53:54,Labastida,expenses,mortgage,-956.34,-18287.82
buyer_8,Antonio,45,ES18209590033460822675,TRX_N-00502-04161726,2023-03-04T09:37:44,Eibar,expenses,healthcare,-55.51,-18343.33
buyer_8,Antonio,45,ES18209590033460822675,TRX_N-00503-54586843,2023-03-06T23:38:49,Labastida,expenses,gas,-70.98,-18414.31
buyer_8,Antonio,45,ES18209590033460822675,TRX_N-00504-97821165,2023-03-06T18:51:31,Labastida,expenses,internet,-42.0,-18456.31
buyer_8,Antonio,45,ES18209590033460822675,TRX_N-00505-80390314,2023-03-07T13:42:08,Labastida,expenses,food,-118.55,-18574.86
buyer_8,Antonio,45,ES18209590033460822675,TRX_N-00506-55642651,2023-03-08T23:20:34,Labastida,expenses,water,-25.37,-18600.23
buyer_8,Antonio,45,ES18209590033460822675,TRX_N-00507-05525982,2023-03-08T11:24:51,Labastida,expenses,phone,-41.68,-18641.91
buyer_8,Antonio,45,ES18209590033460822675,TRX_N-00508-54415857,2023-03-08T19:20:11,Labastida,expenses,electricity,-74.71,-18716.62
buyer_8,Antonio,45,ES18209590033460822675,TRX_N-00509-14571334,2023-03-09T17:15:00,Labastida,expenses,clothing,-108.37,-18824.99
buyer_8,Antonio,45,ES18209590033460822675,TRX_N-00510-53689788,2023-03-09T18:20:54,Labastida,expenses,gifts,-600.92,-19425.91
buyer_8,Antonio,45,ES18209590033460822675,TRX_N-00511-34842175,2023-03-10T03:06:33,Labastida,expenses,cash,-100.0,-19525.91
buyer_8,Antonio,45,ES18209590033460822675,TRX_N-00512-82343188,2023-03-13T16:14:30,Labastida,expenses,food,-105.58,-19631.49
buyer_8,Antonio,45,ES18209590033460822675,TRX_N-00513-06824843,2023-03-13T21:37:08,Labastida,expenses,cash,-100.0,-19731.49
buyer_8,Antonio,45,ES18209590033460822675,TRX_N-00514-78927944,2023-03-14T17:45:30,Labastida,expenses,education,-49.84,-19781.33
buyer_8,Antonio,45,ES18209590033460822675,TRX_N-00515-07965453,2023-03-14T06:09:00,Zuia,expenses,cash,-100.0,-19881.33
buyer_8,Antonio,45,ES18209590033460822675,TRX_N-00516-51806079,2023-03-15T16:26:21,Mungia,expenses,food,-87.42,-19968.75
buyer_8,Antonio,45,ES18209590033460822675,TRX_N-00517-53287298,2023-03-15T08:19:51,Labastida,expenses,transport,-60.98,-20029.73
buyer_8,Antonio,45,ES18209590033460822675,TRX_N-00518-74763529,2023-03-15T14:40:15,Labastida,expenses,clothing,-60.56,-20090.29
buyer_8,Antonio,45,ES18209590033460822675,TRX_N-00519-71212889,2023-03-16T08:24:49,Labastida,expenses,food,-103.02,-20193.31
buyer_8,Antonio,45,ES18209590033460822675,TRX_N-00520-07399177,2023-03-17T13:56:06,Labastida,expenses,leisure,-21.28,-20214.59
buyer_8,Antonio,45,ES18209590033460822675,TRX_N-00521-20112688,2023-03-20T17:36:13,Labastida,expenses,food,-73.36,-20287.95
buyer_8,Antonio,45,ES18209590033460822675,TRX_N-00522-89084377,2023-03-20T22:41:52,Labastida,expenses,children,-166.17,-20454.12
buyer_8,Antonio,45,ES18209590033460822675,TRX_N-00523-62907007,2023-03-22T08:48:36,Labastida,expenses,leisure,-46.09,-20500.21
buyer_8,Antonio,45,ES18209590033460822675,TRX_N-00524-46600813,2023-03-23T09:13:54,Labastida,expenses,food,-64.84,-20565.05
buyer_8,Antonio,45,ES18209590033460822675,TRX_N-00525-38904002,2023-03-23T23:37:58,Labastida,expenses,repairs,-228.95,-20794.0
buyer_8,Antonio,45,ES18209590033460822675,TRX_N-00526-54817693,2023-03-24T17:04:31,Labastida,expenses,leisure,-57.98,-20851.98
buyer_8,Antonio,45,ES18209590033460822675,TRX_N-00527-14633243,2023-03-26T14:14:19,Llodio,expenses,repairs,-295.21,-21147.19
buyer_8,Antonio,45,ES18209590033460822675,TRX_N-00528-77441214,2023-03-28T09:41:16,Galdakao,expenses,education,-43.74,-21190.93
buyer_8,Antonio,45,ES18209590033460822675,TRX_N-00529-97372522,2023-03-28T19:21:42,Labastida,expenses,gifts,-671.35,-21862.28
buyer_8,Antonio,45,ES18209590033460822675,TRX_N-00530-13714039,2023-03-29T14:51:45,Labastida,expenses,cash,-100.0,-21962.28
buyer_8,Antonio,45,ES18209590033460822675,TRX_N-00531-69430598,2023-03-30T13:06:50,Labastida,expenses,cash,-100.0,-22062.28
buyer_8,Antonio,45,ES18209590033460822675,TRX_N-00532-50878773,2023-03-31T17:19:46,Labastida,expenses,education,-64.15,-22126.43
buyer_8,Antonio,45,ES18209590033460822675,TRX_N-00533-08710595,2023-03-31T09:28:56,Labastida,expenses,appliances,-279.27,-22405.7
buyer_8,Antonio,45,ES18209590033460822675,TRX_N-00534-60822021,2023-04-01T10:48:17,Labastida,incomes,salary,1495.59,-20910.11
buyer_8,Antonio,45,ES18209590033460822675,TRX_N-00535-25008440,2023-04-01T10:48:17,Labastida,incomes,salary_partner,1423.63,-19486.48
buyer_8,Antonio,45,ES18209590033460822675,TRX_N-00536-29353360,2023-04-02T16:17:16,Bermeo,expenses,leisure,-80.91,-19567.39
buyer_8,Antonio,45,ES18209590033460822675,TRX_N-00537-34014100,2023-04-03T08:19:25,Irun,expenses,leisure,-31.2,-19598.59
buyer_8,Antonio,45,ES18209590033460822675,TRX_N-00538-58272287,2023-04-04T06:53:20,Labastida,expenses,mortgage,-956.34,-20554.93
buyer_8,Antonio,45,ES18209590033460822675,TRX_N-00539-05745672,2023-04-04T15:26:05,Bilbao,expenses,repairs,-249.92,-20804.85
buyer_8,Antonio,45,ES18209590033460822675,TRX_N-00540-80106685,2023-04-05T18:35:46,Labastida,expenses,gas,-65.87,-20870.72
buyer_8,Antonio,45,ES18209590033460822675,TRX_N-00541-14010243,2023-04-05T01:46:03,Labastida,expenses,gifts,-389.81,-21260.53
buyer_8,Antonio,45,ES18209590033460822675,TRX_N-00542-59346269,2023-04-06T12:38:16,Labastida,expenses,water,-32.16,-21292.69
buyer_8,Antonio,45,ES18209590033460822675,TRX_N-00543-34948671,2023-04-06T10:08:27,Labastida,expenses,internet,-42.0,-21334.69
buyer_8,Antonio,45,ES18209590033460822675,TRX_N-00544-83979585,2023-04-06T18:34:51,Zuia,expenses,travel,-1400.49,-22735.18
buyer_8,Antonio,45,ES18209590033460822675,TRX_N-00545-68801887,2023-04-06T15:49:41,Labastida,expenses,children,-113.74,-22848.92
buyer_8,Antonio,45,ES18209590033460822675,TRX_N-00546-41875369,2023-04-08T14:51:34,Labastida,expenses,electricity,-69.07,-22917.99
buyer_8,Antonio,45,ES18209590033460822675,TRX_N-00547-46914907,2023-04-08T13:22:54,Labastida,expenses,phone,-34.54,-22952.53
buyer_8,Antonio,45,ES18209590033460822675,TRX_N-00548-74384850,2023-04-09T09:31:44,Alegría-Dulantzi,expenses,cash,-100.0,-23052.53
buyer_8,Antonio,45,ES18209590033460822675,TRX_N-00549-65167942,2023-04-10T10:36:09,Labastida,expenses,education,-46.0,-23098.53
buyer_8,Antonio,45,ES18209590033460822675,TRX_N-00550-54734850,2023-04-11T20:25:50,Labastida,expenses,transport,-82.09,-23180.62
buyer_8,Antonio,45,ES18209590033460822675,TRX_N-00551-21915241,2023-04-11T13:09:03,Labastida,expenses,leisure,-51.61,-23232.23
buyer_8,Antonio,45,ES18209590033460822675,TRX_N-00552-22881691,2023-04-13T14:40:32,Labastida,expenses,food,-99.64,-23331.87
buyer_8,Antonio,45,ES18209590033460822675,TRX_N-00553-71605268,2023-04-13T20:49:03,Labastida,expenses,repairs,-115.85,-23447.72
buyer_8,Antonio,45,ES18209590033460822675,TRX_N-00554-61728782,2023-04-15T16:27:58,Labastida,expenses,cash,-100.0,-23547.72
buyer_8,Antonio,45,ES18209590033460822675,TRX_N-00555-92890163,2023-04-15T14:27:21,Labastida,expenses,children,-254.19,-23801.91
buyer_8,Antonio,45,ES18209590033460822675,TRX_N-00556-40390486,2023-04-16T17:12:45,Donostia,expenses,food,-80.46,-23882.37
buyer_8,Antonio,45,ES18209590033460822675,TRX_N-00557-20657718,2023-04-16T14:07:24,Labastida,expenses,leisure,-29.62,-23911.99
buyer_8,Antonio,45,ES18209590033460822675,TRX_N-00558-78904247,2023-04-17T19:37:39,Labastida,expenses,food,-91.65,-24003.64
buyer_8,Antonio,45,ES18209590033460822675,TRX_N-00559-48514344,2023-04-18T16:31:47,Labastida,expenses,food,-64.08,-24067.72
buyer_8,Antonio,45,ES18209590033460822675,TRX_N-00560-61583295,2023-04-18T09:30:57,Labastida,expenses,children,-268.7,-24336.42
buyer_8,Antonio,45,ES18209590033460822675,TRX_N-00561-12499707,2023-04-20T11:52:54,Labastida,expenses,cash,-100.0,-24436.42
buyer_8,Antonio,45,ES18209590033460822675,TRX_N-00562-19339043,2023-04-22T20:08:55,Labastida,expenses,leisure,-45.37,-24481.79
buyer_8,Antonio,45,ES18209590033460822675,TRX_N-00563-45126478,2023-04-22T16:33:32,Labastida,expenses,cash,-100.0,-24581.79
buyer_8,Antonio,45,ES18209590033460822675,TRX_N-00564-01115754,2023-04-23T16:35:54,Labastida,expenses,leisure,-24.85,-24606.64
buyer_8,Antonio,45,ES18209590033460822675,TRX_N-00565-96872043,2023-04-24T07:13:43,Labastida,expenses,food,-86.27,-24692.91
buyer_8,Antonio,45,ES18209590033460822675,TRX_N-00566-32707971,2023-04-24T11:00:25,Labastida,expenses,gifts,-462.03,-25154.94
buyer_8,Antonio,45,ES18209590033460822675,TRX_N-00567-48832250,2023-04-25T07:34:04,Labastida,expenses,food,-84.1,-25239.04
buyer_8,Antonio,45,ES18209590033460822675,TRX_N-00568-72933828,2023-04-28T12:12:29,Labastida,expenses,healthcare,-146.9,-25385.94
buyer_8,Antonio,45,ES18209590033460822675,TRX_N-00569-34158776,2023-04-29T20:10:09,Labastida,expenses,cash,-100.0,-25485.94
buyer_8,Antonio,45,ES18209590033460822675,TRX_N-00570-51793172,2023-04-30T21:01:24,Labastida,expenses,leisure,-35.7,-25521.64
buyer_8,Antonio,45,ES18209590033460822675,TRX_N-00571-28165816,2023-04-30T09:45:15,Labastida,expenses,repairs,-220.06,-25741.7
buyer_8,Antonio,45,ES18209590033460822675,TRX_N-00572-95252305,2023-05-01T12:53:55,Labastida,incomes,salary,1495.59,-24246.11
buyer_8,Antonio,45,ES18209590033460822675,TRX_N-00573-09347251,2023-05-01T12:53:55,Labastida,incomes,salary_partner,1423.63,-22822.48
buyer_8,Antonio,45,ES18209590033460822675,TRX_N-00574-41059908,2023-05-01T12:53:55,Labastida,incomes,extra_income,185.49,-22636.99
buyer_8,Antonio,45,ES18209590033460822675,TRX_N-00575-75486613,2023-05-01T13:47:20,Labastida,expenses,education,-60.45,-22697.44
buyer_8,Antonio,45,ES18209590033460822675,TRX_N-00576-75384514,2023-05-02T08:18:30,Leioa,expenses,education,-57.19,-22754.63
buyer_8,Antonio,45,ES18209590033460822675,TRX_N-00577-34247645,2023-05-04T13:38:42,Labastida,expenses,mortgage,-956.34,-23710.97
buyer_8,Antonio,45,ES18209590033460822675,TRX_N-00578-36510030,2023-05-04T16:02:39,Labastida,expenses,food,-73.0,-23783.97
buyer_8,Antonio,45,ES18209590033460822675,TRX_N-00579-28268416,2023-05-05T16:53:03,Labastida,expenses,electricity,-37.61,-23821.58
buyer_8,Antonio,45,ES18209590033460822675,TRX_N-00580-59385914,2023-05-05T19:04:02,Galdakao,expenses,leisure,-20.16,-23841.74
buyer_8,Antonio,45,ES18209590033460822675,TRX_N-00581-93024951,2023-05-05T13:33:28,Labastida,expenses,education,-47.38,-23889.12
buyer_8,Antonio,45,ES18209590033460822675,TRX_N-00582-34405739,2023-05-05T22:35:14,Labastida,expenses,cash,-100.0,-23989.12
buyer_8,Antonio,45,ES18209590033460822675,TRX_N-00583-53018441,2023-05-07T22:02:17,Labastida,expenses,water,-23.5,-24012.62
buyer_8,Antonio,45,ES18209590033460822675,TRX_N-00584-21309781,2023-05-07T20:55:07,Labastida,expenses,internet,-42.0,-24054.62
buyer_8,Antonio,45,ES18209590033460822675,TRX_N-00585-40940295,2023-05-07T11:23:42,Labastida,expenses,healthcare,-118.4,-24173.02
buyer_8,Antonio,45,ES18209590033460822675,TRX_N-00586-73955170,2023-05-08T11:27:57,Labastida,expenses,phone,-40.17,-24213.19
buyer_8,Antonio,45,ES18209590033460822675,TRX_N-00587-99094903,2023-05-08T18:54:31,Labastida,expenses,gas,-88.39,-24301.58
buyer_8,Antonio,45,ES18209590033460822675,TRX_N-00588-57226394,2023-05-08T11:56:59,Labastida,expenses,cash,-100.0,-24401.58
buyer_8,Antonio,45,ES18209590033460822675,TRX_N-00589-53979068,2023-05-10T12:50:08,Labastida,expenses,gifts,-693.42,-25095.0
buyer_8,Antonio,45,ES18209590033460822675,TRX_N-00590-77021502,2023-05-11T14:45:05,Getxo,expenses,leisure,-59.48,-25154.48
buyer_8,Antonio,45,ES18209590033460822675,TRX_N-00591-04599483,2023-05-13T14:00:07,Arrasate,expenses,food,-104.99,-25259.47
buyer_8,Antonio,45,ES18209590033460822675,TRX_N-00592-29419449,2023-05-13T00:56:45,Labastida,expenses,education,-43.12,-25302.59
buyer_8,Antonio,45,ES18209590033460822675,TRX_N-00593-60047685,2023-05-14T16:01:27,Labastida,expenses,education,-66.78,-25369.37
buyer_8,Antonio,45,ES18209590033460822675,TRX_N-00594-38103517,2023-05-14T11:37:05,Labastida,expenses,gifts,-584.64,-25954.01
buyer_8,Antonio,45,ES18209590033460822675,TRX_N-00595-59003992,2023-05-15T08:15:52,Labastida,expenses,leisure,-24.67,-25978.68
buyer_8,Antonio,45,ES18209590033460822675,TRX_N-00596-00712208,2023-05-17T13:51:16,Labastida,expenses,healthcare,-147.67,-26126.35
buyer_8,Antonio,45,ES18209590033460822675,TRX_N-00597-87529335,2023-05-20T05:11:46,Labastida,expenses,cash,-100.0,-26226.35
buyer_8,Antonio,45,ES18209590033460822675,TRX_N-00598-63545407,2023-05-21T16:55:19,Irun,expenses,cash,-100.0,-26326.35
buyer_8,Antonio,45,ES18209590033460822675,TRX_N-00599-95509622,2023-05-24T11:44:03,Labastida,expenses,leisure,-44.96,-26371.31
buyer_8,Antonio,45,ES18209590033460822675,TRX_N-00600-66306437,2023-05-25T17:30:50,Labastida,expenses,transport,-63.71,-26435.02
buyer_8,Antonio,45,ES18209590033460822675,TRX_N-00601-03487366,2023-05-26T18:36:00,Labastida,expenses,food,-124.48,-26559.5
buyer_8,Antonio,45,ES18209590033460822675,TRX_N-00602-44532911,2023-05-29T20:13:23,Berango,expenses,leisure,-35.09,-26594.59
buyer_8,Antonio,45,ES18209590033460822675,TRX_N-00603-56862773,2023-05-30T13:27:43,Labastida,expenses,food,-93.88,-26688.47
buyer_8,Antonio,45,ES18209590033460822675,TRX_N-00604-93400680,2023-05-30T16:18:11,Labastida,expenses,cash,-100.0,-26788.47
buyer_8,Antonio,45,ES18209590033460822675,TRX_N-00605-07751416,2023-05-31T19:03:42,Labastida,expenses,transport,-45.59,-26834.06
buyer_8,Antonio,45,ES18209590033460822675,TRX_N-00606-19502385,2023-06-01T01:31:54,Labastida,incomes,salary,1495.59,-25338.47
buyer_8,Antonio,45,ES18209590033460822675,TRX_N-00607-43263771,2023-06-01T01:31:54,Labastida,incomes,salary_partner,1423.63,-23914.84
buyer_8,Antonio,45,ES18209590033460822675,TRX_N-00608-93738166,2023-06-01T01:31:54,Labastida,incomes,salary_bonus,1115.16,-22799.68
buyer_8,Antonio,45,ES18209590033460822675,TRX_N-00609-95245768,2023-06-01T01:31:54,Labastida,incomes,salary_partner_bonus,1013.59,-21786.09
buyer_8,Antonio,45,ES18209590033460822675,TRX_N-00610-57408315,2023-06-01T10:54:32,Labastida,expenses,repairs,-241.83,-22027.92
buyer_8,Antonio,45,ES18209590033460822675,TRX_N-00611-74407257,2023-06-02T15:20:57,Elciego,expenses,clothing,-85.78,-22113.7
buyer_8,Antonio,45,ES18209590033460822675,TRX_N-00612-67113202,2023-06-04T08:54:27,Labastida,expenses,mortgage,-956.34,-23070.04
buyer_8,Antonio,45,ES18209590033460822675,TRX_N-00613-27308677,2023-06-04T08:25:42,Hondarribia,expenses,food,-119.65,-23189.69
buyer_8,Antonio,45,ES18209590033460822675,TRX_N-00614-19099849,2023-06-04T20:41:13,Labastida,expenses,repairs,-250.48,-23440.17
buyer_8,Antonio,45,ES18209590033460822675,TRX_N-00615-93976543,2023-06-05T16:04:36,Labastida,expenses,internet,-42.0,-23482.17
buyer_8,Antonio,45,ES18209590033460822675,TRX_N-00616-98859283,2023-06-05T03:16:49,Labastida,expenses,leisure,-67.11,-23549.28
buyer_8,Antonio,45,ES18209590033460822675,TRX_N-00617-55729064,2023-06-05T12:48:00,Labastida,expenses,children,-187.56,-23736.84
buyer_8,Antonio,45,ES18209590033460822675,TRX_N-00618-17255318,2023-06-06T12:28:29,Labastida,expenses,water,-22.11,-23758.95
buyer_8,Antonio,45,ES18209590033460822675,TRX_N-00619-69843238,2023-06-06T12:59:50,Labastida,expenses,gas,-107.2,-23866.15
buyer_8,Antonio,45,ES18209590033460822675,TRX_N-00620-20409918,2023-06-06T20:06:18,Labastida,expenses,phone,-42.52,-23908.67
buyer_8,Antonio,45,ES18209590033460822675,TRX_N-00621-26004868,2023-06-06T15:34:56,Labastida,expenses,clothing,-106.16,-24014.83
buyer_8,Antonio,45,ES18209590033460822675,TRX_N-00622-40082771,2023-06-06T18:46:20,Labastida,expenses,cash,-100.0,-24114.83
buyer_8,Antonio,45,ES18209590033460822675,TRX_N-00623-69465658,2023-06-08T08:50:13,Labastida,expenses,electricity,-55.73,-24170.56
buyer_8,Antonio,45,ES18209590033460822675,TRX_N-00624-02414160,2023-06-09T15:04:48,Labastida,expenses,appliances,-91.79,-24262.35
buyer_8,Antonio,45,ES18209590033460822675,TRX_N-00625-78364388,2023-06-12T13:06:36,Labastida,expenses,transport,-48.44,-24310.79
buyer_8,Antonio,45,ES18209590033460822675,TRX_N-00626-95826066,2023-06-12T09:20:40,Labastida,expenses,appliances,-359.37,-24670.16
buyer_8,Antonio,45,ES18209590033460822675,TRX_N-00627-69641975,2023-06-12T08:20:17,Labastida,expenses,gifts,-689.35,-25359.51
buyer_8,Antonio,45,ES18209590033460822675,TRX_N-00628-73006285,2023-06-13T20:53:57,Labastida,expenses,transport,-77.03,-25436.54
buyer_8,Antonio,45,ES18209590033460822675,TRX_N-00629-73854935,2023-06-14T08:10:16,Labastida,expenses,cash,-100.0,-25536.54
buyer_8,Antonio,45,ES18209590033460822675,TRX_N-00630-55516700,2023-06-17T09:11:48,Labastida,expenses,food,-87.91,-25624.45
buyer_8,Antonio,45,ES18209590033460822675,TRX_N-00631-67502734,2023-06-17T09:39:03,Labastida,expenses,leisure,-60.93,-25685.38
buyer_8,Antonio,45,ES18209590033460822675,TRX_N-00632-61322722,2023-06-17T11:26:38,Labastida,expenses,cash,-100.0,-25785.38
buyer_8,Antonio,45,ES18209590033460822675,TRX_N-00633-33269181,2023-06-18T16:44:14,Labastida,expenses,leisure,-69.07,-25854.45
buyer_8,Antonio,45,ES18209590033460822675,TRX_N-00634-58429804,2023-06-19T17:15:40,Labastida,expenses,cash,-100.0,-25954.45
buyer_8,Antonio,45,ES18209590033460822675,TRX_N-00635-31020291,2023-06-20T18:00:55,Labastida,expenses,leisure,-33.13,-25987.58
buyer_8,Antonio,45,ES18209590033460822675,TRX_N-00636-11781875,2023-06-20T04:06:22,Labastida,expenses,cash,-100.0,-26087.58
buyer_8,Antonio,45,ES18209590033460822675,TRX_N-00637-54246865,2023-06-20T19:55:28,Labastida,expenses,repairs,-89.83,-26177.41
buyer_8,Antonio,45,ES18209590033460822675,TRX_N-00638-91335376,2023-06-21T14:07:15,Galdakao,expenses,leisure,-27.97,-26205.38
buyer_8,Antonio,45,ES18209590033460822675,TRX_N-00639-93897180,2023-06-21T18:51:34,Labastida,expenses,gifts,-660.97,-26866.35
buyer_8,Antonio,45,ES18209590033460822675,TRX_N-00640-44001203,2023-06-22T15:21:42,Galdakao,expenses,cash,-100.0,-26966.35
buyer_8,Antonio,45,ES18209590033460822675,TRX_N-00641-51012857,2023-06-24T09:15:20,Durango,expenses,food,-103.87,-27070.22
buyer_8,Antonio,45,ES18209590033460822675,TRX_N-00642-02955005,2023-06-25T09:21:41,Labastida,expenses,leisure,-55.73,-27125.95
buyer_8,Antonio,45,ES18209590033460822675,TRX_N-00643-20773879,2023-06-25T18:52:22,Labastida,expenses,cash,-100.0,-27225.95
buyer_8,Antonio,45,ES18209590033460822675,TRX_N-00644-09517814,2023-06-25T13:38:30,Labastida,expenses,repairs,-148.84,-27374.79
buyer_8,Antonio,45,ES18209590033460822675,TRX_N-00645-68133872,2023-06-26T04:44:51,Mungia,expenses,transport,-74.25,-27449.04
buyer_8,Antonio,45,ES18209590033460822675,TRX_N-00646-83465101,2023-06-26T14:36:17,Labastida,expenses,clothing,-70.26,-27519.3
buyer_8,Antonio,45,ES18209590033460822675,TRX_N-00647-28389820,2023-06-27T13:57:32,Labastida,expenses,repairs,-49.58,-27568.88
buyer_8,Antonio,45,ES18209590033460822675,TRX_N-00648-52678091,2023-06-29T11:15:10,Labastida,expenses,food,-103.48,-27672.36
buyer_8,Antonio,45,ES18209590033460822675,TRX_N-00649-93216354,2023-06-29T13:39:26,Oyón-Oion,expenses,leisure,-65.47,-27737.83
buyer_8,Antonio,45,ES18209590033460822675,TRX_N-00650-03725544,2023-07-01T16:44:11,Labastida,incomes,salary,1495.59,-26242.24
buyer_8,Antonio,45,ES18209590033460822675,TRX_N-00651-56841510,2023-07-01T16:44:11,Labastida,incomes,salary_partner,1423.63,-24818.61
buyer_8,Antonio,45,ES18209590033460822675,TRX_N-00652-96767161,2023-07-01T11:50:16,Labastida,expenses,transport,-64.6,-24883.21
buyer_8,Antonio,45,ES18209590033460822675,TRX_N-00653-36232206,2023-07-01T11:08:24,Labastida,expenses,cash,-100.0,-24983.21
buyer_8,Antonio,45,ES18209590033460822675,TRX_N-00654-12704326,2023-07-01T08:34:48,Labastida,expenses,repairs,-150.32,-25133.53
buyer_8,Antonio,45,ES18209590033460822675,TRX_N-00655-93837516,2023-07-02T10:06:39,Labastida,expenses,leisure,-24.76,-25158.29
buyer_8,Antonio,45,ES18209590033460822675,TRX_N-00656-90467852,2023-07-02T16:54:16,Zarautz,expenses,cash,-100.0,-25258.29
buyer_8,Antonio,45,ES18209590033460822675,TRX_N-00657-18042480,2023-07-02T14:57:10,Errenteria,expenses,appliances,-338.65,-25596.94
buyer_8,Antonio,45,ES18209590033460822675,TRX_N-00658-77500096,2023-07-03T18:51:07,Labastida,expenses,food,-119.43,-25716.37
buyer_8,Antonio,45,ES18209590033460822675,TRX_N-00659-98798059,2023-07-03T11:17:16,Labastida,expenses,cash,-100.0,-25816.37
buyer_8,Antonio,45,ES18209590033460822675,TRX_N-00660-00520486,2023-07-04T09:08:48,Labastida,expenses,mortgage,-956.34,-26772.71
buyer_8,Antonio,45,ES18209590033460822675,TRX_N-00661-57346649,2023-07-04T17:55:39,Arrasate,expenses,appliances,-330.02,-27102.73
buyer_8,Antonio,45,ES18209590033460822675,TRX_N-00662-65110994,2023-07-05T17:24:15,Labastida,expenses,water,-33.24,-27135.97
buyer_8,Antonio,45,ES18209590033460822675,TRX_N-00663-92149172,2023-07-05T19:30:19,Labastida,expenses,electricity,-23.28,-27159.25
buyer_8,Antonio,45,ES18209590033460822675,TRX_N-00664-49178040,2023-07-05T20:53:20,Labastida,expenses,gas,-100.0,-27259.25
buyer_8,Antonio,45,ES18209590033460822675,TRX_N-00665-63388944,2023-07-06T19:18:45,Labastida,expenses,internet,-42.0,-27301.25
buyer_8,Antonio,45,ES18209590033460822675,TRX_N-00666-68217836,2023-07-06T17:44:51,Durango,expenses,food,-94.24,-27395.49
buyer_8,Antonio,45,ES18209590033460822675,TRX_N-00667-91413370,2023-07-06T12:36:10,Labastida,expenses,repairs,-67.74,-27463.23
buyer_8,Antonio,45,ES18209590033460822675,TRX_N-00668-79400972,2023-07-07T21:40:17,Labastida,expenses,appliances,-127.09,-27590.32
buyer_8,Antonio,45,ES18209590033460822675,TRX_N-00669-45491091,2023-07-07T18:07:18,Labastida,expenses,gifts,-223.92,-27814.24
buyer_8,Antonio,45,ES18209590033460822675,TRX_N-00670-07651564,2023-07-08T09:13:50,Labastida,expenses,phone,-38.57,-27852.81
buyer_8,Antonio,45,ES18209590033460822675,TRX_N-00671-69856338,2023-07-08T04:55:49,Arrasate,expenses,food,-63.47,-27916.28
buyer_8,Antonio,45,ES18209590033460822675,TRX_N-00672-81081320,2023-07-08T14:56:06,Labastida,expenses,transport,-56.96,-27973.24
buyer_8,Antonio,45,ES18209590033460822675,TRX_N-00673-15548782,2023-07-08T08:51:31,Labastida,expenses,leisure,-51.07,-28024.31
buyer_8,Antonio,45,ES18209590033460822675,TRX_N-00674-05174182,2023-07-09T19:51:42,Labastida,expenses,leisure,-22.36,-28046.67
buyer_8,Antonio,45,ES18209590033460822675,TRX_N-00675-89023095,2023-07-11T12:44:08,Labastida,expenses,cash,-100.0,-28146.67
buyer_8,Antonio,45,ES18209590033460822675,TRX_N-00676-54994693,2023-07-12T08:50:00,Arrasate,expenses,cash,-100.0,-28246.67
buyer_8,Antonio,45,ES18209590033460822675,TRX_N-00677-42182629,2023-07-13T16:29:09,Labastida,expenses,leisure,-33.56,-28280.23
buyer_8,Antonio,45,ES18209590033460822675,TRX_N-00678-62169111,2023-07-15T06:18:13,Labastida,expenses,food,-120.3,-28400.53
buyer_8,Antonio,45,ES18209590033460822675,TRX_N-00679-64934829,2023-07-16T20:27:58,Labastida,expenses,leisure,-81.1,-28481.63
buyer_8,Antonio,45,ES18209590033460822675,TRX_N-00680-80349721,2023-07-16T08:38:01,Labastida,expenses,healthcare,-50.11,-28531.74
buyer_8,Antonio,45,ES18209590033460822675,TRX_N-00681-94301251,2023-07-17T05:18:07,Labastida,expenses,cash,-100.0,-28631.74
buyer_8,Antonio,45,ES18209590033460822675,TRX_N-00682-98127163,2023-07-19T21:34:07,Sestao,expenses,transport,-49.76,-28681.5
buyer_8,Antonio,45,ES18209590033460822675,TRX_N-00683-57310254,2023-07-20T20:52:56,Bilbao,expenses,food,-123.57,-28805.07
buyer_8,Antonio,45,ES18209590033460822675,TRX_N-00684-33519092,2023-07-21T11:37:15,Labastida,expenses,cash,-100.0,-28905.07
buyer_8,Antonio,45,ES18209590033460822675,TRX_N-00685-64704883,2023-07-23T08:51:27,Galdakao,expenses,food,-74.1,-28979.17
buyer_8,Antonio,45,ES18209590033460822675,TRX_N-00686-10733578,2023-07-23T12:16:43,Labastida,expenses,transport,-42.68,-29021.85
buyer_8,Antonio,45,ES18209590033460822675,TRX_N-00687-81770965,2023-07-23T09:30:59,Labastida,expenses,cash,-100.0,-29121.85
buyer_8,Antonio,45,ES18209590033460822675,TRX_N-00688-63648695,2023-07-25T10:25:42,Labastida,expenses,gifts,-512.38,-29634.23
buyer_8,Antonio,45,ES18209590033460822675,TRX_N-00689-65743342,2023-07-26T14:56:23,Labastida,expenses,food,-68.87,-29703.1
buyer_8,Antonio,45,ES18209590033460822675,TRX_N-00690-86934460,2023-07-28T14:49:16,Getxo,expenses,healthcare,-53.66,-29756.76
buyer_8,Antonio,45,ES18209590033460822675,TRX_N-00691-78975822,2023-07-28T13:11:07,Labastida,expenses,cash,-100.0,-29856.76
buyer_8,Antonio,45,ES18209590033460822675,TRX_N-00692-30119892,2023-08-01T13:59:12,Labastida,incomes,salary,1495.59,-28361.17
buyer_8,Antonio,45,ES18209590033460822675,TRX_N-00693-01389832,2023-08-01T13:59:12,Labastida,incomes,salary_partner,1423.63,-26937.54
buyer_8,Antonio,45,ES18209590033460822675,TRX_N-00694-70856827,2023-08-01T15:42:26,Labastida,expenses,gifts,-161.31,-27098.85
buyer_8,Antonio,45,ES18209590033460822675,TRX_N-00695-05736379,2023-08-03T09:04:57,Pasaia,expenses,cash,-100.0,-27198.85
buyer_8,Antonio,45,ES18209590033460822675,TRX_N-00696-49248400,2023-08-04T13:48:48,Labastida,expenses,mortgage,-956.34,-28155.19
buyer_8,Antonio,45,ES18209590033460822675,TRX_N-00697-23908113,2023-08-04T13:09:46,Labastida,expenses,transport,-83.18,-28238.37
buyer_8,Antonio,45,ES18209590033460822675,TRX_N-00698-67700481,2023-08-04T17:49:27,Labastida,expenses,travel,-637.99,-28876.36
buyer_8,Antonio,45,ES18209590033460822675,TRX_N-00699-56718962,2023-08-05T14:19:27,Labastida,expenses,gas,-46.74,-28923.1
buyer_8,Antonio,45,ES18209590033460822675,TRX_N-00700-13790087,2023-08-07T18:51:26,Labastida,expenses,water,-32.13,-28955.23
buyer_8,Antonio,45,ES18209590033460822675,TRX_N-00701-07505361,2023-08-07T11:47:41,Labastida,expenses,internet,-42.0,-28997.23
buyer_8,Antonio,45,ES18209590033460822675,TRX_N-00702-45232907,2023-08-07T18:17:15,Labastida,expenses,cash,-100.0,-29097.23
buyer_8,Antonio,45,ES18209590033460822675,TRX_N-00703-69017748,2023-08-08T18:43:47,Labastida,expenses,phone,-30.45,-29127.68
buyer_8,Antonio,45,ES18209590033460822675,TRX_N-00704-77684802,2023-08-08T13:51:59,Labastida,expenses,electricity,-71.79,-29199.47
buyer_8,Antonio,45,ES18209590033460822675,TRX_N-00705-83101683,2023-08-12T19:16:46,Labastida,expenses,leisure,-43.75,-29243.22
buyer_8,Antonio,45,ES18209590033460822675,TRX_N-00706-74385530,2023-08-14T11:24:01,Labastida,expenses,transport,-56.44,-29299.66
buyer_8,Antonio,45,ES18209590033460822675,TRX_N-00707-66658110,2023-08-15T14:11:21,Lasarte-Oria,expenses,healthcare,-83.96,-29383.62
buyer_8,Antonio,45,ES18209590033460822675,TRX_N-00708-55748974,2023-08-17T11:56:28,Labastida,expenses,food,-94.47,-29478.09
buyer_8,Antonio,45,ES18209590033460822675,TRX_N-00709-90124597,2023-08-21T16:22:25,Labastida,expenses,cash,-100.0,-29578.09
buyer_8,Antonio,45,ES18209590033460822675,TRX_N-00710-31555121,2023-08-22T12:12:09,Sopela,expenses,clothing,-128.11,-29706.2
buyer_8,Antonio,45,ES18209590033460822675,TRX_N-00711-08316872,2023-08-23T22:29:05,Labastida,expenses,cash,-100.0,-29806.2
buyer_8,Antonio,45,ES18209590033460822675,TRX_N-00712-09128284,2023-08-24T14:42:28,Labastida,expenses,food,-96.15,-29902.35
buyer_8,Antonio,45,ES18209590033460822675,TRX_N-00713-68630701,2023-08-25T09:44:34,Labastida,expenses,food,-70.73,-29973.08
buyer_8,Antonio,45,ES18209590033460822675,TRX_N-00714-84690579,2023-08-26T23:58:24,Labastida,expenses,food,-76.34,-30049.42
buyer_8,Antonio,45,ES18209590033460822675,TRX_N-00715-52194251,2023-08-26T19:56:21,Labastida,expenses,cash,-100.0,-30149.42
buyer_8,Antonio,45,ES18209590033460822675,TRX_N-00716-25618915,2023-08-29T16:02:27,Labastida,expenses,food,-74.58,-30224.0
buyer_8,Antonio,45,ES18209590033460822675,TRX_N-00717-92017546,2023-08-29T16:42:09,Labastida,expenses,children,-195.86,-30419.86
buyer_8,Antonio,45,ES18209590033460822675,TRX_N-00718-13867334,2023-08-30T17:14:20,Labastida,expenses,education,-72.87,-30492.73
buyer_8,Antonio,45,ES18209590033460822675,TRX_N-00719-45357997,2023-08-30T15:37:04,Labastida,expenses,cash,-100.0,-30592.73
buyer_8,Antonio,45,ES18209590033460822675,TRX_N-00720-28924233,2023-08-31T03:41:28,Labastida,expenses,appliances,-321.34,-30914.07
buyer_8,Antonio,45,ES18209590033460822675,TRX_N-00721-04458402,2023-08-31T19:21:13,Sestao,expenses,repairs,-197.52,-31111.59
buyer_8,Antonio,45,ES18209590033460822675,TRX_N-00722-29282875,2023-08-31T21:30:44,Labastida,expenses,gifts,-611.46,-31723.05
buyer_8,Antonio,45,ES18209590033460822675,TRX_N-00723-16255714,2023-09-01T19:02:32,Labastida,incomes,salary,1495.59,-30227.46
buyer_8,Antonio,45,ES18209590033460822675,TRX_N-00724-61625335,2023-09-01T19:02:32,Labastida,incomes,salary_partner,1423.63,-28803.83
buyer_8,Antonio,45,ES18209590033460822675,TRX_N-00725-45060882,2023-09-01T19:02:32,Labastida,incomes,extra_income,185.49,-28618.34
buyer_8,Antonio,45,ES18209590033460822675,TRX_N-00726-25219377,2023-09-01T12:54:07,Labastida,expenses,food,-66.85,-28685.19
buyer_8,Antonio,45,ES18209590033460822675,TRX_N-00727-81920083,2023-09-02T05:40:46,Labastida,expenses,cash,-100.0,-28785.19
buyer_8,Antonio,45,ES18209590033460822675,TRX_N-00728-35264779,2023-09-03T18:05:40,Labastida,expenses,leisure,-21.79,-28806.98
buyer_8,Antonio,45,ES18209590033460822675,TRX_N-00729-84484160,2023-09-04T10:17:35,Labastida,expenses,mortgage,-956.34,-29763.32
buyer_8,Antonio,45,ES18209590033460822675,TRX_N-00730-79151365,2023-09-04T06:51:24,Labastida,expenses,children,-176.92,-29940.24
buyer_8,Antonio,45,ES18209590033460822675,TRX_N-00731-22351167,2023-09-05T10:33:50,Labastida,expenses,electricity,-27.31,-29967.55
buyer_8,Antonio,45,ES18209590033460822675,TRX_N-00732-25648659,2023-09-06T12:09:35,Labastida,expenses,water,-30.88,-29998.43
buyer_8,Antonio,45,ES18209590033460822675,TRX_N-00733-98338696,2023-09-06T12:09:48,Labastida,expenses,phone,-32.07,-30030.5
buyer_8,Antonio,45,ES18209590033460822675,TRX_N-00734-14735229,2023-09-06T21:50:21,Labastida,expenses,gifts,-800.36,-30830.86
buyer_8,Antonio,45,ES18209590033460822675,TRX_N-00735-96138666,2023-09-07T16:16:51,Labastida,expenses,gas,-47.95,-30878.81
buyer_8,Antonio,45,ES18209590033460822675,TRX_N-00736-44659482,2023-09-08T08:51:25,Labastida,expenses,internet,-42.0,-30920.81
buyer_8,Antonio,45,ES18209590033460822675,TRX_N-00737-29715283,2023-09-09T19:40:59,Labastida,expenses,food,-89.74,-31010.55
buyer_8,Antonio,45,ES18209590033460822675,TRX_N-00738-53692260,2023-09-10T08:14:50,Portugalete,expenses,transport,-75.51,-31086.06
buyer_8,Antonio,45,ES18209590033460822675,TRX_N-00739-71924391,2023-09-10T10:20:32,Berango,expenses,appliances,-199.89,-31285.95
buyer_8,Antonio,45,ES18209590033460822675,TRX_N-00740-59893114,2023-09-12T09:47:28,Labastida,expenses,cash,-100.0,-31385.95
buyer_8,Antonio,45,ES18209590033460822675,TRX_N-00741-84472266,2023-09-13T18:47:13,Labastida,expenses,cash,-100.0,-31485.95
buyer_8,Antonio,45,ES18209590033460822675,TRX_N-00742-33296922,2023-09-16T18:39:47,Labastida,expenses,food,-88.94,-31574.89
buyer_8,Antonio,45,ES18209590033460822675,TRX_N-00743-87677052,2023-09-16T17:10:15,Labastida,expenses,transport,-72.44,-31647.33
buyer_8,Antonio,45,ES18209590033460822675,TRX_N-00744-59189679,2023-09-16T14:49:59,Labastida,expenses,cash,-100.0,-31747.33
buyer_8,Antonio,45,ES18209590033460822675,TRX_N-00745-89174382,2023-09-17T11:06:43,Labastida,expenses,food,-111.72,-31859.05
buyer_8,Antonio,45,ES18209590033460822675,TRX_N-00746-34637656,2023-09-18T08:03:23,Labastida,expenses,leisure,-41.97,-31901.02
buyer_8,Antonio,45,ES18209590033460822675,TRX_N-00747-44934156,2023-09-18T17:42:49,Labastida,expenses,children,-181.4,-32082.42
buyer_8,Antonio,45,ES18209590033460822675,TRX_N-00748-69114027,2023-09-19T12:40:11,Labastida,expenses,food,-76.39,-32158.81
buyer_8,Antonio,45,ES18209590033460822675,TRX_N-00749-26989600,2023-09-19T21:32:25,Labastida,expenses,education,-44.71,-32203.52
buyer_8,Antonio,45,ES18209590033460822675,TRX_N-00750-58917178,2023-09-21T21:10:10,Labastida,expenses,transport,-47.13,-32250.65
buyer_8,Antonio,45,ES18209590033460822675,TRX_N-00751-02800112,2023-09-21T18:34:41,Labastida,expenses,repairs,-238.89,-32489.54
buyer_8,Antonio,45,ES18209590033460822675,TRX_N-00752-73764219,2023-09-23T12:42:03,Labastida,expenses,education,-45.5,-32535.04
buyer_8,Antonio,45,ES18209590033460822675,TRX_N-00753-14172068,2023-09-24T19:34:22,Labastida,expenses,cash,-100.0,-32635.04
buyer_8,Antonio,45,ES18209590033460822675,TRX_N-00754-06760696,2023-09-25T15:58:39,Labastida,expenses,clothing,-116.08,-32751.12
buyer_8,Antonio,45,ES18209590033460822675,TRX_N-00755-21872187,2023-09-26T09:59:59,Labastida,expenses,education,-75.66,-32826.78
buyer_8,Antonio,45,ES18209590033460822675,TRX_N-00756-25905122,2023-09-26T18:38:11,Labastida,expenses,cash,-100.0,-32926.78
buyer_8,Antonio,45,ES18209590033460822675,TRX_N-00757-40878054,2023-09-28T09:28:26,Labastida,expenses,appliances,-365.36,-33292.14
buyer_8,Antonio,45,ES18209590033460822675,TRX_N-00758-54750789,2023-09-28T15:05:42,Labastida,expenses,children,-279.75,-33571.89
buyer_8,Antonio,45,ES18209590033460822675,TRX_N-00759-98825467,2023-09-30T12:47:18,Labastida,expenses,food,-80.58,-33652.47
buyer_8,Antonio,45,ES18209590033460822675,TRX_N-00760-53549277,2023-10-01T13:34:11,Labastida,incomes,salary,1495.59,-32156.88
buyer_8,Antonio,45,ES18209590033460822675,TRX_N-00761-78082890,2023-10-01T13:34:11,Labastida,incomes,salary_partner,1423.63,-30733.25
buyer_8,Antonio,45,ES18209590033460822675,TRX_N-00762-84429295,2023-10-02T09:04:23,Labastida,expenses,cash,-100.0,-30833.25
buyer_8,Antonio,45,ES18209590033460822675,TRX_N-00763-66572585,2023-10-04T22:28:27,Labastida,expenses,mortgage,-956.34,-31789.59
buyer_8,Antonio,45,ES18209590033460822675,TRX_N-00764-59802711,2023-10-04T16:39:02,Labastida,expenses,transport,-48.19,-31837.78
buyer_8,Antonio,45,ES18209590033460822675,TRX_N-00765-50836341,2023-10-05T15:34:15,Labastida,expenses,gas,-48.46,-31886.24
buyer_8,Antonio,45,ES18209590033460822675,TRX_N-00766-26579716,2023-10-05T10:35:37,Labastida,expenses,internet,-42.0,-31928.24
buyer_8,Antonio,45,ES18209590033460822675,TRX_N-00767-17374044,2023-10-05T15:40:40,Labastida,expenses,clothing,-82.44,-32010.68
buyer_8,Antonio,45,ES18209590033460822675,TRX_N-00768-52606246,2023-10-05T19:19:47,Labastida,expenses,repairs,-146.92,-32157.6
buyer_8,Antonio,45,ES18209590033460822675,TRX_N-00769-27096849,2023-10-06T14:53:28,Labastida,expenses,phone,-32.68,-32190.28
buyer_8,Antonio,45,ES18209590033460822675,TRX_N-00770-94048237,2023-10-06T16:17:42,Labastida,expenses,cash,-100.0,-32290.28
buyer_8,Antonio,45,ES18209590033460822675,TRX_N-00771-86512155,2023-10-07T22:58:10,Labastida,expenses,leisure,-39.87,-32330.15
buyer_8,Antonio,45,ES18209590033460822675,TRX_N-00772-49819445,2023-10-08T18:09:27,Labastida,expenses,water,-20.42,-32350.57
buyer_8,Antonio,45,ES18209590033460822675,TRX_N-00773-48808227,2023-10-08T14:31:40,Labastida,expenses,electricity,-60.38,-32410.95
buyer_8,Antonio,45,ES18209590033460822675,TRX_N-00774-85984776,2023-10-09T16:38:13,Labastida,expenses,healthcare,-107.81,-32518.76
buyer_8,Antonio,45,ES18209590033460822675,TRX_N-00775-66038386,2023-10-11T16:46:00,Labastida,expenses,transport,-77.77,-32596.53
buyer_8,Antonio,45,ES18209590033460822675,TRX_N-00776-53400077,2023-10-14T01:56:31,Errenteria,expenses,cash,-100.0,-32696.53
buyer_8,Antonio,45,ES18209590033460822675,TRX_N-00777-62840856,2023-10-17T09:34:50,Labastida,expenses,transport,-47.75,-32744.28
buyer_8,Antonio,45,ES18209590033460822675,TRX_N-00778-73222031,2023-10-18T17:21:17,Labastida,expenses,cash,-100.0,-32844.28
buyer_8,Antonio,45,ES18209590033460822675,TRX_N-00779-05428743,2023-10-22T17:34:41,Labastida,expenses,leisure,-59.74,-32904.02
buyer_8,Antonio,45,ES18209590033460822675,TRX_N-00780-11170690,2023-10-24T13:49:57,Labastida,expenses,leisure,-28.44,-32932.46
buyer_8,Antonio,45,ES18209590033460822675,TRX_N-00781-69479823,2023-10-25T16:58:24,Labastida,expenses,leisure,-37.58,-32970.04
buyer_8,Antonio,45,ES18209590033460822675,TRX_N-00782-49514590,2023-10-27T11:44:47,Sopela,expenses,cash,-100.0,-33070.04
buyer_8,Antonio,45,ES18209590033460822675,TRX_N-00783-78326329,2023-10-30T15:11:35,Labastida,expenses,transport,-46.46,-33116.5
buyer_8,Antonio,45,ES18209590033460822675,TRX_N-00784-72555718,2023-10-31T10:46:15,Labastida,expenses,food,-121.7,-33238.2
buyer_8,Antonio,45,ES18209590033460822675,TRX_N-00785-05898723,2023-10-31T11:58:57,Labastida,expenses,clothing,-152.79,-33390.99
buyer_8,Antonio,45,ES18209590033460822675,TRX_N-00786-60452840,2023-11-01T13:35:12,Labastida,incomes,salary,1495.59,-31895.4
buyer_8,Antonio,45,ES18209590033460822675,TRX_N-00787-74731360,2023-11-01T13:35:12,Labastida,incomes,salary_partner,1423.63,-30471.77
buyer_8,Antonio,45,ES18209590033460822675,TRX_N-00788-17486308,2023-11-01T10:07:16,Llodio,expenses,clothing,-61.58,-30533.35
buyer_8,Antonio,45,ES18209590033460822675,TRX_N-00789-23499821,2023-11-01T12:55:34,Labastida,expenses,education,-78.28,-30611.63
buyer_8,Antonio,45,ES18209590033460822675,TRX_N-00790-43272238,2023-11-03T13:02:24,Labastida,expenses,clothing,-159.31,-30770.94
buyer_8,Antonio,45,ES18209590033460822675,TRX_N-00791-03236527,2023-11-03T23:10:42,Labastida,expenses,repairs,-100.8,-30871.74
buyer_8,Antonio,45,ES18209590033460822675,TRX_N-00792-19299947,2023-11-04T08:34:58,Labastida,expenses,mortgage,-956.34,-31828.08
buyer_8,Antonio,45,ES18209590033460822675,TRX_N-00793-03580532,2023-11-04T21:23:23,Labastida,expenses,leisure,-74.45,-31902.53
buyer_8,Antonio,45,ES18209590033460822675,TRX_N-00794-58867020,2023-11-05T11:19:36,Labastida,expenses,food,-72.94,-31975.47
buyer_8,Antonio,45,ES18209590033460822675,TRX_N-00795-43903422,2023-11-05T16:40:01,Labastida,expenses,leisure,-73.87,-32049.34
buyer_8,Antonio,45,ES18209590033460822675,TRX_N-00796-06613901,2023-11-05T01:00:22,Galdakao,expenses,healthcare,-83.49,-32132.83
buyer_8,Antonio,45,ES18209590033460822675,TRX_N-00797-25481049,2023-11-05T17:39:55,Labastida,expenses,cash,-100.0,-32232.83
buyer_8,Antonio,45,ES18209590033460822675,TRX_N-00798-01673068,2023-11-07T13:45:15,Labastida,expenses,water,-38.26,-32271.09
buyer_8,Antonio,45,ES18209590033460822675,TRX_N-00799-46985714,2023-11-07T07:10:44,Labastida,expenses,gas,-70.22,-32341.31
buyer_8,Antonio,45,ES18209590033460822675,TRX_N-00800-08421561,2023-11-07T10:59:44,Labastida,expenses,phone,-43.3,-32384.61
buyer_8,Antonio,45,ES18209590033460822675,TRX_N-00801-59360336,2023-11-07T14:59:47,Labastida,expenses,food,-118.36,-32502.97
buyer_8,Antonio,45,ES18209590033460822675,TRX_N-00802-21311178,2023-11-08T10:59:33,Labastida,expenses,electricity,-64.65,-32567.62
buyer_8,Antonio,45,ES18209590033460822675,TRX_N-00803-70989540,2023-11-08T01:23:52,Labastida,expenses,internet,-42.0,-32609.62
buyer_8,Antonio,45,ES18209590033460822675,TRX_N-00804-13179334,2023-11-08T18:11:48,Labastida,expenses,food,-91.95,-32701.57
buyer_8,Antonio,45,ES18209590033460822675,TRX_N-00805-80281337,2023-11-09T10:27:06,Labastida,expenses,healthcare,-127.56,-32829.13
buyer_8,Antonio,45,ES18209590033460822675,TRX_N-00806-78108501,2023-11-09T13:07:33,Labastida,expenses,appliances,-361.34,-33190.47
buyer_8,Antonio,45,ES18209590033460822675,TRX_N-00807-42290020,2023-11-10T19:43:22,Labastida,expenses,leisure,-27.06,-33217.53
buyer_8,Antonio,45,ES18209590033460822675,TRX_N-00808-27033703,2023-11-15T17:59:17,Labastida,expenses,leisure,-47.96,-33265.49
buyer_8,Antonio,45,ES18209590033460822675,TRX_N-00809-51786752,2023-11-16T13:03:39,Labastida,expenses,food,-92.06,-33357.55
buyer_8,Antonio,45,ES18209590033460822675,TRX_N-00810-68486755,2023-11-17T18:18:17,Labastida,expenses,education,-57.1,-33414.65
buyer_8,Antonio,45,ES18209590033460822675,TRX_N-00811-82508742,2023-11-17T01:42:58,Labastida,expenses,cash,-100.0,-33514.65
buyer_8,Antonio,45,ES18209590033460822675,TRX_N-00812-83477621,2023-11-17T17:09:00,Labastida,expenses,repairs,-305.79,-33820.44
buyer_8,Antonio,45,ES18209590033460822675,TRX_N-00813-94498132,2023-11-22T16:37:01,Berango,expenses,transport,-67.05,-33887.49
buyer_8,Antonio,45,ES18209590033460822675,TRX_N-00814-89334400,2023-11-22T15:10:21,Labastida,expenses,cash,-100.0,-33987.49
buyer_8,Antonio,45,ES18209590033460822675,TRX_N-00815-08691292,2023-11-23T20:25:54,Labastida,expenses,cash,-100.0,-34087.49
buyer_8,Antonio,45,ES18209590033460822675,TRX_N-00816-86587012,2023-11-25T08:41:17,Labastida,expenses,food,-118.07,-34205.56
buyer_8,Antonio,45,ES18209590033460822675,TRX_N-00817-36163589,2023-11-25T15:22:08,Labastida,expenses,cash,-100.0,-34305.56
buyer_8,Antonio,45,ES18209590033460822675,TRX_N-00818-80140634,2023-11-28T18:28:49,Labastida,expenses,leisure,-62.94,-34368.5
buyer_8,Antonio,45,ES18209590033460822675,TRX_N-00819-56041641,2023-12-01T18:59:08,Labastida,incomes,salary,1495.59,-32872.91
buyer_8,Antonio,45,ES18209590033460822675,TRX_N-00820-35610344,2023-12-01T18:59:08,Labastida,incomes,salary_partner,1423.63,-31449.28
buyer_8,Antonio,45,ES18209590033460822675,TRX_N-00821-19767684,2023-12-01T18:59:08,Labastida,incomes,extra_income,185.49,-31263.79
buyer_8,Antonio,45,ES18209590033460822675,TRX_N-00822-42298275,2023-12-01T18:59:08,Labastida,incomes,salary_bonus,1105.09,-30158.7
buyer_8,Antonio,45,ES18209590033460822675,TRX_N-00823-60456118,2023-12-01T18:59:08,Labastida,incomes,salary_partner_bonus,1077.24,-29081.46
buyer_8,Antonio,45,ES18209590033460822675,TRX_N-00824-28872924,2023-12-01T14:40:17,Labastida,expenses,cash,-100.0,-29181.46
buyer_8,Antonio,45,ES18209590033460822675,TRX_N-00825-14516794,2023-12-03T11:31:11,Labastida,expenses,leisure,-40.29,-29221.75
buyer_8,Antonio,45,ES18209590033460822675,TRX_N-00826-03203155,2023-12-04T18:32:55,Labastida,expenses,mortgage,-956.34,-30178.09
buyer_8,Antonio,45,ES18209590033460822675,TRX_N-00827-12360679,2023-12-04T11:17:33,Labastida,expenses,food,-102.27,-30280.36
buyer_8,Antonio,45,ES18209590033460822675,TRX_N-00828-70135661,2023-12-05T10:10:03,Labastida,expenses,water,-28.6,-30308.96
buyer_8,Antonio,45,ES18209590033460822675,TRX_N-00829-28358504,2023-12-05T13:04:53,Labastida,expenses,phone,-31.9,-30340.86
buyer_8,Antonio,45,ES18209590033460822675,TRX_N-00830-28557562,2023-12-05T06:58:33,Labastida,expenses,appliances,-112.35,-30453.21
buyer_8,Antonio,45,ES18209590033460822675,TRX_N-00831-93399095,2023-12-07T13:27:28,Labastida,expenses,electricity,-22.32,-30475.53
buyer_8,Antonio,45,ES18209590033460822675,TRX_N-00832-32930899,2023-12-07T19:04:08,Labastida,expenses,gas,-65.58,-30541.11
buyer_8,Antonio,45,ES18209590033460822675,TRX_N-00833-07721190,2023-12-07T15:47:01,Labastida,expenses,transport,-68.82,-30609.93
buyer_8,Antonio,45,ES18209590033460822675,TRX_N-00834-63605502,2023-12-08T17:06:47,Labastida,expenses,internet,-42.0,-30651.93
buyer_8,Antonio,45,ES18209590033460822675,TRX_N-00835-53911447,2023-12-09T14:47:09,Labastida,expenses,children,-93.34,-30745.27
buyer_8,Antonio,45,ES18209590033460822675,TRX_N-00836-41011158,2023-12-11T09:39:23,Labastida,expenses,leisure,-68.59,-30813.86
buyer_8,Antonio,45,ES18209590033460822675,TRX_N-00837-73215727,2023-12-12T17:46:14,Labastida,expenses,cash,-100.0,-30913.86
buyer_8,Antonio,45,ES18209590033460822675,TRX_N-00838-90460590,2023-12-12T15:42:31,Labastida,expenses,children,-206.82,-31120.68
buyer_8,Antonio,45,ES18209590033460822675,TRX_N-00839-61375368,2023-12-13T18:05:19,Labastida,expenses,cash,-100.0,-31220.68
buyer_8,Antonio,45,ES18209590033460822675,TRX_N-00840-41509184,2023-12-15T22:50:31,Labastida,expenses,food,-103.67,-31324.35
buyer_8,Antonio,45,ES18209590033460822675,TRX_N-00841-77380384,2023-12-16T07:38:09,Labastida,expenses,cash,-100.0,-31424.35
buyer_8,Antonio,45,ES18209590033460822675,TRX_N-00842-18972930,2023-12-17T23:20:12,Labastida,expenses,gifts,-308.31,-31732.66
buyer_8,Antonio,45,ES18209590033460822675,TRX_N-00843-43730082,2023-12-19T15:32:47,Labastida,expenses,education,-73.86,-31806.52
buyer_8,Antonio,45,ES18209590033460822675,TRX_N-00844-65541425,2023-12-19T16:40:52,Labastida,expenses,cash,-100.0,-31906.52
buyer_8,Antonio,45,ES18209590033460822675,TRX_N-00845-50989536,2023-12-21T19:41:49,Labastida,expenses,leisure,-76.95,-31983.47
buyer_8,Antonio,45,ES18209590033460822675,TRX_N-00846-06113366,2023-12-25T14:16:37,Salvatierra/Agurain,expenses,food,-89.23,-32072.7
buyer_8,Antonio,45,ES18209590033460822675,TRX_N-00847-69417195,2023-12-25T10:31:33,Labastida,expenses,transport,-69.56,-32142.26
buyer_8,Antonio,45,ES18209590033460822675,TRX_N-00848-48386657,2023-12-27T10:58:47,Labastida,expenses,leisure,-31.87,-32174.13
buyer_8,Antonio,45,ES18209590033460822675,TRX_N-00849-44414483,2023-12-27T18:32:25,Portugalete,expenses,repairs,-65.03,-32239.16
buyer_8,Antonio,45,ES18209590033460822675,TRX_N-00850-46345757,2023-12-28T04:07:12,Labastida,expenses,education,-54.06,-32293.22
buyer_8,Antonio,45,ES18209590033460822675,TRX_N-00851-71795583,2023-12-30T09:50:44,Labastida,expenses,cash,-100.0,-32393.22
buyer_8,Antonio,45,ES18209590033460822675,TRX_N-00852-53780855,2023-12-30T11:36:02,Labastida,expenses,gifts,-599.44,-32992.66
buyer_8,Antonio,45,ES18209590033460822675,TRX_N-00853-16540792,2023-12-31T20:04:08,Labastida,expenses,cash,-100.0,-33092.66
buyer_8,Antonio,45,ES18209590033460822675,TRX_N-00854-17390611,2024-01-01T19:44:37,Labastida,incomes,salary,1532.67,-31559.99
buyer_8,Antonio,45,ES18209590033460822675,TRX_N-00855-01374617,2024-01-01T19:44:37,Labastida,incomes,salary_partner,1458.93,-30101.06
buyer_8,Antonio,45,ES18209590033460822675,TRX_N-00856-94686918,2024-01-01T18:58:51,Labastida,expenses,food,-91.76,-30192.82
buyer_8,Antonio,45,ES18209590033460822675,TRX_N-00857-71495748,2024-01-04T16:05:18,Labastida,expenses,mortgage,-956.34,-31149.16
buyer_8,Antonio,45,ES18209590033460822675,TRX_N-00858-12392209,2024-01-04T08:10:50,Zarautz,expenses,cash,-100.0,-31249.16
buyer_8,Antonio,45,ES18209590033460822675,TRX_N-00859-74386087,2024-01-05T18:01:04,Labastida,expenses,electricity,-82.11,-31331.27
buyer_8,Antonio,45,ES18209590033460822675,TRX_N-00860-43514489,2024-01-05T13:22:50,Labastida,expenses,internet,-42.0,-31373.27
buyer_8,Antonio,45,ES18209590033460822675,TRX_N-00861-03486954,2024-01-05T19:54:35,Labastida,expenses,phone,-33.7,-31406.97
buyer_8,Antonio,45,ES18209590033460822675,TRX_N-00862-52692543,2024-01-05T20:44:36,Vitoria-Gasteiz,expenses,repairs,-158.21,-31565.18
buyer_8,Antonio,45,ES18209590033460822675,TRX_N-00863-18334869,2024-01-05T12:25:25,Labastida,expenses,gifts,-305.93,-31871.11
buyer_8,Antonio,45,ES18209590033460822675,TRX_N-00864-20726787,2024-01-06T19:01:05,Labastida,expenses,water,-21.65,-31892.76
buyer_8,Antonio,45,ES18209590033460822675,TRX_N-00865-48593512,2024-01-07T11:55:54,Labastida,expenses,gas,-72.08,-31964.84
buyer_8,Antonio,45,ES18209590033460822675,TRX_N-00866-70513807,2024-01-07T10:02:36,Labastida,expenses,food,-117.69,-32082.53
buyer_8,Antonio,45,ES18209590033460822675,TRX_N-00867-43963425,2024-01-07T15:43:36,Labastida,expenses,leisure,-75.31,-32157.84
buyer_8,Antonio,45,ES18209590033460822675,TRX_N-00868-85095213,2024-01-08T18:54:41,Labastida,expenses,cash,-100.0,-32257.84
buyer_8,Antonio,45,ES18209590033460822675,TRX_N-00869-71173445,2024-01-10T09:56:03,Zuia,expenses,repairs,-280.5,-32538.34
buyer_8,Antonio,45,ES18209590033460822675,TRX_N-00870-31748737,2024-01-14T19:55:51,Labastida,expenses,cash,-100.0,-32638.34
buyer_8,Antonio,45,ES18209590033460822675,TRX_N-00871-73479102,2024-01-16T07:00:41,Labastida,expenses,food,-115.71,-32754.05
buyer_8,Antonio,45,ES18209590033460822675,TRX_N-00872-04465217,2024-01-17T05:12:05,Labastida,expenses,food,-93.16,-32847.21
buyer_8,Antonio,45,ES18209590033460822675,TRX_N-00873-29659025,2024-01-18T12:51:54,Labastida,expenses,transport,-66.31,-32913.52
buyer_8,Antonio,45,ES18209590033460822675,TRX_N-00874-89361934,2024-01-20T17:48:48,Labastida,expenses,food,-71.5,-32985.02
buyer_8,Antonio,45,ES18209590033460822675,TRX_N-00875-31012320,2024-01-20T22:17:06,Labastida,expenses,transport,-81.68,-33066.7
buyer_8,Antonio,45,ES18209590033460822675,TRX_N-00876-44650096,2024-01-20T08:32:47,Eibar,expenses,cash,-100.0,-33166.7
buyer_8,Antonio,45,ES18209590033460822675,TRX_N-00877-55922386,2024-01-21T14:48:34,Labastida,expenses,clothing,-56.67,-33223.37
buyer_8,Antonio,45,ES18209590033460822675,TRX_N-00878-28956059,2024-01-23T02:28:31,Labastida,expenses,food,-86.58,-33309.95
buyer_8,Antonio,45,ES18209590033460822675,TRX_N-00879-39554329,2024-01-23T19:44:14,Oyón-Oion,expenses,cash,-100.0,-33409.95
buyer_8,Antonio,45,ES18209590033460822675,TRX_N-00880-54747613,2024-01-25T14:09:40,Labastida,expenses,appliances,-186.42,-33596.37
buyer_8,Antonio,45,ES18209590033460822675,TRX_N-00881-73011898,2024-01-26T19:52:59,Labastida,expenses,travel,-1809.56,-35405.93
buyer_8,Antonio,45,ES18209590033460822675,TRX_N-00882-14167619,2024-01-26T22:26:27,Labastida,expenses,repairs,-36.32,-35442.25
buyer_8,Antonio,45,ES18209590033460822675,TRX_N-00883-62504904,2024-01-30T14:56:58,Labastida,expenses,food,-68.63,-35510.88
buyer_8,Antonio,45,ES18209590033460822675,TRX_N-00884-62001360,2024-01-31T11:15:09,Sestao,expenses,leisure,-36.91,-35547.79
buyer_8,Antonio,45,ES18209590033460822675,TRX_N-00885-11266399,2024-02-01T11:33:25,Labastida,incomes,salary,1532.67,-34015.12
buyer_8,Antonio,45,ES18209590033460822675,TRX_N-00886-84343646,2024-02-01T11:33:25,Labastida,incomes,salary_partner,1458.93,-32556.19
buyer_8,Antonio,45,ES18209590033460822675,TRX_N-00887-63375760,2024-02-03T17:18:19,Labastida,expenses,healthcare,-60.98,-32617.17
buyer_8,Antonio,45,ES18209590033460822675,TRX_N-00888-11815426,2024-02-04T09:46:48,Labastida,expenses,mortgage,-956.34,-33573.51
buyer_8,Antonio,45,ES18209590033460822675,TRX_N-00889-98407366,2024-02-04T19:14:38,Irun,expenses,transport,-48.54,-33622.05
buyer_8,Antonio,45,ES18209590033460822675,TRX_N-00890-02087053,2024-02-04T11:42:03,Labastida,expenses,children,-110.23,-33732.28
buyer_8,Antonio,45,ES18209590033460822675,TRX_N-00891-88650823,2024-02-05T09:10:49,Labastida,expenses,phone,-44.13,-33776.41
buyer_8,Antonio,45,ES18209590033460822675,TRX_N-00892-08356982,2024-02-05T17:51:13,Labastida,expenses,food,-73.33,-33849.74
buyer_8,Antonio,45,ES18209590033460822675,TRX_N-00893-22069127,2024-02-05T09:21:57,Zuia,expenses,transport,-87.88,-33937.62
buyer_8,Antonio,45,ES18209590033460822675,TRX_N-00894-95810863,2024-02-05T13:48:57,Labastida,expenses,travel,-1471.59,-35409.21
buyer_8,Antonio,45,ES18209590033460822675,TRX_N-00895-45626732,2024-02-05T16:53:46,Zuia,expenses,repairs,-48.59,-35457.8
buyer_8,Antonio,45,ES18209590033460822675,TRX_N-00896-52458353,2024-02-06T17:27:22,Labastida,expenses,water,-43.26,-35501.06
buyer_8,Antonio,45,ES18209590033460822675,TRX_N-00897-28508216,2024-02-08T20:19:33,Labastida,expenses,electricity,-45.29,-35546.35
buyer_8,Antonio,45,ES18209590033460822675,TRX_N-00898-15036666,2024-02-08T19:23:26,Labastida,expenses,gas,-53.02,-35599.37
buyer_8,Antonio,45,ES18209590033460822675,TRX_N-00899-86659228,2024-02-08T13:15:20,Labastida,expenses,internet,-42.0,-35641.37
buyer_8,Antonio,45,ES18209590033460822675,TRX_N-00900-32661837,2024-02-08T05:52:22,Labastida,expenses,food,-121.99,-35763.36
buyer_8,Antonio,45,ES18209590033460822675,TRX_N-00901-98446982,2024-02-09T17:45:46,Labastida,expenses,cash,-100.0,-35863.36
buyer_8,Antonio,45,ES18209590033460822675,TRX_N-00902-86236457,2024-02-10T14:34:11,Labastida,expenses,food,-115.74,-35979.1
buyer_8,Antonio,45,ES18209590033460822675,TRX_N-00903-82850275,2024-02-11T15:44:34,Labastida,expenses,clothing,-47.84,-36026.94
buyer_8,Antonio,45,ES18209590033460822675,TRX_N-00904-89860950,2024-02-12T10:23:18,Labastida,expenses,cash,-100.0,-36126.94
buyer_8,Antonio,45,ES18209590033460822675,TRX_N-00905-17764227,2024-02-13T22:35:30,Labastida,expenses,clothing,-73.51,-36200.45
buyer_8,Antonio,45,ES18209590033460822675,TRX_N-00906-22048218,2024-02-15T15:20:45,Labastida,expenses,leisure,-49.84,-36250.29
buyer_8,Antonio,45,ES18209590033460822675,TRX_N-00907-35779866,2024-02-15T17:56:54,Labastida,expenses,repairs,-202.55,-36452.84
buyer_8,Antonio,45,ES18209590033460822675,TRX_N-00908-89840050,2024-02-16T14:27:45,Labastida,expenses,leisure,-48.56,-36501.4
buyer_8,Antonio,45,ES18209590033460822675,TRX_N-00909-22609420,2024-02-16T16:16:00,Labastida,expenses,cash,-100.0,-36601.4
buyer_8,Antonio,45,ES18209590033460822675,TRX_N-00910-36442761,2024-02-18T14:09:35,Labastida,expenses,repairs,-138.67,-36740.07
buyer_8,Antonio,45,ES18209590033460822675,TRX_N-00911-44613174,2024-02-20T10:45:34,Labastida,expenses,transport,-65.65,-36805.72
buyer_8,Antonio,45,ES18209590033460822675,TRX_N-00912-15583350,2024-02-21T15:30:40,Labastida,expenses,gifts,-84.0,-36889.72
buyer_8,Antonio,45,ES18209590033460822675,TRX_N-00913-49503824,2024-02-26T21:59:06,Labastida,expenses,clothing,-74.2,-36963.92
buyer_8,Antonio,45,ES18209590033460822675,TRX_N-00914-47975497,2024-02-26T16:16:27,Labastida,expenses,cash,-100.0,-37063.92
buyer_8,Antonio,45,ES18209590033460822675,TRX_N-00915-00441729,2024-02-27T17:15:38,Labastida,expenses,transport,-45.68,-37109.6
buyer_8,Antonio,45,ES18209590033460822675,TRX_N-00916-72074947,2024-02-28T10:46:42,Labastida,expenses,food,-81.55,-37191.15
buyer_8,Antonio,45,ES18209590033460822675,TRX_N-00917-03320702,2024-03-01T15:35:48,Labastida,incomes,salary,1532.67,-35658.48
buyer_8,Antonio,45,ES18209590033460822675,TRX_N-00918-41075910,2024-03-01T15:35:48,Labastida,incomes,salary_partner,1458.93,-34199.55
buyer_8,Antonio,45,ES18209590033460822675,TRX_N-00919-72168131,2024-03-01T15:35:48,Labastida,incomes,extra_income,185.49,-34014.06
buyer_8,Antonio,45,ES18209590033460822675,TRX_N-00920-14468129,2024-03-04T11:57:50,Labastida,expenses,mortgage,-956.34,-34970.4
buyer_8,Antonio,45,ES18209590033460822675,TRX_N-00921-54719231,2024-03-06T15:30:18,Labastida,expenses,gas,-53.73,-35024.13
buyer_8,Antonio,45,ES18209590033460822675,TRX_N-00922-78723759,2024-03-06T16:30:38,Labastida,expenses,children,-243.01,-35267.14
buyer_8,Antonio,45,ES18209590033460822675,TRX_N-00923-00157566,2024-03-07T12:33:00,Labastida,expenses,electricity,-87.9,-35355.04
buyer_8,Antonio,45,ES18209590033460822675,TRX_N-00924-76812892,2024-03-08T20:44:47,Labastida,expenses,water,-23.5,-35378.54
buyer_8,Antonio,45,ES18209590033460822675,TRX_N-00925-09781165,2024-03-08T15:05:11,Labastida,expenses,internet,-42.0,-35420.54
buyer_8,Antonio,45,ES18209590033460822675,TRX_N-00926-97612747,2024-03-08T10:29:42,Labastida,expenses,phone,-34.19,-35454.73
buyer_8,Antonio,45,ES18209590033460822675,TRX_N-00927-80112691,2024-03-08T12:34:26,Sestao,expenses,food,-64.18,-35518.91
buyer_8,Antonio,45,ES18209590033460822675,TRX_N-00928-64514052,2024-03-08T06:57:35,Labastida,expenses,clothing,-104.67,-35623.58
buyer_8,Antonio,45,ES18209590033460822675,TRX_N-00929-80007063,2024-03-09T11:08:20,Labastida,expenses,food,-71.17,-35694.75
buyer_8,Antonio,45,ES18209590033460822675,TRX_N-00930-69873523,2024-03-10T14:29:02,Labastida,expenses,food,-69.85,-35764.6
buyer_8,Antonio,45,ES18209590033460822675,TRX_N-00931-13802555,2024-03-12T11:08:59,Labastida,expenses,clothing,-85.09,-35849.69
buyer_8,Antonio,45,ES18209590033460822675,TRX_N-00932-84372844,2024-03-12T16:59:56,Labastida,expenses,cash,-100.0,-35949.69
buyer_8,Antonio,45,ES18209590033460822675,TRX_N-00933-83995598,2024-03-15T18:05:03,Labastida,expenses,leisure,-43.54,-35993.23
buyer_8,Antonio,45,ES18209590033460822675,TRX_N-00934-87733903,2024-03-15T08:26:39,Labastida,expenses,education,-51.51,-36044.74
buyer_8,Antonio,45,ES18209590033460822675,TRX_N-00935-91567898,2024-03-18T08:32:00,Durango,expenses,leisure,-41.6,-36086.34
buyer_8,Antonio,45,ES18209590033460822675,TRX_N-00936-50788473,2024-03-18T08:49:51,Labastida,expenses,cash,-100.0,-36186.34
buyer_8,Antonio,45,ES18209590033460822675,TRX_N-00937-64639477,2024-03-19T19:30:47,Labastida,expenses,gifts,-484.92,-36671.26
buyer_8,Antonio,45,ES18209590033460822675,TRX_N-00938-83379783,2024-03-20T09:06:05,Labastida,expenses,transport,-42.12,-36713.38
buyer_8,Antonio,45,ES18209590033460822675,TRX_N-00939-21659489,2024-03-21T14:07:53,Labastida,expenses,education,-46.48,-36759.86
buyer_8,Antonio,45,ES18209590033460822675,TRX_N-00940-85542349,2024-03-24T21:13:12,Labastida,expenses,appliances,-411.35,-37171.21
buyer_8,Antonio,45,ES18209590033460822675,TRX_N-00941-52726932,2024-03-24T13:05:29,Labastida,expenses,gifts,-786.09,-37957.3
buyer_8,Antonio,45,ES18209590033460822675,TRX_N-00942-79075204,2024-03-25T21:17:01,Labastida,expenses,transport,-60.48,-38017.78
buyer_8,Antonio,45,ES18209590033460822675,TRX_N-00943-40993278,2024-03-26T08:51:15,Bermeo,expenses,appliances,-306.13,-38323.91
buyer_8,Antonio,45,ES18209590033460822675,TRX_N-00944-71013960,2024-03-27T12:59:58,Labastida,expenses,cash,-100.0,-38423.91
buyer_8,Antonio,45,ES18209590033460822675,TRX_N-00945-10277125,2024-03-28T15:02:20,Labastida,expenses,cash,-100.0,-38523.91
buyer_8,Antonio,45,ES18209590033460822675,TRX_N-00946-04832388,2024-03-31T14:10:52,Labastida,expenses,transport,-49.59,-38573.5
buyer_8,Antonio,45,ES18209590033460822675,TRX_N-00947-18230103,2024-03-31T17:32:12,Labastida,expenses,leisure,-41.09,-38614.59
buyer_8,Antonio,45,ES18209590033460822675,TRX_N-00948-68144729,2024-04-01T20:29:53,Labastida,incomes,salary,1532.67,-37081.92
buyer_8,Antonio,45,ES18209590033460822675,TRX_N-00949-06736622,2024-04-01T20:29:53,Labastida,incomes,salary_partner,1458.93,-35622.99
buyer_8,Antonio,45,ES18209590033460822675,TRX_N-00950-36366600,2024-04-01T14:23:53,Labastida,expenses,healthcare,-118.87,-35741.86
buyer_8,Antonio,45,ES18209590033460822675,TRX_N-00951-88118878,2024-04-03T12:29:04,Labastida,expenses,healthcare,-57.62,-35799.48
buyer_8,Antonio,45,ES18209590033460822675,TRX_N-00952-03195078,2024-04-04T22:17:04,Labastida,expenses,mortgage,-956.34,-36755.82
buyer_8,Antonio,45,ES18209590033460822675,TRX_N-00953-75173180,2024-04-04T17:57:26,Sestao,expenses,appliances,-169.11,-36924.93
buyer_8,Antonio,45,ES18209590033460822675,TRX_N-00954-47796799,2024-04-05T10:02:30,Labastida,expenses,electricity,-47.35,-36972.28
buyer_8,Antonio,45,ES18209590033460822675,TRX_N-00955-97988570,2024-04-06T09:13:48,Labastida,expenses,phone,-44.38,-37016.66
buyer_8,Antonio,45,ES18209590033460822675,TRX_N-00956-65419590,2024-04-07T14:51:59,Labastida,expenses,internet,-42.0,-37058.66
buyer_8,Antonio,45,ES18209590033460822675,TRX_N-00957-38663069,2024-04-08T19:06:03,Labastida,expenses,water,-33.74,-37092.4
buyer_8,Antonio,45,ES18209590033460822675,TRX_N-00958-02372382,2024-04-08T20:52:55,Labastida,expenses,gas,-76.77,-37169.17
buyer_8,Antonio,45,ES18209590033460822675,TRX_N-00959-37153747,2024-04-08T13:56:56,Labastida,expenses,transport,-52.53,-37221.7
buyer_8,Antonio,45,ES18209590033460822675,TRX_N-00960-48974200,2024-04-08T15:34:01,Labastida,expenses,cash,-100.0,-37321.7
buyer_8,Antonio,45,ES18209590033460822675,TRX_N-00961-26944693,2024-04-09T09:24:19,Labastida,expenses,leisure,-60.57,-37382.27
buyer_8,Antonio,45,ES18209590033460822675,TRX_N-00962-65732931,2024-04-09T16:35:00,Labastida,expenses,cash,-100.0,-37482.27
buyer_8,Antonio,45,ES18209590033460822675,TRX_N-00963-93497751,2024-04-09T11:26:25,Labastida,expenses,appliances,-285.88,-37768.15
buyer_8,Antonio,45,ES18209590033460822675,TRX_N-00964-57080244,2024-04-10T12:26:42,Labastida,expenses,food,-64.23,-37832.38
buyer_8,Antonio,45,ES18209590033460822675,TRX_N-00965-49526440,2024-04-11T17:00:15,Labastida,expenses,cash,-100.0,-37932.38
buyer_8,Antonio,45,ES18209590033460822675,TRX_N-00966-16537110,2024-04-12T13:09:14,Labastida,expenses,food,-91.64,-38024.02
buyer_8,Antonio,45,ES18209590033460822675,TRX_N-00967-29969181,2024-04-12T14:16:02,Labastida,expenses,gifts,-431.05,-38455.07
buyer_8,Antonio,45,ES18209590033460822675,TRX_N-00968-47261430,2024-04-14T11:58:22,Labastida,expenses,food,-75.19,-38530.26
buyer_8,Antonio,45,ES18209590033460822675,TRX_N-00969-18506921,2024-04-15T19:39:09,Labastida,expenses,leisure,-66.59,-38596.85
buyer_8,Antonio,45,ES18209590033460822675,TRX_N-00970-52027879,2024-04-16T18:35:07,Labastida,expenses,gifts,-757.75,-39354.6
buyer_8,Antonio,45,ES18209590033460822675,TRX_N-00971-06828187,2024-04-17T14:30:28,Mungia,expenses,cash,-100.0,-39454.6
buyer_8,Antonio,45,ES18209590033460822675,TRX_N-00972-66418840,2024-04-18T10:54:52,Labastida,expenses,food,-81.41,-39536.01
buyer_8,Antonio,45,ES18209590033460822675,TRX_N-00973-19434985,2024-04-18T18:12:05,Labastida,expenses,children,-60.23,-39596.24
buyer_8,Antonio,45,ES18209590033460822675,TRX_N-00974-05166461,2024-04-20T20:59:40,Labastida,expenses,food,-72.12,-39668.36
buyer_8,Antonio,45,ES18209590033460822675,TRX_N-00975-11541295,2024-04-20T22:13:44,Labastida,expenses,leisure,-64.57,-39732.93
buyer_8,Antonio,45,ES18209590033460822675,TRX_N-00976-28227485,2024-04-20T17:33:39,Labastida,expenses,gifts,-336.48,-40069.41
buyer_8,Antonio,45,ES18209590033460822675,TRX_N-00977-71978435,2024-04-21T11:03:29,Labastida,expenses,leisure,-54.28,-40123.69
buyer_8,Antonio,45,ES18209590033460822675,TRX_N-00978-28659651,2024-04-23T15:27:16,Labastida,expenses,leisure,-54.11,-40177.8
buyer_8,Antonio,45,ES18209590033460822675,TRX_N-00979-05660197,2024-04-23T18:32:27,Labastida,expenses,healthcare,-112.1,-40289.9
buyer_8,Antonio,45,ES18209590033460822675,TRX_N-00980-70957706,2024-04-23T14:25:22,Labastida,expenses,cash,-100.0,-40389.9
buyer_8,Antonio,45,ES18209590033460822675,TRX_N-00981-88009775,2024-04-24T16:04:12,Labastida,expenses,children,-175.31,-40565.21
buyer_8,Antonio,45,ES18209590033460822675,TRX_N-00982-18285708,2024-04-25T10:00:54,Labastida,expenses,leisure,-24.77,-40589.98
buyer_8,Antonio,45,ES18209590033460822675,TRX_N-00983-93720860,2024-04-25T08:58:57,Labastida,expenses,children,-188.91,-40778.89
buyer_8,Antonio,45,ES18209590033460822675,TRX_N-00984-82636275,2024-04-28T16:46:10,Labastida,expenses,leisure,-83.65,-40862.54
buyer_8,Antonio,45,ES18209590033460822675,TRX_N-00985-51655625,2024-04-30T11:28:32,Portugalete,expenses,cash,-100.0,-40962.54
buyer_8,Antonio,45,ES18209590033460822675,TRX_N-00986-07185714,2024-05-01T11:30:58,Labastida,incomes,salary,1532.67,-39429.87
buyer_8,Antonio,45,ES18209590033460822675,TRX_N-00987-69170098,2024-05-01T11:30:58,Labastida,incomes,salary_partner,1458.93,-37970.94
buyer_8,Antonio,45,ES18209590033460822675,TRX_N-00988-56830060,2024-05-01T04:00:21,Basauri,expenses,cash,-100.0,-38070.94
buyer_8,Antonio,45,ES18209590033460822675,TRX_N-00989-23535045,2024-05-03T09:02:13,Arrasate,expenses,healthcare,-51.86,-38122.8
buyer_8,Antonio,45,ES18209590033460822675,TRX_N-00990-10665156,2024-05-04T23:44:19,Labastida,expenses,mortgage,-956.34,-39079.14
buyer_8,Antonio,45,ES18209590033460822675,TRX_N-00991-71792117,2024-05-04T17:24:33,Labastida,expenses,education,-45.49,-39124.63
buyer_8,Antonio,45,ES18209590033460822675,TRX_N-00992-51532432,2024-05-05T13:33:26,Labastida,expenses,internet,-42.0,-39166.63
buyer_8,Antonio,45,ES18209590033460822675,TRX_N-00993-86335795,2024-05-05T13:45:54,Elciego,expenses,food,-62.31,-39228.94
buyer_8,Antonio,45,ES18209590033460822675,TRX_N-00994-00320617,2024-05-06T17:45:39,Labastida,expenses,electricity,-77.34,-39306.28
buyer_8,Antonio,45,ES18209590033460822675,TRX_N-00995-23545340,2024-05-06T09:56:27,Labastida,expenses,phone,-37.38,-39343.66
buyer_8,Antonio,45,ES18209590033460822675,TRX_N-00996-27334826,2024-05-06T19:42:31,Zarautz,expenses,transport,-47.91,-39391.57
buyer_8,Antonio,45,ES18209590033460822675,TRX_N-00997-37696661,2024-05-06T09:46:46,Labastida,expenses,cash,-100.0,-39491.57
buyer_8,Antonio,45,ES18209590033460822675,TRX_N-00998-79252669,2024-05-06T07:10:30,Labastida,expenses,gifts,-384.05,-39875.62
buyer_8,Antonio,45,ES18209590033460822675,TRX_N-00999-64185081,2024-05-07T13:52:03,Barakaldo,expenses,cash,-100.0,-39975.62
buyer_8,Antonio,45,ES18209590033460822675,TRX_N-01000-30623248,2024-05-08T19:16:28,Labastida,expenses,water,-41.61,-40017.23
buyer_8,Antonio,45,ES18209590033460822675,TRX_N-01001-98806950,2024-05-08T16:05:27,Labastida,expenses,gas,-81.36,-40098.59
buyer_8,Antonio,45,ES18209590033460822675,TRX_N-01002-97261660,2024-05-10T22:40:00,Labastida,expenses,appliances,-165.01,-40263.6
buyer_8,Antonio,45,ES18209590033460822675,TRX_N-01003-59542172,2024-05-14T20:46:43,Labastida,expenses,healthcare,-130.4,-40394.0
buyer_8,Antonio,45,ES18209590033460822675,TRX_N-01004-15759658,2024-05-14T09:31:59,Labastida,expenses,cash,-100.0,-40494.0
buyer_8,Antonio,45,ES18209590033460822675,TRX_N-01005-46735155,2024-05-16T15:32:40,Labastida,expenses,leisure,-79.04,-40573.04
buyer_8,Antonio,45,ES18209590033460822675,TRX_N-01006-86829622,2024-05-16T10:41:02,Labastida,expenses,cash,-100.0,-40673.04
buyer_8,Antonio,45,ES18209590033460822675,TRX_N-01007-27365900,2024-05-16T09:35:19,Labastida,expenses,gifts,-676.19,-41349.23
buyer_8,Antonio,45,ES18209590033460822675,TRX_N-01008-12291838,2024-05-17T19:29:08,Labastida,expenses,cash,-100.0,-41449.23
buyer_8,Antonio,45,ES18209590033460822675,TRX_N-01009-62268360,2024-05-22T11:17:55,Labastida,expenses,food,-77.13,-41526.36
buyer_8,Antonio,45,ES18209590033460822675,TRX_N-01010-66607596,2024-05-22T18:22:57,Labastida,expenses,leisure,-48.5,-41574.86
buyer_8,Antonio,45,ES18209590033460822675,TRX_N-01011-27426377,2024-05-22T12:27:55,Labastida,expenses,clothing,-73.03,-41647.89
buyer_8,Antonio,45,ES18209590033460822675,TRX_N-01012-56178753,2024-05-24T22:03:55,Labastida,expenses,food,-68.22,-41716.11
buyer_8,Antonio,45,ES18209590033460822675,TRX_N-01013-29898610,2024-05-26T14:48:27,Labastida,expenses,appliances,-210.47,-41926.58
buyer_8,Antonio,45,ES18209590033460822675,TRX_N-01014-86448568,2024-05-31T11:17:55,Labastida,expenses,leisure,-39.9,-41966.48
buyer_8,Antonio,45,ES18209590033460822675,TRX_N-01015-85487351,2024-06-01T09:47:43,Labastida,incomes,salary,1532.67,-40433.81
buyer_8,Antonio,45,ES18209590033460822675,TRX_N-01016-50139324,2024-06-01T09:47:43,Labastida,incomes,salary_partner,1458.93,-38974.88
buyer_8,Antonio,45,ES18209590033460822675,TRX_N-01017-33002413,2024-06-01T09:47:43,Labastida,incomes,salary_bonus,1127.31,-37847.57
buyer_8,Antonio,45,ES18209590033460822675,TRX_N-01018-65977500,2024-06-01T09:47:43,Labastida,incomes,salary_partner_bonus,1076.12,-36771.45
buyer_8,Antonio,45,ES18209590033460822675,TRX_N-01019-18523246,2024-06-01T19:23:55,Labastida,expenses,cash,-100.0,-36871.45
buyer_8,Antonio,45,ES18209590033460822675,TRX_N-01020-86662062,2024-06-02T08:11:33,Labastida,expenses,clothing,-69.78,-36941.23
buyer_8,Antonio,45,ES18209590033460822675,TRX_N-01021-47258055,2024-06-03T08:42:48,Labastida,expenses,cash,-100.0,-37041.23
buyer_8,Antonio,45,ES18209590033460822675,TRX_N-01022-42144735,2024-06-04T10:57:17,Labastida,expenses,mortgage,-956.34,-37997.57
buyer_8,Antonio,45,ES18209590033460822675,TRX_N-01023-65715640,2024-06-04T08:20:25,Labastida,expenses,food,-103.28,-38100.85
buyer_8,Antonio,45,ES18209590033460822675,TRX_N-01024-67048767,2024-06-05T12:38:45,Labastida,expenses,gas,-89.93,-38190.78
buyer_8,Antonio,45,ES18209590033460822675,TRX_N-01025-37506413,2024-06-05T17:59:33,Lasarte-Oria,expenses,cash,-100.0,-38290.78
buyer_8,Antonio,45,ES18209590033460822675,TRX_N-01026-50002355,2024-06-06T12:48:51,Labastida,expenses,water,-32.46,-38323.24
buyer_8,Antonio,45,ES18209590033460822675,TRX_N-01027-51461765,2024-06-06T12:21:57,Labastida,expenses,internet,-42.0,-38365.24
buyer_8,Antonio,45,ES18209590033460822675,TRX_N-01028-42967578,2024-06-06T19:56:39,Labastida,expenses,phone,-36.91,-38402.15
buyer_8,Antonio,45,ES18209590033460822675,TRX_N-01029-25460698,2024-06-08T09:01:11,Labastida,expenses,electricity,-24.29,-38426.44
buyer_8,Antonio,45,ES18209590033460822675,TRX_N-01030-98000629,2024-06-09T11:33:54,Labastida,expenses,gifts,-261.95,-38688.39
buyer_8,Antonio,45,ES18209590033460822675,TRX_N-01031-55922269,2024-06-10T22:20:10,Labastida,expenses,healthcare,-172.82,-38861.21
buyer_8,Antonio,45,ES18209590033460822675,TRX_N-01032-61501464,2024-06-11T08:23:37,Donostia,expenses,cash,-100.0,-38961.21
buyer_8,Antonio,45,ES18209590033460822675,TRX_N-01033-17894724,2024-06-11T17:07:33,Labastida,expenses,repairs,-265.32,-39226.53
buyer_8,Antonio,45,ES18209590033460822675,TRX_N-01034-63521870,2024-06-15T01:13:37,Labastida,expenses,appliances,-172.27,-39398.8
buyer_8,Antonio,45,ES18209590033460822675,TRX_N-01035-28893583,2024-06-16T15:41:42,Portugalete,expenses,leisure,-46.39,-39445.19
buyer_8,Antonio,45,ES18209590033460822675,TRX_N-01036-17924891,2024-06-18T15:51:39,Barakaldo,expenses,transport,-64.54,-39509.73
buyer_8,Antonio,45,ES18209590033460822675,TRX_N-01037-86803864,2024-06-19T12:50:33,Labastida,expenses,repairs,-125.65,-39635.38
buyer_8,Antonio,45,ES18209590033460822675,TRX_N-01038-78143263,2024-06-20T14:16:11,Labastida,expenses,gifts,-386.52,-40021.9
buyer_8,Antonio,45,ES18209590033460822675,TRX_N-01039-22269184,2024-06-22T15:05:42,Labastida,expenses,transport,-72.71,-40094.61
buyer_8,Antonio,45,ES18209590033460822675,TRX_N-01040-13912618,2024-06-22T00:10:08,Labastida,expenses,cash,-100.0,-40194.61
buyer_8,Antonio,45,ES18209590033460822675,TRX_N-01041-93067818,2024-06-23T20:21:35,Zarautz,expenses,transport,-59.8,-40254.41
buyer_8,Antonio,45,ES18209590033460822675,TRX_N-01042-81735532,2024-06-23T09:08:34,Labastida,expenses,clothing,-87.43,-40341.84
buyer_8,Antonio,45,ES18209590033460822675,TRX_N-01043-48747691,2024-06-24T02:29:11,Labastida,expenses,children,-153.15,-40494.99
buyer_8,Antonio,45,ES18209590033460822675,TRX_N-01044-38912894,2024-06-25T12:39:47,Labastida,expenses,food,-87.62,-40582.61
buyer_8,Antonio,45,ES18209590033460822675,TRX_N-01045-41582760,2024-06-25T16:16:10,Labastida,expenses,transport,-83.25,-40665.86
buyer_8,Antonio,45,ES18209590033460822675,TRX_N-01046-34900533,2024-06-25T08:31:09,Labastida,expenses,cash,-100.0,-40765.86
buyer_8,Antonio,45,ES18209590033460822675,TRX_N-01047-18653927,2024-06-26T10:54:07,Labastida,expenses,cash,-100.0,-40865.86
buyer_8,Antonio,45,ES18209590033460822675,TRX_N-01048-65109913,2024-06-28T03:41:54,Labastida,expenses,leisure,-70.51,-40936.37
buyer_8,Antonio,45,ES18209590033460822675,TRX_N-01049-51663616,2024-06-30T20:19:38,Labastida,expenses,food,-86.86,-41023.23
buyer_8,Antonio,45,ES18209590033460822675,TRX_N-01050-69816241,2024-06-30T16:07:47,Labastida,expenses,transport,-84.98,-41108.21
buyer_8,Antonio,45,ES18209590033460822675,TRX_N-01051-50743168,2024-07-01T08:35:14,Labastida,incomes,salary,1532.67,-39575.54
buyer_8,Antonio,45,ES18209590033460822675,TRX_N-01052-12496722,2024-07-01T08:35:14,Labastida,incomes,salary_partner,1458.93,-38116.61
buyer_8,Antonio,45,ES18209590033460822675,TRX_N-01053-96805105,2024-07-01T08:35:14,Labastida,incomes,extra_income,185.49,-37931.12
buyer_8,Antonio,45,ES18209590033460822675,TRX_N-01054-89060475,2024-07-01T10:44:30,Labastida,expenses,food,-95.15,-38026.27
buyer_8,Antonio,45,ES18209590033460822675,TRX_N-01055-69155703,2024-07-01T19:57:01,Labastida,expenses,transport,-54.3,-38080.57
buyer_8,Antonio,45,ES18209590033460822675,TRX_N-01056-24227281,2024-07-02T08:02:06,Labastida,expenses,cash,-100.0,-38180.57
buyer_8,Antonio,45,ES18209590033460822675,TRX_N-01057-87205780,2024-07-04T10:48:40,Labastida,expenses,mortgage,-956.34,-39136.91
buyer_8,Antonio,45,ES18209590033460822675,TRX_N-01058-32467004,2024-07-06T09:33:41,Labastida,expenses,electricity,-59.43,-39196.34
buyer_8,Antonio,45,ES18209590033460822675,TRX_N-01059-89607618,2024-07-06T19:01:19,Labastida,expenses,gas,-37.43,-39233.77
buyer_8,Antonio,45,ES18209590033460822675,TRX_N-01060-99727795,2024-07-06T08:53:38,Labastida,expenses,phone,-38.89,-39272.66
buyer_8,Antonio,45,ES18209590033460822675,TRX_N-01061-77658731,2024-07-06T18:49:55,Eibar,expenses,food,-67.06,-39339.72
buyer_8,Antonio,45,ES18209590033460822675,TRX_N-01062-84747076,2024-07-06T17:59:35,Basauri,expenses,leisure,-59.87,-39399.59
buyer_8,Antonio,45,ES18209590033460822675,TRX_N-01063-93434173,2024-07-06T13:16:16,Labastida,expenses,repairs,-187.94,-39587.53
buyer_8,Antonio,45,ES18209590033460822675,TRX_N-01064-88792332,2024-07-07T22:46:56,Labastida,expenses,water,-42.44,-39629.97
buyer_8,Antonio,45,ES18209590033460822675,TRX_N-01065-82395146,2024-07-07T17:37:33,Labastida,expenses,food,-88.5,-39718.47
buyer_8,Antonio,45,ES18209590033460822675,TRX_N-01066-61022593,2024-07-07T22:51:22,Labastida,expenses,transport,-83.39,-39801.86
buyer_8,Antonio,45,ES18209590033460822675,TRX_N-01067-02634972,2024-07-08T19:19:09,Labastida,expenses,internet,-42.0,-39843.86
buyer_8,Antonio,45,ES18209590033460822675,TRX_N-01068-83867029,2024-07-08T09:00:24,Labastida,expenses,food,-61.23,-39905.09
buyer_8,Antonio,45,ES18209590033460822675,TRX_N-01069-86604472,2024-07-09T10:00:51,Labastida,expenses,leisure,-78.3,-39983.39
buyer_8,Antonio,45,ES18209590033460822675,TRX_N-01070-40332652,2024-07-09T18:52:37,Eibar,expenses,cash,-100.0,-40083.39
buyer_8,Antonio,45,ES18209590033460822675,TRX_N-01071-56640931,2024-07-11T13:51:33,Labastida,expenses,education,-49.26,-40132.65
buyer_8,Antonio,45,ES18209590033460822675,TRX_N-01072-37127729,2024-07-11T14:36:46,Labastida,expenses,gifts,-701.4,-40834.05
buyer_8,Antonio,45,ES18209590033460822675,TRX_N-01073-30001316,2024-07-12T19:40:20,Alegría-Dulantzi,expenses,cash,-100.0,-40934.05
buyer_8,Antonio,45,ES18209590033460822675,TRX_N-01074-73623556,2024-07-14T10:43:01,Labastida,expenses,repairs,-126.5,-41060.55
buyer_8,Antonio,45,ES18209590033460822675,TRX_N-01075-04800000,2024-07-15T18:32:44,Andoain,expenses,food,-68.29,-41128.84
buyer_8,Antonio,45,ES18209590033460822675,TRX_N-01076-50236364,2024-07-16T11:27:37,Labastida,expenses,leisure,-82.09,-41210.93
buyer_8,Antonio,45,ES18209590033460822675,TRX_N-01077-28416083,2024-07-17T05:36:20,Labastida,expenses,cash,-100.0,-41310.93
buyer_8,Antonio,45,ES18209590033460822675,TRX_N-01078-34563048,2024-07-19T08:30:50,Labastida,expenses,leisure,-74.13,-41385.06
buyer_8,Antonio,45,ES18209590033460822675,TRX_N-01079-89932914,2024-07-20T14:43:26,Labastida,expenses,transport,-76.86,-41461.92
buyer_8,Antonio,45,ES18209590033460822675,TRX_N-01080-33037246,2024-07-21T11:35:17,Labastida,expenses,cash,-100.0,-41561.92
buyer_8,Antonio,45,ES18209590033460822675,TRX_N-01081-71303465,2024-07-22T16:27:00,Leioa,expenses,food,-96.67,-41658.59
buyer_8,Antonio,45,ES18209590033460822675,TRX_N-01082-51180583,2024-07-22T16:53:12,Labastida,expenses,cash,-100.0,-41758.59
buyer_8,Antonio,45,ES18209590033460822675,TRX_N-01083-31763427,2024-07-22T19:49:37,Labastida,expenses,repairs,-320.51,-42079.1
buyer_8,Antonio,45,ES18209590033460822675,TRX_N-01084-98282733,2024-07-25T15:50:00,Labastida,expenses,cash,-100.0,-42179.1
buyer_8,Antonio,45,ES18209590033460822675,TRX_N-01085-20670114,2024-07-26T08:16:15,Labastida,expenses,education,-47.47,-42226.57
buyer_8,Antonio,45,ES18209590033460822675,TRX_N-01086-20496007,2024-07-28T11:46:15,Labastida,expenses,cash,-100.0,-42326.57
buyer_8,Antonio,45,ES18209590033460822675,TRX_N-01087-75771675,2024-07-29T10:40:23,Labastida,expenses,clothing,-100.99,-42427.56
buyer_8,Antonio,45,ES18209590033460822675,TRX_N-01088-08273145,2024-07-29T14:52:29,Labastida,expenses,cash,-100.0,-42527.56
buyer_8,Antonio,45,ES18209590033460822675,TRX_N-01089-07540602,2024-07-29T17:34:27,Labastida,expenses,repairs,-176.52,-42704.08
buyer_8,Antonio,45,ES18209590033460822675,TRX_N-01090-29416701,2024-07-29T15:45:30,Labastida,expenses,gifts,-767.13,-43471.21
buyer_8,Antonio,45,ES18209590033460822675,TRX_N-01091-43867266,2024-07-30T19:38:41,Labastida,expenses,transport,-46.81,-43518.02
buyer_8,Antonio,45,ES18209590033460822675,TRX_N-01092-83241815,2024-07-31T09:18:52,Labastida,expenses,food,-75.77,-43593.79
buyer_8,Antonio,45,ES18209590033460822675,TRX_N-01093-53243391,2024-07-31T19:02:13,Labastida,expenses,repairs,-284.7,-43878.49
buyer_8,Antonio,45,ES18209590033460822675,TRX_N-01094-64196854,2024-08-01T17:59:01,Labastida,incomes,salary,1532.67,-42345.82
buyer_8,Antonio,45,ES18209590033460822675,TRX_N-01095-90463142,2024-08-01T17:59:01,Labastida,incomes,salary_partner,1458.93,-40886.89
buyer_8,Antonio,45,ES18209590033460822675,TRX_N-01096-78192798,2024-08-01T18:40:37,Labastida,expenses,transport,-86.26,-40973.15
buyer_8,Antonio,45,ES18209590033460822675,TRX_N-01097-01122213,2024-08-01T17:03:48,Labastida,expenses,leisure,-49.12,-41022.27
buyer_8,Antonio,45,ES18209590033460822675,TRX_N-01098-19858208,2024-08-01T18:23:10,Labastida,expenses,clothing,-152.78,-41175.05
buyer_8,Antonio,45,ES18209590033460822675,TRX_N-01099-62735507,2024-08-02T23:50:59,Labastida,expenses,appliances,-132.08,-41307.13
buyer_8,Antonio,45,ES18209590033460822675,TRX_N-01100-42789131,2024-08-03T08:31:30,Labastida,expenses,leisure,-22.26,-41329.39
buyer_8,Antonio,45,ES18209590033460822675,TRX_N-01101-73296981,2024-08-03T20:22:05,Labastida,expenses,education,-63.92,-41393.31
buyer_8,Antonio,45,ES18209590033460822675,TRX_N-01102-43091145,2024-08-04T19:37:29,Labastida,expenses,mortgage,-956.34,-42349.65
buyer_8,Antonio,45,ES18209590033460822675,TRX_N-01103-52821140,2024-08-04T12:19:49,Labastida,expenses,food,-83.53,-42433.18
buyer_8,Antonio,45,ES18209590033460822675,TRX_N-01104-25839834,2024-08-04T20:11:54,Labastida,expenses,transport,-88.87,-42522.05
buyer_8,Antonio,45,ES18209590033460822675,TRX_N-01105-83408344,2024-08-05T22:20:31,Labastida,expenses,gas,-60.43,-42582.48
buyer_8,Antonio,45,ES18209590033460822675,TRX_N-01106-97173173,2024-08-05T08:31:16,Labastida,expenses,internet,-42.0,-42624.48
buyer_8,Antonio,45,ES18209590033460822675,TRX_N-01107-55653888,2024-08-05T16:42:49,Labastida,expenses,food,-65.98,-42690.46
buyer_8,Antonio,45,ES18209590033460822675,TRX_N-01108-09133521,2024-08-05T18:13:41,Labastida,expenses,repairs,-211.33,-42901.79
buyer_8,Antonio,45,ES18209590033460822675,TRX_N-01109-21329706,2024-08-06T19:43:14,Labastida,expenses,food,-84.12,-42985.91
buyer_8,Antonio,45,ES18209590033460822675,TRX_N-01110-05055490,2024-08-07T18:24:15,Labastida,expenses,electricity,-55.24,-43041.15
buyer_8,Antonio,45,ES18209590033460822675,TRX_N-01111-89835775,2024-08-07T04:31:09,Labastida,expenses,education,-72.05,-43113.2
buyer_8,Antonio,45,ES18209590033460822675,TRX_N-01112-55617595,2024-08-07T20:28:55,Labastida,expenses,cash,-100.0,-43213.2
buyer_8,Antonio,45,ES18209590033460822675,TRX_N-01113-07094293,2024-08-08T06:10:06,Labastida,expenses,phone,-33.23,-43246.43
buyer_8,Antonio,45,ES18209590033460822675,TRX_N-01114-16429352,2024-08-08T08:36:49,Labastida,expenses,water,-32.42,-43278.85
buyer_8,Antonio,45,ES18209590033460822675,TRX_N-01115-90015123,2024-08-10T10:27:49,Getxo,expenses,food,-77.2,-43356.05
buyer_8,Antonio,45,ES18209590033460822675,TRX_N-01116-53332588,2024-08-14T20:44:39,Berango,expenses,gifts,-25.21,-43381.26
buyer_8,Antonio,45,ES18209590033460822675,TRX_N-01117-03179639,2024-08-16T18:55:17,Labastida,expenses,food,-102.51,-43483.77
buyer_8,Antonio,45,ES18209590033460822675,TRX_N-01118-83948277,2024-08-24T09:34:31,Lasarte-Oria,expenses,food,-116.43,-43600.2
buyer_8,Antonio,45,ES18209590033460822675,TRX_N-01119-51600311,2024-08-24T20:20:02,Labastida,expenses,transport,-65.14,-43665.34
buyer_8,Antonio,45,ES18209590033460822675,TRX_N-01120-57353861,2024-08-25T13:22:47,Labastida,expenses,clothing,-68.44,-43733.78
buyer_8,Antonio,45,ES18209590033460822675,TRX_N-01121-46127738,2024-08-28T20:13:04,Labastida,expenses,cash,-100.0,-43833.78
buyer_8,Antonio,45,ES18209590033460822675,TRX_N-01122-82350172,2024-08-29T16:43:44,Eibar,expenses,leisure,-72.19,-43905.97
buyer_8,Antonio,45,ES18209590033460822675,TRX_N-01123-32189327,2024-08-30T17:02:58,Labastida,expenses,repairs,-73.3,-43979.27
buyer_8,Antonio,45,ES18209590033460822675,TRX_N-01124-30179530,2024-08-30T12:54:41,Labastida,expenses,gifts,-273.25,-44252.52
buyer_8,Antonio,45,ES18209590033460822675,TRX_N-01125-14014747,2024-09-01T17:08:31,Labastida,incomes,salary,1532.67,-42719.85
buyer_8,Antonio,45,ES18209590033460822675,TRX_N-01126-19609084,2024-09-01T17:08:31,Labastida,incomes,salary_partner,1458.93,-41260.92
buyer_8,Antonio,45,ES18209590033460822675,TRX_N-01127-03745600,2024-09-01T22:59:52,Labastida,expenses,gifts,-228.27,-41489.19
buyer_8,Antonio,45,ES18209590033460822675,TRX_N-01128-69385001,2024-09-03T08:36:22,Labastida,expenses,leisure,-50.31,-41539.5
buyer_8,Antonio,45,ES18209590033460822675,TRX_N-01129-85230600,2024-09-04T12:37:00,Labastida,expenses,mortgage,-956.34,-42495.84
buyer_8,Antonio,45,ES18209590033460822675,TRX_N-01130-66260754,2024-09-05T17:53:46,Labastida,expenses,healthcare,-118.52,-42614.36
buyer_8,Antonio,45,ES18209590033460822675,TRX_N-01131-23968023,2024-09-06T14:41:33,Labastida,expenses,internet,-42.0,-42656.36
buyer_8,Antonio,45,ES18209590033460822675,TRX_N-01132-66823552,2024-09-06T22:30:12,Labastida,expenses,phone,-38.17,-42694.53
buyer_8,Antonio,45,ES18209590033460822675,TRX_N-01133-81720836,2024-09-07T03:39:48,Labastida,expenses,gifts,-126.15,-42820.68
buyer_8,Antonio,45,ES18209590033460822675,TRX_N-01134-24757589,2024-09-08T18:19:33,Labastida,expenses,gas,-43.71,-42864.39
buyer_8,Antonio,45,ES18209590033460822675,TRX_N-01135-92607015,2024-09-08T11:22:02,Labastida,expenses,water,-22.61,-42887.0
buyer_8,Antonio,45,ES18209590033460822675,TRX_N-01136-01043926,2024-09-08T19:42:52,Labastida,expenses,electricity,-59.66,-42946.66
buyer_8,Antonio,45,ES18209590033460822675,TRX_N-01137-38434010,2024-09-08T14:48:59,Labastida,expenses,cash,-100.0,-43046.66
buyer_8,Antonio,45,ES18209590033460822675,TRX_N-01138-96202787,2024-09-09T20:21:19,Labastida,expenses,transport,-85.48,-43132.14
buyer_8,Antonio,45,ES18209590033460822675,TRX_N-01139-04655457,2024-09-11T16:19:11,Vitoria-Gasteiz,expenses,transport,-66.46,-43198.6
buyer_8,Antonio,45,ES18209590033460822675,TRX_N-01140-19419441,2024-09-11T10:49:59,Labastida,expenses,leisure,-33.61,-43232.21
buyer_8,Antonio,45,ES18209590033460822675,TRX_N-01141-88406422,2024-09-14T08:51:27,Labastida,expenses,cash,-100.0,-43332.21
buyer_8,Antonio,45,ES18209590033460822675,TRX_N-01142-54684893,2024-09-15T23:26:00,Labastida,expenses,food,-91.05,-43423.26
buyer_8,Antonio,45,ES18209590033460822675,TRX_N-01143-39860325,2024-09-16T18:35:52,Labastida,expenses,travel,-1629.28,-45052.54
buyer_8,Antonio,45,ES18209590033460822675,TRX_N-01144-91698351,2024-09-19T14:57:49,Labastida,expenses,repairs,-286.29,-45338.83
buyer_8,Antonio,45,ES18209590033460822675,TRX_N-01145-31926434,2024-09-20T14:32:51,Labastida,expenses,leisure,-56.77,-45395.6
buyer_8,Antonio,45,ES18209590033460822675,TRX_N-01146-73011118,2024-09-21T19:38:32,Labastida,expenses,food,-92.4,-45488.0
buyer_8,Antonio,45,ES18209590033460822675,TRX_N-01147-81283735,2024-09-21T21:28:22,Labastida,expenses,children,-103.84,-45591.84
buyer_8,Antonio,45,ES18209590033460822675,TRX_N-01148-22002055,2024-09-23T19:46:07,Labastida,expenses,leisure,-72.61,-45664.45
buyer_8,Antonio,45,ES18209590033460822675,TRX_N-01149-23062567,2024-09-24T19:00:33,Labastida,expenses,cash,-100.0,-45764.45
buyer_8,Antonio,45,ES18209590033460822675,TRX_N-01150-82847973,2024-09-24T17:28:01,Labastida,expenses,gifts,-290.7,-46055.15
buyer_8,Antonio,45,ES18209590033460822675,TRX_N-01151-13363604,2024-09-25T20:39:15,Labastida,expenses,food,-90.58,-46145.73
buyer_8,Antonio,45,ES18209590033460822675,TRX_N-01152-44628460,2024-09-25T11:33:58,Labastida,expenses,education,-57.33,-46203.06
buyer_8,Antonio,45,ES18209590033460822675,TRX_N-01153-45591453,2024-09-26T08:55:30,Galdakao,expenses,clothing,-138.67,-46341.73
buyer_8,Antonio,45,ES18209590033460822675,TRX_N-01154-89995977,2024-09-29T19:05:49,Labastida,expenses,cash,-100.0,-46441.73
buyer_8,Antonio,45,ES18209590033460822675,TRX_N-01155-46940645,2024-09-29T10:23:23,Labastida,expenses,repairs,-238.75,-46680.48
buyer_8,Antonio,45,ES18209590033460822675,TRX_N-01156-11074248,2024-10-01T09:29:35,Labastida,incomes,salary,1532.67,-45147.81
buyer_8,Antonio,45,ES18209590033460822675,TRX_N-01157-96409588,2024-10-01T09:29:35,Labastida,incomes,salary_partner,1458.93,-43688.88
buyer_8,Antonio,45,ES18209590033460822675,TRX_N-01158-13918689,2024-10-01T23:28:49,Pasaia,expenses,healthcare,-131.27,-43820.15
buyer_8,Antonio,45,ES18209590033460822675,TRX_N-01159-76511966,2024-10-02T06:46:39,Labastida,expenses,cash,-100.0,-43920.15
buyer_8,Antonio,45,ES18209590033460822675,TRX_N-01160-06589771,2024-10-04T19:30:35,Labastida,expenses,mortgage,-956.34,-44876.49
buyer_8,Antonio,45,ES18209590033460822675,TRX_N-01161-80040995,2024-10-05T11:08:39,Labastida,expenses,gas,-82.57,-44959.06
buyer_8,Antonio,45,ES18209590033460822675,TRX_N-01162-18465899,2024-10-05T16:09:35,Bermeo,expenses,food,-67.57,-45026.63
buyer_8,Antonio,45,ES18209590033460822675,TRX_N-01163-66067275,2024-10-06T17:08:16,Labastida,expenses,cash,-100.0,-45126.63
buyer_8,Antonio,45,ES18209590033460822675,TRX_N-01164-15633071,2024-10-06T14:02:27,Labastida,expenses,children,-275.13,-45401.76
buyer_8,Antonio,45,ES18209590033460822675,TRX_N-01165-12665378,2024-10-07T18:31:49,Labastida,expenses,internet,-42.0,-45443.76
buyer_8,Antonio,45,ES18209590033460822675,TRX_N-01166-61765486,2024-10-08T01:04:29,Labastida,expenses,phone,-32.98,-45476.74
buyer_8,Antonio,45,ES18209590033460822675,TRX_N-01167-72474420,2024-10-08T15:31:21,Labastida,expenses,water,-34.78,-45511.52
buyer_8,Antonio,45,ES18209590033460822675,TRX_N-01168-47040376,2024-10-08T10:45:46,Labastida,expenses,electricity,-45.86,-45557.38
buyer_8,Antonio,45,ES18209590033460822675,TRX_N-01169-07135838,2024-10-08T17:10:42,Labastida,expenses,clothing,-85.86,-45643.24
buyer_8,Antonio,45,ES18209590033460822675,TRX_N-01170-66087973,2024-10-08T15:15:51,Labastida,expenses,gifts,-415.85,-46059.09
buyer_8,Antonio,45,ES18209590033460822675,TRX_N-01171-18616113,2024-10-09T12:15:40,Labastida,expenses,education,-75.16,-46134.25
