profile,name,surname,birth_date,dni,email,password,iban,assets,timestamp,city,type,category,amount,balance
buyer_1,Luis,Garay,1996-08-10,22984418N,luis.garay@cooltech.tech,641191,ES45209531629390469205,4758.25,2022-01-01T18:44:17,Bilbao,incomes,salary,1441.77,6200.02
buyer_1,Luis,Garay,1996-08-10,22984418N,luis.garay@cooltech.tech,641191,ES45209531629390469205,4758.25,2022-01-01T22:15:02,Bilbao,expenses,food,-69.85,6130.17
buyer_1,Luis,Garay,1996-08-10,22984418N,luis.garay@cooltech.tech,641191,ES45209531629390469205,4758.25,2022-01-01T17:06:21,Bilbao,expenses,transport,-46.45,6083.72
buyer_1,Luis,Garay,1996-08-10,22984418N,luis.garay@cooltech.tech,641191,ES45209531629390469205,4758.25,2022-01-02T16:45:45,Bilbao,expenses,cash,-100.0,5983.72
buyer_1,Luis,Garay,1996-08-10,22984418N,luis.garay@cooltech.tech,641191,ES45209531629390469205,4758.25,2022-01-03T20:47:00,Bilbao,expenses,cash,-100.0,5883.72
buyer_1,Luis,Garay,1996-08-10,22984418N,luis.garay@cooltech.tech,641191,ES45209531629390469205,4758.25,2022-01-04T21:55:30,Bilbao,expenses,rent,-488.24,5395.48
buyer_1,Luis,Garay,1996-08-10,22984418N,luis.garay@cooltech.tech,641191,ES45209531629390469205,4758.25,2022-01-04T12:31:18,Bilbao,expenses,transport,-85.92,5309.56
buyer_1,Luis,Garay,1996-08-10,22984418N,luis.garay@cooltech.tech,641191,ES45209531629390469205,4758.25,2022-01-06T19:06:38,Bilbao,expenses,phone,-28.97,5280.59
buyer_1,Luis,Garay,1996-08-10,22984418N,luis.garay@cooltech.tech,641191,ES45209531629390469205,4758.25,2022-01-07T13:29:57,Bilbao,expenses,gas,-29.83,5250.76
buyer_1,Luis,Garay,1996-08-10,22984418N,luis.garay@cooltech.tech,641191,ES45209531629390469205,4758.25,2022-01-08T12:23:30,Bilbao,expenses,water,-28.49,5222.27
buyer_1,Luis,Garay,1996-08-10,22984418N,luis.garay@cooltech.tech,641191,ES45209531629390469205,4758.25,2022-01-08T17:48:19,Bilbao,expenses,electricity,-39.96,5182.31
buyer_1,Luis,Garay,1996-08-10,22984418N,luis.garay@cooltech.tech,641191,ES45209531629390469205,4758.25,2022-01-08T16:18:12,Bilbao,expenses,internet,-30.28,5152.03
buyer_1,Luis,Garay,1996-08-10,22984418N,luis.garay@cooltech.tech,641191,ES45209531629390469205,4758.25,2022-01-08T14:40:41,Bilbao,expenses,cash,-100.0,5052.03
buyer_1,Luis,Garay,1996-08-10,22984418N,luis.garay@cooltech.tech,641191,ES45209531629390469205,4758.25,2022-01-09T03:31:51,Bilbao,expenses,cash,-100.0,4952.03
buyer_1,Luis,Garay,1996-08-10,22984418N,luis.garay@cooltech.tech,641191,ES45209531629390469205,4758.25,2022-01-11T22:03:34,Bilbao,expenses,cash,-100.0,4852.03
buyer_1,Luis,Garay,1996-08-10,22984418N,luis.garay@cooltech.tech,641191,ES45209531629390469205,4758.25,2022-01-12T11:38:29,Bilbao,expenses,food,-77.68,4774.35
buyer_1,Luis,Garay,1996-08-10,22984418N,luis.garay@cooltech.tech,641191,ES45209531629390469205,4758.25,2022-01-14T15:10:05,Bilbao,expenses,appliances,-77.16,4697.19
buyer_1,Luis,Garay,1996-08-10,22984418N,luis.garay@cooltech.tech,641191,ES45209531629390469205,4758.25,2022-01-15T16:22:24,Bilbao,expenses,cash,-100.0,4597.19
buyer_1,Luis,Garay,1996-08-10,22984418N,luis.garay@cooltech.tech,641191,ES45209531629390469205,4758.25,2022-01-17T14:19:47,Bilbao,expenses,appliances,-158.02,4439.17
buyer_1,Luis,Garay,1996-08-10,22984418N,luis.garay@cooltech.tech,641191,ES45209531629390469205,4758.25,2022-01-18T14:27:12,Bilbao,expenses,transport,-58.0,4381.17
buyer_1,Luis,Garay,1996-08-10,22984418N,luis.garay@cooltech.tech,641191,ES45209531629390469205,4758.25,2022-01-20T13:41:31,Bilbao,expenses,transport,-59.25,4321.92
buyer_1,Luis,Garay,1996-08-10,22984418N,luis.garay@cooltech.tech,641191,ES45209531629390469205,4758.25,2022-01-20T13:42:58,Bilbao,expenses,cash,-100.0,4221.92
buyer_1,Luis,Garay,1996-08-10,22984418N,luis.garay@cooltech.tech,641191,ES45209531629390469205,4758.25,2022-01-22T17:44:03,Bilbao,expenses,cash,-100.0,4121.92
buyer_1,Luis,Garay,1996-08-10,22984418N,luis.garay@cooltech.tech,641191,ES45209531629390469205,4758.25,2022-01-23T12:27:54,Bilbao,expenses,healthcare,-158.72,3963.2
buyer_1,Luis,Garay,1996-08-10,22984418N,luis.garay@cooltech.tech,641191,ES45209531629390469205,4758.25,2022-01-24T16:34:05,Bilbao,expenses,cash,-100.0,3863.2
buyer_1,Luis,Garay,1996-08-10,22984418N,luis.garay@cooltech.tech,641191,ES45209531629390469205,4758.25,2022-01-27T22:59:13,Bilbao,expenses,gifts,-230.89,3632.31
buyer_1,Luis,Garay,1996-08-10,22984418N,luis.garay@cooltech.tech,641191,ES45209531629390469205,4758.25,2022-01-28T09:19:11,Bilbao,expenses,gifts,-106.58,3525.73
buyer_1,Luis,Garay,1996-08-10,22984418N,luis.garay@cooltech.tech,641191,ES45209531629390469205,4758.25,2022-01-29T17:18:07,Bilbao,expenses,leisure,-65.3,3460.43
buyer_1,Luis,Garay,1996-08-10,22984418N,luis.garay@cooltech.tech,641191,ES45209531629390469205,4758.25,2022-01-29T02:48:47,Bilbao,expenses,gifts,-43.87,3416.56
buyer_1,Luis,Garay,1996-08-10,22984418N,luis.garay@cooltech.tech,641191,ES45209531629390469205,4758.25,2022-01-30T16:54:43,Bilbao,expenses,travel,-453.79,2962.77
buyer_1,Luis,Garay,1996-08-10,22984418N,luis.garay@cooltech.tech,641191,ES45209531629390469205,4758.25,2022-01-31T01:49:33,Bilbao,expenses,leisure,-22.78,2939.99
buyer_1,Luis,Garay,1996-08-10,22984418N,luis.garay@cooltech.tech,641191,ES45209531629390469205,4758.25,2022-02-01T11:09:15,Bilbao,incomes,salary,1441.77,4381.76
buyer_1,Luis,Garay,1996-08-10,22984418N,luis.garay@cooltech.tech,641191,ES45209531629390469205,4758.25,2022-02-02T12:58:27,Bilbao,expenses,food,-103.8,4277.96
buyer_1,Luis,Garay,1996-08-10,22984418N,luis.garay@cooltech.tech,641191,ES45209531629390469205,4758.25,2022-02-02T15:34:30,Bilbao,expenses,healthcare,-145.95,4132.01
buyer_1,Luis,Garay,1996-08-10,22984418N,luis.garay@cooltech.tech,641191,ES45209531629390469205,4758.25,2022-02-03T11:13:14,Bilbao,expenses,leisure,-64.22,4067.79
buyer_1,Luis,Garay,1996-08-10,22984418N,luis.garay@cooltech.tech,641191,ES45209531629390469205,4758.25,2022-02-03T09:03:46,Bilbao,expenses,education,-60.68,4007.11
buyer_1,Luis,Garay,1996-08-10,22984418N,luis.garay@cooltech.tech,641191,ES45209531629390469205,4758.25,2022-02-04T18:43:05,Bilbao,expenses,rent,-488.24,3518.87
buyer_1,Luis,Garay,1996-08-10,22984418N,luis.garay@cooltech.tech,641191,ES45209531629390469205,4758.25,2022-02-05T09:22:59,Bilbao,expenses,electricity,-51.94,3466.93
buyer_1,Luis,Garay,1996-08-10,22984418N,luis.garay@cooltech.tech,641191,ES45209531629390469205,4758.25,2022-02-06T19:42:44,Bilbao,expenses,internet,-30.28,3436.65
buyer_1,Luis,Garay,1996-08-10,22984418N,luis.garay@cooltech.tech,641191,ES45209531629390469205,4758.25,2022-02-07T23:39:06,Bilbao,expenses,phone,-30.57,3406.08
buyer_1,Luis,Garay,1996-08-10,22984418N,luis.garay@cooltech.tech,641191,ES45209531629390469205,4758.25,2022-02-07T16:26:20,Bilbao,expenses,food,-70.51,3335.57
buyer_1,Luis,Garay,1996-08-10,22984418N,luis.garay@cooltech.tech,641191,ES45209531629390469205,4758.25,2022-02-07T14:01:21,Bilbao,expenses,healthcare,-51.56,3284.01
buyer_1,Luis,Garay,1996-08-10,22984418N,luis.garay@cooltech.tech,641191,ES45209531629390469205,4758.25,2022-02-08T05:55:45,Bilbao,expenses,water,-21.9,3262.11
buyer_1,Luis,Garay,1996-08-10,22984418N,luis.garay@cooltech.tech,641191,ES45209531629390469205,4758.25,2022-02-08T08:50:08,Bilbao,expenses,gas,-36.37,3225.74
buyer_1,Luis,Garay,1996-08-10,22984418N,luis.garay@cooltech.tech,641191,ES45209531629390469205,4758.25,2022-02-08T17:40:07,Bilbao,expenses,food,-101.61,3124.13
buyer_1,Luis,Garay,1996-08-10,22984418N,luis.garay@cooltech.tech,641191,ES45209531629390469205,4758.25,2022-02-09T14:22:21,Bilbao,expenses,transport,-74.04,3050.09
buyer_1,Luis,Garay,1996-08-10,22984418N,luis.garay@cooltech.tech,641191,ES45209531629390469205,4758.25,2022-02-10T00:48:56,Bilbao,expenses,food,-60.62,2989.47
buyer_1,Luis,Garay,1996-08-10,22984418N,luis.garay@cooltech.tech,641191,ES45209531629390469205,4758.25,2022-02-11T20:36:33,Bilbao,expenses,cash,-100.0,2889.47
buyer_1,Luis,Garay,1996-08-10,22984418N,luis.garay@cooltech.tech,641191,ES45209531629390469205,4758.25,2022-02-13T08:14:08,Bilbao,expenses,food,-67.29,2822.18
buyer_1,Luis,Garay,1996-08-10,22984418N,luis.garay@cooltech.tech,641191,ES45209531629390469205,4758.25,2022-02-13T20:54:17,Bilbao,expenses,transport,-56.68,2765.5
buyer_1,Luis,Garay,1996-08-10,22984418N,luis.garay@cooltech.tech,641191,ES45209531629390469205,4758.25,2022-02-15T18:39:40,Bilbao,expenses,food,-118.74,2646.76
buyer_1,Luis,Garay,1996-08-10,22984418N,luis.garay@cooltech.tech,641191,ES45209531629390469205,4758.25,2022-02-15T10:36:16,Bilbao,expenses,leisure,-19.5,2627.26
buyer_1,Luis,Garay,1996-08-10,22984418N,luis.garay@cooltech.tech,641191,ES45209531629390469205,4758.25,2022-02-15T10:33:19,Bilbao,expenses,healthcare,-183.93,2443.33
buyer_1,Luis,Garay,1996-08-10,22984418N,luis.garay@cooltech.tech,641191,ES45209531629390469205,4758.25,2022-02-16T13:22:17,Bilbao,expenses,cash,-100.0,2343.33
buyer_1,Luis,Garay,1996-08-10,22984418N,luis.garay@cooltech.tech,641191,ES45209531629390469205,4758.25,2022-02-17T11:15:15,Bilbao,expenses,transport,-84.56,2258.77
buyer_1,Luis,Garay,1996-08-10,22984418N,luis.garay@cooltech.tech,641191,ES45209531629390469205,4758.25,2022-02-17T21:59:40,Bilbao,expenses,education,-69.05,2189.72
buyer_1,Luis,Garay,1996-08-10,22984418N,luis.garay@cooltech.tech,641191,ES45209531629390469205,4758.25,2022-02-18T22:56:06,Bilbao,expenses,education,-44.45,2145.27
buyer_1,Luis,Garay,1996-08-10,22984418N,luis.garay@cooltech.tech,641191,ES45209531629390469205,4758.25,2022-02-19T19:12:06,Bilbao,expenses,cash,-100.0,2045.27
buyer_1,Luis,Garay,1996-08-10,22984418N,luis.garay@cooltech.tech,641191,ES45209531629390469205,4758.25,2022-02-20T09:02:10,Bilbao,expenses,food,-118.08,1927.19
buyer_1,Luis,Garay,1996-08-10,22984418N,luis.garay@cooltech.tech,641191,ES45209531629390469205,4758.25,2022-02-20T16:04:13,Bilbao,expenses,cash,-100.0,1827.19
buyer_1,Luis,Garay,1996-08-10,22984418N,luis.garay@cooltech.tech,641191,ES45209531629390469205,4758.25,2022-02-23T09:10:00,Bilbao,expenses,food,-110.95,1716.24
buyer_1,Luis,Garay,1996-08-10,22984418N,luis.garay@cooltech.tech,641191,ES45209531629390469205,4758.25,2022-02-23T18:44:10,Bilbao,expenses,leisure,-24.44,1691.8
buyer_1,Luis,Garay,1996-08-10,22984418N,luis.garay@cooltech.tech,641191,ES45209531629390469205,4758.25,2022-02-23T12:12:44,Bilbao,expenses,cash,-100.0,1591.8
buyer_1,Luis,Garay,1996-08-10,22984418N,luis.garay@cooltech.tech,641191,ES45209531629390469205,4758.25,2022-02-23T13:39:15,Bilbao,expenses,gifts,-318.99,1272.81
buyer_1,Luis,Garay,1996-08-10,22984418N,luis.garay@cooltech.tech,641191,ES45209531629390469205,4758.25,2022-02-24T22:04:54,Bilbao,expenses,leisure,-37.2,1235.61
buyer_1,Luis,Garay,1996-08-10,22984418N,luis.garay@cooltech.tech,641191,ES45209531629390469205,4758.25,2022-02-26T15:56:51,Bilbao,expenses,transport,-72.07,1163.54
buyer_1,Luis,Garay,1996-08-10,22984418N,luis.garay@cooltech.tech,641191,ES45209531629390469205,4758.25,2022-02-27T19:05:59,Bilbao,expenses,food,-65.96,1097.58
buyer_1,Luis,Garay,1996-08-10,22984418N,luis.garay@cooltech.tech,641191,ES45209531629390469205,4758.25,2022-02-27T00:37:01,Bilbao,expenses,travel,-359.08,738.5
buyer_1,Luis,Garay,1996-08-10,22984418N,luis.garay@cooltech.tech,641191,ES45209531629390469205,4758.25,2022-02-28T20:41:11,Bilbao,expenses,leisure,-77.19,661.31
buyer_1,Luis,Garay,1996-08-10,22984418N,luis.garay@cooltech.tech,641191,ES45209531629390469205,4758.25,2022-03-01T17:39:03,Bilbao,incomes,salary,1441.77,2103.08
buyer_1,Luis,Garay,1996-08-10,22984418N,luis.garay@cooltech.tech,641191,ES45209531629390469205,4758.25,2022-03-01T19:29:26,Bilbao,expenses,repairs,-75.94,2027.14
buyer_1,Luis,Garay,1996-08-10,22984418N,luis.garay@cooltech.tech,641191,ES45209531629390469205,4758.25,2022-03-04T08:03:25,Bilbao,expenses,rent,-488.24,1538.9
buyer_1,Luis,Garay,1996-08-10,22984418N,luis.garay@cooltech.tech,641191,ES45209531629390469205,4758.25,2022-03-04T19:29:59,Bilbao,expenses,transport,-44.59,1494.31
buyer_1,Luis,Garay,1996-08-10,22984418N,luis.garay@cooltech.tech,641191,ES45209531629390469205,4758.25,2022-03-05T12:30:16,Bilbao,expenses,electricity,-19.26,1475.05
buyer_1,Luis,Garay,1996-08-10,22984418N,luis.garay@cooltech.tech,641191,ES45209531629390469205,4758.25,2022-03-05T21:16:32,Bilbao,expenses,internet,-30.28,1444.77
buyer_1,Luis,Garay,1996-08-10,22984418N,luis.garay@cooltech.tech,641191,ES45209531629390469205,4758.25,2022-03-05T11:18:07,Bilbao,expenses,clothing,-45.53,1399.24
buyer_1,Luis,Garay,1996-08-10,22984418N,luis.garay@cooltech.tech,641191,ES45209531629390469205,4758.25,2022-03-06T15:44:50,Bilbao,expenses,car,-187.19,1212.05
buyer_1,Luis,Garay,1996-08-10,22984418N,luis.garay@cooltech.tech,641191,ES45209531629390469205,4758.25,2022-03-07T15:25:59,Bilbao,expenses,water,-18.3,1193.75
buyer_1,Luis,Garay,1996-08-10,22984418N,luis.garay@cooltech.tech,641191,ES45209531629390469205,4758.25,2022-03-07T20:08:33,Bilbao,expenses,cash,-100.0,1093.75
buyer_1,Luis,Garay,1996-08-10,22984418N,luis.garay@cooltech.tech,641191,ES45209531629390469205,4758.25,2022-03-08T17:34:31,Bilbao,expenses,gas,-65.65,1028.1
buyer_1,Luis,Garay,1996-08-10,22984418N,luis.garay@cooltech.tech,641191,ES45209531629390469205,4758.25,2022-03-08T13:19:30,Bilbao,expenses,phone,-25.46,1002.64
buyer_1,Luis,Garay,1996-08-10,22984418N,luis.garay@cooltech.tech,641191,ES45209531629390469205,4758.25,2022-03-08T09:18:42,Bilbao,expenses,gifts,-402.53,600.11
buyer_1,Luis,Garay,1996-08-10,22984418N,luis.garay@cooltech.tech,641191,ES45209531629390469205,4758.25,2022-03-09T15:50:22,Bilbao,expenses,food,-68.49,531.62
buyer_1,Luis,Garay,1996-08-10,22984418N,luis.garay@cooltech.tech,641191,ES45209531629390469205,4758.25,2022-03-09T18:20:05,Bilbao,expenses,gifts,-453.53,78.09
buyer_1,Luis,Garay,1996-08-10,22984418N,luis.garay@cooltech.tech,641191,ES45209531629390469205,4758.25,2022-03-15T11:17:07,Bilbao,expenses,food,-64.51,13.58
buyer_1,Luis,Garay,1996-08-10,22984418N,luis.garay@cooltech.tech,641191,ES45209531629390469205,4758.25,2022-03-15T21:40:34,Bilbao,expenses,leisure,-60.04,-46.46
buyer_1,Luis,Garay,1996-08-10,22984418N,luis.garay@cooltech.tech,641191,ES45209531629390469205,4758.25,2022-03-15T23:17:45,Bilbao,expenses,cash,-100.0,-146.46
buyer_1,Luis,Garay,1996-08-10,22984418N,luis.garay@cooltech.tech,641191,ES45209531629390469205,4758.25,2022-03-16T16:01:12,Bilbao,expenses,repairs,-163.19,-309.65
buyer_1,Luis,Garay,1996-08-10,22984418N,luis.garay@cooltech.tech,641191,ES45209531629390469205,4758.25,2022-03-17T19:31:10,Bilbao,expenses,leisure,-54.83,-364.48
buyer_1,Luis,Garay,1996-08-10,22984418N,luis.garay@cooltech.tech,641191,ES45209531629390469205,4758.25,2022-03-20T12:55:07,Bilbao,expenses,cash,-100.0,-464.48
buyer_1,Luis,Garay,1996-08-10,22984418N,luis.garay@cooltech.tech,641191,ES45209531629390469205,4758.25,2022-03-21T08:30:47,Bilbao,expenses,leisure,-41.13,-505.61
buyer_1,Luis,Garay,1996-08-10,22984418N,luis.garay@cooltech.tech,641191,ES45209531629390469205,4758.25,2022-03-21T17:02:23,Bilbao,expenses,healthcare,-130.6,-636.21
buyer_1,Luis,Garay,1996-08-10,22984418N,luis.garay@cooltech.tech,641191,ES45209531629390469205,4758.25,2022-03-21T19:22:38,Bilbao,expenses,education,-66.87,-703.08
buyer_1,Luis,Garay,1996-08-10,22984418N,luis.garay@cooltech.tech,641191,ES45209531629390469205,4758.25,2022-03-22T13:26:04,Bilbao,expenses,transport,-80.21,-783.29
buyer_1,Luis,Garay,1996-08-10,22984418N,luis.garay@cooltech.tech,641191,ES45209531629390469205,4758.25,2022-03-23T19:42:49,Bilbao,expenses,leisure,-65.17,-848.46
buyer_1,Luis,Garay,1996-08-10,22984418N,luis.garay@cooltech.tech,641191,ES45209531629390469205,4758.25,2022-03-24T08:38:00,Bilbao,expenses,leisure,-76.11,-924.57
buyer_1,Luis,Garay,1996-08-10,22984418N,luis.garay@cooltech.tech,641191,ES45209531629390469205,4758.25,2022-03-25T09:11:49,Bilbao,expenses,gifts,-305.41,-1229.98
buyer_1,Luis,Garay,1996-08-10,22984418N,luis.garay@cooltech.tech,641191,ES45209531629390469205,4758.25,2022-03-26T13:08:43,Bilbao,expenses,food,-100.06,-1330.04
buyer_1,Luis,Garay,1996-08-10,22984418N,luis.garay@cooltech.tech,641191,ES45209531629390469205,4758.25,2022-03-28T17:02:18,Bilbao,expenses,gifts,-314.16,-1644.2
buyer_1,Luis,Garay,1996-08-10,22984418N,luis.garay@cooltech.tech,641191,ES45209531629390469205,4758.25,2022-03-29T13:09:07,Bilbao,expenses,cash,-100.0,-1744.2
buyer_1,Luis,Garay,1996-08-10,22984418N,luis.garay@cooltech.tech,641191,ES45209531629390469205,4758.25,2022-04-01T13:18:00,Bilbao,incomes,salary,1441.77,-302.43
buyer_1,Luis,Garay,1996-08-10,22984418N,luis.garay@cooltech.tech,641191,ES45209531629390469205,4758.25,2022-04-01T13:18:00,Bilbao,incomes,extra_income,156.73,-145.7
buyer_1,Luis,Garay,1996-08-10,22984418N,luis.garay@cooltech.tech,641191,ES45209531629390469205,4758.25,2022-04-03T08:23:11,Bilbao,expenses,leisure,-55.69,-201.39
buyer_1,Luis,Garay,1996-08-10,22984418N,luis.garay@cooltech.tech,641191,ES45209531629390469205,4758.25,2022-04-04T16:38:18,Bilbao,expenses,rent,-488.24,-689.63
buyer_1,Luis,Garay,1996-08-10,22984418N,luis.garay@cooltech.tech,641191,ES45209531629390469205,4758.25,2022-04-07T16:38:08,Bilbao,expenses,water,-23.49,-713.12
buyer_1,Luis,Garay,1996-08-10,22984418N,luis.garay@cooltech.tech,641191,ES45209531629390469205,4758.25,2022-04-07T15:58:40,Bilbao,expenses,transport,-88.52,-801.64
buyer_1,Luis,Garay,1996-08-10,22984418N,luis.garay@cooltech.tech,641191,ES45209531629390469205,4758.25,2022-04-08T17:31:50,Bilbao,expenses,electricity,-28.99,-830.63
buyer_1,Luis,Garay,1996-08-10,22984418N,luis.garay@cooltech.tech,641191,ES45209531629390469205,4758.25,2022-04-08T09:53:44,Bilbao,expenses,gas,-59.93,-890.56
buyer_1,Luis,Garay,1996-08-10,22984418N,luis.garay@cooltech.tech,641191,ES45209531629390469205,4758.25,2022-04-08T15:17:36,Bilbao,expenses,internet,-30.28,-920.84
buyer_1,Luis,Garay,1996-08-10,22984418N,luis.garay@cooltech.tech,641191,ES45209531629390469205,4758.25,2022-04-08T20:31:15,Bilbao,expenses,phone,-27.35,-948.19
buyer_1,Luis,Garay,1996-08-10,22984418N,luis.garay@cooltech.tech,641191,ES45209531629390469205,4758.25,2022-04-08T08:12:48,Bilbao,expenses,appliances,-294.14,-1242.33
buyer_1,Luis,Garay,1996-08-10,22984418N,luis.garay@cooltech.tech,641191,ES45209531629390469205,4758.25,2022-04-11T09:49:50,Bilbao,expenses,food,-86.82,-1329.15
buyer_1,Luis,Garay,1996-08-10,22984418N,luis.garay@cooltech.tech,641191,ES45209531629390469205,4758.25,2022-04-11T06:23:03,Bilbao,expenses,leisure,-80.19,-1409.34
buyer_1,Luis,Garay,1996-08-10,22984418N,luis.garay@cooltech.tech,641191,ES45209531629390469205,4758.25,2022-04-11T08:44:59,Bilbao,expenses,travel,-413.46,-1822.8
buyer_1,Luis,Garay,1996-08-10,22984418N,luis.garay@cooltech.tech,641191,ES45209531629390469205,4758.25,2022-04-12T17:58:27,Bilbao,expenses,repairs,-115.73,-1938.53
buyer_1,Luis,Garay,1996-08-10,22984418N,luis.garay@cooltech.tech,641191,ES45209531629390469205,4758.25,2022-04-13T13:18:02,Bilbao,expenses,cash,-100.0,-2038.53
buyer_1,Luis,Garay,1996-08-10,22984418N,luis.garay@cooltech.tech,641191,ES45209531629390469205,4758.25,2022-04-14T20:47:28,Bilbao,expenses,transport,-86.47,-2125.0
buyer_1,Luis,Garay,1996-08-10,22984418N,luis.garay@cooltech.tech,641191,ES45209531629390469205,4758.25,2022-04-14T08:56:58,Bilbao,expenses,appliances,-190.68,-2315.68
buyer_1,Luis,Garay,1996-08-10,22984418N,luis.garay@cooltech.tech,641191,ES45209531629390469205,4758.25,2022-04-14T11:13:57,Bilbao,expenses,gifts,-171.53,-2487.21
buyer_1,Luis,Garay,1996-08-10,22984418N,luis.garay@cooltech.tech,641191,ES45209531629390469205,4758.25,2022-04-15T10:42:18,Bilbao,expenses,cash,-100.0,-2587.21
buyer_1,Luis,Garay,1996-08-10,22984418N,luis.garay@cooltech.tech,641191,ES45209531629390469205,4758.25,2022-04-18T07:58:50,Bilbao,expenses,transport,-86.19,-2673.4
buyer_1,Luis,Garay,1996-08-10,22984418N,luis.garay@cooltech.tech,641191,ES45209531629390469205,4758.25,2022-04-20T12:11:47,Bilbao,expenses,food,-93.73,-2767.13
buyer_1,Luis,Garay,1996-08-10,22984418N,luis.garay@cooltech.tech,641191,ES45209531629390469205,4758.25,2022-04-21T19:09:28,Bilbao,expenses,healthcare,-165.34,-2932.47
buyer_1,Luis,Garay,1996-08-10,22984418N,luis.garay@cooltech.tech,641191,ES45209531629390469205,4758.25,2022-04-21T09:03:36,Bilbao,expenses,repairs,-50.35,-2982.82
buyer_1,Luis,Garay,1996-08-10,22984418N,luis.garay@cooltech.tech,641191,ES45209531629390469205,4758.25,2022-04-22T21:21:37,Bilbao,expenses,leisure,-27.97,-3010.79
buyer_1,Luis,Garay,1996-08-10,22984418N,luis.garay@cooltech.tech,641191,ES45209531629390469205,4758.25,2022-04-24T23:00:09,Bilbao,expenses,cash,-100.0,-3110.79
buyer_1,Luis,Garay,1996-08-10,22984418N,luis.garay@cooltech.tech,641191,ES45209531629390469205,4758.25,2022-04-25T20:42:42,Bilbao,expenses,gifts,-207.33,-3318.12
buyer_1,Luis,Garay,1996-08-10,22984418N,luis.garay@cooltech.tech,641191,ES45209531629390469205,4758.25,2022-04-27T22:23:18,Bilbao,expenses,education,-59.46,-3377.58
buyer_1,Luis,Garay,1996-08-10,22984418N,luis.garay@cooltech.tech,641191,ES45209531629390469205,4758.25,2022-04-27T05:14:50,Bilbao,expenses,cash,-100.0,-3477.58
buyer_1,Luis,Garay,1996-08-10,22984418N,luis.garay@cooltech.tech,641191,ES45209531629390469205,4758.25,2022-04-28T03:26:51,Bilbao,expenses,food,-123.93,-3601.51
buyer_1,Luis,Garay,1996-08-10,22984418N,luis.garay@cooltech.tech,641191,ES45209531629390469205,4758.25,2022-04-28T19:28:45,Bilbao,expenses,repairs,-245.46,-3846.97
buyer_1,Luis,Garay,1996-08-10,22984418N,luis.garay@cooltech.tech,641191,ES45209531629390469205,4758.25,2022-04-30T15:09:47,Bilbao,expenses,clothing,-125.76,-3972.73
buyer_1,Luis,Garay,1996-08-10,22984418N,luis.garay@cooltech.tech,641191,ES45209531629390469205,4758.25,2022-05-01T09:38:27,Bilbao,incomes,salary,1441.77,-2530.96
buyer_1,Luis,Garay,1996-08-10,22984418N,luis.garay@cooltech.tech,641191,ES45209531629390469205,4758.25,2022-05-01T11:18:28,Bilbao,expenses,transport,-43.84,-2574.8
buyer_1,Luis,Garay,1996-08-10,22984418N,luis.garay@cooltech.tech,641191,ES45209531629390469205,4758.25,2022-05-01T18:01:21,Bilbao,expenses,leisure,-53.93,-2628.73
buyer_1,Luis,Garay,1996-08-10,22984418N,luis.garay@cooltech.tech,641191,ES45209531629390469205,4758.25,2022-05-01T12:07:11,Bilbao,expenses,repairs,-89.97,-2718.7
buyer_1,Luis,Garay,1996-08-10,22984418N,luis.garay@cooltech.tech,641191,ES45209531629390469205,4758.25,2022-05-04T15:05:03,Bilbao,expenses,rent,-488.24,-3206.94
buyer_1,Luis,Garay,1996-08-10,22984418N,luis.garay@cooltech.tech,641191,ES45209531629390469205,4758.25,2022-05-04T22:54:49,Bilbao,expenses,healthcare,-88.46,-3295.4
buyer_1,Luis,Garay,1996-08-10,22984418N,luis.garay@cooltech.tech,641191,ES45209531629390469205,4758.25,2022-05-05T02:10:31,Bilbao,expenses,gas,-39.64,-3335.04
buyer_1,Luis,Garay,1996-08-10,22984418N,luis.garay@cooltech.tech,641191,ES45209531629390469205,4758.25,2022-05-05T05:10:19,Bilbao,expenses,education,-62.25,-3397.29
buyer_1,Luis,Garay,1996-08-10,22984418N,luis.garay@cooltech.tech,641191,ES45209531629390469205,4758.25,2022-05-07T12:41:43,Bilbao,expenses,internet,-30.28,-3427.57
buyer_1,Luis,Garay,1996-08-10,22984418N,luis.garay@cooltech.tech,641191,ES45209531629390469205,4758.25,2022-05-08T18:44:15,Bilbao,expenses,phone,-31.81,-3459.38
buyer_1,Luis,Garay,1996-08-10,22984418N,luis.garay@cooltech.tech,641191,ES45209531629390469205,4758.25,2022-05-08T08:44:33,Bilbao,expenses,water,-21.62,-3481.0
buyer_1,Luis,Garay,1996-08-10,22984418N,luis.garay@cooltech.tech,641191,ES45209531629390469205,4758.25,2022-05-08T05:49:04,Bilbao,expenses,electricity,-27.81,-3508.81
buyer_1,Luis,Garay,1996-08-10,22984418N,luis.garay@cooltech.tech,641191,ES45209531629390469205,4758.25,2022-05-08T11:18:10,Bilbao,expenses,repairs,-264.81,-3773.62
buyer_1,Luis,Garay,1996-08-10,22984418N,luis.garay@cooltech.tech,641191,ES45209531629390469205,4758.25,2022-05-09T10:04:06,Bilbao,expenses,gifts,-509.69,-4283.31
buyer_1,Luis,Garay,1996-08-10,22984418N,luis.garay@cooltech.tech,641191,ES45209531629390469205,4758.25,2022-05-10T09:01:24,Bilbao,expenses,transport,-67.39,-4350.7
buyer_1,Luis,Garay,1996-08-10,22984418N,luis.garay@cooltech.tech,641191,ES45209531629390469205,4758.25,2022-05-10T23:50:46,Bilbao,expenses,cash,-100.0,-4450.7
buyer_1,Luis,Garay,1996-08-10,22984418N,luis.garay@cooltech.tech,641191,ES45209531629390469205,4758.25,2022-05-11T05:33:42,Bilbao,expenses,healthcare,-39.21,-4489.91
buyer_1,Luis,Garay,1996-08-10,22984418N,luis.garay@cooltech.tech,641191,ES45209531629390469205,4758.25,2022-05-12T17:13:23,Bilbao,expenses,transport,-45.73,-4535.64
buyer_1,Luis,Garay,1996-08-10,22984418N,luis.garay@cooltech.tech,641191,ES45209531629390469205,4758.25,2022-05-13T19:19:07,Bilbao,expenses,healthcare,-174.48,-4710.12
buyer_1,Luis,Garay,1996-08-10,22984418N,luis.garay@cooltech.tech,641191,ES45209531629390469205,4758.25,2022-05-13T16:57:12,Bilbao,expenses,cash,-100.0,-4810.12
buyer_1,Luis,Garay,1996-08-10,22984418N,luis.garay@cooltech.tech,641191,ES45209531629390469205,4758.25,2022-05-13T17:31:29,Bilbao,expenses,gifts,-215.5,-5025.62
buyer_1,Luis,Garay,1996-08-10,22984418N,luis.garay@cooltech.tech,641191,ES45209531629390469205,4758.25,2022-05-15T11:45:36,Bilbao,expenses,transport,-85.72,-5111.34
buyer_1,Luis,Garay,1996-08-10,22984418N,luis.garay@cooltech.tech,641191,ES45209531629390469205,4758.25,2022-05-15T19:56:41,Bilbao,expenses,gifts,-47.25,-5158.59
buyer_1,Luis,Garay,1996-08-10,22984418N,luis.garay@cooltech.tech,641191,ES45209531629390469205,4758.25,2022-05-17T14:48:28,Bilbao,expenses,travel,-450.1,-5608.69
buyer_1,Luis,Garay,1996-08-10,22984418N,luis.garay@cooltech.tech,641191,ES45209531629390469205,4758.25,2022-05-19T02:37:15,Bilbao,expenses,car,-79.35,-5688.04
buyer_1,Luis,Garay,1996-08-10,22984418N,luis.garay@cooltech.tech,641191,ES45209531629390469205,4758.25,2022-05-20T09:50:47,Bilbao,expenses,cash,-100.0,-5788.04
buyer_1,Luis,Garay,1996-08-10,22984418N,luis.garay@cooltech.tech,641191,ES45209531629390469205,4758.25,2022-05-21T14:10:41,Bilbao,expenses,transport,-61.21,-5849.25
buyer_1,Luis,Garay,1996-08-10,22984418N,luis.garay@cooltech.tech,641191,ES45209531629390469205,4758.25,2022-05-26T11:12:21,Bilbao,expenses,food,-63.38,-5912.63
buyer_1,Luis,Garay,1996-08-10,22984418N,luis.garay@cooltech.tech,641191,ES45209531629390469205,4758.25,2022-05-27T13:28:09,Bilbao,expenses,cash,-100.0,-6012.63
buyer_1,Luis,Garay,1996-08-10,22984418N,luis.garay@cooltech.tech,641191,ES45209531629390469205,4758.25,2022-05-29T17:55:53,Bilbao,expenses,food,-83.24,-6095.87
buyer_1,Luis,Garay,1996-08-10,22984418N,luis.garay@cooltech.tech,641191,ES45209531629390469205,4758.25,2022-05-29T16:22:58,Bilbao,expenses,education,-57.86,-6153.73
buyer_1,Luis,Garay,1996-08-10,22984418N,luis.garay@cooltech.tech,641191,ES45209531629390469205,4758.25,2022-05-29T05:26:14,Bilbao,expenses,travel,-439.3,-6593.03
buyer_1,Luis,Garay,1996-08-10,22984418N,luis.garay@cooltech.tech,641191,ES45209531629390469205,4758.25,2022-05-30T00:52:57,Bilbao,expenses,gifts,-512.1,-7105.13
buyer_1,Luis,Garay,1996-08-10,22984418N,luis.garay@cooltech.tech,641191,ES45209531629390469205,4758.25,2022-05-31T19:35:37,Bilbao,expenses,leisure,-77.53,-7182.66
buyer_1,Luis,Garay,1996-08-10,22984418N,luis.garay@cooltech.tech,641191,ES45209531629390469205,4758.25,2022-06-01T11:27:54,Bilbao,incomes,salary,1441.77,-5740.89
buyer_1,Luis,Garay,1996-08-10,22984418N,luis.garay@cooltech.tech,641191,ES45209531629390469205,4758.25,2022-06-01T11:27:54,Bilbao,incomes,salary_bonus,1055.07,-4685.82
buyer_1,Luis,Garay,1996-08-10,22984418N,luis.garay@cooltech.tech,641191,ES45209531629390469205,4758.25,2022-06-01T14:27:06,Bilbao,expenses,leisure,-31.54,-4717.36
buyer_1,Luis,Garay,1996-08-10,22984418N,luis.garay@cooltech.tech,641191,ES45209531629390469205,4758.25,2022-06-01T21:26:45,Bilbao,expenses,gifts,-285.94,-5003.3
buyer_1,Luis,Garay,1996-08-10,22984418N,luis.garay@cooltech.tech,641191,ES45209531629390469205,4758.25,2022-06-02T08:23:55,Bilbao,expenses,food,-65.57,-5068.87
buyer_1,Luis,Garay,1996-08-10,22984418N,luis.garay@cooltech.tech,641191,ES45209531629390469205,4758.25,2022-06-03T23:01:34,Bilbao,expenses,taxes,-961.88,-6030.75
buyer_1,Luis,Garay,1996-08-10,22984418N,luis.garay@cooltech.tech,641191,ES45209531629390469205,4758.25,2022-06-03T12:51:55,Bilbao,expenses,insurance,-340.45,-6371.2
buyer_1,Luis,Garay,1996-08-10,22984418N,luis.garay@cooltech.tech,641191,ES45209531629390469205,4758.25,2022-06-03T19:10:31,Bilbao,expenses,food,-120.11,-6491.31
buyer_1,Luis,Garay,1996-08-10,22984418N,luis.garay@cooltech.tech,641191,ES45209531629390469205,4758.25,2022-06-04T11:49:53,Bilbao,expenses,rent,-488.24,-6979.55
buyer_1,Luis,Garay,1996-08-10,22984418N,luis.garay@cooltech.tech,641191,ES45209531629390469205,4758.25,2022-06-05T21:37:37,Bilbao,expenses,gifts,-166.12,-7145.67
buyer_1,Luis,Garay,1996-08-10,22984418N,luis.garay@cooltech.tech,641191,ES45209531629390469205,4758.25,2022-06-06T08:07:16,Bilbao,expenses,water,-18.14,-7163.81
buyer_1,Luis,Garay,1996-08-10,22984418N,luis.garay@cooltech.tech,641191,ES45209531629390469205,4758.25,2022-06-07T09:37:04,Bilbao,expenses,internet,-30.28,-7194.09
buyer_1,Luis,Garay,1996-08-10,22984418N,luis.garay@cooltech.tech,641191,ES45209531629390469205,4758.25,2022-06-08T21:08:48,Bilbao,expenses,phone,-23.45,-7217.54
buyer_1,Luis,Garay,1996-08-10,22984418N,luis.garay@cooltech.tech,641191,ES45209531629390469205,4758.25,2022-06-08T09:09:36,Bilbao,expenses,electricity,-21.81,-7239.35
buyer_1,Luis,Garay,1996-08-10,22984418N,luis.garay@cooltech.tech,641191,ES45209531629390469205,4758.25,2022-06-08T13:31:52,Bilbao,expenses,gas,-82.14,-7321.49
buyer_1,Luis,Garay,1996-08-10,22984418N,luis.garay@cooltech.tech,641191,ES45209531629390469205,4758.25,2022-06-09T09:10:41,Bilbao,expenses,food,-123.75,-7445.24
buyer_1,Luis,Garay,1996-08-10,22984418N,luis.garay@cooltech.tech,641191,ES45209531629390469205,4758.25,2022-06-09T09:30:00,Bilbao,expenses,cash,-100.0,-7545.24
buyer_1,Luis,Garay,1996-08-10,22984418N,luis.garay@cooltech.tech,641191,ES45209531629390469205,4758.25,2022-06-10T12:36:20,Bilbao,expenses,gifts,-95.37,-7640.61
buyer_1,Luis,Garay,1996-08-10,22984418N,luis.garay@cooltech.tech,641191,ES45209531629390469205,4758.25,2022-06-11T05:38:47,Bilbao,expenses,food,-62.28,-7702.89
buyer_1,Luis,Garay,1996-08-10,22984418N,luis.garay@cooltech.tech,641191,ES45209531629390469205,4758.25,2022-06-12T03:51:04,Bilbao,expenses,leisure,-65.73,-7768.62
buyer_1,Luis,Garay,1996-08-10,22984418N,luis.garay@cooltech.tech,641191,ES45209531629390469205,4758.25,2022-06-12T22:42:00,Bilbao,expenses,gifts,-74.42,-7843.04
buyer_1,Luis,Garay,1996-08-10,22984418N,luis.garay@cooltech.tech,641191,ES45209531629390469205,4758.25,2022-06-14T20:32:19,Bilbao,expenses,gifts,-446.72,-8289.76
buyer_1,Luis,Garay,1996-08-10,22984418N,luis.garay@cooltech.tech,641191,ES45209531629390469205,4758.25,2022-06-17T16:54:36,Bilbao,expenses,cash,-100.0,-8389.76
buyer_1,Luis,Garay,1996-08-10,22984418N,luis.garay@cooltech.tech,641191,ES45209531629390469205,4758.25,2022-06-19T09:01:02,Bilbao,expenses,food,-80.15,-8469.91
buyer_1,Luis,Garay,1996-08-10,22984418N,luis.garay@cooltech.tech,641191,ES45209531629390469205,4758.25,2022-06-19T09:17:22,Bilbao,expenses,clothing,-117.91,-8587.82
buyer_1,Luis,Garay,1996-08-10,22984418N,luis.garay@cooltech.tech,641191,ES45209531629390469205,4758.25,2022-06-20T19:07:40,Bilbao,expenses,food,-122.15,-8709.97
buyer_1,Luis,Garay,1996-08-10,22984418N,luis.garay@cooltech.tech,641191,ES45209531629390469205,4758.25,2022-06-22T19:42:16,Bilbao,expenses,transport,-62.0,-8771.97
buyer_1,Luis,Garay,1996-08-10,22984418N,luis.garay@cooltech.tech,641191,ES45209531629390469205,4758.25,2022-06-23T17:59:54,Bilbao,expenses,appliances,-155.94,-8927.91
buyer_1,Luis,Garay,1996-08-10,22984418N,luis.garay@cooltech.tech,641191,ES45209531629390469205,4758.25,2022-06-24T12:04:56,Bilbao,expenses,transport,-45.62,-8973.53
buyer_1,Luis,Garay,1996-08-10,22984418N,luis.garay@cooltech.tech,641191,ES45209531629390469205,4758.25,2022-06-24T19:09:33,Bilbao,expenses,cash,-100.0,-9073.53
buyer_1,Luis,Garay,1996-08-10,22984418N,luis.garay@cooltech.tech,641191,ES45209531629390469205,4758.25,2022-06-25T16:55:24,Bilbao,expenses,cash,-100.0,-9173.53
buyer_1,Luis,Garay,1996-08-10,22984418N,luis.garay@cooltech.tech,641191,ES45209531629390469205,4758.25,2022-06-26T19:22:49,Bilbao,expenses,travel,-550.3,-9723.83
buyer_1,Luis,Garay,1996-08-10,22984418N,luis.garay@cooltech.tech,641191,ES45209531629390469205,4758.25,2022-06-28T10:05:07,Bilbao,expenses,food,-90.05,-9813.88
buyer_1,Luis,Garay,1996-08-10,22984418N,luis.garay@cooltech.tech,641191,ES45209531629390469205,4758.25,2022-06-28T14:53:26,Bilbao,expenses,cash,-100.0,-9913.88
buyer_1,Luis,Garay,1996-08-10,22984418N,luis.garay@cooltech.tech,641191,ES45209531629390469205,4758.25,2022-06-29T18:38:01,Bilbao,expenses,healthcare,-131.56,-10045.44
buyer_1,Luis,Garay,1996-08-10,22984418N,luis.garay@cooltech.tech,641191,ES45209531629390469205,4758.25,2022-06-29T18:31:08,Bilbao,expenses,cash,-100.0,-10145.44
buyer_1,Luis,Garay,1996-08-10,22984418N,luis.garay@cooltech.tech,641191,ES45209531629390469205,4758.25,2022-06-29T08:06:59,Bilbao,expenses,repairs,-119.01,-10264.45
buyer_1,Luis,Garay,1996-08-10,22984418N,luis.garay@cooltech.tech,641191,ES45209531629390469205,4758.25,2022-06-30T22:19:25,Bilbao,expenses,travel,-459.29,-10723.74
buyer_1,Luis,Garay,1996-08-10,22984418N,luis.garay@cooltech.tech,641191,ES45209531629390469205,4758.25,2022-07-01T03:06:52,Bilbao,incomes,salary,1441.77,-9281.97
buyer_1,Luis,Garay,1996-08-10,22984418N,luis.garay@cooltech.tech,641191,ES45209531629390469205,4758.25,2022-07-01T03:06:52,Bilbao,incomes,extra_income,156.73,-9125.24
buyer_1,Luis,Garay,1996-08-10,22984418N,luis.garay@cooltech.tech,641191,ES45209531629390469205,4758.25,2022-07-01T14:10:45,Bilbao,expenses,food,-72.53,-9197.77
buyer_1,Luis,Garay,1996-08-10,22984418N,luis.garay@cooltech.tech,641191,ES45209531629390469205,4758.25,2022-07-01T12:31:29,Bilbao,expenses,transport,-42.06,-9239.83
buyer_1,Luis,Garay,1996-08-10,22984418N,luis.garay@cooltech.tech,641191,ES45209531629390469205,4758.25,2022-07-02T08:10:36,Bilbao,expenses,transport,-46.45,-9286.28
buyer_1,Luis,Garay,1996-08-10,22984418N,luis.garay@cooltech.tech,641191,ES45209531629390469205,4758.25,2022-07-02T13:02:16,Bilbao,expenses,healthcare,-70.16,-9356.44
buyer_1,Luis,Garay,1996-08-10,22984418N,luis.garay@cooltech.tech,641191,ES45209531629390469205,4758.25,2022-07-02T11:33:45,Bilbao,expenses,education,-62.14,-9418.58
buyer_1,Luis,Garay,1996-08-10,22984418N,luis.garay@cooltech.tech,641191,ES45209531629390469205,4758.25,2022-07-03T12:49:16,Bilbao,expenses,leisure,-42.02,-9460.6
buyer_1,Luis,Garay,1996-08-10,22984418N,luis.garay@cooltech.tech,641191,ES45209531629390469205,4758.25,2022-07-04T12:50:20,Bilbao,expenses,rent,-488.24,-9948.84
buyer_1,Luis,Garay,1996-08-10,22984418N,luis.garay@cooltech.tech,641191,ES45209531629390469205,4758.25,2022-07-04T23:08:37,Bilbao,expenses,cash,-100.0,-10048.84
buyer_1,Luis,Garay,1996-08-10,22984418N,luis.garay@cooltech.tech,641191,ES45209531629390469205,4758.25,2022-07-05T16:08:32,Bilbao,expenses,electricity,-23.97,-10072.81
buyer_1,Luis,Garay,1996-08-10,22984418N,luis.garay@cooltech.tech,641191,ES45209531629390469205,4758.25,2022-07-05T15:00:42,Bilbao,expenses,gas,-62.46,-10135.27
buyer_1,Luis,Garay,1996-08-10,22984418N,luis.garay@cooltech.tech,641191,ES45209531629390469205,4758.25,2022-07-05T09:08:38,Bilbao,expenses,food,-100.57,-10235.84
buyer_1,Luis,Garay,1996-08-10,22984418N,luis.garay@cooltech.tech,641191,ES45209531629390469205,4758.25,2022-07-05T11:21:18,Bilbao,expenses,education,-68.0,-10303.84
buyer_1,Luis,Garay,1996-08-10,22984418N,luis.garay@cooltech.tech,641191,ES45209531629390469205,4758.25,2022-07-06T09:24:14,Bilbao,expenses,water,-22.21,-10326.05
buyer_1,Luis,Garay,1996-08-10,22984418N,luis.garay@cooltech.tech,641191,ES45209531629390469205,4758.25,2022-07-08T18:29:24,Bilbao,expenses,internet,-30.28,-10356.33
buyer_1,Luis,Garay,1996-08-10,22984418N,luis.garay@cooltech.tech,641191,ES45209531629390469205,4758.25,2022-07-08T12:29:59,Bilbao,expenses,phone,-22.23,-10378.56
buyer_1,Luis,Garay,1996-08-10,22984418N,luis.garay@cooltech.tech,641191,ES45209531629390469205,4758.25,2022-07-08T07:05:13,Bilbao,expenses,food,-113.54,-10492.1
buyer_1,Luis,Garay,1996-08-10,22984418N,luis.garay@cooltech.tech,641191,ES45209531629390469205,4758.25,2022-07-08T15:27:41,Bilbao,expenses,transport,-41.45,-10533.55
buyer_1,Luis,Garay,1996-08-10,22984418N,luis.garay@cooltech.tech,641191,ES45209531629390469205,4758.25,2022-07-09T16:13:11,Bilbao,expenses,education,-50.56,-10584.11
buyer_1,Luis,Garay,1996-08-10,22984418N,luis.garay@cooltech.tech,641191,ES45209531629390469205,4758.25,2022-07-14T20:21:25,Bilbao,expenses,education,-47.23,-10631.34
buyer_1,Luis,Garay,1996-08-10,22984418N,luis.garay@cooltech.tech,641191,ES45209531629390469205,4758.25,2022-07-16T13:40:40,Bilbao,expenses,leisure,-46.1,-10677.44
buyer_1,Luis,Garay,1996-08-10,22984418N,luis.garay@cooltech.tech,641191,ES45209531629390469205,4758.25,2022-07-17T19:36:11,Bilbao,expenses,clothing,-159.7,-10837.14
buyer_1,Luis,Garay,1996-08-10,22984418N,luis.garay@cooltech.tech,641191,ES45209531629390469205,4758.25,2022-07-19T03:33:49,Bilbao,expenses,repairs,-176.76,-11013.9
buyer_1,Luis,Garay,1996-08-10,22984418N,luis.garay@cooltech.tech,641191,ES45209531629390469205,4758.25,2022-07-23T20:53:09,Bilbao,expenses,education,-50.69,-11064.59
buyer_1,Luis,Garay,1996-08-10,22984418N,luis.garay@cooltech.tech,641191,ES45209531629390469205,4758.25,2022-07-24T07:49:23,Bilbao,expenses,food,-83.88,-11148.47
buyer_1,Luis,Garay,1996-08-10,22984418N,luis.garay@cooltech.tech,641191,ES45209531629390469205,4758.25,2022-07-24T11:47:13,Bilbao,expenses,transport,-69.03,-11217.5
buyer_1,Luis,Garay,1996-08-10,22984418N,luis.garay@cooltech.tech,641191,ES45209531629390469205,4758.25,2022-07-24T16:50:59,Bilbao,expenses,clothing,-142.75,-11360.25
buyer_1,Luis,Garay,1996-08-10,22984418N,luis.garay@cooltech.tech,641191,ES45209531629390469205,4758.25,2022-07-28T12:46:38,Bilbao,expenses,leisure,-31.85,-11392.1
buyer_1,Luis,Garay,1996-08-10,22984418N,luis.garay@cooltech.tech,641191,ES45209531629390469205,4758.25,2022-07-31T17:19:55,Bilbao,expenses,food,-76.46,-11468.56
buyer_1,Luis,Garay,1996-08-10,22984418N,luis.garay@cooltech.tech,641191,ES45209531629390469205,4758.25,2022-07-31T22:02:25,Bilbao,expenses,gifts,-193.66,-11662.22
buyer_1,Luis,Garay,1996-08-10,22984418N,luis.garay@cooltech.tech,641191,ES45209531629390469205,4758.25,2022-08-01T09:55:16,Bilbao,incomes,salary,1441.77,-10220.45
buyer_1,Luis,Garay,1996-08-10,22984418N,luis.garay@cooltech.tech,641191,ES45209531629390469205,4758.25,2022-08-01T20:39:48,Bilbao,expenses,repairs,-204.57,-10425.02
buyer_1,Luis,Garay,1996-08-10,22984418N,luis.garay@cooltech.tech,641191,ES45209531629390469205,4758.25,2022-08-02T17:41:58,Bilbao,expenses,gifts,-370.13,-10795.15
buyer_1,Luis,Garay,1996-08-10,22984418N,luis.garay@cooltech.tech,641191,ES45209531629390469205,4758.25,2022-08-03T12:41:53,Bilbao,expenses,clothing,-98.68,-10893.83
buyer_1,Luis,Garay,1996-08-10,22984418N,luis.garay@cooltech.tech,641191,ES45209531629390469205,4758.25,2022-08-04T15:23:31,Bilbao,expenses,rent,-488.24,-11382.07
buyer_1,Luis,Garay,1996-08-10,22984418N,luis.garay@cooltech.tech,641191,ES45209531629390469205,4758.25,2022-08-04T09:54:45,Bilbao,expenses,cash,-100.0,-11482.07
buyer_1,Luis,Garay,1996-08-10,22984418N,luis.garay@cooltech.tech,641191,ES45209531629390469205,4758.25,2022-08-05T20:10:11,Bilbao,expenses,internet,-30.28,-11512.35
buyer_1,Luis,Garay,1996-08-10,22984418N,luis.garay@cooltech.tech,641191,ES45209531629390469205,4758.25,2022-08-07T16:23:13,Bilbao,expenses,phone,-31.77,-11544.12
buyer_1,Luis,Garay,1996-08-10,22984418N,luis.garay@cooltech.tech,641191,ES45209531629390469205,4758.25,2022-08-08T09:09:44,Bilbao,expenses,gas,-48.63,-11592.75
buyer_1,Luis,Garay,1996-08-10,22984418N,luis.garay@cooltech.tech,641191,ES45209531629390469205,4758.25,2022-08-08T21:59:03,Bilbao,expenses,water,-27.71,-11620.46
buyer_1,Luis,Garay,1996-08-10,22984418N,luis.garay@cooltech.tech,641191,ES45209531629390469205,4758.25,2022-08-08T00:39:29,Bilbao,expenses,electricity,-50.32,-11670.78
buyer_1,Luis,Garay,1996-08-10,22984418N,luis.garay@cooltech.tech,641191,ES45209531629390469205,4758.25,2022-08-09T21:01:33,Bilbao,expenses,cash,-100.0,-11770.78
buyer_1,Luis,Garay,1996-08-10,22984418N,luis.garay@cooltech.tech,641191,ES45209531629390469205,4758.25,2022-08-12T19:50:00,Bilbao,expenses,cash,-100.0,-11870.78
buyer_1,Luis,Garay,1996-08-10,22984418N,luis.garay@cooltech.tech,641191,ES45209531629390469205,4758.25,2022-08-13T13:49:37,Bilbao,expenses,appliances,-79.06,-11949.84
buyer_1,Luis,Garay,1996-08-10,22984418N,luis.garay@cooltech.tech,641191,ES45209531629390469205,4758.25,2022-08-15T11:49:08,Bilbao,expenses,food,-82.25,-12032.09
buyer_1,Luis,Garay,1996-08-10,22984418N,luis.garay@cooltech.tech,641191,ES45209531629390469205,4758.25,2022-08-15T20:29:10,Bilbao,expenses,transport,-85.37,-12117.46
buyer_1,Luis,Garay,1996-08-10,22984418N,luis.garay@cooltech.tech,641191,ES45209531629390469205,4758.25,2022-08-16T11:01:45,Bilbao,expenses,food,-118.0,-12235.46
buyer_1,Luis,Garay,1996-08-10,22984418N,luis.garay@cooltech.tech,641191,ES45209531629390469205,4758.25,2022-08-18T23:17:36,Bilbao,expenses,gifts,-108.9,-12344.36
buyer_1,Luis,Garay,1996-08-10,22984418N,luis.garay@cooltech.tech,641191,ES45209531629390469205,4758.25,2022-08-20T12:21:37,Bilbao,expenses,repairs,-199.8,-12544.16
buyer_1,Luis,Garay,1996-08-10,22984418N,luis.garay@cooltech.tech,641191,ES45209531629390469205,4758.25,2022-08-20T14:39:42,Bilbao,expenses,gifts,-361.58,-12905.74
buyer_1,Luis,Garay,1996-08-10,22984418N,luis.garay@cooltech.tech,641191,ES45209531629390469205,4758.25,2022-08-21T01:44:20,Bilbao,expenses,healthcare,-169.02,-13074.76
buyer_1,Luis,Garay,1996-08-10,22984418N,luis.garay@cooltech.tech,641191,ES45209531629390469205,4758.25,2022-08-22T09:53:06,Bilbao,expenses,food,-108.25,-13183.01
buyer_1,Luis,Garay,1996-08-10,22984418N,luis.garay@cooltech.tech,641191,ES45209531629390469205,4758.25,2022-08-22T17:25:47,Bilbao,expenses,healthcare,-103.58,-13286.59
buyer_1,Luis,Garay,1996-08-10,22984418N,luis.garay@cooltech.tech,641191,ES45209531629390469205,4758.25,2022-08-22T12:18:41,Bilbao,expenses,education,-62.13,-13348.72
buyer_1,Luis,Garay,1996-08-10,22984418N,luis.garay@cooltech.tech,641191,ES45209531629390469205,4758.25,2022-08-23T14:39:26,Bilbao,expenses,transport,-46.72,-13395.44
buyer_1,Luis,Garay,1996-08-10,22984418N,luis.garay@cooltech.tech,641191,ES45209531629390469205,4758.25,2022-08-24T12:37:18,Bilbao,expenses,transport,-45.67,-13441.11
buyer_1,Luis,Garay,1996-08-10,22984418N,luis.garay@cooltech.tech,641191,ES45209531629390469205,4758.25,2022-08-27T16:14:02,Bilbao,expenses,education,-61.36,-13502.47
buyer_1,Luis,Garay,1996-08-10,22984418N,luis.garay@cooltech.tech,641191,ES45209531629390469205,4758.25,2022-08-28T19:08:15,Bilbao,expenses,cash,-100.0,-13602.47
buyer_1,Luis,Garay,1996-08-10,22984418N,luis.garay@cooltech.tech,641191,ES45209531629390469205,4758.25,2022-08-31T17:58:35,Bilbao,expenses,transport,-43.65,-13646.12
buyer_1,Luis,Garay,1996-08-10,22984418N,luis.garay@cooltech.tech,641191,ES45209531629390469205,4758.25,2022-09-01T09:26:34,Bilbao,incomes,salary,1441.77,-12204.35
buyer_1,Luis,Garay,1996-08-10,22984418N,luis.garay@cooltech.tech,641191,ES45209531629390469205,4758.25,2022-09-02T02:23:22,Bilbao,expenses,transport,-67.26,-12271.61
buyer_1,Luis,Garay,1996-08-10,22984418N,luis.garay@cooltech.tech,641191,ES45209531629390469205,4758.25,2022-09-02T03:48:08,Bilbao,expenses,leisure,-27.35,-12298.96
buyer_1,Luis,Garay,1996-08-10,22984418N,luis.garay@cooltech.tech,641191,ES45209531629390469205,4758.25,2022-09-04T11:01:48,Bilbao,expenses,rent,-488.24,-12787.2
buyer_1,Luis,Garay,1996-08-10,22984418N,luis.garay@cooltech.tech,641191,ES45209531629390469205,4758.25,2022-09-05T20:55:48,Bilbao,expenses,internet,-30.28,-12817.48
buyer_1,Luis,Garay,1996-08-10,22984418N,luis.garay@cooltech.tech,641191,ES45209531629390469205,4758.25,2022-09-05T17:30:54,Bilbao,expenses,food,-119.61,-12937.09
buyer_1,Luis,Garay,1996-08-10,22984418N,luis.garay@cooltech.tech,641191,ES45209531629390469205,4758.25,2022-09-05T19:12:42,Bilbao,expenses,appliances,-134.22,-13071.31
buyer_1,Luis,Garay,1996-08-10,22984418N,luis.garay@cooltech.tech,641191,ES45209531629390469205,4758.25,2022-09-06T15:19:06,Bilbao,expenses,phone,-24.86,-13096.17
buyer_1,Luis,Garay,1996-08-10,22984418N,luis.garay@cooltech.tech,641191,ES45209531629390469205,4758.25,2022-09-07T20:40:53,Bilbao,expenses,transport,-48.91,-13145.08
buyer_1,Luis,Garay,1996-08-10,22984418N,luis.garay@cooltech.tech,641191,ES45209531629390469205,4758.25,2022-09-07T08:46:01,Bilbao,expenses,education,-55.0,-13200.08
buyer_1,Luis,Garay,1996-08-10,22984418N,luis.garay@cooltech.tech,641191,ES45209531629390469205,4758.25,2022-09-08T08:04:33,Bilbao,expenses,electricity,-33.77,-13233.85
buyer_1,Luis,Garay,1996-08-10,22984418N,luis.garay@cooltech.tech,641191,ES45209531629390469205,4758.25,2022-09-08T21:32:02,Bilbao,expenses,water,-31.29,-13265.14
buyer_1,Luis,Garay,1996-08-10,22984418N,luis.garay@cooltech.tech,641191,ES45209531629390469205,4758.25,2022-09-08T02:40:45,Bilbao,expenses,gas,-61.38,-13326.52
buyer_1,Luis,Garay,1996-08-10,22984418N,luis.garay@cooltech.tech,641191,ES45209531629390469205,4758.25,2022-09-08T12:34:22,Bilbao,expenses,food,-81.7,-13408.22
buyer_1,Luis,Garay,1996-08-10,22984418N,luis.garay@cooltech.tech,641191,ES45209531629390469205,4758.25,2022-09-08T10:35:59,Bilbao,expenses,transport,-87.18,-13495.4
buyer_1,Luis,Garay,1996-08-10,22984418N,luis.garay@cooltech.tech,641191,ES45209531629390469205,4758.25,2022-09-09T09:31:36,Bilbao,expenses,food,-85.0,-13580.4
buyer_1,Luis,Garay,1996-08-10,22984418N,luis.garay@cooltech.tech,641191,ES45209531629390469205,4758.25,2022-09-11T11:21:25,Bilbao,expenses,healthcare,-155.33,-13735.73
buyer_1,Luis,Garay,1996-08-10,22984418N,luis.garay@cooltech.tech,641191,ES45209531629390469205,4758.25,2022-09-12T20:15:01,Bilbao,expenses,transport,-56.43,-13792.16
buyer_1,Luis,Garay,1996-08-10,22984418N,luis.garay@cooltech.tech,641191,ES45209531629390469205,4758.25,2022-09-12T10:08:29,Bilbao,expenses,education,-60.08,-13852.24
buyer_1,Luis,Garay,1996-08-10,22984418N,luis.garay@cooltech.tech,641191,ES45209531629390469205,4758.25,2022-09-13T06:58:42,Bilbao,expenses,healthcare,-156.73,-14008.97
buyer_1,Luis,Garay,1996-08-10,22984418N,luis.garay@cooltech.tech,641191,ES45209531629390469205,4758.25,2022-09-13T14:50:53,Bilbao,expenses,cash,-100.0,-14108.97
buyer_1,Luis,Garay,1996-08-10,22984418N,luis.garay@cooltech.tech,641191,ES45209531629390469205,4758.25,2022-09-14T18:59:47,Bilbao,expenses,repairs,-44.92,-14153.89
buyer_1,Luis,Garay,1996-08-10,22984418N,luis.garay@cooltech.tech,641191,ES45209531629390469205,4758.25,2022-09-15T04:06:42,Bilbao,expenses,food,-87.63,-14241.52
buyer_1,Luis,Garay,1996-08-10,22984418N,luis.garay@cooltech.tech,641191,ES45209531629390469205,4758.25,2022-09-15T08:18:27,Bilbao,expenses,cash,-100.0,-14341.52
buyer_1,Luis,Garay,1996-08-10,22984418N,luis.garay@cooltech.tech,641191,ES45209531629390469205,4758.25,2022-09-16T09:02:53,Bilbao,expenses,gifts,-460.04,-14801.56
buyer_1,Luis,Garay,1996-08-10,22984418N,luis.garay@cooltech.tech,641191,ES45209531629390469205,4758.25,2022-09-17T10:53:12,Bilbao,expenses,clothing,-121.18,-14922.74
buyer_1,Luis,Garay,1996-08-10,22984418N,luis.garay@cooltech.tech,641191,ES45209531629390469205,4758.25,2022-09-17T23:20:46,Bilbao,expenses,cash,-100.0,-15022.74
buyer_1,Luis,Garay,1996-08-10,22984418N,luis.garay@cooltech.tech,641191,ES45209531629390469205,4758.25,2022-09-18T09:57:50,Bilbao,expenses,education,-68.12,-15090.86
buyer_1,Luis,Garay,1996-08-10,22984418N,luis.garay@cooltech.tech,641191,ES45209531629390469205,4758.25,2022-09-19T19:51:02,Bilbao,expenses,cash,-100.0,-15190.86
buyer_1,Luis,Garay,1996-08-10,22984418N,luis.garay@cooltech.tech,641191,ES45209531629390469205,4758.25,2022-09-21T10:14:24,Bilbao,expenses,food,-77.93,-15268.79
buyer_1,Luis,Garay,1996-08-10,22984418N,luis.garay@cooltech.tech,641191,ES45209531629390469205,4758.25,2022-09-21T16:38:50,Bilbao,expenses,clothing,-86.57,-15355.36
buyer_1,Luis,Garay,1996-08-10,22984418N,luis.garay@cooltech.tech,641191,ES45209531629390469205,4758.25,2022-09-22T20:16:27,Bilbao,expenses,food,-69.38,-15424.74
buyer_1,Luis,Garay,1996-08-10,22984418N,luis.garay@cooltech.tech,641191,ES45209531629390469205,4758.25,2022-09-22T12:59:19,Bilbao,expenses,cash,-100.0,-15524.74
buyer_1,Luis,Garay,1996-08-10,22984418N,luis.garay@cooltech.tech,641191,ES45209531629390469205,4758.25,2022-09-24T15:27:00,Bilbao,expenses,transport,-84.79,-15609.53
buyer_1,Luis,Garay,1996-08-10,22984418N,luis.garay@cooltech.tech,641191,ES45209531629390469205,4758.25,2022-09-26T20:48:38,Bilbao,expenses,food,-123.3,-15732.83
buyer_1,Luis,Garay,1996-08-10,22984418N,luis.garay@cooltech.tech,641191,ES45209531629390469205,4758.25,2022-09-27T12:36:43,Bilbao,expenses,repairs,-243.24,-15976.07
buyer_1,Luis,Garay,1996-08-10,22984418N,luis.garay@cooltech.tech,641191,ES45209531629390469205,4758.25,2022-09-28T20:39:12,Bilbao,expenses,leisure,-24.39,-16000.46
buyer_1,Luis,Garay,1996-08-10,22984418N,luis.garay@cooltech.tech,641191,ES45209531629390469205,4758.25,2022-09-28T16:39:00,Bilbao,expenses,cash,-100.0,-16100.46
buyer_1,Luis,Garay,1996-08-10,22984418N,luis.garay@cooltech.tech,641191,ES45209531629390469205,4758.25,2022-09-29T11:42:44,Bilbao,expenses,repairs,-42.99,-16143.45
buyer_1,Luis,Garay,1996-08-10,22984418N,luis.garay@cooltech.tech,641191,ES45209531629390469205,4758.25,2022-09-30T03:26:10,Bilbao,expenses,food,-85.81,-16229.26
buyer_1,Luis,Garay,1996-08-10,22984418N,luis.garay@cooltech.tech,641191,ES45209531629390469205,4758.25,2022-10-01T11:03:56,Bilbao,incomes,salary,1441.77,-14787.49
buyer_1,Luis,Garay,1996-08-10,22984418N,luis.garay@cooltech.tech,641191,ES45209531629390469205,4758.25,2022-10-03T15:18:04,Bilbao,expenses,food,-78.96,-14866.45
buyer_1,Luis,Garay,1996-08-10,22984418N,luis.garay@cooltech.tech,641191,ES45209531629390469205,4758.25,2022-10-03T17:50:00,Bilbao,expenses,clothing,-108.22,-14974.67
buyer_1,Luis,Garay,1996-08-10,22984418N,luis.garay@cooltech.tech,641191,ES45209531629390469205,4758.25,2022-10-04T15:18:43,Bilbao,expenses,rent,-488.24,-15462.91
buyer_1,Luis,Garay,1996-08-10,22984418N,luis.garay@cooltech.tech,641191,ES45209531629390469205,4758.25,2022-10-05T18:10:31,Bilbao,expenses,water,-25.66,-15488.57
buyer_1,Luis,Garay,1996-08-10,22984418N,luis.garay@cooltech.tech,641191,ES45209531629390469205,4758.25,2022-10-05T13:11:17,Bilbao,expenses,phone,-29.01,-15517.58
buyer_1,Luis,Garay,1996-08-10,22984418N,luis.garay@cooltech.tech,641191,ES45209531629390469205,4758.25,2022-10-05T11:55:52,Bilbao,expenses,food,-81.76,-15599.34
buyer_1,Luis,Garay,1996-08-10,22984418N,luis.garay@cooltech.tech,641191,ES45209531629390469205,4758.25,2022-10-06T14:32:09,Bilbao,expenses,leisure,-53.29,-15652.63
buyer_1,Luis,Garay,1996-08-10,22984418N,luis.garay@cooltech.tech,641191,ES45209531629390469205,4758.25,2022-10-06T14:06:10,Bilbao,expenses,clothing,-78.58,-15731.21
buyer_1,Luis,Garay,1996-08-10,22984418N,luis.garay@cooltech.tech,641191,ES45209531629390469205,4758.25,2022-10-07T18:54:43,Bilbao,expenses,electricity,-27.38,-15758.59
buyer_1,Luis,Garay,1996-08-10,22984418N,luis.garay@cooltech.tech,641191,ES45209531629390469205,4758.25,2022-10-08T09:35:46,Bilbao,expenses,gas,-61.6,-15820.19
buyer_1,Luis,Garay,1996-08-10,22984418N,luis.garay@cooltech.tech,641191,ES45209531629390469205,4758.25,2022-10-08T12:46:11,Bilbao,expenses,internet,-30.28,-15850.47
buyer_1,Luis,Garay,1996-08-10,22984418N,luis.garay@cooltech.tech,641191,ES45209531629390469205,4758.25,2022-10-08T14:18:27,Bilbao,expenses,food,-92.44,-15942.91
buyer_1,Luis,Garay,1996-08-10,22984418N,luis.garay@cooltech.tech,641191,ES45209531629390469205,4758.25,2022-10-09T21:07:44,Bilbao,expenses,food,-111.31,-16054.22
buyer_1,Luis,Garay,1996-08-10,22984418N,luis.garay@cooltech.tech,641191,ES45209531629390469205,4758.25,2022-10-10T15:42:55,Bilbao,expenses,transport,-55.34,-16109.56
buyer_1,Luis,Garay,1996-08-10,22984418N,luis.garay@cooltech.tech,641191,ES45209531629390469205,4758.25,2022-10-11T09:52:45,Bilbao,expenses,leisure,-60.68,-16170.24
buyer_1,Luis,Garay,1996-08-10,22984418N,luis.garay@cooltech.tech,641191,ES45209531629390469205,4758.25,2022-10-11T10:54:05,Bilbao,expenses,cash,-100.0,-16270.24
buyer_1,Luis,Garay,1996-08-10,22984418N,luis.garay@cooltech.tech,641191,ES45209531629390469205,4758.25,2022-10-11T16:49:45,Bilbao,expenses,appliances,-278.61,-16548.85
buyer_1,Luis,Garay,1996-08-10,22984418N,luis.garay@cooltech.tech,641191,ES45209531629390469205,4758.25,2022-10-12T18:12:15,Bilbao,expenses,clothing,-103.69,-16652.54
buyer_1,Luis,Garay,1996-08-10,22984418N,luis.garay@cooltech.tech,641191,ES45209531629390469205,4758.25,2022-10-12T20:43:17,Bilbao,expenses,education,-53.6,-16706.14
buyer_1,Luis,Garay,1996-08-10,22984418N,luis.garay@cooltech.tech,641191,ES45209531629390469205,4758.25,2022-10-12T19:07:45,Bilbao,expenses,appliances,-238.4,-16944.54
buyer_1,Luis,Garay,1996-08-10,22984418N,luis.garay@cooltech.tech,641191,ES45209531629390469205,4758.25,2022-10-16T16:09:52,Bilbao,expenses,cash,-100.0,-17044.54
buyer_1,Luis,Garay,1996-08-10,22984418N,luis.garay@cooltech.tech,641191,ES45209531629390469205,4758.25,2022-10-19T12:03:24,Bilbao,expenses,leisure,-33.08,-17077.62
buyer_1,Luis,Garay,1996-08-10,22984418N,luis.garay@cooltech.tech,641191,ES45209531629390469205,4758.25,2022-10-20T11:22:17,Bilbao,expenses,food,-98.05,-17175.67
buyer_1,Luis,Garay,1996-08-10,22984418N,luis.garay@cooltech.tech,641191,ES45209531629390469205,4758.25,2022-10-21T21:19:08,Bilbao,expenses,transport,-54.19,-17229.86
buyer_1,Luis,Garay,1996-08-10,22984418N,luis.garay@cooltech.tech,641191,ES45209531629390469205,4758.25,2022-10-26T10:41:46,Bilbao,expenses,food,-84.59,-17314.45
buyer_1,Luis,Garay,1996-08-10,22984418N,luis.garay@cooltech.tech,641191,ES45209531629390469205,4758.25,2022-10-26T20:02:43,Bilbao,expenses,leisure,-65.7,-17380.15
buyer_1,Luis,Garay,1996-08-10,22984418N,luis.garay@cooltech.tech,641191,ES45209531629390469205,4758.25,2022-10-26T12:34:32,Bilbao,expenses,clothing,-113.13,-17493.28
buyer_1,Luis,Garay,1996-08-10,22984418N,luis.garay@cooltech.tech,641191,ES45209531629390469205,4758.25,2022-10-26T19:04:03,Bilbao,expenses,gifts,-80.79,-17574.07
buyer_1,Luis,Garay,1996-08-10,22984418N,luis.garay@cooltech.tech,641191,ES45209531629390469205,4758.25,2022-10-27T19:55:23,Bilbao,expenses,repairs,-64.58,-17638.65
buyer_1,Luis,Garay,1996-08-10,22984418N,luis.garay@cooltech.tech,641191,ES45209531629390469205,4758.25,2022-10-30T20:52:34,Bilbao,expenses,cash,-100.0,-17738.65
buyer_1,Luis,Garay,1996-08-10,22984418N,luis.garay@cooltech.tech,641191,ES45209531629390469205,4758.25,2022-11-01T13:00:42,Bilbao,incomes,salary,1441.77,-16296.88
buyer_1,Luis,Garay,1996-08-10,22984418N,luis.garay@cooltech.tech,641191,ES45209531629390469205,4758.25,2022-11-01T13:00:42,Bilbao,incomes,extra_income,156.73,-16140.15
buyer_1,Luis,Garay,1996-08-10,22984418N,luis.garay@cooltech.tech,641191,ES45209531629390469205,4758.25,2022-11-01T06:36:11,Bilbao,expenses,leisure,-82.38,-16222.53
buyer_1,Luis,Garay,1996-08-10,22984418N,luis.garay@cooltech.tech,641191,ES45209531629390469205,4758.25,2022-11-03T20:16:59,Bilbao,expenses,clothing,-61.9,-16284.43
buyer_1,Luis,Garay,1996-08-10,22984418N,luis.garay@cooltech.tech,641191,ES45209531629390469205,4758.25,2022-11-03T08:57:49,Bilbao,expenses,appliances,-111.33,-16395.76
buyer_1,Luis,Garay,1996-08-10,22984418N,luis.garay@cooltech.tech,641191,ES45209531629390469205,4758.25,2022-11-04T09:27:35,Bilbao,expenses,rent,-488.24,-16884.0
buyer_1,Luis,Garay,1996-08-10,22984418N,luis.garay@cooltech.tech,641191,ES45209531629390469205,4758.25,2022-11-04T20:44:55,Bilbao,expenses,food,-114.38,-16998.38
buyer_1,Luis,Garay,1996-08-10,22984418N,luis.garay@cooltech.tech,641191,ES45209531629390469205,4758.25,2022-11-04T15:49:48,Bilbao,expenses,cash,-100.0,-17098.38
buyer_1,Luis,Garay,1996-08-10,22984418N,luis.garay@cooltech.tech,641191,ES45209531629390469205,4758.25,2022-11-05T19:01:02,Bilbao,expenses,internet,-30.28,-17128.66
buyer_1,Luis,Garay,1996-08-10,22984418N,luis.garay@cooltech.tech,641191,ES45209531629390469205,4758.25,2022-11-05T20:28:27,Bilbao,expenses,cash,-100.0,-17228.66
buyer_1,Luis,Garay,1996-08-10,22984418N,luis.garay@cooltech.tech,641191,ES45209531629390469205,4758.25,2022-11-07T13:28:48,Bilbao,expenses,water,-18.89,-17247.55
buyer_1,Luis,Garay,1996-08-10,22984418N,luis.garay@cooltech.tech,641191,ES45209531629390469205,4758.25,2022-11-07T10:05:55,Bilbao,expenses,leisure,-36.0,-17283.55
buyer_1,Luis,Garay,1996-08-10,22984418N,luis.garay@cooltech.tech,641191,ES45209531629390469205,4758.25,2022-11-07T08:59:11,Bilbao,expenses,clothing,-58.81,-17342.36
buyer_1,Luis,Garay,1996-08-10,22984418N,luis.garay@cooltech.tech,641191,ES45209531629390469205,4758.25,2022-11-07T13:34:54,Bilbao,expenses,cash,-100.0,-17442.36
buyer_1,Luis,Garay,1996-08-10,22984418N,luis.garay@cooltech.tech,641191,ES45209531629390469205,4758.25,2022-11-08T14:00:14,Bilbao,expenses,gas,-42.57,-17484.93
buyer_1,Luis,Garay,1996-08-10,22984418N,luis.garay@cooltech.tech,641191,ES45209531629390469205,4758.25,2022-11-08T13:09:05,Bilbao,expenses,phone,-22.03,-17506.96
buyer_1,Luis,Garay,1996-08-10,22984418N,luis.garay@cooltech.tech,641191,ES45209531629390469205,4758.25,2022-11-08T08:07:34,Bilbao,expenses,electricity,-51.58,-17558.54
buyer_1,Luis,Garay,1996-08-10,22984418N,luis.garay@cooltech.tech,641191,ES45209531629390469205,4758.25,2022-11-10T08:32:03,Bilbao,expenses,food,-99.03,-17657.57
buyer_1,Luis,Garay,1996-08-10,22984418N,luis.garay@cooltech.tech,641191,ES45209531629390469205,4758.25,2022-11-10T10:43:40,Bilbao,expenses,cash,-100.0,-17757.57
buyer_1,Luis,Garay,1996-08-10,22984418N,luis.garay@cooltech.tech,641191,ES45209531629390469205,4758.25,2022-11-10T11:40:16,Bilbao,expenses,gifts,-113.05,-17870.62
buyer_1,Luis,Garay,1996-08-10,22984418N,luis.garay@cooltech.tech,641191,ES45209531629390469205,4758.25,2022-11-11T23:19:40,Bilbao,expenses,transport,-65.8,-17936.42
buyer_1,Luis,Garay,1996-08-10,22984418N,luis.garay@cooltech.tech,641191,ES45209531629390469205,4758.25,2022-11-11T11:46:15,Bilbao,expenses,leisure,-60.97,-17997.39
buyer_1,Luis,Garay,1996-08-10,22984418N,luis.garay@cooltech.tech,641191,ES45209531629390469205,4758.25,2022-11-11T13:50:08,Bilbao,expenses,education,-77.45,-18074.84
buyer_1,Luis,Garay,1996-08-10,22984418N,luis.garay@cooltech.tech,641191,ES45209531629390469205,4758.25,2022-11-11T10:15:41,Bilbao,expenses,cash,-100.0,-18174.84
buyer_1,Luis,Garay,1996-08-10,22984418N,luis.garay@cooltech.tech,641191,ES45209531629390469205,4758.25,2022-11-12T18:04:08,Bilbao,expenses,appliances,-293.52,-18468.36
buyer_1,Luis,Garay,1996-08-10,22984418N,luis.garay@cooltech.tech,641191,ES45209531629390469205,4758.25,2022-11-13T15:37:47,Bilbao,expenses,transport,-69.94,-18538.3
buyer_1,Luis,Garay,1996-08-10,22984418N,luis.garay@cooltech.tech,641191,ES45209531629390469205,4758.25,2022-11-13T03:47:17,Bilbao,expenses,repairs,-175.3,-18713.6
buyer_1,Luis,Garay,1996-08-10,22984418N,luis.garay@cooltech.tech,641191,ES45209531629390469205,4758.25,2022-11-14T08:34:30,Bilbao,expenses,food,-115.37,-18828.97
buyer_1,Luis,Garay,1996-08-10,22984418N,luis.garay@cooltech.tech,641191,ES45209531629390469205,4758.25,2022-11-15T03:41:45,Bilbao,expenses,leisure,-26.95,-18855.92
buyer_1,Luis,Garay,1996-08-10,22984418N,luis.garay@cooltech.tech,641191,ES45209531629390469205,4758.25,2022-11-16T10:25:20,Bilbao,expenses,leisure,-20.92,-18876.84
buyer_1,Luis,Garay,1996-08-10,22984418N,luis.garay@cooltech.tech,641191,ES45209531629390469205,4758.25,2022-11-17T16:18:10,Bilbao,expenses,transport,-54.22,-18931.06
buyer_1,Luis,Garay,1996-08-10,22984418N,luis.garay@cooltech.tech,641191,ES45209531629390469205,4758.25,2022-11-17T16:18:16,Bilbao,expenses,clothing,-85.31,-19016.37
buyer_1,Luis,Garay,1996-08-10,22984418N,luis.garay@cooltech.tech,641191,ES45209531629390469205,4758.25,2022-11-17T17:55:36,Bilbao,expenses,education,-57.45,-19073.82
buyer_1,Luis,Garay,1996-08-10,22984418N,luis.garay@cooltech.tech,641191,ES45209531629390469205,4758.25,2022-11-17T08:19:11,Bilbao,expenses,gifts,-353.54,-19427.36
buyer_1,Luis,Garay,1996-08-10,22984418N,luis.garay@cooltech.tech,641191,ES45209531629390469205,4758.25,2022-11-18T14:24:52,Bilbao,expenses,healthcare,-161.25,-19588.61
buyer_1,Luis,Garay,1996-08-10,22984418N,luis.garay@cooltech.tech,641191,ES45209531629390469205,4758.25,2022-11-21T04:29:13,Bilbao,expenses,food,-91.67,-19680.28
buyer_1,Luis,Garay,1996-08-10,22984418N,luis.garay@cooltech.tech,641191,ES45209531629390469205,4758.25,2022-11-21T15:57:49,Bilbao,expenses,cash,-100.0,-19780.28
buyer_1,Luis,Garay,1996-08-10,22984418N,luis.garay@cooltech.tech,641191,ES45209531629390469205,4758.25,2022-11-25T18:02:07,Bilbao,expenses,food,-102.35,-19882.63
buyer_1,Luis,Garay,1996-08-10,22984418N,luis.garay@cooltech.tech,641191,ES45209531629390469205,4758.25,2022-11-26T09:12:24,Bilbao,expenses,leisure,-69.84,-19952.47
buyer_1,Luis,Garay,1996-08-10,22984418N,luis.garay@cooltech.tech,641191,ES45209531629390469205,4758.25,2022-11-26T08:54:31,Bilbao,expenses,healthcare,-97.96,-20050.43
buyer_1,Luis,Garay,1996-08-10,22984418N,luis.garay@cooltech.tech,641191,ES45209531629390469205,4758.25,2022-11-27T16:49:19,Bilbao,expenses,food,-88.09,-20138.52
buyer_1,Luis,Garay,1996-08-10,22984418N,luis.garay@cooltech.tech,641191,ES45209531629390469205,4758.25,2022-11-27T10:58:41,Bilbao,expenses,repairs,-160.24,-20298.76
buyer_1,Luis,Garay,1996-08-10,22984418N,luis.garay@cooltech.tech,641191,ES45209531629390469205,4758.25,2022-11-29T09:09:48,Bilbao,expenses,cash,-100.0,-20398.76
buyer_1,Luis,Garay,1996-08-10,22984418N,luis.garay@cooltech.tech,641191,ES45209531629390469205,4758.25,2022-11-30T13:13:43,Bilbao,expenses,food,-109.69,-20508.45
buyer_1,Luis,Garay,1996-08-10,22984418N,luis.garay@cooltech.tech,641191,ES45209531629390469205,4758.25,2022-12-01T09:10:56,Bilbao,incomes,salary,1441.77,-19066.68
buyer_1,Luis,Garay,1996-08-10,22984418N,luis.garay@cooltech.tech,641191,ES45209531629390469205,4758.25,2022-12-01T09:10:56,Bilbao,incomes,salary_bonus,1030.65,-18036.03
buyer_1,Luis,Garay,1996-08-10,22984418N,luis.garay@cooltech.tech,641191,ES45209531629390469205,4758.25,2022-12-03T17:44:04,Bilbao,expenses,gifts,-187.33,-18223.36
buyer_1,Luis,Garay,1996-08-10,22984418N,luis.garay@cooltech.tech,641191,ES45209531629390469205,4758.25,2022-12-04T18:45:48,Bilbao,expenses,rent,-488.24,-18711.6
buyer_1,Luis,Garay,1996-08-10,22984418N,luis.garay@cooltech.tech,641191,ES45209531629390469205,4758.25,2022-12-04T18:13:59,Bilbao,expenses,leisure,-25.3,-18736.9
buyer_1,Luis,Garay,1996-08-10,22984418N,luis.garay@cooltech.tech,641191,ES45209531629390469205,4758.25,2022-12-04T12:49:43,Bilbao,expenses,clothing,-114.96,-18851.86
buyer_1,Luis,Garay,1996-08-10,22984418N,luis.garay@cooltech.tech,641191,ES45209531629390469205,4758.25,2022-12-05T09:22:29,Bilbao,expenses,electricity,-39.0,-18890.86
buyer_1,Luis,Garay,1996-08-10,22984418N,luis.garay@cooltech.tech,641191,ES45209531629390469205,4758.25,2022-12-05T12:12:05,Bilbao,expenses,internet,-30.28,-18921.14
buyer_1,Luis,Garay,1996-08-10,22984418N,luis.garay@cooltech.tech,641191,ES45209531629390469205,4758.25,2022-12-05T18:59:21,Bilbao,expenses,phone,-25.18,-18946.32
buyer_1,Luis,Garay,1996-08-10,22984418N,luis.garay@cooltech.tech,641191,ES45209531629390469205,4758.25,2022-12-05T20:26:42,Bilbao,expenses,food,-109.86,-19056.18
buyer_1,Luis,Garay,1996-08-10,22984418N,luis.garay@cooltech.tech,641191,ES45209531629390469205,4758.25,2022-12-06T13:50:47,Bilbao,expenses,water,-26.54,-19082.72
buyer_1,Luis,Garay,1996-08-10,22984418N,luis.garay@cooltech.tech,641191,ES45209531629390469205,4758.25,2022-12-06T19:32:45,Bilbao,expenses,leisure,-23.69,-19106.41
buyer_1,Luis,Garay,1996-08-10,22984418N,luis.garay@cooltech.tech,641191,ES45209531629390469205,4758.25,2022-12-06T22:44:53,Bilbao,expenses,education,-55.46,-19161.87
buyer_1,Luis,Garay,1996-08-10,22984418N,luis.garay@cooltech.tech,641191,ES45209531629390469205,4758.25,2022-12-07T20:12:42,Bilbao,expenses,gas,-71.25,-19233.12
buyer_1,Luis,Garay,1996-08-10,22984418N,luis.garay@cooltech.tech,641191,ES45209531629390469205,4758.25,2022-12-08T16:09:02,Bilbao,expenses,repairs,-118.29,-19351.41
buyer_1,Luis,Garay,1996-08-10,22984418N,luis.garay@cooltech.tech,641191,ES45209531629390469205,4758.25,2022-12-09T13:48:22,Bilbao,expenses,food,-92.72,-19444.13
buyer_1,Luis,Garay,1996-08-10,22984418N,luis.garay@cooltech.tech,641191,ES45209531629390469205,4758.25,2022-12-09T17:13:31,Bilbao,expenses,healthcare,-88.52,-19532.65
buyer_1,Luis,Garay,1996-08-10,22984418N,luis.garay@cooltech.tech,641191,ES45209531629390469205,4758.25,2022-12-13T09:26:41,Bilbao,expenses,food,-71.71,-19604.36
buyer_1,Luis,Garay,1996-08-10,22984418N,luis.garay@cooltech.tech,641191,ES45209531629390469205,4758.25,2022-12-13T21:29:21,Bilbao,expenses,cash,-100.0,-19704.36
buyer_1,Luis,Garay,1996-08-10,22984418N,luis.garay@cooltech.tech,641191,ES45209531629390469205,4758.25,2022-12-14T20:00:06,Bilbao,expenses,clothing,-93.08,-19797.44
buyer_1,Luis,Garay,1996-08-10,22984418N,luis.garay@cooltech.tech,641191,ES45209531629390469205,4758.25,2022-12-15T12:04:29,Bilbao,expenses,healthcare,-38.18,-19835.62
buyer_1,Luis,Garay,1996-08-10,22984418N,luis.garay@cooltech.tech,641191,ES45209531629390469205,4758.25,2022-12-15T19:16:42,Bilbao,expenses,cash,-100.0,-19935.62
buyer_1,Luis,Garay,1996-08-10,22984418N,luis.garay@cooltech.tech,641191,ES45209531629390469205,4758.25,2022-12-17T13:00:21,Bilbao,expenses,food,-70.07,-20005.69
buyer_1,Luis,Garay,1996-08-10,22984418N,luis.garay@cooltech.tech,641191,ES45209531629390469205,4758.25,2022-12-17T20:27:22,Bilbao,expenses,cash,-100.0,-20105.69
buyer_1,Luis,Garay,1996-08-10,22984418N,luis.garay@cooltech.tech,641191,ES45209531629390469205,4758.25,2022-12-18T09:31:59,Bilbao,expenses,cash,-100.0,-20205.69
buyer_1,Luis,Garay,1996-08-10,22984418N,luis.garay@cooltech.tech,641191,ES45209531629390469205,4758.25,2022-12-19T05:57:13,Bilbao,expenses,food,-107.62,-20313.31
buyer_1,Luis,Garay,1996-08-10,22984418N,luis.garay@cooltech.tech,641191,ES45209531629390469205,4758.25,2022-12-20T21:02:14,Bilbao,expenses,leisure,-83.12,-20396.43
buyer_1,Luis,Garay,1996-08-10,22984418N,luis.garay@cooltech.tech,641191,ES45209531629390469205,4758.25,2022-12-23T09:41:46,Bilbao,expenses,transport,-86.33,-20482.76
buyer_1,Luis,Garay,1996-08-10,22984418N,luis.garay@cooltech.tech,641191,ES45209531629390469205,4758.25,2022-12-24T12:16:56,Bilbao,expenses,clothing,-64.4,-20547.16
buyer_1,Luis,Garay,1996-08-10,22984418N,luis.garay@cooltech.tech,641191,ES45209531629390469205,4758.25,2022-12-24T08:32:25,Bilbao,expenses,cash,-100.0,-20647.16
buyer_1,Luis,Garay,1996-08-10,22984418N,luis.garay@cooltech.tech,641191,ES45209531629390469205,4758.25,2022-12-25T10:44:25,Bilbao,expenses,leisure,-27.67,-20674.83
buyer_1,Luis,Garay,1996-08-10,22984418N,luis.garay@cooltech.tech,641191,ES45209531629390469205,4758.25,2022-12-27T19:54:48,Bilbao,expenses,food,-124.51,-20799.34
buyer_1,Luis,Garay,1996-08-10,22984418N,luis.garay@cooltech.tech,641191,ES45209531629390469205,4758.25,2022-12-28T18:50:49,Bilbao,expenses,transport,-87.96,-20887.3
buyer_1,Luis,Garay,1996-08-10,22984418N,luis.garay@cooltech.tech,641191,ES45209531629390469205,4758.25,2022-12-28T21:29:49,Bilbao,expenses,gifts,-26.85,-20914.15
buyer_1,Luis,Garay,1996-08-10,22984418N,luis.garay@cooltech.tech,641191,ES45209531629390469205,4758.25,2022-12-30T23:14:25,Bilbao,expenses,transport,-88.26,-21002.41
buyer_1,Luis,Garay,1996-08-10,22984418N,luis.garay@cooltech.tech,641191,ES45209531629390469205,4758.25,2022-12-30T17:09:22,Bilbao,expenses,leisure,-33.32,-21035.73
buyer_1,Luis,Garay,1996-08-10,22984418N,luis.garay@cooltech.tech,641191,ES45209531629390469205,4758.25,2022-12-30T01:19:35,Bilbao,expenses,cash,-100.0,-21135.73
buyer_1,Luis,Garay,1996-08-10,22984418N,luis.garay@cooltech.tech,641191,ES45209531629390469205,4758.25,2023-01-01T14:00:44,Bilbao,incomes,salary,1494.23,-19641.5
buyer_1,Luis,Garay,1996-08-10,22984418N,luis.garay@cooltech.tech,641191,ES45209531629390469205,4758.25,2023-01-01T16:11:09,Bilbao,expenses,gifts,-425.11,-20066.61
buyer_1,Luis,Garay,1996-08-10,22984418N,luis.garay@cooltech.tech,641191,ES45209531629390469205,4758.25,2023-01-03T18:35:16,Bilbao,expenses,clothing,-149.15,-20215.76
buyer_1,Luis,Garay,1996-08-10,22984418N,luis.garay@cooltech.tech,641191,ES45209531629390469205,4758.25,2023-01-04T14:15:12,Bilbao,expenses,rent,-483.94,-20699.7
buyer_1,Luis,Garay,1996-08-10,22984418N,luis.garay@cooltech.tech,641191,ES45209531629390469205,4758.25,2023-01-05T14:10:57,Bilbao,expenses,gas,-78.11,-20777.81
buyer_1,Luis,Garay,1996-08-10,22984418N,luis.garay@cooltech.tech,641191,ES45209531629390469205,4758.25,2023-01-05T16:20:44,Bilbao,expenses,transport,-88.38,-20866.19
buyer_1,Luis,Garay,1996-08-10,22984418N,luis.garay@cooltech.tech,641191,ES45209531629390469205,4758.25,2023-01-06T20:55:33,Bilbao,expenses,cash,-100.0,-20966.19
buyer_1,Luis,Garay,1996-08-10,22984418N,luis.garay@cooltech.tech,641191,ES45209531629390469205,4758.25,2023-01-07T18:26:05,Bilbao,expenses,water,-27.11,-20993.3
buyer_1,Luis,Garay,1996-08-10,22984418N,luis.garay@cooltech.tech,641191,ES45209531629390469205,4758.25,2023-01-07T09:47:32,Bilbao,expenses,food,-80.04,-21073.34
buyer_1,Luis,Garay,1996-08-10,22984418N,luis.garay@cooltech.tech,641191,ES45209531629390469205,4758.25,2023-01-08T19:20:40,Bilbao,expenses,electricity,-61.78,-21135.12
buyer_1,Luis,Garay,1996-08-10,22984418N,luis.garay@cooltech.tech,641191,ES45209531629390469205,4758.25,2023-01-08T09:50:14,Bilbao,expenses,internet,-31.38,-21166.5
buyer_1,Luis,Garay,1996-08-10,22984418N,luis.garay@cooltech.tech,641191,ES45209531629390469205,4758.25,2023-01-08T17:55:20,Bilbao,expenses,phone,-24.97,-21191.47
buyer_1,Luis,Garay,1996-08-10,22984418N,luis.garay@cooltech.tech,641191,ES45209531629390469205,4758.25,2023-01-11T13:04:04,Bilbao,expenses,food,-66.16,-21257.63
buyer_1,Luis,Garay,1996-08-10,22984418N,luis.garay@cooltech.tech,641191,ES45209531629390469205,4758.25,2023-01-12T12:59:27,Bilbao,expenses,food,-75.79,-21333.42
buyer_1,Luis,Garay,1996-08-10,22984418N,luis.garay@cooltech.tech,641191,ES45209531629390469205,4758.25,2023-01-13T16:15:07,Bilbao,expenses,clothing,-101.21,-21434.63
buyer_1,Luis,Garay,1996-08-10,22984418N,luis.garay@cooltech.tech,641191,ES45209531629390469205,4758.25,2023-01-15T18:59:56,Bilbao,expenses,food,-113.22,-21547.85
buyer_1,Luis,Garay,1996-08-10,22984418N,luis.garay@cooltech.tech,641191,ES45209531629390469205,4758.25,2023-01-17T08:26:53,Bilbao,expenses,food,-120.96,-21668.81
buyer_1,Luis,Garay,1996-08-10,22984418N,luis.garay@cooltech.tech,641191,ES45209531629390469205,4758.25,2023-01-18T19:04:27,Bilbao,expenses,food,-107.5,-21776.31
buyer_1,Luis,Garay,1996-08-10,22984418N,luis.garay@cooltech.tech,641191,ES45209531629390469205,4758.25,2023-01-18T22:51:26,Bilbao,expenses,clothing,-48.57,-21824.88
buyer_1,Luis,Garay,1996-08-10,22984418N,luis.garay@cooltech.tech,641191,ES45209531629390469205,4758.25,2023-01-23T10:04:38,Bilbao,expenses,food,-112.52,-21937.4
buyer_1,Luis,Garay,1996-08-10,22984418N,luis.garay@cooltech.tech,641191,ES45209531629390469205,4758.25,2023-01-23T12:14:40,Bilbao,expenses,transport,-42.76,-21980.16
buyer_1,Luis,Garay,1996-08-10,22984418N,luis.garay@cooltech.tech,641191,ES45209531629390469205,4758.25,2023-01-23T21:31:35,Bilbao,expenses,cash,-100.0,-22080.16
buyer_1,Luis,Garay,1996-08-10,22984418N,luis.garay@cooltech.tech,641191,ES45209531629390469205,4758.25,2023-01-24T17:33:21,Bilbao,expenses,cash,-100.0,-22180.16
buyer_1,Luis,Garay,1996-08-10,22984418N,luis.garay@cooltech.tech,641191,ES45209531629390469205,4758.25,2023-01-25T12:46:29,Bilbao,expenses,appliances,-345.18,-22525.34
buyer_1,Luis,Garay,1996-08-10,22984418N,luis.garay@cooltech.tech,641191,ES45209531629390469205,4758.25,2023-01-26T20:35:47,Bilbao,expenses,food,-91.75,-22617.09
buyer_1,Luis,Garay,1996-08-10,22984418N,luis.garay@cooltech.tech,641191,ES45209531629390469205,4758.25,2023-01-28T09:34:02,Bilbao,expenses,repairs,-211.95,-22829.04
buyer_1,Luis,Garay,1996-08-10,22984418N,luis.garay@cooltech.tech,641191,ES45209531629390469205,4758.25,2023-01-29T21:59:29,Bilbao,expenses,repairs,-234.13,-23063.17
buyer_1,Luis,Garay,1996-08-10,22984418N,luis.garay@cooltech.tech,641191,ES45209531629390469205,4758.25,2023-01-30T14:10:45,Bilbao,expenses,gifts,-223.42,-23286.59
buyer_1,Luis,Garay,1996-08-10,22984418N,luis.garay@cooltech.tech,641191,ES45209531629390469205,4758.25,2023-02-01T18:28:09,Bilbao,incomes,salary,1494.23,-21792.36
buyer_1,Luis,Garay,1996-08-10,22984418N,luis.garay@cooltech.tech,641191,ES45209531629390469205,4758.25,2023-02-01T14:54:12,Bilbao,expenses,leisure,-43.54,-21835.9
buyer_1,Luis,Garay,1996-08-10,22984418N,luis.garay@cooltech.tech,641191,ES45209531629390469205,4758.25,2023-02-01T21:41:17,Bilbao,expenses,healthcare,-173.43,-22009.33
buyer_1,Luis,Garay,1996-08-10,22984418N,luis.garay@cooltech.tech,641191,ES45209531629390469205,4758.25,2023-02-04T18:49:12,Bilbao,expenses,rent,-483.94,-22493.27
buyer_1,Luis,Garay,1996-08-10,22984418N,luis.garay@cooltech.tech,641191,ES45209531629390469205,4758.25,2023-02-05T19:15:29,Bilbao,expenses,electricity,-15.86,-22509.13
buyer_1,Luis,Garay,1996-08-10,22984418N,luis.garay@cooltech.tech,641191,ES45209531629390469205,4758.25,2023-02-05T15:53:01,Bilbao,expenses,clothing,-112.84,-22621.97
buyer_1,Luis,Garay,1996-08-10,22984418N,luis.garay@cooltech.tech,641191,ES45209531629390469205,4758.25,2023-02-06T12:33:17,Bilbao,expenses,water,-14.98,-22636.95
buyer_1,Luis,Garay,1996-08-10,22984418N,luis.garay@cooltech.tech,641191,ES45209531629390469205,4758.25,2023-02-06T16:17:12,Bilbao,expenses,gas,-45.13,-22682.08
buyer_1,Luis,Garay,1996-08-10,22984418N,luis.garay@cooltech.tech,641191,ES45209531629390469205,4758.25,2023-02-06T05:41:54,Bilbao,expenses,phone,-26.14,-22708.22
buyer_1,Luis,Garay,1996-08-10,22984418N,luis.garay@cooltech.tech,641191,ES45209531629390469205,4758.25,2023-02-08T19:23:33,Bilbao,expenses,internet,-31.38,-22739.6
buyer_1,Luis,Garay,1996-08-10,22984418N,luis.garay@cooltech.tech,641191,ES45209531629390469205,4758.25,2023-02-10T13:40:18,Bilbao,expenses,cash,-100.0,-22839.6
buyer_1,Luis,Garay,1996-08-10,22984418N,luis.garay@cooltech.tech,641191,ES45209531629390469205,4758.25,2023-02-13T05:10:16,Bilbao,expenses,cash,-100.0,-22939.6
buyer_1,Luis,Garay,1996-08-10,22984418N,luis.garay@cooltech.tech,641191,ES45209531629390469205,4758.25,2023-02-14T17:53:34,Bilbao,expenses,cash,-100.0,-23039.6
buyer_1,Luis,Garay,1996-08-10,22984418N,luis.garay@cooltech.tech,641191,ES45209531629390469205,4758.25,2023-02-14T08:41:55,Bilbao,expenses,gifts,-310.17,-23349.77
buyer_1,Luis,Garay,1996-08-10,22984418N,luis.garay@cooltech.tech,641191,ES45209531629390469205,4758.25,2023-02-17T09:02:25,Bilbao,expenses,food,-66.0,-23415.77
buyer_1,Luis,Garay,1996-08-10,22984418N,luis.garay@cooltech.tech,641191,ES45209531629390469205,4758.25,2023-02-17T11:02:16,Bilbao,expenses,transport,-65.63,-23481.4
buyer_1,Luis,Garay,1996-08-10,22984418N,luis.garay@cooltech.tech,641191,ES45209531629390469205,4758.25,2023-02-20T08:46:16,Bilbao,expenses,cash,-100.0,-23581.4
buyer_1,Luis,Garay,1996-08-10,22984418N,luis.garay@cooltech.tech,641191,ES45209531629390469205,4758.25,2023-02-20T16:36:51,Bilbao,expenses,gifts,-151.7,-23733.1
buyer_1,Luis,Garay,1996-08-10,22984418N,luis.garay@cooltech.tech,641191,ES45209531629390469205,4758.25,2023-02-21T16:58:52,Bilbao,expenses,cash,-100.0,-23833.1
buyer_1,Luis,Garay,1996-08-10,22984418N,luis.garay@cooltech.tech,641191,ES45209531629390469205,4758.25,2023-02-22T09:49:22,Bilbao,expenses,leisure,-58.67,-23891.77
buyer_1,Luis,Garay,1996-08-10,22984418N,luis.garay@cooltech.tech,641191,ES45209531629390469205,4758.25,2023-02-23T15:06:12,Bilbao,expenses,food,-104.63,-23996.4
buyer_1,Luis,Garay,1996-08-10,22984418N,luis.garay@cooltech.tech,641191,ES45209531629390469205,4758.25,2023-02-24T11:54:55,Bilbao,expenses,healthcare,-105.55,-24101.95
buyer_1,Luis,Garay,1996-08-10,22984418N,luis.garay@cooltech.tech,641191,ES45209531629390469205,4758.25,2023-02-25T23:10:09,Bilbao,expenses,food,-86.71,-24188.66
buyer_1,Luis,Garay,1996-08-10,22984418N,luis.garay@cooltech.tech,641191,ES45209531629390469205,4758.25,2023-02-26T15:33:41,Bilbao,expenses,cash,-100.0,-24288.66
buyer_1,Luis,Garay,1996-08-10,22984418N,luis.garay@cooltech.tech,641191,ES45209531629390469205,4758.25,2023-02-26T17:24:28,Bilbao,expenses,repairs,-209.49,-24498.15
buyer_1,Luis,Garay,1996-08-10,22984418N,luis.garay@cooltech.tech,641191,ES45209531629390469205,4758.25,2023-03-01T12:14:20,Bilbao,incomes,salary,1494.23,-23003.92
buyer_1,Luis,Garay,1996-08-10,22984418N,luis.garay@cooltech.tech,641191,ES45209531629390469205,4758.25,2023-03-01T12:14:20,Bilbao,incomes,extra_income,156.73,-22847.19
buyer_1,Luis,Garay,1996-08-10,22984418N,luis.garay@cooltech.tech,641191,ES45209531629390469205,4758.25,2023-03-03T15:25:07,Bilbao,expenses,repairs,-125.88,-22973.07
buyer_1,Luis,Garay,1996-08-10,22984418N,luis.garay@cooltech.tech,641191,ES45209531629390469205,4758.25,2023-03-03T23:01:20,Bilbao,expenses,gifts,-426.54,-23399.61
buyer_1,Luis,Garay,1996-08-10,22984418N,luis.garay@cooltech.tech,641191,ES45209531629390469205,4758.25,2023-03-04T09:09:04,Bilbao,expenses,rent,-483.94,-23883.55
buyer_1,Luis,Garay,1996-08-10,22984418N,luis.garay@cooltech.tech,641191,ES45209531629390469205,4758.25,2023-03-05T15:56:33,Bilbao,expenses,water,-31.38,-23914.93
buyer_1,Luis,Garay,1996-08-10,22984418N,luis.garay@cooltech.tech,641191,ES45209531629390469205,4758.25,2023-03-05T12:18:26,Bilbao,expenses,phone,-24.33,-23939.26
buyer_1,Luis,Garay,1996-08-10,22984418N,luis.garay@cooltech.tech,641191,ES45209531629390469205,4758.25,2023-03-07T10:58:44,Bilbao,expenses,gas,-23.24,-23962.5
buyer_1,Luis,Garay,1996-08-10,22984418N,luis.garay@cooltech.tech,641191,ES45209531629390469205,4758.25,2023-03-07T17:17:09,Bilbao,expenses,transport,-78.0,-24040.5
buyer_1,Luis,Garay,1996-08-10,22984418N,luis.garay@cooltech.tech,641191,ES45209531629390469205,4758.25,2023-03-08T17:24:42,Bilbao,expenses,internet,-31.38,-24071.88
buyer_1,Luis,Garay,1996-08-10,22984418N,luis.garay@cooltech.tech,641191,ES45209531629390469205,4758.25,2023-03-08T22:08:40,Bilbao,expenses,electricity,-50.6,-24122.48
buyer_1,Luis,Garay,1996-08-10,22984418N,luis.garay@cooltech.tech,641191,ES45209531629390469205,4758.25,2023-03-09T17:25:10,Bilbao,expenses,transport,-48.34,-24170.82
buyer_1,Luis,Garay,1996-08-10,22984418N,luis.garay@cooltech.tech,641191,ES45209531629390469205,4758.25,2023-03-09T16:54:35,Bilbao,expenses,healthcare,-112.95,-24283.77
buyer_1,Luis,Garay,1996-08-10,22984418N,luis.garay@cooltech.tech,641191,ES45209531629390469205,4758.25,2023-03-09T14:57:51,Bilbao,expenses,gifts,-303.77,-24587.54
buyer_1,Luis,Garay,1996-08-10,22984418N,luis.garay@cooltech.tech,641191,ES45209531629390469205,4758.25,2023-03-10T10:16:32,Bilbao,expenses,healthcare,-87.95,-24675.49
buyer_1,Luis,Garay,1996-08-10,22984418N,luis.garay@cooltech.tech,641191,ES45209531629390469205,4758.25,2023-03-11T15:42:50,Bilbao,expenses,healthcare,-50.35,-24725.84
buyer_1,Luis,Garay,1996-08-10,22984418N,luis.garay@cooltech.tech,641191,ES45209531629390469205,4758.25,2023-03-13T13:38:28,Bilbao,expenses,cash,-100.0,-24825.84
buyer_1,Luis,Garay,1996-08-10,22984418N,luis.garay@cooltech.tech,641191,ES45209531629390469205,4758.25,2023-03-15T11:19:02,Bilbao,expenses,cash,-100.0,-24925.84
buyer_1,Luis,Garay,1996-08-10,22984418N,luis.garay@cooltech.tech,641191,ES45209531629390469205,4758.25,2023-03-16T12:47:53,Bilbao,expenses,food,-124.55,-25050.39
buyer_1,Luis,Garay,1996-08-10,22984418N,luis.garay@cooltech.tech,641191,ES45209531629390469205,4758.25,2023-03-18T20:02:52,Bilbao,expenses,food,-109.67,-25160.06
buyer_1,Luis,Garay,1996-08-10,22984418N,luis.garay@cooltech.tech,641191,ES45209531629390469205,4758.25,2023-03-18T13:30:21,Bilbao,expenses,education,-66.06,-25226.12
buyer_1,Luis,Garay,1996-08-10,22984418N,luis.garay@cooltech.tech,641191,ES45209531629390469205,4758.25,2023-03-21T12:23:47,Bilbao,expenses,food,-88.4,-25314.52
buyer_1,Luis,Garay,1996-08-10,22984418N,luis.garay@cooltech.tech,641191,ES45209531629390469205,4758.25,2023-03-22T21:06:11,Bilbao,expenses,appliances,-236.99,-25551.51
buyer_1,Luis,Garay,1996-08-10,22984418N,luis.garay@cooltech.tech,641191,ES45209531629390469205,4758.25,2023-03-24T23:28:41,Bilbao,expenses,cash,-100.0,-25651.51
buyer_1,Luis,Garay,1996-08-10,22984418N,luis.garay@cooltech.tech,641191,ES45209531629390469205,4758.25,2023-03-27T20:40:31,Bilbao,expenses,appliances,-294.82,-25946.33
buyer_1,Luis,Garay,1996-08-10,22984418N,luis.garay@cooltech.tech,641191,ES45209531629390469205,4758.25,2023-03-30T14:17:44,Bilbao,expenses,transport,-51.31,-25997.64
buyer_1,Luis,Garay,1996-08-10,22984418N,luis.garay@cooltech.tech,641191,ES45209531629390469205,4758.25,2023-03-30T15:38:28,Bilbao,expenses,leisure,-69.01,-26066.65
buyer_1,Luis,Garay,1996-08-10,22984418N,luis.garay@cooltech.tech,641191,ES45209531629390469205,4758.25,2023-03-31T11:45:08,Bilbao,expenses,transport,-55.02,-26121.67
buyer_1,Luis,Garay,1996-08-10,22984418N,luis.garay@cooltech.tech,641191,ES45209531629390469205,4758.25,2023-03-31T13:07:22,Bilbao,expenses,gifts,-565.84,-26687.51
buyer_1,Luis,Garay,1996-08-10,22984418N,luis.garay@cooltech.tech,641191,ES45209531629390469205,4758.25,2023-04-01T14:17:19,Bilbao,incomes,salary,1494.23,-25193.28
buyer_1,Luis,Garay,1996-08-10,22984418N,luis.garay@cooltech.tech,641191,ES45209531629390469205,4758.25,2023-04-03T14:04:30,Bilbao,expenses,cash,-100.0,-25293.28
buyer_1,Luis,Garay,1996-08-10,22984418N,luis.garay@cooltech.tech,641191,ES45209531629390469205,4758.25,2023-04-04T20:13:38,Bilbao,expenses,rent,-483.94,-25777.22
buyer_1,Luis,Garay,1996-08-10,22984418N,luis.garay@cooltech.tech,641191,ES45209531629390469205,4758.25,2023-04-04T18:14:20,Bilbao,expenses,cash,-100.0,-25877.22
buyer_1,Luis,Garay,1996-08-10,22984418N,luis.garay@cooltech.tech,641191,ES45209531629390469205,4758.25,2023-04-05T18:25:48,Bilbao,expenses,gas,-49.6,-25926.82
buyer_1,Luis,Garay,1996-08-10,22984418N,luis.garay@cooltech.tech,641191,ES45209531629390469205,4758.25,2023-04-05T08:28:48,Bilbao,expenses,cash,-100.0,-26026.82
buyer_1,Luis,Garay,1996-08-10,22984418N,luis.garay@cooltech.tech,641191,ES45209531629390469205,4758.25,2023-04-07T16:56:27,Bilbao,expenses,electricity,-19.32,-26046.14
buyer_1,Luis,Garay,1996-08-10,22984418N,luis.garay@cooltech.tech,641191,ES45209531629390469205,4758.25,2023-04-08T04:50:40,Bilbao,expenses,internet,-31.38,-26077.52
buyer_1,Luis,Garay,1996-08-10,22984418N,luis.garay@cooltech.tech,641191,ES45209531629390469205,4758.25,2023-04-08T13:40:33,Bilbao,expenses,phone,-27.65,-26105.17
buyer_1,Luis,Garay,1996-08-10,22984418N,luis.garay@cooltech.tech,641191,ES45209531629390469205,4758.25,2023-04-08T08:41:41,Bilbao,expenses,water,-25.34,-26130.51
buyer_1,Luis,Garay,1996-08-10,22984418N,luis.garay@cooltech.tech,641191,ES45209531629390469205,4758.25,2023-04-09T18:45:23,Bilbao,expenses,food,-81.99,-26212.5
buyer_1,Luis,Garay,1996-08-10,22984418N,luis.garay@cooltech.tech,641191,ES45209531629390469205,4758.25,2023-04-10T12:58:09,Bilbao,expenses,food,-82.18,-26294.68
buyer_1,Luis,Garay,1996-08-10,22984418N,luis.garay@cooltech.tech,641191,ES45209531629390469205,4758.25,2023-04-10T11:03:30,Bilbao,expenses,transport,-70.11,-26364.79
buyer_1,Luis,Garay,1996-08-10,22984418N,luis.garay@cooltech.tech,641191,ES45209531629390469205,4758.25,2023-04-10T09:10:04,Bilbao,expenses,clothing,-119.65,-26484.44
buyer_1,Luis,Garay,1996-08-10,22984418N,luis.garay@cooltech.tech,641191,ES45209531629390469205,4758.25,2023-04-10T16:09:37,Bilbao,expenses,gifts,-322.18,-26806.62
buyer_1,Luis,Garay,1996-08-10,22984418N,luis.garay@cooltech.tech,641191,ES45209531629390469205,4758.25,2023-04-14T12:02:07,Bilbao,expenses,leisure,-56.41,-26863.03
buyer_1,Luis,Garay,1996-08-10,22984418N,luis.garay@cooltech.tech,641191,ES45209531629390469205,4758.25,2023-04-14T18:32:00,Bilbao,expenses,repairs,-174.05,-27037.08
buyer_1,Luis,Garay,1996-08-10,22984418N,luis.garay@cooltech.tech,641191,ES45209531629390469205,4758.25,2023-04-15T18:28:19,Bilbao,expenses,leisure,-29.84,-27066.92
buyer_1,Luis,Garay,1996-08-10,22984418N,luis.garay@cooltech.tech,641191,ES45209531629390469205,4758.25,2023-04-16T01:11:37,Bilbao,expenses,repairs,-103.58,-27170.5
buyer_1,Luis,Garay,1996-08-10,22984418N,luis.garay@cooltech.tech,641191,ES45209531629390469205,4758.25,2023-04-17T20:18:29,Bilbao,expenses,gifts,-287.33,-27457.83
buyer_1,Luis,Garay,1996-08-10,22984418N,luis.garay@cooltech.tech,641191,ES45209531629390469205,4758.25,2023-04-18T18:11:44,Bilbao,expenses,leisure,-20.64,-27478.47
buyer_1,Luis,Garay,1996-08-10,22984418N,luis.garay@cooltech.tech,641191,ES45209531629390469205,4758.25,2023-04-19T14:01:43,Bilbao,expenses,transport,-53.72,-27532.19
buyer_1,Luis,Garay,1996-08-10,22984418N,luis.garay@cooltech.tech,641191,ES45209531629390469205,4758.25,2023-04-19T10:19:03,Bilbao,expenses,leisure,-61.61,-27593.8
buyer_1,Luis,Garay,1996-08-10,22984418N,luis.garay@cooltech.tech,641191,ES45209531629390469205,4758.25,2023-04-19T13:02:08,Bilbao,expenses,travel,-431.8,-28025.6
buyer_1,Luis,Garay,1996-08-10,22984418N,luis.garay@cooltech.tech,641191,ES45209531629390469205,4758.25,2023-04-21T22:17:23,Bilbao,expenses,education,-77.39,-28102.99
buyer_1,Luis,Garay,1996-08-10,22984418N,luis.garay@cooltech.tech,641191,ES45209531629390469205,4758.25,2023-04-21T10:36:22,Bilbao,expenses,cash,-100.0,-28202.99
buyer_1,Luis,Garay,1996-08-10,22984418N,luis.garay@cooltech.tech,641191,ES45209531629390469205,4758.25,2023-04-23T18:33:58,Bilbao,expenses,appliances,-231.45,-28434.44
buyer_1,Luis,Garay,1996-08-10,22984418N,luis.garay@cooltech.tech,641191,ES45209531629390469205,4758.25,2023-04-26T09:47:04,Bilbao,expenses,clothing,-100.5,-28534.94
buyer_1,Luis,Garay,1996-08-10,22984418N,luis.garay@cooltech.tech,641191,ES45209531629390469205,4758.25,2023-04-27T14:54:14,Bilbao,expenses,education,-76.88,-28611.82
buyer_1,Luis,Garay,1996-08-10,22984418N,luis.garay@cooltech.tech,641191,ES45209531629390469205,4758.25,2023-04-29T21:13:56,Bilbao,expenses,education,-50.96,-28662.78
buyer_1,Luis,Garay,1996-08-10,22984418N,luis.garay@cooltech.tech,641191,ES45209531629390469205,4758.25,2023-04-30T11:22:05,Bilbao,expenses,leisure,-42.73,-28705.51
buyer_1,Luis,Garay,1996-08-10,22984418N,luis.garay@cooltech.tech,641191,ES45209531629390469205,4758.25,2023-05-01T10:41:50,Bilbao,incomes,salary,1494.23,-27211.28
buyer_1,Luis,Garay,1996-08-10,22984418N,luis.garay@cooltech.tech,641191,ES45209531629390469205,4758.25,2023-05-01T14:35:15,Bilbao,expenses,leisure,-27.34,-27238.62
buyer_1,Luis,Garay,1996-08-10,22984418N,luis.garay@cooltech.tech,641191,ES45209531629390469205,4758.25,2023-05-02T17:04:16,Bilbao,expenses,transport,-65.19,-27303.81
buyer_1,Luis,Garay,1996-08-10,22984418N,luis.garay@cooltech.tech,641191,ES45209531629390469205,4758.25,2023-05-04T13:37:45,Bilbao,expenses,rent,-483.94,-27787.75
buyer_1,Luis,Garay,1996-08-10,22984418N,luis.garay@cooltech.tech,641191,ES45209531629390469205,4758.25,2023-05-04T17:14:37,Bilbao,expenses,food,-113.58,-27901.33
buyer_1,Luis,Garay,1996-08-10,22984418N,luis.garay@cooltech.tech,641191,ES45209531629390469205,4758.25,2023-05-05T17:48:38,Bilbao,expenses,phone,-33.22,-27934.55
buyer_1,Luis,Garay,1996-08-10,22984418N,luis.garay@cooltech.tech,641191,ES45209531629390469205,4758.25,2023-05-05T09:09:29,Bilbao,expenses,cash,-100.0,-28034.55
buyer_1,Luis,Garay,1996-08-10,22984418N,luis.garay@cooltech.tech,641191,ES45209531629390469205,4758.25,2023-05-05T16:00:02,Bilbao,expenses,travel,-424.09,-28458.64
buyer_1,Luis,Garay,1996-08-10,22984418N,luis.garay@cooltech.tech,641191,ES45209531629390469205,4758.25,2023-05-06T10:06:50,Bilbao,expenses,water,-28.52,-28487.16
buyer_1,Luis,Garay,1996-08-10,22984418N,luis.garay@cooltech.tech,641191,ES45209531629390469205,4758.25,2023-05-06T12:04:44,Bilbao,expenses,internet,-31.38,-28518.54
buyer_1,Luis,Garay,1996-08-10,22984418N,luis.garay@cooltech.tech,641191,ES45209531629390469205,4758.25,2023-05-07T09:05:30,Bilbao,expenses,travel,-365.26,-28883.8
buyer_1,Luis,Garay,1996-08-10,22984418N,luis.garay@cooltech.tech,641191,ES45209531629390469205,4758.25,2023-05-08T10:39:45,Bilbao,expenses,electricity,-24.92,-28908.72
buyer_1,Luis,Garay,1996-08-10,22984418N,luis.garay@cooltech.tech,641191,ES45209531629390469205,4758.25,2023-05-08T18:41:34,Bilbao,expenses,gas,-35.92,-28944.64
buyer_1,Luis,Garay,1996-08-10,22984418N,luis.garay@cooltech.tech,641191,ES45209531629390469205,4758.25,2023-05-08T19:03:55,Bilbao,expenses,transport,-69.06,-29013.7
buyer_1,Luis,Garay,1996-08-10,22984418N,luis.garay@cooltech.tech,641191,ES45209531629390469205,4758.25,2023-05-09T23:40:29,Bilbao,expenses,appliances,-203.62,-29217.32
buyer_1,Luis,Garay,1996-08-10,22984418N,luis.garay@cooltech.tech,641191,ES45209531629390469205,4758.25,2023-05-11T15:36:39,Bilbao,expenses,clothing,-127.58,-29344.9
buyer_1,Luis,Garay,1996-08-10,22984418N,luis.garay@cooltech.tech,641191,ES45209531629390469205,4758.25,2023-05-13T08:29:24,Bilbao,expenses,cash,-100.0,-29444.9
buyer_1,Luis,Garay,1996-08-10,22984418N,luis.garay@cooltech.tech,641191,ES45209531629390469205,4758.25,2023-05-15T18:20:28,Bilbao,expenses,leisure,-27.11,-29472.01
buyer_1,Luis,Garay,1996-08-10,22984418N,luis.garay@cooltech.tech,641191,ES45209531629390469205,4758.25,2023-05-16T10:08:41,Bilbao,expenses,food,-119.97,-29591.98
buyer_1,Luis,Garay,1996-08-10,22984418N,luis.garay@cooltech.tech,641191,ES45209531629390469205,4758.25,2023-05-18T18:45:38,Bilbao,expenses,food,-74.33,-29666.31
buyer_1,Luis,Garay,1996-08-10,22984418N,luis.garay@cooltech.tech,641191,ES45209531629390469205,4758.25,2023-05-18T12:43:25,Bilbao,expenses,clothing,-70.87,-29737.18
buyer_1,Luis,Garay,1996-08-10,22984418N,luis.garay@cooltech.tech,641191,ES45209531629390469205,4758.25,2023-05-18T19:46:05,Bilbao,expenses,gifts,-268.78,-30005.96
buyer_1,Luis,Garay,1996-08-10,22984418N,luis.garay@cooltech.tech,641191,ES45209531629390469205,4758.25,2023-05-19T13:24:35,Bilbao,expenses,transport,-55.84,-30061.8
buyer_1,Luis,Garay,1996-08-10,22984418N,luis.garay@cooltech.tech,641191,ES45209531629390469205,4758.25,2023-05-21T00:01:05,Bilbao,expenses,leisure,-74.15,-30135.95
buyer_1,Luis,Garay,1996-08-10,22984418N,luis.garay@cooltech.tech,641191,ES45209531629390469205,4758.25,2023-05-21T18:30:53,Bilbao,expenses,cash,-100.0,-30235.95
buyer_1,Luis,Garay,1996-08-10,22984418N,luis.garay@cooltech.tech,641191,ES45209531629390469205,4758.25,2023-05-21T13:33:39,Bilbao,expenses,travel,-437.47,-30673.42
buyer_1,Luis,Garay,1996-08-10,22984418N,luis.garay@cooltech.tech,641191,ES45209531629390469205,4758.25,2023-05-23T23:01:52,Bilbao,expenses,transport,-67.06,-30740.48
buyer_1,Luis,Garay,1996-08-10,22984418N,luis.garay@cooltech.tech,641191,ES45209531629390469205,4758.25,2023-05-24T17:57:37,Bilbao,expenses,appliances,-136.26,-30876.74
buyer_1,Luis,Garay,1996-08-10,22984418N,luis.garay@cooltech.tech,641191,ES45209531629390469205,4758.25,2023-05-24T18:48:41,Bilbao,expenses,gifts,-193.24,-31069.98
buyer_1,Luis,Garay,1996-08-10,22984418N,luis.garay@cooltech.tech,641191,ES45209531629390469205,4758.25,2023-05-25T16:08:45,Bilbao,expenses,cash,-100.0,-31169.98
buyer_1,Luis,Garay,1996-08-10,22984418N,luis.garay@cooltech.tech,641191,ES45209531629390469205,4758.25,2023-05-27T17:59:53,Bilbao,expenses,transport,-65.87,-31235.85
buyer_1,Luis,Garay,1996-08-10,22984418N,luis.garay@cooltech.tech,641191,ES45209531629390469205,4758.25,2023-05-27T11:28:02,Bilbao,expenses,cash,-100.0,-31335.85
buyer_1,Luis,Garay,1996-08-10,22984418N,luis.garay@cooltech.tech,641191,ES45209531629390469205,4758.25,2023-05-29T20:07:23,Bilbao,expenses,transport,-65.82,-31401.67
buyer_1,Luis,Garay,1996-08-10,22984418N,luis.garay@cooltech.tech,641191,ES45209531629390469205,4758.25,2023-05-30T08:55:04,Bilbao,expenses,repairs,-259.6,-31661.27
buyer_1,Luis,Garay,1996-08-10,22984418N,luis.garay@cooltech.tech,641191,ES45209531629390469205,4758.25,2023-06-01T13:30:44,Bilbao,incomes,salary,1494.23,-30167.04
buyer_1,Luis,Garay,1996-08-10,22984418N,luis.garay@cooltech.tech,641191,ES45209531629390469205,4758.25,2023-06-01T13:30:44,Bilbao,incomes,salary_bonus,1193.26,-28973.78
buyer_1,Luis,Garay,1996-08-10,22984418N,luis.garay@cooltech.tech,641191,ES45209531629390469205,4758.25,2023-06-03T12:57:53,Bilbao,expenses,taxes,-1336.74,-30310.52
buyer_1,Luis,Garay,1996-08-10,22984418N,luis.garay@cooltech.tech,641191,ES45209531629390469205,4758.25,2023-06-03T11:10:15,Bilbao,expenses,insurance,-237.94,-30548.46
buyer_1,Luis,Garay,1996-08-10,22984418N,luis.garay@cooltech.tech,641191,ES45209531629390469205,4758.25,2023-06-04T12:31:32,Bilbao,expenses,rent,-483.94,-31032.4
buyer_1,Luis,Garay,1996-08-10,22984418N,luis.garay@cooltech.tech,641191,ES45209531629390469205,4758.25,2023-06-04T11:34:06,Bilbao,expenses,transport,-85.97,-31118.37
buyer_1,Luis,Garay,1996-08-10,22984418N,luis.garay@cooltech.tech,641191,ES45209531629390469205,4758.25,2023-06-04T09:07:58,Bilbao,expenses,appliances,-378.72,-31497.09
buyer_1,Luis,Garay,1996-08-10,22984418N,luis.garay@cooltech.tech,641191,ES45209531629390469205,4758.25,2023-06-04T02:23:31,Bilbao,expenses,repairs,-92.69,-31589.78
buyer_1,Luis,Garay,1996-08-10,22984418N,luis.garay@cooltech.tech,641191,ES45209531629390469205,4758.25,2023-06-05T11:56:13,Bilbao,expenses,food,-80.54,-31670.32
buyer_1,Luis,Garay,1996-08-10,22984418N,luis.garay@cooltech.tech,641191,ES45209531629390469205,4758.25,2023-06-05T18:55:42,Bilbao,expenses,cash,-100.0,-31770.32
buyer_1,Luis,Garay,1996-08-10,22984418N,luis.garay@cooltech.tech,641191,ES45209531629390469205,4758.25,2023-06-06T15:30:09,Bilbao,expenses,gas,-37.03,-31807.35
buyer_1,Luis,Garay,1996-08-10,22984418N,luis.garay@cooltech.tech,641191,ES45209531629390469205,4758.25,2023-06-06T17:15:53,Bilbao,expenses,food,-91.39,-31898.74
buyer_1,Luis,Garay,1996-08-10,22984418N,luis.garay@cooltech.tech,641191,ES45209531629390469205,4758.25,2023-06-06T20:16:18,Bilbao,expenses,travel,-417.37,-32316.11
buyer_1,Luis,Garay,1996-08-10,22984418N,luis.garay@cooltech.tech,641191,ES45209531629390469205,4758.25,2023-06-07T20:09:17,Bilbao,expenses,leisure,-48.92,-32365.03
buyer_1,Luis,Garay,1996-08-10,22984418N,luis.garay@cooltech.tech,641191,ES45209531629390469205,4758.25,2023-06-07T18:57:23,Bilbao,expenses,cash,-100.0,-32465.03
buyer_1,Luis,Garay,1996-08-10,22984418N,luis.garay@cooltech.tech,641191,ES45209531629390469205,4758.25,2023-06-08T17:41:33,Bilbao,expenses,water,-20.95,-32485.98
buyer_1,Luis,Garay,1996-08-10,22984418N,luis.garay@cooltech.tech,641191,ES45209531629390469205,4758.25,2023-06-08T09:17:15,Bilbao,expenses,electricity,-16.89,-32502.87
buyer_1,Luis,Garay,1996-08-10,22984418N,luis.garay@cooltech.tech,641191,ES45209531629390469205,4758.25,2023-06-08T13:13:20,Bilbao,expenses,internet,-31.38,-32534.25
buyer_1,Luis,Garay,1996-08-10,22984418N,luis.garay@cooltech.tech,641191,ES45209531629390469205,4758.25,2023-06-08T16:17:29,Bilbao,expenses,phone,-22.96,-32557.21
buyer_1,Luis,Garay,1996-08-10,22984418N,luis.garay@cooltech.tech,641191,ES45209531629390469205,4758.25,2023-06-08T12:01:07,Bilbao,expenses,transport,-52.46,-32609.67
buyer_1,Luis,Garay,1996-08-10,22984418N,luis.garay@cooltech.tech,641191,ES45209531629390469205,4758.25,2023-06-08T10:39:32,Bilbao,expenses,education,-76.54,-32686.21
buyer_1,Luis,Garay,1996-08-10,22984418N,luis.garay@cooltech.tech,641191,ES45209531629390469205,4758.25,2023-06-11T15:44:40,Bilbao,expenses,food,-70.79,-32757.0
buyer_1,Luis,Garay,1996-08-10,22984418N,luis.garay@cooltech.tech,641191,ES45209531629390469205,4758.25,2023-06-11T14:56:54,Bilbao,expenses,repairs,-174.98,-32931.98
buyer_1,Luis,Garay,1996-08-10,22984418N,luis.garay@cooltech.tech,641191,ES45209531629390469205,4758.25,2023-06-12T17:46:29,Bilbao,expenses,leisure,-69.26,-33001.24
buyer_1,Luis,Garay,1996-08-10,22984418N,luis.garay@cooltech.tech,641191,ES45209531629390469205,4758.25,2023-06-13T09:09:31,Bilbao,expenses,leisure,-76.91,-33078.15
buyer_1,Luis,Garay,1996-08-10,22984418N,luis.garay@cooltech.tech,641191,ES45209531629390469205,4758.25,2023-06-15T16:53:34,Bilbao,expenses,food,-99.24,-33177.39
buyer_1,Luis,Garay,1996-08-10,22984418N,luis.garay@cooltech.tech,641191,ES45209531629390469205,4758.25,2023-06-15T15:49:19,Bilbao,expenses,repairs,-117.71,-33295.1
buyer_1,Luis,Garay,1996-08-10,22984418N,luis.garay@cooltech.tech,641191,ES45209531629390469205,4758.25,2023-06-16T14:31:58,Bilbao,expenses,leisure,-69.78,-33364.88
buyer_1,Luis,Garay,1996-08-10,22984418N,luis.garay@cooltech.tech,641191,ES45209531629390469205,4758.25,2023-06-16T11:44:20,Bilbao,expenses,travel,-429.57,-33794.45
buyer_1,Luis,Garay,1996-08-10,22984418N,luis.garay@cooltech.tech,641191,ES45209531629390469205,4758.25,2023-06-17T10:43:00,Bilbao,expenses,transport,-88.43,-33882.88
buyer_1,Luis,Garay,1996-08-10,22984418N,luis.garay@cooltech.tech,641191,ES45209531629390469205,4758.25,2023-06-18T21:50:21,Bilbao,expenses,food,-123.63,-34006.51
buyer_1,Luis,Garay,1996-08-10,22984418N,luis.garay@cooltech.tech,641191,ES45209531629390469205,4758.25,2023-06-19T13:18:26,Bilbao,expenses,leisure,-44.09,-34050.6
buyer_1,Luis,Garay,1996-08-10,22984418N,luis.garay@cooltech.tech,641191,ES45209531629390469205,4758.25,2023-06-21T20:11:37,Bilbao,expenses,transport,-84.35,-34134.95
buyer_1,Luis,Garay,1996-08-10,22984418N,luis.garay@cooltech.tech,641191,ES45209531629390469205,4758.25,2023-06-22T18:12:11,Bilbao,expenses,food,-73.32,-34208.27
buyer_1,Luis,Garay,1996-08-10,22984418N,luis.garay@cooltech.tech,641191,ES45209531629390469205,4758.25,2023-06-22T11:18:04,Bilbao,expenses,repairs,-225.41,-34433.68
buyer_1,Luis,Garay,1996-08-10,22984418N,luis.garay@cooltech.tech,641191,ES45209531629390469205,4758.25,2023-06-24T15:23:01,Bilbao,expenses,transport,-43.67,-34477.35
buyer_1,Luis,Garay,1996-08-10,22984418N,luis.garay@cooltech.tech,641191,ES45209531629390469205,4758.25,2023-06-24T09:02:10,Bilbao,expenses,leisure,-69.11,-34546.46
buyer_1,Luis,Garay,1996-08-10,22984418N,luis.garay@cooltech.tech,641191,ES45209531629390469205,4758.25,2023-06-24T08:34:51,Bilbao,expenses,education,-69.26,-34615.72
buyer_1,Luis,Garay,1996-08-10,22984418N,luis.garay@cooltech.tech,641191,ES45209531629390469205,4758.25,2023-06-25T15:33:56,Bilbao,expenses,education,-50.18,-34665.9
buyer_1,Luis,Garay,1996-08-10,22984418N,luis.garay@cooltech.tech,641191,ES45209531629390469205,4758.25,2023-06-27T10:58:10,Bilbao,expenses,education,-74.08,-34739.98
buyer_1,Luis,Garay,1996-08-10,22984418N,luis.garay@cooltech.tech,641191,ES45209531629390469205,4758.25,2023-06-29T14:52:29,Bilbao,expenses,cash,-100.0,-34839.98
buyer_1,Luis,Garay,1996-08-10,22984418N,luis.garay@cooltech.tech,641191,ES45209531629390469205,4758.25,2023-07-01T20:54:47,Bilbao,incomes,salary,1494.23,-33345.75
buyer_1,Luis,Garay,1996-08-10,22984418N,luis.garay@cooltech.tech,641191,ES45209531629390469205,4758.25,2023-07-01T20:54:47,Bilbao,incomes,extra_income,156.73,-33189.02
buyer_1,Luis,Garay,1996-08-10,22984418N,luis.garay@cooltech.tech,641191,ES45209531629390469205,4758.25,2023-07-01T10:16:47,Bilbao,expenses,leisure,-64.46,-33253.48
buyer_1,Luis,Garay,1996-08-10,22984418N,luis.garay@cooltech.tech,641191,ES45209531629390469205,4758.25,2023-07-01T04:39:37,Bilbao,expenses,clothing,-154.74,-33408.22
buyer_1,Luis,Garay,1996-08-10,22984418N,luis.garay@cooltech.tech,641191,ES45209531629390469205,4758.25,2023-07-02T10:28:24,Bilbao,expenses,gifts,-554.74,-33962.96
buyer_1,Luis,Garay,1996-08-10,22984418N,luis.garay@cooltech.tech,641191,ES45209531629390469205,4758.25,2023-07-03T14:18:57,Bilbao,expenses,leisure,-51.33,-34014.29
buyer_1,Luis,Garay,1996-08-10,22984418N,luis.garay@cooltech.tech,641191,ES45209531629390469205,4758.25,2023-07-04T21:43:50,Bilbao,expenses,rent,-483.94,-34498.23
buyer_1,Luis,Garay,1996-08-10,22984418N,luis.garay@cooltech.tech,641191,ES45209531629390469205,4758.25,2023-07-04T10:14:17,Bilbao,expenses,cash,-100.0,-34598.23
buyer_1,Luis,Garay,1996-08-10,22984418N,luis.garay@cooltech.tech,641191,ES45209531629390469205,4758.25,2023-07-05T12:49:28,Bilbao,expenses,internet,-31.38,-34629.61
buyer_1,Luis,Garay,1996-08-10,22984418N,luis.garay@cooltech.tech,641191,ES45209531629390469205,4758.25,2023-07-05T12:58:28,Bilbao,expenses,leisure,-32.64,-34662.25
buyer_1,Luis,Garay,1996-08-10,22984418N,luis.garay@cooltech.tech,641191,ES45209531629390469205,4758.25,2023-07-06T18:49:05,Bilbao,expenses,phone,-23.47,-34685.72
buyer_1,Luis,Garay,1996-08-10,22984418N,luis.garay@cooltech.tech,641191,ES45209531629390469205,4758.25,2023-07-07T12:44:52,Bilbao,expenses,water,-21.94,-34707.66
buyer_1,Luis,Garay,1996-08-10,22984418N,luis.garay@cooltech.tech,641191,ES45209531629390469205,4758.25,2023-07-07T18:28:52,Bilbao,expenses,gas,-66.24,-34773.9
buyer_1,Luis,Garay,1996-08-10,22984418N,luis.garay@cooltech.tech,641191,ES45209531629390469205,4758.25,2023-07-08T12:16:36,Bilbao,expenses,electricity,-60.94,-34834.84
buyer_1,Luis,Garay,1996-08-10,22984418N,luis.garay@cooltech.tech,641191,ES45209531629390469205,4758.25,2023-07-09T17:46:36,Bilbao,expenses,appliances,-404.87,-35239.71
buyer_1,Luis,Garay,1996-08-10,22984418N,luis.garay@cooltech.tech,641191,ES45209531629390469205,4758.25,2023-07-11T15:49:41,Bilbao,expenses,education,-74.76,-35314.47
buyer_1,Luis,Garay,1996-08-10,22984418N,luis.garay@cooltech.tech,641191,ES45209531629390469205,4758.25,2023-07-12T19:33:46,Bilbao,expenses,transport,-66.15,-35380.62
buyer_1,Luis,Garay,1996-08-10,22984418N,luis.garay@cooltech.tech,641191,ES45209531629390469205,4758.25,2023-07-12T15:32:20,Bilbao,expenses,cash,-100.0,-35480.62
buyer_1,Luis,Garay,1996-08-10,22984418N,luis.garay@cooltech.tech,641191,ES45209531629390469205,4758.25,2023-07-14T10:01:38,Bilbao,expenses,cash,-100.0,-35580.62
buyer_1,Luis,Garay,1996-08-10,22984418N,luis.garay@cooltech.tech,641191,ES45209531629390469205,4758.25,2023-07-20T17:33:40,Bilbao,expenses,cash,-100.0,-35680.62
buyer_1,Luis,Garay,1996-08-10,22984418N,luis.garay@cooltech.tech,641191,ES45209531629390469205,4758.25,2023-07-22T12:57:07,Bilbao,expenses,gifts,-331.49,-36012.11
buyer_1,Luis,Garay,1996-08-10,22984418N,luis.garay@cooltech.tech,641191,ES45209531629390469205,4758.25,2023-07-24T10:00:15,Bilbao,expenses,transport,-47.96,-36060.07
buyer_1,Luis,Garay,1996-08-10,22984418N,luis.garay@cooltech.tech,641191,ES45209531629390469205,4758.25,2023-07-24T15:31:05,Bilbao,expenses,cash,-100.0,-36160.07
buyer_1,Luis,Garay,1996-08-10,22984418N,luis.garay@cooltech.tech,641191,ES45209531629390469205,4758.25,2023-07-24T19:19:37,Bilbao,expenses,gifts,-476.8,-36636.87
buyer_1,Luis,Garay,1996-08-10,22984418N,luis.garay@cooltech.tech,641191,ES45209531629390469205,4758.25,2023-07-25T23:50:24,Bilbao,expenses,leisure,-72.15,-36709.02
buyer_1,Luis,Garay,1996-08-10,22984418N,luis.garay@cooltech.tech,641191,ES45209531629390469205,4758.25,2023-07-26T08:38:57,Bilbao,expenses,cash,-100.0,-36809.02
buyer_1,Luis,Garay,1996-08-10,22984418N,luis.garay@cooltech.tech,641191,ES45209531629390469205,4758.25,2023-07-27T06:25:10,Bilbao,expenses,leisure,-22.19,-36831.21
buyer_1,Luis,Garay,1996-08-10,22984418N,luis.garay@cooltech.tech,641191,ES45209531629390469205,4758.25,2023-08-01T21:06:02,Bilbao,incomes,salary,1494.23,-35336.98
buyer_1,Luis,Garay,1996-08-10,22984418N,luis.garay@cooltech.tech,641191,ES45209531629390469205,4758.25,2023-08-01T10:45:32,Bilbao,expenses,gifts,-615.61,-35952.59
buyer_1,Luis,Garay,1996-08-10,22984418N,luis.garay@cooltech.tech,641191,ES45209531629390469205,4758.25,2023-08-02T11:51:57,Bilbao,expenses,cash,-100.0,-36052.59
buyer_1,Luis,Garay,1996-08-10,22984418N,luis.garay@cooltech.tech,641191,ES45209531629390469205,4758.25,2023-08-04T17:41:48,Bilbao,expenses,rent,-483.94,-36536.53
buyer_1,Luis,Garay,1996-08-10,22984418N,luis.garay@cooltech.tech,641191,ES45209531629390469205,4758.25,2023-08-04T00:56:56,Bilbao,expenses,cash,-100.0,-36636.53
buyer_1,Luis,Garay,1996-08-10,22984418N,luis.garay@cooltech.tech,641191,ES45209531629390469205,4758.25,2023-08-04T18:36:09,Bilbao,expenses,travel,-356.21,-36992.74
buyer_1,Luis,Garay,1996-08-10,22984418N,luis.garay@cooltech.tech,641191,ES45209531629390469205,4758.25,2023-08-05T18:53:13,Bilbao,expenses,phone,-23.66,-37016.4
buyer_1,Luis,Garay,1996-08-10,22984418N,luis.garay@cooltech.tech,641191,ES45209531629390469205,4758.25,2023-08-05T10:57:43,Bilbao,expenses,gifts,-369.24,-37385.64
buyer_1,Luis,Garay,1996-08-10,22984418N,luis.garay@cooltech.tech,641191,ES45209531629390469205,4758.25,2023-08-06T14:12:04,Bilbao,expenses,water,-32.94,-37418.58
buyer_1,Luis,Garay,1996-08-10,22984418N,luis.garay@cooltech.tech,641191,ES45209531629390469205,4758.25,2023-08-06T19:52:42,Bilbao,expenses,gas,-75.17,-37493.75
buyer_1,Luis,Garay,1996-08-10,22984418N,luis.garay@cooltech.tech,641191,ES45209531629390469205,4758.25,2023-08-06T04:34:35,Bilbao,expenses,food,-88.89,-37582.64
buyer_1,Luis,Garay,1996-08-10,22984418N,luis.garay@cooltech.tech,641191,ES45209531629390469205,4758.25,2023-08-06T17:17:30,Bilbao,expenses,healthcare,-74.61,-37657.25
buyer_1,Luis,Garay,1996-08-10,22984418N,luis.garay@cooltech.tech,641191,ES45209531629390469205,4758.25,2023-08-07T13:14:59,Bilbao,expenses,internet,-31.38,-37688.63
buyer_1,Luis,Garay,1996-08-10,22984418N,luis.garay@cooltech.tech,641191,ES45209531629390469205,4758.25,2023-08-08T09:37:12,Bilbao,expenses,electricity,-52.67,-37741.3
buyer_1,Luis,Garay,1996-08-10,22984418N,luis.garay@cooltech.tech,641191,ES45209531629390469205,4758.25,2023-08-08T19:54:17,Bilbao,expenses,food,-102.71,-37844.01
buyer_1,Luis,Garay,1996-08-10,22984418N,luis.garay@cooltech.tech,641191,ES45209531629390469205,4758.25,2023-08-08T13:06:01,Bilbao,expenses,transport,-80.96,-37924.97
buyer_1,Luis,Garay,1996-08-10,22984418N,luis.garay@cooltech.tech,641191,ES45209531629390469205,4758.25,2023-08-10T14:39:09,Bilbao,expenses,leisure,-29.18,-37954.15
buyer_1,Luis,Garay,1996-08-10,22984418N,luis.garay@cooltech.tech,641191,ES45209531629390469205,4758.25,2023-08-11T00:32:57,Bilbao,expenses,cash,-100.0,-38054.15
buyer_1,Luis,Garay,1996-08-10,22984418N,luis.garay@cooltech.tech,641191,ES45209531629390469205,4758.25,2023-08-11T11:23:40,Bilbao,expenses,repairs,-257.08,-38311.23
buyer_1,Luis,Garay,1996-08-10,22984418N,luis.garay@cooltech.tech,641191,ES45209531629390469205,4758.25,2023-08-13T14:49:33,Bilbao,expenses,gifts,-611.24,-38922.47
buyer_1,Luis,Garay,1996-08-10,22984418N,luis.garay@cooltech.tech,641191,ES45209531629390469205,4758.25,2023-08-15T13:10:12,Bilbao,expenses,repairs,-200.31,-39122.78
buyer_1,Luis,Garay,1996-08-10,22984418N,luis.garay@cooltech.tech,641191,ES45209531629390469205,4758.25,2023-08-17T12:22:23,Bilbao,expenses,leisure,-45.48,-39168.26
buyer_1,Luis,Garay,1996-08-10,22984418N,luis.garay@cooltech.tech,641191,ES45209531629390469205,4758.25,2023-08-19T09:23:09,Bilbao,expenses,cash,-100.0,-39268.26
buyer_1,Luis,Garay,1996-08-10,22984418N,luis.garay@cooltech.tech,641191,ES45209531629390469205,4758.25,2023-08-20T13:30:29,Bilbao,expenses,cash,-100.0,-39368.26
buyer_1,Luis,Garay,1996-08-10,22984418N,luis.garay@cooltech.tech,641191,ES45209531629390469205,4758.25,2023-08-20T12:42:45,Bilbao,expenses,repairs,-319.1,-39687.36
buyer_1,Luis,Garay,1996-08-10,22984418N,luis.garay@cooltech.tech,641191,ES45209531629390469205,4758.25,2023-08-20T15:22:25,Bilbao,expenses,gifts,-110.25,-39797.61
buyer_1,Luis,Garay,1996-08-10,22984418N,luis.garay@cooltech.tech,641191,ES45209531629390469205,4758.25,2023-08-22T08:34:54,Bilbao,expenses,repairs,-210.15,-40007.76
buyer_1,Luis,Garay,1996-08-10,22984418N,luis.garay@cooltech.tech,641191,ES45209531629390469205,4758.25,2023-08-23T18:55:19,Bilbao,expenses,food,-68.62,-40076.38
buyer_1,Luis,Garay,1996-08-10,22984418N,luis.garay@cooltech.tech,641191,ES45209531629390469205,4758.25,2023-08-25T11:47:34,Bilbao,expenses,appliances,-310.73,-40387.11
buyer_1,Luis,Garay,1996-08-10,22984418N,luis.garay@cooltech.tech,641191,ES45209531629390469205,4758.25,2023-08-26T11:33:01,Bilbao,expenses,food,-65.77,-40452.88
buyer_1,Luis,Garay,1996-08-10,22984418N,luis.garay@cooltech.tech,641191,ES45209531629390469205,4758.25,2023-08-27T12:33:16,Bilbao,expenses,cash,-100.0,-40552.88
buyer_1,Luis,Garay,1996-08-10,22984418N,luis.garay@cooltech.tech,641191,ES45209531629390469205,4758.25,2023-08-27T06:56:27,Bilbao,expenses,repairs,-112.44,-40665.32
buyer_1,Luis,Garay,1996-08-10,22984418N,luis.garay@cooltech.tech,641191,ES45209531629390469205,4758.25,2023-08-29T08:52:29,Bilbao,expenses,food,-118.22,-40783.54
buyer_1,Luis,Garay,1996-08-10,22984418N,luis.garay@cooltech.tech,641191,ES45209531629390469205,4758.25,2023-08-29T07:37:01,Bilbao,expenses,leisure,-33.45,-40816.99
buyer_1,Luis,Garay,1996-08-10,22984418N,luis.garay@cooltech.tech,641191,ES45209531629390469205,4758.25,2023-08-30T18:41:43,Bilbao,expenses,food,-95.18,-40912.17
buyer_1,Luis,Garay,1996-08-10,22984418N,luis.garay@cooltech.tech,641191,ES45209531629390469205,4758.25,2023-09-01T02:49:02,Bilbao,incomes,salary,1494.23,-39417.94
buyer_1,Luis,Garay,1996-08-10,22984418N,luis.garay@cooltech.tech,641191,ES45209531629390469205,4758.25,2023-09-03T16:11:18,Bilbao,expenses,food,-88.65,-39506.59
buyer_1,Luis,Garay,1996-08-10,22984418N,luis.garay@cooltech.tech,641191,ES45209531629390469205,4758.25,2023-09-04T17:15:49,Bilbao,expenses,rent,-483.94,-39990.53
buyer_1,Luis,Garay,1996-08-10,22984418N,luis.garay@cooltech.tech,641191,ES45209531629390469205,4758.25,2023-09-04T11:41:57,Bilbao,expenses,cash,-100.0,-40090.53
buyer_1,Luis,Garay,1996-08-10,22984418N,luis.garay@cooltech.tech,641191,ES45209531629390469205,4758.25,2023-09-04T20:53:02,Bilbao,expenses,appliances,-379.42,-40469.95
buyer_1,Luis,Garay,1996-08-10,22984418N,luis.garay@cooltech.tech,641191,ES45209531629390469205,4758.25,2023-09-05T16:48:15,Bilbao,expenses,water,-25.31,-40495.26
buyer_1,Luis,Garay,1996-08-10,22984418N,luis.garay@cooltech.tech,641191,ES45209531629390469205,4758.25,2023-09-05T12:23:49,Bilbao,expenses,gas,-78.82,-40574.08
buyer_1,Luis,Garay,1996-08-10,22984418N,luis.garay@cooltech.tech,641191,ES45209531629390469205,4758.25,2023-09-05T00:39:27,Bilbao,expenses,phone,-23.12,-40597.2
buyer_1,Luis,Garay,1996-08-10,22984418N,luis.garay@cooltech.tech,641191,ES45209531629390469205,4758.25,2023-09-05T13:54:00,Bilbao,expenses,food,-118.38,-40715.58
buyer_1,Luis,Garay,1996-08-10,22984418N,luis.garay@cooltech.tech,641191,ES45209531629390469205,4758.25,2023-09-05T18:04:13,Bilbao,expenses,leisure,-41.31,-40756.89
buyer_1,Luis,Garay,1996-08-10,22984418N,luis.garay@cooltech.tech,641191,ES45209531629390469205,4758.25,2023-09-05T12:20:16,Bilbao,expenses,cash,-100.0,-40856.89
buyer_1,Luis,Garay,1996-08-10,22984418N,luis.garay@cooltech.tech,641191,ES45209531629390469205,4758.25,2023-09-06T18:54:11,Bilbao,expenses,internet,-31.38,-40888.27
buyer_1,Luis,Garay,1996-08-10,22984418N,luis.garay@cooltech.tech,641191,ES45209531629390469205,4758.25,2023-09-06T23:50:24,Bilbao,expenses,gifts,-224.24,-41112.51
buyer_1,Luis,Garay,1996-08-10,22984418N,luis.garay@cooltech.tech,641191,ES45209531629390469205,4758.25,2023-09-07T16:59:33,Bilbao,expenses,gifts,-265.81,-41378.32
buyer_1,Luis,Garay,1996-08-10,22984418N,luis.garay@cooltech.tech,641191,ES45209531629390469205,4758.25,2023-09-08T11:28:54,Bilbao,expenses,electricity,-22.27,-41400.59
buyer_1,Luis,Garay,1996-08-10,22984418N,luis.garay@cooltech.tech,641191,ES45209531629390469205,4758.25,2023-09-10T20:24:38,Bilbao,expenses,appliances,-232.98,-41633.57
buyer_1,Luis,Garay,1996-08-10,22984418N,luis.garay@cooltech.tech,641191,ES45209531629390469205,4758.25,2023-09-11T18:27:20,Bilbao,expenses,clothing,-148.26,-41781.83
buyer_1,Luis,Garay,1996-08-10,22984418N,luis.garay@cooltech.tech,641191,ES45209531629390469205,4758.25,2023-09-11T22:00:09,Bilbao,expenses,education,-51.8,-41833.63
buyer_1,Luis,Garay,1996-08-10,22984418N,luis.garay@cooltech.tech,641191,ES45209531629390469205,4758.25,2023-09-12T15:40:45,Bilbao,expenses,leisure,-80.25,-41913.88
buyer_1,Luis,Garay,1996-08-10,22984418N,luis.garay@cooltech.tech,641191,ES45209531629390469205,4758.25,2023-09-12T08:21:38,Bilbao,expenses,repairs,-142.45,-42056.33
buyer_1,Luis,Garay,1996-08-10,22984418N,luis.garay@cooltech.tech,641191,ES45209531629390469205,4758.25,2023-09-13T22:08:43,Bilbao,expenses,food,-97.55,-42153.88
buyer_1,Luis,Garay,1996-08-10,22984418N,luis.garay@cooltech.tech,641191,ES45209531629390469205,4758.25,2023-09-13T20:12:39,Bilbao,expenses,repairs,-60.21,-42214.09
buyer_1,Luis,Garay,1996-08-10,22984418N,luis.garay@cooltech.tech,641191,ES45209531629390469205,4758.25,2023-09-15T08:04:39,Bilbao,expenses,transport,-71.3,-42285.39
buyer_1,Luis,Garay,1996-08-10,22984418N,luis.garay@cooltech.tech,641191,ES45209531629390469205,4758.25,2023-09-15T08:04:31,Bilbao,expenses,clothing,-111.48,-42396.87
buyer_1,Luis,Garay,1996-08-10,22984418N,luis.garay@cooltech.tech,641191,ES45209531629390469205,4758.25,2023-09-16T18:58:10,Bilbao,expenses,appliances,-222.86,-42619.73
buyer_1,Luis,Garay,1996-08-10,22984418N,luis.garay@cooltech.tech,641191,ES45209531629390469205,4758.25,2023-09-18T09:06:48,Bilbao,expenses,cash,-100.0,-42719.73
buyer_1,Luis,Garay,1996-08-10,22984418N,luis.garay@cooltech.tech,641191,ES45209531629390469205,4758.25,2023-09-20T10:40:07,Bilbao,expenses,cash,-100.0,-42819.73
buyer_1,Luis,Garay,1996-08-10,22984418N,luis.garay@cooltech.tech,641191,ES45209531629390469205,4758.25,2023-09-21T09:30:15,Bilbao,expenses,food,-64.17,-42883.9
buyer_1,Luis,Garay,1996-08-10,22984418N,luis.garay@cooltech.tech,641191,ES45209531629390469205,4758.25,2023-09-22T13:42:26,Bilbao,expenses,leisure,-38.65,-42922.55
buyer_1,Luis,Garay,1996-08-10,22984418N,luis.garay@cooltech.tech,641191,ES45209531629390469205,4758.25,2023-09-22T11:23:33,Bilbao,expenses,repairs,-169.01,-43091.56
buyer_1,Luis,Garay,1996-08-10,22984418N,luis.garay@cooltech.tech,641191,ES45209531629390469205,4758.25,2023-09-24T18:48:11,Bilbao,expenses,leisure,-69.27,-43160.83
buyer_1,Luis,Garay,1996-08-10,22984418N,luis.garay@cooltech.tech,641191,ES45209531629390469205,4758.25,2023-09-24T15:59:14,Bilbao,expenses,repairs,-93.93,-43254.76
buyer_1,Luis,Garay,1996-08-10,22984418N,luis.garay@cooltech.tech,641191,ES45209531629390469205,4758.25,2023-09-26T20:58:05,Bilbao,expenses,food,-122.17,-43376.93
buyer_1,Luis,Garay,1996-08-10,22984418N,luis.garay@cooltech.tech,641191,ES45209531629390469205,4758.25,2023-09-29T19:44:19,Bilbao,expenses,food,-107.83,-43484.76
buyer_1,Luis,Garay,1996-08-10,22984418N,luis.garay@cooltech.tech,641191,ES45209531629390469205,4758.25,2023-09-29T09:34:21,Bilbao,expenses,leisure,-61.11,-43545.87
buyer_1,Luis,Garay,1996-08-10,22984418N,luis.garay@cooltech.tech,641191,ES45209531629390469205,4758.25,2023-09-29T17:40:54,Bilbao,expenses,education,-60.68,-43606.55
buyer_1,Luis,Garay,1996-08-10,22984418N,luis.garay@cooltech.tech,641191,ES45209531629390469205,4758.25,2023-10-01T20:58:56,Bilbao,incomes,salary,1494.23,-42112.32
buyer_1,Luis,Garay,1996-08-10,22984418N,luis.garay@cooltech.tech,641191,ES45209531629390469205,4758.25,2023-10-01T20:58:56,Bilbao,incomes,extra_income,156.73,-41955.59
buyer_1,Luis,Garay,1996-08-10,22984418N,luis.garay@cooltech.tech,641191,ES45209531629390469205,4758.25,2023-10-01T13:26:24,Bilbao,expenses,food,-70.18,-42025.77
buyer_1,Luis,Garay,1996-08-10,22984418N,luis.garay@cooltech.tech,641191,ES45209531629390469205,4758.25,2023-10-01T09:53:24,Bilbao,expenses,education,-76.95,-42102.72
buyer_1,Luis,Garay,1996-08-10,22984418N,luis.garay@cooltech.tech,641191,ES45209531629390469205,4758.25,2023-10-01T06:47:32,Bilbao,expenses,cash,-100.0,-42202.72
buyer_1,Luis,Garay,1996-08-10,22984418N,luis.garay@cooltech.tech,641191,ES45209531629390469205,4758.25,2023-10-02T14:04:17,Bilbao,expenses,cash,-100.0,-42302.72
buyer_1,Luis,Garay,1996-08-10,22984418N,luis.garay@cooltech.tech,641191,ES45209531629390469205,4758.25,2023-10-03T16:24:11,Bilbao,expenses,food,-79.25,-42381.97
buyer_1,Luis,Garay,1996-08-10,22984418N,luis.garay@cooltech.tech,641191,ES45209531629390469205,4758.25,2023-10-04T13:53:56,Bilbao,expenses,rent,-483.94,-42865.91
buyer_1,Luis,Garay,1996-08-10,22984418N,luis.garay@cooltech.tech,641191,ES45209531629390469205,4758.25,2023-10-06T08:35:07,Bilbao,expenses,internet,-31.38,-42897.29
buyer_1,Luis,Garay,1996-08-10,22984418N,luis.garay@cooltech.tech,641191,ES45209531629390469205,4758.25,2023-10-06T19:32:28,Bilbao,expenses,cash,-100.0,-42997.29
buyer_1,Luis,Garay,1996-08-10,22984418N,luis.garay@cooltech.tech,641191,ES45209531629390469205,4758.25,2023-10-07T08:52:43,Bilbao,expenses,gas,-42.01,-43039.3
buyer_1,Luis,Garay,1996-08-10,22984418N,luis.garay@cooltech.tech,641191,ES45209531629390469205,4758.25,2023-10-08T08:40:02,Bilbao,expenses,water,-24.45,-43063.75
buyer_1,Luis,Garay,1996-08-10,22984418N,luis.garay@cooltech.tech,641191,ES45209531629390469205,4758.25,2023-10-08T16:32:00,Bilbao,expenses,electricity,-48.34,-43112.09
buyer_1,Luis,Garay,1996-08-10,22984418N,luis.garay@cooltech.tech,641191,ES45209531629390469205,4758.25,2023-10-08T19:00:56,Bilbao,expenses,phone,-32.91,-43145.0
buyer_1,Luis,Garay,1996-08-10,22984418N,luis.garay@cooltech.tech,641191,ES45209531629390469205,4758.25,2023-10-08T20:49:04,Bilbao,expenses,food,-82.16,-43227.16
buyer_1,Luis,Garay,1996-08-10,22984418N,luis.garay@cooltech.tech,641191,ES45209531629390469205,4758.25,2023-10-08T20:23:52,Bilbao,expenses,cash,-100.0,-43327.16
buyer_1,Luis,Garay,1996-08-10,22984418N,luis.garay@cooltech.tech,641191,ES45209531629390469205,4758.25,2023-10-09T22:00:09,Bilbao,expenses,repairs,-93.88,-43421.04
buyer_1,Luis,Garay,1996-08-10,22984418N,luis.garay@cooltech.tech,641191,ES45209531629390469205,4758.25,2023-10-10T15:52:10,Bilbao,expenses,gifts,-420.98,-43842.02
buyer_1,Luis,Garay,1996-08-10,22984418N,luis.garay@cooltech.tech,641191,ES45209531629390469205,4758.25,2023-10-12T16:11:37,Bilbao,expenses,appliances,-329.54,-44171.56
buyer_1,Luis,Garay,1996-08-10,22984418N,luis.garay@cooltech.tech,641191,ES45209531629390469205,4758.25,2023-10-14T18:35:04,Bilbao,expenses,cash,-100.0,-44271.56
buyer_1,Luis,Garay,1996-08-10,22984418N,luis.garay@cooltech.tech,641191,ES45209531629390469205,4758.25,2023-10-15T23:08:08,Bilbao,expenses,food,-80.27,-44351.83
buyer_1,Luis,Garay,1996-08-10,22984418N,luis.garay@cooltech.tech,641191,ES45209531629390469205,4758.25,2023-10-16T18:49:51,Bilbao,expenses,cash,-100.0,-44451.83
buyer_1,Luis,Garay,1996-08-10,22984418N,luis.garay@cooltech.tech,641191,ES45209531629390469205,4758.25,2023-10-18T08:11:34,Bilbao,expenses,food,-73.6,-44525.43
buyer_1,Luis,Garay,1996-08-10,22984418N,luis.garay@cooltech.tech,641191,ES45209531629390469205,4758.25,2023-10-19T14:02:16,Bilbao,expenses,food,-83.6,-44609.03
buyer_1,Luis,Garay,1996-08-10,22984418N,luis.garay@cooltech.tech,641191,ES45209531629390469205,4758.25,2023-10-22T17:03:20,Bilbao,expenses,food,-72.61,-44681.64
buyer_1,Luis,Garay,1996-08-10,22984418N,luis.garay@cooltech.tech,641191,ES45209531629390469205,4758.25,2023-10-22T10:46:21,Bilbao,expenses,transport,-47.29,-44728.93
buyer_1,Luis,Garay,1996-08-10,22984418N,luis.garay@cooltech.tech,641191,ES45209531629390469205,4758.25,2023-10-23T22:32:23,Bilbao,expenses,food,-103.43,-44832.36
buyer_1,Luis,Garay,1996-08-10,22984418N,luis.garay@cooltech.tech,641191,ES45209531629390469205,4758.25,2023-10-25T11:29:34,Bilbao,expenses,food,-121.93,-44954.29
buyer_1,Luis,Garay,1996-08-10,22984418N,luis.garay@cooltech.tech,641191,ES45209531629390469205,4758.25,2023-10-25T12:29:00,Bilbao,expenses,appliances,-180.87,-45135.16
buyer_1,Luis,Garay,1996-08-10,22984418N,luis.garay@cooltech.tech,641191,ES45209531629390469205,4758.25,2023-10-30T17:17:44,Bilbao,expenses,transport,-61.63,-45196.79
buyer_1,Luis,Garay,1996-08-10,22984418N,luis.garay@cooltech.tech,641191,ES45209531629390469205,4758.25,2023-10-30T17:02:05,Bilbao,expenses,healthcare,-180.01,-45376.8
buyer_1,Luis,Garay,1996-08-10,22984418N,luis.garay@cooltech.tech,641191,ES45209531629390469205,4758.25,2023-10-31T13:32:02,Bilbao,expenses,cash,-100.0,-45476.8
buyer_1,Luis,Garay,1996-08-10,22984418N,luis.garay@cooltech.tech,641191,ES45209531629390469205,4758.25,2023-10-31T09:08:18,Bilbao,expenses,gifts,-441.37,-45918.17
buyer_1,Luis,Garay,1996-08-10,22984418N,luis.garay@cooltech.tech,641191,ES45209531629390469205,4758.25,2023-11-01T15:37:08,Bilbao,incomes,salary,1494.23,-44423.94
buyer_1,Luis,Garay,1996-08-10,22984418N,luis.garay@cooltech.tech,641191,ES45209531629390469205,4758.25,2023-11-02T13:23:23,Bilbao,expenses,leisure,-57.02,-44480.96
buyer_1,Luis,Garay,1996-08-10,22984418N,luis.garay@cooltech.tech,641191,ES45209531629390469205,4758.25,2023-11-02T01:52:58,Bilbao,expenses,education,-77.79,-44558.75
buyer_1,Luis,Garay,1996-08-10,22984418N,luis.garay@cooltech.tech,641191,ES45209531629390469205,4758.25,2023-11-02T14:08:31,Bilbao,expenses,repairs,-225.87,-44784.62
buyer_1,Luis,Garay,1996-08-10,22984418N,luis.garay@cooltech.tech,641191,ES45209531629390469205,4758.25,2023-11-03T21:03:10,Bilbao,expenses,transport,-72.23,-44856.85
buyer_1,Luis,Garay,1996-08-10,22984418N,luis.garay@cooltech.tech,641191,ES45209531629390469205,4758.25,2023-11-04T14:30:58,Bilbao,expenses,rent,-483.94,-45340.79
buyer_1,Luis,Garay,1996-08-10,22984418N,luis.garay@cooltech.tech,641191,ES45209531629390469205,4758.25,2023-11-04T12:49:54,Bilbao,expenses,transport,-46.58,-45387.37
buyer_1,Luis,Garay,1996-08-10,22984418N,luis.garay@cooltech.tech,641191,ES45209531629390469205,4758.25,2023-11-05T13:11:49,Bilbao,expenses,gas,-40.22,-45427.59
buyer_1,Luis,Garay,1996-08-10,22984418N,luis.garay@cooltech.tech,641191,ES45209531629390469205,4758.25,2023-11-05T02:43:58,Bilbao,expenses,internet,-31.38,-45458.97
buyer_1,Luis,Garay,1996-08-10,22984418N,luis.garay@cooltech.tech,641191,ES45209531629390469205,4758.25,2023-11-06T11:36:27,Bilbao,expenses,transport,-53.56,-45512.53
buyer_1,Luis,Garay,1996-08-10,22984418N,luis.garay@cooltech.tech,641191,ES45209531629390469205,4758.25,2023-11-07T08:43:21,Bilbao,expenses,water,-33.13,-45545.66
buyer_1,Luis,Garay,1996-08-10,22984418N,luis.garay@cooltech.tech,641191,ES45209531629390469205,4758.25,2023-11-08T12:28:11,Bilbao,expenses,electricity,-48.2,-45593.86
buyer_1,Luis,Garay,1996-08-10,22984418N,luis.garay@cooltech.tech,641191,ES45209531629390469205,4758.25,2023-11-08T09:47:42,Bilbao,expenses,phone,-29.28,-45623.14
buyer_1,Luis,Garay,1996-08-10,22984418N,luis.garay@cooltech.tech,641191,ES45209531629390469205,4758.25,2023-11-08T12:32:59,Bilbao,expenses,transport,-88.29,-45711.43
buyer_1,Luis,Garay,1996-08-10,22984418N,luis.garay@cooltech.tech,641191,ES45209531629390469205,4758.25,2023-11-08T20:08:16,Bilbao,expenses,education,-67.33,-45778.76
buyer_1,Luis,Garay,1996-08-10,22984418N,luis.garay@cooltech.tech,641191,ES45209531629390469205,4758.25,2023-11-09T17:08:59,Bilbao,expenses,food,-123.04,-45901.8
buyer_1,Luis,Garay,1996-08-10,22984418N,luis.garay@cooltech.tech,641191,ES45209531629390469205,4758.25,2023-11-10T13:24:54,Bilbao,expenses,cash,-100.0,-46001.8
buyer_1,Luis,Garay,1996-08-10,22984418N,luis.garay@cooltech.tech,641191,ES45209531629390469205,4758.25,2023-11-11T08:11:16,Bilbao,expenses,food,-90.62,-46092.42
buyer_1,Luis,Garay,1996-08-10,22984418N,luis.garay@cooltech.tech,641191,ES45209531629390469205,4758.25,2023-11-12T16:19:19,Bilbao,expenses,healthcare,-141.16,-46233.58
buyer_1,Luis,Garay,1996-08-10,22984418N,luis.garay@cooltech.tech,641191,ES45209531629390469205,4758.25,2023-11-13T02:54:09,Bilbao,expenses,education,-70.64,-46304.22
buyer_1,Luis,Garay,1996-08-10,22984418N,luis.garay@cooltech.tech,641191,ES45209531629390469205,4758.25,2023-11-15T19:34:04,Bilbao,expenses,cash,-100.0,-46404.22
buyer_1,Luis,Garay,1996-08-10,22984418N,luis.garay@cooltech.tech,641191,ES45209531629390469205,4758.25,2023-11-16T08:45:45,Bilbao,expenses,food,-109.98,-46514.2
buyer_1,Luis,Garay,1996-08-10,22984418N,luis.garay@cooltech.tech,641191,ES45209531629390469205,4758.25,2023-11-17T14:45:44,Bilbao,expenses,leisure,-60.51,-46574.71
buyer_1,Luis,Garay,1996-08-10,22984418N,luis.garay@cooltech.tech,641191,ES45209531629390469205,4758.25,2023-11-17T18:50:50,Bilbao,expenses,cash,-100.0,-46674.71
buyer_1,Luis,Garay,1996-08-10,22984418N,luis.garay@cooltech.tech,641191,ES45209531629390469205,4758.25,2023-11-19T09:48:53,Bilbao,expenses,leisure,-29.1,-46703.81
buyer_1,Luis,Garay,1996-08-10,22984418N,luis.garay@cooltech.tech,641191,ES45209531629390469205,4758.25,2023-11-20T11:56:21,Bilbao,expenses,repairs,-77.66,-46781.47
buyer_1,Luis,Garay,1996-08-10,22984418N,luis.garay@cooltech.tech,641191,ES45209531629390469205,4758.25,2023-11-22T18:20:52,Bilbao,expenses,repairs,-277.13,-47058.6
buyer_1,Luis,Garay,1996-08-10,22984418N,luis.garay@cooltech.tech,641191,ES45209531629390469205,4758.25,2023-11-24T10:30:25,Bilbao,expenses,cash,-100.0,-47158.6
buyer_1,Luis,Garay,1996-08-10,22984418N,luis.garay@cooltech.tech,641191,ES45209531629390469205,4758.25,2023-11-26T20:49:16,Bilbao,expenses,food,-76.47,-47235.07
buyer_1,Luis,Garay,1996-08-10,22984418N,luis.garay@cooltech.tech,641191,ES45209531629390469205,4758.25,2023-11-26T14:32:38,Bilbao,expenses,cash,-100.0,-47335.07
buyer_1,Luis,Garay,1996-08-10,22984418N,luis.garay@cooltech.tech,641191,ES45209531629390469205,4758.25,2023-11-28T21:02:50,Bilbao,expenses,food,-91.2,-47426.27
buyer_1,Luis,Garay,1996-08-10,22984418N,luis.garay@cooltech.tech,641191,ES45209531629390469205,4758.25,2023-12-01T17:15:21,Bilbao,incomes,salary,1494.23,-45932.04
buyer_1,Luis,Garay,1996-08-10,22984418N,luis.garay@cooltech.tech,641191,ES45209531629390469205,4758.25,2023-12-01T17:15:21,Bilbao,incomes,salary_bonus,1088.25,-44843.79
buyer_1,Luis,Garay,1996-08-10,22984418N,luis.garay@cooltech.tech,641191,ES45209531629390469205,4758.25,2023-12-01T05:45:03,Bilbao,expenses,food,-116.64,-44960.43
buyer_1,Luis,Garay,1996-08-10,22984418N,luis.garay@cooltech.tech,641191,ES45209531629390469205,4758.25,2023-12-01T10:28:37,Bilbao,expenses,leisure,-43.76,-45004.19
buyer_1,Luis,Garay,1996-08-10,22984418N,luis.garay@cooltech.tech,641191,ES45209531629390469205,4758.25,2023-12-02T03:24:30,Bilbao,expenses,cash,-100.0,-45104.19
buyer_1,Luis,Garay,1996-08-10,22984418N,luis.garay@cooltech.tech,641191,ES45209531629390469205,4758.25,2023-12-02T14:35:55,Bilbao,expenses,gifts,-288.12,-45392.31
buyer_1,Luis,Garay,1996-08-10,22984418N,luis.garay@cooltech.tech,641191,ES45209531629390469205,4758.25,2023-12-03T16:36:54,Bilbao,expenses,clothing,-51.99,-45444.3
buyer_1,Luis,Garay,1996-08-10,22984418N,luis.garay@cooltech.tech,641191,ES45209531629390469205,4758.25,2023-12-04T14:12:11,Bilbao,expenses,rent,-483.94,-45928.24
buyer_1,Luis,Garay,1996-08-10,22984418N,luis.garay@cooltech.tech,641191,ES45209531629390469205,4758.25,2023-12-04T10:23:20,Bilbao,expenses,cash,-100.0,-46028.24
buyer_1,Luis,Garay,1996-08-10,22984418N,luis.garay@cooltech.tech,641191,ES45209531629390469205,4758.25,2023-12-05T20:36:26,Bilbao,expenses,gas,-84.57,-46112.81
buyer_1,Luis,Garay,1996-08-10,22984418N,luis.garay@cooltech.tech,641191,ES45209531629390469205,4758.25,2023-12-06T09:04:52,Bilbao,expenses,water,-25.16,-46137.97
buyer_1,Luis,Garay,1996-08-10,22984418N,luis.garay@cooltech.tech,641191,ES45209531629390469205,4758.25,2023-12-06T17:45:33,Bilbao,expenses,internet,-31.38,-46169.35
buyer_1,Luis,Garay,1996-08-10,22984418N,luis.garay@cooltech.tech,641191,ES45209531629390469205,4758.25,2023-12-08T14:55:39,Bilbao,expenses,electricity,-42.84,-46212.19
buyer_1,Luis,Garay,1996-08-10,22984418N,luis.garay@cooltech.tech,641191,ES45209531629390469205,4758.25,2023-12-08T14:07:09,Bilbao,expenses,phone,-29.06,-46241.25
buyer_1,Luis,Garay,1996-08-10,22984418N,luis.garay@cooltech.tech,641191,ES45209531629390469205,4758.25,2023-12-08T13:54:30,Bilbao,expenses,food,-106.52,-46347.77
buyer_1,Luis,Garay,1996-08-10,22984418N,luis.garay@cooltech.tech,641191,ES45209531629390469205,4758.25,2023-12-08T15:06:15,Bilbao,expenses,transport,-58.62,-46406.39
buyer_1,Luis,Garay,1996-08-10,22984418N,luis.garay@cooltech.tech,641191,ES45209531629390469205,4758.25,2023-12-10T18:56:15,Bilbao,expenses,food,-62.32,-46468.71
buyer_1,Luis,Garay,1996-08-10,22984418N,luis.garay@cooltech.tech,641191,ES45209531629390469205,4758.25,2023-12-10T15:53:12,Bilbao,expenses,education,-71.72,-46540.43
buyer_1,Luis,Garay,1996-08-10,22984418N,luis.garay@cooltech.tech,641191,ES45209531629390469205,4758.25,2023-12-12T00:31:10,Bilbao,expenses,food,-111.67,-46652.1
buyer_1,Luis,Garay,1996-08-10,22984418N,luis.garay@cooltech.tech,641191,ES45209531629390469205,4758.25,2023-12-13T11:04:20,Bilbao,expenses,leisure,-61.87,-46713.97
buyer_1,Luis,Garay,1996-08-10,22984418N,luis.garay@cooltech.tech,641191,ES45209531629390469205,4758.25,2023-12-14T17:27:06,Bilbao,expenses,clothing,-86.77,-46800.74
buyer_1,Luis,Garay,1996-08-10,22984418N,luis.garay@cooltech.tech,641191,ES45209531629390469205,4758.25,2023-12-14T14:33:08,Bilbao,expenses,cash,-100.0,-46900.74
buyer_1,Luis,Garay,1996-08-10,22984418N,luis.garay@cooltech.tech,641191,ES45209531629390469205,4758.25,2023-12-14T21:40:54,Bilbao,expenses,gifts,-411.42,-47312.16
buyer_1,Luis,Garay,1996-08-10,22984418N,luis.garay@cooltech.tech,641191,ES45209531629390469205,4758.25,2023-12-15T13:34:10,Bilbao,expenses,transport,-72.6,-47384.76
buyer_1,Luis,Garay,1996-08-10,22984418N,luis.garay@cooltech.tech,641191,ES45209531629390469205,4758.25,2023-12-17T14:01:11,Bilbao,expenses,food,-119.15,-47503.91
buyer_1,Luis,Garay,1996-08-10,22984418N,luis.garay@cooltech.tech,641191,ES45209531629390469205,4758.25,2023-12-18T15:54:54,Bilbao,expenses,food,-101.31,-47605.22
buyer_1,Luis,Garay,1996-08-10,22984418N,luis.garay@cooltech.tech,641191,ES45209531629390469205,4758.25,2023-12-18T11:27:20,Bilbao,expenses,transport,-58.08,-47663.3
buyer_1,Luis,Garay,1996-08-10,22984418N,luis.garay@cooltech.tech,641191,ES45209531629390469205,4758.25,2023-12-18T05:33:11,Bilbao,expenses,leisure,-35.05,-47698.35
buyer_1,Luis,Garay,1996-08-10,22984418N,luis.garay@cooltech.tech,641191,ES45209531629390469205,4758.25,2023-12-20T10:36:40,Bilbao,expenses,leisure,-61.71,-47760.06
buyer_1,Luis,Garay,1996-08-10,22984418N,luis.garay@cooltech.tech,641191,ES45209531629390469205,4758.25,2023-12-21T09:00:33,Bilbao,expenses,cash,-100.0,-47860.06
buyer_1,Luis,Garay,1996-08-10,22984418N,luis.garay@cooltech.tech,641191,ES45209531629390469205,4758.25,2023-12-21T18:38:38,Bilbao,expenses,gifts,-214.83,-48074.89
buyer_1,Luis,Garay,1996-08-10,22984418N,luis.garay@cooltech.tech,641191,ES45209531629390469205,4758.25,2023-12-22T11:32:35,Bilbao,expenses,cash,-100.0,-48174.89
buyer_1,Luis,Garay,1996-08-10,22984418N,luis.garay@cooltech.tech,641191,ES45209531629390469205,4758.25,2023-12-29T12:13:01,Bilbao,expenses,gifts,-517.73,-48692.62
buyer_1,Luis,Garay,1996-08-10,22984418N,luis.garay@cooltech.tech,641191,ES45209531629390469205,4758.25,2023-12-31T10:37:41,Bilbao,expenses,clothing,-95.15,-48787.77
buyer_1,Luis,Garay,1996-08-10,22984418N,luis.garay@cooltech.tech,641191,ES45209531629390469205,4758.25,2023-12-31T19:31:02,Bilbao,expenses,cash,-100.0,-48887.77
buyer_1,Luis,Garay,1996-08-10,22984418N,luis.garay@cooltech.tech,641191,ES45209531629390469205,4758.25,2024-01-01T09:30:24,Bilbao,incomes,salary,1530.87,-47356.9
buyer_1,Luis,Garay,1996-08-10,22984418N,luis.garay@cooltech.tech,641191,ES45209531629390469205,4758.25,2024-01-02T15:59:14,Bilbao,expenses,food,-72.78,-47429.68
buyer_1,Luis,Garay,1996-08-10,22984418N,luis.garay@cooltech.tech,641191,ES45209531629390469205,4758.25,2024-01-02T16:17:24,Bilbao,expenses,leisure,-30.97,-47460.65
buyer_1,Luis,Garay,1996-08-10,22984418N,luis.garay@cooltech.tech,641191,ES45209531629390469205,4758.25,2024-01-03T13:25:46,Bilbao,expenses,healthcare,-182.25,-47642.9
buyer_1,Luis,Garay,1996-08-10,22984418N,luis.garay@cooltech.tech,641191,ES45209531629390469205,4758.25,2024-01-04T09:24:09,Bilbao,expenses,rent,-560.24,-48203.14
buyer_1,Luis,Garay,1996-08-10,22984418N,luis.garay@cooltech.tech,641191,ES45209531629390469205,4758.25,2024-01-04T20:20:29,Bilbao,expenses,food,-96.01,-48299.15
buyer_1,Luis,Garay,1996-08-10,22984418N,luis.garay@cooltech.tech,641191,ES45209531629390469205,4758.25,2024-01-05T20:31:17,Bilbao,expenses,water,-15.81,-48314.96
buyer_1,Luis,Garay,1996-08-10,22984418N,luis.garay@cooltech.tech,641191,ES45209531629390469205,4758.25,2024-01-05T08:36:00,Bilbao,expenses,transport,-78.19,-48393.15
buyer_1,Luis,Garay,1996-08-10,22984418N,luis.garay@cooltech.tech,641191,ES45209531629390469205,4758.25,2024-01-06T21:40:48,Bilbao,expenses,electricity,-26.74,-48419.89
buyer_1,Luis,Garay,1996-08-10,22984418N,luis.garay@cooltech.tech,641191,ES45209531629390469205,4758.25,2024-01-06T13:57:21,Bilbao,expenses,transport,-54.25,-48474.14
buyer_1,Luis,Garay,1996-08-10,22984418N,luis.garay@cooltech.tech,641191,ES45209531629390469205,4758.25,2024-01-07T15:49:15,Bilbao,expenses,cash,-100.0,-48574.14
buyer_1,Luis,Garay,1996-08-10,22984418N,luis.garay@cooltech.tech,641191,ES45209531629390469205,4758.25,2024-01-08T16:50:09,Bilbao,expenses,internet,-32.15,-48606.29
buyer_1,Luis,Garay,1996-08-10,22984418N,luis.garay@cooltech.tech,641191,ES45209531629390469205,4758.25,2024-01-08T17:47:38,Bilbao,expenses,gas,-27.51,-48633.8
buyer_1,Luis,Garay,1996-08-10,22984418N,luis.garay@cooltech.tech,641191,ES45209531629390469205,4758.25,2024-01-08T19:46:43,Bilbao,expenses,phone,-32.26,-48666.06
buyer_1,Luis,Garay,1996-08-10,22984418N,luis.garay@cooltech.tech,641191,ES45209531629390469205,4758.25,2024-01-08T05:05:23,Bilbao,expenses,cash,-100.0,-48766.06
buyer_1,Luis,Garay,1996-08-10,22984418N,luis.garay@cooltech.tech,641191,ES45209531629390469205,4758.25,2024-01-09T12:03:13,Bilbao,expenses,education,-68.93,-48834.99
buyer_1,Luis,Garay,1996-08-10,22984418N,luis.garay@cooltech.tech,641191,ES45209531629390469205,4758.25,2024-01-09T08:58:30,Bilbao,expenses,cash,-100.0,-48934.99
buyer_1,Luis,Garay,1996-08-10,22984418N,luis.garay@cooltech.tech,641191,ES45209531629390469205,4758.25,2024-01-12T15:20:22,Bilbao,expenses,food,-113.24,-49048.23
buyer_1,Luis,Garay,1996-08-10,22984418N,luis.garay@cooltech.tech,641191,ES45209531629390469205,4758.25,2024-01-13T16:14:40,Bilbao,expenses,transport,-45.59,-49093.82
buyer_1,Luis,Garay,1996-08-10,22984418N,luis.garay@cooltech.tech,641191,ES45209531629390469205,4758.25,2024-01-13T15:13:37,Bilbao,expenses,leisure,-69.29,-49163.11
buyer_1,Luis,Garay,1996-08-10,22984418N,luis.garay@cooltech.tech,641191,ES45209531629390469205,4758.25,2024-01-15T23:17:51,Bilbao,expenses,cash,-100.0,-49263.11
buyer_1,Luis,Garay,1996-08-10,22984418N,luis.garay@cooltech.tech,641191,ES45209531629390469205,4758.25,2024-01-16T10:37:50,Bilbao,expenses,food,-65.83,-49328.94
buyer_1,Luis,Garay,1996-08-10,22984418N,luis.garay@cooltech.tech,641191,ES45209531629390469205,4758.25,2024-01-17T02:55:46,Bilbao,expenses,repairs,-273.69,-49602.63
buyer_1,Luis,Garay,1996-08-10,22984418N,luis.garay@cooltech.tech,641191,ES45209531629390469205,4758.25,2024-01-18T17:38:55,Bilbao,expenses,cash,-100.0,-49702.63
buyer_1,Luis,Garay,1996-08-10,22984418N,luis.garay@cooltech.tech,641191,ES45209531629390469205,4758.25,2024-01-18T16:28:35,Bilbao,expenses,repairs,-303.19,-50005.82
buyer_1,Luis,Garay,1996-08-10,22984418N,luis.garay@cooltech.tech,641191,ES45209531629390469205,4758.25,2024-01-19T12:02:11,Bilbao,expenses,appliances,-400.51,-50406.33
buyer_1,Luis,Garay,1996-08-10,22984418N,luis.garay@cooltech.tech,641191,ES45209531629390469205,4758.25,2024-01-23T17:05:01,Bilbao,expenses,clothing,-134.2,-50540.53
buyer_1,Luis,Garay,1996-08-10,22984418N,luis.garay@cooltech.tech,641191,ES45209531629390469205,4758.25,2024-01-24T18:42:36,Bilbao,expenses,food,-117.14,-50657.67
buyer_1,Luis,Garay,1996-08-10,22984418N,luis.garay@cooltech.tech,641191,ES45209531629390469205,4758.25,2024-01-24T08:17:19,Bilbao,expenses,transport,-84.96,-50742.63
buyer_1,Luis,Garay,1996-08-10,22984418N,luis.garay@cooltech.tech,641191,ES45209531629390469205,4758.25,2024-01-25T16:32:16,Bilbao,expenses,leisure,-65.85,-50808.48
buyer_1,Luis,Garay,1996-08-10,22984418N,luis.garay@cooltech.tech,641191,ES45209531629390469205,4758.25,2024-01-25T13:58:33,Bilbao,expenses,clothing,-95.01,-50903.49
buyer_1,Luis,Garay,1996-08-10,22984418N,luis.garay@cooltech.tech,641191,ES45209531629390469205,4758.25,2024-01-27T14:03:56,Bilbao,expenses,leisure,-80.31,-50983.8
buyer_1,Luis,Garay,1996-08-10,22984418N,luis.garay@cooltech.tech,641191,ES45209531629390469205,4758.25,2024-01-30T14:32:24,Bilbao,expenses,gifts,-364.94,-51348.74
buyer_1,Luis,Garay,1996-08-10,22984418N,luis.garay@cooltech.tech,641191,ES45209531629390469205,4758.25,2024-02-01T18:34:54,Bilbao,incomes,salary,1530.87,-49817.87
buyer_1,Luis,Garay,1996-08-10,22984418N,luis.garay@cooltech.tech,641191,ES45209531629390469205,4758.25,2024-02-01T18:34:54,Bilbao,incomes,extra_income,156.73,-49661.14
buyer_1,Luis,Garay,1996-08-10,22984418N,luis.garay@cooltech.tech,641191,ES45209531629390469205,4758.25,2024-02-01T03:11:03,Bilbao,expenses,transport,-56.34,-49717.48
buyer_1,Luis,Garay,1996-08-10,22984418N,luis.garay@cooltech.tech,641191,ES45209531629390469205,4758.25,2024-02-02T13:16:35,Bilbao,expenses,food,-118.26,-49835.74
buyer_1,Luis,Garay,1996-08-10,22984418N,luis.garay@cooltech.tech,641191,ES45209531629390469205,4758.25,2024-02-02T19:37:27,Bilbao,expenses,transport,-46.07,-49881.81
buyer_1,Luis,Garay,1996-08-10,22984418N,luis.garay@cooltech.tech,641191,ES45209531629390469205,4758.25,2024-02-04T19:37:52,Bilbao,expenses,rent,-560.24,-50442.05
buyer_1,Luis,Garay,1996-08-10,22984418N,luis.garay@cooltech.tech,641191,ES45209531629390469205,4758.25,2024-02-05T08:04:31,Bilbao,expenses,water,-25.2,-50467.25
buyer_1,Luis,Garay,1996-08-10,22984418N,luis.garay@cooltech.tech,641191,ES45209531629390469205,4758.25,2024-02-05T14:46:02,Bilbao,expenses,gas,-69.26,-50536.51
buyer_1,Luis,Garay,1996-08-10,22984418N,luis.garay@cooltech.tech,641191,ES45209531629390469205,4758.25,2024-02-05T17:40:44,Bilbao,expenses,appliances,-267.42,-50803.93
buyer_1,Luis,Garay,1996-08-10,22984418N,luis.garay@cooltech.tech,641191,ES45209531629390469205,4758.25,2024-02-05T11:53:22,Bilbao,expenses,repairs,-63.98,-50867.91
buyer_1,Luis,Garay,1996-08-10,22984418N,luis.garay@cooltech.tech,641191,ES45209531629390469205,4758.25,2024-02-06T12:34:51,Bilbao,expenses,leisure,-63.95,-50931.86
buyer_1,Luis,Garay,1996-08-10,22984418N,luis.garay@cooltech.tech,641191,ES45209531629390469205,4758.25,2024-02-06T11:41:29,Bilbao,expenses,cash,-100.0,-51031.86
buyer_1,Luis,Garay,1996-08-10,22984418N,luis.garay@cooltech.tech,641191,ES45209531629390469205,4758.25,2024-02-07T12:15:51,Bilbao,expenses,electricity,-36.3,-51068.16
buyer_1,Luis,Garay,1996-08-10,22984418N,luis.garay@cooltech.tech,641191,ES45209531629390469205,4758.25,2024-02-07T16:10:46,Bilbao,expenses,repairs,-54.48,-51122.64
buyer_1,Luis,Garay,1996-08-10,22984418N,luis.garay@cooltech.tech,641191,ES45209531629390469205,4758.25,2024-02-08T12:40:04,Bilbao,expenses,phone,-31.36,-51154.0
buyer_1,Luis,Garay,1996-08-10,22984418N,luis.garay@cooltech.tech,641191,ES45209531629390469205,4758.25,2024-02-08T18:48:01,Bilbao,expenses,internet,-32.15,-51186.15
buyer_1,Luis,Garay,1996-08-10,22984418N,luis.garay@cooltech.tech,641191,ES45209531629390469205,4758.25,2024-02-09T14:25:34,Bilbao,expenses,food,-63.86,-51250.01
buyer_1,Luis,Garay,1996-08-10,22984418N,luis.garay@cooltech.tech,641191,ES45209531629390469205,4758.25,2024-02-12T05:46:10,Bilbao,expenses,transport,-56.58,-51306.59
buyer_1,Luis,Garay,1996-08-10,22984418N,luis.garay@cooltech.tech,641191,ES45209531629390469205,4758.25,2024-02-12T23:31:18,Bilbao,expenses,leisure,-23.53,-51330.12
buyer_1,Luis,Garay,1996-08-10,22984418N,luis.garay@cooltech.tech,641191,ES45209531629390469205,4758.25,2024-02-13T17:02:23,Bilbao,expenses,cash,-100.0,-51430.12
buyer_1,Luis,Garay,1996-08-10,22984418N,luis.garay@cooltech.tech,641191,ES45209531629390469205,4758.25,2024-02-14T21:09:04,Bilbao,expenses,appliances,-335.17,-51765.29
buyer_1,Luis,Garay,1996-08-10,22984418N,luis.garay@cooltech.tech,641191,ES45209531629390469205,4758.25,2024-02-15T02:34:25,Bilbao,expenses,cash,-100.0,-51865.29
buyer_1,Luis,Garay,1996-08-10,22984418N,luis.garay@cooltech.tech,641191,ES45209531629390469205,4758.25,2024-02-15T18:54:11,Bilbao,expenses,appliances,-246.76,-52112.05
buyer_1,Luis,Garay,1996-08-10,22984418N,luis.garay@cooltech.tech,641191,ES45209531629390469205,4758.25,2024-02-16T20:45:56,Bilbao,expenses,food,-98.11,-52210.16
buyer_1,Luis,Garay,1996-08-10,22984418N,luis.garay@cooltech.tech,641191,ES45209531629390469205,4758.25,2024-02-16T12:48:30,Bilbao,expenses,transport,-85.15,-52295.31
buyer_1,Luis,Garay,1996-08-10,22984418N,luis.garay@cooltech.tech,641191,ES45209531629390469205,4758.25,2024-02-16T14:32:10,Bilbao,expenses,clothing,-133.57,-52428.88
buyer_1,Luis,Garay,1996-08-10,22984418N,luis.garay@cooltech.tech,641191,ES45209531629390469205,4758.25,2024-02-18T09:30:03,Bilbao,expenses,appliances,-375.29,-52804.17
buyer_1,Luis,Garay,1996-08-10,22984418N,luis.garay@cooltech.tech,641191,ES45209531629390469205,4758.25,2024-02-20T14:26:15,Bilbao,expenses,leisure,-63.86,-52868.03
buyer_1,Luis,Garay,1996-08-10,22984418N,luis.garay@cooltech.tech,641191,ES45209531629390469205,4758.25,2024-02-20T13:00:32,Bilbao,expenses,appliances,-375.46,-53243.49
buyer_1,Luis,Garay,1996-08-10,22984418N,luis.garay@cooltech.tech,641191,ES45209531629390469205,4758.25,2024-02-22T17:45:22,Bilbao,expenses,leisure,-24.85,-53268.34
buyer_1,Luis,Garay,1996-08-10,22984418N,luis.garay@cooltech.tech,641191,ES45209531629390469205,4758.25,2024-02-23T03:56:45,Bilbao,expenses,food,-82.75,-53351.09
buyer_1,Luis,Garay,1996-08-10,22984418N,luis.garay@cooltech.tech,641191,ES45209531629390469205,4758.25,2024-02-23T22:22:05,Bilbao,expenses,gifts,-259.78,-53610.87
buyer_1,Luis,Garay,1996-08-10,22984418N,luis.garay@cooltech.tech,641191,ES45209531629390469205,4758.25,2024-02-28T20:31:00,Bilbao,expenses,transport,-85.54,-53696.41
buyer_1,Luis,Garay,1996-08-10,22984418N,luis.garay@cooltech.tech,641191,ES45209531629390469205,4758.25,2024-02-28T18:16:26,Bilbao,expenses,leisure,-75.39,-53771.8
buyer_1,Luis,Garay,1996-08-10,22984418N,luis.garay@cooltech.tech,641191,ES45209531629390469205,4758.25,2024-02-28T18:54:24,Bilbao,expenses,repairs,-174.45,-53946.25
buyer_1,Luis,Garay,1996-08-10,22984418N,luis.garay@cooltech.tech,641191,ES45209531629390469205,4758.25,2024-03-01T19:37:09,Bilbao,incomes,salary,1530.87,-52415.38
buyer_1,Luis,Garay,1996-08-10,22984418N,luis.garay@cooltech.tech,641191,ES45209531629390469205,4758.25,2024-03-02T13:33:12,Bilbao,expenses,education,-68.9,-52484.28
buyer_1,Luis,Garay,1996-08-10,22984418N,luis.garay@cooltech.tech,641191,ES45209531629390469205,4758.25,2024-03-04T08:15:50,Bilbao,expenses,rent,-560.24,-53044.52
buyer_1,Luis,Garay,1996-08-10,22984418N,luis.garay@cooltech.tech,641191,ES45209531629390469205,4758.25,2024-03-04T08:39:23,Bilbao,expenses,transport,-81.1,-53125.62
buyer_1,Luis,Garay,1996-08-10,22984418N,luis.garay@cooltech.tech,641191,ES45209531629390469205,4758.25,2024-03-04T19:19:35,Bilbao,expenses,cash,-100.0,-53225.62
buyer_1,Luis,Garay,1996-08-10,22984418N,luis.garay@cooltech.tech,641191,ES45209531629390469205,4758.25,2024-03-05T17:45:47,Bilbao,expenses,cash,-100.0,-53325.62
buyer_1,Luis,Garay,1996-08-10,22984418N,luis.garay@cooltech.tech,641191,ES45209531629390469205,4758.25,2024-03-05T20:04:45,Bilbao,expenses,repairs,-299.45,-53625.07
buyer_1,Luis,Garay,1996-08-10,22984418N,luis.garay@cooltech.tech,641191,ES45209531629390469205,4758.25,2024-03-06T20:05:24,Bilbao,expenses,water,-19.43,-53644.5
buyer_1,Luis,Garay,1996-08-10,22984418N,luis.garay@cooltech.tech,641191,ES45209531629390469205,4758.25,2024-03-06T10:32:30,Bilbao,expenses,electricity,-23.78,-53668.28
buyer_1,Luis,Garay,1996-08-10,22984418N,luis.garay@cooltech.tech,641191,ES45209531629390469205,4758.25,2024-03-07T22:51:20,Bilbao,expenses,phone,-28.39,-53696.67
buyer_1,Luis,Garay,1996-08-10,22984418N,luis.garay@cooltech.tech,641191,ES45209531629390469205,4758.25,2024-03-07T09:29:54,Bilbao,expenses,food,-96.19,-53792.86
buyer_1,Luis,Garay,1996-08-10,22984418N,luis.garay@cooltech.tech,641191,ES45209531629390469205,4758.25,2024-03-07T22:35:06,Bilbao,expenses,transport,-78.32,-53871.18
buyer_1,Luis,Garay,1996-08-10,22984418N,luis.garay@cooltech.tech,641191,ES45209531629390469205,4758.25,2024-03-07T20:22:54,Bilbao,expenses,education,-71.57,-53942.75
buyer_1,Luis,Garay,1996-08-10,22984418N,luis.garay@cooltech.tech,641191,ES45209531629390469205,4758.25,2024-03-08T20:47:52,Bilbao,expenses,gas,-47.03,-53989.78
buyer_1,Luis,Garay,1996-08-10,22984418N,luis.garay@cooltech.tech,641191,ES45209531629390469205,4758.25,2024-03-08T18:16:54,Bilbao,expenses,internet,-32.15,-54021.93
buyer_1,Luis,Garay,1996-08-10,22984418N,luis.garay@cooltech.tech,641191,ES45209531629390469205,4758.25,2024-03-08T17:16:04,Bilbao,expenses,education,-54.68,-54076.61
buyer_1,Luis,Garay,1996-08-10,22984418N,luis.garay@cooltech.tech,641191,ES45209531629390469205,4758.25,2024-03-09T18:25:04,Bilbao,expenses,food,-82.91,-54159.52
buyer_1,Luis,Garay,1996-08-10,22984418N,luis.garay@cooltech.tech,641191,ES45209531629390469205,4758.25,2024-03-13T16:25:53,Bilbao,expenses,food,-83.04,-54242.56
buyer_1,Luis,Garay,1996-08-10,22984418N,luis.garay@cooltech.tech,641191,ES45209531629390469205,4758.25,2024-03-14T08:56:21,Bilbao,expenses,appliances,-103.17,-54345.73
buyer_1,Luis,Garay,1996-08-10,22984418N,luis.garay@cooltech.tech,641191,ES45209531629390469205,4758.25,2024-03-15T14:17:24,Bilbao,expenses,cash,-100.0,-54445.73
buyer_1,Luis,Garay,1996-08-10,22984418N,luis.garay@cooltech.tech,641191,ES45209531629390469205,4758.25,2024-03-16T13:24:34,Bilbao,expenses,leisure,-34.96,-54480.69
buyer_1,Luis,Garay,1996-08-10,22984418N,luis.garay@cooltech.tech,641191,ES45209531629390469205,4758.25,2024-03-17T14:32:19,Bilbao,expenses,travel,-337.47,-54818.16
buyer_1,Luis,Garay,1996-08-10,22984418N,luis.garay@cooltech.tech,641191,ES45209531629390469205,4758.25,2024-03-18T00:01:59,Bilbao,expenses,leisure,-48.0,-54866.16
buyer_1,Luis,Garay,1996-08-10,22984418N,luis.garay@cooltech.tech,641191,ES45209531629390469205,4758.25,2024-03-20T14:57:28,Bilbao,expenses,cash,-100.0,-54966.16
buyer_1,Luis,Garay,1996-08-10,22984418N,luis.garay@cooltech.tech,641191,ES45209531629390469205,4758.25,2024-03-20T08:56:55,Bilbao,expenses,travel,-475.04,-55441.2
buyer_1,Luis,Garay,1996-08-10,22984418N,luis.garay@cooltech.tech,641191,ES45209531629390469205,4758.25,2024-03-21T19:33:41,Bilbao,expenses,food,-122.3,-55563.5
buyer_1,Luis,Garay,1996-08-10,22984418N,luis.garay@cooltech.tech,641191,ES45209531629390469205,4758.25,2024-03-21T11:42:19,Bilbao,expenses,education,-76.14,-55639.64
buyer_1,Luis,Garay,1996-08-10,22984418N,luis.garay@cooltech.tech,641191,ES45209531629390469205,4758.25,2024-03-23T16:35:35,Bilbao,expenses,cash,-100.0,-55739.64
buyer_1,Luis,Garay,1996-08-10,22984418N,luis.garay@cooltech.tech,641191,ES45209531629390469205,4758.25,2024-03-25T12:00:57,Bilbao,expenses,leisure,-68.66,-55808.3
buyer_1,Luis,Garay,1996-08-10,22984418N,luis.garay@cooltech.tech,641191,ES45209531629390469205,4758.25,2024-03-26T08:06:55,Bilbao,expenses,gifts,-267.02,-56075.32
buyer_1,Luis,Garay,1996-08-10,22984418N,luis.garay@cooltech.tech,641191,ES45209531629390469205,4758.25,2024-03-27T01:46:34,Bilbao,expenses,leisure,-40.21,-56115.53
buyer_1,Luis,Garay,1996-08-10,22984418N,luis.garay@cooltech.tech,641191,ES45209531629390469205,4758.25,2024-03-27T14:18:03,Bilbao,expenses,education,-44.43,-56159.96
buyer_1,Luis,Garay,1996-08-10,22984418N,luis.garay@cooltech.tech,641191,ES45209531629390469205,4758.25,2024-03-30T13:00:26,Bilbao,expenses,gifts,-521.91,-56681.87
buyer_1,Luis,Garay,1996-08-10,22984418N,luis.garay@cooltech.tech,641191,ES45209531629390469205,4758.25,2024-03-31T08:25:58,Bilbao,expenses,clothing,-72.4,-56754.27
buyer_1,Luis,Garay,1996-08-10,22984418N,luis.garay@cooltech.tech,641191,ES45209531629390469205,4758.25,2024-04-01T16:41:28,Bilbao,incomes,salary,1530.87,-55223.4
buyer_1,Luis,Garay,1996-08-10,22984418N,luis.garay@cooltech.tech,641191,ES45209531629390469205,4758.25,2024-04-02T20:35:54,Bilbao,expenses,leisure,-65.86,-55289.26
buyer_1,Luis,Garay,1996-08-10,22984418N,luis.garay@cooltech.tech,641191,ES45209531629390469205,4758.25,2024-04-03T15:26:45,Bilbao,expenses,food,-103.58,-55392.84
buyer_1,Luis,Garay,1996-08-10,22984418N,luis.garay@cooltech.tech,641191,ES45209531629390469205,4758.25,2024-04-03T11:24:37,Bilbao,expenses,leisure,-33.71,-55426.55
buyer_1,Luis,Garay,1996-08-10,22984418N,luis.garay@cooltech.tech,641191,ES45209531629390469205,4758.25,2024-04-03T22:10:34,Bilbao,expenses,cash,-100.0,-55526.55
buyer_1,Luis,Garay,1996-08-10,22984418N,luis.garay@cooltech.tech,641191,ES45209531629390469205,4758.25,2024-04-04T10:57:06,Bilbao,expenses,rent,-560.24,-56086.79
buyer_1,Luis,Garay,1996-08-10,22984418N,luis.garay@cooltech.tech,641191,ES45209531629390469205,4758.25,2024-04-04T09:44:43,Bilbao,expenses,cash,-100.0,-56186.79
buyer_1,Luis,Garay,1996-08-10,22984418N,luis.garay@cooltech.tech,641191,ES45209531629390469205,4758.25,2024-04-05T23:53:47,Bilbao,expenses,water,-27.47,-56214.26
buyer_1,Luis,Garay,1996-08-10,22984418N,luis.garay@cooltech.tech,641191,ES45209531629390469205,4758.25,2024-04-07T08:32:07,Bilbao,expenses,internet,-32.15,-56246.41
buyer_1,Luis,Garay,1996-08-10,22984418N,luis.garay@cooltech.tech,641191,ES45209531629390469205,4758.25,2024-04-08T18:17:25,Bilbao,expenses,electricity,-49.66,-56296.07
buyer_1,Luis,Garay,1996-08-10,22984418N,luis.garay@cooltech.tech,641191,ES45209531629390469205,4758.25,2024-04-08T17:32:45,Bilbao,expenses,gas,-79.16,-56375.23
buyer_1,Luis,Garay,1996-08-10,22984418N,luis.garay@cooltech.tech,641191,ES45209531629390469205,4758.25,2024-04-08T15:14:33,Bilbao,expenses,phone,-24.36,-56399.59
buyer_1,Luis,Garay,1996-08-10,22984418N,luis.garay@cooltech.tech,641191,ES45209531629390469205,4758.25,2024-04-08T14:35:38,Bilbao,expenses,clothing,-94.14,-56493.73
buyer_1,Luis,Garay,1996-08-10,22984418N,luis.garay@cooltech.tech,641191,ES45209531629390469205,4758.25,2024-04-08T08:58:32,Bilbao,expenses,cash,-100.0,-56593.73
buyer_1,Luis,Garay,1996-08-10,22984418N,luis.garay@cooltech.tech,641191,ES45209531629390469205,4758.25,2024-04-10T17:04:36,Bilbao,expenses,clothing,-146.17,-56739.9
buyer_1,Luis,Garay,1996-08-10,22984418N,luis.garay@cooltech.tech,641191,ES45209531629390469205,4758.25,2024-04-10T17:39:35,Bilbao,expenses,repairs,-99.95,-56839.85
buyer_1,Luis,Garay,1996-08-10,22984418N,luis.garay@cooltech.tech,641191,ES45209531629390469205,4758.25,2024-04-11T07:26:56,Bilbao,expenses,transport,-57.49,-56897.34
buyer_1,Luis,Garay,1996-08-10,22984418N,luis.garay@cooltech.tech,641191,ES45209531629390469205,4758.25,2024-04-13T04:50:11,Bilbao,expenses,leisure,-58.78,-56956.12
buyer_1,Luis,Garay,1996-08-10,22984418N,luis.garay@cooltech.tech,641191,ES45209531629390469205,4758.25,2024-04-13T13:30:40,Bilbao,expenses,education,-42.01,-56998.13
buyer_1,Luis,Garay,1996-08-10,22984418N,luis.garay@cooltech.tech,641191,ES45209531629390469205,4758.25,2024-04-13T09:19:26,Bilbao,expenses,car,-124.34,-57122.47
buyer_1,Luis,Garay,1996-08-10,22984418N,luis.garay@cooltech.tech,641191,ES45209531629390469205,4758.25,2024-04-14T12:13:59,Bilbao,expenses,gifts,-355.08,-57477.55
buyer_1,Luis,Garay,1996-08-10,22984418N,luis.garay@cooltech.tech,641191,ES45209531629390469205,4758.25,2024-04-15T17:52:36,Bilbao,expenses,leisure,-26.41,-57503.96
buyer_1,Luis,Garay,1996-08-10,22984418N,luis.garay@cooltech.tech,641191,ES45209531629390469205,4758.25,2024-04-16T09:41:29,Bilbao,expenses,leisure,-71.83,-57575.79
buyer_1,Luis,Garay,1996-08-10,22984418N,luis.garay@cooltech.tech,641191,ES45209531629390469205,4758.25,2024-04-17T19:30:22,Bilbao,expenses,food,-123.97,-57699.76
buyer_1,Luis,Garay,1996-08-10,22984418N,luis.garay@cooltech.tech,641191,ES45209531629390469205,4758.25,2024-04-20T02:12:35,Bilbao,expenses,transport,-73.98,-57773.74
buyer_1,Luis,Garay,1996-08-10,22984418N,luis.garay@cooltech.tech,641191,ES45209531629390469205,4758.25,2024-04-21T22:39:10,Bilbao,expenses,leisure,-60.4,-57834.14
buyer_1,Luis,Garay,1996-08-10,22984418N,luis.garay@cooltech.tech,641191,ES45209531629390469205,4758.25,2024-04-21T17:10:44,Bilbao,expenses,repairs,-165.25,-57999.39
buyer_1,Luis,Garay,1996-08-10,22984418N,luis.garay@cooltech.tech,641191,ES45209531629390469205,4758.25,2024-04-23T19:17:01,Bilbao,expenses,cash,-100.0,-58099.39
buyer_1,Luis,Garay,1996-08-10,22984418N,luis.garay@cooltech.tech,641191,ES45209531629390469205,4758.25,2024-04-24T16:38:55,Bilbao,expenses,transport,-81.88,-58181.27
buyer_1,Luis,Garay,1996-08-10,22984418N,luis.garay@cooltech.tech,641191,ES45209531629390469205,4758.25,2024-04-24T12:20:10,Bilbao,expenses,education,-51.79,-58233.06
buyer_1,Luis,Garay,1996-08-10,22984418N,luis.garay@cooltech.tech,641191,ES45209531629390469205,4758.25,2024-04-24T21:15:51,Bilbao,expenses,travel,-375.71,-58608.77
buyer_1,Luis,Garay,1996-08-10,22984418N,luis.garay@cooltech.tech,641191,ES45209531629390469205,4758.25,2024-04-25T17:34:12,Bilbao,expenses,food,-66.21,-58674.98
buyer_1,Luis,Garay,1996-08-10,22984418N,luis.garay@cooltech.tech,641191,ES45209531629390469205,4758.25,2024-04-26T04:24:23,Bilbao,expenses,food,-105.52,-58780.5
buyer_1,Luis,Garay,1996-08-10,22984418N,luis.garay@cooltech.tech,641191,ES45209531629390469205,4758.25,2024-04-26T19:53:36,Bilbao,expenses,leisure,-57.53,-58838.03
buyer_1,Luis,Garay,1996-08-10,22984418N,luis.garay@cooltech.tech,641191,ES45209531629390469205,4758.25,2024-04-26T16:38:59,Bilbao,expenses,gifts,-322.79,-59160.82
buyer_1,Luis,Garay,1996-08-10,22984418N,luis.garay@cooltech.tech,641191,ES45209531629390469205,4758.25,2024-04-27T14:05:56,Bilbao,expenses,leisure,-83.53,-59244.35
buyer_1,Luis,Garay,1996-08-10,22984418N,luis.garay@cooltech.tech,641191,ES45209531629390469205,4758.25,2024-04-27T07:04:51,Bilbao,expenses,education,-55.01,-59299.36
buyer_1,Luis,Garay,1996-08-10,22984418N,luis.garay@cooltech.tech,641191,ES45209531629390469205,4758.25,2024-04-29T17:49:29,Bilbao,expenses,transport,-72.14,-59371.5
buyer_1,Luis,Garay,1996-08-10,22984418N,luis.garay@cooltech.tech,641191,ES45209531629390469205,4758.25,2024-04-30T16:24:14,Bilbao,expenses,transport,-43.66,-59415.16
buyer_1,Luis,Garay,1996-08-10,22984418N,luis.garay@cooltech.tech,641191,ES45209531629390469205,4758.25,2024-05-01T16:21:11,Bilbao,incomes,salary,1530.87,-57884.29
buyer_1,Luis,Garay,1996-08-10,22984418N,luis.garay@cooltech.tech,641191,ES45209531629390469205,4758.25,2024-05-01T16:21:11,Bilbao,incomes,extra_income,156.73,-57727.56
buyer_1,Luis,Garay,1996-08-10,22984418N,luis.garay@cooltech.tech,641191,ES45209531629390469205,4758.25,2024-05-03T14:58:04,Bilbao,expenses,leisure,-19.52,-57747.08
buyer_1,Luis,Garay,1996-08-10,22984418N,luis.garay@cooltech.tech,641191,ES45209531629390469205,4758.25,2024-05-04T12:35:47,Bilbao,expenses,rent,-560.24,-58307.32
buyer_1,Luis,Garay,1996-08-10,22984418N,luis.garay@cooltech.tech,641191,ES45209531629390469205,4758.25,2024-05-04T15:24:44,Bilbao,expenses,cash,-100.0,-58407.32
buyer_1,Luis,Garay,1996-08-10,22984418N,luis.garay@cooltech.tech,641191,ES45209531629390469205,4758.25,2024-05-05T17:11:37,Bilbao,expenses,food,-112.59,-58519.91
buyer_1,Luis,Garay,1996-08-10,22984418N,luis.garay@cooltech.tech,641191,ES45209531629390469205,4758.25,2024-05-06T09:11:29,Bilbao,expenses,education,-45.12,-58565.03
buyer_1,Luis,Garay,1996-08-10,22984418N,luis.garay@cooltech.tech,641191,ES45209531629390469205,4758.25,2024-05-07T10:37:31,Bilbao,expenses,gas,-62.32,-58627.35
buyer_1,Luis,Garay,1996-08-10,22984418N,luis.garay@cooltech.tech,641191,ES45209531629390469205,4758.25,2024-05-08T08:09:13,Bilbao,expenses,water,-24.35,-58651.7
buyer_1,Luis,Garay,1996-08-10,22984418N,luis.garay@cooltech.tech,641191,ES45209531629390469205,4758.25,2024-05-08T16:25:02,Bilbao,expenses,electricity,-64.21,-58715.91
buyer_1,Luis,Garay,1996-08-10,22984418N,luis.garay@cooltech.tech,641191,ES45209531629390469205,4758.25,2024-05-08T11:07:14,Bilbao,expenses,internet,-32.15,-58748.06
buyer_1,Luis,Garay,1996-08-10,22984418N,luis.garay@cooltech.tech,641191,ES45209531629390469205,4758.25,2024-05-08T09:24:06,Bilbao,expenses,phone,-25.53,-58773.59
buyer_1,Luis,Garay,1996-08-10,22984418N,luis.garay@cooltech.tech,641191,ES45209531629390469205,4758.25,2024-05-09T15:53:38,Bilbao,expenses,appliances,-206.13,-58979.72
buyer_1,Luis,Garay,1996-08-10,22984418N,luis.garay@cooltech.tech,641191,ES45209531629390469205,4758.25,2024-05-10T07:38:23,Bilbao,expenses,food,-81.89,-59061.61
buyer_1,Luis,Garay,1996-08-10,22984418N,luis.garay@cooltech.tech,641191,ES45209531629390469205,4758.25,2024-05-10T20:05:16,Bilbao,expenses,cash,-100.0,-59161.61
buyer_1,Luis,Garay,1996-08-10,22984418N,luis.garay@cooltech.tech,641191,ES45209531629390469205,4758.25,2024-05-12T14:19:55,Bilbao,expenses,transport,-41.21,-59202.82
buyer_1,Luis,Garay,1996-08-10,22984418N,luis.garay@cooltech.tech,641191,ES45209531629390469205,4758.25,2024-05-12T19:35:50,Bilbao,expenses,cash,-100.0,-59302.82
buyer_1,Luis,Garay,1996-08-10,22984418N,luis.garay@cooltech.tech,641191,ES45209531629390469205,4758.25,2024-05-12T20:42:59,Bilbao,expenses,appliances,-192.88,-59495.7
buyer_1,Luis,Garay,1996-08-10,22984418N,luis.garay@cooltech.tech,641191,ES45209531629390469205,4758.25,2024-05-15T14:47:03,Bilbao,expenses,car,-140.87,-59636.57
buyer_1,Luis,Garay,1996-08-10,22984418N,luis.garay@cooltech.tech,641191,ES45209531629390469205,4758.25,2024-05-18T05:50:05,Bilbao,expenses,transport,-65.23,-59701.8
buyer_1,Luis,Garay,1996-08-10,22984418N,luis.garay@cooltech.tech,641191,ES45209531629390469205,4758.25,2024-05-20T14:18:05,Bilbao,expenses,gifts,-325.89,-60027.69
buyer_1,Luis,Garay,1996-08-10,22984418N,luis.garay@cooltech.tech,641191,ES45209531629390469205,4758.25,2024-05-21T09:51:07,Bilbao,expenses,cash,-100.0,-60127.69
buyer_1,Luis,Garay,1996-08-10,22984418N,luis.garay@cooltech.tech,641191,ES45209531629390469205,4758.25,2024-05-21T15:08:40,Bilbao,expenses,travel,-458.22,-60585.91
buyer_1,Luis,Garay,1996-08-10,22984418N,luis.garay@cooltech.tech,641191,ES45209531629390469205,4758.25,2024-05-22T16:15:15,Bilbao,expenses,food,-110.8,-60696.71
buyer_1,Luis,Garay,1996-08-10,22984418N,luis.garay@cooltech.tech,641191,ES45209531629390469205,4758.25,2024-05-23T12:49:02,Bilbao,expenses,leisure,-42.33,-60739.04
buyer_1,Luis,Garay,1996-08-10,22984418N,luis.garay@cooltech.tech,641191,ES45209531629390469205,4758.25,2024-05-25T13:24:30,Bilbao,expenses,food,-78.08,-60817.12
buyer_1,Luis,Garay,1996-08-10,22984418N,luis.garay@cooltech.tech,641191,ES45209531629390469205,4758.25,2024-05-25T19:22:34,Bilbao,expenses,cash,-100.0,-60917.12
buyer_1,Luis,Garay,1996-08-10,22984418N,luis.garay@cooltech.tech,641191,ES45209531629390469205,4758.25,2024-05-25T14:02:03,Bilbao,expenses,repairs,-108.61,-61025.73
buyer_1,Luis,Garay,1996-08-10,22984418N,luis.garay@cooltech.tech,641191,ES45209531629390469205,4758.25,2024-05-28T14:16:18,Bilbao,expenses,cash,-100.0,-61125.73
buyer_1,Luis,Garay,1996-08-10,22984418N,luis.garay@cooltech.tech,641191,ES45209531629390469205,4758.25,2024-05-28T18:22:04,Bilbao,expenses,travel,-342.68,-61468.41
buyer_1,Luis,Garay,1996-08-10,22984418N,luis.garay@cooltech.tech,641191,ES45209531629390469205,4758.25,2024-05-31T04:50:43,Bilbao,expenses,food,-109.58,-61577.99
buyer_1,Luis,Garay,1996-08-10,22984418N,luis.garay@cooltech.tech,641191,ES45209531629390469205,4758.25,2024-06-01T16:34:59,Bilbao,incomes,salary,1530.87,-60047.12
buyer_1,Luis,Garay,1996-08-10,22984418N,luis.garay@cooltech.tech,641191,ES45209531629390469205,4758.25,2024-06-01T16:34:59,Bilbao,incomes,salary_bonus,1094.37,-58952.75
buyer_1,Luis,Garay,1996-08-10,22984418N,luis.garay@cooltech.tech,641191,ES45209531629390469205,4758.25,2024-06-01T11:33:39,Bilbao,expenses,appliances,-229.83,-59182.58
buyer_1,Luis,Garay,1996-08-10,22984418N,luis.garay@cooltech.tech,641191,ES45209531629390469205,4758.25,2024-06-02T13:46:31,Bilbao,expenses,taxes,-1253.12,-60435.7
buyer_1,Luis,Garay,1996-08-10,22984418N,luis.garay@cooltech.tech,641191,ES45209531629390469205,4758.25,2024-06-02T17:45:29,Bilbao,expenses,insurance,-251.6,-60687.3
buyer_1,Luis,Garay,1996-08-10,22984418N,luis.garay@cooltech.tech,641191,ES45209531629390469205,4758.25,2024-06-02T11:29:25,Bilbao,expenses,travel,-462.58,-61149.88
buyer_1,Luis,Garay,1996-08-10,22984418N,luis.garay@cooltech.tech,641191,ES45209531629390469205,4758.25,2024-06-03T11:12:07,Bilbao,expenses,food,-104.79,-61254.67
buyer_1,Luis,Garay,1996-08-10,22984418N,luis.garay@cooltech.tech,641191,ES45209531629390469205,4758.25,2024-06-03T08:19:21,Bilbao,expenses,gifts,-412.71,-61667.38
buyer_1,Luis,Garay,1996-08-10,22984418N,luis.garay@cooltech.tech,641191,ES45209531629390469205,4758.25,2024-06-04T09:16:40,Bilbao,expenses,rent,-560.24,-62227.62
buyer_1,Luis,Garay,1996-08-10,22984418N,luis.garay@cooltech.tech,641191,ES45209531629390469205,4758.25,2024-06-05T20:53:57,Bilbao,expenses,transport,-74.98,-62302.6
buyer_1,Luis,Garay,1996-08-10,22984418N,luis.garay@cooltech.tech,641191,ES45209531629390469205,4758.25,2024-06-06T17:18:36,Bilbao,expenses,gas,-38.85,-62341.45
buyer_1,Luis,Garay,1996-08-10,22984418N,luis.garay@cooltech.tech,641191,ES45209531629390469205,4758.25,2024-06-06T13:53:57,Bilbao,expenses,internet,-32.15,-62373.6
buyer_1,Luis,Garay,1996-08-10,22984418N,luis.garay@cooltech.tech,641191,ES45209531629390469205,4758.25,2024-06-06T18:00:08,Bilbao,expenses,cash,-100.0,-62473.6
buyer_1,Luis,Garay,1996-08-10,22984418N,luis.garay@cooltech.tech,641191,ES45209531629390469205,4758.25,2024-06-06T18:07:10,Bilbao,expenses,travel,-325.26,-62798.86
buyer_1,Luis,Garay,1996-08-10,22984418N,luis.garay@cooltech.tech,641191,ES45209531629390469205,4758.25,2024-06-08T18:53:54,Bilbao,expenses,phone,-31.37,-62830.23
buyer_1,Luis,Garay,1996-08-10,22984418N,luis.garay@cooltech.tech,641191,ES45209531629390469205,4758.25,2024-06-08T19:33:56,Bilbao,expenses,water,-15.7,-62845.93
buyer_1,Luis,Garay,1996-08-10,22984418N,luis.garay@cooltech.tech,641191,ES45209531629390469205,4758.25,2024-06-08T13:16:57,Bilbao,expenses,electricity,-16.59,-62862.52
buyer_1,Luis,Garay,1996-08-10,22984418N,luis.garay@cooltech.tech,641191,ES45209531629390469205,4758.25,2024-06-08T13:57:38,Bilbao,expenses,repairs,-83.07,-62945.59
buyer_1,Luis,Garay,1996-08-10,22984418N,luis.garay@cooltech.tech,641191,ES45209531629390469205,4758.25,2024-06-12T09:55:41,Bilbao,expenses,food,-88.68,-63034.27
buyer_1,Luis,Garay,1996-08-10,22984418N,luis.garay@cooltech.tech,641191,ES45209531629390469205,4758.25,2024-06-12T21:25:30,Bilbao,expenses,cash,-100.0,-63134.27
buyer_1,Luis,Garay,1996-08-10,22984418N,luis.garay@cooltech.tech,641191,ES45209531629390469205,4758.25,2024-06-13T09:19:27,Bilbao,expenses,food,-113.24,-63247.51
buyer_1,Luis,Garay,1996-08-10,22984418N,luis.garay@cooltech.tech,641191,ES45209531629390469205,4758.25,2024-06-13T18:11:21,Bilbao,expenses,cash,-100.0,-63347.51
buyer_1,Luis,Garay,1996-08-10,22984418N,luis.garay@cooltech.tech,641191,ES45209531629390469205,4758.25,2024-06-14T20:59:45,Bilbao,expenses,healthcare,-186.11,-63533.62
buyer_1,Luis,Garay,1996-08-10,22984418N,luis.garay@cooltech.tech,641191,ES45209531629390469205,4758.25,2024-06-15T02:28:34,Bilbao,expenses,food,-112.05,-63645.67
buyer_1,Luis,Garay,1996-08-10,22984418N,luis.garay@cooltech.tech,641191,ES45209531629390469205,4758.25,2024-06-15T18:16:04,Bilbao,expenses,leisure,-84.05,-63729.72
buyer_1,Luis,Garay,1996-08-10,22984418N,luis.garay@cooltech.tech,641191,ES45209531629390469205,4758.25,2024-06-15T08:44:21,Bilbao,expenses,clothing,-138.66,-63868.38
buyer_1,Luis,Garay,1996-08-10,22984418N,luis.garay@cooltech.tech,641191,ES45209531629390469205,4758.25,2024-06-16T15:40:10,Bilbao,expenses,repairs,-113.88,-63982.26
buyer_1,Luis,Garay,1996-08-10,22984418N,luis.garay@cooltech.tech,641191,ES45209531629390469205,4758.25,2024-06-18T19:04:45,Bilbao,expenses,cash,-100.0,-64082.26
buyer_1,Luis,Garay,1996-08-10,22984418N,luis.garay@cooltech.tech,641191,ES45209531629390469205,4758.25,2024-06-19T14:50:09,Bilbao,expenses,cash,-100.0,-64182.26
buyer_1,Luis,Garay,1996-08-10,22984418N,luis.garay@cooltech.tech,641191,ES45209531629390469205,4758.25,2024-06-19T19:30:02,Bilbao,expenses,gifts,-154.01,-64336.27
buyer_1,Luis,Garay,1996-08-10,22984418N,luis.garay@cooltech.tech,641191,ES45209531629390469205,4758.25,2024-06-20T18:21:27,Bilbao,expenses,leisure,-35.44,-64371.71
buyer_1,Luis,Garay,1996-08-10,22984418N,luis.garay@cooltech.tech,641191,ES45209531629390469205,4758.25,2024-06-21T08:06:07,Bilbao,expenses,cash,-100.0,-64471.71
buyer_1,Luis,Garay,1996-08-10,22984418N,luis.garay@cooltech.tech,641191,ES45209531629390469205,4758.25,2024-06-21T10:14:08,Bilbao,expenses,gifts,-202.0,-64673.71
buyer_1,Luis,Garay,1996-08-10,22984418N,luis.garay@cooltech.tech,641191,ES45209531629390469205,4758.25,2024-06-24T12:13:26,Bilbao,expenses,appliances,-289.13,-64962.84
buyer_1,Luis,Garay,1996-08-10,22984418N,luis.garay@cooltech.tech,641191,ES45209531629390469205,4758.25,2024-06-25T15:28:08,Bilbao,expenses,leisure,-34.24,-64997.08
buyer_1,Luis,Garay,1996-08-10,22984418N,luis.garay@cooltech.tech,641191,ES45209531629390469205,4758.25,2024-06-26T10:22:15,Bilbao,expenses,repairs,-71.79,-65068.87
buyer_1,Luis,Garay,1996-08-10,22984418N,luis.garay@cooltech.tech,641191,ES45209531629390469205,4758.25,2024-06-27T14:40:23,Bilbao,expenses,cash,-100.0,-65168.87
buyer_1,Luis,Garay,1996-08-10,22984418N,luis.garay@cooltech.tech,641191,ES45209531629390469205,4758.25,2024-06-29T19:38:57,Bilbao,expenses,food,-82.06,-65250.93
buyer_1,Luis,Garay,1996-08-10,22984418N,luis.garay@cooltech.tech,641191,ES45209531629390469205,4758.25,2024-06-29T13:38:10,Bilbao,expenses,transport,-58.03,-65308.96
buyer_1,Luis,Garay,1996-08-10,22984418N,luis.garay@cooltech.tech,641191,ES45209531629390469205,4758.25,2024-06-29T20:28:18,Bilbao,expenses,leisure,-64.3,-65373.26
buyer_1,Luis,Garay,1996-08-10,22984418N,luis.garay@cooltech.tech,641191,ES45209531629390469205,4758.25,2024-06-29T08:59:36,Bilbao,expenses,gifts,-140.8,-65514.06
buyer_1,Luis,Garay,1996-08-10,22984418N,luis.garay@cooltech.tech,641191,ES45209531629390469205,4758.25,2024-06-30T11:49:44,Bilbao,expenses,education,-54.16,-65568.22
buyer_1,Luis,Garay,1996-08-10,22984418N,luis.garay@cooltech.tech,641191,ES45209531629390469205,4758.25,2024-07-01T11:50:18,Bilbao,incomes,salary,1530.87,-64037.35
buyer_1,Luis,Garay,1996-08-10,22984418N,luis.garay@cooltech.tech,641191,ES45209531629390469205,4758.25,2024-07-02T02:06:41,Bilbao,expenses,cash,-100.0,-64137.35
buyer_1,Luis,Garay,1996-08-10,22984418N,luis.garay@cooltech.tech,641191,ES45209531629390469205,4758.25,2024-07-03T10:33:14,Bilbao,expenses,transport,-59.42,-64196.77
buyer_1,Luis,Garay,1996-08-10,22984418N,luis.garay@cooltech.tech,641191,ES45209531629390469205,4758.25,2024-07-03T17:50:10,Bilbao,expenses,travel,-288.98,-64485.75
buyer_1,Luis,Garay,1996-08-10,22984418N,luis.garay@cooltech.tech,641191,ES45209531629390469205,4758.25,2024-07-04T11:51:43,Bilbao,expenses,rent,-560.24,-65045.99
buyer_1,Luis,Garay,1996-08-10,22984418N,luis.garay@cooltech.tech,641191,ES45209531629390469205,4758.25,2024-07-05T15:01:22,Bilbao,expenses,water,-24.76,-65070.75
buyer_1,Luis,Garay,1996-08-10,22984418N,luis.garay@cooltech.tech,641191,ES45209531629390469205,4758.25,2024-07-05T14:52:27,Bilbao,expenses,internet,-32.15,-65102.9
buyer_1,Luis,Garay,1996-08-10,22984418N,luis.garay@cooltech.tech,641191,ES45209531629390469205,4758.25,2024-07-06T17:58:25,Bilbao,expenses,food,-113.81,-65216.71
buyer_1,Luis,Garay,1996-08-10,22984418N,luis.garay@cooltech.tech,641191,ES45209531629390469205,4758.25,2024-07-06T17:11:07,Bilbao,expenses,car,-94.24,-65310.95
buyer_1,Luis,Garay,1996-08-10,22984418N,luis.garay@cooltech.tech,641191,ES45209531629390469205,4758.25,2024-07-07T22:05:57,Bilbao,expenses,gas,-40.55,-65351.5
buyer_1,Luis,Garay,1996-08-10,22984418N,luis.garay@cooltech.tech,641191,ES45209531629390469205,4758.25,2024-07-08T17:01:24,Bilbao,expenses,electricity,-18.76,-65370.26
buyer_1,Luis,Garay,1996-08-10,22984418N,luis.garay@cooltech.tech,641191,ES45209531629390469205,4758.25,2024-07-08T10:42:16,Bilbao,expenses,phone,-30.21,-65400.47
buyer_1,Luis,Garay,1996-08-10,22984418N,luis.garay@cooltech.tech,641191,ES45209531629390469205,4758.25,2024-07-09T17:42:55,Bilbao,expenses,cash,-100.0,-65500.47
buyer_1,Luis,Garay,1996-08-10,22984418N,luis.garay@cooltech.tech,641191,ES45209531629390469205,4758.25,2024-07-09T09:45:49,Bilbao,expenses,gifts,-33.01,-65533.48
buyer_1,Luis,Garay,1996-08-10,22984418N,luis.garay@cooltech.tech,641191,ES45209531629390469205,4758.25,2024-07-10T19:29:20,Bilbao,expenses,cash,-100.0,-65633.48
buyer_1,Luis,Garay,1996-08-10,22984418N,luis.garay@cooltech.tech,641191,ES45209531629390469205,4758.25,2024-07-13T11:36:33,Bilbao,expenses,food,-106.41,-65739.89
buyer_1,Luis,Garay,1996-08-10,22984418N,luis.garay@cooltech.tech,641191,ES45209531629390469205,4758.25,2024-07-17T18:36:34,Bilbao,expenses,gifts,-136.81,-65876.7
buyer_1,Luis,Garay,1996-08-10,22984418N,luis.garay@cooltech.tech,641191,ES45209531629390469205,4758.25,2024-07-20T15:41:25,Bilbao,expenses,leisure,-40.91,-65917.61
buyer_1,Luis,Garay,1996-08-10,22984418N,luis.garay@cooltech.tech,641191,ES45209531629390469205,4758.25,2024-07-20T13:09:06,Bilbao,expenses,cash,-100.0,-66017.61
buyer_1,Luis,Garay,1996-08-10,22984418N,luis.garay@cooltech.tech,641191,ES45209531629390469205,4758.25,2024-07-22T16:55:50,Bilbao,expenses,clothing,-71.75,-66089.36
buyer_1,Luis,Garay,1996-08-10,22984418N,luis.garay@cooltech.tech,641191,ES45209531629390469205,4758.25,2024-07-24T11:43:25,Bilbao,expenses,transport,-69.49,-66158.85
buyer_1,Luis,Garay,1996-08-10,22984418N,luis.garay@cooltech.tech,641191,ES45209531629390469205,4758.25,2024-07-24T19:07:30,Bilbao,expenses,education,-78.48,-66237.33
buyer_1,Luis,Garay,1996-08-10,22984418N,luis.garay@cooltech.tech,641191,ES45209531629390469205,4758.25,2024-07-25T09:57:42,Bilbao,expenses,healthcare,-43.82,-66281.15
buyer_1,Luis,Garay,1996-08-10,22984418N,luis.garay@cooltech.tech,641191,ES45209531629390469205,4758.25,2024-07-26T19:09:43,Bilbao,expenses,transport,-67.49,-66348.64
buyer_1,Luis,Garay,1996-08-10,22984418N,luis.garay@cooltech.tech,641191,ES45209531629390469205,4758.25,2024-07-27T08:00:23,Bilbao,expenses,leisure,-67.62,-66416.26
buyer_1,Luis,Garay,1996-08-10,22984418N,luis.garay@cooltech.tech,641191,ES45209531629390469205,4758.25,2024-08-01T20:44:05,Bilbao,incomes,salary,1530.87,-64885.39
buyer_1,Luis,Garay,1996-08-10,22984418N,luis.garay@cooltech.tech,641191,ES45209531629390469205,4758.25,2024-08-01T10:33:36,Bilbao,expenses,transport,-88.15,-64973.54
buyer_1,Luis,Garay,1996-08-10,22984418N,luis.garay@cooltech.tech,641191,ES45209531629390469205,4758.25,2024-08-01T14:03:15,Bilbao,expenses,gifts,-413.53,-65387.07
buyer_1,Luis,Garay,1996-08-10,22984418N,luis.garay@cooltech.tech,641191,ES45209531629390469205,4758.25,2024-08-02T15:44:39,Bilbao,expenses,repairs,-131.05,-65518.12
buyer_1,Luis,Garay,1996-08-10,22984418N,luis.garay@cooltech.tech,641191,ES45209531629390469205,4758.25,2024-08-04T08:39:31,Bilbao,expenses,rent,-560.24,-66078.36
buyer_1,Luis,Garay,1996-08-10,22984418N,luis.garay@cooltech.tech,641191,ES45209531629390469205,4758.25,2024-08-04T10:20:31,Bilbao,expenses,clothing,-110.0,-66188.36
buyer_1,Luis,Garay,1996-08-10,22984418N,luis.garay@cooltech.tech,641191,ES45209531629390469205,4758.25,2024-08-05T13:12:14,Bilbao,expenses,gas,-87.41,-66275.77
buyer_1,Luis,Garay,1996-08-10,22984418N,luis.garay@cooltech.tech,641191,ES45209531629390469205,4758.25,2024-08-05T18:42:13,Bilbao,expenses,food,-79.22,-66354.99
buyer_1,Luis,Garay,1996-08-10,22984418N,luis.garay@cooltech.tech,641191,ES45209531629390469205,4758.25,2024-08-05T14:42:17,Bilbao,expenses,clothing,-137.06,-66492.05
buyer_1,Luis,Garay,1996-08-10,22984418N,luis.garay@cooltech.tech,641191,ES45209531629390469205,4758.25,2024-08-07T17:53:26,Bilbao,expenses,internet,-32.15,-66524.2
buyer_1,Luis,Garay,1996-08-10,22984418N,luis.garay@cooltech.tech,641191,ES45209531629390469205,4758.25,2024-08-07T16:37:16,Bilbao,expenses,leisure,-38.65,-66562.85
buyer_1,Luis,Garay,1996-08-10,22984418N,luis.garay@cooltech.tech,641191,ES45209531629390469205,4758.25,2024-08-07T17:47:16,Bilbao,expenses,cash,-100.0,-66662.85
buyer_1,Luis,Garay,1996-08-10,22984418N,luis.garay@cooltech.tech,641191,ES45209531629390469205,4758.25,2024-08-07T19:19:11,Bilbao,expenses,repairs,-46.31,-66709.16
buyer_1,Luis,Garay,1996-08-10,22984418N,luis.garay@cooltech.tech,641191,ES45209531629390469205,4758.25,2024-08-08T02:15:01,Bilbao,expenses,phone,-34.42,-66743.58
buyer_1,Luis,Garay,1996-08-10,22984418N,luis.garay@cooltech.tech,641191,ES45209531629390469205,4758.25,2024-08-08T22:39:40,Bilbao,expenses,water,-31.95,-66775.53
buyer_1,Luis,Garay,1996-08-10,22984418N,luis.garay@cooltech.tech,641191,ES45209531629390469205,4758.25,2024-08-08T23:05:35,Bilbao,expenses,electricity,-16.05,-66791.58
buyer_1,Luis,Garay,1996-08-10,22984418N,luis.garay@cooltech.tech,641191,ES45209531629390469205,4758.25,2024-08-08T13:27:55,Bilbao,expenses,clothing,-71.75,-66863.33
buyer_1,Luis,Garay,1996-08-10,22984418N,luis.garay@cooltech.tech,641191,ES45209531629390469205,4758.25,2024-08-09T15:16:26,Bilbao,expenses,clothing,-92.4,-66955.73
buyer_1,Luis,Garay,1996-08-10,22984418N,luis.garay@cooltech.tech,641191,ES45209531629390469205,4758.25,2024-08-13T15:39:08,Bilbao,expenses,food,-76.75,-67032.48
buyer_1,Luis,Garay,1996-08-10,22984418N,luis.garay@cooltech.tech,641191,ES45209531629390469205,4758.25,2024-08-13T11:09:57,Bilbao,expenses,cash,-100.0,-67132.48
buyer_1,Luis,Garay,1996-08-10,22984418N,luis.garay@cooltech.tech,641191,ES45209531629390469205,4758.25,2024-08-13T10:45:32,Bilbao,expenses,gifts,-102.47,-67234.95
buyer_1,Luis,Garay,1996-08-10,22984418N,luis.garay@cooltech.tech,641191,ES45209531629390469205,4758.25,2024-08-14T09:00:32,Bilbao,expenses,leisure,-54.85,-67289.8
buyer_1,Luis,Garay,1996-08-10,22984418N,luis.garay@cooltech.tech,641191,ES45209531629390469205,4758.25,2024-08-15T17:19:26,Bilbao,expenses,education,-54.41,-67344.21
buyer_1,Luis,Garay,1996-08-10,22984418N,luis.garay@cooltech.tech,641191,ES45209531629390469205,4758.25,2024-08-15T13:50:30,Bilbao,expenses,cash,-100.0,-67444.21
buyer_1,Luis,Garay,1996-08-10,22984418N,luis.garay@cooltech.tech,641191,ES45209531629390469205,4758.25,2024-08-15T10:35:33,Bilbao,expenses,repairs,-63.25,-67507.46
buyer_1,Luis,Garay,1996-08-10,22984418N,luis.garay@cooltech.tech,641191,ES45209531629390469205,4758.25,2024-08-15T18:31:05,Bilbao,expenses,gifts,-329.12,-67836.58
buyer_1,Luis,Garay,1996-08-10,22984418N,luis.garay@cooltech.tech,641191,ES45209531629390469205,4758.25,2024-08-18T12:48:22,Bilbao,expenses,food,-98.76,-67935.34
buyer_1,Luis,Garay,1996-08-10,22984418N,luis.garay@cooltech.tech,641191,ES45209531629390469205,4758.25,2024-08-20T13:38:21,Bilbao,expenses,cash,-100.0,-68035.34
buyer_1,Luis,Garay,1996-08-10,22984418N,luis.garay@cooltech.tech,641191,ES45209531629390469205,4758.25,2024-08-20T18:58:42,Bilbao,expenses,repairs,-202.1,-68237.44
buyer_1,Luis,Garay,1996-08-10,22984418N,luis.garay@cooltech.tech,641191,ES45209531629390469205,4758.25,2024-08-21T09:10:56,Bilbao,expenses,gifts,-325.88,-68563.32
buyer_1,Luis,Garay,1996-08-10,22984418N,luis.garay@cooltech.tech,641191,ES45209531629390469205,4758.25,2024-08-22T22:06:21,Bilbao,expenses,clothing,-47.1,-68610.42
buyer_1,Luis,Garay,1996-08-10,22984418N,luis.garay@cooltech.tech,641191,ES45209531629390469205,4758.25,2024-08-24T20:22:51,Bilbao,expenses,clothing,-102.1,-68712.52
buyer_1,Luis,Garay,1996-08-10,22984418N,luis.garay@cooltech.tech,641191,ES45209531629390469205,4758.25,2024-08-24T08:03:18,Bilbao,expenses,appliances,-368.89,-69081.41
buyer_1,Luis,Garay,1996-08-10,22984418N,luis.garay@cooltech.tech,641191,ES45209531629390469205,4758.25,2024-08-24T12:21:55,Bilbao,expenses,repairs,-84.31,-69165.72
buyer_1,Luis,Garay,1996-08-10,22984418N,luis.garay@cooltech.tech,641191,ES45209531629390469205,4758.25,2024-08-25T03:49:19,Bilbao,expenses,leisure,-69.15,-69234.87
buyer_1,Luis,Garay,1996-08-10,22984418N,luis.garay@cooltech.tech,641191,ES45209531629390469205,4758.25,2024-08-25T08:02:14,Bilbao,expenses,cash,-100.0,-69334.87
buyer_1,Luis,Garay,1996-08-10,22984418N,luis.garay@cooltech.tech,641191,ES45209531629390469205,4758.25,2024-08-26T19:16:34,Bilbao,expenses,clothing,-61.88,-69396.75
buyer_1,Luis,Garay,1996-08-10,22984418N,luis.garay@cooltech.tech,641191,ES45209531629390469205,4758.25,2024-08-27T14:30:26,Bilbao,expenses,travel,-329.47,-69726.22
buyer_1,Luis,Garay,1996-08-10,22984418N,luis.garay@cooltech.tech,641191,ES45209531629390469205,4758.25,2024-08-28T13:00:05,Bilbao,expenses,gifts,-226.29,-69952.51
buyer_1,Luis,Garay,1996-08-10,22984418N,luis.garay@cooltech.tech,641191,ES45209531629390469205,4758.25,2024-08-29T16:06:07,Bilbao,expenses,education,-67.11,-70019.62
buyer_1,Luis,Garay,1996-08-10,22984418N,luis.garay@cooltech.tech,641191,ES45209531629390469205,4758.25,2024-08-29T10:51:22,Bilbao,expenses,repairs,-212.67,-70232.29
buyer_1,Luis,Garay,1996-08-10,22984418N,luis.garay@cooltech.tech,641191,ES45209531629390469205,4758.25,2024-09-01T19:14:40,Bilbao,incomes,salary,1530.87,-68701.42
buyer_1,Luis,Garay,1996-08-10,22984418N,luis.garay@cooltech.tech,641191,ES45209531629390469205,4758.25,2024-09-01T19:14:40,Bilbao,incomes,extra_income,156.73,-68544.69
buyer_1,Luis,Garay,1996-08-10,22984418N,luis.garay@cooltech.tech,641191,ES45209531629390469205,4758.25,2024-09-01T07:35:33,Bilbao,expenses,repairs,-37.39,-68582.08
buyer_1,Luis,Garay,1996-08-10,22984418N,luis.garay@cooltech.tech,641191,ES45209531629390469205,4758.25,2024-09-04T19:46:43,Bilbao,expenses,rent,-560.24,-69142.32
buyer_1,Luis,Garay,1996-08-10,22984418N,luis.garay@cooltech.tech,641191,ES45209531629390469205,4758.25,2024-09-06T10:44:33,Bilbao,expenses,electricity,-22.25,-69164.57
buyer_1,Luis,Garay,1996-08-10,22984418N,luis.garay@cooltech.tech,641191,ES45209531629390469205,4758.25,2024-09-06T09:29:39,Bilbao,expenses,cash,-100.0,-69264.57
buyer_1,Luis,Garay,1996-08-10,22984418N,luis.garay@cooltech.tech,641191,ES45209531629390469205,4758.25,2024-09-07T20:31:40,Bilbao,expenses,internet,-32.15,-69296.72
buyer_1,Luis,Garay,1996-08-10,22984418N,luis.garay@cooltech.tech,641191,ES45209531629390469205,4758.25,2024-09-07T23:19:44,Bilbao,expenses,food,-81.05,-69377.77
buyer_1,Luis,Garay,1996-08-10,22984418N,luis.garay@cooltech.tech,641191,ES45209531629390469205,4758.25,2024-09-08T18:18:13,Bilbao,expenses,water,-27.07,-69404.84
buyer_1,Luis,Garay,1996-08-10,22984418N,luis.garay@cooltech.tech,641191,ES45209531629390469205,4758.25,2024-09-08T21:43:41,Bilbao,expenses,gas,-50.3,-69455.14
buyer_1,Luis,Garay,1996-08-10,22984418N,luis.garay@cooltech.tech,641191,ES45209531629390469205,4758.25,2024-09-08T09:20:19,Bilbao,expenses,phone,-31.39,-69486.53
buyer_1,Luis,Garay,1996-08-10,22984418N,luis.garay@cooltech.tech,641191,ES45209531629390469205,4758.25,2024-09-09T13:19:11,Bilbao,expenses,transport,-82.19,-69568.72
buyer_1,Luis,Garay,1996-08-10,22984418N,luis.garay@cooltech.tech,641191,ES45209531629390469205,4758.25,2024-09-10T11:22:29,Bilbao,expenses,transport,-81.23,-69649.95
buyer_1,Luis,Garay,1996-08-10,22984418N,luis.garay@cooltech.tech,641191,ES45209531629390469205,4758.25,2024-09-10T10:04:46,Bilbao,expenses,leisure,-28.89,-69678.84
buyer_1,Luis,Garay,1996-08-10,22984418N,luis.garay@cooltech.tech,641191,ES45209531629390469205,4758.25,2024-09-15T08:17:29,Bilbao,expenses,gifts,-428.05,-70106.89
buyer_1,Luis,Garay,1996-08-10,22984418N,luis.garay@cooltech.tech,641191,ES45209531629390469205,4758.25,2024-09-16T12:50:28,Bilbao,expenses,gifts,-445.73,-70552.62
buyer_1,Luis,Garay,1996-08-10,22984418N,luis.garay@cooltech.tech,641191,ES45209531629390469205,4758.25,2024-09-17T14:37:59,Bilbao,expenses,transport,-60.4,-70613.02
buyer_1,Luis,Garay,1996-08-10,22984418N,luis.garay@cooltech.tech,641191,ES45209531629390469205,4758.25,2024-09-17T16:35:37,Bilbao,expenses,clothing,-127.55,-70740.57
buyer_1,Luis,Garay,1996-08-10,22984418N,luis.garay@cooltech.tech,641191,ES45209531629390469205,4758.25,2024-09-19T09:40:43,Bilbao,expenses,food,-70.82,-70811.39
buyer_1,Luis,Garay,1996-08-10,22984418N,luis.garay@cooltech.tech,641191,ES45209531629390469205,4758.25,2024-09-19T14:56:48,Bilbao,expenses,leisure,-58.45,-70869.84
buyer_1,Luis,Garay,1996-08-10,22984418N,luis.garay@cooltech.tech,641191,ES45209531629390469205,4758.25,2024-09-20T16:05:22,Bilbao,expenses,leisure,-23.73,-70893.57
buyer_1,Luis,Garay,1996-08-10,22984418N,luis.garay@cooltech.tech,641191,ES45209531629390469205,4758.25,2024-09-20T16:31:25,Bilbao,expenses,clothing,-68.61,-70962.18
buyer_1,Luis,Garay,1996-08-10,22984418N,luis.garay@cooltech.tech,641191,ES45209531629390469205,4758.25,2024-09-21T06:37:38,Bilbao,expenses,repairs,-163.16,-71125.34
buyer_1,Luis,Garay,1996-08-10,22984418N,luis.garay@cooltech.tech,641191,ES45209531629390469205,4758.25,2024-09-23T20:02:01,Bilbao,expenses,leisure,-46.87,-71172.21
buyer_1,Luis,Garay,1996-08-10,22984418N,luis.garay@cooltech.tech,641191,ES45209531629390469205,4758.25,2024-09-24T20:29:37,Bilbao,expenses,food,-92.94,-71265.15
buyer_1,Luis,Garay,1996-08-10,22984418N,luis.garay@cooltech.tech,641191,ES45209531629390469205,4758.25,2024-09-25T22:26:26,Bilbao,expenses,clothing,-134.35,-71399.5
buyer_1,Luis,Garay,1996-08-10,22984418N,luis.garay@cooltech.tech,641191,ES45209531629390469205,4758.25,2024-09-25T09:18:04,Bilbao,expenses,healthcare,-89.97,-71489.47
buyer_1,Luis,Garay,1996-08-10,22984418N,luis.garay@cooltech.tech,641191,ES45209531629390469205,4758.25,2024-09-26T11:40:19,Bilbao,expenses,repairs,-41.61,-71531.08
buyer_1,Luis,Garay,1996-08-10,22984418N,luis.garay@cooltech.tech,641191,ES45209531629390469205,4758.25,2024-09-28T10:44:08,Bilbao,expenses,gifts,-280.98,-71812.06
buyer_1,Luis,Garay,1996-08-10,22984418N,luis.garay@cooltech.tech,641191,ES45209531629390469205,4758.25,2024-09-29T14:58:23,Bilbao,expenses,cash,-100.0,-71912.06
buyer_1,Luis,Garay,1996-08-10,22984418N,luis.garay@cooltech.tech,641191,ES45209531629390469205,4758.25,2024-09-30T11:27:56,Bilbao,expenses,appliances,-227.88,-72139.94
buyer_1,Luis,Garay,1996-08-10,22984418N,luis.garay@cooltech.tech,641191,ES45209531629390469205,4758.25,2024-10-01T09:00:09,Bilbao,incomes,salary,1530.87,-70609.07
buyer_1,Luis,Garay,1996-08-10,22984418N,luis.garay@cooltech.tech,641191,ES45209531629390469205,4758.25,2024-10-01T09:27:21,Bilbao,expenses,clothing,-158.33,-70767.4
buyer_1,Luis,Garay,1996-08-10,22984418N,luis.garay@cooltech.tech,641191,ES45209531629390469205,4758.25,2024-10-04T11:09:50,Bilbao,expenses,rent,-560.24,-71327.64
buyer_1,Luis,Garay,1996-08-10,22984418N,luis.garay@cooltech.tech,641191,ES45209531629390469205,4758.25,2024-10-04T20:22:20,Bilbao,expenses,cash,-100.0,-71427.64
buyer_1,Luis,Garay,1996-08-10,22984418N,luis.garay@cooltech.tech,641191,ES45209531629390469205,4758.25,2024-10-04T09:52:43,Bilbao,expenses,repairs,-117.16,-71544.8
buyer_1,Luis,Garay,1996-08-10,22984418N,luis.garay@cooltech.tech,641191,ES45209531629390469205,4758.25,2024-10-05T09:24:57,Bilbao,expenses,phone,-28.86,-71573.66
buyer_1,Luis,Garay,1996-08-10,22984418N,luis.garay@cooltech.tech,641191,ES45209531629390469205,4758.25,2024-10-06T12:12:43,Bilbao,expenses,internet,-32.15,-71605.81
buyer_1,Luis,Garay,1996-08-10,22984418N,luis.garay@cooltech.tech,641191,ES45209531629390469205,4758.25,2024-10-07T00:59:29,Bilbao,expenses,water,-19.06,-71624.87
buyer_1,Luis,Garay,1996-08-10,22984418N,luis.garay@cooltech.tech,641191,ES45209531629390469205,4758.25,2024-10-08T10:27:24,Bilbao,expenses,electricity,-65.97,-71690.84
buyer_1,Luis,Garay,1996-08-10,22984418N,luis.garay@cooltech.tech,641191,ES45209531629390469205,4758.25,2024-10-08T12:54:31,Bilbao,expenses,gas,-65.58,-71756.42
buyer_1,Luis,Garay,1996-08-10,22984418N,luis.garay@cooltech.tech,641191,ES45209531629390469205,4758.25,2024-10-08T18:16:55,Bilbao,expenses,leisure,-74.73,-71831.15
buyer_2,Carmen,Lozano,1984-09-05,01940193M,carmen.lozano@brilliantdata.site,257841,ES11209564797724896921,5500.05,2022-01-01T20:06:56,Zarautz,incomes,salary,1989.85,7489.9
buyer_2,Carmen,Lozano,1984-09-05,01940193M,carmen.lozano@brilliantdata.site,257841,ES11209564797724896921,5500.05,2022-01-04T21:08:55,Zarautz,expenses,mortgage,-888.96,6600.94
buyer_2,Carmen,Lozano,1984-09-05,01940193M,carmen.lozano@brilliantdata.site,257841,ES11209564797724896921,5500.05,2022-01-04T21:12:59,Zarautz,expenses,food,-104.09,6496.85
buyer_2,Carmen,Lozano,1984-09-05,01940193M,carmen.lozano@brilliantdata.site,257841,ES11209564797724896921,5500.05,2022-01-04T19:01:46,Zarautz,expenses,travel,-528.79,5968.06
buyer_2,Carmen,Lozano,1984-09-05,01940193M,carmen.lozano@brilliantdata.site,257841,ES11209564797724896921,5500.05,2022-01-04T20:38:10,Zarautz,expenses,gifts,-53.53,5914.53
buyer_2,Carmen,Lozano,1984-09-05,01940193M,carmen.lozano@brilliantdata.site,257841,ES11209564797724896921,5500.05,2022-01-05T15:41:42,Zarautz,expenses,internet,-41.79,5872.74
buyer_2,Carmen,Lozano,1984-09-05,01940193M,carmen.lozano@brilliantdata.site,257841,ES11209564797724896921,5500.05,2022-01-06T19:38:42,Zarautz,expenses,gas,-104.78,5767.96
buyer_2,Carmen,Lozano,1984-09-05,01940193M,carmen.lozano@brilliantdata.site,257841,ES11209564797724896921,5500.05,2022-01-07T22:44:54,Zarautz,expenses,water,-38.14,5729.82
buyer_2,Carmen,Lozano,1984-09-05,01940193M,carmen.lozano@brilliantdata.site,257841,ES11209564797724896921,5500.05,2022-01-08T11:11:01,Zarautz,expenses,phone,-39.92,5689.9
buyer_2,Carmen,Lozano,1984-09-05,01940193M,carmen.lozano@brilliantdata.site,257841,ES11209564797724896921,5500.05,2022-01-08T12:11:30,Zarautz,expenses,electricity,-74.05,5615.85
buyer_2,Carmen,Lozano,1984-09-05,01940193M,carmen.lozano@brilliantdata.site,257841,ES11209564797724896921,5500.05,2022-01-08T18:26:26,Zarautz,expenses,children,-270.53,5345.32
buyer_2,Carmen,Lozano,1984-09-05,01940193M,carmen.lozano@brilliantdata.site,257841,ES11209564797724896921,5500.05,2022-01-11T08:44:14,Zarautz,expenses,food,-66.43,5278.89
buyer_2,Carmen,Lozano,1984-09-05,01940193M,carmen.lozano@brilliantdata.site,257841,ES11209564797724896921,5500.05,2022-01-11T17:44:05,Zarautz,expenses,repairs,-294.87,4984.02
buyer_2,Carmen,Lozano,1984-09-05,01940193M,carmen.lozano@brilliantdata.site,257841,ES11209564797724896921,5500.05,2022-01-12T13:05:00,Zarautz,expenses,cash,-100.0,4884.02
buyer_2,Carmen,Lozano,1984-09-05,01940193M,carmen.lozano@brilliantdata.site,257841,ES11209564797724896921,5500.05,2022-01-14T14:49:36,Zarautz,expenses,leisure,-84.96,4799.06
buyer_2,Carmen,Lozano,1984-09-05,01940193M,carmen.lozano@brilliantdata.site,257841,ES11209564797724896921,5500.05,2022-01-16T19:26:21,Zarautz,expenses,cash,-100.0,4699.06
buyer_2,Carmen,Lozano,1984-09-05,01940193M,carmen.lozano@brilliantdata.site,257841,ES11209564797724896921,5500.05,2022-01-19T08:12:16,Zarautz,expenses,leisure,-34.73,4664.33
buyer_2,Carmen,Lozano,1984-09-05,01940193M,carmen.lozano@brilliantdata.site,257841,ES11209564797724896921,5500.05,2022-01-23T13:27:55,Zarautz,expenses,transport,-42.44,4621.89
buyer_2,Carmen,Lozano,1984-09-05,01940193M,carmen.lozano@brilliantdata.site,257841,ES11209564797724896921,5500.05,2022-01-23T16:05:26,Zarautz,expenses,leisure,-41.9,4579.99
buyer_2,Carmen,Lozano,1984-09-05,01940193M,carmen.lozano@brilliantdata.site,257841,ES11209564797724896921,5500.05,2022-01-23T12:08:21,Zarautz,expenses,cash,-100.0,4479.99
buyer_2,Carmen,Lozano,1984-09-05,01940193M,carmen.lozano@brilliantdata.site,257841,ES11209564797724896921,5500.05,2022-01-23T20:55:42,Zarautz,expenses,repairs,-166.0,4313.99
buyer_2,Carmen,Lozano,1984-09-05,01940193M,carmen.lozano@brilliantdata.site,257841,ES11209564797724896921,5500.05,2022-01-24T08:34:00,Zarautz,expenses,food,-97.18,4216.81
buyer_2,Carmen,Lozano,1984-09-05,01940193M,carmen.lozano@brilliantdata.site,257841,ES11209564797724896921,5500.05,2022-01-24T11:50:18,Zarautz,expenses,transport,-75.49,4141.32
buyer_2,Carmen,Lozano,1984-09-05,01940193M,carmen.lozano@brilliantdata.site,257841,ES11209564797724896921,5500.05,2022-01-24T08:08:09,Zarautz,expenses,leisure,-76.78,4064.54
buyer_2,Carmen,Lozano,1984-09-05,01940193M,carmen.lozano@brilliantdata.site,257841,ES11209564797724896921,5500.05,2022-01-25T15:30:57,Zarautz,expenses,leisure,-44.88,4019.66
buyer_2,Carmen,Lozano,1984-09-05,01940193M,carmen.lozano@brilliantdata.site,257841,ES11209564797724896921,5500.05,2022-01-25T10:58:42,Zarautz,expenses,cash,-100.0,3919.66
buyer_2,Carmen,Lozano,1984-09-05,01940193M,carmen.lozano@brilliantdata.site,257841,ES11209564797724896921,5500.05,2022-01-26T08:52:01,Zarautz,expenses,children,-373.98,3545.68
buyer_2,Carmen,Lozano,1984-09-05,01940193M,carmen.lozano@brilliantdata.site,257841,ES11209564797724896921,5500.05,2022-01-27T12:55:25,Zarautz,expenses,children,-457.08,3088.6
buyer_2,Carmen,Lozano,1984-09-05,01940193M,carmen.lozano@brilliantdata.site,257841,ES11209564797724896921,5500.05,2022-01-28T16:35:53,Zarautz,expenses,transport,-80.96,3007.64
buyer_2,Carmen,Lozano,1984-09-05,01940193M,carmen.lozano@brilliantdata.site,257841,ES11209564797724896921,5500.05,2022-01-28T17:25:00,Zarautz,expenses,leisure,-56.95,2950.69
buyer_2,Carmen,Lozano,1984-09-05,01940193M,carmen.lozano@brilliantdata.site,257841,ES11209564797724896921,5500.05,2022-01-28T10:55:12,Zarautz,expenses,cash,-100.0,2850.69
buyer_2,Carmen,Lozano,1984-09-05,01940193M,carmen.lozano@brilliantdata.site,257841,ES11209564797724896921,5500.05,2022-01-30T04:24:24,Zarautz,expenses,repairs,-144.76,2705.93
buyer_2,Carmen,Lozano,1984-09-05,01940193M,carmen.lozano@brilliantdata.site,257841,ES11209564797724896921,5500.05,2022-01-31T14:30:51,Zarautz,expenses,healthcare,-126.34,2579.59
buyer_2,Carmen,Lozano,1984-09-05,01940193M,carmen.lozano@brilliantdata.site,257841,ES11209564797724896921,5500.05,2022-02-01T09:47:30,Zarautz,incomes,salary,1989.85,4569.44
buyer_2,Carmen,Lozano,1984-09-05,01940193M,carmen.lozano@brilliantdata.site,257841,ES11209564797724896921,5500.05,2022-02-02T21:27:33,Zarautz,expenses,cash,-100.0,4469.44
buyer_2,Carmen,Lozano,1984-09-05,01940193M,carmen.lozano@brilliantdata.site,257841,ES11209564797724896921,5500.05,2022-02-03T16:45:45,Zarautz,expenses,transport,-89.74,4379.7
buyer_2,Carmen,Lozano,1984-09-05,01940193M,carmen.lozano@brilliantdata.site,257841,ES11209564797724896921,5500.05,2022-02-04T10:35:00,Zarautz,expenses,mortgage,-888.96,3490.74
buyer_2,Carmen,Lozano,1984-09-05,01940193M,carmen.lozano@brilliantdata.site,257841,ES11209564797724896921,5500.05,2022-02-04T12:13:32,Zarautz,expenses,food,-113.86,3376.88
buyer_2,Carmen,Lozano,1984-09-05,01940193M,carmen.lozano@brilliantdata.site,257841,ES11209564797724896921,5500.05,2022-02-04T18:23:45,Zarautz,expenses,repairs,-189.72,3187.16
buyer_2,Carmen,Lozano,1984-09-05,01940193M,carmen.lozano@brilliantdata.site,257841,ES11209564797724896921,5500.05,2022-02-05T08:48:17,Zarautz,expenses,internet,-41.79,3145.37
buyer_2,Carmen,Lozano,1984-09-05,01940193M,carmen.lozano@brilliantdata.site,257841,ES11209564797724896921,5500.05,2022-02-06T13:29:59,Zarautz,expenses,water,-42.19,3103.18
buyer_2,Carmen,Lozano,1984-09-05,01940193M,carmen.lozano@brilliantdata.site,257841,ES11209564797724896921,5500.05,2022-02-06T17:50:29,Zarautz,expenses,phone,-38.87,3064.31
buyer_2,Carmen,Lozano,1984-09-05,01940193M,carmen.lozano@brilliantdata.site,257841,ES11209564797724896921,5500.05,2022-02-07T11:29:43,Zarautz,expenses,electricity,-46.67,3017.64
buyer_2,Carmen,Lozano,1984-09-05,01940193M,carmen.lozano@brilliantdata.site,257841,ES11209564797724896921,5500.05,2022-02-08T20:19:13,Zarautz,expenses,gas,-46.48,2971.16
buyer_2,Carmen,Lozano,1984-09-05,01940193M,carmen.lozano@brilliantdata.site,257841,ES11209564797724896921,5500.05,2022-02-09T23:23:09,Zarautz,expenses,cash,-100.0,2871.16
buyer_2,Carmen,Lozano,1984-09-05,01940193M,carmen.lozano@brilliantdata.site,257841,ES11209564797724896921,5500.05,2022-02-10T14:00:39,Zarautz,expenses,children,-301.57,2569.59
buyer_2,Carmen,Lozano,1984-09-05,01940193M,carmen.lozano@brilliantdata.site,257841,ES11209564797724896921,5500.05,2022-02-12T21:39:43,Zarautz,expenses,clothing,-63.44,2506.15
buyer_2,Carmen,Lozano,1984-09-05,01940193M,carmen.lozano@brilliantdata.site,257841,ES11209564797724896921,5500.05,2022-02-13T12:14:13,Zarautz,expenses,food,-124.49,2381.66
buyer_2,Carmen,Lozano,1984-09-05,01940193M,carmen.lozano@brilliantdata.site,257841,ES11209564797724896921,5500.05,2022-02-14T18:44:48,Zarautz,expenses,clothing,-132.87,2248.79
buyer_2,Carmen,Lozano,1984-09-05,01940193M,carmen.lozano@brilliantdata.site,257841,ES11209564797724896921,5500.05,2022-02-15T16:29:56,Zarautz,expenses,food,-118.76,2130.03
buyer_2,Carmen,Lozano,1984-09-05,01940193M,carmen.lozano@brilliantdata.site,257841,ES11209564797724896921,5500.05,2022-02-15T08:53:34,Zarautz,expenses,transport,-49.91,2080.12
buyer_2,Carmen,Lozano,1984-09-05,01940193M,carmen.lozano@brilliantdata.site,257841,ES11209564797724896921,5500.05,2022-02-17T11:02:41,Zarautz,expenses,food,-81.89,1998.23
buyer_2,Carmen,Lozano,1984-09-05,01940193M,carmen.lozano@brilliantdata.site,257841,ES11209564797724896921,5500.05,2022-02-18T07:28:27,Zarautz,expenses,healthcare,-172.69,1825.54
buyer_2,Carmen,Lozano,1984-09-05,01940193M,carmen.lozano@brilliantdata.site,257841,ES11209564797724896921,5500.05,2022-02-18T10:13:24,Zarautz,expenses,gifts,-161.81,1663.73
buyer_2,Carmen,Lozano,1984-09-05,01940193M,carmen.lozano@brilliantdata.site,257841,ES11209564797724896921,5500.05,2022-02-20T15:03:22,Zarautz,expenses,leisure,-62.98,1600.75
buyer_2,Carmen,Lozano,1984-09-05,01940193M,carmen.lozano@brilliantdata.site,257841,ES11209564797724896921,5500.05,2022-02-21T14:44:36,Zarautz,expenses,food,-108.51,1492.24
buyer_2,Carmen,Lozano,1984-09-05,01940193M,carmen.lozano@brilliantdata.site,257841,ES11209564797724896921,5500.05,2022-02-23T09:38:43,Zarautz,expenses,cash,-100.0,1392.24
buyer_2,Carmen,Lozano,1984-09-05,01940193M,carmen.lozano@brilliantdata.site,257841,ES11209564797724896921,5500.05,2022-02-26T10:08:47,Zarautz,expenses,healthcare,-38.96,1353.28
buyer_2,Carmen,Lozano,1984-09-05,01940193M,carmen.lozano@brilliantdata.site,257841,ES11209564797724896921,5500.05,2022-02-27T22:28:41,Zarautz,expenses,repairs,-165.1,1188.18
buyer_2,Carmen,Lozano,1984-09-05,01940193M,carmen.lozano@brilliantdata.site,257841,ES11209564797724896921,5500.05,2022-02-28T16:07:12,Zarautz,expenses,clothing,-51.63,1136.55
buyer_2,Carmen,Lozano,1984-09-05,01940193M,carmen.lozano@brilliantdata.site,257841,ES11209564797724896921,5500.05,2022-03-01T15:44:57,Zarautz,incomes,salary,1989.85,3126.4
buyer_2,Carmen,Lozano,1984-09-05,01940193M,carmen.lozano@brilliantdata.site,257841,ES11209564797724896921,5500.05,2022-03-01T15:44:57,Zarautz,incomes,extra_income,376.86,3503.26
buyer_2,Carmen,Lozano,1984-09-05,01940193M,carmen.lozano@brilliantdata.site,257841,ES11209564797724896921,5500.05,2022-03-01T12:14:37,Zarautz,expenses,food,-64.54,3438.72
buyer_2,Carmen,Lozano,1984-09-05,01940193M,carmen.lozano@brilliantdata.site,257841,ES11209564797724896921,5500.05,2022-03-04T16:09:12,Zarautz,expenses,mortgage,-888.96,2549.76
buyer_2,Carmen,Lozano,1984-09-05,01940193M,carmen.lozano@brilliantdata.site,257841,ES11209564797724896921,5500.05,2022-03-04T12:31:55,Zarautz,expenses,repairs,-331.71,2218.05
buyer_2,Carmen,Lozano,1984-09-05,01940193M,carmen.lozano@brilliantdata.site,257841,ES11209564797724896921,5500.05,2022-03-05T20:05:58,Zarautz,expenses,gas,-60.83,2157.22
buyer_2,Carmen,Lozano,1984-09-05,01940193M,carmen.lozano@brilliantdata.site,257841,ES11209564797724896921,5500.05,2022-03-05T15:28:26,Zarautz,expenses,internet,-41.79,2115.43
buyer_2,Carmen,Lozano,1984-09-05,01940193M,carmen.lozano@brilliantdata.site,257841,ES11209564797724896921,5500.05,2022-03-05T16:31:23,Zarautz,expenses,phone,-33.83,2081.6
buyer_2,Carmen,Lozano,1984-09-05,01940193M,carmen.lozano@brilliantdata.site,257841,ES11209564797724896921,5500.05,2022-03-06T09:50:29,Zarautz,expenses,leisure,-41.48,2040.12
buyer_2,Carmen,Lozano,1984-09-05,01940193M,carmen.lozano@brilliantdata.site,257841,ES11209564797724896921,5500.05,2022-03-07T22:21:37,Zarautz,expenses,cash,-100.0,1940.12
buyer_2,Carmen,Lozano,1984-09-05,01940193M,carmen.lozano@brilliantdata.site,257841,ES11209564797724896921,5500.05,2022-03-08T18:24:17,Zarautz,expenses,water,-42.36,1897.76
buyer_2,Carmen,Lozano,1984-09-05,01940193M,carmen.lozano@brilliantdata.site,257841,ES11209564797724896921,5500.05,2022-03-08T10:25:23,Zarautz,expenses,electricity,-38.55,1859.21
buyer_2,Carmen,Lozano,1984-09-05,01940193M,carmen.lozano@brilliantdata.site,257841,ES11209564797724896921,5500.05,2022-03-09T22:20:29,Zarautz,expenses,cash,-100.0,1759.21
buyer_2,Carmen,Lozano,1984-09-05,01940193M,carmen.lozano@brilliantdata.site,257841,ES11209564797724896921,5500.05,2022-03-09T09:00:51,Zarautz,expenses,repairs,-204.65,1554.56
buyer_2,Carmen,Lozano,1984-09-05,01940193M,carmen.lozano@brilliantdata.site,257841,ES11209564797724896921,5500.05,2022-03-12T08:30:46,Zarautz,expenses,cash,-100.0,1454.56
buyer_2,Carmen,Lozano,1984-09-05,01940193M,carmen.lozano@brilliantdata.site,257841,ES11209564797724896921,5500.05,2022-03-17T16:56:02,Zarautz,expenses,transport,-51.35,1403.21
buyer_2,Carmen,Lozano,1984-09-05,01940193M,carmen.lozano@brilliantdata.site,257841,ES11209564797724896921,5500.05,2022-03-17T00:57:33,Zarautz,expenses,cash,-100.0,1303.21
buyer_2,Carmen,Lozano,1984-09-05,01940193M,carmen.lozano@brilliantdata.site,257841,ES11209564797724896921,5500.05,2022-03-18T20:34:44,Zarautz,expenses,cash,-100.0,1203.21
buyer_2,Carmen,Lozano,1984-09-05,01940193M,carmen.lozano@brilliantdata.site,257841,ES11209564797724896921,5500.05,2022-03-18T17:55:57,Zarautz,expenses,repairs,-37.15,1166.06
buyer_2,Carmen,Lozano,1984-09-05,01940193M,carmen.lozano@brilliantdata.site,257841,ES11209564797724896921,5500.05,2022-03-18T17:39:25,Zarautz,expenses,gifts,-91.41,1074.65
buyer_2,Carmen,Lozano,1984-09-05,01940193M,carmen.lozano@brilliantdata.site,257841,ES11209564797724896921,5500.05,2022-03-20T19:02:52,Zarautz,expenses,food,-120.21,954.44
buyer_2,Carmen,Lozano,1984-09-05,01940193M,carmen.lozano@brilliantdata.site,257841,ES11209564797724896921,5500.05,2022-03-20T10:10:29,Zarautz,expenses,transport,-64.68,889.76
buyer_2,Carmen,Lozano,1984-09-05,01940193M,carmen.lozano@brilliantdata.site,257841,ES11209564797724896921,5500.05,2022-03-21T20:10:23,Zarautz,expenses,food,-88.48,801.28
buyer_2,Carmen,Lozano,1984-09-05,01940193M,carmen.lozano@brilliantdata.site,257841,ES11209564797724896921,5500.05,2022-03-22T13:57:42,Zarautz,expenses,appliances,-106.49,694.79
buyer_2,Carmen,Lozano,1984-09-05,01940193M,carmen.lozano@brilliantdata.site,257841,ES11209564797724896921,5500.05,2022-03-26T12:49:24,Zarautz,expenses,food,-118.68,576.11
buyer_2,Carmen,Lozano,1984-09-05,01940193M,carmen.lozano@brilliantdata.site,257841,ES11209564797724896921,5500.05,2022-03-27T20:45:41,Zarautz,expenses,leisure,-55.82,520.29
buyer_2,Carmen,Lozano,1984-09-05,01940193M,carmen.lozano@brilliantdata.site,257841,ES11209564797724896921,5500.05,2022-03-31T18:55:14,Zarautz,expenses,transport,-62.42,457.87
buyer_2,Carmen,Lozano,1984-09-05,01940193M,carmen.lozano@brilliantdata.site,257841,ES11209564797724896921,5500.05,2022-03-31T23:54:56,Zarautz,expenses,healthcare,-171.53,286.34
buyer_2,Carmen,Lozano,1984-09-05,01940193M,carmen.lozano@brilliantdata.site,257841,ES11209564797724896921,5500.05,2022-04-01T19:22:58,Zarautz,incomes,salary,1989.85,2276.19
buyer_2,Carmen,Lozano,1984-09-05,01940193M,carmen.lozano@brilliantdata.site,257841,ES11209564797724896921,5500.05,2022-04-01T17:07:18,Zarautz,expenses,leisure,-32.76,2243.43
buyer_2,Carmen,Lozano,1984-09-05,01940193M,carmen.lozano@brilliantdata.site,257841,ES11209564797724896921,5500.05,2022-04-01T21:59:30,Zarautz,expenses,cash,-100.0,2143.43
buyer_2,Carmen,Lozano,1984-09-05,01940193M,carmen.lozano@brilliantdata.site,257841,ES11209564797724896921,5500.05,2022-04-02T08:25:15,Zarautz,expenses,food,-120.5,2022.93
buyer_2,Carmen,Lozano,1984-09-05,01940193M,carmen.lozano@brilliantdata.site,257841,ES11209564797724896921,5500.05,2022-04-02T18:00:46,Zarautz,expenses,leisure,-52.87,1970.06
buyer_2,Carmen,Lozano,1984-09-05,01940193M,carmen.lozano@brilliantdata.site,257841,ES11209564797724896921,5500.05,2022-04-03T05:47:19,Zarautz,expenses,gifts,-74.93,1895.13
buyer_2,Carmen,Lozano,1984-09-05,01940193M,carmen.lozano@brilliantdata.site,257841,ES11209564797724896921,5500.05,2022-04-04T16:00:16,Zarautz,expenses,mortgage,-888.96,1006.17
buyer_2,Carmen,Lozano,1984-09-05,01940193M,carmen.lozano@brilliantdata.site,257841,ES11209564797724896921,5500.05,2022-04-05T21:27:36,Zarautz,expenses,gas,-112.56,893.61
buyer_2,Carmen,Lozano,1984-09-05,01940193M,carmen.lozano@brilliantdata.site,257841,ES11209564797724896921,5500.05,2022-04-05T08:42:02,Zarautz,expenses,transport,-76.97,816.64
buyer_2,Carmen,Lozano,1984-09-05,01940193M,carmen.lozano@brilliantdata.site,257841,ES11209564797724896921,5500.05,2022-04-06T16:47:29,Zarautz,expenses,cash,-100.0,716.64
buyer_2,Carmen,Lozano,1984-09-05,01940193M,carmen.lozano@brilliantdata.site,257841,ES11209564797724896921,5500.05,2022-04-07T15:30:03,Zarautz,expenses,water,-26.75,689.89
buyer_2,Carmen,Lozano,1984-09-05,01940193M,carmen.lozano@brilliantdata.site,257841,ES11209564797724896921,5500.05,2022-04-07T13:10:04,Zarautz,expenses,phone,-39.85,650.04
buyer_2,Carmen,Lozano,1984-09-05,01940193M,carmen.lozano@brilliantdata.site,257841,ES11209564797724896921,5500.05,2022-04-08T17:30:56,Zarautz,expenses,electricity,-38.51,611.53
buyer_2,Carmen,Lozano,1984-09-05,01940193M,carmen.lozano@brilliantdata.site,257841,ES11209564797724896921,5500.05,2022-04-08T09:21:28,Zarautz,expenses,internet,-41.79,569.74
buyer_2,Carmen,Lozano,1984-09-05,01940193M,carmen.lozano@brilliantdata.site,257841,ES11209564797724896921,5500.05,2022-04-08T17:24:53,Zarautz,expenses,transport,-46.32,523.42
buyer_2,Carmen,Lozano,1984-09-05,01940193M,carmen.lozano@brilliantdata.site,257841,ES11209564797724896921,5500.05,2022-04-08T15:32:57,Zarautz,expenses,education,-47.36,476.06
buyer_2,Carmen,Lozano,1984-09-05,01940193M,carmen.lozano@brilliantdata.site,257841,ES11209564797724896921,5500.05,2022-04-09T14:58:08,Zarautz,expenses,cash,-100.0,376.06
buyer_2,Carmen,Lozano,1984-09-05,01940193M,carmen.lozano@brilliantdata.site,257841,ES11209564797724896921,5500.05,2022-04-10T16:05:03,Zarautz,expenses,cash,-100.0,276.06
buyer_2,Carmen,Lozano,1984-09-05,01940193M,carmen.lozano@brilliantdata.site,257841,ES11209564797724896921,5500.05,2022-04-11T14:43:02,Zarautz,expenses,food,-63.21,212.85
buyer_2,Carmen,Lozano,1984-09-05,01940193M,carmen.lozano@brilliantdata.site,257841,ES11209564797724896921,5500.05,2022-04-11T10:27:00,Zarautz,expenses,transport,-64.22,148.63
buyer_2,Carmen,Lozano,1984-09-05,01940193M,carmen.lozano@brilliantdata.site,257841,ES11209564797724896921,5500.05,2022-04-11T04:34:23,Zarautz,expenses,education,-45.0,103.63
buyer_2,Carmen,Lozano,1984-09-05,01940193M,carmen.lozano@brilliantdata.site,257841,ES11209564797724896921,5500.05,2022-04-13T12:36:38,Zarautz,expenses,food,-101.7,1.93
buyer_2,Carmen,Lozano,1984-09-05,01940193M,carmen.lozano@brilliantdata.site,257841,ES11209564797724896921,5500.05,2022-04-13T22:20:10,Zarautz,expenses,education,-44.66,-42.73
buyer_2,Carmen,Lozano,1984-09-05,01940193M,carmen.lozano@brilliantdata.site,257841,ES11209564797724896921,5500.05,2022-04-14T03:09:59,Zarautz,expenses,food,-103.47,-146.2
buyer_2,Carmen,Lozano,1984-09-05,01940193M,carmen.lozano@brilliantdata.site,257841,ES11209564797724896921,5500.05,2022-04-15T17:27:19,Zarautz,expenses,food,-111.82,-258.02
buyer_2,Carmen,Lozano,1984-09-05,01940193M,carmen.lozano@brilliantdata.site,257841,ES11209564797724896921,5500.05,2022-04-16T18:44:27,Zarautz,expenses,repairs,-208.97,-466.99
buyer_2,Carmen,Lozano,1984-09-05,01940193M,carmen.lozano@brilliantdata.site,257841,ES11209564797724896921,5500.05,2022-04-18T04:31:58,Zarautz,expenses,education,-77.25,-544.24
buyer_2,Carmen,Lozano,1984-09-05,01940193M,carmen.lozano@brilliantdata.site,257841,ES11209564797724896921,5500.05,2022-04-18T14:46:34,Zarautz,expenses,appliances,-81.52,-625.76
buyer_2,Carmen,Lozano,1984-09-05,01940193M,carmen.lozano@brilliantdata.site,257841,ES11209564797724896921,5500.05,2022-04-19T21:29:46,Zarautz,expenses,food,-73.98,-699.74
buyer_2,Carmen,Lozano,1984-09-05,01940193M,carmen.lozano@brilliantdata.site,257841,ES11209564797724896921,5500.05,2022-04-20T09:02:46,Zarautz,expenses,travel,-530.61,-1230.35
buyer_2,Carmen,Lozano,1984-09-05,01940193M,carmen.lozano@brilliantdata.site,257841,ES11209564797724896921,5500.05,2022-04-21T10:52:39,Zarautz,expenses,leisure,-72.06,-1302.41
buyer_2,Carmen,Lozano,1984-09-05,01940193M,carmen.lozano@brilliantdata.site,257841,ES11209564797724896921,5500.05,2022-04-22T12:58:07,Zarautz,expenses,clothing,-118.61,-1421.02
buyer_2,Carmen,Lozano,1984-09-05,01940193M,carmen.lozano@brilliantdata.site,257841,ES11209564797724896921,5500.05,2022-04-23T12:41:09,Zarautz,expenses,education,-42.28,-1463.3
buyer_2,Carmen,Lozano,1984-09-05,01940193M,carmen.lozano@brilliantdata.site,257841,ES11209564797724896921,5500.05,2022-04-23T17:12:08,Zarautz,expenses,cash,-100.0,-1563.3
buyer_2,Carmen,Lozano,1984-09-05,01940193M,carmen.lozano@brilliantdata.site,257841,ES11209564797724896921,5500.05,2022-04-24T13:46:21,Zarautz,expenses,food,-93.91,-1657.21
buyer_2,Carmen,Lozano,1984-09-05,01940193M,carmen.lozano@brilliantdata.site,257841,ES11209564797724896921,5500.05,2022-04-24T03:42:15,Zarautz,expenses,education,-57.75,-1714.96
buyer_2,Carmen,Lozano,1984-09-05,01940193M,carmen.lozano@brilliantdata.site,257841,ES11209564797724896921,5500.05,2022-04-27T17:01:37,Zarautz,expenses,leisure,-50.84,-1765.8
buyer_2,Carmen,Lozano,1984-09-05,01940193M,carmen.lozano@brilliantdata.site,257841,ES11209564797724896921,5500.05,2022-04-27T12:01:57,Zarautz,expenses,education,-42.67,-1808.47
buyer_2,Carmen,Lozano,1984-09-05,01940193M,carmen.lozano@brilliantdata.site,257841,ES11209564797724896921,5500.05,2022-05-01T08:28:57,Zarautz,incomes,salary,1989.85,181.38
buyer_2,Carmen,Lozano,1984-09-05,01940193M,carmen.lozano@brilliantdata.site,257841,ES11209564797724896921,5500.05,2022-05-02T18:30:02,Zarautz,expenses,food,-67.16,114.22
buyer_2,Carmen,Lozano,1984-09-05,01940193M,carmen.lozano@brilliantdata.site,257841,ES11209564797724896921,5500.05,2022-05-04T10:24:39,Zarautz,expenses,mortgage,-888.96,-774.74
buyer_2,Carmen,Lozano,1984-09-05,01940193M,carmen.lozano@brilliantdata.site,257841,ES11209564797724896921,5500.05,2022-05-04T14:41:22,Zarautz,expenses,leisure,-32.54,-807.28
buyer_2,Carmen,Lozano,1984-09-05,01940193M,carmen.lozano@brilliantdata.site,257841,ES11209564797724896921,5500.05,2022-05-05T21:23:29,Zarautz,expenses,electricity,-85.48,-892.76
buyer_2,Carmen,Lozano,1984-09-05,01940193M,carmen.lozano@brilliantdata.site,257841,ES11209564797724896921,5500.05,2022-05-05T22:26:52,Zarautz,expenses,gas,-86.15,-978.91
buyer_2,Carmen,Lozano,1984-09-05,01940193M,carmen.lozano@brilliantdata.site,257841,ES11209564797724896921,5500.05,2022-05-06T16:18:11,Zarautz,expenses,cash,-100.0,-1078.91
buyer_2,Carmen,Lozano,1984-09-05,01940193M,carmen.lozano@brilliantdata.site,257841,ES11209564797724896921,5500.05,2022-05-07T03:35:29,Zarautz,expenses,internet,-41.79,-1120.7
buyer_2,Carmen,Lozano,1984-09-05,01940193M,carmen.lozano@brilliantdata.site,257841,ES11209564797724896921,5500.05,2022-05-07T14:35:53,Zarautz,expenses,education,-56.83,-1177.53
buyer_2,Carmen,Lozano,1984-09-05,01940193M,carmen.lozano@brilliantdata.site,257841,ES11209564797724896921,5500.05,2022-05-08T18:56:33,Zarautz,expenses,water,-39.16,-1216.69
buyer_2,Carmen,Lozano,1984-09-05,01940193M,carmen.lozano@brilliantdata.site,257841,ES11209564797724896921,5500.05,2022-05-08T13:14:12,Zarautz,expenses,phone,-32.49,-1249.18
buyer_2,Carmen,Lozano,1984-09-05,01940193M,carmen.lozano@brilliantdata.site,257841,ES11209564797724896921,5500.05,2022-05-08T08:31:52,Zarautz,expenses,cash,-100.0,-1349.18
buyer_2,Carmen,Lozano,1984-09-05,01940193M,carmen.lozano@brilliantdata.site,257841,ES11209564797724896921,5500.05,2022-05-10T19:32:50,Zarautz,expenses,cash,-100.0,-1449.18
buyer_2,Carmen,Lozano,1984-09-05,01940193M,carmen.lozano@brilliantdata.site,257841,ES11209564797724896921,5500.05,2022-05-12T15:19:43,Zarautz,expenses,cash,-100.0,-1549.18
buyer_2,Carmen,Lozano,1984-09-05,01940193M,carmen.lozano@brilliantdata.site,257841,ES11209564797724896921,5500.05,2022-05-13T16:44:47,Zarautz,expenses,leisure,-34.37,-1583.55
buyer_2,Carmen,Lozano,1984-09-05,01940193M,carmen.lozano@brilliantdata.site,257841,ES11209564797724896921,5500.05,2022-05-15T18:20:54,Zarautz,expenses,gifts,-558.57,-2142.12
buyer_2,Carmen,Lozano,1984-09-05,01940193M,carmen.lozano@brilliantdata.site,257841,ES11209564797724896921,5500.05,2022-05-17T19:56:11,Zarautz,expenses,leisure,-35.83,-2177.95
buyer_2,Carmen,Lozano,1984-09-05,01940193M,carmen.lozano@brilliantdata.site,257841,ES11209564797724896921,5500.05,2022-05-18T10:42:24,Zarautz,expenses,leisure,-19.35,-2197.3
buyer_2,Carmen,Lozano,1984-09-05,01940193M,carmen.lozano@brilliantdata.site,257841,ES11209564797724896921,5500.05,2022-05-18T09:20:37,Zarautz,expenses,cash,-100.0,-2297.3
buyer_2,Carmen,Lozano,1984-09-05,01940193M,carmen.lozano@brilliantdata.site,257841,ES11209564797724896921,5500.05,2022-05-18T12:51:11,Zarautz,expenses,repairs,-98.23,-2395.53
buyer_2,Carmen,Lozano,1984-09-05,01940193M,carmen.lozano@brilliantdata.site,257841,ES11209564797724896921,5500.05,2022-05-19T09:14:54,Zarautz,expenses,leisure,-41.27,-2436.8
buyer_2,Carmen,Lozano,1984-09-05,01940193M,carmen.lozano@brilliantdata.site,257841,ES11209564797724896921,5500.05,2022-05-21T19:27:16,Zarautz,expenses,education,-43.24,-2480.04
buyer_2,Carmen,Lozano,1984-09-05,01940193M,carmen.lozano@brilliantdata.site,257841,ES11209564797724896921,5500.05,2022-05-23T09:15:11,Zarautz,expenses,cash,-100.0,-2580.04
buyer_2,Carmen,Lozano,1984-09-05,01940193M,carmen.lozano@brilliantdata.site,257841,ES11209564797724896921,5500.05,2022-05-24T23:49:00,Zarautz,expenses,cash,-100.0,-2680.04
buyer_2,Carmen,Lozano,1984-09-05,01940193M,carmen.lozano@brilliantdata.site,257841,ES11209564797724896921,5500.05,2022-05-24T10:55:04,Zarautz,expenses,gifts,-311.94,-2991.98
buyer_2,Carmen,Lozano,1984-09-05,01940193M,carmen.lozano@brilliantdata.site,257841,ES11209564797724896921,5500.05,2022-05-25T20:50:05,Zarautz,expenses,transport,-43.09,-3035.07
buyer_2,Carmen,Lozano,1984-09-05,01940193M,carmen.lozano@brilliantdata.site,257841,ES11209564797724896921,5500.05,2022-05-25T17:56:14,Zarautz,expenses,repairs,-43.16,-3078.23
buyer_2,Carmen,Lozano,1984-09-05,01940193M,carmen.lozano@brilliantdata.site,257841,ES11209564797724896921,5500.05,2022-05-27T21:38:29,Zarautz,expenses,cash,-100.0,-3178.23
buyer_2,Carmen,Lozano,1984-09-05,01940193M,carmen.lozano@brilliantdata.site,257841,ES11209564797724896921,5500.05,2022-05-28T15:36:50,Zarautz,expenses,appliances,-233.52,-3411.75
buyer_2,Carmen,Lozano,1984-09-05,01940193M,carmen.lozano@brilliantdata.site,257841,ES11209564797724896921,5500.05,2022-05-29T14:23:01,Zarautz,expenses,repairs,-290.56,-3702.31
buyer_2,Carmen,Lozano,1984-09-05,01940193M,carmen.lozano@brilliantdata.site,257841,ES11209564797724896921,5500.05,2022-05-31T09:00:42,Zarautz,expenses,food,-95.16,-3797.47
buyer_2,Carmen,Lozano,1984-09-05,01940193M,carmen.lozano@brilliantdata.site,257841,ES11209564797724896921,5500.05,2022-06-01T17:59:08,Zarautz,incomes,salary,1989.85,-1807.62
buyer_2,Carmen,Lozano,1984-09-05,01940193M,carmen.lozano@brilliantdata.site,257841,ES11209564797724896921,5500.05,2022-06-01T17:59:08,Zarautz,incomes,salary_bonus,1566.71,-240.91
buyer_2,Carmen,Lozano,1984-09-05,01940193M,carmen.lozano@brilliantdata.site,257841,ES11209564797724896921,5500.05,2022-06-01T04:34:30,Zarautz,expenses,food,-63.61,-304.52
buyer_2,Carmen,Lozano,1984-09-05,01940193M,carmen.lozano@brilliantdata.site,257841,ES11209564797724896921,5500.05,2022-06-01T12:08:18,Zarautz,expenses,transport,-46.3,-350.82
buyer_2,Carmen,Lozano,1984-09-05,01940193M,carmen.lozano@brilliantdata.site,257841,ES11209564797724896921,5500.05,2022-06-03T08:34:47,Zarautz,expenses,leisure,-57.71,-408.53
buyer_2,Carmen,Lozano,1984-09-05,01940193M,carmen.lozano@brilliantdata.site,257841,ES11209564797724896921,5500.05,2022-06-04T17:52:14,Zarautz,expenses,mortgage,-888.96,-1297.49
buyer_2,Carmen,Lozano,1984-09-05,01940193M,carmen.lozano@brilliantdata.site,257841,ES11209564797724896921,5500.05,2022-06-04T20:22:05,Zarautz,expenses,transport,-64.59,-1362.08
buyer_2,Carmen,Lozano,1984-09-05,01940193M,carmen.lozano@brilliantdata.site,257841,ES11209564797724896921,5500.05,2022-06-04T01:59:38,Zarautz,expenses,clothing,-137.77,-1499.85
buyer_2,Carmen,Lozano,1984-09-05,01940193M,carmen.lozano@brilliantdata.site,257841,ES11209564797724896921,5500.05,2022-06-04T02:57:03,Zarautz,expenses,children,-583.7696666666666,-2083.62
buyer_2,Carmen,Lozano,1984-09-05,01940193M,carmen.lozano@brilliantdata.site,257841,ES11209564797724896921,5500.05,2022-06-05T08:53:43,Zarautz,expenses,gas,-97.35,-2180.97
buyer_2,Carmen,Lozano,1984-09-05,01940193M,carmen.lozano@brilliantdata.site,257841,ES11209564797724896921,5500.05,2022-06-05T11:58:11,Zarautz,expenses,food,-124.68,-2305.65
buyer_2,Carmen,Lozano,1984-09-05,01940193M,carmen.lozano@brilliantdata.site,257841,ES11209564797724896921,5500.05,2022-06-05T13:11:05,Zarautz,expenses,leisure,-23.2,-2328.85
buyer_2,Carmen,Lozano,1984-09-05,01940193M,carmen.lozano@brilliantdata.site,257841,ES11209564797724896921,5500.05,2022-06-06T04:05:10,Zarautz,expenses,water,-37.39,-2366.24
buyer_2,Carmen,Lozano,1984-09-05,01940193M,carmen.lozano@brilliantdata.site,257841,ES11209564797724896921,5500.05,2022-06-06T14:33:54,Zarautz,expenses,phone,-39.71,-2405.95
buyer_2,Carmen,Lozano,1984-09-05,01940193M,carmen.lozano@brilliantdata.site,257841,ES11209564797724896921,5500.05,2022-06-06T12:53:57,Zarautz,expenses,clothing,-134.94,-2540.89
buyer_2,Carmen,Lozano,1984-09-05,01940193M,carmen.lozano@brilliantdata.site,257841,ES11209564797724896921,5500.05,2022-06-07T14:32:39,Zarautz,expenses,children,-569.37,-3110.26
buyer_2,Carmen,Lozano,1984-09-05,01940193M,carmen.lozano@brilliantdata.site,257841,ES11209564797724896921,5500.05,2022-06-08T21:35:04,Zarautz,expenses,electricity,-80.61,-3190.87
buyer_2,Carmen,Lozano,1984-09-05,01940193M,carmen.lozano@brilliantdata.site,257841,ES11209564797724896921,5500.05,2022-06-08T19:00:04,Zarautz,expenses,internet,-41.79,-3232.66
buyer_2,Carmen,Lozano,1984-09-05,01940193M,carmen.lozano@brilliantdata.site,257841,ES11209564797724896921,5500.05,2022-06-09T22:51:03,Zarautz,expenses,clothing,-149.95,-3382.61
buyer_2,Carmen,Lozano,1984-09-05,01940193M,carmen.lozano@brilliantdata.site,257841,ES11209564797724896921,5500.05,2022-06-09T23:12:21,Zarautz,expenses,education,-71.72,-3454.33
buyer_2,Carmen,Lozano,1984-09-05,01940193M,carmen.lozano@brilliantdata.site,257841,ES11209564797724896921,5500.05,2022-06-09T20:42:23,Zarautz,expenses,cash,-100.0,-3554.33
buyer_2,Carmen,Lozano,1984-09-05,01940193M,carmen.lozano@brilliantdata.site,257841,ES11209564797724896921,5500.05,2022-06-10T23:16:47,Zarautz,expenses,leisure,-70.64,-3624.97
buyer_2,Carmen,Lozano,1984-09-05,01940193M,carmen.lozano@brilliantdata.site,257841,ES11209564797724896921,5500.05,2022-06-10T13:59:43,Zarautz,expenses,cash,-100.0,-3724.97
buyer_2,Carmen,Lozano,1984-09-05,01940193M,carmen.lozano@brilliantdata.site,257841,ES11209564797724896921,5500.05,2022-06-11T07:12:55,Zarautz,expenses,food,-71.63,-3796.6
buyer_2,Carmen,Lozano,1984-09-05,01940193M,carmen.lozano@brilliantdata.site,257841,ES11209564797724896921,5500.05,2022-06-12T12:34:00,Zarautz,expenses,clothing,-96.3,-3892.9
buyer_2,Carmen,Lozano,1984-09-05,01940193M,carmen.lozano@brilliantdata.site,257841,ES11209564797724896921,5500.05,2022-06-15T19:01:58,Zarautz,expenses,transport,-55.13,-3948.03
buyer_2,Carmen,Lozano,1984-09-05,01940193M,carmen.lozano@brilliantdata.site,257841,ES11209564797724896921,5500.05,2022-06-16T23:40:34,Zarautz,expenses,cash,-100.0,-4048.03
buyer_2,Carmen,Lozano,1984-09-05,01940193M,carmen.lozano@brilliantdata.site,257841,ES11209564797724896921,5500.05,2022-06-17T17:58:44,Zarautz,expenses,leisure,-38.41,-4086.44
buyer_2,Carmen,Lozano,1984-09-05,01940193M,carmen.lozano@brilliantdata.site,257841,ES11209564797724896921,5500.05,2022-06-17T13:05:33,Zarautz,expenses,cash,-100.0,-4186.44
buyer_2,Carmen,Lozano,1984-09-05,01940193M,carmen.lozano@brilliantdata.site,257841,ES11209564797724896921,5500.05,2022-06-19T11:54:43,Zarautz,expenses,cash,-100.0,-4286.44
buyer_2,Carmen,Lozano,1984-09-05,01940193M,carmen.lozano@brilliantdata.site,257841,ES11209564797724896921,5500.05,2022-06-20T09:48:57,Zarautz,expenses,leisure,-60.5,-4346.94
buyer_2,Carmen,Lozano,1984-09-05,01940193M,carmen.lozano@brilliantdata.site,257841,ES11209564797724896921,5500.05,2022-06-23T14:53:26,Zarautz,expenses,education,-52.91,-4399.85
buyer_2,Carmen,Lozano,1984-09-05,01940193M,carmen.lozano@brilliantdata.site,257841,ES11209564797724896921,5500.05,2022-06-24T19:50:49,Zarautz,expenses,cash,-100.0,-4499.85
buyer_2,Carmen,Lozano,1984-09-05,01940193M,carmen.lozano@brilliantdata.site,257841,ES11209564797724896921,5500.05,2022-06-24T13:35:28,Zarautz,expenses,gifts,-195.91,-4695.76
buyer_2,Carmen,Lozano,1984-09-05,01940193M,carmen.lozano@brilliantdata.site,257841,ES11209564797724896921,5500.05,2022-06-25T10:28:16,Zarautz,expenses,food,-105.97,-4801.73
buyer_2,Carmen,Lozano,1984-09-05,01940193M,carmen.lozano@brilliantdata.site,257841,ES11209564797724896921,5500.05,2022-06-25T21:48:06,Zarautz,expenses,education,-61.43,-4863.16
buyer_2,Carmen,Lozano,1984-09-05,01940193M,carmen.lozano@brilliantdata.site,257841,ES11209564797724896921,5500.05,2022-06-26T14:10:10,Zarautz,expenses,cash,-100.0,-4963.16
buyer_2,Carmen,Lozano,1984-09-05,01940193M,carmen.lozano@brilliantdata.site,257841,ES11209564797724896921,5500.05,2022-06-26T12:26:25,Zarautz,expenses,repairs,-324.47,-5287.63
buyer_2,Carmen,Lozano,1984-09-05,01940193M,carmen.lozano@brilliantdata.site,257841,ES11209564797724896921,5500.05,2022-06-28T13:37:44,Zarautz,expenses,food,-86.66,-5374.29
buyer_2,Carmen,Lozano,1984-09-05,01940193M,carmen.lozano@brilliantdata.site,257841,ES11209564797724896921,5500.05,2022-06-30T10:53:28,Zarautz,expenses,appliances,-317.18,-5691.47
buyer_2,Carmen,Lozano,1984-09-05,01940193M,carmen.lozano@brilliantdata.site,257841,ES11209564797724896921,5500.05,2022-07-01T17:34:39,Zarautz,incomes,salary,1989.85,-3701.62
buyer_2,Carmen,Lozano,1984-09-05,01940193M,carmen.lozano@brilliantdata.site,257841,ES11209564797724896921,5500.05,2022-07-01T17:34:39,Zarautz,incomes,extra_income,376.86,-3324.76
buyer_2,Carmen,Lozano,1984-09-05,01940193M,carmen.lozano@brilliantdata.site,257841,ES11209564797724896921,5500.05,2022-07-01T14:09:25,Zarautz,expenses,education,-49.49,-3374.25
buyer_2,Carmen,Lozano,1984-09-05,01940193M,carmen.lozano@brilliantdata.site,257841,ES11209564797724896921,5500.05,2022-07-02T14:50:27,Zarautz,expenses,transport,-84.11,-3458.36
buyer_2,Carmen,Lozano,1984-09-05,01940193M,carmen.lozano@brilliantdata.site,257841,ES11209564797724896921,5500.05,2022-07-03T08:49:53,Zarautz,expenses,transport,-62.44,-3520.8
buyer_2,Carmen,Lozano,1984-09-05,01940193M,carmen.lozano@brilliantdata.site,257841,ES11209564797724896921,5500.05,2022-07-03T20:21:22,Zarautz,expenses,children,-254.1,-3774.9
buyer_2,Carmen,Lozano,1984-09-05,01940193M,carmen.lozano@brilliantdata.site,257841,ES11209564797724896921,5500.05,2022-07-04T21:28:31,Zarautz,expenses,mortgage,-888.96,-4663.86
buyer_2,Carmen,Lozano,1984-09-05,01940193M,carmen.lozano@brilliantdata.site,257841,ES11209564797724896921,5500.05,2022-07-04T18:16:55,Zarautz,expenses,leisure,-57.06,-4720.92
buyer_2,Carmen,Lozano,1984-09-05,01940193M,carmen.lozano@brilliantdata.site,257841,ES11209564797724896921,5500.05,2022-07-05T10:10:21,Zarautz,expenses,cash,-100.0,-4820.92
buyer_2,Carmen,Lozano,1984-09-05,01940193M,carmen.lozano@brilliantdata.site,257841,ES11209564797724896921,5500.05,2022-07-06T10:22:33,Zarautz,expenses,water,-29.15,-4850.07
buyer_2,Carmen,Lozano,1984-09-05,01940193M,carmen.lozano@brilliantdata.site,257841,ES11209564797724896921,5500.05,2022-07-06T02:12:30,Zarautz,expenses,gas,-105.23,-4955.3
buyer_2,Carmen,Lozano,1984-09-05,01940193M,carmen.lozano@brilliantdata.site,257841,ES11209564797724896921,5500.05,2022-07-06T12:52:27,Zarautz,expenses,children,-535.21,-5490.51
buyer_2,Carmen,Lozano,1984-09-05,01940193M,carmen.lozano@brilliantdata.site,257841,ES11209564797724896921,5500.05,2022-07-07T10:47:13,Zarautz,expenses,internet,-41.79,-5532.3
buyer_2,Carmen,Lozano,1984-09-05,01940193M,carmen.lozano@brilliantdata.site,257841,ES11209564797724896921,5500.05,2022-07-07T02:29:50,Zarautz,expenses,gifts,-421.99,-5954.29
buyer_2,Carmen,Lozano,1984-09-05,01940193M,carmen.lozano@brilliantdata.site,257841,ES11209564797724896921,5500.05,2022-07-08T11:19:05,Zarautz,expenses,electricity,-81.43,-6035.72
buyer_2,Carmen,Lozano,1984-09-05,01940193M,carmen.lozano@brilliantdata.site,257841,ES11209564797724896921,5500.05,2022-07-08T08:50:24,Zarautz,expenses,phone,-40.97,-6076.69
buyer_2,Carmen,Lozano,1984-09-05,01940193M,carmen.lozano@brilliantdata.site,257841,ES11209564797724896921,5500.05,2022-07-10T09:15:38,Zarautz,expenses,healthcare,-179.36,-6256.05
buyer_2,Carmen,Lozano,1984-09-05,01940193M,carmen.lozano@brilliantdata.site,257841,ES11209564797724896921,5500.05,2022-07-10T06:59:40,Zarautz,expenses,education,-55.34,-6311.39
buyer_2,Carmen,Lozano,1984-09-05,01940193M,carmen.lozano@brilliantdata.site,257841,ES11209564797724896921,5500.05,2022-07-10T13:15:47,Zarautz,expenses,cash,-100.0,-6411.39
buyer_2,Carmen,Lozano,1984-09-05,01940193M,carmen.lozano@brilliantdata.site,257841,ES11209564797724896921,5500.05,2022-07-11T07:46:01,Zarautz,expenses,cash,-100.0,-6511.39
buyer_2,Carmen,Lozano,1984-09-05,01940193M,carmen.lozano@brilliantdata.site,257841,ES11209564797724896921,5500.05,2022-07-13T12:46:39,Zarautz,expenses,cash,-100.0,-6611.39
buyer_2,Carmen,Lozano,1984-09-05,01940193M,carmen.lozano@brilliantdata.site,257841,ES11209564797724896921,5500.05,2022-07-14T08:48:21,Zarautz,expenses,transport,-68.38,-6679.77
buyer_2,Carmen,Lozano,1984-09-05,01940193M,carmen.lozano@brilliantdata.site,257841,ES11209564797724896921,5500.05,2022-07-14T19:24:37,Zarautz,expenses,cash,-100.0,-6779.77
buyer_2,Carmen,Lozano,1984-09-05,01940193M,carmen.lozano@brilliantdata.site,257841,ES11209564797724896921,5500.05,2022-07-16T08:33:40,Zarautz,expenses,food,-105.11,-6884.88
buyer_2,Carmen,Lozano,1984-09-05,01940193M,carmen.lozano@brilliantdata.site,257841,ES11209564797724896921,5500.05,2022-07-16T14:18:10,Zarautz,expenses,leisure,-78.36,-6963.24
buyer_2,Carmen,Lozano,1984-09-05,01940193M,carmen.lozano@brilliantdata.site,257841,ES11209564797724896921,5500.05,2022-07-16T00:47:21,Zarautz,expenses,education,-73.85,-7037.09
buyer_2,Carmen,Lozano,1984-09-05,01940193M,carmen.lozano@brilliantdata.site,257841,ES11209564797724896921,5500.05,2022-07-17T12:53:44,Zarautz,expenses,transport,-53.97,-7091.06
buyer_2,Carmen,Lozano,1984-09-05,01940193M,carmen.lozano@brilliantdata.site,257841,ES11209564797724896921,5500.05,2022-07-17T21:44:36,Zarautz,expenses,travel,-343.81,-7434.87
buyer_2,Carmen,Lozano,1984-09-05,01940193M,carmen.lozano@brilliantdata.site,257841,ES11209564797724896921,5500.05,2022-07-18T17:46:19,Zarautz,expenses,transport,-75.69,-7510.56
buyer_2,Carmen,Lozano,1984-09-05,01940193M,carmen.lozano@brilliantdata.site,257841,ES11209564797724896921,5500.05,2022-07-19T19:45:39,Zarautz,expenses,transport,-52.67,-7563.23
buyer_2,Carmen,Lozano,1984-09-05,01940193M,carmen.lozano@brilliantdata.site,257841,ES11209564797724896921,5500.05,2022-07-20T21:13:13,Zarautz,expenses,leisure,-40.2,-7603.43
buyer_2,Carmen,Lozano,1984-09-05,01940193M,carmen.lozano@brilliantdata.site,257841,ES11209564797724896921,5500.05,2022-07-22T21:12:29,Zarautz,expenses,leisure,-27.69,-7631.12
buyer_2,Carmen,Lozano,1984-09-05,01940193M,carmen.lozano@brilliantdata.site,257841,ES11209564797724896921,5500.05,2022-07-22T16:31:42,Zarautz,expenses,clothing,-78.23,-7709.35
buyer_2,Carmen,Lozano,1984-09-05,01940193M,carmen.lozano@brilliantdata.site,257841,ES11209564797724896921,5500.05,2022-07-22T18:38:49,Zarautz,expenses,cash,-100.0,-7809.35
buyer_2,Carmen,Lozano,1984-09-05,01940193M,carmen.lozano@brilliantdata.site,257841,ES11209564797724896921,5500.05,2022-07-24T14:54:40,Zarautz,expenses,food,-95.51,-7904.86
buyer_2,Carmen,Lozano,1984-09-05,01940193M,carmen.lozano@brilliantdata.site,257841,ES11209564797724896921,5500.05,2022-07-24T09:25:15,Zarautz,expenses,transport,-64.39,-7969.25
buyer_2,Carmen,Lozano,1984-09-05,01940193M,carmen.lozano@brilliantdata.site,257841,ES11209564797724896921,5500.05,2022-07-26T14:05:49,Zarautz,expenses,transport,-41.96,-8011.21
buyer_2,Carmen,Lozano,1984-09-05,01940193M,carmen.lozano@brilliantdata.site,257841,ES11209564797724896921,5500.05,2022-07-26T16:26:10,Zarautz,expenses,children,-229.06,-8240.27
buyer_2,Carmen,Lozano,1984-09-05,01940193M,carmen.lozano@brilliantdata.site,257841,ES11209564797724896921,5500.05,2022-07-27T23:33:19,Zarautz,expenses,transport,-59.32,-8299.59
buyer_2,Carmen,Lozano,1984-09-05,01940193M,carmen.lozano@brilliantdata.site,257841,ES11209564797724896921,5500.05,2022-07-28T16:18:18,Zarautz,expenses,cash,-100.0,-8399.59
buyer_2,Carmen,Lozano,1984-09-05,01940193M,carmen.lozano@brilliantdata.site,257841,ES11209564797724896921,5500.05,2022-07-29T14:21:36,Zarautz,expenses,children,-518.26,-8917.85
buyer_2,Carmen,Lozano,1984-09-05,01940193M,carmen.lozano@brilliantdata.site,257841,ES11209564797724896921,5500.05,2022-07-30T13:52:03,Zarautz,expenses,cash,-100.0,-9017.85
buyer_2,Carmen,Lozano,1984-09-05,01940193M,carmen.lozano@brilliantdata.site,257841,ES11209564797724896921,5500.05,2022-08-01T18:17:44,Zarautz,incomes,salary,1989.85,-7028.0
buyer_2,Carmen,Lozano,1984-09-05,01940193M,carmen.lozano@brilliantdata.site,257841,ES11209564797724896921,5500.05,2022-08-02T11:31:20,Zarautz,expenses,education,-63.73,-7091.73
buyer_2,Carmen,Lozano,1984-09-05,01940193M,carmen.lozano@brilliantdata.site,257841,ES11209564797724896921,5500.05,2022-08-04T12:22:54,Zarautz,expenses,mortgage,-888.96,-7980.69
buyer_2,Carmen,Lozano,1984-09-05,01940193M,carmen.lozano@brilliantdata.site,257841,ES11209564797724896921,5500.05,2022-08-04T18:14:08,Zarautz,expenses,appliances,-333.47,-8314.16
buyer_2,Carmen,Lozano,1984-09-05,01940193M,carmen.lozano@brilliantdata.site,257841,ES11209564797724896921,5500.05,2022-08-06T18:04:09,Zarautz,expenses,gas,-40.69,-8354.85
buyer_2,Carmen,Lozano,1984-09-05,01940193M,carmen.lozano@brilliantdata.site,257841,ES11209564797724896921,5500.05,2022-08-06T21:39:36,Zarautz,expenses,transport,-66.25,-8421.1
buyer_2,Carmen,Lozano,1984-09-05,01940193M,carmen.lozano@brilliantdata.site,257841,ES11209564797724896921,5500.05,2022-08-07T00:08:20,Zarautz,expenses,water,-41.99,-8463.09
buyer_2,Carmen,Lozano,1984-09-05,01940193M,carmen.lozano@brilliantdata.site,257841,ES11209564797724896921,5500.05,2022-08-07T12:41:20,Zarautz,expenses,leisure,-83.96,-8547.05
buyer_2,Carmen,Lozano,1984-09-05,01940193M,carmen.lozano@brilliantdata.site,257841,ES11209564797724896921,5500.05,2022-08-07T13:27:37,Zarautz,expenses,cash,-100.0,-8647.05
buyer_2,Carmen,Lozano,1984-09-05,01940193M,carmen.lozano@brilliantdata.site,257841,ES11209564797724896921,5500.05,2022-08-08T19:19:43,Zarautz,expenses,internet,-41.79,-8688.84
buyer_2,Carmen,Lozano,1984-09-05,01940193M,carmen.lozano@brilliantdata.site,257841,ES11209564797724896921,5500.05,2022-08-08T19:54:00,Zarautz,expenses,electricity,-57.43,-8746.27
buyer_2,Carmen,Lozano,1984-09-05,01940193M,carmen.lozano@brilliantdata.site,257841,ES11209564797724896921,5500.05,2022-08-08T18:18:10,Zarautz,expenses,phone,-44.33,-8790.6
buyer_2,Carmen,Lozano,1984-09-05,01940193M,carmen.lozano@brilliantdata.site,257841,ES11209564797724896921,5500.05,2022-08-09T09:15:48,Zarautz,expenses,food,-97.66,-8888.26
buyer_2,Carmen,Lozano,1984-09-05,01940193M,carmen.lozano@brilliantdata.site,257841,ES11209564797724896921,5500.05,2022-08-09T10:50:58,Zarautz,expenses,healthcare,-153.96,-9042.22
buyer_2,Carmen,Lozano,1984-09-05,01940193M,carmen.lozano@brilliantdata.site,257841,ES11209564797724896921,5500.05,2022-08-10T19:19:32,Zarautz,expenses,healthcare,-181.95,-9224.17
buyer_2,Carmen,Lozano,1984-09-05,01940193M,carmen.lozano@brilliantdata.site,257841,ES11209564797724896921,5500.05,2022-08-11T15:42:11,Zarautz,expenses,clothing,-75.56,-9299.73
buyer_2,Carmen,Lozano,1984-09-05,01940193M,carmen.lozano@brilliantdata.site,257841,ES11209564797724896921,5500.05,2022-08-11T17:25:33,Zarautz,expenses,travel,-676.24,-9975.97
buyer_2,Carmen,Lozano,1984-09-05,01940193M,carmen.lozano@brilliantdata.site,257841,ES11209564797724896921,5500.05,2022-08-12T15:46:11,Zarautz,expenses,food,-75.82,-10051.79
buyer_2,Carmen,Lozano,1984-09-05,01940193M,carmen.lozano@brilliantdata.site,257841,ES11209564797724896921,5500.05,2022-08-13T10:36:34,Zarautz,expenses,food,-88.93,-10140.72
buyer_2,Carmen,Lozano,1984-09-05,01940193M,carmen.lozano@brilliantdata.site,257841,ES11209564797724896921,5500.05,2022-08-13T08:15:01,Zarautz,expenses,transport,-60.46,-10201.18
buyer_2,Carmen,Lozano,1984-09-05,01940193M,carmen.lozano@brilliantdata.site,257841,ES11209564797724896921,5500.05,2022-08-14T11:00:27,Zarautz,expenses,travel,-297.9,-10499.08
buyer_2,Carmen,Lozano,1984-09-05,01940193M,carmen.lozano@brilliantdata.site,257841,ES11209564797724896921,5500.05,2022-08-18T12:21:55,Zarautz,expenses,children,-504.01,-11003.09
buyer_2,Carmen,Lozano,1984-09-05,01940193M,carmen.lozano@brilliantdata.site,257841,ES11209564797724896921,5500.05,2022-08-19T09:22:09,Zarautz,expenses,cash,-100.0,-11103.09
buyer_2,Carmen,Lozano,1984-09-05,01940193M,carmen.lozano@brilliantdata.site,257841,ES11209564797724896921,5500.05,2022-08-20T13:22:47,Zarautz,expenses,transport,-42.27,-11145.36
buyer_2,Carmen,Lozano,1984-09-05,01940193M,carmen.lozano@brilliantdata.site,257841,ES11209564797724896921,5500.05,2022-08-20T11:50:13,Zarautz,expenses,cash,-100.0,-11245.36
buyer_2,Carmen,Lozano,1984-09-05,01940193M,carmen.lozano@brilliantdata.site,257841,ES11209564797724896921,5500.05,2022-08-20T20:14:52,Zarautz,expenses,gifts,-455.61,-11700.97
buyer_2,Carmen,Lozano,1984-09-05,01940193M,carmen.lozano@brilliantdata.site,257841,ES11209564797724896921,5500.05,2022-08-23T17:32:56,Zarautz,expenses,children,-448.94,-12149.91
buyer_2,Carmen,Lozano,1984-09-05,01940193M,carmen.lozano@brilliantdata.site,257841,ES11209564797724896921,5500.05,2022-08-24T17:58:41,Zarautz,expenses,cash,-100.0,-12249.91
buyer_2,Carmen,Lozano,1984-09-05,01940193M,carmen.lozano@brilliantdata.site,257841,ES11209564797724896921,5500.05,2022-08-25T11:06:07,Zarautz,expenses,repairs,-293.96,-12543.87
buyer_2,Carmen,Lozano,1984-09-05,01940193M,carmen.lozano@brilliantdata.site,257841,ES11209564797724896921,5500.05,2022-08-26T17:28:19,Zarautz,expenses,leisure,-60.92,-12604.79
buyer_2,Carmen,Lozano,1984-09-05,01940193M,carmen.lozano@brilliantdata.site,257841,ES11209564797724896921,5500.05,2022-08-26T13:21:24,Zarautz,expenses,cash,-100.0,-12704.79
buyer_2,Carmen,Lozano,1984-09-05,01940193M,carmen.lozano@brilliantdata.site,257841,ES11209564797724896921,5500.05,2022-08-28T22:48:15,Zarautz,expenses,food,-107.5,-12812.29
buyer_2,Carmen,Lozano,1984-09-05,01940193M,carmen.lozano@brilliantdata.site,257841,ES11209564797724896921,5500.05,2022-08-28T11:35:32,Zarautz,expenses,children,-388.36,-13200.65
buyer_2,Carmen,Lozano,1984-09-05,01940193M,carmen.lozano@brilliantdata.site,257841,ES11209564797724896921,5500.05,2022-08-29T10:11:03,Zarautz,expenses,food,-96.75,-13297.4
buyer_2,Carmen,Lozano,1984-09-05,01940193M,carmen.lozano@brilliantdata.site,257841,ES11209564797724896921,5500.05,2022-08-30T11:35:40,Zarautz,expenses,clothing,-67.09,-13364.49
buyer_2,Carmen,Lozano,1984-09-05,01940193M,carmen.lozano@brilliantdata.site,257841,ES11209564797724896921,5500.05,2022-08-30T22:05:43,Zarautz,expenses,cash,-100.0,-13464.49
buyer_2,Carmen,Lozano,1984-09-05,01940193M,carmen.lozano@brilliantdata.site,257841,ES11209564797724896921,5500.05,2022-08-31T20:09:54,Zarautz,expenses,children,-785.36,-14249.85
buyer_2,Carmen,Lozano,1984-09-05,01940193M,carmen.lozano@brilliantdata.site,257841,ES11209564797724896921,5500.05,2022-09-01T18:33:35,Zarautz,incomes,salary,1989.85,-12260.0
buyer_2,Carmen,Lozano,1984-09-05,01940193M,carmen.lozano@brilliantdata.site,257841,ES11209564797724896921,5500.05,2022-09-02T11:18:55,Zarautz,expenses,cash,-100.0,-12360.0
buyer_2,Carmen,Lozano,1984-09-05,01940193M,carmen.lozano@brilliantdata.site,257841,ES11209564797724896921,5500.05,2022-09-03T06:01:51,Zarautz,expenses,cash,-100.0,-12460.0
buyer_2,Carmen,Lozano,1984-09-05,01940193M,carmen.lozano@brilliantdata.site,257841,ES11209564797724896921,5500.05,2022-09-03T14:58:41,Zarautz,expenses,gifts,-624.82,-13084.82
buyer_2,Carmen,Lozano,1984-09-05,01940193M,carmen.lozano@brilliantdata.site,257841,ES11209564797724896921,5500.05,2022-09-04T20:10:25,Zarautz,expenses,mortgage,-888.96,-13973.78
buyer_2,Carmen,Lozano,1984-09-05,01940193M,carmen.lozano@brilliantdata.site,257841,ES11209564797724896921,5500.05,2022-09-04T01:57:35,Zarautz,expenses,cash,-100.0,-14073.78
buyer_2,Carmen,Lozano,1984-09-05,01940193M,carmen.lozano@brilliantdata.site,257841,ES11209564797724896921,5500.05,2022-09-05T19:09:40,Zarautz,expenses,water,-40.9,-14114.68
buyer_2,Carmen,Lozano,1984-09-05,01940193M,carmen.lozano@brilliantdata.site,257841,ES11209564797724896921,5500.05,2022-09-05T23:33:22,Zarautz,expenses,electricity,-36.41,-14151.09
buyer_2,Carmen,Lozano,1984-09-05,01940193M,carmen.lozano@brilliantdata.site,257841,ES11209564797724896921,5500.05,2022-09-05T08:18:33,Zarautz,expenses,internet,-41.79,-14192.88
buyer_2,Carmen,Lozano,1984-09-05,01940193M,carmen.lozano@brilliantdata.site,257841,ES11209564797724896921,5500.05,2022-09-05T04:56:20,Zarautz,expenses,phone,-30.91,-14223.79
buyer_2,Carmen,Lozano,1984-09-05,01940193M,carmen.lozano@brilliantdata.site,257841,ES11209564797724896921,5500.05,2022-09-05T08:49:53,Zarautz,expenses,cash,-100.0,-14323.79
buyer_2,Carmen,Lozano,1984-09-05,01940193M,carmen.lozano@brilliantdata.site,257841,ES11209564797724896921,5500.05,2022-09-06T16:04:59,Zarautz,expenses,gas,-103.9,-14427.69
buyer_2,Carmen,Lozano,1984-09-05,01940193M,carmen.lozano@brilliantdata.site,257841,ES11209564797724896921,5500.05,2022-09-07T19:23:53,Zarautz,expenses,food,-122.57,-14550.26
buyer_2,Carmen,Lozano,1984-09-05,01940193M,carmen.lozano@brilliantdata.site,257841,ES11209564797724896921,5500.05,2022-09-07T11:51:36,Zarautz,expenses,leisure,-57.39,-14607.65
buyer_2,Carmen,Lozano,1984-09-05,01940193M,carmen.lozano@brilliantdata.site,257841,ES11209564797724896921,5500.05,2022-09-07T22:40:07,Zarautz,expenses,education,-66.88,-14674.53
buyer_2,Carmen,Lozano,1984-09-05,01940193M,carmen.lozano@brilliantdata.site,257841,ES11209564797724896921,5500.05,2022-09-07T10:20:01,Zarautz,expenses,gifts,-176.42,-14850.95
buyer_2,Carmen,Lozano,1984-09-05,01940193M,carmen.lozano@brilliantdata.site,257841,ES11209564797724896921,5500.05,2022-09-08T18:53:06,Zarautz,expenses,leisure,-44.65,-14895.6
buyer_2,Carmen,Lozano,1984-09-05,01940193M,carmen.lozano@brilliantdata.site,257841,ES11209564797724896921,5500.05,2022-09-08T13:19:49,Zarautz,expenses,education,-57.88,-14953.48
buyer_2,Carmen,Lozano,1984-09-05,01940193M,carmen.lozano@brilliantdata.site,257841,ES11209564797724896921,5500.05,2022-09-09T21:02:23,Zarautz,expenses,food,-102.96,-15056.44
buyer_2,Carmen,Lozano,1984-09-05,01940193M,carmen.lozano@brilliantdata.site,257841,ES11209564797724896921,5500.05,2022-09-09T12:59:27,Zarautz,expenses,children,-342.21,-15398.65
buyer_2,Carmen,Lozano,1984-09-05,01940193M,carmen.lozano@brilliantdata.site,257841,ES11209564797724896921,5500.05,2022-09-11T10:08:40,Zarautz,expenses,transport,-56.15,-15454.8
buyer_2,Carmen,Lozano,1984-09-05,01940193M,carmen.lozano@brilliantdata.site,257841,ES11209564797724896921,5500.05,2022-09-12T18:20:42,Zarautz,expenses,transport,-52.86,-15507.66
buyer_2,Carmen,Lozano,1984-09-05,01940193M,carmen.lozano@brilliantdata.site,257841,ES11209564797724896921,5500.05,2022-09-12T11:59:21,Zarautz,expenses,clothing,-122.95,-15630.61
buyer_2,Carmen,Lozano,1984-09-05,01940193M,carmen.lozano@brilliantdata.site,257841,ES11209564797724896921,5500.05,2022-09-13T16:37:15,Zarautz,expenses,gifts,-741.37,-16371.98
buyer_2,Carmen,Lozano,1984-09-05,01940193M,carmen.lozano@brilliantdata.site,257841,ES11209564797724896921,5500.05,2022-09-17T22:33:47,Zarautz,expenses,cash,-100.0,-16471.98
buyer_2,Carmen,Lozano,1984-09-05,01940193M,carmen.lozano@brilliantdata.site,257841,ES11209564797724896921,5500.05,2022-09-19T15:25:46,Zarautz,expenses,gifts,-402.69,-16874.67
buyer_2,Carmen,Lozano,1984-09-05,01940193M,carmen.lozano@brilliantdata.site,257841,ES11209564797724896921,5500.05,2022-09-20T09:35:45,Zarautz,expenses,education,-55.44,-16930.11
buyer_2,Carmen,Lozano,1984-09-05,01940193M,carmen.lozano@brilliantdata.site,257841,ES11209564797724896921,5500.05,2022-09-20T16:11:41,Zarautz,expenses,cash,-100.0,-17030.11
buyer_2,Carmen,Lozano,1984-09-05,01940193M,carmen.lozano@brilliantdata.site,257841,ES11209564797724896921,5500.05,2022-09-21T13:56:13,Zarautz,expenses,leisure,-55.97,-17086.08
buyer_2,Carmen,Lozano,1984-09-05,01940193M,carmen.lozano@brilliantdata.site,257841,ES11209564797724896921,5500.05,2022-09-22T15:40:54,Zarautz,expenses,cash,-100.0,-17186.08
buyer_2,Carmen,Lozano,1984-09-05,01940193M,carmen.lozano@brilliantdata.site,257841,ES11209564797724896921,5500.05,2022-09-23T09:02:51,Zarautz,expenses,food,-86.76,-17272.84
buyer_2,Carmen,Lozano,1984-09-05,01940193M,carmen.lozano@brilliantdata.site,257841,ES11209564797724896921,5500.05,2022-09-27T10:59:21,Zarautz,expenses,transport,-41.96,-17314.8
buyer_2,Carmen,Lozano,1984-09-05,01940193M,carmen.lozano@brilliantdata.site,257841,ES11209564797724896921,5500.05,2022-09-27T08:52:49,Zarautz,expenses,cash,-100.0,-17414.8
buyer_2,Carmen,Lozano,1984-09-05,01940193M,carmen.lozano@brilliantdata.site,257841,ES11209564797724896921,5500.05,2022-09-28T09:12:20,Zarautz,expenses,cash,-100.0,-17514.8
buyer_2,Carmen,Lozano,1984-09-05,01940193M,carmen.lozano@brilliantdata.site,257841,ES11209564797724896921,5500.05,2022-09-28T22:28:09,Zarautz,expenses,repairs,-109.01,-17623.81
buyer_2,Carmen,Lozano,1984-09-05,01940193M,carmen.lozano@brilliantdata.site,257841,ES11209564797724896921,5500.05,2022-09-29T13:17:04,Zarautz,expenses,repairs,-331.47,-17955.28
buyer_2,Carmen,Lozano,1984-09-05,01940193M,carmen.lozano@brilliantdata.site,257841,ES11209564797724896921,5500.05,2022-09-30T10:12:11,Zarautz,expenses,cash,-100.0,-18055.28
buyer_2,Carmen,Lozano,1984-09-05,01940193M,carmen.lozano@brilliantdata.site,257841,ES11209564797724896921,5500.05,2022-10-01T13:29:33,Zarautz,incomes,salary,1989.85,-16065.43
buyer_2,Carmen,Lozano,1984-09-05,01940193M,carmen.lozano@brilliantdata.site,257841,ES11209564797724896921,5500.05,2022-10-01T13:14:08,Zarautz,expenses,food,-60.98,-16126.41
buyer_2,Carmen,Lozano,1984-09-05,01940193M,carmen.lozano@brilliantdata.site,257841,ES11209564797724896921,5500.05,2022-10-01T17:42:23,Zarautz,expenses,repairs,-98.97,-16225.38
buyer_2,Carmen,Lozano,1984-09-05,01940193M,carmen.lozano@brilliantdata.site,257841,ES11209564797724896921,5500.05,2022-10-02T11:01:38,Zarautz,expenses,food,-121.3,-16346.68
buyer_2,Carmen,Lozano,1984-09-05,01940193M,carmen.lozano@brilliantdata.site,257841,ES11209564797724896921,5500.05,2022-10-02T17:44:46,Zarautz,expenses,transport,-75.31,-16421.99
buyer_2,Carmen,Lozano,1984-09-05,01940193M,carmen.lozano@brilliantdata.site,257841,ES11209564797724896921,5500.05,2022-10-04T11:14:40,Zarautz,expenses,mortgage,-888.96,-17310.95
buyer_2,Carmen,Lozano,1984-09-05,01940193M,carmen.lozano@brilliantdata.site,257841,ES11209564797724896921,5500.05,2022-10-05T17:10:04,Zarautz,expenses,cash,-100.0,-17410.95
buyer_2,Carmen,Lozano,1984-09-05,01940193M,carmen.lozano@brilliantdata.site,257841,ES11209564797724896921,5500.05,2022-10-06T16:36:21,Zarautz,expenses,internet,-41.79,-17452.74
buyer_2,Carmen,Lozano,1984-09-05,01940193M,carmen.lozano@brilliantdata.site,257841,ES11209564797724896921,5500.05,2022-10-07T17:26:23,Zarautz,expenses,water,-41.0,-17493.74
buyer_2,Carmen,Lozano,1984-09-05,01940193M,carmen.lozano@brilliantdata.site,257841,ES11209564797724896921,5500.05,2022-10-07T16:28:38,Zarautz,expenses,education,-43.78,-17537.52
buyer_2,Carmen,Lozano,1984-09-05,01940193M,carmen.lozano@brilliantdata.site,257841,ES11209564797724896921,5500.05,2022-10-07T17:10:05,Zarautz,expenses,repairs,-68.27,-17605.79
buyer_2,Carmen,Lozano,1984-09-05,01940193M,carmen.lozano@brilliantdata.site,257841,ES11209564797724896921,5500.05,2022-10-08T19:31:26,Zarautz,expenses,electricity,-80.45,-17686.24
buyer_2,Carmen,Lozano,1984-09-05,01940193M,carmen.lozano@brilliantdata.site,257841,ES11209564797724896921,5500.05,2022-10-08T11:18:24,Zarautz,expenses,gas,-47.7,-17733.94
buyer_2,Carmen,Lozano,1984-09-05,01940193M,carmen.lozano@brilliantdata.site,257841,ES11209564797724896921,5500.05,2022-10-08T08:21:09,Zarautz,expenses,phone,-43.67,-17777.61
buyer_2,Carmen,Lozano,1984-09-05,01940193M,carmen.lozano@brilliantdata.site,257841,ES11209564797724896921,5500.05,2022-10-08T02:35:55,Zarautz,expenses,clothing,-59.64,-17837.25
buyer_2,Carmen,Lozano,1984-09-05,01940193M,carmen.lozano@brilliantdata.site,257841,ES11209564797724896921,5500.05,2022-10-09T09:41:31,Zarautz,expenses,food,-68.47,-17905.72
buyer_2,Carmen,Lozano,1984-09-05,01940193M,carmen.lozano@brilliantdata.site,257841,ES11209564797724896921,5500.05,2022-10-10T11:25:53,Zarautz,expenses,repairs,-93.42,-17999.14
buyer_2,Carmen,Lozano,1984-09-05,01940193M,carmen.lozano@brilliantdata.site,257841,ES11209564797724896921,5500.05,2022-10-11T16:46:53,Zarautz,expenses,cash,-100.0,-18099.14
buyer_2,Carmen,Lozano,1984-09-05,01940193M,carmen.lozano@brilliantdata.site,257841,ES11209564797724896921,5500.05,2022-10-14T22:23:53,Zarautz,expenses,cash,-100.0,-18199.14
buyer_2,Carmen,Lozano,1984-09-05,01940193M,carmen.lozano@brilliantdata.site,257841,ES11209564797724896921,5500.05,2022-10-16T09:30:54,Zarautz,expenses,leisure,-36.21,-18235.35
buyer_2,Carmen,Lozano,1984-09-05,01940193M,carmen.lozano@brilliantdata.site,257841,ES11209564797724896921,5500.05,2022-10-18T18:27:06,Zarautz,expenses,cash,-100.0,-18335.35
buyer_2,Carmen,Lozano,1984-09-05,01940193M,carmen.lozano@brilliantdata.site,257841,ES11209564797724896921,5500.05,2022-10-21T14:12:52,Zarautz,expenses,food,-80.72,-18416.07
buyer_2,Carmen,Lozano,1984-09-05,01940193M,carmen.lozano@brilliantdata.site,257841,ES11209564797724896921,5500.05,2022-10-21T18:15:44,Zarautz,expenses,education,-49.32,-18465.39
buyer_2,Carmen,Lozano,1984-09-05,01940193M,carmen.lozano@brilliantdata.site,257841,ES11209564797724896921,5500.05,2022-10-22T09:58:17,Zarautz,expenses,cash,-100.0,-18565.39
buyer_2,Carmen,Lozano,1984-09-05,01940193M,carmen.lozano@brilliantdata.site,257841,ES11209564797724896921,5500.05,2022-10-22T17:09:20,Zarautz,expenses,gifts,-342.64,-18908.03
buyer_2,Carmen,Lozano,1984-09-05,01940193M,carmen.lozano@brilliantdata.site,257841,ES11209564797724896921,5500.05,2022-10-23T19:26:30,Zarautz,expenses,food,-124.84,-19032.87
buyer_2,Carmen,Lozano,1984-09-05,01940193M,carmen.lozano@brilliantdata.site,257841,ES11209564797724896921,5500.05,2022-10-23T15:50:31,Zarautz,expenses,transport,-59.63,-19092.5
buyer_2,Carmen,Lozano,1984-09-05,01940193M,carmen.lozano@brilliantdata.site,257841,ES11209564797724896921,5500.05,2022-10-23T00:10:24,Zarautz,expenses,repairs,-318.63,-19411.13
buyer_2,Carmen,Lozano,1984-09-05,01940193M,carmen.lozano@brilliantdata.site,257841,ES11209564797724896921,5500.05,2022-10-26T08:14:43,Zarautz,expenses,cash,-100.0,-19511.13
buyer_2,Carmen,Lozano,1984-09-05,01940193M,carmen.lozano@brilliantdata.site,257841,ES11209564797724896921,5500.05,2022-10-27T16:11:02,Zarautz,expenses,cash,-100.0,-19611.13
buyer_2,Carmen,Lozano,1984-09-05,01940193M,carmen.lozano@brilliantdata.site,257841,ES11209564797724896921,5500.05,2022-10-30T20:22:07,Zarautz,expenses,transport,-45.07,-19656.2
buyer_2,Carmen,Lozano,1984-09-05,01940193M,carmen.lozano@brilliantdata.site,257841,ES11209564797724896921,5500.05,2022-10-31T14:48:50,Zarautz,expenses,food,-76.73,-19732.93
buyer_2,Carmen,Lozano,1984-09-05,01940193M,carmen.lozano@brilliantdata.site,257841,ES11209564797724896921,5500.05,2022-11-01T14:15:08,Zarautz,incomes,salary,1989.85,-17743.08
buyer_2,Carmen,Lozano,1984-09-05,01940193M,carmen.lozano@brilliantdata.site,257841,ES11209564797724896921,5500.05,2022-11-01T14:15:08,Zarautz,incomes,extra_income,376.86,-17366.22
buyer_2,Carmen,Lozano,1984-09-05,01940193M,carmen.lozano@brilliantdata.site,257841,ES11209564797724896921,5500.05,2022-11-01T17:50:42,Zarautz,expenses,repairs,-257.47,-17623.69
buyer_2,Carmen,Lozano,1984-09-05,01940193M,carmen.lozano@brilliantdata.site,257841,ES11209564797724896921,5500.05,2022-11-02T12:45:03,Zarautz,expenses,food,-79.73,-17703.42
buyer_2,Carmen,Lozano,1984-09-05,01940193M,carmen.lozano@brilliantdata.site,257841,ES11209564797724896921,5500.05,2022-11-03T22:34:56,Zarautz,expenses,transport,-73.92,-17777.34
buyer_2,Carmen,Lozano,1984-09-05,01940193M,carmen.lozano@brilliantdata.site,257841,ES11209564797724896921,5500.05,2022-11-03T16:21:32,Zarautz,expenses,clothing,-107.71,-17885.05
buyer_2,Carmen,Lozano,1984-09-05,01940193M,carmen.lozano@brilliantdata.site,257841,ES11209564797724896921,5500.05,2022-11-04T08:52:36,Zarautz,expenses,mortgage,-888.96,-18774.01
buyer_2,Carmen,Lozano,1984-09-05,01940193M,carmen.lozano@brilliantdata.site,257841,ES11209564797724896921,5500.05,2022-11-04T14:07:10,Zarautz,expenses,cash,-100.0,-18874.01
buyer_2,Carmen,Lozano,1984-09-05,01940193M,carmen.lozano@brilliantdata.site,257841,ES11209564797724896921,5500.05,2022-11-05T12:09:43,Zarautz,expenses,electricity,-35.68,-18909.69
buyer_2,Carmen,Lozano,1984-09-05,01940193M,carmen.lozano@brilliantdata.site,257841,ES11209564797724896921,5500.05,2022-11-05T13:00:58,Zarautz,expenses,phone,-30.8,-18940.49
buyer_2,Carmen,Lozano,1984-09-05,01940193M,carmen.lozano@brilliantdata.site,257841,ES11209564797724896921,5500.05,2022-11-06T19:17:37,Zarautz,expenses,internet,-41.79,-18982.28
buyer_2,Carmen,Lozano,1984-09-05,01940193M,carmen.lozano@brilliantdata.site,257841,ES11209564797724896921,5500.05,2022-11-06T19:46:37,Zarautz,expenses,food,-63.98,-19046.26
buyer_2,Carmen,Lozano,1984-09-05,01940193M,carmen.lozano@brilliantdata.site,257841,ES11209564797724896921,5500.05,2022-11-06T13:19:16,Zarautz,expenses,healthcare,-51.34,-19097.6
buyer_2,Carmen,Lozano,1984-09-05,01940193M,carmen.lozano@brilliantdata.site,257841,ES11209564797724896921,5500.05,2022-11-07T12:40:23,Zarautz,expenses,food,-62.03,-19159.63
buyer_2,Carmen,Lozano,1984-09-05,01940193M,carmen.lozano@brilliantdata.site,257841,ES11209564797724896921,5500.05,2022-11-08T02:52:21,Zarautz,expenses,water,-30.06,-19189.69
buyer_2,Carmen,Lozano,1984-09-05,01940193M,carmen.lozano@brilliantdata.site,257841,ES11209564797724896921,5500.05,2022-11-08T18:06:17,Zarautz,expenses,gas,-59.96,-19249.65
buyer_2,Carmen,Lozano,1984-09-05,01940193M,carmen.lozano@brilliantdata.site,257841,ES11209564797724896921,5500.05,2022-11-10T12:07:41,Zarautz,expenses,transport,-80.45,-19330.1
buyer_2,Carmen,Lozano,1984-09-05,01940193M,carmen.lozano@brilliantdata.site,257841,ES11209564797724896921,5500.05,2022-11-12T22:55:36,Zarautz,expenses,gifts,-188.72,-19518.82
buyer_2,Carmen,Lozano,1984-09-05,01940193M,carmen.lozano@brilliantdata.site,257841,ES11209564797724896921,5500.05,2022-11-13T13:52:11,Zarautz,expenses,clothing,-81.43,-19600.25
buyer_2,Carmen,Lozano,1984-09-05,01940193M,carmen.lozano@brilliantdata.site,257841,ES11209564797724896921,5500.05,2022-11-14T04:20:02,Zarautz,expenses,children,-331.99,-19932.24
buyer_2,Carmen,Lozano,1984-09-05,01940193M,carmen.lozano@brilliantdata.site,257841,ES11209564797724896921,5500.05,2022-11-16T14:40:23,Zarautz,expenses,clothing,-120.29,-20052.53
buyer_2,Carmen,Lozano,1984-09-05,01940193M,carmen.lozano@brilliantdata.site,257841,ES11209564797724896921,5500.05,2022-11-17T12:50:42,Zarautz,expenses,cash,-100.0,-20152.53
buyer_2,Carmen,Lozano,1984-09-05,01940193M,carmen.lozano@brilliantdata.site,257841,ES11209564797724896921,5500.05,2022-11-20T16:57:02,Zarautz,expenses,cash,-100.0,-20252.53
buyer_2,Carmen,Lozano,1984-09-05,01940193M,carmen.lozano@brilliantdata.site,257841,ES11209564797724896921,5500.05,2022-11-21T12:08:58,Zarautz,expenses,clothing,-59.67,-20312.2
buyer_2,Carmen,Lozano,1984-09-05,01940193M,carmen.lozano@brilliantdata.site,257841,ES11209564797724896921,5500.05,2022-11-21T18:06:40,Zarautz,expenses,gifts,-135.06,-20447.26
buyer_2,Carmen,Lozano,1984-09-05,01940193M,carmen.lozano@brilliantdata.site,257841,ES11209564797724896921,5500.05,2022-11-23T10:10:43,Zarautz,expenses,leisure,-79.28,-20526.54
buyer_2,Carmen,Lozano,1984-09-05,01940193M,carmen.lozano@brilliantdata.site,257841,ES11209564797724896921,5500.05,2022-11-23T17:56:39,Zarautz,expenses,cash,-100.0,-20626.54
buyer_2,Carmen,Lozano,1984-09-05,01940193M,carmen.lozano@brilliantdata.site,257841,ES11209564797724896921,5500.05,2022-11-24T15:31:22,Zarautz,expenses,transport,-67.4,-20693.94
buyer_2,Carmen,Lozano,1984-09-05,01940193M,carmen.lozano@brilliantdata.site,257841,ES11209564797724896921,5500.05,2022-11-25T11:59:25,Zarautz,expenses,clothing,-129.54,-20823.48
buyer_2,Carmen,Lozano,1984-09-05,01940193M,carmen.lozano@brilliantdata.site,257841,ES11209564797724896921,5500.05,2022-11-25T13:24:51,Zarautz,expenses,appliances,-118.32,-20941.8
buyer_2,Carmen,Lozano,1984-09-05,01940193M,carmen.lozano@brilliantdata.site,257841,ES11209564797724896921,5500.05,2022-11-26T21:45:39,Zarautz,expenses,repairs,-106.36,-21048.16
buyer_2,Carmen,Lozano,1984-09-05,01940193M,carmen.lozano@brilliantdata.site,257841,ES11209564797724896921,5500.05,2022-11-27T19:09:19,Zarautz,expenses,transport,-89.01,-21137.17
buyer_2,Carmen,Lozano,1984-09-05,01940193M,carmen.lozano@brilliantdata.site,257841,ES11209564797724896921,5500.05,2022-11-29T10:04:38,Zarautz,expenses,leisure,-33.97,-21171.14
buyer_2,Carmen,Lozano,1984-09-05,01940193M,carmen.lozano@brilliantdata.site,257841,ES11209564797724896921,5500.05,2022-11-30T19:25:16,Zarautz,expenses,transport,-76.35,-21247.49
buyer_2,Carmen,Lozano,1984-09-05,01940193M,carmen.lozano@brilliantdata.site,257841,ES11209564797724896921,5500.05,2022-11-30T15:03:06,Zarautz,expenses,healthcare,-78.58,-21326.07
buyer_2,Carmen,Lozano,1984-09-05,01940193M,carmen.lozano@brilliantdata.site,257841,ES11209564797724896921,5500.05,2022-11-30T14:50:23,Zarautz,expenses,gifts,-457.81,-21783.88
buyer_2,Carmen,Lozano,1984-09-05,01940193M,carmen.lozano@brilliantdata.site,257841,ES11209564797724896921,5500.05,2022-12-01T06:06:03,Zarautz,incomes,salary,1989.85,-19794.03
buyer_2,Carmen,Lozano,1984-09-05,01940193M,carmen.lozano@brilliantdata.site,257841,ES11209564797724896921,5500.05,2022-12-01T06:06:03,Zarautz,incomes,salary_bonus,1569.59,-18224.44
buyer_2,Carmen,Lozano,1984-09-05,01940193M,carmen.lozano@brilliantdata.site,257841,ES11209564797724896921,5500.05,2022-12-01T20:54:59,Zarautz,expenses,children,-307.97,-18532.41
buyer_2,Carmen,Lozano,1984-09-05,01940193M,carmen.lozano@brilliantdata.site,257841,ES11209564797724896921,5500.05,2022-12-02T15:05:53,Zarautz,expenses,leisure,-24.15,-18556.56
buyer_2,Carmen,Lozano,1984-09-05,01940193M,carmen.lozano@brilliantdata.site,257841,ES11209564797724896921,5500.05,2022-12-04T12:05:05,Zarautz,expenses,mortgage,-888.96,-19445.52
buyer_2,Carmen,Lozano,1984-09-05,01940193M,carmen.lozano@brilliantdata.site,257841,ES11209564797724896921,5500.05,2022-12-04T13:43:06,Zarautz,expenses,cash,-100.0,-19545.52
buyer_2,Carmen,Lozano,1984-09-05,01940193M,carmen.lozano@brilliantdata.site,257841,ES11209564797724896921,5500.05,2022-12-04T11:15:05,Zarautz,expenses,gifts,-278.82,-19824.34
buyer_2,Carmen,Lozano,1984-09-05,01940193M,carmen.lozano@brilliantdata.site,257841,ES11209564797724896921,5500.05,2022-12-05T15:08:21,Zarautz,expenses,internet,-41.79,-19866.13
buyer_2,Carmen,Lozano,1984-09-05,01940193M,carmen.lozano@brilliantdata.site,257841,ES11209564797724896921,5500.05,2022-12-05T11:12:33,Zarautz,expenses,phone,-33.61,-19899.74
buyer_2,Carmen,Lozano,1984-09-05,01940193M,carmen.lozano@brilliantdata.site,257841,ES11209564797724896921,5500.05,2022-12-05T05:50:25,Zarautz,expenses,children,-752.28,-20652.02
buyer_2,Carmen,Lozano,1984-09-05,01940193M,carmen.lozano@brilliantdata.site,257841,ES11209564797724896921,5500.05,2022-12-06T20:31:42,Zarautz,expenses,water,-35.39,-20687.41
buyer_2,Carmen,Lozano,1984-09-05,01940193M,carmen.lozano@brilliantdata.site,257841,ES11209564797724896921,5500.05,2022-12-06T21:21:59,Zarautz,expenses,food,-108.41,-20795.82
buyer_2,Carmen,Lozano,1984-09-05,01940193M,carmen.lozano@brilliantdata.site,257841,ES11209564797724896921,5500.05,2022-12-08T11:25:11,Zarautz,expenses,gas,-102.74,-20898.56
buyer_2,Carmen,Lozano,1984-09-05,01940193M,carmen.lozano@brilliantdata.site,257841,ES11209564797724896921,5500.05,2022-12-08T20:24:59,Zarautz,expenses,electricity,-22.48,-20921.04
buyer_2,Carmen,Lozano,1984-09-05,01940193M,carmen.lozano@brilliantdata.site,257841,ES11209564797724896921,5500.05,2022-12-08T23:54:46,Zarautz,expenses,cash,-100.0,-21021.04
buyer_2,Carmen,Lozano,1984-09-05,01940193M,carmen.lozano@brilliantdata.site,257841,ES11209564797724896921,5500.05,2022-12-09T16:49:34,Zarautz,expenses,leisure,-60.99,-21082.03
buyer_2,Carmen,Lozano,1984-09-05,01940193M,carmen.lozano@brilliantdata.site,257841,ES11209564797724896921,5500.05,2022-12-11T18:10:02,Zarautz,expenses,cash,-100.0,-21182.03
buyer_2,Carmen,Lozano,1984-09-05,01940193M,carmen.lozano@brilliantdata.site,257841,ES11209564797724896921,5500.05,2022-12-12T19:18:37,Zarautz,expenses,leisure,-49.81,-21231.84
buyer_2,Carmen,Lozano,1984-09-05,01940193M,carmen.lozano@brilliantdata.site,257841,ES11209564797724896921,5500.05,2022-12-14T14:35:28,Zarautz,expenses,leisure,-58.89,-21290.73
buyer_2,Carmen,Lozano,1984-09-05,01940193M,carmen.lozano@brilliantdata.site,257841,ES11209564797724896921,5500.05,2022-12-14T18:08:13,Zarautz,expenses,appliances,-355.16,-21645.89
buyer_2,Carmen,Lozano,1984-09-05,01940193M,carmen.lozano@brilliantdata.site,257841,ES11209564797724896921,5500.05,2022-12-14T12:04:17,Zarautz,expenses,gifts,-228.35,-21874.24
buyer_2,Carmen,Lozano,1984-09-05,01940193M,carmen.lozano@brilliantdata.site,257841,ES11209564797724896921,5500.05,2022-12-17T18:28:55,Zarautz,expenses,food,-62.91,-21937.15
buyer_2,Carmen,Lozano,1984-09-05,01940193M,carmen.lozano@brilliantdata.site,257841,ES11209564797724896921,5500.05,2022-12-17T12:51:29,Zarautz,expenses,cash,-100.0,-22037.15
buyer_2,Carmen,Lozano,1984-09-05,01940193M,carmen.lozano@brilliantdata.site,257841,ES11209564797724896921,5500.05,2022-12-17T15:50:11,Zarautz,expenses,gifts,-27.57,-22064.72
buyer_2,Carmen,Lozano,1984-09-05,01940193M,carmen.lozano@brilliantdata.site,257841,ES11209564797724896921,5500.05,2022-12-20T11:13:16,Zarautz,expenses,food,-63.45,-22128.17
buyer_2,Carmen,Lozano,1984-09-05,01940193M,carmen.lozano@brilliantdata.site,257841,ES11209564797724896921,5500.05,2022-12-20T15:40:14,Zarautz,expenses,cash,-100.0,-22228.17
buyer_2,Carmen,Lozano,1984-09-05,01940193M,carmen.lozano@brilliantdata.site,257841,ES11209564797724896921,5500.05,2022-12-23T08:13:16,Zarautz,expenses,leisure,-28.68,-22256.85
buyer_2,Carmen,Lozano,1984-09-05,01940193M,carmen.lozano@brilliantdata.site,257841,ES11209564797724896921,5500.05,2022-12-26T16:19:54,Zarautz,expenses,clothing,-105.77,-22362.62
buyer_2,Carmen,Lozano,1984-09-05,01940193M,carmen.lozano@brilliantdata.site,257841,ES11209564797724896921,5500.05,2022-12-26T17:03:20,Zarautz,expenses,cash,-100.0,-22462.62
buyer_2,Carmen,Lozano,1984-09-05,01940193M,carmen.lozano@brilliantdata.site,257841,ES11209564797724896921,5500.05,2022-12-27T05:58:17,Zarautz,expenses,transport,-60.58,-22523.2
buyer_2,Carmen,Lozano,1984-09-05,01940193M,carmen.lozano@brilliantdata.site,257841,ES11209564797724896921,5500.05,2022-12-27T12:19:19,Zarautz,expenses,education,-71.63,-22594.83
buyer_2,Carmen,Lozano,1984-09-05,01940193M,carmen.lozano@brilliantdata.site,257841,ES11209564797724896921,5500.05,2022-12-30T15:02:12,Zarautz,expenses,education,-48.97,-22643.8
buyer_2,Carmen,Lozano,1984-09-05,01940193M,carmen.lozano@brilliantdata.site,257841,ES11209564797724896921,5500.05,2022-12-31T02:56:24,Zarautz,expenses,cash,-100.0,-22743.8
buyer_2,Carmen,Lozano,1984-09-05,01940193M,carmen.lozano@brilliantdata.site,257841,ES11209564797724896921,5500.05,2023-01-01T16:51:06,Zarautz,incomes,salary,2038.44,-20705.36
buyer_2,Carmen,Lozano,1984-09-05,01940193M,carmen.lozano@brilliantdata.site,257841,ES11209564797724896921,5500.05,2023-01-02T11:15:15,Zarautz,expenses,food,-99.34,-20804.7
buyer_2,Carmen,Lozano,1984-09-05,01940193M,carmen.lozano@brilliantdata.site,257841,ES11209564797724896921,5500.05,2023-01-02T16:45:29,Zarautz,expenses,cash,-100.0,-20904.7
buyer_2,Carmen,Lozano,1984-09-05,01940193M,carmen.lozano@brilliantdata.site,257841,ES11209564797724896921,5500.05,2023-01-03T10:32:34,Zarautz,expenses,leisure,-19.16,-20923.86
buyer_2,Carmen,Lozano,1984-09-05,01940193M,carmen.lozano@brilliantdata.site,257841,ES11209564797724896921,5500.05,2023-01-04T17:43:33,Zarautz,expenses,mortgage,-820.89,-21744.75
buyer_2,Carmen,Lozano,1984-09-05,01940193M,carmen.lozano@brilliantdata.site,257841,ES11209564797724896921,5500.05,2023-01-05T16:04:53,Zarautz,expenses,cash,-100.0,-21844.75
buyer_2,Carmen,Lozano,1984-09-05,01940193M,carmen.lozano@brilliantdata.site,257841,ES11209564797724896921,5500.05,2023-01-06T08:07:17,Zarautz,expenses,water,-35.13,-21879.88
buyer_2,Carmen,Lozano,1984-09-05,01940193M,carmen.lozano@brilliantdata.site,257841,ES11209564797724896921,5500.05,2023-01-06T02:41:39,Zarautz,expenses,internet,-42.81,-21922.69
buyer_2,Carmen,Lozano,1984-09-05,01940193M,carmen.lozano@brilliantdata.site,257841,ES11209564797724896921,5500.05,2023-01-08T21:11:22,Zarautz,expenses,electricity,-74.88,-21997.57
buyer_2,Carmen,Lozano,1984-09-05,01940193M,carmen.lozano@brilliantdata.site,257841,ES11209564797724896921,5500.05,2023-01-08T10:29:12,Zarautz,expenses,gas,-77.05,-22074.62
buyer_2,Carmen,Lozano,1984-09-05,01940193M,carmen.lozano@brilliantdata.site,257841,ES11209564797724896921,5500.05,2023-01-08T15:21:40,Zarautz,expenses,phone,-31.9,-22106.52
buyer_2,Carmen,Lozano,1984-09-05,01940193M,carmen.lozano@brilliantdata.site,257841,ES11209564797724896921,5500.05,2023-01-08T16:53:35,Zarautz,expenses,clothing,-55.8,-22162.32
buyer_2,Carmen,Lozano,1984-09-05,01940193M,carmen.lozano@brilliantdata.site,257841,ES11209564797724896921,5500.05,2023-01-08T22:04:21,Zarautz,expenses,healthcare,-178.59,-22340.91
buyer_2,Carmen,Lozano,1984-09-05,01940193M,carmen.lozano@brilliantdata.site,257841,ES11209564797724896921,5500.05,2023-01-09T12:32:28,Zarautz,expenses,food,-61.5,-22402.41
buyer_2,Carmen,Lozano,1984-09-05,01940193M,carmen.lozano@brilliantdata.site,257841,ES11209564797724896921,5500.05,2023-01-09T11:40:03,Zarautz,expenses,leisure,-51.17,-22453.58
buyer_2,Carmen,Lozano,1984-09-05,01940193M,carmen.lozano@brilliantdata.site,257841,ES11209564797724896921,5500.05,2023-01-11T18:02:51,Zarautz,expenses,appliances,-118.56,-22572.14
buyer_2,Carmen,Lozano,1984-09-05,01940193M,carmen.lozano@brilliantdata.site,257841,ES11209564797724896921,5500.05,2023-01-12T09:03:47,Zarautz,expenses,education,-52.78,-22624.92
buyer_2,Carmen,Lozano,1984-09-05,01940193M,carmen.lozano@brilliantdata.site,257841,ES11209564797724896921,5500.05,2023-01-13T16:55:03,Zarautz,expenses,cash,-100.0,-22724.92
buyer_2,Carmen,Lozano,1984-09-05,01940193M,carmen.lozano@brilliantdata.site,257841,ES11209564797724896921,5500.05,2023-01-14T11:41:10,Zarautz,expenses,travel,-317.47,-23042.39
buyer_2,Carmen,Lozano,1984-09-05,01940193M,carmen.lozano@brilliantdata.site,257841,ES11209564797724896921,5500.05,2023-01-16T20:36:20,Zarautz,expenses,food,-107.76,-23150.15
buyer_2,Carmen,Lozano,1984-09-05,01940193M,carmen.lozano@brilliantdata.site,257841,ES11209564797724896921,5500.05,2023-01-16T22:37:54,Zarautz,expenses,cash,-100.0,-23250.15
buyer_2,Carmen,Lozano,1984-09-05,01940193M,carmen.lozano@brilliantdata.site,257841,ES11209564797724896921,5500.05,2023-01-17T12:03:11,Zarautz,expenses,food,-112.2,-23362.35
buyer_2,Carmen,Lozano,1984-09-05,01940193M,carmen.lozano@brilliantdata.site,257841,ES11209564797724896921,5500.05,2023-01-17T09:53:08,Zarautz,expenses,transport,-41.18,-23403.53
buyer_2,Carmen,Lozano,1984-09-05,01940193M,carmen.lozano@brilliantdata.site,257841,ES11209564797724896921,5500.05,2023-01-18T15:37:55,Zarautz,expenses,food,-80.39,-23483.92
buyer_2,Carmen,Lozano,1984-09-05,01940193M,carmen.lozano@brilliantdata.site,257841,ES11209564797724896921,5500.05,2023-01-19T10:17:57,Zarautz,expenses,leisure,-25.06,-23508.98
buyer_2,Carmen,Lozano,1984-09-05,01940193M,carmen.lozano@brilliantdata.site,257841,ES11209564797724896921,5500.05,2023-01-20T16:16:06,Zarautz,expenses,transport,-51.5,-23560.48
buyer_2,Carmen,Lozano,1984-09-05,01940193M,carmen.lozano@brilliantdata.site,257841,ES11209564797724896921,5500.05,2023-01-20T19:45:08,Zarautz,expenses,leisure,-40.19,-23600.67
buyer_2,Carmen,Lozano,1984-09-05,01940193M,carmen.lozano@brilliantdata.site,257841,ES11209564797724896921,5500.05,2023-01-20T09:57:12,Zarautz,expenses,repairs,-118.81,-23719.48
buyer_2,Carmen,Lozano,1984-09-05,01940193M,carmen.lozano@brilliantdata.site,257841,ES11209564797724896921,5500.05,2023-01-22T13:03:30,Zarautz,expenses,transport,-71.18,-23790.66
buyer_2,Carmen,Lozano,1984-09-05,01940193M,carmen.lozano@brilliantdata.site,257841,ES11209564797724896921,5500.05,2023-01-25T15:10:47,Zarautz,expenses,food,-89.56,-23880.22
buyer_2,Carmen,Lozano,1984-09-05,01940193M,carmen.lozano@brilliantdata.site,257841,ES11209564797724896921,5500.05,2023-01-25T12:23:41,Zarautz,expenses,gifts,-45.62,-23925.84
buyer_2,Carmen,Lozano,1984-09-05,01940193M,carmen.lozano@brilliantdata.site,257841,ES11209564797724896921,5500.05,2023-01-28T18:50:23,Zarautz,expenses,leisure,-78.37,-24004.21
buyer_2,Carmen,Lozano,1984-09-05,01940193M,carmen.lozano@brilliantdata.site,257841,ES11209564797724896921,5500.05,2023-01-30T09:21:22,Zarautz,expenses,food,-111.62,-24115.83
buyer_2,Carmen,Lozano,1984-09-05,01940193M,carmen.lozano@brilliantdata.site,257841,ES11209564797724896921,5500.05,2023-02-01T16:53:33,Zarautz,incomes,salary,2038.44,-22077.39
buyer_2,Carmen,Lozano,1984-09-05,01940193M,carmen.lozano@brilliantdata.site,257841,ES11209564797724896921,5500.05,2023-02-01T16:53:33,Zarautz,incomes,extra_income,376.86,-21700.53
buyer_2,Carmen,Lozano,1984-09-05,01940193M,carmen.lozano@brilliantdata.site,257841,ES11209564797724896921,5500.05,2023-02-01T15:04:38,Zarautz,expenses,cash,-100.0,-21800.53
buyer_2,Carmen,Lozano,1984-09-05,01940193M,carmen.lozano@brilliantdata.site,257841,ES11209564797724896921,5500.05,2023-02-04T09:14:21,Zarautz,expenses,mortgage,-820.89,-22621.42
buyer_2,Carmen,Lozano,1984-09-05,01940193M,carmen.lozano@brilliantdata.site,257841,ES11209564797724896921,5500.05,2023-02-04T19:28:25,Zarautz,expenses,transport,-68.83,-22690.25
buyer_2,Carmen,Lozano,1984-09-05,01940193M,carmen.lozano@brilliantdata.site,257841,ES11209564797724896921,5500.05,2023-02-05T08:09:08,Zarautz,expenses,water,-40.23,-22730.48
buyer_2,Carmen,Lozano,1984-09-05,01940193M,carmen.lozano@brilliantdata.site,257841,ES11209564797724896921,5500.05,2023-02-05T23:01:07,Zarautz,expenses,electricity,-67.78,-22798.26
buyer_2,Carmen,Lozano,1984-09-05,01940193M,carmen.lozano@brilliantdata.site,257841,ES11209564797724896921,5500.05,2023-02-05T17:47:33,Zarautz,expenses,internet,-42.81,-22841.07
buyer_2,Carmen,Lozano,1984-09-05,01940193M,carmen.lozano@brilliantdata.site,257841,ES11209564797724896921,5500.05,2023-02-05T23:45:06,Zarautz,expenses,phone,-40.46,-22881.53
buyer_2,Carmen,Lozano,1984-09-05,01940193M,carmen.lozano@brilliantdata.site,257841,ES11209564797724896921,5500.05,2023-02-05T10:27:11,Zarautz,expenses,transport,-79.15,-22960.68
buyer_2,Carmen,Lozano,1984-09-05,01940193M,carmen.lozano@brilliantdata.site,257841,ES11209564797724896921,5500.05,2023-02-06T18:42:19,Zarautz,expenses,gas,-58.33,-23019.01
buyer_2,Carmen,Lozano,1984-09-05,01940193M,carmen.lozano@brilliantdata.site,257841,ES11209564797724896921,5500.05,2023-02-06T16:58:25,Zarautz,expenses,food,-112.84,-23131.85
buyer_2,Carmen,Lozano,1984-09-05,01940193M,carmen.lozano@brilliantdata.site,257841,ES11209564797724896921,5500.05,2023-02-06T19:20:40,Zarautz,expenses,transport,-46.3,-23178.15
buyer_2,Carmen,Lozano,1984-09-05,01940193M,carmen.lozano@brilliantdata.site,257841,ES11209564797724896921,5500.05,2023-02-07T19:45:18,Zarautz,expenses,children,-659.44,-23837.59
buyer_2,Carmen,Lozano,1984-09-05,01940193M,carmen.lozano@brilliantdata.site,257841,ES11209564797724896921,5500.05,2023-02-08T09:21:25,Zarautz,expenses,transport,-66.7,-23904.29
buyer_2,Carmen,Lozano,1984-09-05,01940193M,carmen.lozano@brilliantdata.site,257841,ES11209564797724896921,5500.05,2023-02-09T02:33:25,Zarautz,expenses,transport,-87.0,-23991.29
buyer_2,Carmen,Lozano,1984-09-05,01940193M,carmen.lozano@brilliantdata.site,257841,ES11209564797724896921,5500.05,2023-02-11T21:12:49,Zarautz,expenses,transport,-70.97,-24062.26
buyer_2,Carmen,Lozano,1984-09-05,01940193M,carmen.lozano@brilliantdata.site,257841,ES11209564797724896921,5500.05,2023-02-12T14:45:40,Zarautz,expenses,repairs,-170.92,-24233.18
buyer_2,Carmen,Lozano,1984-09-05,01940193M,carmen.lozano@brilliantdata.site,257841,ES11209564797724896921,5500.05,2023-02-14T10:56:35,Zarautz,expenses,cash,-100.0,-24333.18
buyer_2,Carmen,Lozano,1984-09-05,01940193M,carmen.lozano@brilliantdata.site,257841,ES11209564797724896921,5500.05,2023-02-15T10:41:44,Zarautz,expenses,gifts,-570.07,-24903.25
buyer_2,Carmen,Lozano,1984-09-05,01940193M,carmen.lozano@brilliantdata.site,257841,ES11209564797724896921,5500.05,2023-02-17T19:00:38,Zarautz,expenses,repairs,-132.7,-25035.95
buyer_2,Carmen,Lozano,1984-09-05,01940193M,carmen.lozano@brilliantdata.site,257841,ES11209564797724896921,5500.05,2023-02-18T15:25:43,Zarautz,expenses,transport,-50.8,-25086.75
buyer_2,Carmen,Lozano,1984-09-05,01940193M,carmen.lozano@brilliantdata.site,257841,ES11209564797724896921,5500.05,2023-02-18T06:30:22,Zarautz,expenses,leisure,-54.03,-25140.78
buyer_2,Carmen,Lozano,1984-09-05,01940193M,carmen.lozano@brilliantdata.site,257841,ES11209564797724896921,5500.05,2023-02-18T14:36:58,Zarautz,expenses,appliances,-179.34,-25320.12
buyer_2,Carmen,Lozano,1984-09-05,01940193M,carmen.lozano@brilliantdata.site,257841,ES11209564797724896921,5500.05,2023-02-19T02:50:15,Zarautz,expenses,cash,-100.0,-25420.12
buyer_2,Carmen,Lozano,1984-09-05,01940193M,carmen.lozano@brilliantdata.site,257841,ES11209564797724896921,5500.05,2023-02-20T09:40:48,Zarautz,expenses,travel,-341.07,-25761.19
buyer_2,Carmen,Lozano,1984-09-05,01940193M,carmen.lozano@brilliantdata.site,257841,ES11209564797724896921,5500.05,2023-02-20T11:55:34,Zarautz,expenses,children,-544.86,-26306.05
buyer_2,Carmen,Lozano,1984-09-05,01940193M,carmen.lozano@brilliantdata.site,257841,ES11209564797724896921,5500.05,2023-02-22T18:27:57,Zarautz,expenses,leisure,-32.5,-26338.55
buyer_2,Carmen,Lozano,1984-09-05,01940193M,carmen.lozano@brilliantdata.site,257841,ES11209564797724896921,5500.05,2023-02-25T15:12:25,Zarautz,expenses,children,-672.39,-27010.94
buyer_2,Carmen,Lozano,1984-09-05,01940193M,carmen.lozano@brilliantdata.site,257841,ES11209564797724896921,5500.05,2023-02-28T14:46:04,Zarautz,expenses,transport,-55.51,-27066.45
buyer_2,Carmen,Lozano,1984-09-05,01940193M,carmen.lozano@brilliantdata.site,257841,ES11209564797724896921,5500.05,2023-03-01T11:36:23,Zarautz,incomes,salary,2038.44,-25028.01
buyer_2,Carmen,Lozano,1984-09-05,01940193M,carmen.lozano@brilliantdata.site,257841,ES11209564797724896921,5500.05,2023-03-03T22:35:14,Zarautz,expenses,cash,-100.0,-25128.01
buyer_2,Carmen,Lozano,1984-09-05,01940193M,carmen.lozano@brilliantdata.site,257841,ES11209564797724896921,5500.05,2023-03-04T15:28:52,Zarautz,expenses,mortgage,-820.89,-25948.9
buyer_2,Carmen,Lozano,1984-09-05,01940193M,carmen.lozano@brilliantdata.site,257841,ES11209564797724896921,5500.05,2023-03-06T18:53:44,Zarautz,expenses,internet,-42.81,-25991.71
buyer_2,Carmen,Lozano,1984-09-05,01940193M,carmen.lozano@brilliantdata.site,257841,ES11209564797724896921,5500.05,2023-03-07T22:16:50,Zarautz,expenses,phone,-33.85,-26025.56
buyer_2,Carmen,Lozano,1984-09-05,01940193M,carmen.lozano@brilliantdata.site,257841,ES11209564797724896921,5500.05,2023-03-07T00:23:33,Zarautz,expenses,cash,-100.0,-26125.56
buyer_2,Carmen,Lozano,1984-09-05,01940193M,carmen.lozano@brilliantdata.site,257841,ES11209564797724896921,5500.05,2023-03-08T09:57:06,Zarautz,expenses,gas,-89.74,-26215.3
buyer_2,Carmen,Lozano,1984-09-05,01940193M,carmen.lozano@brilliantdata.site,257841,ES11209564797724896921,5500.05,2023-03-08T17:44:04,Zarautz,expenses,water,-28.82,-26244.12
buyer_2,Carmen,Lozano,1984-09-05,01940193M,carmen.lozano@brilliantdata.site,257841,ES11209564797724896921,5500.05,2023-03-08T15:57:37,Zarautz,expenses,electricity,-29.79,-26273.91
buyer_2,Carmen,Lozano,1984-09-05,01940193M,carmen.lozano@brilliantdata.site,257841,ES11209564797724896921,5500.05,2023-03-08T10:35:25,Zarautz,expenses,cash,-100.0,-26373.91
buyer_2,Carmen,Lozano,1984-09-05,01940193M,carmen.lozano@brilliantdata.site,257841,ES11209564797724896921,5500.05,2023-03-10T17:34:51,Zarautz,expenses,gifts,-744.12,-27118.03
buyer_2,Carmen,Lozano,1984-09-05,01940193M,carmen.lozano@brilliantdata.site,257841,ES11209564797724896921,5500.05,2023-03-10T17:58:44,Zarautz,expenses,children,-158.95341666666684,-27276.98
buyer_2,Carmen,Lozano,1984-09-05,01940193M,carmen.lozano@brilliantdata.site,257841,ES11209564797724896921,5500.05,2023-03-12T11:33:48,Zarautz,expenses,cash,-100.0,-27376.98
buyer_2,Carmen,Lozano,1984-09-05,01940193M,carmen.lozano@brilliantdata.site,257841,ES11209564797724896921,5500.05,2023-03-15T11:51:13,Zarautz,expenses,cash,-100.0,-27476.98
buyer_2,Carmen,Lozano,1984-09-05,01940193M,carmen.lozano@brilliantdata.site,257841,ES11209564797724896921,5500.05,2023-03-16T21:00:02,Zarautz,expenses,food,-70.37,-27547.35
buyer_2,Carmen,Lozano,1984-09-05,01940193M,carmen.lozano@brilliantdata.site,257841,ES11209564797724896921,5500.05,2023-03-17T17:04:51,Zarautz,expenses,transport,-57.28,-27604.63
buyer_2,Carmen,Lozano,1984-09-05,01940193M,carmen.lozano@brilliantdata.site,257841,ES11209564797724896921,5500.05,2023-03-19T22:02:02,Zarautz,expenses,cash,-100.0,-27704.63
buyer_2,Carmen,Lozano,1984-09-05,01940193M,carmen.lozano@brilliantdata.site,257841,ES11209564797724896921,5500.05,2023-03-20T05:13:44,Zarautz,expenses,food,-114.66,-27819.29
buyer_2,Carmen,Lozano,1984-09-05,01940193M,carmen.lozano@brilliantdata.site,257841,ES11209564797724896921,5500.05,2023-03-20T14:41:10,Zarautz,expenses,cash,-100.0,-27919.29
buyer_2,Carmen,Lozano,1984-09-05,01940193M,carmen.lozano@brilliantdata.site,257841,ES11209564797724896921,5500.05,2023-03-21T15:22:13,Zarautz,expenses,transport,-55.03,-27974.32
buyer_2,Carmen,Lozano,1984-09-05,01940193M,carmen.lozano@brilliantdata.site,257841,ES11209564797724896921,5500.05,2023-03-23T19:25:25,Zarautz,expenses,transport,-81.53,-28055.85
buyer_2,Carmen,Lozano,1984-09-05,01940193M,carmen.lozano@brilliantdata.site,257841,ES11209564797724896921,5500.05,2023-03-25T08:05:46,Zarautz,expenses,appliances,-155.12,-28210.97
buyer_2,Carmen,Lozano,1984-09-05,01940193M,carmen.lozano@brilliantdata.site,257841,ES11209564797724896921,5500.05,2023-03-27T09:32:13,Zarautz,expenses,transport,-63.65,-28274.62
buyer_2,Carmen,Lozano,1984-09-05,01940193M,carmen.lozano@brilliantdata.site,257841,ES11209564797724896921,5500.05,2023-03-28T12:28:52,Zarautz,expenses,cash,-100.0,-28374.62
buyer_2,Carmen,Lozano,1984-09-05,01940193M,carmen.lozano@brilliantdata.site,257841,ES11209564797724896921,5500.05,2023-03-29T10:03:10,Zarautz,expenses,children,-311.17,-28685.79
buyer_2,Carmen,Lozano,1984-09-05,01940193M,carmen.lozano@brilliantdata.site,257841,ES11209564797724896921,5500.05,2023-03-31T18:59:27,Zarautz,expenses,cash,-100.0,-28785.79
buyer_2,Carmen,Lozano,1984-09-05,01940193M,carmen.lozano@brilliantdata.site,257841,ES11209564797724896921,5500.05,2023-04-01T12:51:21,Zarautz,incomes,salary,2038.44,-26747.35
buyer_2,Carmen,Lozano,1984-09-05,01940193M,carmen.lozano@brilliantdata.site,257841,ES11209564797724896921,5500.05,2023-04-04T14:36:48,Zarautz,expenses,mortgage,-820.89,-27568.24
buyer_2,Carmen,Lozano,1984-09-05,01940193M,carmen.lozano@brilliantdata.site,257841,ES11209564797724896921,5500.05,2023-04-04T08:08:51,Zarautz,expenses,leisure,-29.24,-27597.48
buyer_2,Carmen,Lozano,1984-09-05,01940193M,carmen.lozano@brilliantdata.site,257841,ES11209564797724896921,5500.05,2023-04-04T17:35:57,Zarautz,expenses,cash,-100.0,-27697.48
buyer_2,Carmen,Lozano,1984-09-05,01940193M,carmen.lozano@brilliantdata.site,257841,ES11209564797724896921,5500.05,2023-04-05T10:10:28,Zarautz,expenses,water,-22.0,-27719.48
buyer_2,Carmen,Lozano,1984-09-05,01940193M,carmen.lozano@brilliantdata.site,257841,ES11209564797724896921,5500.05,2023-04-05T10:23:27,Zarautz,expenses,transport,-40.34,-27759.82
buyer_2,Carmen,Lozano,1984-09-05,01940193M,carmen.lozano@brilliantdata.site,257841,ES11209564797724896921,5500.05,2023-04-05T09:58:16,Zarautz,expenses,clothing,-84.28,-27844.1
buyer_2,Carmen,Lozano,1984-09-05,01940193M,carmen.lozano@brilliantdata.site,257841,ES11209564797724896921,5500.05,2023-04-06T12:34:24,Zarautz,expenses,electricity,-36.37,-27880.47
buyer_2,Carmen,Lozano,1984-09-05,01940193M,carmen.lozano@brilliantdata.site,257841,ES11209564797724896921,5500.05,2023-04-06T16:11:35,Zarautz,expenses,internet,-42.81,-27923.28
buyer_2,Carmen,Lozano,1984-09-05,01940193M,carmen.lozano@brilliantdata.site,257841,ES11209564797724896921,5500.05,2023-04-06T20:37:54,Zarautz,expenses,appliances,-288.96,-28212.24
buyer_2,Carmen,Lozano,1984-09-05,01940193M,carmen.lozano@brilliantdata.site,257841,ES11209564797724896921,5500.05,2023-04-07T09:14:26,Zarautz,expenses,gas,-89.47,-28301.71
buyer_2,Carmen,Lozano,1984-09-05,01940193M,carmen.lozano@brilliantdata.site,257841,ES11209564797724896921,5500.05,2023-04-08T14:32:53,Zarautz,expenses,phone,-44.11,-28345.82
buyer_2,Carmen,Lozano,1984-09-05,01940193M,carmen.lozano@brilliantdata.site,257841,ES11209564797724896921,5500.05,2023-04-08T23:11:11,Zarautz,expenses,food,-62.79,-28408.61
buyer_2,Carmen,Lozano,1984-09-05,01940193M,carmen.lozano@brilliantdata.site,257841,ES11209564797724896921,5500.05,2023-04-08T08:29:52,Zarautz,expenses,healthcare,-159.01,-28567.62
buyer_2,Carmen,Lozano,1984-09-05,01940193M,carmen.lozano@brilliantdata.site,257841,ES11209564797724896921,5500.05,2023-04-10T17:39:18,Zarautz,expenses,leisure,-18.65,-28586.27
buyer_2,Carmen,Lozano,1984-09-05,01940193M,carmen.lozano@brilliantdata.site,257841,ES11209564797724896921,5500.05,2023-04-10T09:01:22,Zarautz,expenses,education,-65.3,-28651.57
buyer_2,Carmen,Lozano,1984-09-05,01940193M,carmen.lozano@brilliantdata.site,257841,ES11209564797724896921,5500.05,2023-04-11T03:29:55,Zarautz,expenses,transport,-70.21,-28721.78
buyer_2,Carmen,Lozano,1984-09-05,01940193M,carmen.lozano@brilliantdata.site,257841,ES11209564797724896921,5500.05,2023-04-12T21:01:37,Zarautz,expenses,repairs,-188.7,-28910.48
buyer_2,Carmen,Lozano,1984-09-05,01940193M,carmen.lozano@brilliantdata.site,257841,ES11209564797724896921,5500.05,2023-04-13T09:40:28,Zarautz,expenses,food,-86.31,-28996.79
buyer_2,Carmen,Lozano,1984-09-05,01940193M,carmen.lozano@brilliantdata.site,257841,ES11209564797724896921,5500.05,2023-04-13T21:08:43,Zarautz,expenses,education,-44.41,-29041.2
buyer_2,Carmen,Lozano,1984-09-05,01940193M,carmen.lozano@brilliantdata.site,257841,ES11209564797724896921,5500.05,2023-04-13T08:37:46,Zarautz,expenses,repairs,-153.99,-29195.19
buyer_2,Carmen,Lozano,1984-09-05,01940193M,carmen.lozano@brilliantdata.site,257841,ES11209564797724896921,5500.05,2023-04-15T11:16:43,Zarautz,expenses,healthcare,-51.63,-29246.82
buyer_2,Carmen,Lozano,1984-09-05,01940193M,carmen.lozano@brilliantdata.site,257841,ES11209564797724896921,5500.05,2023-04-15T09:35:33,Zarautz,expenses,children,-591.53,-29838.35
buyer_2,Carmen,Lozano,1984-09-05,01940193M,carmen.lozano@brilliantdata.site,257841,ES11209564797724896921,5500.05,2023-04-16T08:56:46,Zarautz,expenses,transport,-64.3,-29902.65
buyer_2,Carmen,Lozano,1984-09-05,01940193M,carmen.lozano@brilliantdata.site,257841,ES11209564797724896921,5500.05,2023-04-17T10:33:22,Zarautz,expenses,travel,-631.57,-30534.22
buyer_2,Carmen,Lozano,1984-09-05,01940193M,carmen.lozano@brilliantdata.site,257841,ES11209564797724896921,5500.05,2023-04-18T23:11:23,Zarautz,expenses,children,-241.46,-30775.68
buyer_2,Carmen,Lozano,1984-09-05,01940193M,carmen.lozano@brilliantdata.site,257841,ES11209564797724896921,5500.05,2023-04-19T00:38:35,Zarautz,expenses,appliances,-165.48,-30941.16
buyer_2,Carmen,Lozano,1984-09-05,01940193M,carmen.lozano@brilliantdata.site,257841,ES11209564797724896921,5500.05,2023-04-22T10:37:06,Zarautz,expenses,food,-102.02,-31043.18
buyer_2,Carmen,Lozano,1984-09-05,01940193M,carmen.lozano@brilliantdata.site,257841,ES11209564797724896921,5500.05,2023-04-23T16:29:35,Zarautz,expenses,transport,-75.53,-31118.71
buyer_2,Carmen,Lozano,1984-09-05,01940193M,carmen.lozano@brilliantdata.site,257841,ES11209564797724896921,5500.05,2023-04-24T19:14:08,Zarautz,expenses,repairs,-241.11,-31359.82
buyer_2,Carmen,Lozano,1984-09-05,01940193M,carmen.lozano@brilliantdata.site,257841,ES11209564797724896921,5500.05,2023-04-25T17:32:11,Zarautz,expenses,gifts,-244.67,-31604.49
buyer_2,Carmen,Lozano,1984-09-05,01940193M,carmen.lozano@brilliantdata.site,257841,ES11209564797724896921,5500.05,2023-04-27T14:24:11,Zarautz,expenses,food,-119.27,-31723.76
buyer_2,Carmen,Lozano,1984-09-05,01940193M,carmen.lozano@brilliantdata.site,257841,ES11209564797724896921,5500.05,2023-05-01T23:29:41,Zarautz,incomes,salary,2038.44,-29685.32
buyer_2,Carmen,Lozano,1984-09-05,01940193M,carmen.lozano@brilliantdata.site,257841,ES11209564797724896921,5500.05,2023-05-01T23:29:41,Zarautz,incomes,extra_income,376.86,-29308.46
buyer_2,Carmen,Lozano,1984-09-05,01940193M,carmen.lozano@brilliantdata.site,257841,ES11209564797724896921,5500.05,2023-05-01T12:59:15,Zarautz,expenses,leisure,-49.59,-29358.05
buyer_2,Carmen,Lozano,1984-09-05,01940193M,carmen.lozano@brilliantdata.site,257841,ES11209564797724896921,5500.05,2023-05-01T01:30:08,Zarautz,expenses,clothing,-79.0,-29437.05
buyer_2,Carmen,Lozano,1984-09-05,01940193M,carmen.lozano@brilliantdata.site,257841,ES11209564797724896921,5500.05,2023-05-03T08:29:26,Zarautz,expenses,food,-120.1,-29557.15
buyer_2,Carmen,Lozano,1984-09-05,01940193M,carmen.lozano@brilliantdata.site,257841,ES11209564797724896921,5500.05,2023-05-04T11:42:43,Zarautz,expenses,mortgage,-820.89,-30378.04
buyer_2,Carmen,Lozano,1984-09-05,01940193M,carmen.lozano@brilliantdata.site,257841,ES11209564797724896921,5500.05,2023-05-05T10:10:09,Zarautz,expenses,gas,-59.01,-30437.05
buyer_2,Carmen,Lozano,1984-09-05,01940193M,carmen.lozano@brilliantdata.site,257841,ES11209564797724896921,5500.05,2023-05-05T18:20:13,Zarautz,expenses,phone,-41.89,-30478.94
buyer_2,Carmen,Lozano,1984-09-05,01940193M,carmen.lozano@brilliantdata.site,257841,ES11209564797724896921,5500.05,2023-05-05T08:58:10,Zarautz,expenses,cash,-100.0,-30578.94
buyer_2,Carmen,Lozano,1984-09-05,01940193M,carmen.lozano@brilliantdata.site,257841,ES11209564797724896921,5500.05,2023-05-06T13:20:15,Zarautz,expenses,electricity,-84.39,-30663.33
buyer_2,Carmen,Lozano,1984-09-05,01940193M,carmen.lozano@brilliantdata.site,257841,ES11209564797724896921,5500.05,2023-05-06T05:24:20,Zarautz,expenses,internet,-42.81,-30706.14
buyer_2,Carmen,Lozano,1984-09-05,01940193M,carmen.lozano@brilliantdata.site,257841,ES11209564797724896921,5500.05,2023-05-08T09:09:28,Zarautz,expenses,water,-23.98,-30730.12
buyer_2,Carmen,Lozano,1984-09-05,01940193M,carmen.lozano@brilliantdata.site,257841,ES11209564797724896921,5500.05,2023-05-10T23:41:33,Zarautz,expenses,children,-483.86,-31213.98
buyer_2,Carmen,Lozano,1984-09-05,01940193M,carmen.lozano@brilliantdata.site,257841,ES11209564797724896921,5500.05,2023-05-11T10:59:55,Zarautz,expenses,leisure,-50.69,-31264.67
buyer_2,Carmen,Lozano,1984-09-05,01940193M,carmen.lozano@brilliantdata.site,257841,ES11209564797724896921,5500.05,2023-05-15T11:57:02,Zarautz,expenses,clothing,-84.93,-31349.6
buyer_2,Carmen,Lozano,1984-09-05,01940193M,carmen.lozano@brilliantdata.site,257841,ES11209564797724896921,5500.05,2023-05-15T10:05:07,Zarautz,expenses,healthcare,-187.01,-31536.61
buyer_2,Carmen,Lozano,1984-09-05,01940193M,carmen.lozano@brilliantdata.site,257841,ES11209564797724896921,5500.05,2023-05-15T13:31:21,Zarautz,expenses,gifts,-168.36,-31704.97
buyer_2,Carmen,Lozano,1984-09-05,01940193M,carmen.lozano@brilliantdata.site,257841,ES11209564797724896921,5500.05,2023-05-18T13:34:52,Zarautz,expenses,food,-105.12,-31810.09
buyer_2,Carmen,Lozano,1984-09-05,01940193M,carmen.lozano@brilliantdata.site,257841,ES11209564797724896921,5500.05,2023-05-18T17:39:22,Zarautz,expenses,transport,-47.46,-31857.55
buyer_2,Carmen,Lozano,1984-09-05,01940193M,carmen.lozano@brilliantdata.site,257841,ES11209564797724896921,5500.05,2023-05-20T16:02:01,Zarautz,expenses,food,-108.52,-31966.07
buyer_2,Carmen,Lozano,1984-09-05,01940193M,carmen.lozano@brilliantdata.site,257841,ES11209564797724896921,5500.05,2023-05-20T20:58:37,Zarautz,expenses,transport,-78.23,-32044.3
buyer_2,Carmen,Lozano,1984-09-05,01940193M,carmen.lozano@brilliantdata.site,257841,ES11209564797724896921,5500.05,2023-05-21T10:24:46,Zarautz,expenses,children,-573.66,-32617.96
buyer_2,Carmen,Lozano,1984-09-05,01940193M,carmen.lozano@brilliantdata.site,257841,ES11209564797724896921,5500.05,2023-05-22T09:39:19,Zarautz,expenses,healthcare,-166.83,-32784.79
buyer_2,Carmen,Lozano,1984-09-05,01940193M,carmen.lozano@brilliantdata.site,257841,ES11209564797724896921,5500.05,2023-05-22T19:48:13,Zarautz,expenses,cash,-100.0,-32884.79
buyer_2,Carmen,Lozano,1984-09-05,01940193M,carmen.lozano@brilliantdata.site,257841,ES11209564797724896921,5500.05,2023-05-23T17:35:10,Zarautz,expenses,food,-60.12,-32944.91
buyer_2,Carmen,Lozano,1984-09-05,01940193M,carmen.lozano@brilliantdata.site,257841,ES11209564797724896921,5500.05,2023-05-23T07:20:42,Zarautz,expenses,gifts,-717.63,-33662.54
buyer_2,Carmen,Lozano,1984-09-05,01940193M,carmen.lozano@brilliantdata.site,257841,ES11209564797724896921,5500.05,2023-05-24T16:09:50,Zarautz,expenses,leisure,-52.54,-33715.08
buyer_2,Carmen,Lozano,1984-09-05,01940193M,carmen.lozano@brilliantdata.site,257841,ES11209564797724896921,5500.05,2023-05-24T04:41:42,Zarautz,expenses,gifts,-34.05,-33749.13
buyer_2,Carmen,Lozano,1984-09-05,01940193M,carmen.lozano@brilliantdata.site,257841,ES11209564797724896921,5500.05,2023-05-25T19:29:44,Zarautz,expenses,cash,-100.0,-33849.13
buyer_2,Carmen,Lozano,1984-09-05,01940193M,carmen.lozano@brilliantdata.site,257841,ES11209564797724896921,5500.05,2023-05-25T20:26:16,Zarautz,expenses,appliances,-291.23,-34140.36
buyer_2,Carmen,Lozano,1984-09-05,01940193M,carmen.lozano@brilliantdata.site,257841,ES11209564797724896921,5500.05,2023-05-26T20:17:05,Zarautz,expenses,food,-73.99,-34214.35
buyer_2,Carmen,Lozano,1984-09-05,01940193M,carmen.lozano@brilliantdata.site,257841,ES11209564797724896921,5500.05,2023-05-26T15:56:14,Zarautz,expenses,leisure,-26.1,-34240.45
buyer_2,Carmen,Lozano,1984-09-05,01940193M,carmen.lozano@brilliantdata.site,257841,ES11209564797724896921,5500.05,2023-05-26T02:10:48,Zarautz,expenses,cash,-100.0,-34340.45
buyer_2,Carmen,Lozano,1984-09-05,01940193M,carmen.lozano@brilliantdata.site,257841,ES11209564797724896921,5500.05,2023-05-28T15:32:14,Zarautz,expenses,food,-105.9,-34446.35
buyer_2,Carmen,Lozano,1984-09-05,01940193M,carmen.lozano@brilliantdata.site,257841,ES11209564797724896921,5500.05,2023-05-28T13:18:36,Zarautz,expenses,transport,-66.19,-34512.54
buyer_2,Carmen,Lozano,1984-09-05,01940193M,carmen.lozano@brilliantdata.site,257841,ES11209564797724896921,5500.05,2023-05-28T08:39:38,Zarautz,expenses,healthcare,-69.7,-34582.24
buyer_2,Carmen,Lozano,1984-09-05,01940193M,carmen.lozano@brilliantdata.site,257841,ES11209564797724896921,5500.05,2023-06-01T14:54:11,Zarautz,incomes,salary,2038.44,-32543.8
buyer_2,Carmen,Lozano,1984-09-05,01940193M,carmen.lozano@brilliantdata.site,257841,ES11209564797724896921,5500.05,2023-06-01T14:54:11,Zarautz,incomes,salary_bonus,1586.28,-30957.52
buyer_2,Carmen,Lozano,1984-09-05,01940193M,carmen.lozano@brilliantdata.site,257841,ES11209564797724896921,5500.05,2023-06-01T09:03:42,Zarautz,expenses,leisure,-63.65,-31021.17
buyer_2,Carmen,Lozano,1984-09-05,01940193M,carmen.lozano@brilliantdata.site,257841,ES11209564797724896921,5500.05,2023-06-02T18:21:13,Zarautz,expenses,food,-94.33,-31115.5
buyer_2,Carmen,Lozano,1984-09-05,01940193M,carmen.lozano@brilliantdata.site,257841,ES11209564797724896921,5500.05,2023-06-03T15:44:03,Zarautz,expenses,gifts,-761.78,-31877.28
buyer_2,Carmen,Lozano,1984-09-05,01940193M,carmen.lozano@brilliantdata.site,257841,ES11209564797724896921,5500.05,2023-06-04T20:38:52,Zarautz,expenses,mortgage,-820.89,-32698.17
buyer_2,Carmen,Lozano,1984-09-05,01940193M,carmen.lozano@brilliantdata.site,257841,ES11209564797724896921,5500.05,2023-06-04T20:57:41,Zarautz,expenses,gifts,-497.45,-33195.62
buyer_2,Carmen,Lozano,1984-09-05,01940193M,carmen.lozano@brilliantdata.site,257841,ES11209564797724896921,5500.05,2023-06-05T16:41:02,Zarautz,expenses,water,-41.74,-33237.36
buyer_2,Carmen,Lozano,1984-09-05,01940193M,carmen.lozano@brilliantdata.site,257841,ES11209564797724896921,5500.05,2023-06-05T11:28:58,Zarautz,expenses,internet,-42.81,-33280.17
buyer_2,Carmen,Lozano,1984-09-05,01940193M,carmen.lozano@brilliantdata.site,257841,ES11209564797724896921,5500.05,2023-06-05T19:35:28,Zarautz,expenses,phone,-38.95,-33319.12
buyer_2,Carmen,Lozano,1984-09-05,01940193M,carmen.lozano@brilliantdata.site,257841,ES11209564797724896921,5500.05,2023-06-05T11:47:14,Zarautz,expenses,education,-73.04,-33392.16
buyer_2,Carmen,Lozano,1984-09-05,01940193M,carmen.lozano@brilliantdata.site,257841,ES11209564797724896921,5500.05,2023-06-06T10:21:23,Zarautz,expenses,cash,-100.0,-33492.16
buyer_2,Carmen,Lozano,1984-09-05,01940193M,carmen.lozano@brilliantdata.site,257841,ES11209564797724896921,5500.05,2023-06-07T13:38:50,Zarautz,expenses,electricity,-70.18,-33562.34
buyer_2,Carmen,Lozano,1984-09-05,01940193M,carmen.lozano@brilliantdata.site,257841,ES11209564797724896921,5500.05,2023-06-08T19:09:08,Zarautz,expenses,gas,-62.74,-33625.08
buyer_2,Carmen,Lozano,1984-09-05,01940193M,carmen.lozano@brilliantdata.site,257841,ES11209564797724896921,5500.05,2023-06-08T18:39:47,Zarautz,expenses,cash,-100.0,-33725.08
buyer_2,Carmen,Lozano,1984-09-05,01940193M,carmen.lozano@brilliantdata.site,257841,ES11209564797724896921,5500.05,2023-06-10T23:36:24,Zarautz,expenses,leisure,-48.55,-33773.63
buyer_2,Carmen,Lozano,1984-09-05,01940193M,carmen.lozano@brilliantdata.site,257841,ES11209564797724896921,5500.05,2023-06-11T12:17:16,Zarautz,expenses,food,-78.75,-33852.38
buyer_2,Carmen,Lozano,1984-09-05,01940193M,carmen.lozano@brilliantdata.site,257841,ES11209564797724896921,5500.05,2023-06-13T21:58:14,Zarautz,expenses,gifts,-583.19,-34435.57
buyer_2,Carmen,Lozano,1984-09-05,01940193M,carmen.lozano@brilliantdata.site,257841,ES11209564797724896921,5500.05,2023-06-15T14:57:08,Zarautz,expenses,food,-102.49,-34538.06
buyer_2,Carmen,Lozano,1984-09-05,01940193M,carmen.lozano@brilliantdata.site,257841,ES11209564797724896921,5500.05,2023-06-15T10:48:32,Zarautz,expenses,gifts,-769.89,-35307.95
buyer_2,Carmen,Lozano,1984-09-05,01940193M,carmen.lozano@brilliantdata.site,257841,ES11209564797724896921,5500.05,2023-06-16T10:37:56,Zarautz,expenses,transport,-89.37,-35397.32
buyer_2,Carmen,Lozano,1984-09-05,01940193M,carmen.lozano@brilliantdata.site,257841,ES11209564797724896921,5500.05,2023-06-16T12:01:38,Zarautz,expenses,cash,-100.0,-35497.32
buyer_2,Carmen,Lozano,1984-09-05,01940193M,carmen.lozano@brilliantdata.site,257841,ES11209564797724896921,5500.05,2023-06-17T19:12:09,Zarautz,expenses,leisure,-79.41,-35576.73
buyer_2,Carmen,Lozano,1984-09-05,01940193M,carmen.lozano@brilliantdata.site,257841,ES11209564797724896921,5500.05,2023-06-18T00:01:31,Zarautz,expenses,food,-69.22,-35645.95
buyer_2,Carmen,Lozano,1984-09-05,01940193M,carmen.lozano@brilliantdata.site,257841,ES11209564797724896921,5500.05,2023-06-20T15:34:09,Zarautz,expenses,food,-95.1,-35741.05
buyer_2,Carmen,Lozano,1984-09-05,01940193M,carmen.lozano@brilliantdata.site,257841,ES11209564797724896921,5500.05,2023-06-20T16:27:14,Zarautz,expenses,cash,-100.0,-35841.05
buyer_2,Carmen,Lozano,1984-09-05,01940193M,carmen.lozano@brilliantdata.site,257841,ES11209564797724896921,5500.05,2023-06-22T10:40:07,Zarautz,expenses,clothing,-108.87,-35949.92
buyer_2,Carmen,Lozano,1984-09-05,01940193M,carmen.lozano@brilliantdata.site,257841,ES11209564797724896921,5500.05,2023-06-23T10:29:09,Zarautz,expenses,food,-98.12,-36048.04
buyer_2,Carmen,Lozano,1984-09-05,01940193M,carmen.lozano@brilliantdata.site,257841,ES11209564797724896921,5500.05,2023-06-23T10:44:11,Zarautz,expenses,cash,-100.0,-36148.04
buyer_2,Carmen,Lozano,1984-09-05,01940193M,carmen.lozano@brilliantdata.site,257841,ES11209564797724896921,5500.05,2023-06-24T19:14:15,Zarautz,expenses,food,-79.17,-36227.21
buyer_2,Carmen,Lozano,1984-09-05,01940193M,carmen.lozano@brilliantdata.site,257841,ES11209564797724896921,5500.05,2023-06-24T20:09:33,Zarautz,expenses,transport,-46.92,-36274.13
buyer_2,Carmen,Lozano,1984-09-05,01940193M,carmen.lozano@brilliantdata.site,257841,ES11209564797724896921,5500.05,2023-06-24T10:05:14,Zarautz,expenses,leisure,-32.37,-36306.5
buyer_2,Carmen,Lozano,1984-09-05,01940193M,carmen.lozano@brilliantdata.site,257841,ES11209564797724896921,5500.05,2023-06-25T17:24:45,Zarautz,expenses,repairs,-321.82,-36628.32
buyer_2,Carmen,Lozano,1984-09-05,01940193M,carmen.lozano@brilliantdata.site,257841,ES11209564797724896921,5500.05,2023-06-26T18:32:00,Zarautz,expenses,transport,-86.13,-36714.45
buyer_2,Carmen,Lozano,1984-09-05,01940193M,carmen.lozano@brilliantdata.site,257841,ES11209564797724896921,5500.05,2023-06-27T08:50:05,Zarautz,expenses,cash,-100.0,-36814.45
buyer_2,Carmen,Lozano,1984-09-05,01940193M,carmen.lozano@brilliantdata.site,257841,ES11209564797724896921,5500.05,2023-06-29T14:29:26,Zarautz,expenses,education,-77.87,-36892.32
buyer_2,Carmen,Lozano,1984-09-05,01940193M,carmen.lozano@brilliantdata.site,257841,ES11209564797724896921,5500.05,2023-06-29T11:15:38,Zarautz,expenses,children,-214.86,-37107.18
buyer_2,Carmen,Lozano,1984-09-05,01940193M,carmen.lozano@brilliantdata.site,257841,ES11209564797724896921,5500.05,2023-06-30T14:43:23,Zarautz,expenses,appliances,-196.86,-37304.04
buyer_2,Carmen,Lozano,1984-09-05,01940193M,carmen.lozano@brilliantdata.site,257841,ES11209564797724896921,5500.05,2023-07-01T15:30:36,Zarautz,incomes,salary,2038.44,-35265.6
buyer_2,Carmen,Lozano,1984-09-05,01940193M,carmen.lozano@brilliantdata.site,257841,ES11209564797724896921,5500.05,2023-07-01T09:06:35,Zarautz,expenses,gifts,-531.6,-35797.2
buyer_2,Carmen,Lozano,1984-09-05,01940193M,carmen.lozano@brilliantdata.site,257841,ES11209564797724896921,5500.05,2023-07-02T17:29:07,Zarautz,expenses,cash,-100.0,-35897.2
buyer_2,Carmen,Lozano,1984-09-05,01940193M,carmen.lozano@brilliantdata.site,257841,ES11209564797724896921,5500.05,2023-07-02T01:39:03,Zarautz,expenses,repairs,-252.45,-36149.65
buyer_2,Carmen,Lozano,1984-09-05,01940193M,carmen.lozano@brilliantdata.site,257841,ES11209564797724896921,5500.05,2023-07-03T15:24:52,Zarautz,expenses,food,-108.27,-36257.92
buyer_2,Carmen,Lozano,1984-09-05,01940193M,carmen.lozano@brilliantdata.site,257841,ES11209564797724896921,5500.05,2023-07-04T14:08:25,Zarautz,expenses,mortgage,-820.89,-37078.81
buyer_2,Carmen,Lozano,1984-09-05,01940193M,carmen.lozano@brilliantdata.site,257841,ES11209564797724896921,5500.05,2023-07-04T19:26:48,Zarautz,expenses,children,-227.86,-37306.67
buyer_2,Carmen,Lozano,1984-09-05,01940193M,carmen.lozano@brilliantdata.site,257841,ES11209564797724896921,5500.05,2023-07-05T18:56:06,Zarautz,expenses,water,-45.85,-37352.52
buyer_2,Carmen,Lozano,1984-09-05,01940193M,carmen.lozano@brilliantdata.site,257841,ES11209564797724896921,5500.05,2023-07-05T16:59:36,Zarautz,expenses,electricity,-75.99,-37428.51
buyer_2,Carmen,Lozano,1984-09-05,01940193M,carmen.lozano@brilliantdata.site,257841,ES11209564797724896921,5500.05,2023-07-06T15:54:08,Zarautz,expenses,internet,-42.81,-37471.32
buyer_2,Carmen,Lozano,1984-09-05,01940193M,carmen.lozano@brilliantdata.site,257841,ES11209564797724896921,5500.05,2023-07-07T22:07:07,Zarautz,expenses,phone,-40.34,-37511.66
buyer_2,Carmen,Lozano,1984-09-05,01940193M,carmen.lozano@brilliantdata.site,257841,ES11209564797724896921,5500.05,2023-07-07T13:00:20,Zarautz,expenses,transport,-56.54,-37568.2
buyer_2,Carmen,Lozano,1984-09-05,01940193M,carmen.lozano@brilliantdata.site,257841,ES11209564797724896921,5500.05,2023-07-07T22:12:23,Zarautz,expenses,cash,-100.0,-37668.2
buyer_2,Carmen,Lozano,1984-09-05,01940193M,carmen.lozano@brilliantdata.site,257841,ES11209564797724896921,5500.05,2023-07-08T20:26:50,Zarautz,expenses,gas,-87.08,-37755.28
buyer_2,Carmen,Lozano,1984-09-05,01940193M,carmen.lozano@brilliantdata.site,257841,ES11209564797724896921,5500.05,2023-07-08T15:37:46,Zarautz,expenses,leisure,-80.56,-37835.84
buyer_2,Carmen,Lozano,1984-09-05,01940193M,carmen.lozano@brilliantdata.site,257841,ES11209564797724896921,5500.05,2023-07-10T08:12:24,Zarautz,expenses,cash,-100.0,-37935.84
buyer_2,Carmen,Lozano,1984-09-05,01940193M,carmen.lozano@brilliantdata.site,257841,ES11209564797724896921,5500.05,2023-07-14T23:36:27,Zarautz,expenses,cash,-100.0,-38035.84
buyer_2,Carmen,Lozano,1984-09-05,01940193M,carmen.lozano@brilliantdata.site,257841,ES11209564797724896921,5500.05,2023-07-15T17:27:54,Zarautz,expenses,cash,-100.0,-38135.84
buyer_2,Carmen,Lozano,1984-09-05,01940193M,carmen.lozano@brilliantdata.site,257841,ES11209564797724896921,5500.05,2023-07-16T11:30:00,Zarautz,expenses,transport,-67.38,-38203.22
buyer_2,Carmen,Lozano,1984-09-05,01940193M,carmen.lozano@brilliantdata.site,257841,ES11209564797724896921,5500.05,2023-07-16T12:07:26,Zarautz,expenses,repairs,-196.01,-38399.23
buyer_2,Carmen,Lozano,1984-09-05,01940193M,carmen.lozano@brilliantdata.site,257841,ES11209564797724896921,5500.05,2023-07-18T09:28:23,Zarautz,expenses,transport,-72.77,-38472.0
buyer_2,Carmen,Lozano,1984-09-05,01940193M,carmen.lozano@brilliantdata.site,257841,ES11209564797724896921,5500.05,2023-07-19T15:32:10,Zarautz,expenses,appliances,-133.81,-38605.81
buyer_2,Carmen,Lozano,1984-09-05,01940193M,carmen.lozano@brilliantdata.site,257841,ES11209564797724896921,5500.05,2023-07-20T15:54:12,Zarautz,expenses,healthcare,-183.22,-38789.03
buyer_2,Carmen,Lozano,1984-09-05,01940193M,carmen.lozano@brilliantdata.site,257841,ES11209564797724896921,5500.05,2023-07-20T18:55:57,Zarautz,expenses,cash,-100.0,-38889.03
buyer_2,Carmen,Lozano,1984-09-05,01940193M,carmen.lozano@brilliantdata.site,257841,ES11209564797724896921,5500.05,2023-07-20T18:37:55,Zarautz,expenses,gifts,-93.93,-38982.96
buyer_2,Carmen,Lozano,1984-09-05,01940193M,carmen.lozano@brilliantdata.site,257841,ES11209564797724896921,5500.05,2023-07-21T12:24:36,Zarautz,expenses,cash,-100.0,-39082.96
buyer_2,Carmen,Lozano,1984-09-05,01940193M,carmen.lozano@brilliantdata.site,257841,ES11209564797724896921,5500.05,2023-07-22T13:21:09,Zarautz,expenses,cash,-100.0,-39182.96
buyer_2,Carmen,Lozano,1984-09-05,01940193M,carmen.lozano@brilliantdata.site,257841,ES11209564797724896921,5500.05,2023-07-22T14:05:09,Zarautz,expenses,children,-673.53,-39856.49
buyer_2,Carmen,Lozano,1984-09-05,01940193M,carmen.lozano@brilliantdata.site,257841,ES11209564797724896921,5500.05,2023-07-23T09:15:43,Zarautz,expenses,leisure,-33.73,-39890.22
buyer_2,Carmen,Lozano,1984-09-05,01940193M,carmen.lozano@brilliantdata.site,257841,ES11209564797724896921,5500.05,2023-07-23T18:26:47,Zarautz,expenses,cash,-100.0,-39990.22
buyer_2,Carmen,Lozano,1984-09-05,01940193M,carmen.lozano@brilliantdata.site,257841,ES11209564797724896921,5500.05,2023-07-24T16:05:52,Zarautz,expenses,cash,-100.0,-40090.22
buyer_2,Carmen,Lozano,1984-09-05,01940193M,carmen.lozano@brilliantdata.site,257841,ES11209564797724896921,5500.05,2023-07-25T16:48:16,Zarautz,expenses,cash,-100.0,-40190.22
buyer_2,Carmen,Lozano,1984-09-05,01940193M,carmen.lozano@brilliantdata.site,257841,ES11209564797724896921,5500.05,2023-07-26T18:16:30,Zarautz,expenses,leisure,-31.15,-40221.37
buyer_2,Carmen,Lozano,1984-09-05,01940193M,carmen.lozano@brilliantdata.site,257841,ES11209564797724896921,5500.05,2023-07-26T10:05:53,Zarautz,expenses,repairs,-265.43,-40486.8
buyer_2,Carmen,Lozano,1984-09-05,01940193M,carmen.lozano@brilliantdata.site,257841,ES11209564797724896921,5500.05,2023-07-27T15:59:03,Zarautz,expenses,leisure,-35.47,-40522.27
buyer_2,Carmen,Lozano,1984-09-05,01940193M,carmen.lozano@brilliantdata.site,257841,ES11209564797724896921,5500.05,2023-07-27T17:00:59,Zarautz,expenses,cash,-100.0,-40622.27
buyer_2,Carmen,Lozano,1984-09-05,01940193M,carmen.lozano@brilliantdata.site,257841,ES11209564797724896921,5500.05,2023-07-31T16:36:54,Zarautz,expenses,gifts,-453.42,-41075.69
buyer_2,Carmen,Lozano,1984-09-05,01940193M,carmen.lozano@brilliantdata.site,257841,ES11209564797724896921,5500.05,2023-08-01T10:20:03,Zarautz,incomes,salary,2038.44,-39037.25
buyer_2,Carmen,Lozano,1984-09-05,01940193M,carmen.lozano@brilliantdata.site,257841,ES11209564797724896921,5500.05,2023-08-01T10:20:03,Zarautz,incomes,extra_income,376.86,-38660.39
buyer_2,Carmen,Lozano,1984-09-05,01940193M,carmen.lozano@brilliantdata.site,257841,ES11209564797724896921,5500.05,2023-08-01T20:02:24,Zarautz,expenses,cash,-100.0,-38760.39
buyer_2,Carmen,Lozano,1984-09-05,01940193M,carmen.lozano@brilliantdata.site,257841,ES11209564797724896921,5500.05,2023-08-01T08:35:53,Zarautz,expenses,gifts,-619.5,-39379.89
buyer_2,Carmen,Lozano,1984-09-05,01940193M,carmen.lozano@brilliantdata.site,257841,ES11209564797724896921,5500.05,2023-08-02T09:03:28,Zarautz,expenses,transport,-60.56,-39440.45
buyer_2,Carmen,Lozano,1984-09-05,01940193M,carmen.lozano@brilliantdata.site,257841,ES11209564797724896921,5500.05,2023-08-03T09:47:21,Zarautz,expenses,food,-72.39,-39512.84
buyer_2,Carmen,Lozano,1984-09-05,01940193M,carmen.lozano@brilliantdata.site,257841,ES11209564797724896921,5500.05,2023-08-04T11:21:37,Zarautz,expenses,mortgage,-820.89,-40333.73
buyer_2,Carmen,Lozano,1984-09-05,01940193M,carmen.lozano@brilliantdata.site,257841,ES11209564797724896921,5500.05,2023-08-05T13:18:52,Zarautz,expenses,water,-30.67,-40364.4
buyer_2,Carmen,Lozano,1984-09-05,01940193M,carmen.lozano@brilliantdata.site,257841,ES11209564797724896921,5500.05,2023-08-05T18:10:21,Zarautz,expenses,gas,-41.23,-40405.63
buyer_2,Carmen,Lozano,1984-09-05,01940193M,carmen.lozano@brilliantdata.site,257841,ES11209564797724896921,5500.05,2023-08-05T18:13:10,Zarautz,expenses,phone,-42.17,-40447.8
buyer_2,Carmen,Lozano,1984-09-05,01940193M,carmen.lozano@brilliantdata.site,257841,ES11209564797724896921,5500.05,2023-08-05T18:11:07,Zarautz,expenses,clothing,-85.43,-40533.23
buyer_2,Carmen,Lozano,1984-09-05,01940193M,carmen.lozano@brilliantdata.site,257841,ES11209564797724896921,5500.05,2023-08-05T06:40:32,Zarautz,expenses,education,-75.11,-40608.34
buyer_2,Carmen,Lozano,1984-09-05,01940193M,carmen.lozano@brilliantdata.site,257841,ES11209564797724896921,5500.05,2023-08-06T19:45:41,Zarautz,expenses,transport,-73.12,-40681.46
buyer_2,Carmen,Lozano,1984-09-05,01940193M,carmen.lozano@brilliantdata.site,257841,ES11209564797724896921,5500.05,2023-08-06T10:03:27,Zarautz,expenses,cash,-100.0,-40781.46
buyer_2,Carmen,Lozano,1984-09-05,01940193M,carmen.lozano@brilliantdata.site,257841,ES11209564797724896921,5500.05,2023-08-06T10:35:13,Zarautz,expenses,children,-522.29,-41303.75
buyer_2,Carmen,Lozano,1984-09-05,01940193M,carmen.lozano@brilliantdata.site,257841,ES11209564797724896921,5500.05,2023-08-07T15:27:20,Zarautz,expenses,electricity,-76.64,-41380.39
buyer_2,Carmen,Lozano,1984-09-05,01940193M,carmen.lozano@brilliantdata.site,257841,ES11209564797724896921,5500.05,2023-08-07T23:00:29,Zarautz,expenses,cash,-100.0,-41480.39
buyer_2,Carmen,Lozano,1984-09-05,01940193M,carmen.lozano@brilliantdata.site,257841,ES11209564797724896921,5500.05,2023-08-07T17:11:31,Zarautz,expenses,gifts,-571.76,-42052.15
buyer_2,Carmen,Lozano,1984-09-05,01940193M,carmen.lozano@brilliantdata.site,257841,ES11209564797724896921,5500.05,2023-08-08T16:20:44,Zarautz,expenses,internet,-42.81,-42094.96
buyer_2,Carmen,Lozano,1984-09-05,01940193M,carmen.lozano@brilliantdata.site,257841,ES11209564797724896921,5500.05,2023-08-10T10:46:15,Zarautz,expenses,food,-114.48,-42209.44
buyer_2,Carmen,Lozano,1984-09-05,01940193M,carmen.lozano@brilliantdata.site,257841,ES11209564797724896921,5500.05,2023-08-10T08:29:01,Zarautz,expenses,repairs,-235.81,-42445.25
buyer_2,Carmen,Lozano,1984-09-05,01940193M,carmen.lozano@brilliantdata.site,257841,ES11209564797724896921,5500.05,2023-08-10T13:57:55,Zarautz,expenses,children,-552.7834166666669,-42998.03
buyer_2,Carmen,Lozano,1984-09-05,01940193M,carmen.lozano@brilliantdata.site,257841,ES11209564797724896921,5500.05,2023-08-13T09:35:00,Zarautz,expenses,education,-47.96,-43045.99
buyer_2,Carmen,Lozano,1984-09-05,01940193M,carmen.lozano@brilliantdata.site,257841,ES11209564797724896921,5500.05,2023-08-16T20:15:33,Zarautz,expenses,cash,-100.0,-43145.99
buyer_2,Carmen,Lozano,1984-09-05,01940193M,carmen.lozano@brilliantdata.site,257841,ES11209564797724896921,5500.05,2023-08-17T11:55:10,Zarautz,expenses,transport,-69.58,-43215.57
buyer_2,Carmen,Lozano,1984-09-05,01940193M,carmen.lozano@brilliantdata.site,257841,ES11209564797724896921,5500.05,2023-08-17T15:55:20,Zarautz,expenses,gifts,-300.61,-43516.18
buyer_2,Carmen,Lozano,1984-09-05,01940193M,carmen.lozano@brilliantdata.site,257841,ES11209564797724896921,5500.05,2023-08-18T09:33:57,Zarautz,expenses,gifts,-277.37,-43793.55
buyer_2,Carmen,Lozano,1984-09-05,01940193M,carmen.lozano@brilliantdata.site,257841,ES11209564797724896921,5500.05,2023-08-22T20:48:45,Zarautz,expenses,transport,-84.22,-43877.77
buyer_2,Carmen,Lozano,1984-09-05,01940193M,carmen.lozano@brilliantdata.site,257841,ES11209564797724896921,5500.05,2023-08-22T18:50:00,Zarautz,expenses,clothing,-106.3,-43984.07
buyer_2,Carmen,Lozano,1984-09-05,01940193M,carmen.lozano@brilliantdata.site,257841,ES11209564797724896921,5500.05,2023-08-24T18:51:57,Zarautz,expenses,leisure,-66.03,-44050.1
buyer_2,Carmen,Lozano,1984-09-05,01940193M,carmen.lozano@brilliantdata.site,257841,ES11209564797724896921,5500.05,2023-08-26T00:57:31,Zarautz,expenses,leisure,-19.4,-44069.5
buyer_2,Carmen,Lozano,1984-09-05,01940193M,carmen.lozano@brilliantdata.site,257841,ES11209564797724896921,5500.05,2023-08-27T18:05:10,Zarautz,expenses,food,-85.68,-44155.18
buyer_2,Carmen,Lozano,1984-09-05,01940193M,carmen.lozano@brilliantdata.site,257841,ES11209564797724896921,5500.05,2023-08-29T14:12:22,Zarautz,expenses,cash,-100.0,-44255.18
buyer_2,Carmen,Lozano,1984-09-05,01940193M,carmen.lozano@brilliantdata.site,257841,ES11209564797724896921,5500.05,2023-08-30T23:33:30,Zarautz,expenses,cash,-100.0,-44355.18
buyer_2,Carmen,Lozano,1984-09-05,01940193M,carmen.lozano@brilliantdata.site,257841,ES11209564797724896921,5500.05,2023-09-01T16:48:15,Zarautz,incomes,salary,2038.44,-42316.74
buyer_2,Carmen,Lozano,1984-09-05,01940193M,carmen.lozano@brilliantdata.site,257841,ES11209564797724896921,5500.05,2023-09-02T15:07:56,Zarautz,expenses,cash,-100.0,-42416.74
buyer_2,Carmen,Lozano,1984-09-05,01940193M,carmen.lozano@brilliantdata.site,257841,ES11209564797724896921,5500.05,2023-09-03T21:05:10,Zarautz,expenses,appliances,-253.98,-42670.72
buyer_2,Carmen,Lozano,1984-09-05,01940193M,carmen.lozano@brilliantdata.site,257841,ES11209564797724896921,5500.05,2023-09-04T09:39:42,Zarautz,expenses,mortgage,-820.89,-43491.61
buyer_2,Carmen,Lozano,1984-09-05,01940193M,carmen.lozano@brilliantdata.site,257841,ES11209564797724896921,5500.05,2023-09-04T10:24:59,Zarautz,expenses,gifts,-232.09,-43723.7
buyer_2,Carmen,Lozano,1984-09-05,01940193M,carmen.lozano@brilliantdata.site,257841,ES11209564797724896921,5500.05,2023-09-05T14:54:41,Zarautz,expenses,gas,-73.89,-43797.59
buyer_2,Carmen,Lozano,1984-09-05,01940193M,carmen.lozano@brilliantdata.site,257841,ES11209564797724896921,5500.05,2023-09-05T19:45:27,Zarautz,expenses,children,-442.05,-44239.64
buyer_2,Carmen,Lozano,1984-09-05,01940193M,carmen.lozano@brilliantdata.site,257841,ES11209564797724896921,5500.05,2023-09-06T14:34:49,Zarautz,expenses,water,-39.16,-44278.8
buyer_2,Carmen,Lozano,1984-09-05,01940193M,carmen.lozano@brilliantdata.site,257841,ES11209564797724896921,5500.05,2023-09-06T11:26:34,Zarautz,expenses,internet,-42.81,-44321.61
buyer_2,Carmen,Lozano,1984-09-05,01940193M,carmen.lozano@brilliantdata.site,257841,ES11209564797724896921,5500.05,2023-09-07T16:59:46,Zarautz,expenses,electricity,-60.13,-44381.74
buyer_2,Carmen,Lozano,1984-09-05,01940193M,carmen.lozano@brilliantdata.site,257841,ES11209564797724896921,5500.05,2023-09-07T19:04:15,Zarautz,expenses,phone,-41.1,-44422.84
buyer_2,Carmen,Lozano,1984-09-05,01940193M,carmen.lozano@brilliantdata.site,257841,ES11209564797724896921,5500.05,2023-09-07T12:01:27,Zarautz,expenses,transport,-69.97,-44492.81
buyer_2,Carmen,Lozano,1984-09-05,01940193M,carmen.lozano@brilliantdata.site,257841,ES11209564797724896921,5500.05,2023-09-07T16:03:28,Zarautz,expenses,clothing,-117.43,-44610.24
buyer_2,Carmen,Lozano,1984-09-05,01940193M,carmen.lozano@brilliantdata.site,257841,ES11209564797724896921,5500.05,2023-09-07T07:25:08,Zarautz,expenses,appliances,-77.62,-44687.86
buyer_2,Carmen,Lozano,1984-09-05,01940193M,carmen.lozano@brilliantdata.site,257841,ES11209564797724896921,5500.05,2023-09-08T15:22:01,Zarautz,expenses,transport,-59.61,-44747.47
buyer_2,Carmen,Lozano,1984-09-05,01940193M,carmen.lozano@brilliantdata.site,257841,ES11209564797724896921,5500.05,2023-09-08T12:42:29,Zarautz,expenses,repairs,-201.08,-44948.55
buyer_2,Carmen,Lozano,1984-09-05,01940193M,carmen.lozano@brilliantdata.site,257841,ES11209564797724896921,5500.05,2023-09-09T22:13:40,Zarautz,expenses,travel,-392.6,-45341.15
buyer_2,Carmen,Lozano,1984-09-05,01940193M,carmen.lozano@brilliantdata.site,257841,ES11209564797724896921,5500.05,2023-09-10T09:10:50,Zarautz,expenses,transport,-59.44,-45400.59
buyer_2,Carmen,Lozano,1984-09-05,01940193M,carmen.lozano@brilliantdata.site,257841,ES11209564797724896921,5500.05,2023-09-11T21:16:07,Zarautz,expenses,food,-118.18,-45518.77
buyer_2,Carmen,Lozano,1984-09-05,01940193M,carmen.lozano@brilliantdata.site,257841,ES11209564797724896921,5500.05,2023-09-15T19:10:56,Zarautz,expenses,transport,-86.37,-45605.14
buyer_2,Carmen,Lozano,1984-09-05,01940193M,carmen.lozano@brilliantdata.site,257841,ES11209564797724896921,5500.05,2023-09-15T19:38:12,Zarautz,expenses,gifts,-390.25,-45995.39
buyer_2,Carmen,Lozano,1984-09-05,01940193M,carmen.lozano@brilliantdata.site,257841,ES11209564797724896921,5500.05,2023-09-16T06:25:10,Zarautz,expenses,leisure,-45.93,-46041.32
buyer_2,Carmen,Lozano,1984-09-05,01940193M,carmen.lozano@brilliantdata.site,257841,ES11209564797724896921,5500.05,2023-09-16T09:34:45,Zarautz,expenses,clothing,-82.29,-46123.61
buyer_2,Carmen,Lozano,1984-09-05,01940193M,carmen.lozano@brilliantdata.site,257841,ES11209564797724896921,5500.05,2023-09-17T05:59:57,Zarautz,expenses,transport,-53.51,-46177.12
buyer_2,Carmen,Lozano,1984-09-05,01940193M,carmen.lozano@brilliantdata.site,257841,ES11209564797724896921,5500.05,2023-09-17T15:18:29,Zarautz,expenses,leisure,-40.53,-46217.65
buyer_2,Carmen,Lozano,1984-09-05,01940193M,carmen.lozano@brilliantdata.site,257841,ES11209564797724896921,5500.05,2023-09-19T04:03:32,Zarautz,expenses,repairs,-176.48,-46394.13
buyer_2,Carmen,Lozano,1984-09-05,01940193M,carmen.lozano@brilliantdata.site,257841,ES11209564797724896921,5500.05,2023-09-20T16:17:06,Zarautz,expenses,education,-55.04,-46449.17
buyer_2,Carmen,Lozano,1984-09-05,01940193M,carmen.lozano@brilliantdata.site,257841,ES11209564797724896921,5500.05,2023-09-22T17:20:19,Zarautz,expenses,food,-85.46,-46534.63
buyer_2,Carmen,Lozano,1984-09-05,01940193M,carmen.lozano@brilliantdata.site,257841,ES11209564797724896921,5500.05,2023-09-22T11:07:15,Zarautz,expenses,transport,-58.65,-46593.28
buyer_2,Carmen,Lozano,1984-09-05,01940193M,carmen.lozano@brilliantdata.site,257841,ES11209564797724896921,5500.05,2023-09-23T08:46:22,Zarautz,expenses,transport,-76.8,-46670.08
buyer_2,Carmen,Lozano,1984-09-05,01940193M,carmen.lozano@brilliantdata.site,257841,ES11209564797724896921,5500.05,2023-09-24T14:51:16,Zarautz,expenses,transport,-40.01,-46710.09
buyer_2,Carmen,Lozano,1984-09-05,01940193M,carmen.lozano@brilliantdata.site,257841,ES11209564797724896921,5500.05,2023-09-26T15:38:37,Zarautz,expenses,leisure,-78.73,-46788.82
buyer_2,Carmen,Lozano,1984-09-05,01940193M,carmen.lozano@brilliantdata.site,257841,ES11209564797724896921,5500.05,2023-09-26T18:51:43,Zarautz,expenses,cash,-100.0,-46888.82
buyer_2,Carmen,Lozano,1984-09-05,01940193M,carmen.lozano@brilliantdata.site,257841,ES11209564797724896921,5500.05,2023-09-27T11:28:11,Zarautz,expenses,food,-71.27,-46960.09
buyer_2,Carmen,Lozano,1984-09-05,01940193M,carmen.lozano@brilliantdata.site,257841,ES11209564797724896921,5500.05,2023-09-27T16:28:19,Zarautz,expenses,leisure,-27.37,-46987.46
buyer_2,Carmen,Lozano,1984-09-05,01940193M,carmen.lozano@brilliantdata.site,257841,ES11209564797724896921,5500.05,2023-09-29T11:11:07,Zarautz,expenses,appliances,-303.07,-47290.53
buyer_2,Carmen,Lozano,1984-09-05,01940193M,carmen.lozano@brilliantdata.site,257841,ES11209564797724896921,5500.05,2023-09-29T05:44:45,Zarautz,expenses,children,-186.47,-47477.0
buyer_2,Carmen,Lozano,1984-09-05,01940193M,carmen.lozano@brilliantdata.site,257841,ES11209564797724896921,5500.05,2023-09-30T19:25:55,Zarautz,expenses,travel,-373.65,-47850.65
buyer_2,Carmen,Lozano,1984-09-05,01940193M,carmen.lozano@brilliantdata.site,257841,ES11209564797724896921,5500.05,2023-10-01T15:37:50,Zarautz,incomes,salary,2038.44,-45812.21
buyer_2,Carmen,Lozano,1984-09-05,01940193M,carmen.lozano@brilliantdata.site,257841,ES11209564797724896921,5500.05,2023-10-01T12:51:41,Zarautz,expenses,cash,-100.0,-45912.21
buyer_2,Carmen,Lozano,1984-09-05,01940193M,carmen.lozano@brilliantdata.site,257841,ES11209564797724896921,5500.05,2023-10-03T22:54:44,Zarautz,expenses,clothing,-142.33,-46054.54
buyer_2,Carmen,Lozano,1984-09-05,01940193M,carmen.lozano@brilliantdata.site,257841,ES11209564797724896921,5500.05,2023-10-04T13:28:53,Zarautz,expenses,mortgage,-820.89,-46875.43
buyer_2,Carmen,Lozano,1984-09-05,01940193M,carmen.lozano@brilliantdata.site,257841,ES11209564797724896921,5500.05,2023-10-05T14:17:02,Zarautz,expenses,food,-123.42,-46998.85
buyer_2,Carmen,Lozano,1984-09-05,01940193M,carmen.lozano@brilliantdata.site,257841,ES11209564797724896921,5500.05,2023-10-05T20:16:08,Zarautz,expenses,transport,-71.96,-47070.81
buyer_2,Carmen,Lozano,1984-09-05,01940193M,carmen.lozano@brilliantdata.site,257841,ES11209564797724896921,5500.05,2023-10-05T14:06:53,Zarautz,expenses,education,-66.12,-47136.93
buyer_2,Carmen,Lozano,1984-09-05,01940193M,carmen.lozano@brilliantdata.site,257841,ES11209564797724896921,5500.05,2023-10-06T10:18:18,Zarautz,expenses,transport,-48.74,-47185.67
buyer_2,Carmen,Lozano,1984-09-05,01940193M,carmen.lozano@brilliantdata.site,257841,ES11209564797724896921,5500.05,2023-10-06T22:31:28,Zarautz,expenses,gifts,-216.16,-47401.83
buyer_2,Carmen,Lozano,1984-09-05,01940193M,carmen.lozano@brilliantdata.site,257841,ES11209564797724896921,5500.05,2023-10-07T20:44:45,Zarautz,expenses,internet,-42.81,-47444.64
buyer_2,Carmen,Lozano,1984-09-05,01940193M,carmen.lozano@brilliantdata.site,257841,ES11209564797724896921,5500.05,2023-10-07T20:40:16,Zarautz,expenses,phone,-41.36,-47486.0
buyer_2,Carmen,Lozano,1984-09-05,01940193M,carmen.lozano@brilliantdata.site,257841,ES11209564797724896921,5500.05,2023-10-07T15:53:37,Zarautz,expenses,education,-51.98,-47537.98
buyer_2,Carmen,Lozano,1984-09-05,01940193M,carmen.lozano@brilliantdata.site,257841,ES11209564797724896921,5500.05,2023-10-08T19:56:58,Zarautz,expenses,water,-24.53,-47562.51
buyer_2,Carmen,Lozano,1984-09-05,01940193M,carmen.lozano@brilliantdata.site,257841,ES11209564797724896921,5500.05,2023-10-08T11:55:55,Zarautz,expenses,electricity,-68.99,-47631.5
buyer_2,Carmen,Lozano,1984-09-05,01940193M,carmen.lozano@brilliantdata.site,257841,ES11209564797724896921,5500.05,2023-10-08T17:09:28,Zarautz,expenses,gas,-81.13,-47712.63
buyer_2,Carmen,Lozano,1984-09-05,01940193M,carmen.lozano@brilliantdata.site,257841,ES11209564797724896921,5500.05,2023-10-11T17:19:52,Zarautz,expenses,food,-65.64,-47778.27
buyer_2,Carmen,Lozano,1984-09-05,01940193M,carmen.lozano@brilliantdata.site,257841,ES11209564797724896921,5500.05,2023-10-13T17:57:52,Zarautz,expenses,leisure,-47.19,-47825.46
buyer_2,Carmen,Lozano,1984-09-05,01940193M,carmen.lozano@brilliantdata.site,257841,ES11209564797724896921,5500.05,2023-10-14T08:12:01,Zarautz,expenses,food,-94.74,-47920.2
buyer_2,Carmen,Lozano,1984-09-05,01940193M,carmen.lozano@brilliantdata.site,257841,ES11209564797724896921,5500.05,2023-10-14T11:18:25,Zarautz,expenses,cash,-100.0,-48020.2
buyer_2,Carmen,Lozano,1984-09-05,01940193M,carmen.lozano@brilliantdata.site,257841,ES11209564797724896921,5500.05,2023-10-15T21:00:34,Zarautz,expenses,leisure,-42.0,-48062.2
buyer_2,Carmen,Lozano,1984-09-05,01940193M,carmen.lozano@brilliantdata.site,257841,ES11209564797724896921,5500.05,2023-10-15T20:39:18,Zarautz,expenses,cash,-100.0,-48162.2
buyer_2,Carmen,Lozano,1984-09-05,01940193M,carmen.lozano@brilliantdata.site,257841,ES11209564797724896921,5500.05,2023-10-17T12:25:35,Zarautz,expenses,food,-70.55,-48232.75
buyer_2,Carmen,Lozano,1984-09-05,01940193M,carmen.lozano@brilliantdata.site,257841,ES11209564797724896921,5500.05,2023-10-17T19:26:26,Zarautz,expenses,education,-66.49,-48299.24
buyer_2,Carmen,Lozano,1984-09-05,01940193M,carmen.lozano@brilliantdata.site,257841,ES11209564797724896921,5500.05,2023-10-17T16:03:45,Zarautz,expenses,cash,-100.0,-48399.24
buyer_2,Carmen,Lozano,1984-09-05,01940193M,carmen.lozano@brilliantdata.site,257841,ES11209564797724896921,5500.05,2023-10-18T11:19:21,Zarautz,expenses,repairs,-187.59,-48586.83
buyer_2,Carmen,Lozano,1984-09-05,01940193M,carmen.lozano@brilliantdata.site,257841,ES11209564797724896921,5500.05,2023-10-19T21:03:56,Zarautz,expenses,food,-72.65,-48659.48
buyer_2,Carmen,Lozano,1984-09-05,01940193M,carmen.lozano@brilliantdata.site,257841,ES11209564797724896921,5500.05,2023-10-20T20:00:40,Zarautz,expenses,leisure,-61.04,-48720.52
buyer_2,Carmen,Lozano,1984-09-05,01940193M,carmen.lozano@brilliantdata.site,257841,ES11209564797724896921,5500.05,2023-10-20T05:23:56,Zarautz,expenses,education,-62.21,-48782.73
buyer_2,Carmen,Lozano,1984-09-05,01940193M,carmen.lozano@brilliantdata.site,257841,ES11209564797724896921,5500.05,2023-10-21T11:06:36,Zarautz,expenses,transport,-52.06,-48834.79
buyer_2,Carmen,Lozano,1984-09-05,01940193M,carmen.lozano@brilliantdata.site,257841,ES11209564797724896921,5500.05,2023-10-21T16:01:44,Zarautz,expenses,cash,-100.0,-48934.79
buyer_2,Carmen,Lozano,1984-09-05,01940193M,carmen.lozano@brilliantdata.site,257841,ES11209564797724896921,5500.05,2023-10-22T18:08:58,Zarautz,expenses,cash,-100.0,-49034.79
buyer_2,Carmen,Lozano,1984-09-05,01940193M,carmen.lozano@brilliantdata.site,257841,ES11209564797724896921,5500.05,2023-10-22T15:50:20,Zarautz,expenses,travel,-377.21,-49412.0
buyer_2,Carmen,Lozano,1984-09-05,01940193M,carmen.lozano@brilliantdata.site,257841,ES11209564797724896921,5500.05,2023-10-25T13:13:44,Zarautz,expenses,transport,-74.13,-49486.13
buyer_2,Carmen,Lozano,1984-09-05,01940193M,carmen.lozano@brilliantdata.site,257841,ES11209564797724896921,5500.05,2023-10-26T20:05:24,Zarautz,expenses,transport,-85.04,-49571.17
buyer_2,Carmen,Lozano,1984-09-05,01940193M,carmen.lozano@brilliantdata.site,257841,ES11209564797724896921,5500.05,2023-10-28T16:17:31,Zarautz,expenses,transport,-60.3,-49631.47
buyer_2,Carmen,Lozano,1984-09-05,01940193M,carmen.lozano@brilliantdata.site,257841,ES11209564797724896921,5500.05,2023-10-30T12:09:39,Zarautz,expenses,cash,-100.0,-49731.47
buyer_2,Carmen,Lozano,1984-09-05,01940193M,carmen.lozano@brilliantdata.site,257841,ES11209564797724896921,5500.05,2023-10-31T12:01:34,Zarautz,expenses,education,-50.03,-49781.5
buyer_2,Carmen,Lozano,1984-09-05,01940193M,carmen.lozano@brilliantdata.site,257841,ES11209564797724896921,5500.05,2023-11-01T14:19:06,Zarautz,incomes,salary,2038.44,-47743.06
buyer_2,Carmen,Lozano,1984-09-05,01940193M,carmen.lozano@brilliantdata.site,257841,ES11209564797724896921,5500.05,2023-11-01T23:22:41,Zarautz,expenses,gifts,-777.5,-48520.56
buyer_2,Carmen,Lozano,1984-09-05,01940193M,carmen.lozano@brilliantdata.site,257841,ES11209564797724896921,5500.05,2023-11-02T20:20:01,Zarautz,expenses,leisure,-59.96,-48580.52
buyer_2,Carmen,Lozano,1984-09-05,01940193M,carmen.lozano@brilliantdata.site,257841,ES11209564797724896921,5500.05,2023-11-03T18:25:18,Zarautz,expenses,travel,-398.57,-48979.09
buyer_2,Carmen,Lozano,1984-09-05,01940193M,carmen.lozano@brilliantdata.site,257841,ES11209564797724896921,5500.05,2023-11-04T04:09:12,Zarautz,expenses,mortgage,-820.89,-49799.98
buyer_2,Carmen,Lozano,1984-09-05,01940193M,carmen.lozano@brilliantdata.site,257841,ES11209564797724896921,5500.05,2023-11-04T11:05:10,Zarautz,expenses,transport,-88.73,-49888.71
buyer_2,Carmen,Lozano,1984-09-05,01940193M,carmen.lozano@brilliantdata.site,257841,ES11209564797724896921,5500.05,2023-11-04T10:23:27,Zarautz,expenses,healthcare,-38.51,-49927.22
buyer_2,Carmen,Lozano,1984-09-05,01940193M,carmen.lozano@brilliantdata.site,257841,ES11209564797724896921,5500.05,2023-11-04T18:18:07,Zarautz,expenses,children,-572.26,-50499.48
buyer_2,Carmen,Lozano,1984-09-05,01940193M,carmen.lozano@brilliantdata.site,257841,ES11209564797724896921,5500.05,2023-11-05T10:38:55,Zarautz,expenses,internet,-42.81,-50542.29
buyer_2,Carmen,Lozano,1984-09-05,01940193M,carmen.lozano@brilliantdata.site,257841,ES11209564797724896921,5500.05,2023-11-07T20:59:17,Zarautz,expenses,water,-29.03,-50571.32
buyer_2,Carmen,Lozano,1984-09-05,01940193M,carmen.lozano@brilliantdata.site,257841,ES11209564797724896921,5500.05,2023-11-07T17:13:01,Zarautz,expenses,food,-60.19,-50631.51
buyer_2,Carmen,Lozano,1984-09-05,01940193M,carmen.lozano@brilliantdata.site,257841,ES11209564797724896921,5500.05,2023-11-08T08:16:24,Zarautz,expenses,electricity,-51.13,-50682.64
buyer_2,Carmen,Lozano,1984-09-05,01940193M,carmen.lozano@brilliantdata.site,257841,ES11209564797724896921,5500.05,2023-11-08T01:09:46,Zarautz,expenses,phone,-42.73,-50725.37
buyer_2,Carmen,Lozano,1984-09-05,01940193M,carmen.lozano@brilliantdata.site,257841,ES11209564797724896921,5500.05,2023-11-08T07:11:00,Zarautz,expenses,gas,-46.68,-50772.05
buyer_2,Carmen,Lozano,1984-09-05,01940193M,carmen.lozano@brilliantdata.site,257841,ES11209564797724896921,5500.05,2023-11-09T13:40:46,Zarautz,expenses,cash,-100.0,-50872.05
buyer_2,Carmen,Lozano,1984-09-05,01940193M,carmen.lozano@brilliantdata.site,257841,ES11209564797724896921,5500.05,2023-11-10T23:51:12,Zarautz,expenses,gifts,-156.82,-51028.87
buyer_2,Carmen,Lozano,1984-09-05,01940193M,carmen.lozano@brilliantdata.site,257841,ES11209564797724896921,5500.05,2023-11-11T14:45:19,Zarautz,expenses,cash,-100.0,-51128.87
buyer_2,Carmen,Lozano,1984-09-05,01940193M,carmen.lozano@brilliantdata.site,257841,ES11209564797724896921,5500.05,2023-11-13T16:49:33,Zarautz,expenses,leisure,-32.04,-51160.91
buyer_2,Carmen,Lozano,1984-09-05,01940193M,carmen.lozano@brilliantdata.site,257841,ES11209564797724896921,5500.05,2023-11-14T08:15:05,Zarautz,expenses,healthcare,-118.59,-51279.5
buyer_2,Carmen,Lozano,1984-09-05,01940193M,carmen.lozano@brilliantdata.site,257841,ES11209564797724896921,5500.05,2023-11-15T19:49:06,Zarautz,expenses,leisure,-19.62,-51299.12
buyer_2,Carmen,Lozano,1984-09-05,01940193M,carmen.lozano@brilliantdata.site,257841,ES11209564797724896921,5500.05,2023-11-16T23:34:42,Zarautz,expenses,leisure,-37.4,-51336.52
buyer_2,Carmen,Lozano,1984-09-05,01940193M,carmen.lozano@brilliantdata.site,257841,ES11209564797724896921,5500.05,2023-11-17T12:08:27,Zarautz,expenses,cash,-100.0,-51436.52
buyer_2,Carmen,Lozano,1984-09-05,01940193M,carmen.lozano@brilliantdata.site,257841,ES11209564797724896921,5500.05,2023-11-18T21:40:55,Zarautz,expenses,food,-72.02,-51508.54
buyer_2,Carmen,Lozano,1984-09-05,01940193M,carmen.lozano@brilliantdata.site,257841,ES11209564797724896921,5500.05,2023-11-20T17:37:56,Zarautz,expenses,leisure,-79.87,-51588.41
buyer_2,Carmen,Lozano,1984-09-05,01940193M,carmen.lozano@brilliantdata.site,257841,ES11209564797724896921,5500.05,2023-11-22T14:27:49,Zarautz,expenses,food,-78.79,-51667.2
buyer_2,Carmen,Lozano,1984-09-05,01940193M,carmen.lozano@brilliantdata.site,257841,ES11209564797724896921,5500.05,2023-11-23T08:00:49,Zarautz,expenses,clothing,-92.24,-51759.44
buyer_2,Carmen,Lozano,1984-09-05,01940193M,carmen.lozano@brilliantdata.site,257841,ES11209564797724896921,5500.05,2023-11-23T14:14:58,Zarautz,expenses,gifts,-295.82,-52055.26
buyer_2,Carmen,Lozano,1984-09-05,01940193M,carmen.lozano@brilliantdata.site,257841,ES11209564797724896921,5500.05,2023-11-24T21:36:32,Zarautz,expenses,appliances,-409.94,-52465.2
buyer_2,Carmen,Lozano,1984-09-05,01940193M,carmen.lozano@brilliantdata.site,257841,ES11209564797724896921,5500.05,2023-11-25T06:00:21,Zarautz,expenses,food,-124.71,-52589.91
buyer_2,Carmen,Lozano,1984-09-05,01940193M,carmen.lozano@brilliantdata.site,257841,ES11209564797724896921,5500.05,2023-11-28T11:13:54,Zarautz,expenses,food,-101.42,-52691.33
buyer_2,Carmen,Lozano,1984-09-05,01940193M,carmen.lozano@brilliantdata.site,257841,ES11209564797724896921,5500.05,2023-11-28T17:33:44,Zarautz,expenses,transport,-74.24,-52765.57
buyer_2,Carmen,Lozano,1984-09-05,01940193M,carmen.lozano@brilliantdata.site,257841,ES11209564797724896921,5500.05,2023-11-29T20:12:54,Zarautz,expenses,food,-85.28,-52850.85
buyer_2,Carmen,Lozano,1984-09-05,01940193M,carmen.lozano@brilliantdata.site,257841,ES11209564797724896921,5500.05,2023-11-29T20:58:02,Zarautz,expenses,appliances,-129.04,-52979.89
buyer_2,Carmen,Lozano,1984-09-05,01940193M,carmen.lozano@brilliantdata.site,257841,ES11209564797724896921,5500.05,2023-11-30T09:05:15,Zarautz,expenses,food,-119.4,-53099.29
buyer_2,Carmen,Lozano,1984-09-05,01940193M,carmen.lozano@brilliantdata.site,257841,ES11209564797724896921,5500.05,2023-12-01T17:10:06,Zarautz,incomes,salary,2038.44,-51060.85
buyer_2,Carmen,Lozano,1984-09-05,01940193M,carmen.lozano@brilliantdata.site,257841,ES11209564797724896921,5500.05,2023-12-01T17:10:06,Zarautz,incomes,extra_income,376.86,-50683.99
buyer_2,Carmen,Lozano,1984-09-05,01940193M,carmen.lozano@brilliantdata.site,257841,ES11209564797724896921,5500.05,2023-12-01T17:10:06,Zarautz,incomes,salary_bonus,1569.02,-49114.97
buyer_2,Carmen,Lozano,1984-09-05,01940193M,carmen.lozano@brilliantdata.site,257841,ES11209564797724896921,5500.05,2023-12-01T08:09:33,Zarautz,expenses,transport,-81.26,-49196.23
buyer_2,Carmen,Lozano,1984-09-05,01940193M,carmen.lozano@brilliantdata.site,257841,ES11209564797724896921,5500.05,2023-12-01T20:23:00,Zarautz,expenses,cash,-100.0,-49296.23
buyer_2,Carmen,Lozano,1984-09-05,01940193M,carmen.lozano@brilliantdata.site,257841,ES11209564797724896921,5500.05,2023-12-03T11:11:13,Zarautz,expenses,cash,-100.0,-49396.23
buyer_2,Carmen,Lozano,1984-09-05,01940193M,carmen.lozano@brilliantdata.site,257841,ES11209564797724896921,5500.05,2023-12-03T09:12:05,Zarautz,expenses,travel,-369.43,-49765.66
buyer_2,Carmen,Lozano,1984-09-05,01940193M,carmen.lozano@brilliantdata.site,257841,ES11209564797724896921,5500.05,2023-12-04T17:58:03,Zarautz,expenses,mortgage,-820.89,-50586.55
buyer_2,Carmen,Lozano,1984-09-05,01940193M,carmen.lozano@brilliantdata.site,257841,ES11209564797724896921,5500.05,2023-12-04T04:09:09,Zarautz,expenses,cash,-100.0,-50686.55
buyer_2,Carmen,Lozano,1984-09-05,01940193M,carmen.lozano@brilliantdata.site,257841,ES11209564797724896921,5500.05,2023-12-05T12:04:10,Zarautz,expenses,cash,-100.0,-50786.55
buyer_2,Carmen,Lozano,1984-09-05,01940193M,carmen.lozano@brilliantdata.site,257841,ES11209564797724896921,5500.05,2023-12-05T18:22:30,Zarautz,expenses,gifts,-631.93,-51418.48
buyer_2,Carmen,Lozano,1984-09-05,01940193M,carmen.lozano@brilliantdata.site,257841,ES11209564797724896921,5500.05,2023-12-06T16:23:19,Zarautz,expenses,electricity,-81.78,-51500.26
buyer_2,Carmen,Lozano,1984-09-05,01940193M,carmen.lozano@brilliantdata.site,257841,ES11209564797724896921,5500.05,2023-12-07T17:08:08,Zarautz,expenses,gas,-64.9,-51565.16
buyer_2,Carmen,Lozano,1984-09-05,01940193M,carmen.lozano@brilliantdata.site,257841,ES11209564797724896921,5500.05,2023-12-07T20:42:39,Zarautz,expenses,internet,-42.81,-51607.97
buyer_2,Carmen,Lozano,1984-09-05,01940193M,carmen.lozano@brilliantdata.site,257841,ES11209564797724896921,5500.05,2023-12-07T15:06:09,Zarautz,expenses,food,-99.3,-51707.27
buyer_2,Carmen,Lozano,1984-09-05,01940193M,carmen.lozano@brilliantdata.site,257841,ES11209564797724896921,5500.05,2023-12-07T17:31:54,Zarautz,expenses,transport,-83.49,-51790.76
buyer_2,Carmen,Lozano,1984-09-05,01940193M,carmen.lozano@brilliantdata.site,257841,ES11209564797724896921,5500.05,2023-12-07T21:06:07,Zarautz,expenses,education,-76.07,-51866.83
buyer_2,Carmen,Lozano,1984-09-05,01940193M,carmen.lozano@brilliantdata.site,257841,ES11209564797724896921,5500.05,2023-12-07T20:55:46,Zarautz,expenses,appliances,-398.33,-52265.16
buyer_2,Carmen,Lozano,1984-09-05,01940193M,carmen.lozano@brilliantdata.site,257841,ES11209564797724896921,5500.05,2023-12-08T18:45:39,Zarautz,expenses,water,-28.17,-52293.33
buyer_2,Carmen,Lozano,1984-09-05,01940193M,carmen.lozano@brilliantdata.site,257841,ES11209564797724896921,5500.05,2023-12-08T11:52:50,Zarautz,expenses,phone,-35.42,-52328.75
buyer_2,Carmen,Lozano,1984-09-05,01940193M,carmen.lozano@brilliantdata.site,257841,ES11209564797724896921,5500.05,2023-12-08T17:14:50,Zarautz,expenses,leisure,-56.72,-52385.47
buyer_2,Carmen,Lozano,1984-09-05,01940193M,carmen.lozano@brilliantdata.site,257841,ES11209564797724896921,5500.05,2023-12-10T10:00:33,Zarautz,expenses,food,-88.57,-52474.04
buyer_2,Carmen,Lozano,1984-09-05,01940193M,carmen.lozano@brilliantdata.site,257841,ES11209564797724896921,5500.05,2023-12-11T09:39:30,Zarautz,expenses,transport,-44.67,-52518.71
buyer_2,Carmen,Lozano,1984-09-05,01940193M,carmen.lozano@brilliantdata.site,257841,ES11209564797724896921,5500.05,2023-12-13T18:10:12,Zarautz,expenses,cash,-100.0,-52618.71
buyer_2,Carmen,Lozano,1984-09-05,01940193M,carmen.lozano@brilliantdata.site,257841,ES11209564797724896921,5500.05,2023-12-13T09:46:09,Zarautz,expenses,children,-591.32,-53210.03
buyer_2,Carmen,Lozano,1984-09-05,01940193M,carmen.lozano@brilliantdata.site,257841,ES11209564797724896921,5500.05,2023-12-14T08:25:28,Zarautz,expenses,cash,-100.0,-53310.03
buyer_2,Carmen,Lozano,1984-09-05,01940193M,carmen.lozano@brilliantdata.site,257841,ES11209564797724896921,5500.05,2023-12-14T14:35:18,Zarautz,expenses,travel,-398.5,-53708.53
buyer_2,Carmen,Lozano,1984-09-05,01940193M,carmen.lozano@brilliantdata.site,257841,ES11209564797724896921,5500.05,2023-12-15T22:53:31,Zarautz,expenses,food,-108.54,-53817.07
buyer_2,Carmen,Lozano,1984-09-05,01940193M,carmen.lozano@brilliantdata.site,257841,ES11209564797724896921,5500.05,2023-12-15T13:18:33,Zarautz,expenses,cash,-100.0,-53917.07
buyer_2,Carmen,Lozano,1984-09-05,01940193M,carmen.lozano@brilliantdata.site,257841,ES11209564797724896921,5500.05,2023-12-18T18:57:51,Zarautz,expenses,cash,-100.0,-54017.07
buyer_2,Carmen,Lozano,1984-09-05,01940193M,carmen.lozano@brilliantdata.site,257841,ES11209564797724896921,5500.05,2023-12-19T19:29:37,Zarautz,expenses,cash,-100.0,-54117.07
buyer_2,Carmen,Lozano,1984-09-05,01940193M,carmen.lozano@brilliantdata.site,257841,ES11209564797724896921,5500.05,2023-12-20T13:50:10,Zarautz,expenses,leisure,-79.66,-54196.73
buyer_2,Carmen,Lozano,1984-09-05,01940193M,carmen.lozano@brilliantdata.site,257841,ES11209564797724896921,5500.05,2023-12-20T21:17:13,Zarautz,expenses,cash,-100.0,-54296.73
buyer_2,Carmen,Lozano,1984-09-05,01940193M,carmen.lozano@brilliantdata.site,257841,ES11209564797724896921,5500.05,2023-12-21T18:38:18,Zarautz,expenses,food,-89.34,-54386.07
buyer_2,Carmen,Lozano,1984-09-05,01940193M,carmen.lozano@brilliantdata.site,257841,ES11209564797724896921,5500.05,2023-12-21T20:49:31,Zarautz,expenses,repairs,-312.54,-54698.61
buyer_2,Carmen,Lozano,1984-09-05,01940193M,carmen.lozano@brilliantdata.site,257841,ES11209564797724896921,5500.05,2023-12-22T21:16:59,Zarautz,expenses,cash,-100.0,-54798.61
buyer_2,Carmen,Lozano,1984-09-05,01940193M,carmen.lozano@brilliantdata.site,257841,ES11209564797724896921,5500.05,2023-12-22T17:43:32,Zarautz,expenses,gifts,-558.15,-55356.76
buyer_2,Carmen,Lozano,1984-09-05,01940193M,carmen.lozano@brilliantdata.site,257841,ES11209564797724896921,5500.05,2023-12-23T19:58:17,Zarautz,expenses,leisure,-40.56,-55397.32
buyer_2,Carmen,Lozano,1984-09-05,01940193M,carmen.lozano@brilliantdata.site,257841,ES11209564797724896921,5500.05,2023-12-26T12:31:16,Zarautz,expenses,transport,-71.92,-55469.24
buyer_2,Carmen,Lozano,1984-09-05,01940193M,carmen.lozano@brilliantdata.site,257841,ES11209564797724896921,5500.05,2023-12-26T12:48:42,Zarautz,expenses,travel,-744.69,-56213.93
buyer_2,Carmen,Lozano,1984-09-05,01940193M,carmen.lozano@brilliantdata.site,257841,ES11209564797724896921,5500.05,2023-12-26T23:43:09,Zarautz,expenses,children,-86.46341666666683,-56300.39
buyer_2,Carmen,Lozano,1984-09-05,01940193M,carmen.lozano@brilliantdata.site,257841,ES11209564797724896921,5500.05,2023-12-27T08:59:49,Zarautz,expenses,transport,-75.79,-56376.18
buyer_2,Carmen,Lozano,1984-09-05,01940193M,carmen.lozano@brilliantdata.site,257841,ES11209564797724896921,5500.05,2023-12-28T19:09:19,Zarautz,expenses,repairs,-178.29,-56554.47
buyer_2,Carmen,Lozano,1984-09-05,01940193M,carmen.lozano@brilliantdata.site,257841,ES11209564797724896921,5500.05,2023-12-29T16:40:38,Zarautz,expenses,cash,-100.0,-56654.47
buyer_2,Carmen,Lozano,1984-09-05,01940193M,carmen.lozano@brilliantdata.site,257841,ES11209564797724896921,5500.05,2023-12-29T07:54:03,Zarautz,expenses,gifts,-193.77,-56848.24
buyer_2,Carmen,Lozano,1984-09-05,01940193M,carmen.lozano@brilliantdata.site,257841,ES11209564797724896921,5500.05,2023-12-31T09:50:22,Zarautz,expenses,food,-100.47,-56948.71
buyer_2,Carmen,Lozano,1984-09-05,01940193M,carmen.lozano@brilliantdata.site,257841,ES11209564797724896921,5500.05,2023-12-31T09:50:14,Zarautz,expenses,transport,-57.18,-57005.89
buyer_2,Carmen,Lozano,1984-09-05,01940193M,carmen.lozano@brilliantdata.site,257841,ES11209564797724896921,5500.05,2023-12-31T17:52:55,Zarautz,expenses,cash,-100.0,-57105.89
buyer_2,Carmen,Lozano,1984-09-05,01940193M,carmen.lozano@brilliantdata.site,257841,ES11209564797724896921,5500.05,2024-01-01T15:48:47,Zarautz,incomes,salary,2080.3,-55025.59
buyer_2,Carmen,Lozano,1984-09-05,01940193M,carmen.lozano@brilliantdata.site,257841,ES11209564797724896921,5500.05,2024-01-01T03:08:48,Zarautz,expenses,clothing,-134.05,-55159.64
buyer_2,Carmen,Lozano,1984-09-05,01940193M,carmen.lozano@brilliantdata.site,257841,ES11209564797724896921,5500.05,2024-01-01T12:08:44,Zarautz,expenses,cash,-100.0,-55259.64
buyer_2,Carmen,Lozano,1984-09-05,01940193M,carmen.lozano@brilliantdata.site,257841,ES11209564797724896921,5500.05,2024-01-02T20:06:59,Zarautz,expenses,leisure,-23.57,-55283.21
buyer_2,Carmen,Lozano,1984-09-05,01940193M,carmen.lozano@brilliantdata.site,257841,ES11209564797724896921,5500.05,2024-01-04T13:30:12,Zarautz,expenses,mortgage,-1059.41,-56342.62
buyer_2,Carmen,Lozano,1984-09-05,01940193M,carmen.lozano@brilliantdata.site,257841,ES11209564797724896921,5500.05,2024-01-05T08:39:54,Zarautz,expenses,gas,-75.74,-56418.36
buyer_2,Carmen,Lozano,1984-09-05,01940193M,carmen.lozano@brilliantdata.site,257841,ES11209564797724896921,5500.05,2024-01-05T11:22:21,Zarautz,expenses,phone,-32.27,-56450.63
buyer_2,Carmen,Lozano,1984-09-05,01940193M,carmen.lozano@brilliantdata.site,257841,ES11209564797724896921,5500.05,2024-01-06T13:03:32,Zarautz,expenses,gifts,-44.28,-56494.91
buyer_2,Carmen,Lozano,1984-09-05,01940193M,carmen.lozano@brilliantdata.site,257841,ES11209564797724896921,5500.05,2024-01-07T12:03:36,Zarautz,expenses,children,-365.22,-56860.13
buyer_2,Carmen,Lozano,1984-09-05,01940193M,carmen.lozano@brilliantdata.site,257841,ES11209564797724896921,5500.05,2024-01-08T19:18:11,Zarautz,expenses,water,-27.16,-56887.29
buyer_2,Carmen,Lozano,1984-09-05,01940193M,carmen.lozano@brilliantdata.site,257841,ES11209564797724896921,5500.05,2024-01-08T06:34:42,Zarautz,expenses,electricity,-63.36,-56950.65
buyer_2,Carmen,Lozano,1984-09-05,01940193M,carmen.lozano@brilliantdata.site,257841,ES11209564797724896921,5500.05,2024-01-08T23:13:06,Zarautz,expenses,internet,-43.69,-56994.34
buyer_2,Carmen,Lozano,1984-09-05,01940193M,carmen.lozano@brilliantdata.site,257841,ES11209564797724896921,5500.05,2024-01-09T02:17:39,Zarautz,expenses,food,-110.77,-57105.11
buyer_2,Carmen,Lozano,1984-09-05,01940193M,carmen.lozano@brilliantdata.site,257841,ES11209564797724896921,5500.05,2024-01-11T12:30:33,Zarautz,expenses,cash,-100.0,-57205.11
buyer_2,Carmen,Lozano,1984-09-05,01940193M,carmen.lozano@brilliantdata.site,257841,ES11209564797724896921,5500.05,2024-01-13T18:53:20,Zarautz,expenses,food,-99.96,-57305.07
buyer_2,Carmen,Lozano,1984-09-05,01940193M,carmen.lozano@brilliantdata.site,257841,ES11209564797724896921,5500.05,2024-01-15T08:16:39,Zarautz,expenses,food,-117.52,-57422.59
buyer_2,Carmen,Lozano,1984-09-05,01940193M,carmen.lozano@brilliantdata.site,257841,ES11209564797724896921,5500.05,2024-01-16T18:56:10,Zarautz,expenses,gifts,-177.63,-57600.22
buyer_2,Carmen,Lozano,1984-09-05,01940193M,carmen.lozano@brilliantdata.site,257841,ES11209564797724896921,5500.05,2024-01-18T15:14:07,Zarautz,expenses,transport,-67.76,-57667.98
buyer_2,Carmen,Lozano,1984-09-05,01940193M,carmen.lozano@brilliantdata.site,257841,ES11209564797724896921,5500.05,2024-01-18T08:51:02,Zarautz,expenses,clothing,-59.4,-57727.38
buyer_2,Carmen,Lozano,1984-09-05,01940193M,carmen.lozano@brilliantdata.site,257841,ES11209564797724896921,5500.05,2024-01-21T09:34:30,Zarautz,expenses,gifts,-30.06,-57757.44
buyer_2,Carmen,Lozano,1984-09-05,01940193M,carmen.lozano@brilliantdata.site,257841,ES11209564797724896921,5500.05,2024-01-22T20:38:50,Zarautz,expenses,transport,-59.16,-57816.6
buyer_2,Carmen,Lozano,1984-09-05,01940193M,carmen.lozano@brilliantdata.site,257841,ES11209564797724896921,5500.05,2024-01-22T08:15:15,Zarautz,expenses,leisure,-28.17,-57844.77
buyer_2,Carmen,Lozano,1984-09-05,01940193M,carmen.lozano@brilliantdata.site,257841,ES11209564797724896921,5500.05,2024-01-22T09:28:28,Zarautz,expenses,gifts,-454.95,-58299.72
buyer_2,Carmen,Lozano,1984-09-05,01940193M,carmen.lozano@brilliantdata.site,257841,ES11209564797724896921,5500.05,2024-01-23T09:28:59,Zarautz,expenses,food,-65.58,-58365.3
buyer_2,Carmen,Lozano,1984-09-05,01940193M,carmen.lozano@brilliantdata.site,257841,ES11209564797724896921,5500.05,2024-01-24T14:21:30,Zarautz,expenses,food,-118.69,-58483.99
buyer_2,Carmen,Lozano,1984-09-05,01940193M,carmen.lozano@brilliantdata.site,257841,ES11209564797724896921,5500.05,2024-01-24T22:42:29,Zarautz,expenses,repairs,-206.04,-58690.03
buyer_2,Carmen,Lozano,1984-09-05,01940193M,carmen.lozano@brilliantdata.site,257841,ES11209564797724896921,5500.05,2024-01-25T09:49:25,Zarautz,expenses,repairs,-38.44,-58728.47
buyer_2,Carmen,Lozano,1984-09-05,01940193M,carmen.lozano@brilliantdata.site,257841,ES11209564797724896921,5500.05,2024-01-26T22:40:38,Zarautz,expenses,leisure,-18.06,-58746.53
buyer_2,Carmen,Lozano,1984-09-05,01940193M,carmen.lozano@brilliantdata.site,257841,ES11209564797724896921,5500.05,2024-01-26T17:41:23,Zarautz,expenses,cash,-100.0,-58846.53
buyer_2,Carmen,Lozano,1984-09-05,01940193M,carmen.lozano@brilliantdata.site,257841,ES11209564797724896921,5500.05,2024-01-29T17:22:19,Zarautz,expenses,repairs,-282.89,-59129.42
buyer_2,Carmen,Lozano,1984-09-05,01940193M,carmen.lozano@brilliantdata.site,257841,ES11209564797724896921,5500.05,2024-01-30T02:59:02,Zarautz,expenses,leisure,-40.16,-59169.58
buyer_2,Carmen,Lozano,1984-09-05,01940193M,carmen.lozano@brilliantdata.site,257841,ES11209564797724896921,5500.05,2024-01-30T13:25:21,Zarautz,expenses,travel,-477.28,-59646.86
buyer_2,Carmen,Lozano,1984-09-05,01940193M,carmen.lozano@brilliantdata.site,257841,ES11209564797724896921,5500.05,2024-02-01T16:51:04,Zarautz,incomes,salary,2080.3,-57566.56
buyer_2,Carmen,Lozano,1984-09-05,01940193M,carmen.lozano@brilliantdata.site,257841,ES11209564797724896921,5500.05,2024-02-01T20:14:01,Zarautz,expenses,cash,-100.0,-57666.56
buyer_2,Carmen,Lozano,1984-09-05,01940193M,carmen.lozano@brilliantdata.site,257841,ES11209564797724896921,5500.05,2024-02-01T22:42:50,Zarautz,expenses,children,-302.8,-57969.36
buyer_2,Carmen,Lozano,1984-09-05,01940193M,carmen.lozano@brilliantdata.site,257841,ES11209564797724896921,5500.05,2024-02-03T13:44:58,Zarautz,expenses,transport,-61.71,-58031.07
buyer_2,Carmen,Lozano,1984-09-05,01940193M,carmen.lozano@brilliantdata.site,257841,ES11209564797724896921,5500.05,2024-02-03T18:16:07,Zarautz,expenses,repairs,-106.94,-58138.01
buyer_2,Carmen,Lozano,1984-09-05,01940193M,carmen.lozano@brilliantdata.site,257841,ES11209564797724896921,5500.05,2024-02-04T13:51:30,Zarautz,expenses,mortgage,-1059.41,-59197.42
buyer_2,Carmen,Lozano,1984-09-05,01940193M,carmen.lozano@brilliantdata.site,257841,ES11209564797724896921,5500.05,2024-02-04T18:20:00,Zarautz,expenses,repairs,-175.28,-59372.7
buyer_2,Carmen,Lozano,1984-09-05,01940193M,carmen.lozano@brilliantdata.site,257841,ES11209564797724896921,5500.05,2024-02-05T18:16:38,Zarautz,expenses,phone,-31.35,-59404.05
buyer_2,Carmen,Lozano,1984-09-05,01940193M,carmen.lozano@brilliantdata.site,257841,ES11209564797724896921,5500.05,2024-02-06T12:47:54,Zarautz,expenses,electricity,-60.39,-59464.44
buyer_2,Carmen,Lozano,1984-09-05,01940193M,carmen.lozano@brilliantdata.site,257841,ES11209564797724896921,5500.05,2024-02-06T22:32:31,Zarautz,expenses,gas,-111.65,-59576.09
buyer_2,Carmen,Lozano,1984-09-05,01940193M,carmen.lozano@brilliantdata.site,257841,ES11209564797724896921,5500.05,2024-02-06T14:37:17,Zarautz,expenses,food,-121.42,-59697.51
buyer_2,Carmen,Lozano,1984-09-05,01940193M,carmen.lozano@brilliantdata.site,257841,ES11209564797724896921,5500.05,2024-02-06T13:51:10,Zarautz,expenses,children,-537.2187500000003,-60234.73
buyer_2,Carmen,Lozano,1984-09-05,01940193M,carmen.lozano@brilliantdata.site,257841,ES11209564797724896921,5500.05,2024-02-07T10:25:56,Zarautz,expenses,repairs,-159.37,-60394.1
buyer_2,Carmen,Lozano,1984-09-05,01940193M,carmen.lozano@brilliantdata.site,257841,ES11209564797724896921,5500.05,2024-02-08T15:01:39,Zarautz,expenses,water,-22.12,-60416.22
buyer_2,Carmen,Lozano,1984-09-05,01940193M,carmen.lozano@brilliantdata.site,257841,ES11209564797724896921,5500.05,2024-02-08T18:26:49,Zarautz,expenses,internet,-43.69,-60459.91
buyer_2,Carmen,Lozano,1984-09-05,01940193M,carmen.lozano@brilliantdata.site,257841,ES11209564797724896921,5500.05,2024-02-08T10:38:39,Zarautz,expenses,transport,-79.78,-60539.69
buyer_2,Carmen,Lozano,1984-09-05,01940193M,carmen.lozano@brilliantdata.site,257841,ES11209564797724896921,5500.05,2024-02-09T11:56:27,Zarautz,expenses,food,-118.67,-60658.36
buyer_2,Carmen,Lozano,1984-09-05,01940193M,carmen.lozano@brilliantdata.site,257841,ES11209564797724896921,5500.05,2024-02-09T06:39:23,Zarautz,expenses,transport,-41.83,-60700.19
buyer_2,Carmen,Lozano,1984-09-05,01940193M,carmen.lozano@brilliantdata.site,257841,ES11209564797724896921,5500.05,2024-02-10T12:13:12,Zarautz,expenses,leisure,-77.23,-60777.42
buyer_2,Carmen,Lozano,1984-09-05,01940193M,carmen.lozano@brilliantdata.site,257841,ES11209564797724896921,5500.05,2024-02-11T10:25:40,Zarautz,expenses,leisure,-84.88,-60862.3
buyer_2,Carmen,Lozano,1984-09-05,01940193M,carmen.lozano@brilliantdata.site,257841,ES11209564797724896921,5500.05,2024-02-11T21:35:18,Zarautz,expenses,cash,-100.0,-60962.3
buyer_2,Carmen,Lozano,1984-09-05,01940193M,carmen.lozano@brilliantdata.site,257841,ES11209564797724896921,5500.05,2024-02-11T08:35:49,Zarautz,expenses,appliances,-145.17,-61107.47
buyer_2,Carmen,Lozano,1984-09-05,01940193M,carmen.lozano@brilliantdata.site,257841,ES11209564797724896921,5500.05,2024-02-13T18:08:10,Zarautz,expenses,cash,-100.0,-61207.47
buyer_2,Carmen,Lozano,1984-09-05,01940193M,carmen.lozano@brilliantdata.site,257841,ES11209564797724896921,5500.05,2024-02-13T19:08:30,Zarautz,expenses,children,-343.36,-61550.83
buyer_2,Carmen,Lozano,1984-09-05,01940193M,carmen.lozano@brilliantdata.site,257841,ES11209564797724896921,5500.05,2024-02-15T16:03:13,Zarautz,expenses,appliances,-190.34,-61741.17
buyer_2,Carmen,Lozano,1984-09-05,01940193M,carmen.lozano@brilliantdata.site,257841,ES11209564797724896921,5500.05,2024-02-16T18:50:19,Zarautz,expenses,transport,-46.62,-61787.79
buyer_2,Carmen,Lozano,1984-09-05,01940193M,carmen.lozano@brilliantdata.site,257841,ES11209564797724896921,5500.05,2024-02-16T15:42:53,Zarautz,expenses,cash,-100.0,-61887.79
buyer_2,Carmen,Lozano,1984-09-05,01940193M,carmen.lozano@brilliantdata.site,257841,ES11209564797724896921,5500.05,2024-02-18T18:51:43,Zarautz,expenses,cash,-100.0,-61987.79
buyer_2,Carmen,Lozano,1984-09-05,01940193M,carmen.lozano@brilliantdata.site,257841,ES11209564797724896921,5500.05,2024-02-18T20:25:39,Zarautz,expenses,gifts,-553.96,-62541.75
buyer_2,Carmen,Lozano,1984-09-05,01940193M,carmen.lozano@brilliantdata.site,257841,ES11209564797724896921,5500.05,2024-02-22T08:55:46,Zarautz,expenses,food,-109.71,-62651.46
buyer_2,Carmen,Lozano,1984-09-05,01940193M,carmen.lozano@brilliantdata.site,257841,ES11209564797724896921,5500.05,2024-02-23T18:15:24,Zarautz,expenses,children,-193.54,-62845.0
buyer_2,Carmen,Lozano,1984-09-05,01940193M,carmen.lozano@brilliantdata.site,257841,ES11209564797724896921,5500.05,2024-02-24T12:17:58,Zarautz,expenses,gifts,-387.9,-63232.9
buyer_2,Carmen,Lozano,1984-09-05,01940193M,carmen.lozano@brilliantdata.site,257841,ES11209564797724896921,5500.05,2024-02-25T11:33:56,Zarautz,expenses,leisure,-33.28,-63266.18
buyer_2,Carmen,Lozano,1984-09-05,01940193M,carmen.lozano@brilliantdata.site,257841,ES11209564797724896921,5500.05,2024-02-26T18:24:04,Zarautz,expenses,education,-78.83,-63345.01
buyer_2,Carmen,Lozano,1984-09-05,01940193M,carmen.lozano@brilliantdata.site,257841,ES11209564797724896921,5500.05,2024-02-26T12:48:37,Zarautz,expenses,children,-223.7,-63568.71
buyer_2,Carmen,Lozano,1984-09-05,01940193M,carmen.lozano@brilliantdata.site,257841,ES11209564797724896921,5500.05,2024-02-28T15:54:50,Zarautz,expenses,food,-108.27,-63676.98
buyer_2,Carmen,Lozano,1984-09-05,01940193M,carmen.lozano@brilliantdata.site,257841,ES11209564797724896921,5500.05,2024-02-28T19:05:46,Zarautz,expenses,cash,-100.0,-63776.98
buyer_2,Carmen,Lozano,1984-09-05,01940193M,carmen.lozano@brilliantdata.site,257841,ES11209564797724896921,5500.05,2024-03-01T12:00:05,Zarautz,incomes,salary,2080.3,-61696.68
buyer_2,Carmen,Lozano,1984-09-05,01940193M,carmen.lozano@brilliantdata.site,257841,ES11209564797724896921,5500.05,2024-03-01T08:43:47,Zarautz,expenses,food,-115.6,-61812.28
buyer_2,Carmen,Lozano,1984-09-05,01940193M,carmen.lozano@brilliantdata.site,257841,ES11209564797724896921,5500.05,2024-03-03T16:20:48,Zarautz,expenses,food,-98.22,-61910.5
buyer_2,Carmen,Lozano,1984-09-05,01940193M,carmen.lozano@brilliantdata.site,257841,ES11209564797724896921,5500.05,2024-03-04T14:28:59,Zarautz,expenses,mortgage,-1059.41,-62969.91
buyer_2,Carmen,Lozano,1984-09-05,01940193M,carmen.lozano@brilliantdata.site,257841,ES11209564797724896921,5500.05,2024-03-05T17:37:52,Zarautz,expenses,water,-26.27,-62996.18
buyer_2,Carmen,Lozano,1984-09-05,01940193M,carmen.lozano@brilliantdata.site,257841,ES11209564797724896921,5500.05,2024-03-05T12:55:06,Zarautz,expenses,electricity,-47.0,-63043.18
buyer_2,Carmen,Lozano,1984-09-05,01940193M,carmen.lozano@brilliantdata.site,257841,ES11209564797724896921,5500.05,2024-03-05T21:54:19,Zarautz,expenses,clothing,-150.97,-63194.15
buyer_2,Carmen,Lozano,1984-09-05,01940193M,carmen.lozano@brilliantdata.site,257841,ES11209564797724896921,5500.05,2024-03-05T13:47:22,Zarautz,expenses,gifts,-423.26,-63617.41
buyer_2,Carmen,Lozano,1984-09-05,01940193M,carmen.lozano@brilliantdata.site,257841,ES11209564797724896921,5500.05,2024-03-07T08:18:01,Zarautz,expenses,gas,-77.86,-63695.27
buyer_2,Carmen,Lozano,1984-09-05,01940193M,carmen.lozano@brilliantdata.site,257841,ES11209564797724896921,5500.05,2024-03-08T19:29:31,Zarautz,expenses,internet,-43.69,-63738.96
buyer_2,Carmen,Lozano,1984-09-05,01940193M,carmen.lozano@brilliantdata.site,257841,ES11209564797724896921,5500.05,2024-03-08T12:42:13,Zarautz,expenses,phone,-40.6,-63779.56
buyer_2,Carmen,Lozano,1984-09-05,01940193M,carmen.lozano@brilliantdata.site,257841,ES11209564797724896921,5500.05,2024-03-10T08:55:56,Zarautz,expenses,leisure,-44.86,-63824.42
buyer_2,Carmen,Lozano,1984-09-05,01940193M,carmen.lozano@brilliantdata.site,257841,ES11209564797724896921,5500.05,2024-03-11T21:55:11,Zarautz,expenses,food,-75.42,-63899.84
buyer_2,Carmen,Lozano,1984-09-05,01940193M,carmen.lozano@brilliantdata.site,257841,ES11209564797724896921,5500.05,2024-03-11T11:31:29,Zarautz,expenses,leisure,-65.89,-63965.73
buyer_2,Carmen,Lozano,1984-09-05,01940193M,carmen.lozano@brilliantdata.site,257841,ES11209564797724896921,5500.05,2024-03-11T10:31:06,Zarautz,expenses,education,-47.37,-64013.1
buyer_2,Carmen,Lozano,1984-09-05,01940193M,carmen.lozano@brilliantdata.site,257841,ES11209564797724896921,5500.05,2024-03-13T20:22:22,Zarautz,expenses,repairs,-327.71,-64340.81
buyer_2,Carmen,Lozano,1984-09-05,01940193M,carmen.lozano@brilliantdata.site,257841,ES11209564797724896921,5500.05,2024-03-14T00:30:03,Zarautz,expenses,transport,-42.49,-64383.3
buyer_2,Carmen,Lozano,1984-09-05,01940193M,carmen.lozano@brilliantdata.site,257841,ES11209564797724896921,5500.05,2024-03-15T11:19:57,Zarautz,expenses,clothing,-158.77,-64542.07
buyer_2,Carmen,Lozano,1984-09-05,01940193M,carmen.lozano@brilliantdata.site,257841,ES11209564797724896921,5500.05,2024-03-16T15:29:33,Zarautz,expenses,healthcare,-109.99,-64652.06
buyer_2,Carmen,Lozano,1984-09-05,01940193M,carmen.lozano@brilliantdata.site,257841,ES11209564797724896921,5500.05,2024-03-17T19:21:45,Zarautz,expenses,cash,-100.0,-64752.06
buyer_2,Carmen,Lozano,1984-09-05,01940193M,carmen.lozano@brilliantdata.site,257841,ES11209564797724896921,5500.05,2024-03-18T21:42:10,Zarautz,expenses,food,-86.78,-64838.84
buyer_2,Carmen,Lozano,1984-09-05,01940193M,carmen.lozano@brilliantdata.site,257841,ES11209564797724896921,5500.05,2024-03-18T12:58:36,Zarautz,expenses,cash,-100.0,-64938.84
buyer_2,Carmen,Lozano,1984-09-05,01940193M,carmen.lozano@brilliantdata.site,257841,ES11209564797724896921,5500.05,2024-03-19T05:54:24,Zarautz,expenses,cash,-100.0,-65038.84
buyer_2,Carmen,Lozano,1984-09-05,01940193M,carmen.lozano@brilliantdata.site,257841,ES11209564797724896921,5500.05,2024-03-20T19:50:20,Zarautz,expenses,repairs,-60.44,-65099.28
buyer_2,Carmen,Lozano,1984-09-05,01940193M,carmen.lozano@brilliantdata.site,257841,ES11209564797724896921,5500.05,2024-03-20T08:31:42,Zarautz,expenses,gifts,-29.41,-65128.69
buyer_2,Carmen,Lozano,1984-09-05,01940193M,carmen.lozano@brilliantdata.site,257841,ES11209564797724896921,5500.05,2024-03-21T18:29:16,Zarautz,expenses,education,-43.08,-65171.77
buyer_2,Carmen,Lozano,1984-09-05,01940193M,carmen.lozano@brilliantdata.site,257841,ES11209564797724896921,5500.05,2024-03-22T13:59:06,Zarautz,expenses,leisure,-35.01,-65206.78
buyer_2,Carmen,Lozano,1984-09-05,01940193M,carmen.lozano@brilliantdata.site,257841,ES11209564797724896921,5500.05,2024-03-22T20:15:25,Zarautz,expenses,education,-46.9,-65253.68
buyer_2,Carmen,Lozano,1984-09-05,01940193M,carmen.lozano@brilliantdata.site,257841,ES11209564797724896921,5500.05,2024-03-24T09:13:52,Zarautz,expenses,cash,-100.0,-65353.68
buyer_2,Carmen,Lozano,1984-09-05,01940193M,carmen.lozano@brilliantdata.site,257841,ES11209564797724896921,5500.05,2024-03-25T20:25:09,Zarautz,expenses,cash,-100.0,-65453.68
buyer_2,Carmen,Lozano,1984-09-05,01940193M,carmen.lozano@brilliantdata.site,257841,ES11209564797724896921,5500.05,2024-03-25T09:37:26,Zarautz,expenses,gifts,-133.78,-65587.46
buyer_2,Carmen,Lozano,1984-09-05,01940193M,carmen.lozano@brilliantdata.site,257841,ES11209564797724896921,5500.05,2024-03-26T16:03:02,Zarautz,expenses,food,-117.56,-65705.02
buyer_2,Carmen,Lozano,1984-09-05,01940193M,carmen.lozano@brilliantdata.site,257841,ES11209564797724896921,5500.05,2024-03-26T16:31:39,Zarautz,expenses,cash,-100.0,-65805.02
buyer_2,Carmen,Lozano,1984-09-05,01940193M,carmen.lozano@brilliantdata.site,257841,ES11209564797724896921,5500.05,2024-03-27T05:27:53,Zarautz,expenses,leisure,-51.7,-65856.72
buyer_2,Carmen,Lozano,1984-09-05,01940193M,carmen.lozano@brilliantdata.site,257841,ES11209564797724896921,5500.05,2024-03-27T08:06:25,Zarautz,expenses,cash,-100.0,-65956.72
buyer_2,Carmen,Lozano,1984-09-05,01940193M,carmen.lozano@brilliantdata.site,257841,ES11209564797724896921,5500.05,2024-03-29T08:40:33,Zarautz,expenses,leisure,-64.96,-66021.68
buyer_2,Carmen,Lozano,1984-09-05,01940193M,carmen.lozano@brilliantdata.site,257841,ES11209564797724896921,5500.05,2024-04-01T12:51:54,Zarautz,incomes,salary,2080.3,-63941.38
buyer_2,Carmen,Lozano,1984-09-05,01940193M,carmen.lozano@brilliantdata.site,257841,ES11209564797724896921,5500.05,2024-04-01T12:51:54,Zarautz,incomes,extra_income,376.86,-63564.52
buyer_2,Carmen,Lozano,1984-09-05,01940193M,carmen.lozano@brilliantdata.site,257841,ES11209564797724896921,5500.05,2024-04-01T17:24:58,Zarautz,expenses,cash,-100.0,-63664.52
buyer_2,Carmen,Lozano,1984-09-05,01940193M,carmen.lozano@brilliantdata.site,257841,ES11209564797724896921,5500.05,2024-04-01T19:18:36,Zarautz,expenses,travel,-400.48,-64065.0
buyer_2,Carmen,Lozano,1984-09-05,01940193M,carmen.lozano@brilliantdata.site,257841,ES11209564797724896921,5500.05,2024-04-02T11:34:55,Zarautz,expenses,repairs,-60.79,-64125.79
buyer_2,Carmen,Lozano,1984-09-05,01940193M,carmen.lozano@brilliantdata.site,257841,ES11209564797724896921,5500.05,2024-04-03T11:21:37,Zarautz,expenses,transport,-57.58,-64183.37
buyer_2,Carmen,Lozano,1984-09-05,01940193M,carmen.lozano@brilliantdata.site,257841,ES11209564797724896921,5500.05,2024-04-03T09:03:46,Zarautz,expenses,cash,-100.0,-64283.37
buyer_2,Carmen,Lozano,1984-09-05,01940193M,carmen.lozano@brilliantdata.site,257841,ES11209564797724896921,5500.05,2024-04-04T18:17:09,Zarautz,expenses,mortgage,-1059.41,-65342.78
buyer_2,Carmen,Lozano,1984-09-05,01940193M,carmen.lozano@brilliantdata.site,257841,ES11209564797724896921,5500.05,2024-04-05T20:32:02,Zarautz,expenses,water,-37.21,-65379.99
buyer_2,Carmen,Lozano,1984-09-05,01940193M,carmen.lozano@brilliantdata.site,257841,ES11209564797724896921,5500.05,2024-04-06T11:00:23,Zarautz,expenses,phone,-34.26,-65414.25
buyer_2,Carmen,Lozano,1984-09-05,01940193M,carmen.lozano@brilliantdata.site,257841,ES11209564797724896921,5500.05,2024-04-07T19:39:32,Zarautz,expenses,electricity,-27.12,-65441.37
buyer_2,Carmen,Lozano,1984-09-05,01940193M,carmen.lozano@brilliantdata.site,257841,ES11209564797724896921,5500.05,2024-04-07T20:09:48,Zarautz,expenses,internet,-43.69,-65485.06
buyer_2,Carmen,Lozano,1984-09-05,01940193M,carmen.lozano@brilliantdata.site,257841,ES11209564797724896921,5500.05,2024-04-08T23:35:08,Zarautz,expenses,gas,-100.27,-65585.33
buyer_2,Carmen,Lozano,1984-09-05,01940193M,carmen.lozano@brilliantdata.site,257841,ES11209564797724896921,5500.05,2024-04-09T08:26:22,Zarautz,expenses,food,-97.78,-65683.11
buyer_2,Carmen,Lozano,1984-09-05,01940193M,carmen.lozano@brilliantdata.site,257841,ES11209564797724896921,5500.05,2024-04-09T19:39:14,Zarautz,expenses,cash,-100.0,-65783.11
buyer_2,Carmen,Lozano,1984-09-05,01940193M,carmen.lozano@brilliantdata.site,257841,ES11209564797724896921,5500.05,2024-04-12T15:41:44,Zarautz,expenses,transport,-78.15,-65861.26
buyer_2,Carmen,Lozano,1984-09-05,01940193M,carmen.lozano@brilliantdata.site,257841,ES11209564797724896921,5500.05,2024-04-14T07:48:09,Zarautz,expenses,repairs,-187.35,-66048.61
buyer_2,Carmen,Lozano,1984-09-05,01940193M,carmen.lozano@brilliantdata.site,257841,ES11209564797724896921,5500.05,2024-04-15T19:11:57,Zarautz,expenses,food,-81.36,-66129.97
buyer_2,Carmen,Lozano,1984-09-05,01940193M,carmen.lozano@brilliantdata.site,257841,ES11209564797724896921,5500.05,2024-04-18T14:48:32,Zarautz,expenses,transport,-87.3,-66217.27
buyer_2,Carmen,Lozano,1984-09-05,01940193M,carmen.lozano@brilliantdata.site,257841,ES11209564797724896921,5500.05,2024-04-24T12:05:17,Zarautz,expenses,leisure,-60.76,-66278.03
buyer_2,Carmen,Lozano,1984-09-05,01940193M,carmen.lozano@brilliantdata.site,257841,ES11209564797724896921,5500.05,2024-04-29T18:04:23,Zarautz,expenses,transport,-79.19,-66357.22
buyer_2,Carmen,Lozano,1984-09-05,01940193M,carmen.lozano@brilliantdata.site,257841,ES11209564797724896921,5500.05,2024-05-01T12:03:31,Zarautz,incomes,salary,2080.3,-64276.92
buyer_2,Carmen,Lozano,1984-09-05,01940193M,carmen.lozano@brilliantdata.site,257841,ES11209564797724896921,5500.05,2024-05-02T14:48:06,Zarautz,expenses,gifts,-592.01,-64868.93
buyer_2,Carmen,Lozano,1984-09-05,01940193M,carmen.lozano@brilliantdata.site,257841,ES11209564797724896921,5500.05,2024-05-04T17:22:42,Zarautz,expenses,mortgage,-1059.41,-65928.34
buyer_2,Carmen,Lozano,1984-09-05,01940193M,carmen.lozano@brilliantdata.site,257841,ES11209564797724896921,5500.05,2024-05-05T18:02:31,Zarautz,expenses,electricity,-38.02,-65966.36
buyer_2,Carmen,Lozano,1984-09-05,01940193M,carmen.lozano@brilliantdata.site,257841,ES11209564797724896921,5500.05,2024-05-05T19:07:36,Zarautz,expenses,internet,-43.69,-66010.05
buyer_2,Carmen,Lozano,1984-09-05,01940193M,carmen.lozano@brilliantdata.site,257841,ES11209564797724896921,5500.05,2024-05-05T18:18:02,Zarautz,expenses,clothing,-153.97,-66164.02
buyer_2,Carmen,Lozano,1984-09-05,01940193M,carmen.lozano@brilliantdata.site,257841,ES11209564797724896921,5500.05,2024-05-06T12:16:34,Zarautz,expenses,transport,-76.86,-66240.88
buyer_2,Carmen,Lozano,1984-09-05,01940193M,carmen.lozano@brilliantdata.site,257841,ES11209564797724896921,5500.05,2024-05-06T09:36:08,Zarautz,expenses,cash,-100.0,-66340.88
buyer_2,Carmen,Lozano,1984-09-05,01940193M,carmen.lozano@brilliantdata.site,257841,ES11209564797724896921,5500.05,2024-05-06T12:27:29,Zarautz,expenses,appliances,-202.26,-66543.14
buyer_2,Carmen,Lozano,1984-09-05,01940193M,carmen.lozano@brilliantdata.site,257841,ES11209564797724896921,5500.05,2024-05-06T13:30:57,Zarautz,expenses,gifts,-83.18,-66626.32
buyer_2,Carmen,Lozano,1984-09-05,01940193M,carmen.lozano@brilliantdata.site,257841,ES11209564797724896921,5500.05,2024-05-07T18:02:26,Zarautz,expenses,food,-93.88,-66720.2
buyer_2,Carmen,Lozano,1984-09-05,01940193M,carmen.lozano@brilliantdata.site,257841,ES11209564797724896921,5500.05,2024-05-07T12:19:35,Zarautz,expenses,clothing,-66.85,-66787.05
buyer_2,Carmen,Lozano,1984-09-05,01940193M,carmen.lozano@brilliantdata.site,257841,ES11209564797724896921,5500.05,2024-05-07T09:58:53,Zarautz,expenses,cash,-100.0,-66887.05
buyer_2,Carmen,Lozano,1984-09-05,01940193M,carmen.lozano@brilliantdata.site,257841,ES11209564797724896921,5500.05,2024-05-08T14:37:19,Zarautz,expenses,water,-29.95,-66917.0
buyer_2,Carmen,Lozano,1984-09-05,01940193M,carmen.lozano@brilliantdata.site,257841,ES11209564797724896921,5500.05,2024-05-08T11:11:20,Zarautz,expenses,gas,-78.02,-66995.02
buyer_2,Carmen,Lozano,1984-09-05,01940193M,carmen.lozano@brilliantdata.site,257841,ES11209564797724896921,5500.05,2024-05-08T18:39:57,Zarautz,expenses,phone,-44.09,-67039.11
buyer_2,Carmen,Lozano,1984-09-05,01940193M,carmen.lozano@brilliantdata.site,257841,ES11209564797724896921,5500.05,2024-05-08T01:39:34,Zarautz,expenses,transport,-43.55,-67082.66
buyer_2,Carmen,Lozano,1984-09-05,01940193M,carmen.lozano@brilliantdata.site,257841,ES11209564797724896921,5500.05,2024-05-10T18:58:59,Zarautz,expenses,cash,-100.0,-67182.66
buyer_2,Carmen,Lozano,1984-09-05,01940193M,carmen.lozano@brilliantdata.site,257841,ES11209564797724896921,5500.05,2024-05-10T17:34:07,Zarautz,expenses,children,-354.22,-67536.88
buyer_2,Carmen,Lozano,1984-09-05,01940193M,carmen.lozano@brilliantdata.site,257841,ES11209564797724896921,5500.05,2024-05-12T16:27:55,Zarautz,expenses,clothing,-48.2,-67585.08
buyer_2,Carmen,Lozano,1984-09-05,01940193M,carmen.lozano@brilliantdata.site,257841,ES11209564797724896921,5500.05,2024-05-13T08:26:58,Zarautz,expenses,repairs,-67.35,-67652.43
buyer_2,Carmen,Lozano,1984-09-05,01940193M,carmen.lozano@brilliantdata.site,257841,ES11209564797724896921,5500.05,2024-05-15T02:36:26,Zarautz,expenses,food,-102.77,-67755.2
buyer_2,Carmen,Lozano,1984-09-05,01940193M,carmen.lozano@brilliantdata.site,257841,ES11209564797724896921,5500.05,2024-05-15T20:36:46,Zarautz,expenses,cash,-100.0,-67855.2
buyer_2,Carmen,Lozano,1984-09-05,01940193M,carmen.lozano@brilliantdata.site,257841,ES11209564797724896921,5500.05,2024-05-16T17:15:19,Zarautz,expenses,children,-269.28,-68124.48
buyer_2,Carmen,Lozano,1984-09-05,01940193M,carmen.lozano@brilliantdata.site,257841,ES11209564797724896921,5500.05,2024-05-17T10:24:35,Zarautz,expenses,gifts,-197.88,-68322.36
buyer_2,Carmen,Lozano,1984-09-05,01940193M,carmen.lozano@brilliantdata.site,257841,ES11209564797724896921,5500.05,2024-05-20T10:05:45,Zarautz,expenses,appliances,-181.58,-68503.94
buyer_2,Carmen,Lozano,1984-09-05,01940193M,carmen.lozano@brilliantdata.site,257841,ES11209564797724896921,5500.05,2024-05-21T02:55:18,Zarautz,expenses,cash,-100.0,-68603.94
buyer_2,Carmen,Lozano,1984-09-05,01940193M,carmen.lozano@brilliantdata.site,257841,ES11209564797724896921,5500.05,2024-05-24T20:01:22,Zarautz,expenses,leisure,-49.58,-68653.52
buyer_2,Carmen,Lozano,1984-09-05,01940193M,carmen.lozano@brilliantdata.site,257841,ES11209564797724896921,5500.05,2024-05-24T12:45:51,Zarautz,expenses,cash,-100.0,-68753.52
buyer_2,Carmen,Lozano,1984-09-05,01940193M,carmen.lozano@brilliantdata.site,257841,ES11209564797724896921,5500.05,2024-05-25T16:01:30,Zarautz,expenses,cash,-100.0,-68853.52
buyer_2,Carmen,Lozano,1984-09-05,01940193M,carmen.lozano@brilliantdata.site,257841,ES11209564797724896921,5500.05,2024-05-26T14:42:20,Zarautz,expenses,education,-49.09,-68902.61
buyer_2,Carmen,Lozano,1984-09-05,01940193M,carmen.lozano@brilliantdata.site,257841,ES11209564797724896921,5500.05,2024-05-27T10:25:10,Zarautz,expenses,appliances,-300.79,-69203.4
buyer_2,Carmen,Lozano,1984-09-05,01940193M,carmen.lozano@brilliantdata.site,257841,ES11209564797724896921,5500.05,2024-05-28T19:18:17,Zarautz,expenses,cash,-100.0,-69303.4
buyer_2,Carmen,Lozano,1984-09-05,01940193M,carmen.lozano@brilliantdata.site,257841,ES11209564797724896921,5500.05,2024-05-30T08:58:12,Zarautz,expenses,food,-85.1,-69388.5
buyer_2,Carmen,Lozano,1984-09-05,01940193M,carmen.lozano@brilliantdata.site,257841,ES11209564797724896921,5500.05,2024-05-30T07:22:40,Zarautz,expenses,education,-72.04,-69460.54
buyer_2,Carmen,Lozano,1984-09-05,01940193M,carmen.lozano@brilliantdata.site,257841,ES11209564797724896921,5500.05,2024-05-31T10:37:16,Zarautz,expenses,food,-99.53,-69560.07
buyer_2,Carmen,Lozano,1984-09-05,01940193M,carmen.lozano@brilliantdata.site,257841,ES11209564797724896921,5500.05,2024-05-31T19:05:14,Zarautz,expenses,leisure,-83.18,-69643.25
buyer_2,Carmen,Lozano,1984-09-05,01940193M,carmen.lozano@brilliantdata.site,257841,ES11209564797724896921,5500.05,2024-05-31T13:10:19,Zarautz,expenses,gifts,-457.99,-70101.24
buyer_2,Carmen,Lozano,1984-09-05,01940193M,carmen.lozano@brilliantdata.site,257841,ES11209564797724896921,5500.05,2024-06-01T22:23:01,Zarautz,incomes,salary,2080.3,-68020.94
buyer_2,Carmen,Lozano,1984-09-05,01940193M,carmen.lozano@brilliantdata.site,257841,ES11209564797724896921,5500.05,2024-06-01T22:23:01,Zarautz,incomes,salary_bonus,1601.86,-66419.08
buyer_2,Carmen,Lozano,1984-09-05,01940193M,carmen.lozano@brilliantdata.site,257841,ES11209564797724896921,5500.05,2024-06-01T20:18:03,Zarautz,expenses,food,-88.67,-66507.75
buyer_2,Carmen,Lozano,1984-09-05,01940193M,carmen.lozano@brilliantdata.site,257841,ES11209564797724896921,5500.05,2024-06-01T13:31:59,Zarautz,expenses,transport,-56.36,-66564.11
buyer_2,Carmen,Lozano,1984-09-05,01940193M,carmen.lozano@brilliantdata.site,257841,ES11209564797724896921,5500.05,2024-06-03T15:09:08,Zarautz,expenses,food,-82.59,-66646.7
buyer_2,Carmen,Lozano,1984-09-05,01940193M,carmen.lozano@brilliantdata.site,257841,ES11209564797724896921,5500.05,2024-06-04T14:25:53,Zarautz,expenses,mortgage,-1059.41,-67706.11
buyer_2,Carmen,Lozano,1984-09-05,01940193M,carmen.lozano@brilliantdata.site,257841,ES11209564797724896921,5500.05,2024-06-05T19:09:44,Zarautz,expenses,water,-31.22,-67737.33
buyer_2,Carmen,Lozano,1984-09-05,01940193M,carmen.lozano@brilliantdata.site,257841,ES11209564797724896921,5500.05,2024-06-06T09:20:06,Zarautz,expenses,gifts,-177.44,-67914.77
buyer_2,Carmen,Lozano,1984-09-05,01940193M,carmen.lozano@brilliantdata.site,257841,ES11209564797724896921,5500.05,2024-06-07T08:24:32,Zarautz,expenses,electricity,-60.18,-67974.95
buyer_2,Carmen,Lozano,1984-09-05,01940193M,carmen.lozano@brilliantdata.site,257841,ES11209564797724896921,5500.05,2024-06-07T09:44:10,Zarautz,expenses,phone,-36.37,-68011.32
buyer_2,Carmen,Lozano,1984-09-05,01940193M,carmen.lozano@brilliantdata.site,257841,ES11209564797724896921,5500.05,2024-06-07T08:01:41,Zarautz,expenses,repairs,-138.79,-68150.11
buyer_2,Carmen,Lozano,1984-09-05,01940193M,carmen.lozano@brilliantdata.site,257841,ES11209564797724896921,5500.05,2024-06-08T10:53:42,Zarautz,expenses,internet,-43.69,-68193.8
buyer_2,Carmen,Lozano,1984-09-05,01940193M,carmen.lozano@brilliantdata.site,257841,ES11209564797724896921,5500.05,2024-06-08T14:56:28,Zarautz,expenses,gas,-32.04,-68225.84
buyer_2,Carmen,Lozano,1984-09-05,01940193M,carmen.lozano@brilliantdata.site,257841,ES11209564797724896921,5500.05,2024-06-09T20:58:29,Zarautz,expenses,transport,-63.77,-68289.61
buyer_2,Carmen,Lozano,1984-09-05,01940193M,carmen.lozano@brilliantdata.site,257841,ES11209564797724896921,5500.05,2024-06-10T13:36:23,Zarautz,expenses,education,-42.59,-68332.2
buyer_2,Carmen,Lozano,1984-09-05,01940193M,carmen.lozano@brilliantdata.site,257841,ES11209564797724896921,5500.05,2024-06-10T13:27:28,Zarautz,expenses,gifts,-177.75,-68509.95
buyer_2,Carmen,Lozano,1984-09-05,01940193M,carmen.lozano@brilliantdata.site,257841,ES11209564797724896921,5500.05,2024-06-11T23:01:54,Zarautz,expenses,gifts,-89.5,-68599.45
buyer_2,Carmen,Lozano,1984-09-05,01940193M,carmen.lozano@brilliantdata.site,257841,ES11209564797724896921,5500.05,2024-06-13T17:43:06,Zarautz,expenses,food,-78.88,-68678.33
buyer_2,Carmen,Lozano,1984-09-05,01940193M,carmen.lozano@brilliantdata.site,257841,ES11209564797724896921,5500.05,2024-06-14T15:12:41,Zarautz,expenses,leisure,-77.35,-68755.68
buyer_2,Carmen,Lozano,1984-09-05,01940193M,carmen.lozano@brilliantdata.site,257841,ES11209564797724896921,5500.05,2024-06-15T11:58:38,Zarautz,expenses,education,-52.67,-68808.35
buyer_2,Carmen,Lozano,1984-09-05,01940193M,carmen.lozano@brilliantdata.site,257841,ES11209564797724896921,5500.05,2024-06-16T16:59:59,Zarautz,expenses,leisure,-53.96,-68862.31
buyer_2,Carmen,Lozano,1984-09-05,01940193M,carmen.lozano@brilliantdata.site,257841,ES11209564797724896921,5500.05,2024-06-19T23:13:39,Zarautz,expenses,food,-77.73,-68940.04
buyer_2,Carmen,Lozano,1984-09-05,01940193M,carmen.lozano@brilliantdata.site,257841,ES11209564797724896921,5500.05,2024-06-19T14:22:39,Zarautz,expenses,leisure,-65.23,-69005.27
buyer_2,Carmen,Lozano,1984-09-05,01940193M,carmen.lozano@brilliantdata.site,257841,ES11209564797724896921,5500.05,2024-06-21T22:00:25,Zarautz,expenses,food,-70.95,-69076.22
buyer_2,Carmen,Lozano,1984-09-05,01940193M,carmen.lozano@brilliantdata.site,257841,ES11209564797724896921,5500.05,2024-06-21T19:06:15,Zarautz,expenses,transport,-49.06,-69125.28
buyer_2,Carmen,Lozano,1984-09-05,01940193M,carmen.lozano@brilliantdata.site,257841,ES11209564797724896921,5500.05,2024-06-23T19:09:55,Zarautz,expenses,cash,-100.0,-69225.28
buyer_2,Carmen,Lozano,1984-09-05,01940193M,carmen.lozano@brilliantdata.site,257841,ES11209564797724896921,5500.05,2024-06-25T00:30:22,Zarautz,expenses,transport,-68.03,-69293.31
buyer_2,Carmen,Lozano,1984-09-05,01940193M,carmen.lozano@brilliantdata.site,257841,ES11209564797724896921,5500.05,2024-06-25T09:26:24,Zarautz,expenses,repairs,-157.44,-69450.75
buyer_2,Carmen,Lozano,1984-09-05,01940193M,carmen.lozano@brilliantdata.site,257841,ES11209564797724896921,5500.05,2024-06-26T12:38:27,Zarautz,expenses,food,-102.02,-69552.77
buyer_2,Carmen,Lozano,1984-09-05,01940193M,carmen.lozano@brilliantdata.site,257841,ES11209564797724896921,5500.05,2024-06-28T08:35:10,Zarautz,expenses,healthcare,-169.82,-69722.59
buyer_2,Carmen,Lozano,1984-09-05,01940193M,carmen.lozano@brilliantdata.site,257841,ES11209564797724896921,5500.05,2024-06-29T08:08:10,Zarautz,expenses,cash,-100.0,-69822.59
buyer_2,Carmen,Lozano,1984-09-05,01940193M,carmen.lozano@brilliantdata.site,257841,ES11209564797724896921,5500.05,2024-06-30T18:03:14,Zarautz,expenses,clothing,-155.64,-69978.23
buyer_2,Carmen,Lozano,1984-09-05,01940193M,carmen.lozano@brilliantdata.site,257841,ES11209564797724896921,5500.05,2024-07-01T13:10:41,Zarautz,incomes,salary,2080.3,-67897.93
buyer_2,Carmen,Lozano,1984-09-05,01940193M,carmen.lozano@brilliantdata.site,257841,ES11209564797724896921,5500.05,2024-07-03T01:11:46,Zarautz,expenses,leisure,-68.24,-67966.17
buyer_2,Carmen,Lozano,1984-09-05,01940193M,carmen.lozano@brilliantdata.site,257841,ES11209564797724896921,5500.05,2024-07-04T17:18:34,Zarautz,expenses,mortgage,-1059.41,-69025.58
buyer_2,Carmen,Lozano,1984-09-05,01940193M,carmen.lozano@brilliantdata.site,257841,ES11209564797724896921,5500.05,2024-07-04T21:11:33,Zarautz,expenses,cash,-100.0,-69125.58
buyer_2,Carmen,Lozano,1984-09-05,01940193M,carmen.lozano@brilliantdata.site,257841,ES11209564797724896921,5500.05,2024-07-04T08:28:26,Zarautz,expenses,gifts,-526.94,-69652.52
buyer_2,Carmen,Lozano,1984-09-05,01940193M,carmen.lozano@brilliantdata.site,257841,ES11209564797724896921,5500.05,2024-07-05T21:43:01,Zarautz,expenses,water,-27.35,-69679.87
buyer_2,Carmen,Lozano,1984-09-05,01940193M,carmen.lozano@brilliantdata.site,257841,ES11209564797724896921,5500.05,2024-07-07T18:03:28,Zarautz,expenses,gas,-38.71,-69718.58
buyer_2,Carmen,Lozano,1984-09-05,01940193M,carmen.lozano@brilliantdata.site,257841,ES11209564797724896921,5500.05,2024-07-07T05:49:55,Zarautz,expenses,internet,-43.69,-69762.27
buyer_2,Carmen,Lozano,1984-09-05,01940193M,carmen.lozano@brilliantdata.site,257841,ES11209564797724896921,5500.05,2024-07-07T20:43:07,Zarautz,expenses,phone,-44.41,-69806.68
buyer_2,Carmen,Lozano,1984-09-05,01940193M,carmen.lozano@brilliantdata.site,257841,ES11209564797724896921,5500.05,2024-07-07T17:26:30,Zarautz,expenses,cash,-100.0,-69906.68
buyer_2,Carmen,Lozano,1984-09-05,01940193M,carmen.lozano@brilliantdata.site,257841,ES11209564797724896921,5500.05,2024-07-08T06:26:27,Zarautz,expenses,electricity,-54.17,-69960.85
buyer_2,Carmen,Lozano,1984-09-05,01940193M,carmen.lozano@brilliantdata.site,257841,ES11209564797724896921,5500.05,2024-07-09T22:46:08,Zarautz,expenses,transport,-69.13,-70029.98
buyer_2,Carmen,Lozano,1984-09-05,01940193M,carmen.lozano@brilliantdata.site,257841,ES11209564797724896921,5500.05,2024-07-10T17:34:41,Zarautz,expenses,transport,-79.5,-70109.48
buyer_2,Carmen,Lozano,1984-09-05,01940193M,carmen.lozano@brilliantdata.site,257841,ES11209564797724896921,5500.05,2024-07-10T12:12:42,Zarautz,expenses,gifts,-394.76,-70504.24
buyer_2,Carmen,Lozano,1984-09-05,01940193M,carmen.lozano@brilliantdata.site,257841,ES11209564797724896921,5500.05,2024-07-11T18:58:22,Zarautz,expenses,children,-586.53,-71090.77
buyer_2,Carmen,Lozano,1984-09-05,01940193M,carmen.lozano@brilliantdata.site,257841,ES11209564797724896921,5500.05,2024-07-15T08:22:54,Zarautz,expenses,clothing,-83.84,-71174.61
buyer_2,Carmen,Lozano,1984-09-05,01940193M,carmen.lozano@brilliantdata.site,257841,ES11209564797724896921,5500.05,2024-07-15T09:47:10,Zarautz,expenses,cash,-100.0,-71274.61
buyer_2,Carmen,Lozano,1984-09-05,01940193M,carmen.lozano@brilliantdata.site,257841,ES11209564797724896921,5500.05,2024-07-16T18:26:51,Zarautz,expenses,leisure,-79.09,-71353.7
buyer_2,Carmen,Lozano,1984-09-05,01940193M,carmen.lozano@brilliantdata.site,257841,ES11209564797724896921,5500.05,2024-07-16T17:16:38,Zarautz,expenses,travel,-500.77,-71854.47
buyer_2,Carmen,Lozano,1984-09-05,01940193M,carmen.lozano@brilliantdata.site,257841,ES11209564797724896921,5500.05,2024-07-16T18:33:13,Zarautz,expenses,repairs,-32.29,-71886.76
buyer_2,Carmen,Lozano,1984-09-05,01940193M,carmen.lozano@brilliantdata.site,257841,ES11209564797724896921,5500.05,2024-07-17T09:56:51,Zarautz,expenses,healthcare,-68.15,-71954.91
buyer_2,Carmen,Lozano,1984-09-05,01940193M,carmen.lozano@brilliantdata.site,257841,ES11209564797724896921,5500.05,2024-07-20T09:33:36,Zarautz,expenses,leisure,-27.85,-71982.76
buyer_2,Carmen,Lozano,1984-09-05,01940193M,carmen.lozano@brilliantdata.site,257841,ES11209564797724896921,5500.05,2024-07-21T19:19:28,Zarautz,expenses,children,-521.48,-72504.24
buyer_2,Carmen,Lozano,1984-09-05,01940193M,carmen.lozano@brilliantdata.site,257841,ES11209564797724896921,5500.05,2024-07-22T07:15:49,Zarautz,expenses,cash,-100.0,-72604.24
buyer_2,Carmen,Lozano,1984-09-05,01940193M,carmen.lozano@brilliantdata.site,257841,ES11209564797724896921,5500.05,2024-07-25T19:25:24,Zarautz,expenses,food,-70.67,-72674.91
buyer_2,Carmen,Lozano,1984-09-05,01940193M,carmen.lozano@brilliantdata.site,257841,ES11209564797724896921,5500.05,2024-07-25T09:40:57,Zarautz,expenses,repairs,-103.89,-72778.8
buyer_2,Carmen,Lozano,1984-09-05,01940193M,carmen.lozano@brilliantdata.site,257841,ES11209564797724896921,5500.05,2024-07-25T19:36:09,Zarautz,expenses,gifts,-83.38,-72862.18
buyer_2,Carmen,Lozano,1984-09-05,01940193M,carmen.lozano@brilliantdata.site,257841,ES11209564797724896921,5500.05,2024-07-28T12:31:33,Zarautz,expenses,healthcare,-58.29,-72920.47
buyer_2,Carmen,Lozano,1984-09-05,01940193M,carmen.lozano@brilliantdata.site,257841,ES11209564797724896921,5500.05,2024-07-28T19:50:14,Zarautz,expenses,appliances,-407.12,-73327.59
buyer_2,Carmen,Lozano,1984-09-05,01940193M,carmen.lozano@brilliantdata.site,257841,ES11209564797724896921,5500.05,2024-07-28T10:32:24,Zarautz,expenses,gifts,-64.06,-73391.65
buyer_2,Carmen,Lozano,1984-09-05,01940193M,carmen.lozano@brilliantdata.site,257841,ES11209564797724896921,5500.05,2024-07-29T12:32:27,Zarautz,expenses,food,-112.31,-73503.96
buyer_2,Carmen,Lozano,1984-09-05,01940193M,carmen.lozano@brilliantdata.site,257841,ES11209564797724896921,5500.05,2024-07-29T18:46:31,Zarautz,expenses,transport,-48.59,-73552.55
buyer_2,Carmen,Lozano,1984-09-05,01940193M,carmen.lozano@brilliantdata.site,257841,ES11209564797724896921,5500.05,2024-07-30T11:15:29,Zarautz,expenses,transport,-65.04,-73617.59
buyer_2,Carmen,Lozano,1984-09-05,01940193M,carmen.lozano@brilliantdata.site,257841,ES11209564797724896921,5500.05,2024-07-30T14:28:10,Zarautz,expenses,gifts,-580.87,-74198.46
buyer_2,Carmen,Lozano,1984-09-05,01940193M,carmen.lozano@brilliantdata.site,257841,ES11209564797724896921,5500.05,2024-07-31T08:25:55,Zarautz,expenses,transport,-57.87,-74256.33
buyer_2,Carmen,Lozano,1984-09-05,01940193M,carmen.lozano@brilliantdata.site,257841,ES11209564797724896921,5500.05,2024-07-31T15:31:33,Zarautz,expenses,gifts,-42.14,-74298.47
buyer_2,Carmen,Lozano,1984-09-05,01940193M,carmen.lozano@brilliantdata.site,257841,ES11209564797724896921,5500.05,2024-08-01T09:28:02,Zarautz,incomes,salary,2080.3,-72218.17
buyer_2,Carmen,Lozano,1984-09-05,01940193M,carmen.lozano@brilliantdata.site,257841,ES11209564797724896921,5500.05,2024-08-01T09:28:02,Zarautz,incomes,extra_income,376.86,-71841.31
buyer_2,Carmen,Lozano,1984-09-05,01940193M,carmen.lozano@brilliantdata.site,257841,ES11209564797724896921,5500.05,2024-08-01T15:33:11,Zarautz,expenses,appliances,-357.43,-72198.74
buyer_2,Carmen,Lozano,1984-09-05,01940193M,carmen.lozano@brilliantdata.site,257841,ES11209564797724896921,5500.05,2024-08-02T17:52:54,Zarautz,expenses,cash,-100.0,-72298.74
buyer_2,Carmen,Lozano,1984-09-05,01940193M,carmen.lozano@brilliantdata.site,257841,ES11209564797724896921,5500.05,2024-08-03T18:46:19,Zarautz,expenses,transport,-53.54,-72352.28
buyer_2,Carmen,Lozano,1984-09-05,01940193M,carmen.lozano@brilliantdata.site,257841,ES11209564797724896921,5500.05,2024-08-03T17:50:22,Zarautz,expenses,clothing,-50.28,-72402.56
buyer_2,Carmen,Lozano,1984-09-05,01940193M,carmen.lozano@brilliantdata.site,257841,ES11209564797724896921,5500.05,2024-08-03T19:04:45,Zarautz,expenses,repairs,-68.66,-72471.22
buyer_2,Carmen,Lozano,1984-09-05,01940193M,carmen.lozano@brilliantdata.site,257841,ES11209564797724896921,5500.05,2024-08-04T14:29:12,Zarautz,expenses,mortgage,-1059.41,-73530.63
buyer_2,Carmen,Lozano,1984-09-05,01940193M,carmen.lozano@brilliantdata.site,257841,ES11209564797724896921,5500.05,2024-08-04T15:52:50,Zarautz,expenses,repairs,-285.48,-73816.11
buyer_2,Carmen,Lozano,1984-09-05,01940193M,carmen.lozano@brilliantdata.site,257841,ES11209564797724896921,5500.05,2024-08-05T09:34:05,Zarautz,expenses,transport,-67.1,-73883.21
buyer_2,Carmen,Lozano,1984-09-05,01940193M,carmen.lozano@brilliantdata.site,257841,ES11209564797724896921,5500.05,2024-08-05T08:27:10,Zarautz,expenses,gifts,-27.5,-73910.71
buyer_2,Carmen,Lozano,1984-09-05,01940193M,carmen.lozano@brilliantdata.site,257841,ES11209564797724896921,5500.05,2024-08-06T13:58:55,Zarautz,expenses,water,-23.63,-73934.34
buyer_2,Carmen,Lozano,1984-09-05,01940193M,carmen.lozano@brilliantdata.site,257841,ES11209564797724896921,5500.05,2024-08-07T20:45:29,Zarautz,expenses,gas,-73.32,-74007.66
buyer_2,Carmen,Lozano,1984-09-05,01940193M,carmen.lozano@brilliantdata.site,257841,ES11209564797724896921,5500.05,2024-08-07T11:19:44,Zarautz,expenses,leisure,-60.7,-74068.36
buyer_2,Carmen,Lozano,1984-09-05,01940193M,carmen.lozano@brilliantdata.site,257841,ES11209564797724896921,5500.05,2024-08-07T14:30:06,Zarautz,expenses,clothing,-105.06,-74173.42
buyer_2,Carmen,Lozano,1984-09-05,01940193M,carmen.lozano@brilliantdata.site,257841,ES11209564797724896921,5500.05,2024-08-08T16:22:54,Zarautz,expenses,electricity,-59.25,-74232.67
buyer_2,Carmen,Lozano,1984-09-05,01940193M,carmen.lozano@brilliantdata.site,257841,ES11209564797724896921,5500.05,2024-08-08T13:35:28,Zarautz,expenses,internet,-43.69,-74276.36
buyer_2,Carmen,Lozano,1984-09-05,01940193M,carmen.lozano@brilliantdata.site,257841,ES11209564797724896921,5500.05,2024-08-08T08:06:02,Zarautz,expenses,phone,-41.05,-74317.41
buyer_2,Carmen,Lozano,1984-09-05,01940193M,carmen.lozano@brilliantdata.site,257841,ES11209564797724896921,5500.05,2024-08-08T14:24:03,Zarautz,expenses,education,-78.27,-74395.68
buyer_2,Carmen,Lozano,1984-09-05,01940193M,carmen.lozano@brilliantdata.site,257841,ES11209564797724896921,5500.05,2024-08-08T10:08:15,Zarautz,expenses,gifts,-411.43,-74807.11
buyer_2,Carmen,Lozano,1984-09-05,01940193M,carmen.lozano@brilliantdata.site,257841,ES11209564797724896921,5500.05,2024-08-08T21:34:34,Zarautz,expenses,children,-168.9387500000003,-74976.05
buyer_2,Carmen,Lozano,1984-09-05,01940193M,carmen.lozano@brilliantdata.site,257841,ES11209564797724896921,5500.05,2024-08-09T18:27:36,Zarautz,expenses,transport,-42.17,-75018.22
buyer_2,Carmen,Lozano,1984-09-05,01940193M,carmen.lozano@brilliantdata.site,257841,ES11209564797724896921,5500.05,2024-08-11T11:00:32,Zarautz,expenses,cash,-100.0,-75118.22
buyer_2,Carmen,Lozano,1984-09-05,01940193M,carmen.lozano@brilliantdata.site,257841,ES11209564797724896921,5500.05,2024-08-12T08:01:22,Zarautz,expenses,education,-69.43,-75187.65
buyer_2,Carmen,Lozano,1984-09-05,01940193M,carmen.lozano@brilliantdata.site,257841,ES11209564797724896921,5500.05,2024-08-14T09:59:35,Zarautz,expenses,healthcare,-122.48,-75310.13
buyer_2,Carmen,Lozano,1984-09-05,01940193M,carmen.lozano@brilliantdata.site,257841,ES11209564797724896921,5500.05,2024-08-15T12:37:12,Zarautz,expenses,repairs,-231.85,-75541.98
buyer_2,Carmen,Lozano,1984-09-05,01940193M,carmen.lozano@brilliantdata.site,257841,ES11209564797724896921,5500.05,2024-08-17T09:12:43,Zarautz,expenses,cash,-100.0,-75641.98
buyer_2,Carmen,Lozano,1984-09-05,01940193M,carmen.lozano@brilliantdata.site,257841,ES11209564797724896921,5500.05,2024-08-18T10:20:43,Zarautz,expenses,children,-568.31,-76210.29
buyer_2,Carmen,Lozano,1984-09-05,01940193M,carmen.lozano@brilliantdata.site,257841,ES11209564797724896921,5500.05,2024-08-21T19:37:39,Zarautz,expenses,cash,-100.0,-76310.29
buyer_2,Carmen,Lozano,1984-09-05,01940193M,carmen.lozano@brilliantdata.site,257841,ES11209564797724896921,5500.05,2024-08-22T19:52:32,Zarautz,expenses,cash,-100.0,-76410.29
buyer_2,Carmen,Lozano,1984-09-05,01940193M,carmen.lozano@brilliantdata.site,257841,ES11209564797724896921,5500.05,2024-08-22T11:49:45,Zarautz,expenses,travel,-414.69,-76824.98
buyer_2,Carmen,Lozano,1984-09-05,01940193M,carmen.lozano@brilliantdata.site,257841,ES11209564797724896921,5500.05,2024-08-23T11:43:18,Zarautz,expenses,healthcare,-80.81,-76905.79
buyer_2,Carmen,Lozano,1984-09-05,01940193M,carmen.lozano@brilliantdata.site,257841,ES11209564797724896921,5500.05,2024-08-23T08:40:04,Zarautz,expenses,appliances,-125.41,-77031.2
buyer_2,Carmen,Lozano,1984-09-05,01940193M,carmen.lozano@brilliantdata.site,257841,ES11209564797724896921,5500.05,2024-08-25T17:42:32,Zarautz,expenses,food,-84.49,-77115.69
buyer_2,Carmen,Lozano,1984-09-05,01940193M,carmen.lozano@brilliantdata.site,257841,ES11209564797724896921,5500.05,2024-08-25T12:11:03,Zarautz,expenses,cash,-100.0,-77215.69
buyer_2,Carmen,Lozano,1984-09-05,01940193M,carmen.lozano@brilliantdata.site,257841,ES11209564797724896921,5500.05,2024-08-26T13:45:27,Zarautz,expenses,cash,-100.0,-77315.69
buyer_2,Carmen,Lozano,1984-09-05,01940193M,carmen.lozano@brilliantdata.site,257841,ES11209564797724896921,5500.05,2024-08-27T14:22:39,Zarautz,expenses,children,-658.6387500000003,-77974.33
buyer_2,Carmen,Lozano,1984-09-05,01940193M,carmen.lozano@brilliantdata.site,257841,ES11209564797724896921,5500.05,2024-08-28T08:14:14,Zarautz,expenses,food,-94.1,-78068.43
buyer_2,Carmen,Lozano,1984-09-05,01940193M,carmen.lozano@brilliantdata.site,257841,ES11209564797724896921,5500.05,2024-08-29T23:58:17,Zarautz,expenses,cash,-100.0,-78168.43
buyer_2,Carmen,Lozano,1984-09-05,01940193M,carmen.lozano@brilliantdata.site,257841,ES11209564797724896921,5500.05,2024-09-01T10:01:45,Zarautz,incomes,salary,2080.3,-76088.13
buyer_2,Carmen,Lozano,1984-09-05,01940193M,carmen.lozano@brilliantdata.site,257841,ES11209564797724896921,5500.05,2024-09-01T19:35:18,Zarautz,expenses,transport,-62.59,-76150.72
buyer_2,Carmen,Lozano,1984-09-05,01940193M,carmen.lozano@brilliantdata.site,257841,ES11209564797724896921,5500.05,2024-09-01T18:05:19,Zarautz,expenses,leisure,-26.94,-76177.66
buyer_2,Carmen,Lozano,1984-09-05,01940193M,carmen.lozano@brilliantdata.site,257841,ES11209564797724896921,5500.05,2024-09-02T18:05:34,Zarautz,expenses,transport,-89.97,-76267.63
buyer_2,Carmen,Lozano,1984-09-05,01940193M,carmen.lozano@brilliantdata.site,257841,ES11209564797724896921,5500.05,2024-09-02T10:48:57,Zarautz,expenses,travel,-303.52,-76571.15
buyer_2,Carmen,Lozano,1984-09-05,01940193M,carmen.lozano@brilliantdata.site,257841,ES11209564797724896921,5500.05,2024-09-04T09:33:46,Zarautz,expenses,mortgage,-1059.41,-77630.56
buyer_2,Carmen,Lozano,1984-09-05,01940193M,carmen.lozano@brilliantdata.site,257841,ES11209564797724896921,5500.05,2024-09-04T18:46:31,Zarautz,expenses,cash,-100.0,-77730.56
buyer_2,Carmen,Lozano,1984-09-05,01940193M,carmen.lozano@brilliantdata.site,257841,ES11209564797724896921,5500.05,2024-09-04T19:10:23,Zarautz,expenses,repairs,-234.86,-77965.42
buyer_2,Carmen,Lozano,1984-09-05,01940193M,carmen.lozano@brilliantdata.site,257841,ES11209564797724896921,5500.05,2024-09-05T19:57:22,Zarautz,expenses,clothing,-48.31,-78013.73
buyer_2,Carmen,Lozano,1984-09-05,01940193M,carmen.lozano@brilliantdata.site,257841,ES11209564797724896921,5500.05,2024-09-05T14:26:46,Zarautz,expenses,appliances,-365.34,-78379.07
buyer_2,Carmen,Lozano,1984-09-05,01940193M,carmen.lozano@brilliantdata.site,257841,ES11209564797724896921,5500.05,2024-09-06T17:07:12,Zarautz,expenses,phone,-32.02,-78411.09
buyer_2,Carmen,Lozano,1984-09-05,01940193M,carmen.lozano@brilliantdata.site,257841,ES11209564797724896921,5500.05,2024-09-07T14:19:18,Zarautz,expenses,food,-78.64,-78489.73
buyer_2,Carmen,Lozano,1984-09-05,01940193M,carmen.lozano@brilliantdata.site,257841,ES11209564797724896921,5500.05,2024-09-08T04:10:39,Zarautz,expenses,electricity,-93.1,-78582.83
buyer_2,Carmen,Lozano,1984-09-05,01940193M,carmen.lozano@brilliantdata.site,257841,ES11209564797724896921,5500.05,2024-09-08T21:42:56,Zarautz,expenses,water,-35.52,-78618.35
buyer_2,Carmen,Lozano,1984-09-05,01940193M,carmen.lozano@brilliantdata.site,257841,ES11209564797724896921,5500.05,2024-09-08T18:04:55,Zarautz,expenses,gas,-89.77,-78708.12
buyer_2,Carmen,Lozano,1984-09-05,01940193M,carmen.lozano@brilliantdata.site,257841,ES11209564797724896921,5500.05,2024-09-08T19:36:00,Zarautz,expenses,internet,-43.69,-78751.81
buyer_2,Carmen,Lozano,1984-09-05,01940193M,carmen.lozano@brilliantdata.site,257841,ES11209564797724896921,5500.05,2024-09-09T11:36:36,Zarautz,expenses,leisure,-74.89,-78826.7
buyer_2,Carmen,Lozano,1984-09-05,01940193M,carmen.lozano@brilliantdata.site,257841,ES11209564797724896921,5500.05,2024-09-10T18:43:59,Zarautz,expenses,leisure,-20.92,-78847.62
buyer_2,Carmen,Lozano,1984-09-05,01940193M,carmen.lozano@brilliantdata.site,257841,ES11209564797724896921,5500.05,2024-09-10T20:45:52,Zarautz,expenses,clothing,-69.61,-78917.23
buyer_2,Carmen,Lozano,1984-09-05,01940193M,carmen.lozano@brilliantdata.site,257841,ES11209564797724896921,5500.05,2024-09-12T22:05:52,Zarautz,expenses,leisure,-67.16,-78984.39
buyer_2,Carmen,Lozano,1984-09-05,01940193M,carmen.lozano@brilliantdata.site,257841,ES11209564797724896921,5500.05,2024-09-12T16:45:42,Zarautz,expenses,gifts,-144.14,-79128.53
buyer_2,Carmen,Lozano,1984-09-05,01940193M,carmen.lozano@brilliantdata.site,257841,ES11209564797724896921,5500.05,2024-09-13T13:31:06,Zarautz,expenses,repairs,-164.37,-79292.9
buyer_2,Carmen,Lozano,1984-09-05,01940193M,carmen.lozano@brilliantdata.site,257841,ES11209564797724896921,5500.05,2024-09-15T20:34:21,Zarautz,expenses,repairs,-58.62,-79351.52
buyer_2,Carmen,Lozano,1984-09-05,01940193M,carmen.lozano@brilliantdata.site,257841,ES11209564797724896921,5500.05,2024-09-17T12:26:57,Zarautz,expenses,travel,-620.97,-79972.49
buyer_2,Carmen,Lozano,1984-09-05,01940193M,carmen.lozano@brilliantdata.site,257841,ES11209564797724896921,5500.05,2024-09-18T11:57:24,Zarautz,expenses,cash,-100.0,-80072.49
buyer_2,Carmen,Lozano,1984-09-05,01940193M,carmen.lozano@brilliantdata.site,257841,ES11209564797724896921,5500.05,2024-09-20T17:30:56,Zarautz,expenses,leisure,-37.01,-80109.5
buyer_2,Carmen,Lozano,1984-09-05,01940193M,carmen.lozano@brilliantdata.site,257841,ES11209564797724896921,5500.05,2024-09-20T09:36:25,Zarautz,expenses,education,-44.56,-80154.06
buyer_2,Carmen,Lozano,1984-09-05,01940193M,carmen.lozano@brilliantdata.site,257841,ES11209564797724896921,5500.05,2024-09-20T13:24:42,Zarautz,expenses,appliances,-76.76,-80230.82
buyer_2,Carmen,Lozano,1984-09-05,01940193M,carmen.lozano@brilliantdata.site,257841,ES11209564797724896921,5500.05,2024-09-21T09:38:12,Zarautz,expenses,food,-95.05,-80325.87
buyer_2,Carmen,Lozano,1984-09-05,01940193M,carmen.lozano@brilliantdata.site,257841,ES11209564797724896921,5500.05,2024-09-23T22:57:07,Zarautz,expenses,repairs,-56.48,-80382.35
buyer_2,Carmen,Lozano,1984-09-05,01940193M,carmen.lozano@brilliantdata.site,257841,ES11209564797724896921,5500.05,2024-09-26T23:35:20,Zarautz,expenses,transport,-84.89,-80467.24
buyer_2,Carmen,Lozano,1984-09-05,01940193M,carmen.lozano@brilliantdata.site,257841,ES11209564797724896921,5500.05,2024-09-26T11:31:46,Zarautz,expenses,children,-573.7487500000003,-81040.99
buyer_2,Carmen,Lozano,1984-09-05,01940193M,carmen.lozano@brilliantdata.site,257841,ES11209564797724896921,5500.05,2024-09-27T11:08:11,Zarautz,expenses,leisure,-39.88,-81080.87
buyer_2,Carmen,Lozano,1984-09-05,01940193M,carmen.lozano@brilliantdata.site,257841,ES11209564797724896921,5500.05,2024-09-30T18:28:11,Zarautz,expenses,cash,-100.0,-81180.87
buyer_2,Carmen,Lozano,1984-09-05,01940193M,carmen.lozano@brilliantdata.site,257841,ES11209564797724896921,5500.05,2024-09-30T12:15:53,Zarautz,expenses,repairs,-157.25,-81338.12
buyer_2,Carmen,Lozano,1984-09-05,01940193M,carmen.lozano@brilliantdata.site,257841,ES11209564797724896921,5500.05,2024-10-01T17:49:55,Zarautz,incomes,salary,2080.3,-79257.82
buyer_2,Carmen,Lozano,1984-09-05,01940193M,carmen.lozano@brilliantdata.site,257841,ES11209564797724896921,5500.05,2024-10-01T23:24:05,Zarautz,expenses,education,-76.9,-79334.72
buyer_2,Carmen,Lozano,1984-09-05,01940193M,carmen.lozano@brilliantdata.site,257841,ES11209564797724896921,5500.05,2024-10-03T14:47:48,Zarautz,expenses,transport,-46.6,-79381.32
buyer_2,Carmen,Lozano,1984-09-05,01940193M,carmen.lozano@brilliantdata.site,257841,ES11209564797724896921,5500.05,2024-10-04T20:11:03,Zarautz,expenses,mortgage,-1059.41,-80440.73
buyer_2,Carmen,Lozano,1984-09-05,01940193M,carmen.lozano@brilliantdata.site,257841,ES11209564797724896921,5500.05,2024-10-04T19:35:14,Zarautz,expenses,food,-120.02,-80560.75
buyer_2,Carmen,Lozano,1984-09-05,01940193M,carmen.lozano@brilliantdata.site,257841,ES11209564797724896921,5500.05,2024-10-05T14:09:22,Zarautz,expenses,electricity,-47.45,-80608.2
buyer_2,Carmen,Lozano,1984-09-05,01940193M,carmen.lozano@brilliantdata.site,257841,ES11209564797724896921,5500.05,2024-10-05T11:46:56,Zarautz,expenses,gas,-91.59,-80699.79
buyer_2,Carmen,Lozano,1984-09-05,01940193M,carmen.lozano@brilliantdata.site,257841,ES11209564797724896921,5500.05,2024-10-05T10:47:19,Zarautz,expenses,phone,-31.75,-80731.54
buyer_2,Carmen,Lozano,1984-09-05,01940193M,carmen.lozano@brilliantdata.site,257841,ES11209564797724896921,5500.05,2024-10-05T20:47:01,Zarautz,expenses,education,-45.2,-80776.74
buyer_2,Carmen,Lozano,1984-09-05,01940193M,carmen.lozano@brilliantdata.site,257841,ES11209564797724896921,5500.05,2024-10-05T05:56:28,Zarautz,expenses,cash,-100.0,-80876.74
buyer_2,Carmen,Lozano,1984-09-05,01940193M,carmen.lozano@brilliantdata.site,257841,ES11209564797724896921,5500.05,2024-10-06T12:44:42,Zarautz,expenses,transport,-88.87,-80965.61
buyer_2,Carmen,Lozano,1984-09-05,01940193M,carmen.lozano@brilliantdata.site,257841,ES11209564797724896921,5500.05,2024-10-07T11:13:10,Zarautz,expenses,internet,-43.69,-81009.3
buyer_2,Carmen,Lozano,1984-09-05,01940193M,carmen.lozano@brilliantdata.site,257841,ES11209564797724896921,5500.05,2024-10-07T18:26:07,Zarautz,expenses,healthcare,-52.7,-81062.0
buyer_2,Carmen,Lozano,1984-09-05,01940193M,carmen.lozano@brilliantdata.site,257841,ES11209564797724896921,5500.05,2024-10-08T21:39:39,Zarautz,expenses,water,-23.43,-81085.43
buyer_2,Carmen,Lozano,1984-09-05,01940193M,carmen.lozano@brilliantdata.site,257841,ES11209564797724896921,5500.05,2024-10-08T16:22:51,Zarautz,expenses,food,-83.66,-81169.09
buyer_2,Carmen,Lozano,1984-09-05,01940193M,carmen.lozano@brilliantdata.site,257841,ES11209564797724896921,5500.05,2024-10-10T21:34:19,Zarautz,expenses,food,-74.02,-81243.11
buyer_2,Carmen,Lozano,1984-09-05,01940193M,carmen.lozano@brilliantdata.site,257841,ES11209564797724896921,5500.05,2024-10-10T03:45:09,Zarautz,expenses,cash,-100.0,-81343.11
buyer_3,Ana,Piñeiro,1989-08-23,25810029G,ana.piñeiro@megacloud.online,485584,ES35209577302742069253,6137.07,2022-01-01T12:09:51,Amurrio,incomes,salary,3152.42,9289.49
buyer_3,Ana,Piñeiro,1989-08-23,25810029G,ana.piñeiro@megacloud.online,485584,ES35209577302742069253,6137.07,2022-01-01T12:09:51,Amurrio,incomes,salary_partner,3458.57,12748.06
buyer_3,Ana,Piñeiro,1989-08-23,25810029G,ana.piñeiro@megacloud.online,485584,ES35209577302742069253,6137.07,2022-01-01T17:07:22,Amurrio,expenses,food,-69.6,12678.46
buyer_3,Ana,Piñeiro,1989-08-23,25810029G,ana.piñeiro@megacloud.online,485584,ES35209577302742069253,6137.07,2022-01-02T08:46:07,Amurrio,expenses,food,-73.24,12605.22
buyer_3,Ana,Piñeiro,1989-08-23,25810029G,ana.piñeiro@megacloud.online,485584,ES35209577302742069253,6137.07,2022-01-03T19:41:32,Amurrio,expenses,repairs,-119.9,12485.32
buyer_3,Ana,Piñeiro,1989-08-23,25810029G,ana.piñeiro@megacloud.online,485584,ES35209577302742069253,6137.07,2022-01-04T15:22:41,Amurrio,expenses,mortgage,-2799.85,9685.47
buyer_3,Ana,Piñeiro,1989-08-23,25810029G,ana.piñeiro@megacloud.online,485584,ES35209577302742069253,6137.07,2022-01-04T20:57:59,Amurrio,expenses,cash,-100.0,9585.47
buyer_3,Ana,Piñeiro,1989-08-23,25810029G,ana.piñeiro@megacloud.online,485584,ES35209577302742069253,6137.07,2022-01-04T13:18:45,Amurrio,expenses,gifts,-406.54,9178.93
buyer_3,Ana,Piñeiro,1989-08-23,25810029G,ana.piñeiro@megacloud.online,485584,ES35209577302742069253,6137.07,2022-01-05T18:44:40,Amurrio,expenses,internet,-138.83,9040.1
buyer_3,Ana,Piñeiro,1989-08-23,25810029G,ana.piñeiro@megacloud.online,485584,ES35209577302742069253,6137.07,2022-01-05T13:40:27,Amurrio,expenses,education,-74.39,8965.71
buyer_3,Ana,Piñeiro,1989-08-23,25810029G,ana.piñeiro@megacloud.online,485584,ES35209577302742069253,6137.07,2022-01-06T10:51:30,Amurrio,expenses,gas,-211.53,8754.18
buyer_3,Ana,Piñeiro,1989-08-23,25810029G,ana.piñeiro@megacloud.online,485584,ES35209577302742069253,6137.07,2022-01-07T15:26:31,Amurrio,expenses,electricity,-100.19,8653.99
buyer_3,Ana,Piñeiro,1989-08-23,25810029G,ana.piñeiro@megacloud.online,485584,ES35209577302742069253,6137.07,2022-01-08T11:22:04,Amurrio,expenses,water,-82.98,8571.01
buyer_3,Ana,Piñeiro,1989-08-23,25810029G,ana.piñeiro@megacloud.online,485584,ES35209577302742069253,6137.07,2022-01-08T11:24:09,Amurrio,expenses,phone,-131.46,8439.55
buyer_3,Ana,Piñeiro,1989-08-23,25810029G,ana.piñeiro@megacloud.online,485584,ES35209577302742069253,6137.07,2022-01-09T16:33:17,Amurrio,expenses,cash,-100.0,8339.55
buyer_3,Ana,Piñeiro,1989-08-23,25810029G,ana.piñeiro@megacloud.online,485584,ES35209577302742069253,6137.07,2022-01-10T13:05:07,Amurrio,expenses,food,-105.72,8233.83
buyer_3,Ana,Piñeiro,1989-08-23,25810029G,ana.piñeiro@megacloud.online,485584,ES35209577302742069253,6137.07,2022-01-12T13:26:34,Amurrio,expenses,appliances,-75.73,8158.1
buyer_3,Ana,Piñeiro,1989-08-23,25810029G,ana.piñeiro@megacloud.online,485584,ES35209577302742069253,6137.07,2022-01-13T15:01:16,Amurrio,expenses,cash,-100.0,8058.1
buyer_3,Ana,Piñeiro,1989-08-23,25810029G,ana.piñeiro@megacloud.online,485584,ES35209577302742069253,6137.07,2022-01-13T14:00:53,Amurrio,expenses,repairs,-283.56,7774.54
buyer_3,Ana,Piñeiro,1989-08-23,25810029G,ana.piñeiro@megacloud.online,485584,ES35209577302742069253,6137.07,2022-01-13T16:08:03,Amurrio,expenses,gifts,-114.74,7659.8
buyer_3,Ana,Piñeiro,1989-08-23,25810029G,ana.piñeiro@megacloud.online,485584,ES35209577302742069253,6137.07,2022-01-15T00:00:06,Amurrio,expenses,transport,-63.11,7596.69
buyer_3,Ana,Piñeiro,1989-08-23,25810029G,ana.piñeiro@megacloud.online,485584,ES35209577302742069253,6137.07,2022-01-15T14:45:08,Amurrio,expenses,leisure,-27.01,7569.68
buyer_3,Ana,Piñeiro,1989-08-23,25810029G,ana.piñeiro@megacloud.online,485584,ES35209577302742069253,6137.07,2022-01-16T12:04:49,Amurrio,expenses,cash,-100.0,7469.68
buyer_3,Ana,Piñeiro,1989-08-23,25810029G,ana.piñeiro@megacloud.online,485584,ES35209577302742069253,6137.07,2022-01-17T09:12:06,Amurrio,expenses,repairs,-44.69,7424.99
buyer_3,Ana,Piñeiro,1989-08-23,25810029G,ana.piñeiro@megacloud.online,485584,ES35209577302742069253,6137.07,2022-01-18T10:19:46,Amurrio,expenses,repairs,-250.03,7174.96
buyer_3,Ana,Piñeiro,1989-08-23,25810029G,ana.piñeiro@megacloud.online,485584,ES35209577302742069253,6137.07,2022-01-20T12:28:15,Amurrio,expenses,food,-84.72,7090.24
buyer_3,Ana,Piñeiro,1989-08-23,25810029G,ana.piñeiro@megacloud.online,485584,ES35209577302742069253,6137.07,2022-01-24T10:30:33,Amurrio,expenses,leisure,-64.59,7025.65
buyer_3,Ana,Piñeiro,1989-08-23,25810029G,ana.piñeiro@megacloud.online,485584,ES35209577302742069253,6137.07,2022-01-24T15:45:55,Amurrio,expenses,clothing,-96.63,6929.02
buyer_3,Ana,Piñeiro,1989-08-23,25810029G,ana.piñeiro@megacloud.online,485584,ES35209577302742069253,6137.07,2022-01-25T04:06:09,Amurrio,expenses,food,-88.93,6840.09
buyer_3,Ana,Piñeiro,1989-08-23,25810029G,ana.piñeiro@megacloud.online,485584,ES35209577302742069253,6137.07,2022-01-29T21:37:13,Amurrio,expenses,food,-99.69,6740.4
buyer_3,Ana,Piñeiro,1989-08-23,25810029G,ana.piñeiro@megacloud.online,485584,ES35209577302742069253,6137.07,2022-01-30T12:46:38,Amurrio,expenses,cash,-100.0,6640.4
buyer_3,Ana,Piñeiro,1989-08-23,25810029G,ana.piñeiro@megacloud.online,485584,ES35209577302742069253,6137.07,2022-01-30T22:50:58,Amurrio,expenses,gifts,-362.41,6277.99
buyer_3,Ana,Piñeiro,1989-08-23,25810029G,ana.piñeiro@megacloud.online,485584,ES35209577302742069253,6137.07,2022-01-31T13:03:06,Amurrio,expenses,leisure,-73.12,6204.87
buyer_3,Ana,Piñeiro,1989-08-23,25810029G,ana.piñeiro@megacloud.online,485584,ES35209577302742069253,6137.07,2022-02-01T11:37:38,Amurrio,incomes,salary,3152.42,9357.29
buyer_3,Ana,Piñeiro,1989-08-23,25810029G,ana.piñeiro@megacloud.online,485584,ES35209577302742069253,6137.07,2022-02-01T11:37:38,Amurrio,incomes,salary_partner,3458.57,12815.86
buyer_3,Ana,Piñeiro,1989-08-23,25810029G,ana.piñeiro@megacloud.online,485584,ES35209577302742069253,6137.07,2022-02-01T01:49:34,Amurrio,expenses,transport,-75.08,12740.78
buyer_3,Ana,Piñeiro,1989-08-23,25810029G,ana.piñeiro@megacloud.online,485584,ES35209577302742069253,6137.07,2022-02-01T20:36:35,Amurrio,expenses,leisure,-37.45,12703.33
buyer_3,Ana,Piñeiro,1989-08-23,25810029G,ana.piñeiro@megacloud.online,485584,ES35209577302742069253,6137.07,2022-02-02T09:53:24,Amurrio,expenses,food,-72.22,12631.11
buyer_3,Ana,Piñeiro,1989-08-23,25810029G,ana.piñeiro@megacloud.online,485584,ES35209577302742069253,6137.07,2022-02-04T18:55:50,Amurrio,expenses,mortgage,-2799.85,9831.26
buyer_3,Ana,Piñeiro,1989-08-23,25810029G,ana.piñeiro@megacloud.online,485584,ES35209577302742069253,6137.07,2022-02-04T15:47:01,Amurrio,expenses,gifts,-729.21,9102.05
buyer_3,Ana,Piñeiro,1989-08-23,25810029G,ana.piñeiro@megacloud.online,485584,ES35209577302742069253,6137.07,2022-02-05T17:37:34,Amurrio,expenses,leisure,-70.02,9032.03
buyer_3,Ana,Piñeiro,1989-08-23,25810029G,ana.piñeiro@megacloud.online,485584,ES35209577302742069253,6137.07,2022-02-07T13:34:30,Amurrio,expenses,phone,-121.27,8910.76
buyer_3,Ana,Piñeiro,1989-08-23,25810029G,ana.piñeiro@megacloud.online,485584,ES35209577302742069253,6137.07,2022-02-07T18:04:33,Amurrio,expenses,food,-105.61,8805.15
buyer_3,Ana,Piñeiro,1989-08-23,25810029G,ana.piñeiro@megacloud.online,485584,ES35209577302742069253,6137.07,2022-02-08T08:15:30,Amurrio,expenses,electricity,-255.77,8549.38
buyer_3,Ana,Piñeiro,1989-08-23,25810029G,ana.piñeiro@megacloud.online,485584,ES35209577302742069253,6137.07,2022-02-08T16:30:59,Amurrio,expenses,water,-120.59,8428.79
buyer_3,Ana,Piñeiro,1989-08-23,25810029G,ana.piñeiro@megacloud.online,485584,ES35209577302742069253,6137.07,2022-02-08T14:26:54,Amurrio,expenses,gas,-139.24,8289.55
buyer_3,Ana,Piñeiro,1989-08-23,25810029G,ana.piñeiro@megacloud.online,485584,ES35209577302742069253,6137.07,2022-02-08T09:38:27,Amurrio,expenses,internet,-138.83,8150.72
buyer_3,Ana,Piñeiro,1989-08-23,25810029G,ana.piñeiro@megacloud.online,485584,ES35209577302742069253,6137.07,2022-02-09T08:33:51,Amurrio,expenses,transport,-89.94,8060.78
buyer_3,Ana,Piñeiro,1989-08-23,25810029G,ana.piñeiro@megacloud.online,485584,ES35209577302742069253,6137.07,2022-02-09T16:37:09,Amurrio,expenses,cash,-100.0,7960.78
buyer_3,Ana,Piñeiro,1989-08-23,25810029G,ana.piñeiro@megacloud.online,485584,ES35209577302742069253,6137.07,2022-02-10T16:22:17,Amurrio,expenses,leisure,-23.62,7937.16
buyer_3,Ana,Piñeiro,1989-08-23,25810029G,ana.piñeiro@megacloud.online,485584,ES35209577302742069253,6137.07,2022-02-10T15:23:56,Amurrio,expenses,education,-72.16,7865.0
buyer_3,Ana,Piñeiro,1989-08-23,25810029G,ana.piñeiro@megacloud.online,485584,ES35209577302742069253,6137.07,2022-02-11T17:54:20,Amurrio,expenses,repairs,-62.94,7802.06
buyer_3,Ana,Piñeiro,1989-08-23,25810029G,ana.piñeiro@megacloud.online,485584,ES35209577302742069253,6137.07,2022-02-14T05:55:30,Amurrio,expenses,gifts,-326.79,7475.27
buyer_3,Ana,Piñeiro,1989-08-23,25810029G,ana.piñeiro@megacloud.online,485584,ES35209577302742069253,6137.07,2022-02-15T20:39:24,Amurrio,expenses,food,-85.79,7389.48
buyer_3,Ana,Piñeiro,1989-08-23,25810029G,ana.piñeiro@megacloud.online,485584,ES35209577302742069253,6137.07,2022-02-18T17:33:17,Amurrio,expenses,education,-64.57,7324.91
buyer_3,Ana,Piñeiro,1989-08-23,25810029G,ana.piñeiro@megacloud.online,485584,ES35209577302742069253,6137.07,2022-02-21T13:18:11,Amurrio,expenses,cash,-100.0,7224.91
buyer_3,Ana,Piñeiro,1989-08-23,25810029G,ana.piñeiro@megacloud.online,485584,ES35209577302742069253,6137.07,2022-02-24T17:23:35,Amurrio,expenses,clothing,-93.82,7131.09
buyer_3,Ana,Piñeiro,1989-08-23,25810029G,ana.piñeiro@megacloud.online,485584,ES35209577302742069253,6137.07,2022-02-25T10:44:33,Amurrio,expenses,food,-76.18,7054.91
buyer_3,Ana,Piñeiro,1989-08-23,25810029G,ana.piñeiro@megacloud.online,485584,ES35209577302742069253,6137.07,2022-02-26T08:31:24,Amurrio,expenses,cash,-100.0,6954.91
buyer_3,Ana,Piñeiro,1989-08-23,25810029G,ana.piñeiro@megacloud.online,485584,ES35209577302742069253,6137.07,2022-03-01T20:30:02,Amurrio,incomes,salary,3152.42,10107.33
buyer_3,Ana,Piñeiro,1989-08-23,25810029G,ana.piñeiro@megacloud.online,485584,ES35209577302742069253,6137.07,2022-03-01T20:30:02,Amurrio,incomes,salary_partner,3458.57,13565.9
buyer_3,Ana,Piñeiro,1989-08-23,25810029G,ana.piñeiro@megacloud.online,485584,ES35209577302742069253,6137.07,2022-03-01T20:30:02,Amurrio,incomes,extra_income,379.94,13945.84
buyer_3,Ana,Piñeiro,1989-08-23,25810029G,ana.piñeiro@megacloud.online,485584,ES35209577302742069253,6137.07,2022-03-01T06:51:38,Amurrio,expenses,cash,-100.0,13845.84
buyer_3,Ana,Piñeiro,1989-08-23,25810029G,ana.piñeiro@megacloud.online,485584,ES35209577302742069253,6137.07,2022-03-02T08:05:40,Amurrio,expenses,transport,-67.05,13778.79
buyer_3,Ana,Piñeiro,1989-08-23,25810029G,ana.piñeiro@megacloud.online,485584,ES35209577302742069253,6137.07,2022-03-02T17:11:52,Amurrio,expenses,clothing,-79.47,13699.32
buyer_3,Ana,Piñeiro,1989-08-23,25810029G,ana.piñeiro@megacloud.online,485584,ES35209577302742069253,6137.07,2022-03-03T06:37:22,Amurrio,expenses,appliances,-227.06,13472.26
buyer_3,Ana,Piñeiro,1989-08-23,25810029G,ana.piñeiro@megacloud.online,485584,ES35209577302742069253,6137.07,2022-03-04T21:09:58,Amurrio,expenses,mortgage,-2799.85,10672.41
buyer_3,Ana,Piñeiro,1989-08-23,25810029G,ana.piñeiro@megacloud.online,485584,ES35209577302742069253,6137.07,2022-03-05T19:03:04,Amurrio,expenses,leisure,-66.42,10605.99
buyer_3,Ana,Piñeiro,1989-08-23,25810029G,ana.piñeiro@megacloud.online,485584,ES35209577302742069253,6137.07,2022-03-05T14:15:01,Amurrio,expenses,cash,-100.0,10505.99
buyer_3,Ana,Piñeiro,1989-08-23,25810029G,ana.piñeiro@megacloud.online,485584,ES35209577302742069253,6137.07,2022-03-06T10:24:39,Amurrio,expenses,water,-139.5,10366.49
buyer_3,Ana,Piñeiro,1989-08-23,25810029G,ana.piñeiro@megacloud.online,485584,ES35209577302742069253,6137.07,2022-03-06T16:56:15,Amurrio,expenses,electricity,-211.57,10154.92
buyer_3,Ana,Piñeiro,1989-08-23,25810029G,ana.piñeiro@megacloud.online,485584,ES35209577302742069253,6137.07,2022-03-07T11:57:29,Amurrio,expenses,food,-90.64,10064.28
buyer_3,Ana,Piñeiro,1989-08-23,25810029G,ana.piñeiro@megacloud.online,485584,ES35209577302742069253,6137.07,2022-03-08T11:27:43,Amurrio,expenses,gas,-352.98,9711.3
buyer_3,Ana,Piñeiro,1989-08-23,25810029G,ana.piñeiro@megacloud.online,485584,ES35209577302742069253,6137.07,2022-03-08T08:25:46,Amurrio,expenses,internet,-138.83,9572.47
buyer_3,Ana,Piñeiro,1989-08-23,25810029G,ana.piñeiro@megacloud.online,485584,ES35209577302742069253,6137.07,2022-03-08T08:01:59,Amurrio,expenses,phone,-131.13,9441.34
buyer_3,Ana,Piñeiro,1989-08-23,25810029G,ana.piñeiro@megacloud.online,485584,ES35209577302742069253,6137.07,2022-03-08T13:19:34,Amurrio,expenses,repairs,-106.12,9335.22
buyer_3,Ana,Piñeiro,1989-08-23,25810029G,ana.piñeiro@megacloud.online,485584,ES35209577302742069253,6137.07,2022-03-08T14:57:31,Amurrio,expenses,gifts,-317.72,9017.5
buyer_3,Ana,Piñeiro,1989-08-23,25810029G,ana.piñeiro@megacloud.online,485584,ES35209577302742069253,6137.07,2022-03-10T01:37:13,Amurrio,expenses,appliances,-80.54,8936.96
buyer_3,Ana,Piñeiro,1989-08-23,25810029G,ana.piñeiro@megacloud.online,485584,ES35209577302742069253,6137.07,2022-03-10T12:52:23,Amurrio,expenses,repairs,-268.87,8668.09
buyer_3,Ana,Piñeiro,1989-08-23,25810029G,ana.piñeiro@megacloud.online,485584,ES35209577302742069253,6137.07,2022-03-13T18:52:39,Amurrio,expenses,repairs,-208.7,8459.39
buyer_3,Ana,Piñeiro,1989-08-23,25810029G,ana.piñeiro@megacloud.online,485584,ES35209577302742069253,6137.07,2022-03-13T20:53:39,Amurrio,expenses,gifts,-617.05,7842.34
buyer_3,Ana,Piñeiro,1989-08-23,25810029G,ana.piñeiro@megacloud.online,485584,ES35209577302742069253,6137.07,2022-03-14T20:28:03,Amurrio,expenses,leisure,-83.9,7758.44
buyer_3,Ana,Piñeiro,1989-08-23,25810029G,ana.piñeiro@megacloud.online,485584,ES35209577302742069253,6137.07,2022-03-15T07:26:39,Amurrio,expenses,leisure,-25.36,7733.08
buyer_3,Ana,Piñeiro,1989-08-23,25810029G,ana.piñeiro@megacloud.online,485584,ES35209577302742069253,6137.07,2022-03-17T17:29:16,Amurrio,expenses,cash,-100.0,7633.08
buyer_3,Ana,Piñeiro,1989-08-23,25810029G,ana.piñeiro@megacloud.online,485584,ES35209577302742069253,6137.07,2022-03-23T06:18:41,Amurrio,expenses,transport,-89.58,7543.5
buyer_3,Ana,Piñeiro,1989-08-23,25810029G,ana.piñeiro@megacloud.online,485584,ES35209577302742069253,6137.07,2022-03-24T18:42:59,Amurrio,expenses,cash,-100.0,7443.5
buyer_3,Ana,Piñeiro,1989-08-23,25810029G,ana.piñeiro@megacloud.online,485584,ES35209577302742069253,6137.07,2022-03-25T09:00:28,Amurrio,expenses,food,-76.51,7366.99
buyer_3,Ana,Piñeiro,1989-08-23,25810029G,ana.piñeiro@megacloud.online,485584,ES35209577302742069253,6137.07,2022-03-26T19:44:33,Amurrio,expenses,transport,-55.78,7311.21
buyer_3,Ana,Piñeiro,1989-08-23,25810029G,ana.piñeiro@megacloud.online,485584,ES35209577302742069253,6137.07,2022-03-27T20:10:40,Amurrio,expenses,food,-76.67,7234.54
buyer_3,Ana,Piñeiro,1989-08-23,25810029G,ana.piñeiro@megacloud.online,485584,ES35209577302742069253,6137.07,2022-03-27T19:31:02,Amurrio,expenses,repairs,-289.01,6945.53
buyer_3,Ana,Piñeiro,1989-08-23,25810029G,ana.piñeiro@megacloud.online,485584,ES35209577302742069253,6137.07,2022-03-27T22:51:31,Amurrio,expenses,gifts,-584.27,6361.26
buyer_3,Ana,Piñeiro,1989-08-23,25810029G,ana.piñeiro@megacloud.online,485584,ES35209577302742069253,6137.07,2022-03-29T11:12:04,Amurrio,expenses,cash,-100.0,6261.26
buyer_3,Ana,Piñeiro,1989-08-23,25810029G,ana.piñeiro@megacloud.online,485584,ES35209577302742069253,6137.07,2022-03-30T19:02:00,Amurrio,expenses,food,-107.32,6153.94
buyer_3,Ana,Piñeiro,1989-08-23,25810029G,ana.piñeiro@megacloud.online,485584,ES35209577302742069253,6137.07,2022-03-31T14:50:47,Amurrio,expenses,leisure,-81.99,6071.95
buyer_3,Ana,Piñeiro,1989-08-23,25810029G,ana.piñeiro@megacloud.online,485584,ES35209577302742069253,6137.07,2022-04-01T18:58:50,Amurrio,incomes,salary,3152.42,9224.37
buyer_3,Ana,Piñeiro,1989-08-23,25810029G,ana.piñeiro@megacloud.online,485584,ES35209577302742069253,6137.07,2022-04-01T18:58:50,Amurrio,incomes,salary_partner,3458.57,12682.94
buyer_3,Ana,Piñeiro,1989-08-23,25810029G,ana.piñeiro@megacloud.online,485584,ES35209577302742069253,6137.07,2022-04-01T14:20:07,Amurrio,expenses,healthcare,-133.6,12549.34
buyer_3,Ana,Piñeiro,1989-08-23,25810029G,ana.piñeiro@megacloud.online,485584,ES35209577302742069253,6137.07,2022-04-01T06:08:19,Amurrio,expenses,cash,-100.0,12449.34
buyer_3,Ana,Piñeiro,1989-08-23,25810029G,ana.piñeiro@megacloud.online,485584,ES35209577302742069253,6137.07,2022-04-01T09:41:50,Amurrio,expenses,travel,-474.19,11975.15
buyer_3,Ana,Piñeiro,1989-08-23,25810029G,ana.piñeiro@megacloud.online,485584,ES35209577302742069253,6137.07,2022-04-03T19:36:50,Amurrio,expenses,clothing,-47.55,11927.6
buyer_3,Ana,Piñeiro,1989-08-23,25810029G,ana.piñeiro@megacloud.online,485584,ES35209577302742069253,6137.07,2022-04-04T11:11:35,Amurrio,expenses,mortgage,-2799.85,9127.75
buyer_3,Ana,Piñeiro,1989-08-23,25810029G,ana.piñeiro@megacloud.online,485584,ES35209577302742069253,6137.07,2022-04-04T07:44:41,Amurrio,expenses,food,-123.49,9004.26
buyer_3,Ana,Piñeiro,1989-08-23,25810029G,ana.piñeiro@megacloud.online,485584,ES35209577302742069253,6137.07,2022-04-05T14:06:00,Amurrio,expenses,electricity,-283.26,8721.0
buyer_3,Ana,Piñeiro,1989-08-23,25810029G,ana.piñeiro@megacloud.online,485584,ES35209577302742069253,6137.07,2022-04-05T16:29:32,Amurrio,expenses,clothing,-105.91,8615.09
buyer_3,Ana,Piñeiro,1989-08-23,25810029G,ana.piñeiro@megacloud.online,485584,ES35209577302742069253,6137.07,2022-04-06T20:06:42,Amurrio,expenses,internet,-138.83,8476.26
buyer_3,Ana,Piñeiro,1989-08-23,25810029G,ana.piñeiro@megacloud.online,485584,ES35209577302742069253,6137.07,2022-04-07T11:41:19,Amurrio,expenses,phone,-115.12,8361.14
buyer_3,Ana,Piñeiro,1989-08-23,25810029G,ana.piñeiro@megacloud.online,485584,ES35209577302742069253,6137.07,2022-04-08T08:10:02,Amurrio,expenses,gas,-139.52,8221.62
buyer_3,Ana,Piñeiro,1989-08-23,25810029G,ana.piñeiro@megacloud.online,485584,ES35209577302742069253,6137.07,2022-04-08T08:54:28,Amurrio,expenses,water,-69.06,8152.56
buyer_3,Ana,Piñeiro,1989-08-23,25810029G,ana.piñeiro@megacloud.online,485584,ES35209577302742069253,6137.07,2022-04-08T10:58:39,Amurrio,expenses,leisure,-60.34,8092.22
buyer_3,Ana,Piñeiro,1989-08-23,25810029G,ana.piñeiro@megacloud.online,485584,ES35209577302742069253,6137.07,2022-04-09T20:43:42,Amurrio,expenses,leisure,-82.48,8009.74
buyer_3,Ana,Piñeiro,1989-08-23,25810029G,ana.piñeiro@megacloud.online,485584,ES35209577302742069253,6137.07,2022-04-11T05:10:14,Amurrio,expenses,travel,-1042.73,6967.01
buyer_3,Ana,Piñeiro,1989-08-23,25810029G,ana.piñeiro@megacloud.online,485584,ES35209577302742069253,6137.07,2022-04-11T19:34:03,Amurrio,expenses,appliances,-148.75,6818.26
buyer_3,Ana,Piñeiro,1989-08-23,25810029G,ana.piñeiro@megacloud.online,485584,ES35209577302742069253,6137.07,2022-04-12T01:07:10,Amurrio,expenses,cash,-100.0,6718.26
buyer_3,Ana,Piñeiro,1989-08-23,25810029G,ana.piñeiro@megacloud.online,485584,ES35209577302742069253,6137.07,2022-04-12T13:23:43,Amurrio,expenses,appliances,-94.08,6624.18
buyer_3,Ana,Piñeiro,1989-08-23,25810029G,ana.piñeiro@megacloud.online,485584,ES35209577302742069253,6137.07,2022-04-13T11:39:48,Amurrio,expenses,food,-67.35,6556.83
buyer_3,Ana,Piñeiro,1989-08-23,25810029G,ana.piñeiro@megacloud.online,485584,ES35209577302742069253,6137.07,2022-04-13T15:52:47,Amurrio,expenses,education,-61.51,6495.32
buyer_3,Ana,Piñeiro,1989-08-23,25810029G,ana.piñeiro@megacloud.online,485584,ES35209577302742069253,6137.07,2022-04-16T11:53:54,Amurrio,expenses,healthcare,-123.08,6372.24
buyer_3,Ana,Piñeiro,1989-08-23,25810029G,ana.piñeiro@megacloud.online,485584,ES35209577302742069253,6137.07,2022-04-18T21:51:21,Amurrio,expenses,food,-83.04,6289.2
buyer_3,Ana,Piñeiro,1989-08-23,25810029G,ana.piñeiro@megacloud.online,485584,ES35209577302742069253,6137.07,2022-04-19T20:31:44,Amurrio,expenses,transport,-77.46,6211.74
buyer_3,Ana,Piñeiro,1989-08-23,25810029G,ana.piñeiro@megacloud.online,485584,ES35209577302742069253,6137.07,2022-04-20T17:41:52,Amurrio,expenses,leisure,-65.64,6146.1
buyer_3,Ana,Piñeiro,1989-08-23,25810029G,ana.piñeiro@megacloud.online,485584,ES35209577302742069253,6137.07,2022-04-21T04:33:25,Amurrio,expenses,repairs,-233.85,5912.25
buyer_3,Ana,Piñeiro,1989-08-23,25810029G,ana.piñeiro@megacloud.online,485584,ES35209577302742069253,6137.07,2022-04-22T08:59:57,Amurrio,expenses,leisure,-70.14,5842.11
buyer_3,Ana,Piñeiro,1989-08-23,25810029G,ana.piñeiro@megacloud.online,485584,ES35209577302742069253,6137.07,2022-04-23T16:16:05,Amurrio,expenses,cash,-100.0,5742.11
buyer_3,Ana,Piñeiro,1989-08-23,25810029G,ana.piñeiro@megacloud.online,485584,ES35209577302742069253,6137.07,2022-04-24T13:18:13,Amurrio,expenses,leisure,-45.64,5696.47
buyer_3,Ana,Piñeiro,1989-08-23,25810029G,ana.piñeiro@megacloud.online,485584,ES35209577302742069253,6137.07,2022-04-24T17:46:43,Amurrio,expenses,healthcare,-160.22,5536.25
buyer_3,Ana,Piñeiro,1989-08-23,25810029G,ana.piñeiro@megacloud.online,485584,ES35209577302742069253,6137.07,2022-04-29T12:50:16,Amurrio,expenses,food,-93.88,5442.37
buyer_3,Ana,Piñeiro,1989-08-23,25810029G,ana.piñeiro@megacloud.online,485584,ES35209577302742069253,6137.07,2022-04-30T14:36:33,Amurrio,expenses,food,-106.43,5335.94
buyer_3,Ana,Piñeiro,1989-08-23,25810029G,ana.piñeiro@megacloud.online,485584,ES35209577302742069253,6137.07,2022-05-01T12:18:13,Amurrio,incomes,salary,3152.42,8488.36
buyer_3,Ana,Piñeiro,1989-08-23,25810029G,ana.piñeiro@megacloud.online,485584,ES35209577302742069253,6137.07,2022-05-01T12:18:13,Amurrio,incomes,salary_partner,3458.57,11946.93
buyer_3,Ana,Piñeiro,1989-08-23,25810029G,ana.piñeiro@megacloud.online,485584,ES35209577302742069253,6137.07,2022-05-01T14:04:38,Amurrio,expenses,cash,-100.0,11846.93
buyer_3,Ana,Piñeiro,1989-08-23,25810029G,ana.piñeiro@megacloud.online,485584,ES35209577302742069253,6137.07,2022-05-04T15:11:21,Amurrio,expenses,mortgage,-2799.85,9047.08
buyer_3,Ana,Piñeiro,1989-08-23,25810029G,ana.piñeiro@megacloud.online,485584,ES35209577302742069253,6137.07,2022-05-05T20:09:51,Amurrio,expenses,electricity,-90.03,8957.05
buyer_3,Ana,Piñeiro,1989-08-23,25810029G,ana.piñeiro@megacloud.online,485584,ES35209577302742069253,6137.07,2022-05-05T13:10:36,Amurrio,expenses,gas,-135.96,8821.09
buyer_3,Ana,Piñeiro,1989-08-23,25810029G,ana.piñeiro@megacloud.online,485584,ES35209577302742069253,6137.07,2022-05-05T12:56:02,Amurrio,expenses,cash,-100.0,8721.09
buyer_3,Ana,Piñeiro,1989-08-23,25810029G,ana.piñeiro@megacloud.online,485584,ES35209577302742069253,6137.07,2022-05-06T08:56:12,Amurrio,expenses,water,-80.51,8640.58
buyer_3,Ana,Piñeiro,1989-08-23,25810029G,ana.piñeiro@megacloud.online,485584,ES35209577302742069253,6137.07,2022-05-06T16:03:03,Amurrio,expenses,food,-63.28,8577.3
buyer_3,Ana,Piñeiro,1989-08-23,25810029G,ana.piñeiro@megacloud.online,485584,ES35209577302742069253,6137.07,2022-05-06T17:58:47,Amurrio,expenses,leisure,-47.3,8530.0
buyer_3,Ana,Piñeiro,1989-08-23,25810029G,ana.piñeiro@megacloud.online,485584,ES35209577302742069253,6137.07,2022-05-07T13:28:35,Amurrio,expenses,internet,-138.83,8391.17
buyer_3,Ana,Piñeiro,1989-08-23,25810029G,ana.piñeiro@megacloud.online,485584,ES35209577302742069253,6137.07,2022-05-07T08:54:51,Amurrio,expenses,phone,-126.49,8264.68
buyer_3,Ana,Piñeiro,1989-08-23,25810029G,ana.piñeiro@megacloud.online,485584,ES35209577302742069253,6137.07,2022-05-07T04:42:47,Amurrio,expenses,gifts,-147.99,8116.69
buyer_3,Ana,Piñeiro,1989-08-23,25810029G,ana.piñeiro@megacloud.online,485584,ES35209577302742069253,6137.07,2022-05-10T13:24:37,Amurrio,expenses,food,-104.81,8011.88
buyer_3,Ana,Piñeiro,1989-08-23,25810029G,ana.piñeiro@megacloud.online,485584,ES35209577302742069253,6137.07,2022-05-10T06:10:17,Amurrio,expenses,repairs,-322.49,7689.39
buyer_3,Ana,Piñeiro,1989-08-23,25810029G,ana.piñeiro@megacloud.online,485584,ES35209577302742069253,6137.07,2022-05-11T13:28:34,Amurrio,expenses,food,-100.15,7589.24
buyer_3,Ana,Piñeiro,1989-08-23,25810029G,ana.piñeiro@megacloud.online,485584,ES35209577302742069253,6137.07,2022-05-11T09:05:15,Amurrio,expenses,transport,-62.36,7526.88
buyer_3,Ana,Piñeiro,1989-08-23,25810029G,ana.piñeiro@megacloud.online,485584,ES35209577302742069253,6137.07,2022-05-12T09:01:15,Amurrio,expenses,food,-120.2,7406.68
buyer_3,Ana,Piñeiro,1989-08-23,25810029G,ana.piñeiro@megacloud.online,485584,ES35209577302742069253,6137.07,2022-05-14T13:54:04,Amurrio,expenses,leisure,-38.14,7368.54
buyer_3,Ana,Piñeiro,1989-08-23,25810029G,ana.piñeiro@megacloud.online,485584,ES35209577302742069253,6137.07,2022-05-14T16:00:51,Amurrio,expenses,cash,-100.0,7268.54
buyer_3,Ana,Piñeiro,1989-08-23,25810029G,ana.piñeiro@megacloud.online,485584,ES35209577302742069253,6137.07,2022-05-15T22:52:06,Amurrio,expenses,leisure,-78.51,7190.03
buyer_3,Ana,Piñeiro,1989-08-23,25810029G,ana.piñeiro@megacloud.online,485584,ES35209577302742069253,6137.07,2022-05-18T18:27:58,Amurrio,expenses,leisure,-52.05,7137.98
buyer_3,Ana,Piñeiro,1989-08-23,25810029G,ana.piñeiro@megacloud.online,485584,ES35209577302742069253,6137.07,2022-05-20T20:23:17,Amurrio,expenses,education,-67.71,7070.27
buyer_3,Ana,Piñeiro,1989-08-23,25810029G,ana.piñeiro@megacloud.online,485584,ES35209577302742069253,6137.07,2022-05-21T18:43:58,Amurrio,expenses,cash,-100.0,6970.27
buyer_3,Ana,Piñeiro,1989-08-23,25810029G,ana.piñeiro@megacloud.online,485584,ES35209577302742069253,6137.07,2022-05-21T11:43:37,Amurrio,expenses,gifts,-590.82,6379.45
buyer_3,Ana,Piñeiro,1989-08-23,25810029G,ana.piñeiro@megacloud.online,485584,ES35209577302742069253,6137.07,2022-05-22T22:57:27,Amurrio,expenses,leisure,-35.4,6344.05
buyer_3,Ana,Piñeiro,1989-08-23,25810029G,ana.piñeiro@megacloud.online,485584,ES35209577302742069253,6137.07,2022-05-23T16:40:00,Amurrio,expenses,leisure,-69.46,6274.59
buyer_3,Ana,Piñeiro,1989-08-23,25810029G,ana.piñeiro@megacloud.online,485584,ES35209577302742069253,6137.07,2022-05-23T13:10:43,Amurrio,expenses,education,-70.85,6203.74
buyer_3,Ana,Piñeiro,1989-08-23,25810029G,ana.piñeiro@megacloud.online,485584,ES35209577302742069253,6137.07,2022-05-25T16:25:05,Amurrio,expenses,leisure,-23.0,6180.74
buyer_3,Ana,Piñeiro,1989-08-23,25810029G,ana.piñeiro@megacloud.online,485584,ES35209577302742069253,6137.07,2022-05-27T12:27:21,Amurrio,expenses,transport,-41.89,6138.85
buyer_3,Ana,Piñeiro,1989-08-23,25810029G,ana.piñeiro@megacloud.online,485584,ES35209577302742069253,6137.07,2022-05-29T18:15:28,Amurrio,expenses,clothing,-59.73,6079.12
buyer_3,Ana,Piñeiro,1989-08-23,25810029G,ana.piñeiro@megacloud.online,485584,ES35209577302742069253,6137.07,2022-05-31T09:07:48,Amurrio,expenses,cash,-100.0,5979.12
buyer_3,Ana,Piñeiro,1989-08-23,25810029G,ana.piñeiro@megacloud.online,485584,ES35209577302742069253,6137.07,2022-06-01T02:25:39,Amurrio,incomes,salary,3152.42,9131.54
buyer_3,Ana,Piñeiro,1989-08-23,25810029G,ana.piñeiro@megacloud.online,485584,ES35209577302742069253,6137.07,2022-06-01T02:25:39,Amurrio,incomes,salary_partner,3458.57,12590.11
buyer_3,Ana,Piñeiro,1989-08-23,25810029G,ana.piñeiro@megacloud.online,485584,ES35209577302742069253,6137.07,2022-06-01T02:25:39,Amurrio,incomes,extra_income,379.94,12970.05
buyer_3,Ana,Piñeiro,1989-08-23,25810029G,ana.piñeiro@megacloud.online,485584,ES35209577302742069253,6137.07,2022-06-01T02:25:39,Amurrio,incomes,salary_bonus,2207.55,15177.6
buyer_3,Ana,Piñeiro,1989-08-23,25810029G,ana.piñeiro@megacloud.online,485584,ES35209577302742069253,6137.07,2022-06-01T02:25:39,Amurrio,incomes,salary_partner_bonus,2721.63,17899.23
buyer_3,Ana,Piñeiro,1989-08-23,25810029G,ana.piñeiro@megacloud.online,485584,ES35209577302742069253,6137.07,2022-06-02T12:29:13,Amurrio,expenses,transport,-88.53,17810.7
buyer_3,Ana,Piñeiro,1989-08-23,25810029G,ana.piñeiro@megacloud.online,485584,ES35209577302742069253,6137.07,2022-06-04T07:03:06,Amurrio,expenses,mortgage,-2799.85,15010.85
buyer_3,Ana,Piñeiro,1989-08-23,25810029G,ana.piñeiro@megacloud.online,485584,ES35209577302742069253,6137.07,2022-06-04T13:03:28,Amurrio,expenses,food,-111.57,14899.28
buyer_3,Ana,Piñeiro,1989-08-23,25810029G,ana.piñeiro@megacloud.online,485584,ES35209577302742069253,6137.07,2022-06-04T00:35:08,Amurrio,expenses,repairs,-235.64,14663.64
buyer_3,Ana,Piñeiro,1989-08-23,25810029G,ana.piñeiro@megacloud.online,485584,ES35209577302742069253,6137.07,2022-06-05T16:47:22,Amurrio,expenses,internet,-138.83,14524.81
buyer_3,Ana,Piñeiro,1989-08-23,25810029G,ana.piñeiro@megacloud.online,485584,ES35209577302742069253,6137.07,2022-06-05T08:37:43,Amurrio,expenses,cash,-100.0,14424.81
buyer_3,Ana,Piñeiro,1989-08-23,25810029G,ana.piñeiro@megacloud.online,485584,ES35209577302742069253,6137.07,2022-06-05T23:40:32,Amurrio,expenses,appliances,-321.3,14103.51
buyer_3,Ana,Piñeiro,1989-08-23,25810029G,ana.piñeiro@megacloud.online,485584,ES35209577302742069253,6137.07,2022-06-06T00:44:32,Amurrio,expenses,gas,-102.25,14001.26
buyer_3,Ana,Piñeiro,1989-08-23,25810029G,ana.piñeiro@megacloud.online,485584,ES35209577302742069253,6137.07,2022-06-06T19:07:11,Amurrio,expenses,food,-61.06,13940.2
buyer_3,Ana,Piñeiro,1989-08-23,25810029G,ana.piñeiro@megacloud.online,485584,ES35209577302742069253,6137.07,2022-06-07T14:19:05,Amurrio,expenses,water,-99.91,13840.29
buyer_3,Ana,Piñeiro,1989-08-23,25810029G,ana.piñeiro@megacloud.online,485584,ES35209577302742069253,6137.07,2022-06-07T21:53:37,Amurrio,expenses,cash,-100.0,13740.29
buyer_3,Ana,Piñeiro,1989-08-23,25810029G,ana.piñeiro@megacloud.online,485584,ES35209577302742069253,6137.07,2022-06-08T21:05:00,Amurrio,expenses,electricity,-293.15,13447.14
buyer_3,Ana,Piñeiro,1989-08-23,25810029G,ana.piñeiro@megacloud.online,485584,ES35209577302742069253,6137.07,2022-06-08T11:59:47,Amurrio,expenses,phone,-140.54,13306.6
buyer_3,Ana,Piñeiro,1989-08-23,25810029G,ana.piñeiro@megacloud.online,485584,ES35209577302742069253,6137.07,2022-06-08T05:05:39,Amurrio,expenses,clothing,-159.15,13147.45
buyer_3,Ana,Piñeiro,1989-08-23,25810029G,ana.piñeiro@megacloud.online,485584,ES35209577302742069253,6137.07,2022-06-09T16:43:28,Amurrio,expenses,transport,-56.24,13091.21
buyer_3,Ana,Piñeiro,1989-08-23,25810029G,ana.piñeiro@megacloud.online,485584,ES35209577302742069253,6137.07,2022-06-10T08:26:55,Amurrio,expenses,transport,-52.98,13038.23
buyer_3,Ana,Piñeiro,1989-08-23,25810029G,ana.piñeiro@megacloud.online,485584,ES35209577302742069253,6137.07,2022-06-12T19:17:15,Amurrio,expenses,transport,-58.62,12979.61
buyer_3,Ana,Piñeiro,1989-08-23,25810029G,ana.piñeiro@megacloud.online,485584,ES35209577302742069253,6137.07,2022-06-13T19:02:29,Amurrio,expenses,food,-69.64,12909.97
buyer_3,Ana,Piñeiro,1989-08-23,25810029G,ana.piñeiro@megacloud.online,485584,ES35209577302742069253,6137.07,2022-06-13T20:27:15,Amurrio,expenses,clothing,-130.62,12779.35
buyer_3,Ana,Piñeiro,1989-08-23,25810029G,ana.piñeiro@megacloud.online,485584,ES35209577302742069253,6137.07,2022-06-13T15:19:01,Amurrio,expenses,education,-49.84,12729.51
buyer_3,Ana,Piñeiro,1989-08-23,25810029G,ana.piñeiro@megacloud.online,485584,ES35209577302742069253,6137.07,2022-06-20T20:39:28,Amurrio,expenses,leisure,-52.4,12677.11
buyer_3,Ana,Piñeiro,1989-08-23,25810029G,ana.piñeiro@megacloud.online,485584,ES35209577302742069253,6137.07,2022-06-21T14:17:39,Amurrio,expenses,cash,-100.0,12577.11
buyer_3,Ana,Piñeiro,1989-08-23,25810029G,ana.piñeiro@megacloud.online,485584,ES35209577302742069253,6137.07,2022-06-22T12:38:09,Amurrio,expenses,food,-113.75,12463.36
buyer_3,Ana,Piñeiro,1989-08-23,25810029G,ana.piñeiro@megacloud.online,485584,ES35209577302742069253,6137.07,2022-06-23T08:52:27,Amurrio,expenses,food,-105.41,12357.95
buyer_3,Ana,Piñeiro,1989-08-23,25810029G,ana.piñeiro@megacloud.online,485584,ES35209577302742069253,6137.07,2022-06-24T12:10:01,Amurrio,expenses,clothing,-148.54,12209.41
buyer_3,Ana,Piñeiro,1989-08-23,25810029G,ana.piñeiro@megacloud.online,485584,ES35209577302742069253,6137.07,2022-06-27T23:40:10,Amurrio,expenses,education,-74.06,12135.35
buyer_3,Ana,Piñeiro,1989-08-23,25810029G,ana.piñeiro@megacloud.online,485584,ES35209577302742069253,6137.07,2022-06-29T09:57:27,Amurrio,expenses,appliances,-295.89,11839.46
buyer_3,Ana,Piñeiro,1989-08-23,25810029G,ana.piñeiro@megacloud.online,485584,ES35209577302742069253,6137.07,2022-06-30T09:17:41,Amurrio,expenses,cash,-100.0,11739.46
buyer_3,Ana,Piñeiro,1989-08-23,25810029G,ana.piñeiro@megacloud.online,485584,ES35209577302742069253,6137.07,2022-07-01T11:14:30,Amurrio,incomes,salary,3152.42,14891.88
buyer_3,Ana,Piñeiro,1989-08-23,25810029G,ana.piñeiro@megacloud.online,485584,ES35209577302742069253,6137.07,2022-07-01T11:14:30,Amurrio,incomes,salary_partner,3458.57,18350.45
buyer_3,Ana,Piñeiro,1989-08-23,25810029G,ana.piñeiro@megacloud.online,485584,ES35209577302742069253,6137.07,2022-07-02T20:28:05,Amurrio,expenses,clothing,-154.53,18195.92
buyer_3,Ana,Piñeiro,1989-08-23,25810029G,ana.piñeiro@megacloud.online,485584,ES35209577302742069253,6137.07,2022-07-03T13:05:42,Amurrio,expenses,leisure,-60.15,18135.77
buyer_3,Ana,Piñeiro,1989-08-23,25810029G,ana.piñeiro@megacloud.online,485584,ES35209577302742069253,6137.07,2022-07-04T08:37:03,Amurrio,expenses,mortgage,-2799.85,15335.92
buyer_3,Ana,Piñeiro,1989-08-23,25810029G,ana.piñeiro@megacloud.online,485584,ES35209577302742069253,6137.07,2022-07-05T16:00:09,Amurrio,expenses,water,-74.08,15261.84
buyer_3,Ana,Piñeiro,1989-08-23,25810029G,ana.piñeiro@megacloud.online,485584,ES35209577302742069253,6137.07,2022-07-05T15:12:39,Amurrio,expenses,electricity,-139.47,15122.37
buyer_3,Ana,Piñeiro,1989-08-23,25810029G,ana.piñeiro@megacloud.online,485584,ES35209577302742069253,6137.07,2022-07-05T10:54:35,Amurrio,expenses,food,-105.64,15016.73
buyer_3,Ana,Piñeiro,1989-08-23,25810029G,ana.piñeiro@megacloud.online,485584,ES35209577302742069253,6137.07,2022-07-06T16:02:27,Amurrio,expenses,gas,-239.94,14776.79
buyer_3,Ana,Piñeiro,1989-08-23,25810029G,ana.piñeiro@megacloud.online,485584,ES35209577302742069253,6137.07,2022-07-06T21:15:59,Amurrio,expenses,transport,-60.45,14716.34
buyer_3,Ana,Piñeiro,1989-08-23,25810029G,ana.piñeiro@megacloud.online,485584,ES35209577302742069253,6137.07,2022-07-07T14:05:31,Amurrio,expenses,phone,-122.41,14593.93
buyer_3,Ana,Piñeiro,1989-08-23,25810029G,ana.piñeiro@megacloud.online,485584,ES35209577302742069253,6137.07,2022-07-08T19:03:00,Amurrio,expenses,internet,-138.83,14455.1
buyer_3,Ana,Piñeiro,1989-08-23,25810029G,ana.piñeiro@megacloud.online,485584,ES35209577302742069253,6137.07,2022-07-09T06:33:49,Amurrio,expenses,food,-110.68,14344.42
buyer_3,Ana,Piñeiro,1989-08-23,25810029G,ana.piñeiro@megacloud.online,485584,ES35209577302742069253,6137.07,2022-07-13T10:37:48,Amurrio,expenses,cash,-100.0,14244.42
buyer_3,Ana,Piñeiro,1989-08-23,25810029G,ana.piñeiro@megacloud.online,485584,ES35209577302742069253,6137.07,2022-07-13T13:15:31,Amurrio,expenses,repairs,-237.37,14007.05
buyer_3,Ana,Piñeiro,1989-08-23,25810029G,ana.piñeiro@megacloud.online,485584,ES35209577302742069253,6137.07,2022-07-15T12:16:41,Amurrio,expenses,food,-113.95,13893.1
buyer_3,Ana,Piñeiro,1989-08-23,25810029G,ana.piñeiro@megacloud.online,485584,ES35209577302742069253,6137.07,2022-07-15T12:38:24,Amurrio,expenses,cash,-100.0,13793.1
buyer_3,Ana,Piñeiro,1989-08-23,25810029G,ana.piñeiro@megacloud.online,485584,ES35209577302742069253,6137.07,2022-07-16T14:47:13,Amurrio,expenses,cash,-100.0,13693.1
buyer_3,Ana,Piñeiro,1989-08-23,25810029G,ana.piñeiro@megacloud.online,485584,ES35209577302742069253,6137.07,2022-07-16T16:20:01,Amurrio,expenses,repairs,-163.49,13529.61
buyer_3,Ana,Piñeiro,1989-08-23,25810029G,ana.piñeiro@megacloud.online,485584,ES35209577302742069253,6137.07,2022-07-16T20:17:10,Amurrio,expenses,gifts,-288.3,13241.31
buyer_3,Ana,Piñeiro,1989-08-23,25810029G,ana.piñeiro@megacloud.online,485584,ES35209577302742069253,6137.07,2022-07-17T12:42:42,Amurrio,expenses,food,-70.07,13171.24
buyer_3,Ana,Piñeiro,1989-08-23,25810029G,ana.piñeiro@megacloud.online,485584,ES35209577302742069253,6137.07,2022-07-18T02:59:29,Amurrio,expenses,gifts,-385.59,12785.65
buyer_3,Ana,Piñeiro,1989-08-23,25810029G,ana.piñeiro@megacloud.online,485584,ES35209577302742069253,6137.07,2022-07-19T23:18:54,Amurrio,expenses,transport,-40.12,12745.53
buyer_3,Ana,Piñeiro,1989-08-23,25810029G,ana.piñeiro@megacloud.online,485584,ES35209577302742069253,6137.07,2022-07-19T15:34:59,Amurrio,expenses,clothing,-93.27,12652.26
buyer_3,Ana,Piñeiro,1989-08-23,25810029G,ana.piñeiro@megacloud.online,485584,ES35209577302742069253,6137.07,2022-07-19T10:07:25,Amurrio,expenses,repairs,-233.59,12418.67
buyer_3,Ana,Piñeiro,1989-08-23,25810029G,ana.piñeiro@megacloud.online,485584,ES35209577302742069253,6137.07,2022-07-23T04:50:00,Amurrio,expenses,food,-97.33,12321.34
buyer_3,Ana,Piñeiro,1989-08-23,25810029G,ana.piñeiro@megacloud.online,485584,ES35209577302742069253,6137.07,2022-07-23T01:05:40,Amurrio,expenses,cash,-100.0,12221.34
buyer_3,Ana,Piñeiro,1989-08-23,25810029G,ana.piñeiro@megacloud.online,485584,ES35209577302742069253,6137.07,2022-07-23T13:43:02,Amurrio,expenses,gifts,-398.7,11822.64
buyer_3,Ana,Piñeiro,1989-08-23,25810029G,ana.piñeiro@megacloud.online,485584,ES35209577302742069253,6137.07,2022-07-25T02:17:20,Amurrio,expenses,food,-83.11,11739.53
buyer_3,Ana,Piñeiro,1989-08-23,25810029G,ana.piñeiro@megacloud.online,485584,ES35209577302742069253,6137.07,2022-07-25T17:11:28,Amurrio,expenses,leisure,-19.22,11720.31
buyer_3,Ana,Piñeiro,1989-08-23,25810029G,ana.piñeiro@megacloud.online,485584,ES35209577302742069253,6137.07,2022-07-28T18:15:15,Amurrio,expenses,transport,-68.35,11651.96
buyer_3,Ana,Piñeiro,1989-08-23,25810029G,ana.piñeiro@megacloud.online,485584,ES35209577302742069253,6137.07,2022-07-28T19:32:03,Amurrio,expenses,repairs,-62.75,11589.21
buyer_3,Ana,Piñeiro,1989-08-23,25810029G,ana.piñeiro@megacloud.online,485584,ES35209577302742069253,6137.07,2022-07-29T11:22:13,Amurrio,expenses,food,-92.82,11496.39
buyer_3,Ana,Piñeiro,1989-08-23,25810029G,ana.piñeiro@megacloud.online,485584,ES35209577302742069253,6137.07,2022-07-29T08:07:54,Amurrio,expenses,leisure,-35.84,11460.55
buyer_3,Ana,Piñeiro,1989-08-23,25810029G,ana.piñeiro@megacloud.online,485584,ES35209577302742069253,6137.07,2022-07-30T11:35:33,Amurrio,expenses,transport,-42.81,11417.74
buyer_3,Ana,Piñeiro,1989-08-23,25810029G,ana.piñeiro@megacloud.online,485584,ES35209577302742069253,6137.07,2022-07-30T13:36:04,Amurrio,expenses,leisure,-30.87,11386.87
buyer_3,Ana,Piñeiro,1989-08-23,25810029G,ana.piñeiro@megacloud.online,485584,ES35209577302742069253,6137.07,2022-08-01T13:03:17,Amurrio,incomes,salary,3152.42,14539.29
buyer_3,Ana,Piñeiro,1989-08-23,25810029G,ana.piñeiro@megacloud.online,485584,ES35209577302742069253,6137.07,2022-08-01T13:03:17,Amurrio,incomes,salary_partner,3458.57,17997.86
buyer_3,Ana,Piñeiro,1989-08-23,25810029G,ana.piñeiro@megacloud.online,485584,ES35209577302742069253,6137.07,2022-08-01T08:03:13,Amurrio,expenses,repairs,-296.76,17701.1
buyer_3,Ana,Piñeiro,1989-08-23,25810029G,ana.piñeiro@megacloud.online,485584,ES35209577302742069253,6137.07,2022-08-02T14:49:14,Amurrio,expenses,food,-72.23,17628.87
buyer_3,Ana,Piñeiro,1989-08-23,25810029G,ana.piñeiro@megacloud.online,485584,ES35209577302742069253,6137.07,2022-08-03T10:26:06,Amurrio,expenses,cash,-100.0,17528.87
buyer_3,Ana,Piñeiro,1989-08-23,25810029G,ana.piñeiro@megacloud.online,485584,ES35209577302742069253,6137.07,2022-08-04T16:45:23,Amurrio,expenses,mortgage,-2799.85,14729.02
buyer_3,Ana,Piñeiro,1989-08-23,25810029G,ana.piñeiro@megacloud.online,485584,ES35209577302742069253,6137.07,2022-08-04T14:38:26,Amurrio,expenses,leisure,-76.47,14652.55
buyer_3,Ana,Piñeiro,1989-08-23,25810029G,ana.piñeiro@megacloud.online,485584,ES35209577302742069253,6137.07,2022-08-06T11:40:34,Amurrio,expenses,electricity,-253.07,14399.48
buyer_3,Ana,Piñeiro,1989-08-23,25810029G,ana.piñeiro@megacloud.online,485584,ES35209577302742069253,6137.07,2022-08-06T16:50:51,Amurrio,expenses,gas,-311.37,14088.11
buyer_3,Ana,Piñeiro,1989-08-23,25810029G,ana.piñeiro@megacloud.online,485584,ES35209577302742069253,6137.07,2022-08-06T20:57:15,Amurrio,expenses,cash,-100.0,13988.11
buyer_3,Ana,Piñeiro,1989-08-23,25810029G,ana.piñeiro@megacloud.online,485584,ES35209577302742069253,6137.07,2022-08-08T16:37:58,Amurrio,expenses,internet,-138.83,13849.28
buyer_3,Ana,Piñeiro,1989-08-23,25810029G,ana.piñeiro@megacloud.online,485584,ES35209577302742069253,6137.07,2022-08-08T19:40:01,Amurrio,expenses,water,-112.39,13736.89
buyer_3,Ana,Piñeiro,1989-08-23,25810029G,ana.piñeiro@megacloud.online,485584,ES35209577302742069253,6137.07,2022-08-08T20:53:52,Amurrio,expenses,phone,-120.69,13616.2
buyer_3,Ana,Piñeiro,1989-08-23,25810029G,ana.piñeiro@megacloud.online,485584,ES35209577302742069253,6137.07,2022-08-09T20:43:06,Amurrio,expenses,transport,-65.61,13550.59
buyer_3,Ana,Piñeiro,1989-08-23,25810029G,ana.piñeiro@megacloud.online,485584,ES35209577302742069253,6137.07,2022-08-10T11:47:55,Amurrio,expenses,education,-45.45,13505.14
buyer_3,Ana,Piñeiro,1989-08-23,25810029G,ana.piñeiro@megacloud.online,485584,ES35209577302742069253,6137.07,2022-08-12T13:22:51,Amurrio,expenses,leisure,-47.51,13457.63
buyer_3,Ana,Piñeiro,1989-08-23,25810029G,ana.piñeiro@megacloud.online,485584,ES35209577302742069253,6137.07,2022-08-12T10:48:37,Amurrio,expenses,repairs,-158.98,13298.65
buyer_3,Ana,Piñeiro,1989-08-23,25810029G,ana.piñeiro@megacloud.online,485584,ES35209577302742069253,6137.07,2022-08-14T08:05:57,Amurrio,expenses,leisure,-49.11,13249.54
buyer_3,Ana,Piñeiro,1989-08-23,25810029G,ana.piñeiro@megacloud.online,485584,ES35209577302742069253,6137.07,2022-08-14T17:17:50,Amurrio,expenses,cash,-100.0,13149.54
buyer_3,Ana,Piñeiro,1989-08-23,25810029G,ana.piñeiro@megacloud.online,485584,ES35209577302742069253,6137.07,2022-08-16T14:26:49,Amurrio,expenses,gifts,-838.12,12311.42
buyer_3,Ana,Piñeiro,1989-08-23,25810029G,ana.piñeiro@megacloud.online,485584,ES35209577302742069253,6137.07,2022-08-17T20:43:55,Amurrio,expenses,appliances,-386.74,11924.68
buyer_3,Ana,Piñeiro,1989-08-23,25810029G,ana.piñeiro@megacloud.online,485584,ES35209577302742069253,6137.07,2022-08-18T03:21:22,Amurrio,expenses,food,-79.79,11844.89
buyer_3,Ana,Piñeiro,1989-08-23,25810029G,ana.piñeiro@megacloud.online,485584,ES35209577302742069253,6137.07,2022-08-21T11:56:19,Amurrio,expenses,appliances,-266.54,11578.35
buyer_3,Ana,Piñeiro,1989-08-23,25810029G,ana.piñeiro@megacloud.online,485584,ES35209577302742069253,6137.07,2022-08-22T13:03:46,Amurrio,expenses,repairs,-207.83,11370.52
buyer_3,Ana,Piñeiro,1989-08-23,25810029G,ana.piñeiro@megacloud.online,485584,ES35209577302742069253,6137.07,2022-08-27T09:26:05,Amurrio,expenses,food,-86.45,11284.07
buyer_3,Ana,Piñeiro,1989-08-23,25810029G,ana.piñeiro@megacloud.online,485584,ES35209577302742069253,6137.07,2022-08-27T11:03:08,Amurrio,expenses,gifts,-478.61,10805.46
buyer_3,Ana,Piñeiro,1989-08-23,25810029G,ana.piñeiro@megacloud.online,485584,ES35209577302742069253,6137.07,2022-08-28T10:17:38,Amurrio,expenses,leisure,-61.87,10743.59
buyer_3,Ana,Piñeiro,1989-08-23,25810029G,ana.piñeiro@megacloud.online,485584,ES35209577302742069253,6137.07,2022-08-29T16:40:03,Amurrio,expenses,education,-54.1,10689.49
buyer_3,Ana,Piñeiro,1989-08-23,25810029G,ana.piñeiro@megacloud.online,485584,ES35209577302742069253,6137.07,2022-08-29T15:47:26,Amurrio,expenses,gifts,-824.39,9865.1
buyer_3,Ana,Piñeiro,1989-08-23,25810029G,ana.piñeiro@megacloud.online,485584,ES35209577302742069253,6137.07,2022-08-31T17:56:57,Amurrio,expenses,cash,-100.0,9765.1
buyer_3,Ana,Piñeiro,1989-08-23,25810029G,ana.piñeiro@megacloud.online,485584,ES35209577302742069253,6137.07,2022-09-01T16:56:23,Amurrio,incomes,salary,3152.42,12917.52
buyer_3,Ana,Piñeiro,1989-08-23,25810029G,ana.piñeiro@megacloud.online,485584,ES35209577302742069253,6137.07,2022-09-01T16:56:23,Amurrio,incomes,salary_partner,3458.57,16376.09
buyer_3,Ana,Piñeiro,1989-08-23,25810029G,ana.piñeiro@megacloud.online,485584,ES35209577302742069253,6137.07,2022-09-01T16:56:23,Amurrio,incomes,extra_income,379.94,16756.03
buyer_3,Ana,Piñeiro,1989-08-23,25810029G,ana.piñeiro@megacloud.online,485584,ES35209577302742069253,6137.07,2022-09-03T11:38:22,Amurrio,expenses,leisure,-80.94,16675.09
buyer_3,Ana,Piñeiro,1989-08-23,25810029G,ana.piñeiro@megacloud.online,485584,ES35209577302742069253,6137.07,2022-09-03T20:54:17,Amurrio,expenses,clothing,-122.36,16552.73
buyer_3,Ana,Piñeiro,1989-08-23,25810029G,ana.piñeiro@megacloud.online,485584,ES35209577302742069253,6137.07,2022-09-04T11:56:05,Amurrio,expenses,mortgage,-2799.85,13752.88
buyer_3,Ana,Piñeiro,1989-08-23,25810029G,ana.piñeiro@megacloud.online,485584,ES35209577302742069253,6137.07,2022-09-04T10:06:00,Amurrio,expenses,food,-96.84,13656.04
buyer_3,Ana,Piñeiro,1989-08-23,25810029G,ana.piñeiro@megacloud.online,485584,ES35209577302742069253,6137.07,2022-09-04T16:38:31,Amurrio,expenses,cash,-100.0,13556.04
buyer_3,Ana,Piñeiro,1989-08-23,25810029G,ana.piñeiro@megacloud.online,485584,ES35209577302742069253,6137.07,2022-09-04T20:30:01,Amurrio,expenses,gifts,-666.03,12890.01
buyer_3,Ana,Piñeiro,1989-08-23,25810029G,ana.piñeiro@megacloud.online,485584,ES35209577302742069253,6137.07,2022-09-05T12:49:01,Amurrio,expenses,gas,-291.28,12598.73
buyer_3,Ana,Piñeiro,1989-08-23,25810029G,ana.piñeiro@megacloud.online,485584,ES35209577302742069253,6137.07,2022-09-05T12:00:58,Amurrio,expenses,food,-72.91,12525.82
buyer_3,Ana,Piñeiro,1989-08-23,25810029G,ana.piñeiro@megacloud.online,485584,ES35209577302742069253,6137.07,2022-09-05T14:50:15,Amurrio,expenses,cash,-100.0,12425.82
buyer_3,Ana,Piñeiro,1989-08-23,25810029G,ana.piñeiro@megacloud.online,485584,ES35209577302742069253,6137.07,2022-09-06T23:15:02,Amurrio,expenses,internet,-138.83,12286.99
buyer_3,Ana,Piñeiro,1989-08-23,25810029G,ana.piñeiro@megacloud.online,485584,ES35209577302742069253,6137.07,2022-09-06T17:54:51,Amurrio,expenses,transport,-69.2,12217.79
buyer_3,Ana,Piñeiro,1989-08-23,25810029G,ana.piñeiro@megacloud.online,485584,ES35209577302742069253,6137.07,2022-09-07T22:53:18,Amurrio,expenses,phone,-128.83,12088.96
buyer_3,Ana,Piñeiro,1989-08-23,25810029G,ana.piñeiro@megacloud.online,485584,ES35209577302742069253,6137.07,2022-09-08T11:02:14,Amurrio,expenses,water,-137.28,11951.68
buyer_3,Ana,Piñeiro,1989-08-23,25810029G,ana.piñeiro@megacloud.online,485584,ES35209577302742069253,6137.07,2022-09-08T12:44:15,Amurrio,expenses,electricity,-159.06,11792.62
buyer_3,Ana,Piñeiro,1989-08-23,25810029G,ana.piñeiro@megacloud.online,485584,ES35209577302742069253,6137.07,2022-09-08T22:16:56,Amurrio,expenses,transport,-84.46,11708.16
buyer_3,Ana,Piñeiro,1989-08-23,25810029G,ana.piñeiro@megacloud.online,485584,ES35209577302742069253,6137.07,2022-09-08T12:36:00,Amurrio,expenses,healthcare,-169.4,11538.76
buyer_3,Ana,Piñeiro,1989-08-23,25810029G,ana.piñeiro@megacloud.online,485584,ES35209577302742069253,6137.07,2022-09-09T10:20:38,Amurrio,expenses,food,-119.11,11419.65
buyer_3,Ana,Piñeiro,1989-08-23,25810029G,ana.piñeiro@megacloud.online,485584,ES35209577302742069253,6137.07,2022-09-09T15:10:11,Amurrio,expenses,transport,-55.06,11364.59
buyer_3,Ana,Piñeiro,1989-08-23,25810029G,ana.piñeiro@megacloud.online,485584,ES35209577302742069253,6137.07,2022-09-09T18:37:36,Amurrio,expenses,repairs,-196.26,11168.33
buyer_3,Ana,Piñeiro,1989-08-23,25810029G,ana.piñeiro@megacloud.online,485584,ES35209577302742069253,6137.07,2022-09-09T07:30:06,Amurrio,expenses,gifts,-333.99,10834.34
buyer_3,Ana,Piñeiro,1989-08-23,25810029G,ana.piñeiro@megacloud.online,485584,ES35209577302742069253,6137.07,2022-09-11T09:46:11,Amurrio,expenses,food,-91.31,10743.03
buyer_3,Ana,Piñeiro,1989-08-23,25810029G,ana.piñeiro@megacloud.online,485584,ES35209577302742069253,6137.07,2022-09-12T15:29:38,Amurrio,expenses,cash,-100.0,10643.03
buyer_3,Ana,Piñeiro,1989-08-23,25810029G,ana.piñeiro@megacloud.online,485584,ES35209577302742069253,6137.07,2022-09-13T18:05:28,Amurrio,expenses,transport,-82.43,10560.6
buyer_3,Ana,Piñeiro,1989-08-23,25810029G,ana.piñeiro@megacloud.online,485584,ES35209577302742069253,6137.07,2022-09-17T22:19:09,Amurrio,expenses,cash,-100.0,10460.6
buyer_3,Ana,Piñeiro,1989-08-23,25810029G,ana.piñeiro@megacloud.online,485584,ES35209577302742069253,6137.07,2022-09-19T13:10:18,Amurrio,expenses,gifts,-511.03,9949.57
buyer_3,Ana,Piñeiro,1989-08-23,25810029G,ana.piñeiro@megacloud.online,485584,ES35209577302742069253,6137.07,2022-09-20T09:20:47,Amurrio,expenses,gifts,-847.32,9102.25
buyer_3,Ana,Piñeiro,1989-08-23,25810029G,ana.piñeiro@megacloud.online,485584,ES35209577302742069253,6137.07,2022-09-22T23:22:14,Amurrio,expenses,travel,-1150.23,7952.02
buyer_3,Ana,Piñeiro,1989-08-23,25810029G,ana.piñeiro@megacloud.online,485584,ES35209577302742069253,6137.07,2022-09-26T17:31:24,Amurrio,expenses,food,-60.57,7891.45
buyer_3,Ana,Piñeiro,1989-08-23,25810029G,ana.piñeiro@megacloud.online,485584,ES35209577302742069253,6137.07,2022-09-27T18:56:49,Amurrio,expenses,repairs,-174.88,7716.57
buyer_3,Ana,Piñeiro,1989-08-23,25810029G,ana.piñeiro@megacloud.online,485584,ES35209577302742069253,6137.07,2022-09-28T19:56:13,Amurrio,expenses,leisure,-55.08,7661.49
buyer_3,Ana,Piñeiro,1989-08-23,25810029G,ana.piñeiro@megacloud.online,485584,ES35209577302742069253,6137.07,2022-10-01T19:11:47,Amurrio,incomes,salary,3152.42,10813.91
buyer_3,Ana,Piñeiro,1989-08-23,25810029G,ana.piñeiro@megacloud.online,485584,ES35209577302742069253,6137.07,2022-10-01T19:11:47,Amurrio,incomes,salary_partner,3458.57,14272.48
buyer_3,Ana,Piñeiro,1989-08-23,25810029G,ana.piñeiro@megacloud.online,485584,ES35209577302742069253,6137.07,2022-10-03T19:04:01,Amurrio,expenses,cash,-100.0,14172.48
buyer_3,Ana,Piñeiro,1989-08-23,25810029G,ana.piñeiro@megacloud.online,485584,ES35209577302742069253,6137.07,2022-10-04T08:50:29,Amurrio,expenses,mortgage,-2799.85,11372.63
buyer_3,Ana,Piñeiro,1989-08-23,25810029G,ana.piñeiro@megacloud.online,485584,ES35209577302742069253,6137.07,2022-10-05T18:41:22,Amurrio,expenses,water,-85.23,11287.4
buyer_3,Ana,Piñeiro,1989-08-23,25810029G,ana.piñeiro@megacloud.online,485584,ES35209577302742069253,6137.07,2022-10-05T18:35:02,Amurrio,expenses,repairs,-85.51,11201.89
buyer_3,Ana,Piñeiro,1989-08-23,25810029G,ana.piñeiro@megacloud.online,485584,ES35209577302742069253,6137.07,2022-10-06T11:36:44,Amurrio,expenses,internet,-138.83,11063.06
buyer_3,Ana,Piñeiro,1989-08-23,25810029G,ana.piñeiro@megacloud.online,485584,ES35209577302742069253,6137.07,2022-10-06T13:22:15,Amurrio,expenses,gifts,-269.11,10793.95
buyer_3,Ana,Piñeiro,1989-08-23,25810029G,ana.piñeiro@megacloud.online,485584,ES35209577302742069253,6137.07,2022-10-07T08:22:27,Amurrio,expenses,gifts,-111.33,10682.62
buyer_3,Ana,Piñeiro,1989-08-23,25810029G,ana.piñeiro@megacloud.online,485584,ES35209577302742069253,6137.07,2022-10-08T16:58:01,Amurrio,expenses,electricity,-198.07,10484.55
buyer_3,Ana,Piñeiro,1989-08-23,25810029G,ana.piñeiro@megacloud.online,485584,ES35209577302742069253,6137.07,2022-10-08T20:54:02,Amurrio,expenses,gas,-165.01,10319.54
buyer_3,Ana,Piñeiro,1989-08-23,25810029G,ana.piñeiro@megacloud.online,485584,ES35209577302742069253,6137.07,2022-10-08T18:36:22,Amurrio,expenses,phone,-103.92,10215.62
buyer_3,Ana,Piñeiro,1989-08-23,25810029G,ana.piñeiro@megacloud.online,485584,ES35209577302742069253,6137.07,2022-10-08T16:33:50,Amurrio,expenses,cash,-100.0,10115.62
buyer_3,Ana,Piñeiro,1989-08-23,25810029G,ana.piñeiro@megacloud.online,485584,ES35209577302742069253,6137.07,2022-10-10T12:25:32,Amurrio,expenses,transport,-59.27,10056.35
buyer_3,Ana,Piñeiro,1989-08-23,25810029G,ana.piñeiro@megacloud.online,485584,ES35209577302742069253,6137.07,2022-10-11T04:34:40,Amurrio,expenses,transport,-56.3,10000.05
buyer_3,Ana,Piñeiro,1989-08-23,25810029G,ana.piñeiro@megacloud.online,485584,ES35209577302742069253,6137.07,2022-10-12T11:56:32,Amurrio,expenses,transport,-84.11,9915.94
buyer_3,Ana,Piñeiro,1989-08-23,25810029G,ana.piñeiro@megacloud.online,485584,ES35209577302742069253,6137.07,2022-10-12T13:14:24,Amurrio,expenses,cash,-100.0,9815.94
buyer_3,Ana,Piñeiro,1989-08-23,25810029G,ana.piñeiro@megacloud.online,485584,ES35209577302742069253,6137.07,2022-10-13T13:14:32,Amurrio,expenses,cash,-100.0,9715.94
buyer_3,Ana,Piñeiro,1989-08-23,25810029G,ana.piñeiro@megacloud.online,485584,ES35209577302742069253,6137.07,2022-10-15T09:09:49,Amurrio,expenses,clothing,-78.76,9637.18
buyer_3,Ana,Piñeiro,1989-08-23,25810029G,ana.piñeiro@megacloud.online,485584,ES35209577302742069253,6137.07,2022-10-16T11:56:30,Amurrio,expenses,food,-98.97,9538.21
buyer_3,Ana,Piñeiro,1989-08-23,25810029G,ana.piñeiro@megacloud.online,485584,ES35209577302742069253,6137.07,2022-10-16T17:17:56,Amurrio,expenses,healthcare,-145.93,9392.28
buyer_3,Ana,Piñeiro,1989-08-23,25810029G,ana.piñeiro@megacloud.online,485584,ES35209577302742069253,6137.07,2022-10-17T22:56:13,Amurrio,expenses,food,-123.05,9269.23
buyer_3,Ana,Piñeiro,1989-08-23,25810029G,ana.piñeiro@megacloud.online,485584,ES35209577302742069253,6137.07,2022-10-18T16:58:13,Amurrio,expenses,gifts,-54.4,9214.83
buyer_3,Ana,Piñeiro,1989-08-23,25810029G,ana.piñeiro@megacloud.online,485584,ES35209577302742069253,6137.07,2022-10-19T12:46:20,Amurrio,expenses,transport,-47.7,9167.13
buyer_3,Ana,Piñeiro,1989-08-23,25810029G,ana.piñeiro@megacloud.online,485584,ES35209577302742069253,6137.07,2022-10-22T16:19:24,Amurrio,expenses,cash,-100.0,9067.13
buyer_3,Ana,Piñeiro,1989-08-23,25810029G,ana.piñeiro@megacloud.online,485584,ES35209577302742069253,6137.07,2022-10-23T13:59:53,Amurrio,expenses,leisure,-67.55,8999.58
buyer_3,Ana,Piñeiro,1989-08-23,25810029G,ana.piñeiro@megacloud.online,485584,ES35209577302742069253,6137.07,2022-10-24T20:51:49,Amurrio,expenses,education,-48.5,8951.08
buyer_3,Ana,Piñeiro,1989-08-23,25810029G,ana.piñeiro@megacloud.online,485584,ES35209577302742069253,6137.07,2022-10-24T05:20:11,Amurrio,expenses,gifts,-122.66,8828.42
buyer_3,Ana,Piñeiro,1989-08-23,25810029G,ana.piñeiro@megacloud.online,485584,ES35209577302742069253,6137.07,2022-10-27T23:20:37,Amurrio,expenses,education,-54.19,8774.23
buyer_3,Ana,Piñeiro,1989-08-23,25810029G,ana.piñeiro@megacloud.online,485584,ES35209577302742069253,6137.07,2022-10-28T13:02:34,Amurrio,expenses,gifts,-847.56,7926.67
buyer_3,Ana,Piñeiro,1989-08-23,25810029G,ana.piñeiro@megacloud.online,485584,ES35209577302742069253,6137.07,2022-10-30T10:24:45,Amurrio,expenses,leisure,-84.16,7842.51
buyer_3,Ana,Piñeiro,1989-08-23,25810029G,ana.piñeiro@megacloud.online,485584,ES35209577302742069253,6137.07,2022-10-31T20:56:37,Amurrio,expenses,cash,-100.0,7742.51
buyer_3,Ana,Piñeiro,1989-08-23,25810029G,ana.piñeiro@megacloud.online,485584,ES35209577302742069253,6137.07,2022-11-01T12:59:00,Amurrio,incomes,salary,3152.42,10894.93
buyer_3,Ana,Piñeiro,1989-08-23,25810029G,ana.piñeiro@megacloud.online,485584,ES35209577302742069253,6137.07,2022-11-01T12:59:00,Amurrio,incomes,salary_partner,3458.57,14353.5
buyer_3,Ana,Piñeiro,1989-08-23,25810029G,ana.piñeiro@megacloud.online,485584,ES35209577302742069253,6137.07,2022-11-01T08:38:32,Amurrio,expenses,transport,-55.46,14298.04
buyer_3,Ana,Piñeiro,1989-08-23,25810029G,ana.piñeiro@megacloud.online,485584,ES35209577302742069253,6137.07,2022-11-03T01:12:16,Amurrio,expenses,food,-121.62,14176.42
buyer_3,Ana,Piñeiro,1989-08-23,25810029G,ana.piñeiro@megacloud.online,485584,ES35209577302742069253,6137.07,2022-11-03T15:20:08,Amurrio,expenses,leisure,-77.95,14098.47
buyer_3,Ana,Piñeiro,1989-08-23,25810029G,ana.piñeiro@megacloud.online,485584,ES35209577302742069253,6137.07,2022-11-04T09:55:15,Amurrio,expenses,mortgage,-2799.85,11298.62
buyer_3,Ana,Piñeiro,1989-08-23,25810029G,ana.piñeiro@megacloud.online,485584,ES35209577302742069253,6137.07,2022-11-04T06:05:20,Amurrio,expenses,food,-79.17,11219.45
buyer_3,Ana,Piñeiro,1989-08-23,25810029G,ana.piñeiro@megacloud.online,485584,ES35209577302742069253,6137.07,2022-11-06T10:17:05,Amurrio,expenses,water,-99.79,11119.66
buyer_3,Ana,Piñeiro,1989-08-23,25810029G,ana.piñeiro@megacloud.online,485584,ES35209577302742069253,6137.07,2022-11-06T10:18:07,Amurrio,expenses,leisure,-33.09,11086.57
buyer_3,Ana,Piñeiro,1989-08-23,25810029G,ana.piñeiro@megacloud.online,485584,ES35209577302742069253,6137.07,2022-11-06T13:17:29,Amurrio,expenses,cash,-100.0,10986.57
buyer_3,Ana,Piñeiro,1989-08-23,25810029G,ana.piñeiro@megacloud.online,485584,ES35209577302742069253,6137.07,2022-11-07T11:59:52,Amurrio,expenses,electricity,-268.76,10717.81
buyer_3,Ana,Piñeiro,1989-08-23,25810029G,ana.piñeiro@megacloud.online,485584,ES35209577302742069253,6137.07,2022-11-07T21:35:10,Amurrio,expenses,internet,-138.83,10578.98
buyer_3,Ana,Piñeiro,1989-08-23,25810029G,ana.piñeiro@megacloud.online,485584,ES35209577302742069253,6137.07,2022-11-08T19:38:59,Amurrio,expenses,gas,-144.56,10434.42
buyer_3,Ana,Piñeiro,1989-08-23,25810029G,ana.piñeiro@megacloud.online,485584,ES35209577302742069253,6137.07,2022-11-08T09:52:07,Amurrio,expenses,phone,-132.75,10301.67
buyer_3,Ana,Piñeiro,1989-08-23,25810029G,ana.piñeiro@megacloud.online,485584,ES35209577302742069253,6137.07,2022-11-09T14:41:18,Amurrio,expenses,healthcare,-57.28,10244.39
buyer_3,Ana,Piñeiro,1989-08-23,25810029G,ana.piñeiro@megacloud.online,485584,ES35209577302742069253,6137.07,2022-11-12T09:26:40,Amurrio,expenses,leisure,-29.22,10215.17
buyer_3,Ana,Piñeiro,1989-08-23,25810029G,ana.piñeiro@megacloud.online,485584,ES35209577302742069253,6137.07,2022-11-14T17:19:49,Amurrio,expenses,clothing,-89.44,10125.73
buyer_3,Ana,Piñeiro,1989-08-23,25810029G,ana.piñeiro@megacloud.online,485584,ES35209577302742069253,6137.07,2022-11-14T15:33:58,Amurrio,expenses,cash,-100.0,10025.73
buyer_3,Ana,Piñeiro,1989-08-23,25810029G,ana.piñeiro@megacloud.online,485584,ES35209577302742069253,6137.07,2022-11-16T10:56:31,Amurrio,expenses,food,-99.53,9926.2
buyer_3,Ana,Piñeiro,1989-08-23,25810029G,ana.piñeiro@megacloud.online,485584,ES35209577302742069253,6137.07,2022-11-17T17:54:16,Amurrio,expenses,food,-67.26,9858.94
buyer_3,Ana,Piñeiro,1989-08-23,25810029G,ana.piñeiro@megacloud.online,485584,ES35209577302742069253,6137.07,2022-11-20T23:58:59,Amurrio,expenses,food,-96.55,9762.39
buyer_3,Ana,Piñeiro,1989-08-23,25810029G,ana.piñeiro@megacloud.online,485584,ES35209577302742069253,6137.07,2022-11-20T06:01:33,Amurrio,expenses,gifts,-274.57,9487.82
buyer_3,Ana,Piñeiro,1989-08-23,25810029G,ana.piñeiro@megacloud.online,485584,ES35209577302742069253,6137.07,2022-11-21T21:04:05,Amurrio,expenses,clothing,-108.85,9378.97
buyer_3,Ana,Piñeiro,1989-08-23,25810029G,ana.piñeiro@megacloud.online,485584,ES35209577302742069253,6137.07,2022-11-22T21:22:06,Amurrio,expenses,leisure,-27.18,9351.79
buyer_3,Ana,Piñeiro,1989-08-23,25810029G,ana.piñeiro@megacloud.online,485584,ES35209577302742069253,6137.07,2022-11-23T09:48:34,Amurrio,expenses,gifts,-832.18,8519.61
buyer_3,Ana,Piñeiro,1989-08-23,25810029G,ana.piñeiro@megacloud.online,485584,ES35209577302742069253,6137.07,2022-11-24T12:16:02,Amurrio,expenses,cash,-100.0,8419.61
buyer_3,Ana,Piñeiro,1989-08-23,25810029G,ana.piñeiro@megacloud.online,485584,ES35209577302742069253,6137.07,2022-11-25T08:05:04,Amurrio,expenses,repairs,-53.7,8365.91
buyer_3,Ana,Piñeiro,1989-08-23,25810029G,ana.piñeiro@megacloud.online,485584,ES35209577302742069253,6137.07,2022-11-27T18:54:17,Amurrio,expenses,repairs,-243.96,8121.95
buyer_3,Ana,Piñeiro,1989-08-23,25810029G,ana.piñeiro@megacloud.online,485584,ES35209577302742069253,6137.07,2022-11-28T16:29:43,Amurrio,expenses,cash,-100.0,8021.95
buyer_3,Ana,Piñeiro,1989-08-23,25810029G,ana.piñeiro@megacloud.online,485584,ES35209577302742069253,6137.07,2022-11-29T15:49:06,Amurrio,expenses,clothing,-66.1,7955.85
buyer_3,Ana,Piñeiro,1989-08-23,25810029G,ana.piñeiro@megacloud.online,485584,ES35209577302742069253,6137.07,2022-11-30T18:49:33,Amurrio,expenses,food,-122.95,7832.9
buyer_3,Ana,Piñeiro,1989-08-23,25810029G,ana.piñeiro@megacloud.online,485584,ES35209577302742069253,6137.07,2022-11-30T18:49:50,Amurrio,expenses,cash,-100.0,7732.9
buyer_3,Ana,Piñeiro,1989-08-23,25810029G,ana.piñeiro@megacloud.online,485584,ES35209577302742069253,6137.07,2022-12-01T17:57:33,Amurrio,incomes,salary,3152.42,10885.32
buyer_3,Ana,Piñeiro,1989-08-23,25810029G,ana.piñeiro@megacloud.online,485584,ES35209577302742069253,6137.07,2022-12-01T17:57:33,Amurrio,incomes,salary_partner,3458.57,14343.89
buyer_3,Ana,Piñeiro,1989-08-23,25810029G,ana.piñeiro@megacloud.online,485584,ES35209577302742069253,6137.07,2022-12-01T17:57:33,Amurrio,incomes,salary_bonus,2360.26,16704.15
buyer_3,Ana,Piñeiro,1989-08-23,25810029G,ana.piñeiro@megacloud.online,485584,ES35209577302742069253,6137.07,2022-12-01T17:57:33,Amurrio,incomes,salary_partner_bonus,2453.64,19157.79
buyer_3,Ana,Piñeiro,1989-08-23,25810029G,ana.piñeiro@megacloud.online,485584,ES35209577302742069253,6137.07,2022-12-02T09:59:25,Amurrio,expenses,food,-66.22,19091.57
buyer_3,Ana,Piñeiro,1989-08-23,25810029G,ana.piñeiro@megacloud.online,485584,ES35209577302742069253,6137.07,2022-12-02T14:46:45,Amurrio,expenses,cash,-100.0,18991.57
buyer_3,Ana,Piñeiro,1989-08-23,25810029G,ana.piñeiro@megacloud.online,485584,ES35209577302742069253,6137.07,2022-12-03T15:43:36,Amurrio,expenses,transport,-41.21,18950.36
buyer_3,Ana,Piñeiro,1989-08-23,25810029G,ana.piñeiro@megacloud.online,485584,ES35209577302742069253,6137.07,2022-12-04T11:26:40,Amurrio,expenses,mortgage,-2799.85,16150.51
buyer_3,Ana,Piñeiro,1989-08-23,25810029G,ana.piñeiro@megacloud.online,485584,ES35209577302742069253,6137.07,2022-12-04T23:04:45,Amurrio,expenses,gifts,-281.47,15869.04
buyer_3,Ana,Piñeiro,1989-08-23,25810029G,ana.piñeiro@megacloud.online,485584,ES35209577302742069253,6137.07,2022-12-05T15:36:15,Amurrio,expenses,electricity,-281.99,15587.05
buyer_3,Ana,Piñeiro,1989-08-23,25810029G,ana.piñeiro@megacloud.online,485584,ES35209577302742069253,6137.07,2022-12-05T04:10:23,Amurrio,expenses,food,-117.28,15469.77
buyer_3,Ana,Piñeiro,1989-08-23,25810029G,ana.piñeiro@megacloud.online,485584,ES35209577302742069253,6137.07,2022-12-05T15:45:19,Amurrio,expenses,cash,-100.0,15369.77
buyer_3,Ana,Piñeiro,1989-08-23,25810029G,ana.piñeiro@megacloud.online,485584,ES35209577302742069253,6137.07,2022-12-05T19:07:59,Amurrio,expenses,gifts,-283.17,15086.6
buyer_3,Ana,Piñeiro,1989-08-23,25810029G,ana.piñeiro@megacloud.online,485584,ES35209577302742069253,6137.07,2022-12-06T11:40:42,Amurrio,expenses,water,-66.4,15020.2
buyer_3,Ana,Piñeiro,1989-08-23,25810029G,ana.piñeiro@megacloud.online,485584,ES35209577302742069253,6137.07,2022-12-06T20:10:54,Amurrio,expenses,gas,-221.68,14798.52
buyer_3,Ana,Piñeiro,1989-08-23,25810029G,ana.piñeiro@megacloud.online,485584,ES35209577302742069253,6137.07,2022-12-06T14:26:58,Amurrio,expenses,phone,-113.07,14685.45
buyer_3,Ana,Piñeiro,1989-08-23,25810029G,ana.piñeiro@megacloud.online,485584,ES35209577302742069253,6137.07,2022-12-08T10:45:13,Amurrio,expenses,internet,-138.83,14546.62
buyer_3,Ana,Piñeiro,1989-08-23,25810029G,ana.piñeiro@megacloud.online,485584,ES35209577302742069253,6137.07,2022-12-09T17:01:30,Amurrio,expenses,leisure,-71.01,14475.61
buyer_3,Ana,Piñeiro,1989-08-23,25810029G,ana.piñeiro@megacloud.online,485584,ES35209577302742069253,6137.07,2022-12-10T16:23:56,Amurrio,expenses,education,-50.43,14425.18
buyer_3,Ana,Piñeiro,1989-08-23,25810029G,ana.piñeiro@megacloud.online,485584,ES35209577302742069253,6137.07,2022-12-12T11:55:58,Amurrio,expenses,food,-65.86,14359.32
buyer_3,Ana,Piñeiro,1989-08-23,25810029G,ana.piñeiro@megacloud.online,485584,ES35209577302742069253,6137.07,2022-12-13T11:51:44,Amurrio,expenses,transport,-78.35,14280.97
buyer_3,Ana,Piñeiro,1989-08-23,25810029G,ana.piñeiro@megacloud.online,485584,ES35209577302742069253,6137.07,2022-12-14T11:16:47,Amurrio,expenses,food,-68.37,14212.6
buyer_3,Ana,Piñeiro,1989-08-23,25810029G,ana.piñeiro@megacloud.online,485584,ES35209577302742069253,6137.07,2022-12-17T13:01:55,Amurrio,expenses,appliances,-286.88,13925.72
buyer_3,Ana,Piñeiro,1989-08-23,25810029G,ana.piñeiro@megacloud.online,485584,ES35209577302742069253,6137.07,2022-12-21T08:38:28,Amurrio,expenses,healthcare,-102.47,13823.25
buyer_3,Ana,Piñeiro,1989-08-23,25810029G,ana.piñeiro@megacloud.online,485584,ES35209577302742069253,6137.07,2022-12-23T19:41:53,Amurrio,expenses,leisure,-72.94,13750.31
buyer_3,Ana,Piñeiro,1989-08-23,25810029G,ana.piñeiro@megacloud.online,485584,ES35209577302742069253,6137.07,2022-12-24T19:36:42,Amurrio,expenses,food,-94.27,13656.04
buyer_3,Ana,Piñeiro,1989-08-23,25810029G,ana.piñeiro@megacloud.online,485584,ES35209577302742069253,6137.07,2022-12-25T15:41:29,Amurrio,expenses,leisure,-67.65,13588.39
buyer_3,Ana,Piñeiro,1989-08-23,25810029G,ana.piñeiro@megacloud.online,485584,ES35209577302742069253,6137.07,2022-12-26T08:55:40,Amurrio,expenses,leisure,-66.51,13521.88
buyer_3,Ana,Piñeiro,1989-08-23,25810029G,ana.piñeiro@megacloud.online,485584,ES35209577302742069253,6137.07,2022-12-26T10:17:58,Amurrio,expenses,travel,-784.89,12736.99
buyer_3,Ana,Piñeiro,1989-08-23,25810029G,ana.piñeiro@megacloud.online,485584,ES35209577302742069253,6137.07,2022-12-28T09:11:59,Amurrio,expenses,leisure,-79.61,12657.38
buyer_3,Ana,Piñeiro,1989-08-23,25810029G,ana.piñeiro@megacloud.online,485584,ES35209577302742069253,6137.07,2022-12-30T13:59:48,Amurrio,expenses,leisure,-69.41,12587.97
buyer_3,Ana,Piñeiro,1989-08-23,25810029G,ana.piñeiro@megacloud.online,485584,ES35209577302742069253,6137.07,2022-12-30T18:52:48,Amurrio,expenses,clothing,-60.1,12527.87
buyer_3,Ana,Piñeiro,1989-08-23,25810029G,ana.piñeiro@megacloud.online,485584,ES35209577302742069253,6137.07,2022-12-31T19:54:21,Amurrio,expenses,leisure,-81.92,12445.95
buyer_3,Ana,Piñeiro,1989-08-23,25810029G,ana.piñeiro@megacloud.online,485584,ES35209577302742069253,6137.07,2023-01-01T19:42:38,Amurrio,incomes,salary,3224.67,15670.62
buyer_3,Ana,Piñeiro,1989-08-23,25810029G,ana.piñeiro@megacloud.online,485584,ES35209577302742069253,6137.07,2023-01-01T19:42:38,Amurrio,incomes,salary_partner,3537.83,19208.45
buyer_3,Ana,Piñeiro,1989-08-23,25810029G,ana.piñeiro@megacloud.online,485584,ES35209577302742069253,6137.07,2023-01-01T19:42:38,Amurrio,incomes,extra_income,379.94,19588.39
buyer_3,Ana,Piñeiro,1989-08-23,25810029G,ana.piñeiro@megacloud.online,485584,ES35209577302742069253,6137.07,2023-01-04T18:29:01,Amurrio,expenses,mortgage,-2545.84,17042.55
buyer_3,Ana,Piñeiro,1989-08-23,25810029G,ana.piñeiro@megacloud.online,485584,ES35209577302742069253,6137.07,2023-01-05T13:11:44,Amurrio,expenses,internet,-142.01,16900.54
buyer_3,Ana,Piñeiro,1989-08-23,25810029G,ana.piñeiro@megacloud.online,485584,ES35209577302742069253,6137.07,2023-01-06T20:27:59,Amurrio,expenses,electricity,-265.98,16634.56
buyer_3,Ana,Piñeiro,1989-08-23,25810029G,ana.piñeiro@megacloud.online,485584,ES35209577302742069253,6137.07,2023-01-06T19:08:11,Amurrio,expenses,gas,-326.86,16307.7
buyer_3,Ana,Piñeiro,1989-08-23,25810029G,ana.piñeiro@megacloud.online,485584,ES35209577302742069253,6137.07,2023-01-06T08:36:27,Amurrio,expenses,phone,-127.89,16179.81
buyer_3,Ana,Piñeiro,1989-08-23,25810029G,ana.piñeiro@megacloud.online,485584,ES35209577302742069253,6137.07,2023-01-06T13:31:47,Amurrio,expenses,clothing,-137.56,16042.25
buyer_3,Ana,Piñeiro,1989-08-23,25810029G,ana.piñeiro@megacloud.online,485584,ES35209577302742069253,6137.07,2023-01-08T13:29:22,Amurrio,expenses,water,-100.32,15941.93
buyer_3,Ana,Piñeiro,1989-08-23,25810029G,ana.piñeiro@megacloud.online,485584,ES35209577302742069253,6137.07,2023-01-08T14:48:45,Amurrio,expenses,gifts,-828.82,15113.11
buyer_3,Ana,Piñeiro,1989-08-23,25810029G,ana.piñeiro@megacloud.online,485584,ES35209577302742069253,6137.07,2023-01-12T20:26:25,Amurrio,expenses,cash,-100.0,15013.11
buyer_3,Ana,Piñeiro,1989-08-23,25810029G,ana.piñeiro@megacloud.online,485584,ES35209577302742069253,6137.07,2023-01-13T19:49:46,Amurrio,expenses,cash,-100.0,14913.11
buyer_3,Ana,Piñeiro,1989-08-23,25810029G,ana.piñeiro@megacloud.online,485584,ES35209577302742069253,6137.07,2023-01-13T09:01:53,Amurrio,expenses,appliances,-304.96,14608.15
buyer_3,Ana,Piñeiro,1989-08-23,25810029G,ana.piñeiro@megacloud.online,485584,ES35209577302742069253,6137.07,2023-01-15T16:07:03,Amurrio,expenses,leisure,-65.36,14542.79
buyer_3,Ana,Piñeiro,1989-08-23,25810029G,ana.piñeiro@megacloud.online,485584,ES35209577302742069253,6137.07,2023-01-16T15:08:34,Amurrio,expenses,cash,-100.0,14442.79
buyer_3,Ana,Piñeiro,1989-08-23,25810029G,ana.piñeiro@megacloud.online,485584,ES35209577302742069253,6137.07,2023-01-18T17:24:53,Amurrio,expenses,cash,-100.0,14342.79
buyer_3,Ana,Piñeiro,1989-08-23,25810029G,ana.piñeiro@megacloud.online,485584,ES35209577302742069253,6137.07,2023-01-22T08:28:46,Amurrio,expenses,leisure,-55.52,14287.27
buyer_3,Ana,Piñeiro,1989-08-23,25810029G,ana.piñeiro@megacloud.online,485584,ES35209577302742069253,6137.07,2023-01-25T10:45:41,Amurrio,expenses,transport,-83.49,14203.78
buyer_3,Ana,Piñeiro,1989-08-23,25810029G,ana.piñeiro@megacloud.online,485584,ES35209577302742069253,6137.07,2023-01-27T13:49:35,Amurrio,expenses,food,-103.45,14100.33
buyer_3,Ana,Piñeiro,1989-08-23,25810029G,ana.piñeiro@megacloud.online,485584,ES35209577302742069253,6137.07,2023-01-29T15:22:44,Amurrio,expenses,leisure,-44.01,14056.32
buyer_3,Ana,Piñeiro,1989-08-23,25810029G,ana.piñeiro@megacloud.online,485584,ES35209577302742069253,6137.07,2023-01-29T06:34:57,Amurrio,expenses,cash,-100.0,13956.32
buyer_3,Ana,Piñeiro,1989-08-23,25810029G,ana.piñeiro@megacloud.online,485584,ES35209577302742069253,6137.07,2023-02-01T09:16:56,Amurrio,incomes,salary,3224.67,17180.99
buyer_3,Ana,Piñeiro,1989-08-23,25810029G,ana.piñeiro@megacloud.online,485584,ES35209577302742069253,6137.07,2023-02-01T09:16:56,Amurrio,incomes,salary_partner,3537.83,20718.82
buyer_3,Ana,Piñeiro,1989-08-23,25810029G,ana.piñeiro@megacloud.online,485584,ES35209577302742069253,6137.07,2023-02-01T08:06:35,Amurrio,expenses,transport,-50.32,20668.5
buyer_3,Ana,Piñeiro,1989-08-23,25810029G,ana.piñeiro@megacloud.online,485584,ES35209577302742069253,6137.07,2023-02-01T14:07:59,Amurrio,expenses,cash,-100.0,20568.5
buyer_3,Ana,Piñeiro,1989-08-23,25810029G,ana.piñeiro@megacloud.online,485584,ES35209577302742069253,6137.07,2023-02-01T13:58:35,Amurrio,expenses,repairs,-51.98,20516.52
buyer_3,Ana,Piñeiro,1989-08-23,25810029G,ana.piñeiro@megacloud.online,485584,ES35209577302742069253,6137.07,2023-02-02T18:12:59,Amurrio,expenses,cash,-100.0,20416.52
buyer_3,Ana,Piñeiro,1989-08-23,25810029G,ana.piñeiro@megacloud.online,485584,ES35209577302742069253,6137.07,2023-02-03T20:30:05,Amurrio,expenses,appliances,-106.49,20310.03
buyer_3,Ana,Piñeiro,1989-08-23,25810029G,ana.piñeiro@megacloud.online,485584,ES35209577302742069253,6137.07,2023-02-04T14:31:32,Amurrio,expenses,mortgage,-2545.84,17764.19
buyer_3,Ana,Piñeiro,1989-08-23,25810029G,ana.piñeiro@megacloud.online,485584,ES35209577302742069253,6137.07,2023-02-05T00:14:24,Amurrio,expenses,gas,-182.27,17581.92
buyer_3,Ana,Piñeiro,1989-08-23,25810029G,ana.piñeiro@megacloud.online,485584,ES35209577302742069253,6137.07,2023-02-05T12:23:51,Amurrio,expenses,food,-63.9,17518.02
buyer_3,Ana,Piñeiro,1989-08-23,25810029G,ana.piñeiro@megacloud.online,485584,ES35209577302742069253,6137.07,2023-02-06T10:02:39,Amurrio,expenses,electricity,-178.05,17339.97
buyer_3,Ana,Piñeiro,1989-08-23,25810029G,ana.piñeiro@megacloud.online,485584,ES35209577302742069253,6137.07,2023-02-06T21:02:58,Amurrio,expenses,phone,-126.99,17212.98
buyer_3,Ana,Piñeiro,1989-08-23,25810029G,ana.piñeiro@megacloud.online,485584,ES35209577302742069253,6137.07,2023-02-06T08:06:09,Amurrio,expenses,healthcare,-100.02,17112.96
buyer_3,Ana,Piñeiro,1989-08-23,25810029G,ana.piñeiro@megacloud.online,485584,ES35209577302742069253,6137.07,2023-02-07T08:46:19,Amurrio,expenses,food,-89.9,17023.06
buyer_3,Ana,Piñeiro,1989-08-23,25810029G,ana.piñeiro@megacloud.online,485584,ES35209577302742069253,6137.07,2023-02-07T12:54:21,Amurrio,expenses,repairs,-276.61,16746.45
buyer_3,Ana,Piñeiro,1989-08-23,25810029G,ana.piñeiro@megacloud.online,485584,ES35209577302742069253,6137.07,2023-02-08T11:27:13,Amurrio,expenses,internet,-142.01,16604.44
buyer_3,Ana,Piñeiro,1989-08-23,25810029G,ana.piñeiro@megacloud.online,485584,ES35209577302742069253,6137.07,2023-02-08T22:50:56,Amurrio,expenses,water,-80.53,16523.91
buyer_3,Ana,Piñeiro,1989-08-23,25810029G,ana.piñeiro@megacloud.online,485584,ES35209577302742069253,6137.07,2023-02-08T12:05:26,Amurrio,expenses,cash,-100.0,16423.91
buyer_3,Ana,Piñeiro,1989-08-23,25810029G,ana.piñeiro@megacloud.online,485584,ES35209577302742069253,6137.07,2023-02-08T19:12:24,Amurrio,expenses,travel,-1342.04,15081.87
buyer_3,Ana,Piñeiro,1989-08-23,25810029G,ana.piñeiro@megacloud.online,485584,ES35209577302742069253,6137.07,2023-02-12T13:19:12,Amurrio,expenses,cash,-100.0,14981.87
buyer_3,Ana,Piñeiro,1989-08-23,25810029G,ana.piñeiro@megacloud.online,485584,ES35209577302742069253,6137.07,2023-02-14T20:54:05,Amurrio,expenses,gifts,-246.82,14735.05
buyer_3,Ana,Piñeiro,1989-08-23,25810029G,ana.piñeiro@megacloud.online,485584,ES35209577302742069253,6137.07,2023-02-15T12:10:46,Amurrio,expenses,food,-110.27,14624.78
buyer_3,Ana,Piñeiro,1989-08-23,25810029G,ana.piñeiro@megacloud.online,485584,ES35209577302742069253,6137.07,2023-02-15T17:40:59,Amurrio,expenses,cash,-100.0,14524.78
buyer_3,Ana,Piñeiro,1989-08-23,25810029G,ana.piñeiro@megacloud.online,485584,ES35209577302742069253,6137.07,2023-02-16T19:45:21,Amurrio,expenses,leisure,-71.7,14453.08
buyer_3,Ana,Piñeiro,1989-08-23,25810029G,ana.piñeiro@megacloud.online,485584,ES35209577302742069253,6137.07,2023-02-16T08:38:26,Amurrio,expenses,repairs,-290.57,14162.51
buyer_3,Ana,Piñeiro,1989-08-23,25810029G,ana.piñeiro@megacloud.online,485584,ES35209577302742069253,6137.07,2023-02-18T09:37:06,Amurrio,expenses,clothing,-114.46,14048.05
buyer_3,Ana,Piñeiro,1989-08-23,25810029G,ana.piñeiro@megacloud.online,485584,ES35209577302742069253,6137.07,2023-02-18T13:13:00,Amurrio,expenses,cash,-100.0,13948.05
buyer_3,Ana,Piñeiro,1989-08-23,25810029G,ana.piñeiro@megacloud.online,485584,ES35209577302742069253,6137.07,2023-02-19T08:19:20,Amurrio,expenses,food,-91.9,13856.15
buyer_3,Ana,Piñeiro,1989-08-23,25810029G,ana.piñeiro@megacloud.online,485584,ES35209577302742069253,6137.07,2023-02-20T09:11:52,Amurrio,expenses,food,-63.0,13793.15
buyer_3,Ana,Piñeiro,1989-08-23,25810029G,ana.piñeiro@megacloud.online,485584,ES35209577302742069253,6137.07,2023-02-22T23:16:51,Amurrio,expenses,transport,-58.96,13734.19
buyer_3,Ana,Piñeiro,1989-08-23,25810029G,ana.piñeiro@megacloud.online,485584,ES35209577302742069253,6137.07,2023-02-22T19:53:57,Amurrio,expenses,leisure,-47.49,13686.7
buyer_3,Ana,Piñeiro,1989-08-23,25810029G,ana.piñeiro@megacloud.online,485584,ES35209577302742069253,6137.07,2023-02-23T03:06:31,Amurrio,expenses,leisure,-28.34,13658.36
buyer_3,Ana,Piñeiro,1989-08-23,25810029G,ana.piñeiro@megacloud.online,485584,ES35209577302742069253,6137.07,2023-02-23T19:09:48,Amurrio,expenses,cash,-100.0,13558.36
buyer_3,Ana,Piñeiro,1989-08-23,25810029G,ana.piñeiro@megacloud.online,485584,ES35209577302742069253,6137.07,2023-02-26T09:58:57,Amurrio,expenses,repairs,-163.2,13395.16
buyer_3,Ana,Piñeiro,1989-08-23,25810029G,ana.piñeiro@megacloud.online,485584,ES35209577302742069253,6137.07,2023-03-01T10:21:06,Amurrio,incomes,salary,3224.67,16619.83
buyer_3,Ana,Piñeiro,1989-08-23,25810029G,ana.piñeiro@megacloud.online,485584,ES35209577302742069253,6137.07,2023-03-01T10:21:06,Amurrio,incomes,salary_partner,3537.83,20157.66
buyer_3,Ana,Piñeiro,1989-08-23,25810029G,ana.piñeiro@megacloud.online,485584,ES35209577302742069253,6137.07,2023-03-01T13:10:52,Amurrio,expenses,food,-85.25,20072.41
buyer_3,Ana,Piñeiro,1989-08-23,25810029G,ana.piñeiro@megacloud.online,485584,ES35209577302742069253,6137.07,2023-03-02T10:08:12,Amurrio,expenses,repairs,-64.33,20008.08
buyer_3,Ana,Piñeiro,1989-08-23,25810029G,ana.piñeiro@megacloud.online,485584,ES35209577302742069253,6137.07,2023-03-03T19:25:01,Amurrio,expenses,cash,-100.0,19908.08
buyer_3,Ana,Piñeiro,1989-08-23,25810029G,ana.piñeiro@megacloud.online,485584,ES35209577302742069253,6137.07,2023-03-03T10:48:57,Amurrio,expenses,repairs,-310.78,19597.3
buyer_3,Ana,Piñeiro,1989-08-23,25810029G,ana.piñeiro@megacloud.online,485584,ES35209577302742069253,6137.07,2023-03-04T09:45:50,Amurrio,expenses,mortgage,-2545.84,17051.46
buyer_3,Ana,Piñeiro,1989-08-23,25810029G,ana.piñeiro@megacloud.online,485584,ES35209577302742069253,6137.07,2023-03-04T10:22:04,Amurrio,expenses,cash,-100.0,16951.46
buyer_3,Ana,Piñeiro,1989-08-23,25810029G,ana.piñeiro@megacloud.online,485584,ES35209577302742069253,6137.07,2023-03-04T17:30:23,Amurrio,expenses,gifts,-71.13,16880.33
buyer_3,Ana,Piñeiro,1989-08-23,25810029G,ana.piñeiro@megacloud.online,485584,ES35209577302742069253,6137.07,2023-03-05T17:45:01,Amurrio,expenses,water,-103.37,16776.96
buyer_3,Ana,Piñeiro,1989-08-23,25810029G,ana.piñeiro@megacloud.online,485584,ES35209577302742069253,6137.07,2023-03-05T14:52:54,Amurrio,expenses,gas,-229.86,16547.1
buyer_3,Ana,Piñeiro,1989-08-23,25810029G,ana.piñeiro@megacloud.online,485584,ES35209577302742069253,6137.07,2023-03-06T10:35:01,Amurrio,expenses,electricity,-90.54,16456.56
buyer_3,Ana,Piñeiro,1989-08-23,25810029G,ana.piñeiro@megacloud.online,485584,ES35209577302742069253,6137.07,2023-03-06T12:32:12,Amurrio,expenses,internet,-142.01,16314.55
buyer_3,Ana,Piñeiro,1989-08-23,25810029G,ana.piñeiro@megacloud.online,485584,ES35209577302742069253,6137.07,2023-03-06T08:27:47,Amurrio,expenses,food,-90.79,16223.76
buyer_3,Ana,Piñeiro,1989-08-23,25810029G,ana.piñeiro@megacloud.online,485584,ES35209577302742069253,6137.07,2023-03-06T11:59:55,Amurrio,expenses,cash,-100.0,16123.76
buyer_3,Ana,Piñeiro,1989-08-23,25810029G,ana.piñeiro@megacloud.online,485584,ES35209577302742069253,6137.07,2023-03-07T09:40:40,Amurrio,expenses,gifts,-241.76,15882.0
buyer_3,Ana,Piñeiro,1989-08-23,25810029G,ana.piñeiro@megacloud.online,485584,ES35209577302742069253,6137.07,2023-03-08T16:17:08,Amurrio,expenses,phone,-141.14,15740.86
buyer_3,Ana,Piñeiro,1989-08-23,25810029G,ana.piñeiro@megacloud.online,485584,ES35209577302742069253,6137.07,2023-03-11T12:58:56,Amurrio,expenses,cash,-100.0,15640.86
buyer_3,Ana,Piñeiro,1989-08-23,25810029G,ana.piñeiro@megacloud.online,485584,ES35209577302742069253,6137.07,2023-03-12T11:28:01,Amurrio,expenses,appliances,-309.17,15331.69
buyer_3,Ana,Piñeiro,1989-08-23,25810029G,ana.piñeiro@megacloud.online,485584,ES35209577302742069253,6137.07,2023-03-13T18:17:20,Amurrio,expenses,food,-102.75,15228.94
buyer_3,Ana,Piñeiro,1989-08-23,25810029G,ana.piñeiro@megacloud.online,485584,ES35209577302742069253,6137.07,2023-03-13T16:45:04,Amurrio,expenses,cash,-100.0,15128.94
buyer_3,Ana,Piñeiro,1989-08-23,25810029G,ana.piñeiro@megacloud.online,485584,ES35209577302742069253,6137.07,2023-03-13T15:52:22,Amurrio,expenses,gifts,-484.42,14644.52
buyer_3,Ana,Piñeiro,1989-08-23,25810029G,ana.piñeiro@megacloud.online,485584,ES35209577302742069253,6137.07,2023-03-16T18:10:33,Amurrio,expenses,cash,-100.0,14544.52
buyer_3,Ana,Piñeiro,1989-08-23,25810029G,ana.piñeiro@megacloud.online,485584,ES35209577302742069253,6137.07,2023-03-17T00:21:59,Amurrio,expenses,food,-108.18,14436.34
buyer_3,Ana,Piñeiro,1989-08-23,25810029G,ana.piñeiro@megacloud.online,485584,ES35209577302742069253,6137.07,2023-03-17T20:16:37,Amurrio,expenses,healthcare,-164.66,14271.68
buyer_3,Ana,Piñeiro,1989-08-23,25810029G,ana.piñeiro@megacloud.online,485584,ES35209577302742069253,6137.07,2023-03-20T08:55:12,Amurrio,expenses,cash,-100.0,14171.68
buyer_3,Ana,Piñeiro,1989-08-23,25810029G,ana.piñeiro@megacloud.online,485584,ES35209577302742069253,6137.07,2023-03-21T12:47:30,Amurrio,expenses,transport,-60.92,14110.76
buyer_3,Ana,Piñeiro,1989-08-23,25810029G,ana.piñeiro@megacloud.online,485584,ES35209577302742069253,6137.07,2023-03-24T17:17:13,Amurrio,expenses,cash,-100.0,14010.76
buyer_3,Ana,Piñeiro,1989-08-23,25810029G,ana.piñeiro@megacloud.online,485584,ES35209577302742069253,6137.07,2023-03-25T10:45:30,Amurrio,expenses,food,-95.12,13915.64
buyer_3,Ana,Piñeiro,1989-08-23,25810029G,ana.piñeiro@megacloud.online,485584,ES35209577302742069253,6137.07,2023-03-25T13:15:17,Amurrio,expenses,clothing,-157.62,13758.02
buyer_3,Ana,Piñeiro,1989-08-23,25810029G,ana.piñeiro@megacloud.online,485584,ES35209577302742069253,6137.07,2023-03-27T11:07:48,Amurrio,expenses,food,-68.0,13690.02
buyer_3,Ana,Piñeiro,1989-08-23,25810029G,ana.piñeiro@megacloud.online,485584,ES35209577302742069253,6137.07,2023-03-27T18:28:50,Amurrio,expenses,transport,-40.86,13649.16
buyer_3,Ana,Piñeiro,1989-08-23,25810029G,ana.piñeiro@megacloud.online,485584,ES35209577302742069253,6137.07,2023-03-27T22:38:26,Amurrio,expenses,appliances,-254.09,13395.07
buyer_3,Ana,Piñeiro,1989-08-23,25810029G,ana.piñeiro@megacloud.online,485584,ES35209577302742069253,6137.07,2023-03-28T09:18:06,Amurrio,expenses,gifts,-334.35,13060.72
buyer_3,Ana,Piñeiro,1989-08-23,25810029G,ana.piñeiro@megacloud.online,485584,ES35209577302742069253,6137.07,2023-04-01T21:36:44,Amurrio,incomes,salary,3224.67,16285.39
buyer_3,Ana,Piñeiro,1989-08-23,25810029G,ana.piñeiro@megacloud.online,485584,ES35209577302742069253,6137.07,2023-04-01T21:36:44,Amurrio,incomes,salary_partner,3537.83,19823.22
buyer_3,Ana,Piñeiro,1989-08-23,25810029G,ana.piñeiro@megacloud.online,485584,ES35209577302742069253,6137.07,2023-04-01T09:13:02,Amurrio,expenses,clothing,-98.53,19724.69
buyer_3,Ana,Piñeiro,1989-08-23,25810029G,ana.piñeiro@megacloud.online,485584,ES35209577302742069253,6137.07,2023-04-02T14:25:02,Amurrio,expenses,appliances,-143.24,19581.45
buyer_3,Ana,Piñeiro,1989-08-23,25810029G,ana.piñeiro@megacloud.online,485584,ES35209577302742069253,6137.07,2023-04-04T08:45:13,Amurrio,expenses,mortgage,-2545.84,17035.61
buyer_3,Ana,Piñeiro,1989-08-23,25810029G,ana.piñeiro@megacloud.online,485584,ES35209577302742069253,6137.07,2023-04-05T12:39:38,Amurrio,expenses,electricity,-148.2,16887.41
buyer_3,Ana,Piñeiro,1989-08-23,25810029G,ana.piñeiro@megacloud.online,485584,ES35209577302742069253,6137.07,2023-04-05T20:44:39,Amurrio,expenses,phone,-137.97,16749.44
buyer_3,Ana,Piñeiro,1989-08-23,25810029G,ana.piñeiro@megacloud.online,485584,ES35209577302742069253,6137.07,2023-04-05T18:50:36,Amurrio,expenses,cash,-100.0,16649.44
buyer_3,Ana,Piñeiro,1989-08-23,25810029G,ana.piñeiro@megacloud.online,485584,ES35209577302742069253,6137.07,2023-04-06T13:02:47,Amurrio,expenses,internet,-142.01,16507.43
buyer_3,Ana,Piñeiro,1989-08-23,25810029G,ana.piñeiro@megacloud.online,485584,ES35209577302742069253,6137.07,2023-04-07T12:32:13,Amurrio,expenses,gas,-195.29,16312.14
buyer_3,Ana,Piñeiro,1989-08-23,25810029G,ana.piñeiro@megacloud.online,485584,ES35209577302742069253,6137.07,2023-04-08T09:00:47,Amurrio,expenses,water,-118.62,16193.52
buyer_3,Ana,Piñeiro,1989-08-23,25810029G,ana.piñeiro@megacloud.online,485584,ES35209577302742069253,6137.07,2023-04-08T08:59:16,Amurrio,expenses,food,-109.02,16084.5
buyer_3,Ana,Piñeiro,1989-08-23,25810029G,ana.piñeiro@megacloud.online,485584,ES35209577302742069253,6137.07,2023-04-09T08:09:30,Amurrio,expenses,transport,-48.63,16035.87
buyer_3,Ana,Piñeiro,1989-08-23,25810029G,ana.piñeiro@megacloud.online,485584,ES35209577302742069253,6137.07,2023-04-12T20:20:26,Amurrio,expenses,clothing,-113.89,15921.98
buyer_3,Ana,Piñeiro,1989-08-23,25810029G,ana.piñeiro@megacloud.online,485584,ES35209577302742069253,6137.07,2023-04-16T10:28:03,Amurrio,expenses,cash,-100.0,15821.98
buyer_3,Ana,Piñeiro,1989-08-23,25810029G,ana.piñeiro@megacloud.online,485584,ES35209577302742069253,6137.07,2023-04-18T12:30:17,Amurrio,expenses,transport,-67.1,15754.88
buyer_3,Ana,Piñeiro,1989-08-23,25810029G,ana.piñeiro@megacloud.online,485584,ES35209577302742069253,6137.07,2023-04-18T19:55:01,Amurrio,expenses,leisure,-46.09,15708.79
buyer_3,Ana,Piñeiro,1989-08-23,25810029G,ana.piñeiro@megacloud.online,485584,ES35209577302742069253,6137.07,2023-04-18T17:50:34,Amurrio,expenses,healthcare,-134.97,15573.82
buyer_3,Ana,Piñeiro,1989-08-23,25810029G,ana.piñeiro@megacloud.online,485584,ES35209577302742069253,6137.07,2023-04-19T09:48:34,Amurrio,expenses,leisure,-27.46,15546.36
buyer_3,Ana,Piñeiro,1989-08-23,25810029G,ana.piñeiro@megacloud.online,485584,ES35209577302742069253,6137.07,2023-04-20T16:16:33,Amurrio,expenses,transport,-89.71,15456.65
buyer_3,Ana,Piñeiro,1989-08-23,25810029G,ana.piñeiro@megacloud.online,485584,ES35209577302742069253,6137.07,2023-04-26T16:51:03,Amurrio,expenses,food,-112.81,15343.84
buyer_3,Ana,Piñeiro,1989-08-23,25810029G,ana.piñeiro@megacloud.online,485584,ES35209577302742069253,6137.07,2023-04-26T09:11:52,Amurrio,expenses,leisure,-68.28,15275.56
buyer_3,Ana,Piñeiro,1989-08-23,25810029G,ana.piñeiro@megacloud.online,485584,ES35209577302742069253,6137.07,2023-04-28T19:37:19,Amurrio,expenses,appliances,-95.21,15180.35
buyer_3,Ana,Piñeiro,1989-08-23,25810029G,ana.piñeiro@megacloud.online,485584,ES35209577302742069253,6137.07,2023-04-28T16:36:24,Amurrio,expenses,gifts,-135.54,15044.81
buyer_3,Ana,Piñeiro,1989-08-23,25810029G,ana.piñeiro@megacloud.online,485584,ES35209577302742069253,6137.07,2023-04-29T18:12:38,Amurrio,expenses,cash,-100.0,14944.81
buyer_3,Ana,Piñeiro,1989-08-23,25810029G,ana.piñeiro@megacloud.online,485584,ES35209577302742069253,6137.07,2023-04-30T16:06:15,Amurrio,expenses,transport,-82.72,14862.09
buyer_3,Ana,Piñeiro,1989-08-23,25810029G,ana.piñeiro@megacloud.online,485584,ES35209577302742069253,6137.07,2023-04-30T13:51:45,Amurrio,expenses,gifts,-386.92,14475.17
buyer_3,Ana,Piñeiro,1989-08-23,25810029G,ana.piñeiro@megacloud.online,485584,ES35209577302742069253,6137.07,2023-05-01T22:44:03,Amurrio,incomes,salary,3224.67,17699.84
buyer_3,Ana,Piñeiro,1989-08-23,25810029G,ana.piñeiro@megacloud.online,485584,ES35209577302742069253,6137.07,2023-05-01T22:44:03,Amurrio,incomes,salary_partner,3537.83,21237.67
buyer_3,Ana,Piñeiro,1989-08-23,25810029G,ana.piñeiro@megacloud.online,485584,ES35209577302742069253,6137.07,2023-05-01T22:44:03,Amurrio,incomes,extra_income,379.94,21617.61
buyer_3,Ana,Piñeiro,1989-08-23,25810029G,ana.piñeiro@megacloud.online,485584,ES35209577302742069253,6137.07,2023-05-01T09:53:47,Amurrio,expenses,food,-77.45,21540.16
buyer_3,Ana,Piñeiro,1989-08-23,25810029G,ana.piñeiro@megacloud.online,485584,ES35209577302742069253,6137.07,2023-05-01T19:47:43,Amurrio,expenses,gifts,-622.9,20917.26
buyer_3,Ana,Piñeiro,1989-08-23,25810029G,ana.piñeiro@megacloud.online,485584,ES35209577302742069253,6137.07,2023-05-02T06:57:23,Amurrio,expenses,leisure,-78.22,20839.04
buyer_3,Ana,Piñeiro,1989-08-23,25810029G,ana.piñeiro@megacloud.online,485584,ES35209577302742069253,6137.07,2023-05-02T19:36:50,Amurrio,expenses,travel,-1235.49,19603.55
buyer_3,Ana,Piñeiro,1989-08-23,25810029G,ana.piñeiro@megacloud.online,485584,ES35209577302742069253,6137.07,2023-05-04T14:51:44,Amurrio,expenses,mortgage,-2545.84,17057.71
buyer_3,Ana,Piñeiro,1989-08-23,25810029G,ana.piñeiro@megacloud.online,485584,ES35209577302742069253,6137.07,2023-05-04T12:01:33,Amurrio,expenses,food,-65.62,16992.09
buyer_3,Ana,Piñeiro,1989-08-23,25810029G,ana.piñeiro@megacloud.online,485584,ES35209577302742069253,6137.07,2023-05-04T15:01:48,Amurrio,expenses,cash,-100.0,16892.09
buyer_3,Ana,Piñeiro,1989-08-23,25810029G,ana.piñeiro@megacloud.online,485584,ES35209577302742069253,6137.07,2023-05-04T17:11:52,Amurrio,expenses,appliances,-232.7,16659.39
buyer_3,Ana,Piñeiro,1989-08-23,25810029G,ana.piñeiro@megacloud.online,485584,ES35209577302742069253,6137.07,2023-05-05T05:50:16,Amurrio,expenses,internet,-142.01,16517.38
buyer_3,Ana,Piñeiro,1989-08-23,25810029G,ana.piñeiro@megacloud.online,485584,ES35209577302742069253,6137.07,2023-05-05T19:55:39,Amurrio,expenses,leisure,-81.33,16436.05
buyer_3,Ana,Piñeiro,1989-08-23,25810029G,ana.piñeiro@megacloud.online,485584,ES35209577302742069253,6137.07,2023-05-07T16:16:19,Amurrio,expenses,water,-94.71,16341.34
buyer_3,Ana,Piñeiro,1989-08-23,25810029G,ana.piñeiro@megacloud.online,485584,ES35209577302742069253,6137.07,2023-05-07T14:24:55,Amurrio,expenses,cash,-100.0,16241.34
buyer_3,Ana,Piñeiro,1989-08-23,25810029G,ana.piñeiro@megacloud.online,485584,ES35209577302742069253,6137.07,2023-05-08T14:55:49,Amurrio,expenses,electricity,-297.71,15943.63
buyer_3,Ana,Piñeiro,1989-08-23,25810029G,ana.piñeiro@megacloud.online,485584,ES35209577302742069253,6137.07,2023-05-08T12:10:04,Amurrio,expenses,gas,-238.24,15705.39
buyer_3,Ana,Piñeiro,1989-08-23,25810029G,ana.piñeiro@megacloud.online,485584,ES35209577302742069253,6137.07,2023-05-08T14:26:30,Amurrio,expenses,phone,-124.24,15581.15
buyer_3,Ana,Piñeiro,1989-08-23,25810029G,ana.piñeiro@megacloud.online,485584,ES35209577302742069253,6137.07,2023-05-08T19:54:33,Amurrio,expenses,food,-87.27,15493.88
buyer_3,Ana,Piñeiro,1989-08-23,25810029G,ana.piñeiro@megacloud.online,485584,ES35209577302742069253,6137.07,2023-05-08T10:42:22,Amurrio,expenses,transport,-48.04,15445.84
buyer_3,Ana,Piñeiro,1989-08-23,25810029G,ana.piñeiro@megacloud.online,485584,ES35209577302742069253,6137.07,2023-05-09T09:44:21,Amurrio,expenses,leisure,-72.76,15373.08
buyer_3,Ana,Piñeiro,1989-08-23,25810029G,ana.piñeiro@megacloud.online,485584,ES35209577302742069253,6137.07,2023-05-10T23:59:09,Amurrio,expenses,leisure,-50.75,15322.33
buyer_3,Ana,Piñeiro,1989-08-23,25810029G,ana.piñeiro@megacloud.online,485584,ES35209577302742069253,6137.07,2023-05-11T20:27:06,Amurrio,expenses,food,-73.91,15248.42
buyer_3,Ana,Piñeiro,1989-08-23,25810029G,ana.piñeiro@megacloud.online,485584,ES35209577302742069253,6137.07,2023-05-11T08:07:34,Amurrio,expenses,clothing,-77.32,15171.1
buyer_3,Ana,Piñeiro,1989-08-23,25810029G,ana.piñeiro@megacloud.online,485584,ES35209577302742069253,6137.07,2023-05-11T10:19:39,Amurrio,expenses,cash,-100.0,15071.1
buyer_3,Ana,Piñeiro,1989-08-23,25810029G,ana.piñeiro@megacloud.online,485584,ES35209577302742069253,6137.07,2023-05-11T08:23:33,Amurrio,expenses,gifts,-842.82,14228.28
buyer_3,Ana,Piñeiro,1989-08-23,25810029G,ana.piñeiro@megacloud.online,485584,ES35209577302742069253,6137.07,2023-05-13T11:41:52,Amurrio,expenses,food,-61.66,14166.62
buyer_3,Ana,Piñeiro,1989-08-23,25810029G,ana.piñeiro@megacloud.online,485584,ES35209577302742069253,6137.07,2023-05-13T08:15:05,Amurrio,expenses,leisure,-75.23,14091.39
buyer_3,Ana,Piñeiro,1989-08-23,25810029G,ana.piñeiro@megacloud.online,485584,ES35209577302742069253,6137.07,2023-05-15T15:04:28,Amurrio,expenses,clothing,-78.28,14013.11
buyer_3,Ana,Piñeiro,1989-08-23,25810029G,ana.piñeiro@megacloud.online,485584,ES35209577302742069253,6137.07,2023-05-18T23:37:26,Amurrio,expenses,food,-100.53,13912.58
buyer_3,Ana,Piñeiro,1989-08-23,25810029G,ana.piñeiro@megacloud.online,485584,ES35209577302742069253,6137.07,2023-05-18T16:31:11,Amurrio,expenses,transport,-47.85,13864.73
buyer_3,Ana,Piñeiro,1989-08-23,25810029G,ana.piñeiro@megacloud.online,485584,ES35209577302742069253,6137.07,2023-05-18T10:27:45,Amurrio,expenses,cash,-100.0,13764.73
buyer_3,Ana,Piñeiro,1989-08-23,25810029G,ana.piñeiro@megacloud.online,485584,ES35209577302742069253,6137.07,2023-05-19T12:23:52,Amurrio,expenses,leisure,-56.16,13708.57
buyer_3,Ana,Piñeiro,1989-08-23,25810029G,ana.piñeiro@megacloud.online,485584,ES35209577302742069253,6137.07,2023-05-23T17:48:46,Amurrio,expenses,food,-100.95,13607.62
buyer_3,Ana,Piñeiro,1989-08-23,25810029G,ana.piñeiro@megacloud.online,485584,ES35209577302742069253,6137.07,2023-05-25T20:33:55,Amurrio,expenses,cash,-100.0,13507.62
buyer_3,Ana,Piñeiro,1989-08-23,25810029G,ana.piñeiro@megacloud.online,485584,ES35209577302742069253,6137.07,2023-05-26T18:52:39,Amurrio,expenses,food,-102.68,13404.94
buyer_3,Ana,Piñeiro,1989-08-23,25810029G,ana.piñeiro@megacloud.online,485584,ES35209577302742069253,6137.07,2023-05-26T08:58:06,Amurrio,expenses,travel,-295.71,13109.23
buyer_3,Ana,Piñeiro,1989-08-23,25810029G,ana.piñeiro@megacloud.online,485584,ES35209577302742069253,6137.07,2023-05-29T11:25:21,Amurrio,expenses,education,-52.65,13056.58
buyer_3,Ana,Piñeiro,1989-08-23,25810029G,ana.piñeiro@megacloud.online,485584,ES35209577302742069253,6137.07,2023-05-30T09:44:24,Amurrio,expenses,repairs,-325.4,12731.18
buyer_3,Ana,Piñeiro,1989-08-23,25810029G,ana.piñeiro@megacloud.online,485584,ES35209577302742069253,6137.07,2023-05-31T08:18:33,Amurrio,expenses,food,-88.83,12642.35
buyer_3,Ana,Piñeiro,1989-08-23,25810029G,ana.piñeiro@megacloud.online,485584,ES35209577302742069253,6137.07,2023-05-31T19:09:07,Amurrio,expenses,transport,-57.66,12584.69
buyer_3,Ana,Piñeiro,1989-08-23,25810029G,ana.piñeiro@megacloud.online,485584,ES35209577302742069253,6137.07,2023-05-31T18:53:10,Amurrio,expenses,gifts,-628.38,11956.31
buyer_3,Ana,Piñeiro,1989-08-23,25810029G,ana.piñeiro@megacloud.online,485584,ES35209577302742069253,6137.07,2023-06-01T17:31:49,Amurrio,incomes,salary,3224.67,15180.98
buyer_3,Ana,Piñeiro,1989-08-23,25810029G,ana.piñeiro@megacloud.online,485584,ES35209577302742069253,6137.07,2023-06-01T17:31:49,Amurrio,incomes,salary_partner,3537.83,18718.81
buyer_3,Ana,Piñeiro,1989-08-23,25810029G,ana.piñeiro@megacloud.online,485584,ES35209577302742069253,6137.07,2023-06-01T17:31:49,Amurrio,incomes,salary_bonus,2527.64,21246.45
buyer_3,Ana,Piñeiro,1989-08-23,25810029G,ana.piñeiro@megacloud.online,485584,ES35209577302742069253,6137.07,2023-06-01T17:31:49,Amurrio,incomes,salary_partner_bonus,2811.12,24057.57
buyer_3,Ana,Piñeiro,1989-08-23,25810029G,ana.piñeiro@megacloud.online,485584,ES35209577302742069253,6137.07,2023-06-01T16:04:21,Amurrio,expenses,food,-97.12,23960.45
buyer_3,Ana,Piñeiro,1989-08-23,25810029G,ana.piñeiro@megacloud.online,485584,ES35209577302742069253,6137.07,2023-06-01T10:51:16,Amurrio,expenses,gifts,-383.06,23577.39
buyer_3,Ana,Piñeiro,1989-08-23,25810029G,ana.piñeiro@megacloud.online,485584,ES35209577302742069253,6137.07,2023-06-02T13:11:14,Amurrio,expenses,appliances,-163.65,23413.74
buyer_3,Ana,Piñeiro,1989-08-23,25810029G,ana.piñeiro@megacloud.online,485584,ES35209577302742069253,6137.07,2023-06-04T08:36:15,Amurrio,expenses,mortgage,-2545.84,20867.9
buyer_3,Ana,Piñeiro,1989-08-23,25810029G,ana.piñeiro@megacloud.online,485584,ES35209577302742069253,6137.07,2023-06-04T20:17:28,Amurrio,expenses,food,-124.19,20743.71
buyer_3,Ana,Piñeiro,1989-08-23,25810029G,ana.piñeiro@megacloud.online,485584,ES35209577302742069253,6137.07,2023-06-04T12:31:48,Amurrio,expenses,gifts,-232.34,20511.37
buyer_3,Ana,Piñeiro,1989-08-23,25810029G,ana.piñeiro@megacloud.online,485584,ES35209577302742069253,6137.07,2023-06-05T18:45:03,Amurrio,expenses,clothing,-58.86,20452.51
buyer_3,Ana,Piñeiro,1989-08-23,25810029G,ana.piñeiro@megacloud.online,485584,ES35209577302742069253,6137.07,2023-06-06T14:36:08,Amurrio,expenses,water,-78.59,20373.92
buyer_3,Ana,Piñeiro,1989-08-23,25810029G,ana.piñeiro@megacloud.online,485584,ES35209577302742069253,6137.07,2023-06-06T09:35:38,Amurrio,expenses,gas,-341.29,20032.63
buyer_3,Ana,Piñeiro,1989-08-23,25810029G,ana.piñeiro@megacloud.online,485584,ES35209577302742069253,6137.07,2023-06-07T13:30:58,Amurrio,expenses,electricity,-106.16,19926.47
buyer_3,Ana,Piñeiro,1989-08-23,25810029G,ana.piñeiro@megacloud.online,485584,ES35209577302742069253,6137.07,2023-06-07T16:07:46,Amurrio,expenses,internet,-142.01,19784.46
buyer_3,Ana,Piñeiro,1989-08-23,25810029G,ana.piñeiro@megacloud.online,485584,ES35209577302742069253,6137.07,2023-06-07T07:33:24,Amurrio,expenses,leisure,-31.64,19752.82
buyer_3,Ana,Piñeiro,1989-08-23,25810029G,ana.piñeiro@megacloud.online,485584,ES35209577302742069253,6137.07,2023-06-08T10:46:07,Amurrio,expenses,phone,-116.73,19636.09
buyer_3,Ana,Piñeiro,1989-08-23,25810029G,ana.piñeiro@megacloud.online,485584,ES35209577302742069253,6137.07,2023-06-08T11:21:53,Amurrio,expenses,clothing,-52.1,19583.99
buyer_3,Ana,Piñeiro,1989-08-23,25810029G,ana.piñeiro@megacloud.online,485584,ES35209577302742069253,6137.07,2023-06-08T10:27:53,Amurrio,expenses,cash,-100.0,19483.99
buyer_3,Ana,Piñeiro,1989-08-23,25810029G,ana.piñeiro@megacloud.online,485584,ES35209577302742069253,6137.07,2023-06-09T19:53:28,Amurrio,expenses,healthcare,-128.54,19355.45
buyer_3,Ana,Piñeiro,1989-08-23,25810029G,ana.piñeiro@megacloud.online,485584,ES35209577302742069253,6137.07,2023-06-11T11:25:57,Amurrio,expenses,transport,-69.21,19286.24
buyer_3,Ana,Piñeiro,1989-08-23,25810029G,ana.piñeiro@megacloud.online,485584,ES35209577302742069253,6137.07,2023-06-12T19:28:24,Amurrio,expenses,clothing,-84.88,19201.36
buyer_3,Ana,Piñeiro,1989-08-23,25810029G,ana.piñeiro@megacloud.online,485584,ES35209577302742069253,6137.07,2023-06-12T03:47:00,Amurrio,expenses,cash,-100.0,19101.36
buyer_3,Ana,Piñeiro,1989-08-23,25810029G,ana.piñeiro@megacloud.online,485584,ES35209577302742069253,6137.07,2023-06-13T19:48:09,Amurrio,expenses,food,-110.43,18990.93
buyer_3,Ana,Piñeiro,1989-08-23,25810029G,ana.piñeiro@megacloud.online,485584,ES35209577302742069253,6137.07,2023-06-13T20:32:42,Amurrio,expenses,cash,-100.0,18890.93
buyer_3,Ana,Piñeiro,1989-08-23,25810029G,ana.piñeiro@megacloud.online,485584,ES35209577302742069253,6137.07,2023-06-14T11:51:09,Amurrio,expenses,cash,-100.0,18790.93
buyer_3,Ana,Piñeiro,1989-08-23,25810029G,ana.piñeiro@megacloud.online,485584,ES35209577302742069253,6137.07,2023-06-17T09:25:35,Amurrio,expenses,healthcare,-157.06,18633.87
buyer_3,Ana,Piñeiro,1989-08-23,25810029G,ana.piñeiro@megacloud.online,485584,ES35209577302742069253,6137.07,2023-06-17T20:00:31,Amurrio,expenses,cash,-100.0,18533.87
buyer_3,Ana,Piñeiro,1989-08-23,25810029G,ana.piñeiro@megacloud.online,485584,ES35209577302742069253,6137.07,2023-06-18T17:50:11,Amurrio,expenses,food,-78.8,18455.07
buyer_3,Ana,Piñeiro,1989-08-23,25810029G,ana.piñeiro@megacloud.online,485584,ES35209577302742069253,6137.07,2023-06-18T19:44:12,Amurrio,expenses,healthcare,-47.84,18407.23
buyer_3,Ana,Piñeiro,1989-08-23,25810029G,ana.piñeiro@megacloud.online,485584,ES35209577302742069253,6137.07,2023-06-18T11:33:00,Amurrio,expenses,travel,-1081.8,17325.43
buyer_3,Ana,Piñeiro,1989-08-23,25810029G,ana.piñeiro@megacloud.online,485584,ES35209577302742069253,6137.07,2023-06-18T19:54:30,Amurrio,expenses,gifts,-160.14,17165.29
buyer_3,Ana,Piñeiro,1989-08-23,25810029G,ana.piñeiro@megacloud.online,485584,ES35209577302742069253,6137.07,2023-06-21T08:56:18,Amurrio,expenses,food,-113.56,17051.73
buyer_3,Ana,Piñeiro,1989-08-23,25810029G,ana.piñeiro@megacloud.online,485584,ES35209577302742069253,6137.07,2023-06-22T11:22:28,Amurrio,expenses,gifts,-360.3,16691.43
buyer_3,Ana,Piñeiro,1989-08-23,25810029G,ana.piñeiro@megacloud.online,485584,ES35209577302742069253,6137.07,2023-06-23T22:47:41,Amurrio,expenses,cash,-100.0,16591.43
buyer_3,Ana,Piñeiro,1989-08-23,25810029G,ana.piñeiro@megacloud.online,485584,ES35209577302742069253,6137.07,2023-06-23T18:34:34,Amurrio,expenses,repairs,-71.14,16520.29
buyer_3,Ana,Piñeiro,1989-08-23,25810029G,ana.piñeiro@megacloud.online,485584,ES35209577302742069253,6137.07,2023-06-24T09:13:46,Amurrio,expenses,gifts,-260.11,16260.18
buyer_3,Ana,Piñeiro,1989-08-23,25810029G,ana.piñeiro@megacloud.online,485584,ES35209577302742069253,6137.07,2023-06-25T18:16:20,Amurrio,expenses,leisure,-41.13,16219.05
buyer_3,Ana,Piñeiro,1989-08-23,25810029G,ana.piñeiro@megacloud.online,485584,ES35209577302742069253,6137.07,2023-06-26T20:39:39,Amurrio,expenses,food,-115.55,16103.5
buyer_3,Ana,Piñeiro,1989-08-23,25810029G,ana.piñeiro@megacloud.online,485584,ES35209577302742069253,6137.07,2023-06-27T17:23:15,Amurrio,expenses,transport,-40.12,16063.38
buyer_3,Ana,Piñeiro,1989-08-23,25810029G,ana.piñeiro@megacloud.online,485584,ES35209577302742069253,6137.07,2023-06-28T15:28:02,Amurrio,expenses,repairs,-68.85,15994.53
buyer_3,Ana,Piñeiro,1989-08-23,25810029G,ana.piñeiro@megacloud.online,485584,ES35209577302742069253,6137.07,2023-06-29T12:02:51,Amurrio,expenses,transport,-79.57,15914.96
buyer_3,Ana,Piñeiro,1989-08-23,25810029G,ana.piñeiro@megacloud.online,485584,ES35209577302742069253,6137.07,2023-06-30T11:23:13,Amurrio,expenses,food,-73.24,15841.72
buyer_3,Ana,Piñeiro,1989-08-23,25810029G,ana.piñeiro@megacloud.online,485584,ES35209577302742069253,6137.07,2023-07-01T15:10:41,Amurrio,incomes,salary,3224.67,19066.39
buyer_3,Ana,Piñeiro,1989-08-23,25810029G,ana.piñeiro@megacloud.online,485584,ES35209577302742069253,6137.07,2023-07-01T15:10:41,Amurrio,incomes,salary_partner,3537.83,22604.22
buyer_3,Ana,Piñeiro,1989-08-23,25810029G,ana.piñeiro@megacloud.online,485584,ES35209577302742069253,6137.07,2023-07-04T19:19:03,Amurrio,expenses,mortgage,-2545.84,20058.38
buyer_3,Ana,Piñeiro,1989-08-23,25810029G,ana.piñeiro@megacloud.online,485584,ES35209577302742069253,6137.07,2023-07-05T16:58:37,Amurrio,expenses,water,-115.94,19942.44
buyer_3,Ana,Piñeiro,1989-08-23,25810029G,ana.piñeiro@megacloud.online,485584,ES35209577302742069253,6137.07,2023-07-06T11:54:03,Amurrio,expenses,internet,-142.01,19800.43
buyer_3,Ana,Piñeiro,1989-08-23,25810029G,ana.piñeiro@megacloud.online,485584,ES35209577302742069253,6137.07,2023-07-06T20:17:33,Amurrio,expenses,phone,-104.56,19695.87
buyer_3,Ana,Piñeiro,1989-08-23,25810029G,ana.piñeiro@megacloud.online,485584,ES35209577302742069253,6137.07,2023-07-07T13:40:33,Amurrio,expenses,electricity,-265.18,19430.69
buyer_3,Ana,Piñeiro,1989-08-23,25810029G,ana.piñeiro@megacloud.online,485584,ES35209577302742069253,6137.07,2023-07-07T18:41:09,Amurrio,expenses,transport,-62.12,19368.57
buyer_3,Ana,Piñeiro,1989-08-23,25810029G,ana.piñeiro@megacloud.online,485584,ES35209577302742069253,6137.07,2023-07-07T20:21:35,Amurrio,expenses,education,-76.41,19292.16
buyer_3,Ana,Piñeiro,1989-08-23,25810029G,ana.piñeiro@megacloud.online,485584,ES35209577302742069253,6137.07,2023-07-07T18:03:39,Amurrio,expenses,gifts,-425.73,18866.43
buyer_3,Ana,Piñeiro,1989-08-23,25810029G,ana.piñeiro@megacloud.online,485584,ES35209577302742069253,6137.07,2023-07-08T17:55:18,Amurrio,expenses,gas,-330.97,18535.46
buyer_3,Ana,Piñeiro,1989-08-23,25810029G,ana.piñeiro@megacloud.online,485584,ES35209577302742069253,6137.07,2023-07-10T12:04:32,Amurrio,expenses,food,-79.7,18455.76
buyer_3,Ana,Piñeiro,1989-08-23,25810029G,ana.piñeiro@megacloud.online,485584,ES35209577302742069253,6137.07,2023-07-12T15:40:25,Amurrio,expenses,cash,-100.0,18355.76
buyer_3,Ana,Piñeiro,1989-08-23,25810029G,ana.piñeiro@megacloud.online,485584,ES35209577302742069253,6137.07,2023-07-12T21:09:28,Amurrio,expenses,repairs,-286.81,18068.95
buyer_3,Ana,Piñeiro,1989-08-23,25810029G,ana.piñeiro@megacloud.online,485584,ES35209577302742069253,6137.07,2023-07-13T18:50:12,Amurrio,expenses,education,-66.05,18002.9
buyer_3,Ana,Piñeiro,1989-08-23,25810029G,ana.piñeiro@megacloud.online,485584,ES35209577302742069253,6137.07,2023-07-14T22:01:23,Amurrio,expenses,transport,-61.65,17941.25
buyer_3,Ana,Piñeiro,1989-08-23,25810029G,ana.piñeiro@megacloud.online,485584,ES35209577302742069253,6137.07,2023-07-14T09:53:56,Amurrio,expenses,clothing,-159.81,17781.44
buyer_3,Ana,Piñeiro,1989-08-23,25810029G,ana.piñeiro@megacloud.online,485584,ES35209577302742069253,6137.07,2023-07-14T02:46:03,Amurrio,expenses,repairs,-204.92,17576.52
buyer_3,Ana,Piñeiro,1989-08-23,25810029G,ana.piñeiro@megacloud.online,485584,ES35209577302742069253,6137.07,2023-07-17T11:14:21,Amurrio,expenses,repairs,-228.94,17347.58
buyer_3,Ana,Piñeiro,1989-08-23,25810029G,ana.piñeiro@megacloud.online,485584,ES35209577302742069253,6137.07,2023-07-18T14:47:39,Amurrio,expenses,leisure,-22.38,17325.2
buyer_3,Ana,Piñeiro,1989-08-23,25810029G,ana.piñeiro@megacloud.online,485584,ES35209577302742069253,6137.07,2023-07-19T21:43:17,Amurrio,expenses,food,-95.46,17229.74
buyer_3,Ana,Piñeiro,1989-08-23,25810029G,ana.piñeiro@megacloud.online,485584,ES35209577302742069253,6137.07,2023-07-20T12:19:21,Amurrio,expenses,food,-99.43,17130.31
buyer_3,Ana,Piñeiro,1989-08-23,25810029G,ana.piñeiro@megacloud.online,485584,ES35209577302742069253,6137.07,2023-07-20T16:51:16,Amurrio,expenses,leisure,-52.19,17078.12
buyer_3,Ana,Piñeiro,1989-08-23,25810029G,ana.piñeiro@megacloud.online,485584,ES35209577302742069253,6137.07,2023-07-20T14:29:12,Amurrio,expenses,cash,-100.0,16978.12
buyer_3,Ana,Piñeiro,1989-08-23,25810029G,ana.piñeiro@megacloud.online,485584,ES35209577302742069253,6137.07,2023-07-20T19:33:08,Amurrio,expenses,gifts,-848.75,16129.37
buyer_3,Ana,Piñeiro,1989-08-23,25810029G,ana.piñeiro@megacloud.online,485584,ES35209577302742069253,6137.07,2023-07-21T15:49:49,Amurrio,expenses,leisure,-61.35,16068.02
buyer_3,Ana,Piñeiro,1989-08-23,25810029G,ana.piñeiro@megacloud.online,485584,ES35209577302742069253,6137.07,2023-07-24T09:48:39,Amurrio,expenses,food,-78.0,15990.02
buyer_3,Ana,Piñeiro,1989-08-23,25810029G,ana.piñeiro@megacloud.online,485584,ES35209577302742069253,6137.07,2023-07-25T15:56:44,Amurrio,expenses,cash,-100.0,15890.02
buyer_3,Ana,Piñeiro,1989-08-23,25810029G,ana.piñeiro@megacloud.online,485584,ES35209577302742069253,6137.07,2023-07-28T01:24:15,Amurrio,expenses,education,-57.2,15832.82
buyer_3,Ana,Piñeiro,1989-08-23,25810029G,ana.piñeiro@megacloud.online,485584,ES35209577302742069253,6137.07,2023-07-29T14:06:19,Amurrio,expenses,food,-122.54,15710.28
buyer_3,Ana,Piñeiro,1989-08-23,25810029G,ana.piñeiro@megacloud.online,485584,ES35209577302742069253,6137.07,2023-07-29T13:35:46,Amurrio,expenses,leisure,-71.05,15639.23
buyer_3,Ana,Piñeiro,1989-08-23,25810029G,ana.piñeiro@megacloud.online,485584,ES35209577302742069253,6137.07,2023-07-30T01:34:51,Amurrio,expenses,food,-77.74,15561.49
buyer_3,Ana,Piñeiro,1989-08-23,25810029G,ana.piñeiro@megacloud.online,485584,ES35209577302742069253,6137.07,2023-07-30T21:51:56,Amurrio,expenses,leisure,-51.09,15510.4
buyer_3,Ana,Piñeiro,1989-08-23,25810029G,ana.piñeiro@megacloud.online,485584,ES35209577302742069253,6137.07,2023-07-31T00:35:38,Amurrio,expenses,food,-110.11,15400.29
buyer_3,Ana,Piñeiro,1989-08-23,25810029G,ana.piñeiro@megacloud.online,485584,ES35209577302742069253,6137.07,2023-08-01T18:44:42,Amurrio,incomes,salary,3224.67,18624.96
buyer_3,Ana,Piñeiro,1989-08-23,25810029G,ana.piñeiro@megacloud.online,485584,ES35209577302742069253,6137.07,2023-08-01T18:44:42,Amurrio,incomes,salary_partner,3537.83,22162.79
buyer_3,Ana,Piñeiro,1989-08-23,25810029G,ana.piñeiro@megacloud.online,485584,ES35209577302742069253,6137.07,2023-08-01T18:44:42,Amurrio,incomes,extra_income,379.94,22542.73
buyer_3,Ana,Piñeiro,1989-08-23,25810029G,ana.piñeiro@megacloud.online,485584,ES35209577302742069253,6137.07,2023-08-03T18:46:26,Amurrio,expenses,food,-76.56,22466.17
buyer_3,Ana,Piñeiro,1989-08-23,25810029G,ana.piñeiro@megacloud.online,485584,ES35209577302742069253,6137.07,2023-08-03T19:17:16,Amurrio,expenses,repairs,-32.38,22433.79
buyer_3,Ana,Piñeiro,1989-08-23,25810029G,ana.piñeiro@megacloud.online,485584,ES35209577302742069253,6137.07,2023-08-04T14:19:39,Amurrio,expenses,mortgage,-2545.84,19887.95
buyer_3,Ana,Piñeiro,1989-08-23,25810029G,ana.piñeiro@megacloud.online,485584,ES35209577302742069253,6137.07,2023-08-04T02:04:01,Amurrio,expenses,food,-124.3,19763.65
buyer_3,Ana,Piñeiro,1989-08-23,25810029G,ana.piñeiro@megacloud.online,485584,ES35209577302742069253,6137.07,2023-08-05T20:08:08,Amurrio,expenses,electricity,-278.15,19485.5
buyer_3,Ana,Piñeiro,1989-08-23,25810029G,ana.piñeiro@megacloud.online,485584,ES35209577302742069253,6137.07,2023-08-05T15:37:03,Amurrio,expenses,gas,-286.65,19198.85
buyer_3,Ana,Piñeiro,1989-08-23,25810029G,ana.piñeiro@megacloud.online,485584,ES35209577302742069253,6137.07,2023-08-05T20:44:00,Amurrio,expenses,phone,-146.3,19052.55
buyer_3,Ana,Piñeiro,1989-08-23,25810029G,ana.piñeiro@megacloud.online,485584,ES35209577302742069253,6137.07,2023-08-06T16:07:52,Amurrio,expenses,cash,-100.0,18952.55
buyer_3,Ana,Piñeiro,1989-08-23,25810029G,ana.piñeiro@megacloud.online,485584,ES35209577302742069253,6137.07,2023-08-08T16:38:08,Amurrio,expenses,water,-91.77,18860.78
buyer_3,Ana,Piñeiro,1989-08-23,25810029G,ana.piñeiro@megacloud.online,485584,ES35209577302742069253,6137.07,2023-08-08T18:33:48,Amurrio,expenses,internet,-142.01,18718.77
buyer_3,Ana,Piñeiro,1989-08-23,25810029G,ana.piñeiro@megacloud.online,485584,ES35209577302742069253,6137.07,2023-08-11T04:01:11,Amurrio,expenses,transport,-89.87,18628.9
buyer_3,Ana,Piñeiro,1989-08-23,25810029G,ana.piñeiro@megacloud.online,485584,ES35209577302742069253,6137.07,2023-08-11T19:11:02,Amurrio,expenses,clothing,-114.55,18514.35
buyer_3,Ana,Piñeiro,1989-08-23,25810029G,ana.piñeiro@megacloud.online,485584,ES35209577302742069253,6137.07,2023-08-12T13:56:11,Amurrio,expenses,leisure,-24.13,18490.22
buyer_3,Ana,Piñeiro,1989-08-23,25810029G,ana.piñeiro@megacloud.online,485584,ES35209577302742069253,6137.07,2023-08-13T17:44:51,Amurrio,expenses,leisure,-25.13,18465.09
buyer_3,Ana,Piñeiro,1989-08-23,25810029G,ana.piñeiro@megacloud.online,485584,ES35209577302742069253,6137.07,2023-08-13T17:03:17,Amurrio,expenses,cash,-100.0,18365.09
buyer_3,Ana,Piñeiro,1989-08-23,25810029G,ana.piñeiro@megacloud.online,485584,ES35209577302742069253,6137.07,2023-08-14T12:25:02,Amurrio,expenses,education,-67.38,18297.71
buyer_3,Ana,Piñeiro,1989-08-23,25810029G,ana.piñeiro@megacloud.online,485584,ES35209577302742069253,6137.07,2023-08-14T10:33:56,Amurrio,expenses,appliances,-401.81,17895.9
buyer_3,Ana,Piñeiro,1989-08-23,25810029G,ana.piñeiro@megacloud.online,485584,ES35209577302742069253,6137.07,2023-08-14T14:01:44,Amurrio,expenses,gifts,-800.63,17095.27
buyer_3,Ana,Piñeiro,1989-08-23,25810029G,ana.piñeiro@megacloud.online,485584,ES35209577302742069253,6137.07,2023-08-15T08:05:31,Amurrio,expenses,clothing,-129.35,16965.92
buyer_3,Ana,Piñeiro,1989-08-23,25810029G,ana.piñeiro@megacloud.online,485584,ES35209577302742069253,6137.07,2023-08-17T16:58:35,Amurrio,expenses,cash,-100.0,16865.92
buyer_3,Ana,Piñeiro,1989-08-23,25810029G,ana.piñeiro@megacloud.online,485584,ES35209577302742069253,6137.07,2023-08-17T11:17:03,Amurrio,expenses,travel,-509.55,16356.37
buyer_3,Ana,Piñeiro,1989-08-23,25810029G,ana.piñeiro@megacloud.online,485584,ES35209577302742069253,6137.07,2023-08-18T11:19:09,Amurrio,expenses,clothing,-149.68,16206.69
buyer_3,Ana,Piñeiro,1989-08-23,25810029G,ana.piñeiro@megacloud.online,485584,ES35209577302742069253,6137.07,2023-08-18T16:59:28,Amurrio,expenses,gifts,-840.8,15365.89
buyer_3,Ana,Piñeiro,1989-08-23,25810029G,ana.piñeiro@megacloud.online,485584,ES35209577302742069253,6137.07,2023-08-20T10:26:46,Amurrio,expenses,repairs,-256.69,15109.2
buyer_3,Ana,Piñeiro,1989-08-23,25810029G,ana.piñeiro@megacloud.online,485584,ES35209577302742069253,6137.07,2023-08-21T19:27:19,Amurrio,expenses,food,-64.5,15044.7
buyer_3,Ana,Piñeiro,1989-08-23,25810029G,ana.piñeiro@megacloud.online,485584,ES35209577302742069253,6137.07,2023-08-23T09:23:06,Amurrio,expenses,food,-112.64,14932.06
buyer_3,Ana,Piñeiro,1989-08-23,25810029G,ana.piñeiro@megacloud.online,485584,ES35209577302742069253,6137.07,2023-08-25T10:23:14,Amurrio,expenses,leisure,-69.55,14862.51
buyer_3,Ana,Piñeiro,1989-08-23,25810029G,ana.piñeiro@megacloud.online,485584,ES35209577302742069253,6137.07,2023-08-29T08:17:38,Amurrio,expenses,leisure,-75.8,14786.71
buyer_3,Ana,Piñeiro,1989-08-23,25810029G,ana.piñeiro@megacloud.online,485584,ES35209577302742069253,6137.07,2023-08-31T09:30:05,Amurrio,expenses,cash,-100.0,14686.71
buyer_3,Ana,Piñeiro,1989-08-23,25810029G,ana.piñeiro@megacloud.online,485584,ES35209577302742069253,6137.07,2023-09-01T20:18:38,Amurrio,incomes,salary,3224.67,17911.38
buyer_3,Ana,Piñeiro,1989-08-23,25810029G,ana.piñeiro@megacloud.online,485584,ES35209577302742069253,6137.07,2023-09-01T20:18:38,Amurrio,incomes,salary_partner,3537.83,21449.21
buyer_3,Ana,Piñeiro,1989-08-23,25810029G,ana.piñeiro@megacloud.online,485584,ES35209577302742069253,6137.07,2023-09-02T23:26:09,Amurrio,expenses,clothing,-112.67,21336.54
buyer_3,Ana,Piñeiro,1989-08-23,25810029G,ana.piñeiro@megacloud.online,485584,ES35209577302742069253,6137.07,2023-09-02T15:56:34,Amurrio,expenses,cash,-100.0,21236.54
buyer_3,Ana,Piñeiro,1989-08-23,25810029G,ana.piñeiro@megacloud.online,485584,ES35209577302742069253,6137.07,2023-09-03T02:44:16,Amurrio,expenses,cash,-100.0,21136.54
buyer_3,Ana,Piñeiro,1989-08-23,25810029G,ana.piñeiro@megacloud.online,485584,ES35209577302742069253,6137.07,2023-09-04T14:40:23,Amurrio,expenses,mortgage,-2545.84,18590.7
buyer_3,Ana,Piñeiro,1989-08-23,25810029G,ana.piñeiro@megacloud.online,485584,ES35209577302742069253,6137.07,2023-09-04T17:36:20,Amurrio,expenses,food,-78.92,18511.78
buyer_3,Ana,Piñeiro,1989-08-23,25810029G,ana.piñeiro@megacloud.online,485584,ES35209577302742069253,6137.07,2023-09-04T08:50:22,Amurrio,expenses,appliances,-238.34,18273.44
buyer_3,Ana,Piñeiro,1989-08-23,25810029G,ana.piñeiro@megacloud.online,485584,ES35209577302742069253,6137.07,2023-09-05T08:30:17,Amurrio,expenses,food,-84.85,18188.59
buyer_3,Ana,Piñeiro,1989-08-23,25810029G,ana.piñeiro@megacloud.online,485584,ES35209577302742069253,6137.07,2023-09-06T14:24:10,Amurrio,expenses,electricity,-210.69,17977.9
buyer_3,Ana,Piñeiro,1989-08-23,25810029G,ana.piñeiro@megacloud.online,485584,ES35209577302742069253,6137.07,2023-09-06T14:24:04,Amurrio,expenses,leisure,-64.17,17913.73
buyer_3,Ana,Piñeiro,1989-08-23,25810029G,ana.piñeiro@megacloud.online,485584,ES35209577302742069253,6137.07,2023-09-07T17:51:17,Amurrio,expenses,water,-116.97,17796.76
buyer_3,Ana,Piñeiro,1989-08-23,25810029G,ana.piñeiro@megacloud.online,485584,ES35209577302742069253,6137.07,2023-09-07T08:56:05,Amurrio,expenses,food,-102.76,17694.0
buyer_3,Ana,Piñeiro,1989-08-23,25810029G,ana.piñeiro@megacloud.online,485584,ES35209577302742069253,6137.07,2023-09-07T18:41:17,Amurrio,expenses,cash,-100.0,17594.0
buyer_3,Ana,Piñeiro,1989-08-23,25810029G,ana.piñeiro@megacloud.online,485584,ES35209577302742069253,6137.07,2023-09-08T12:38:21,Amurrio,expenses,gas,-183.98,17410.02
buyer_3,Ana,Piñeiro,1989-08-23,25810029G,ana.piñeiro@megacloud.online,485584,ES35209577302742069253,6137.07,2023-09-08T18:52:20,Amurrio,expenses,phone,-128.61,17281.41
buyer_3,Ana,Piñeiro,1989-08-23,25810029G,ana.piñeiro@megacloud.online,485584,ES35209577302742069253,6137.07,2023-09-08T17:36:32,Amurrio,expenses,internet,-142.01,17139.4
buyer_3,Ana,Piñeiro,1989-08-23,25810029G,ana.piñeiro@megacloud.online,485584,ES35209577302742069253,6137.07,2023-09-08T21:27:29,Amurrio,expenses,leisure,-80.95,17058.45
buyer_3,Ana,Piñeiro,1989-08-23,25810029G,ana.piñeiro@megacloud.online,485584,ES35209577302742069253,6137.07,2023-09-08T19:38:46,Amurrio,expenses,cash,-100.0,16958.45
buyer_3,Ana,Piñeiro,1989-08-23,25810029G,ana.piñeiro@megacloud.online,485584,ES35209577302742069253,6137.07,2023-09-09T12:25:11,Amurrio,expenses,cash,-100.0,16858.45
buyer_3,Ana,Piñeiro,1989-08-23,25810029G,ana.piñeiro@megacloud.online,485584,ES35209577302742069253,6137.07,2023-09-10T14:31:05,Amurrio,expenses,cash,-100.0,16758.45
buyer_3,Ana,Piñeiro,1989-08-23,25810029G,ana.piñeiro@megacloud.online,485584,ES35209577302742069253,6137.07,2023-09-11T17:58:02,Amurrio,expenses,leisure,-19.87,16738.58
buyer_3,Ana,Piñeiro,1989-08-23,25810029G,ana.piñeiro@megacloud.online,485584,ES35209577302742069253,6137.07,2023-09-12T13:29:50,Amurrio,expenses,repairs,-166.02,16572.56
buyer_3,Ana,Piñeiro,1989-08-23,25810029G,ana.piñeiro@megacloud.online,485584,ES35209577302742069253,6137.07,2023-09-13T15:21:29,Amurrio,expenses,food,-71.86,16500.7
buyer_3,Ana,Piñeiro,1989-08-23,25810029G,ana.piñeiro@megacloud.online,485584,ES35209577302742069253,6137.07,2023-09-15T17:27:52,Amurrio,expenses,cash,-100.0,16400.7
buyer_3,Ana,Piñeiro,1989-08-23,25810029G,ana.piñeiro@megacloud.online,485584,ES35209577302742069253,6137.07,2023-09-16T12:44:01,Amurrio,expenses,travel,-367.98,16032.72
buyer_3,Ana,Piñeiro,1989-08-23,25810029G,ana.piñeiro@megacloud.online,485584,ES35209577302742069253,6137.07,2023-09-18T11:39:56,Amurrio,expenses,cash,-100.0,15932.72
buyer_3,Ana,Piñeiro,1989-08-23,25810029G,ana.piñeiro@megacloud.online,485584,ES35209577302742069253,6137.07,2023-09-19T13:14:28,Amurrio,expenses,appliances,-79.17,15853.55
buyer_3,Ana,Piñeiro,1989-08-23,25810029G,ana.piñeiro@megacloud.online,485584,ES35209577302742069253,6137.07,2023-09-21T09:31:03,Amurrio,expenses,leisure,-58.58,15794.97
buyer_3,Ana,Piñeiro,1989-08-23,25810029G,ana.piñeiro@megacloud.online,485584,ES35209577302742069253,6137.07,2023-09-21T21:58:44,Amurrio,expenses,clothing,-113.55,15681.42
buyer_3,Ana,Piñeiro,1989-08-23,25810029G,ana.piñeiro@megacloud.online,485584,ES35209577302742069253,6137.07,2023-09-21T19:17:40,Amurrio,expenses,gifts,-143.18,15538.24
buyer_3,Ana,Piñeiro,1989-08-23,25810029G,ana.piñeiro@megacloud.online,485584,ES35209577302742069253,6137.07,2023-09-23T09:36:09,Amurrio,expenses,cash,-100.0,15438.24
buyer_3,Ana,Piñeiro,1989-08-23,25810029G,ana.piñeiro@megacloud.online,485584,ES35209577302742069253,6137.07,2023-09-25T16:22:08,Amurrio,expenses,transport,-59.02,15379.22
buyer_3,Ana,Piñeiro,1989-08-23,25810029G,ana.piñeiro@megacloud.online,485584,ES35209577302742069253,6137.07,2023-09-27T14:24:17,Amurrio,expenses,cash,-100.0,15279.22
buyer_3,Ana,Piñeiro,1989-08-23,25810029G,ana.piñeiro@megacloud.online,485584,ES35209577302742069253,6137.07,2023-10-01T02:32:35,Amurrio,incomes,salary,3224.67,18503.89
buyer_3,Ana,Piñeiro,1989-08-23,25810029G,ana.piñeiro@megacloud.online,485584,ES35209577302742069253,6137.07,2023-10-01T02:32:35,Amurrio,incomes,salary_partner,3537.83,22041.72
buyer_3,Ana,Piñeiro,1989-08-23,25810029G,ana.piñeiro@megacloud.online,485584,ES35209577302742069253,6137.07,2023-10-01T17:33:56,Amurrio,expenses,food,-90.53,21951.19
buyer_3,Ana,Piñeiro,1989-08-23,25810029G,ana.piñeiro@megacloud.online,485584,ES35209577302742069253,6137.07,2023-10-01T19:30:43,Amurrio,expenses,gifts,-167.63,21783.56
buyer_3,Ana,Piñeiro,1989-08-23,25810029G,ana.piñeiro@megacloud.online,485584,ES35209577302742069253,6137.07,2023-10-02T17:56:49,Amurrio,expenses,food,-109.96,21673.6
buyer_3,Ana,Piñeiro,1989-08-23,25810029G,ana.piñeiro@megacloud.online,485584,ES35209577302742069253,6137.07,2023-10-04T12:14:40,Amurrio,expenses,mortgage,-2545.84,19127.76
buyer_3,Ana,Piñeiro,1989-08-23,25810029G,ana.piñeiro@megacloud.online,485584,ES35209577302742069253,6137.07,2023-10-04T17:14:52,Amurrio,expenses,food,-96.38,19031.38
buyer_3,Ana,Piñeiro,1989-08-23,25810029G,ana.piñeiro@megacloud.online,485584,ES35209577302742069253,6137.07,2023-10-04T21:46:23,Amurrio,expenses,transport,-53.59,18977.79
buyer_3,Ana,Piñeiro,1989-08-23,25810029G,ana.piñeiro@megacloud.online,485584,ES35209577302742069253,6137.07,2023-10-04T15:46:45,Amurrio,expenses,cash,-100.0,18877.79
buyer_3,Ana,Piñeiro,1989-08-23,25810029G,ana.piñeiro@megacloud.online,485584,ES35209577302742069253,6137.07,2023-10-04T08:22:07,Amurrio,expenses,repairs,-277.39,18600.4
buyer_3,Ana,Piñeiro,1989-08-23,25810029G,ana.piñeiro@megacloud.online,485584,ES35209577302742069253,6137.07,2023-10-06T15:51:51,Amurrio,expenses,water,-77.04,18523.36
buyer_3,Ana,Piñeiro,1989-08-23,25810029G,ana.piñeiro@megacloud.online,485584,ES35209577302742069253,6137.07,2023-10-06T13:14:26,Amurrio,expenses,electricity,-254.61,18268.75
buyer_3,Ana,Piñeiro,1989-08-23,25810029G,ana.piñeiro@megacloud.online,485584,ES35209577302742069253,6137.07,2023-10-07T08:40:51,Amurrio,expenses,gas,-255.06,18013.69
buyer_3,Ana,Piñeiro,1989-08-23,25810029G,ana.piñeiro@megacloud.online,485584,ES35209577302742069253,6137.07,2023-10-08T18:34:58,Amurrio,expenses,internet,-142.01,17871.68
buyer_3,Ana,Piñeiro,1989-08-23,25810029G,ana.piñeiro@megacloud.online,485584,ES35209577302742069253,6137.07,2023-10-08T20:52:55,Amurrio,expenses,phone,-131.17,17740.51
buyer_3,Ana,Piñeiro,1989-08-23,25810029G,ana.piñeiro@megacloud.online,485584,ES35209577302742069253,6137.07,2023-10-08T22:35:38,Amurrio,expenses,travel,-457.32,17283.19
buyer_3,Ana,Piñeiro,1989-08-23,25810029G,ana.piñeiro@megacloud.online,485584,ES35209577302742069253,6137.07,2023-10-09T06:11:45,Amurrio,expenses,education,-55.76,17227.43
buyer_3,Ana,Piñeiro,1989-08-23,25810029G,ana.piñeiro@megacloud.online,485584,ES35209577302742069253,6137.07,2023-10-09T09:40:37,Amurrio,expenses,cash,-100.0,17127.43
buyer_3,Ana,Piñeiro,1989-08-23,25810029G,ana.piñeiro@megacloud.online,485584,ES35209577302742069253,6137.07,2023-10-10T05:13:03,Amurrio,expenses,food,-60.93,17066.5
buyer_3,Ana,Piñeiro,1989-08-23,25810029G,ana.piñeiro@megacloud.online,485584,ES35209577302742069253,6137.07,2023-10-13T19:22:37,Amurrio,expenses,leisure,-83.15,16983.35
buyer_3,Ana,Piñeiro,1989-08-23,25810029G,ana.piñeiro@megacloud.online,485584,ES35209577302742069253,6137.07,2023-10-13T17:51:07,Amurrio,expenses,cash,-100.0,16883.35
buyer_3,Ana,Piñeiro,1989-08-23,25810029G,ana.piñeiro@megacloud.online,485584,ES35209577302742069253,6137.07,2023-10-18T16:19:00,Amurrio,expenses,food,-82.73,16800.62
buyer_3,Ana,Piñeiro,1989-08-23,25810029G,ana.piñeiro@megacloud.online,485584,ES35209577302742069253,6137.07,2023-10-19T23:20:46,Amurrio,expenses,food,-80.72,16719.9
buyer_3,Ana,Piñeiro,1989-08-23,25810029G,ana.piñeiro@megacloud.online,485584,ES35209577302742069253,6137.07,2023-10-21T17:53:01,Amurrio,expenses,gifts,-248.57,16471.33
buyer_3,Ana,Piñeiro,1989-08-23,25810029G,ana.piñeiro@megacloud.online,485584,ES35209577302742069253,6137.07,2023-10-23T18:50:00,Amurrio,expenses,cash,-100.0,16371.33
buyer_3,Ana,Piñeiro,1989-08-23,25810029G,ana.piñeiro@megacloud.online,485584,ES35209577302742069253,6137.07,2023-10-24T03:40:02,Amurrio,expenses,transport,-83.94,16287.39
buyer_3,Ana,Piñeiro,1989-08-23,25810029G,ana.piñeiro@megacloud.online,485584,ES35209577302742069253,6137.07,2023-10-24T04:50:44,Amurrio,expenses,leisure,-27.16,16260.23
buyer_3,Ana,Piñeiro,1989-08-23,25810029G,ana.piñeiro@megacloud.online,485584,ES35209577302742069253,6137.07,2023-10-25T14:53:14,Amurrio,expenses,leisure,-73.62,16186.61
buyer_3,Ana,Piñeiro,1989-08-23,25810029G,ana.piñeiro@megacloud.online,485584,ES35209577302742069253,6137.07,2023-10-26T11:06:53,Amurrio,expenses,leisure,-26.76,16159.85
buyer_3,Ana,Piñeiro,1989-08-23,25810029G,ana.piñeiro@megacloud.online,485584,ES35209577302742069253,6137.07,2023-10-31T18:40:16,Amurrio,expenses,food,-106.86,16052.99
buyer_3,Ana,Piñeiro,1989-08-23,25810029G,ana.piñeiro@megacloud.online,485584,ES35209577302742069253,6137.07,2023-11-01T08:53:05,Amurrio,incomes,salary,3224.67,19277.66
buyer_3,Ana,Piñeiro,1989-08-23,25810029G,ana.piñeiro@megacloud.online,485584,ES35209577302742069253,6137.07,2023-11-01T08:53:05,Amurrio,incomes,salary_partner,3537.83,22815.49
buyer_3,Ana,Piñeiro,1989-08-23,25810029G,ana.piñeiro@megacloud.online,485584,ES35209577302742069253,6137.07,2023-11-01T08:53:05,Amurrio,incomes,extra_income,379.94,23195.43
buyer_3,Ana,Piñeiro,1989-08-23,25810029G,ana.piñeiro@megacloud.online,485584,ES35209577302742069253,6137.07,2023-11-02T12:27:46,Amurrio,expenses,car,-534.77,22660.66
buyer_3,Ana,Piñeiro,1989-08-23,25810029G,ana.piñeiro@megacloud.online,485584,ES35209577302742069253,6137.07,2023-11-04T08:07:42,Amurrio,expenses,mortgage,-2545.84,20114.82
buyer_3,Ana,Piñeiro,1989-08-23,25810029G,ana.piñeiro@megacloud.online,485584,ES35209577302742069253,6137.07,2023-11-06T15:56:24,Amurrio,expenses,gas,-217.82,19897.0
buyer_3,Ana,Piñeiro,1989-08-23,25810029G,ana.piñeiro@megacloud.online,485584,ES35209577302742069253,6137.07,2023-11-06T18:30:03,Amurrio,expenses,cash,-100.0,19797.0
buyer_3,Ana,Piñeiro,1989-08-23,25810029G,ana.piñeiro@megacloud.online,485584,ES35209577302742069253,6137.07,2023-11-07T22:51:08,Amurrio,expenses,phone,-148.94,19648.06
buyer_3,Ana,Piñeiro,1989-08-23,25810029G,ana.piñeiro@megacloud.online,485584,ES35209577302742069253,6137.07,2023-11-07T08:09:16,Amurrio,expenses,food,-72.23,19575.83
buyer_3,Ana,Piñeiro,1989-08-23,25810029G,ana.piñeiro@megacloud.online,485584,ES35209577302742069253,6137.07,2023-11-08T09:56:13,Amurrio,expenses,water,-87.74,19488.09
buyer_3,Ana,Piñeiro,1989-08-23,25810029G,ana.piñeiro@megacloud.online,485584,ES35209577302742069253,6137.07,2023-11-08T08:17:41,Amurrio,expenses,electricity,-166.32,19321.77
buyer_3,Ana,Piñeiro,1989-08-23,25810029G,ana.piñeiro@megacloud.online,485584,ES35209577302742069253,6137.07,2023-11-08T12:30:19,Amurrio,expenses,internet,-142.01,19179.76
buyer_3,Ana,Piñeiro,1989-08-23,25810029G,ana.piñeiro@megacloud.online,485584,ES35209577302742069253,6137.07,2023-11-09T10:10:11,Amurrio,expenses,food,-83.32,19096.44
buyer_3,Ana,Piñeiro,1989-08-23,25810029G,ana.piñeiro@megacloud.online,485584,ES35209577302742069253,6137.07,2023-11-09T18:50:00,Amurrio,expenses,cash,-100.0,18996.44
buyer_3,Ana,Piñeiro,1989-08-23,25810029G,ana.piñeiro@megacloud.online,485584,ES35209577302742069253,6137.07,2023-11-10T20:35:01,Amurrio,expenses,repairs,-38.21,18958.23
buyer_3,Ana,Piñeiro,1989-08-23,25810029G,ana.piñeiro@megacloud.online,485584,ES35209577302742069253,6137.07,2023-11-11T15:51:39,Amurrio,expenses,cash,-100.0,18858.23
buyer_3,Ana,Piñeiro,1989-08-23,25810029G,ana.piñeiro@megacloud.online,485584,ES35209577302742069253,6137.07,2023-11-11T13:54:52,Amurrio,expenses,repairs,-208.36,18649.87
buyer_3,Ana,Piñeiro,1989-08-23,25810029G,ana.piñeiro@megacloud.online,485584,ES35209577302742069253,6137.07,2023-11-12T15:17:20,Amurrio,expenses,repairs,-176.18,18473.69
buyer_3,Ana,Piñeiro,1989-08-23,25810029G,ana.piñeiro@megacloud.online,485584,ES35209577302742069253,6137.07,2023-11-13T16:35:20,Amurrio,expenses,cash,-100.0,18373.69
buyer_3,Ana,Piñeiro,1989-08-23,25810029G,ana.piñeiro@megacloud.online,485584,ES35209577302742069253,6137.07,2023-11-14T15:43:47,Amurrio,expenses,clothing,-74.0,18299.69
buyer_3,Ana,Piñeiro,1989-08-23,25810029G,ana.piñeiro@megacloud.online,485584,ES35209577302742069253,6137.07,2023-11-16T13:02:55,Amurrio,expenses,food,-98.94,18200.75
buyer_3,Ana,Piñeiro,1989-08-23,25810029G,ana.piñeiro@megacloud.online,485584,ES35209577302742069253,6137.07,2023-11-16T17:43:24,Amurrio,expenses,leisure,-38.17,18162.58
buyer_3,Ana,Piñeiro,1989-08-23,25810029G,ana.piñeiro@megacloud.online,485584,ES35209577302742069253,6137.07,2023-11-24T19:19:52,Amurrio,expenses,cash,-100.0,18062.58
buyer_3,Ana,Piñeiro,1989-08-23,25810029G,ana.piñeiro@megacloud.online,485584,ES35209577302742069253,6137.07,2023-11-24T19:17:12,Amurrio,expenses,appliances,-136.75,17925.83
buyer_3,Ana,Piñeiro,1989-08-23,25810029G,ana.piñeiro@megacloud.online,485584,ES35209577302742069253,6137.07,2023-11-24T18:37:51,Amurrio,expenses,repairs,-232.84,17692.99
buyer_3,Ana,Piñeiro,1989-08-23,25810029G,ana.piñeiro@megacloud.online,485584,ES35209577302742069253,6137.07,2023-11-27T12:38:14,Amurrio,expenses,transport,-55.06,17637.93
buyer_3,Ana,Piñeiro,1989-08-23,25810029G,ana.piñeiro@megacloud.online,485584,ES35209577302742069253,6137.07,2023-11-27T19:29:19,Amurrio,expenses,clothing,-105.87,17532.06
buyer_3,Ana,Piñeiro,1989-08-23,25810029G,ana.piñeiro@megacloud.online,485584,ES35209577302742069253,6137.07,2023-12-01T15:48:08,Amurrio,incomes,salary,3224.67,20756.73
buyer_3,Ana,Piñeiro,1989-08-23,25810029G,ana.piñeiro@megacloud.online,485584,ES35209577302742069253,6137.07,2023-12-01T15:48:08,Amurrio,incomes,salary_partner,3537.83,24294.56
buyer_3,Ana,Piñeiro,1989-08-23,25810029G,ana.piñeiro@megacloud.online,485584,ES35209577302742069253,6137.07,2023-12-01T15:48:08,Amurrio,incomes,salary_bonus,2551.04,26845.6
buyer_3,Ana,Piñeiro,1989-08-23,25810029G,ana.piñeiro@megacloud.online,485584,ES35209577302742069253,6137.07,2023-12-01T15:48:08,Amurrio,incomes,salary_partner_bonus,2746.18,29591.78
buyer_3,Ana,Piñeiro,1989-08-23,25810029G,ana.piñeiro@megacloud.online,485584,ES35209577302742069253,6137.07,2023-12-04T03:45:07,Amurrio,expenses,mortgage,-2545.84,27045.94
buyer_3,Ana,Piñeiro,1989-08-23,25810029G,ana.piñeiro@megacloud.online,485584,ES35209577302742069253,6137.07,2023-12-04T12:24:09,Amurrio,expenses,transport,-40.9,27005.04
buyer_3,Ana,Piñeiro,1989-08-23,25810029G,ana.piñeiro@megacloud.online,485584,ES35209577302742069253,6137.07,2023-12-04T13:53:21,Amurrio,expenses,clothing,-133.66,26871.38
buyer_3,Ana,Piñeiro,1989-08-23,25810029G,ana.piñeiro@megacloud.online,485584,ES35209577302742069253,6137.07,2023-12-04T19:19:57,Amurrio,expenses,cash,-100.0,26771.38
buyer_3,Ana,Piñeiro,1989-08-23,25810029G,ana.piñeiro@megacloud.online,485584,ES35209577302742069253,6137.07,2023-12-05T14:01:20,Amurrio,expenses,electricity,-220.05,26551.33
buyer_3,Ana,Piñeiro,1989-08-23,25810029G,ana.piñeiro@megacloud.online,485584,ES35209577302742069253,6137.07,2023-12-05T08:08:46,Amurrio,expenses,phone,-121.56,26429.77
buyer_3,Ana,Piñeiro,1989-08-23,25810029G,ana.piñeiro@megacloud.online,485584,ES35209577302742069253,6137.07,2023-12-07T15:03:58,Amurrio,expenses,internet,-142.01,26287.76
buyer_3,Ana,Piñeiro,1989-08-23,25810029G,ana.piñeiro@megacloud.online,485584,ES35209577302742069253,6137.07,2023-12-07T13:09:59,Amurrio,expenses,clothing,-84.48,26203.28
buyer_3,Ana,Piñeiro,1989-08-23,25810029G,ana.piñeiro@megacloud.online,485584,ES35209577302742069253,6137.07,2023-12-08T08:00:49,Amurrio,expenses,water,-93.83,26109.45
buyer_3,Ana,Piñeiro,1989-08-23,25810029G,ana.piñeiro@megacloud.online,485584,ES35209577302742069253,6137.07,2023-12-08T19:14:44,Amurrio,expenses,gas,-216.58,25892.87
buyer_3,Ana,Piñeiro,1989-08-23,25810029G,ana.piñeiro@megacloud.online,485584,ES35209577302742069253,6137.07,2023-12-08T16:52:08,Amurrio,expenses,repairs,-318.97,25573.9
buyer_3,Ana,Piñeiro,1989-08-23,25810029G,ana.piñeiro@megacloud.online,485584,ES35209577302742069253,6137.07,2023-12-14T11:06:21,Amurrio,expenses,repairs,-28.29,25545.61
buyer_3,Ana,Piñeiro,1989-08-23,25810029G,ana.piñeiro@megacloud.online,485584,ES35209577302742069253,6137.07,2023-12-16T20:50:52,Amurrio,expenses,food,-111.26,25434.35
buyer_3,Ana,Piñeiro,1989-08-23,25810029G,ana.piñeiro@megacloud.online,485584,ES35209577302742069253,6137.07,2023-12-16T09:25:27,Amurrio,expenses,leisure,-74.96,25359.39
buyer_3,Ana,Piñeiro,1989-08-23,25810029G,ana.piñeiro@megacloud.online,485584,ES35209577302742069253,6137.07,2023-12-17T21:58:31,Amurrio,expenses,appliances,-314.11,25045.28
buyer_3,Ana,Piñeiro,1989-08-23,25810029G,ana.piñeiro@megacloud.online,485584,ES35209577302742069253,6137.07,2023-12-18T18:35:02,Amurrio,expenses,cash,-100.0,24945.28
buyer_3,Ana,Piñeiro,1989-08-23,25810029G,ana.piñeiro@megacloud.online,485584,ES35209577302742069253,6137.07,2023-12-19T09:19:36,Amurrio,expenses,food,-78.69,24866.59
buyer_3,Ana,Piñeiro,1989-08-23,25810029G,ana.piñeiro@megacloud.online,485584,ES35209577302742069253,6137.07,2023-12-20T10:29:21,Amurrio,expenses,leisure,-56.4,24810.19
buyer_3,Ana,Piñeiro,1989-08-23,25810029G,ana.piñeiro@megacloud.online,485584,ES35209577302742069253,6137.07,2023-12-20T12:10:11,Amurrio,expenses,cash,-100.0,24710.19
buyer_3,Ana,Piñeiro,1989-08-23,25810029G,ana.piñeiro@megacloud.online,485584,ES35209577302742069253,6137.07,2023-12-22T17:49:43,Amurrio,expenses,leisure,-18.55,24691.64
buyer_3,Ana,Piñeiro,1989-08-23,25810029G,ana.piñeiro@megacloud.online,485584,ES35209577302742069253,6137.07,2023-12-22T20:46:00,Amurrio,expenses,appliances,-220.9,24470.74
buyer_3,Ana,Piñeiro,1989-08-23,25810029G,ana.piñeiro@megacloud.online,485584,ES35209577302742069253,6137.07,2023-12-26T12:07:35,Amurrio,expenses,education,-77.82,24392.92
buyer_3,Ana,Piñeiro,1989-08-23,25810029G,ana.piñeiro@megacloud.online,485584,ES35209577302742069253,6137.07,2023-12-27T19:49:38,Amurrio,expenses,leisure,-44.66,24348.26
buyer_3,Ana,Piñeiro,1989-08-23,25810029G,ana.piñeiro@megacloud.online,485584,ES35209577302742069253,6137.07,2023-12-27T08:34:58,Amurrio,expenses,repairs,-251.01,24097.25
buyer_3,Ana,Piñeiro,1989-08-23,25810029G,ana.piñeiro@megacloud.online,485584,ES35209577302742069253,6137.07,2023-12-28T12:06:22,Amurrio,expenses,cash,-100.0,23997.25
buyer_3,Ana,Piñeiro,1989-08-23,25810029G,ana.piñeiro@megacloud.online,485584,ES35209577302742069253,6137.07,2023-12-30T08:37:03,Amurrio,expenses,food,-67.75,23929.5
buyer_3,Ana,Piñeiro,1989-08-23,25810029G,ana.piñeiro@megacloud.online,485584,ES35209577302742069253,6137.07,2023-12-31T17:18:56,Amurrio,expenses,food,-75.6,23853.9
buyer_3,Ana,Piñeiro,1989-08-23,25810029G,ana.piñeiro@megacloud.online,485584,ES35209577302742069253,6137.07,2024-01-01T23:14:26,Amurrio,incomes,salary,3331.83,27185.73
buyer_3,Ana,Piñeiro,1989-08-23,25810029G,ana.piñeiro@megacloud.online,485584,ES35209577302742069253,6137.07,2024-01-01T23:14:26,Amurrio,incomes,salary_partner,3655.4,30841.13
buyer_3,Ana,Piñeiro,1989-08-23,25810029G,ana.piñeiro@megacloud.online,485584,ES35209577302742069253,6137.07,2024-01-02T11:54:25,Amurrio,expenses,cash,-100.0,30741.13
buyer_3,Ana,Piñeiro,1989-08-23,25810029G,ana.piñeiro@megacloud.online,485584,ES35209577302742069253,6137.07,2024-01-03T16:08:29,Amurrio,expenses,cash,-100.0,30641.13
buyer_3,Ana,Piñeiro,1989-08-23,25810029G,ana.piñeiro@megacloud.online,485584,ES35209577302742069253,6137.07,2024-01-04T16:04:12,Amurrio,expenses,mortgage,-2944.37,27696.76
buyer_3,Ana,Piñeiro,1989-08-23,25810029G,ana.piñeiro@megacloud.online,485584,ES35209577302742069253,6137.07,2024-01-04T08:38:43,Amurrio,expenses,gifts,-758.17,26938.59
buyer_3,Ana,Piñeiro,1989-08-23,25810029G,ana.piñeiro@megacloud.online,485584,ES35209577302742069253,6137.07,2024-01-06T10:27:38,Amurrio,expenses,water,-73.45,26865.14
buyer_3,Ana,Piñeiro,1989-08-23,25810029G,ana.piñeiro@megacloud.online,485584,ES35209577302742069253,6137.07,2024-01-06T21:53:04,Amurrio,expenses,leisure,-58.95,26806.19
buyer_3,Ana,Piñeiro,1989-08-23,25810029G,ana.piñeiro@megacloud.online,485584,ES35209577302742069253,6137.07,2024-01-07T13:23:19,Amurrio,expenses,electricity,-233.62,26572.57
buyer_3,Ana,Piñeiro,1989-08-23,25810029G,ana.piñeiro@megacloud.online,485584,ES35209577302742069253,6137.07,2024-01-07T10:37:30,Amurrio,expenses,internet,-146.73,26425.84
buyer_3,Ana,Piñeiro,1989-08-23,25810029G,ana.piñeiro@megacloud.online,485584,ES35209577302742069253,6137.07,2024-01-08T14:19:41,Amurrio,expenses,gas,-117.23,26308.61
buyer_3,Ana,Piñeiro,1989-08-23,25810029G,ana.piñeiro@megacloud.online,485584,ES35209577302742069253,6137.07,2024-01-08T14:32:37,Amurrio,expenses,phone,-156.01,26152.6
buyer_3,Ana,Piñeiro,1989-08-23,25810029G,ana.piñeiro@megacloud.online,485584,ES35209577302742069253,6137.07,2024-01-09T17:25:08,Amurrio,expenses,leisure,-71.12,26081.48
buyer_3,Ana,Piñeiro,1989-08-23,25810029G,ana.piñeiro@megacloud.online,485584,ES35209577302742069253,6137.07,2024-01-11T14:06:12,Amurrio,expenses,food,-101.08,25980.4
buyer_3,Ana,Piñeiro,1989-08-23,25810029G,ana.piñeiro@megacloud.online,485584,ES35209577302742069253,6137.07,2024-01-12T09:08:55,Amurrio,expenses,cash,-100.0,25880.4
buyer_3,Ana,Piñeiro,1989-08-23,25810029G,ana.piñeiro@megacloud.online,485584,ES35209577302742069253,6137.07,2024-01-13T16:27:54,Amurrio,expenses,education,-48.48,25831.92
buyer_3,Ana,Piñeiro,1989-08-23,25810029G,ana.piñeiro@megacloud.online,485584,ES35209577302742069253,6137.07,2024-01-13T14:36:18,Amurrio,expenses,cash,-100.0,25731.92
buyer_3,Ana,Piñeiro,1989-08-23,25810029G,ana.piñeiro@megacloud.online,485584,ES35209577302742069253,6137.07,2024-01-15T19:51:38,Amurrio,expenses,transport,-63.62,25668.3
buyer_3,Ana,Piñeiro,1989-08-23,25810029G,ana.piñeiro@megacloud.online,485584,ES35209577302742069253,6137.07,2024-01-16T09:02:04,Amurrio,expenses,cash,-100.0,25568.3
buyer_3,Ana,Piñeiro,1989-08-23,25810029G,ana.piñeiro@megacloud.online,485584,ES35209577302742069253,6137.07,2024-01-17T12:00:31,Amurrio,expenses,travel,-1141.66,24426.64
buyer_3,Ana,Piñeiro,1989-08-23,25810029G,ana.piñeiro@megacloud.online,485584,ES35209577302742069253,6137.07,2024-01-18T21:53:41,Amurrio,expenses,leisure,-24.82,24401.82
buyer_3,Ana,Piñeiro,1989-08-23,25810029G,ana.piñeiro@megacloud.online,485584,ES35209577302742069253,6137.07,2024-01-23T14:50:32,Amurrio,expenses,food,-99.73,24302.09
buyer_3,Ana,Piñeiro,1989-08-23,25810029G,ana.piñeiro@megacloud.online,485584,ES35209577302742069253,6137.07,2024-01-23T15:33:45,Amurrio,expenses,leisure,-66.4,24235.69
buyer_3,Ana,Piñeiro,1989-08-23,25810029G,ana.piñeiro@megacloud.online,485584,ES35209577302742069253,6137.07,2024-01-24T08:10:17,Amurrio,expenses,food,-62.53,24173.16
buyer_3,Ana,Piñeiro,1989-08-23,25810029G,ana.piñeiro@megacloud.online,485584,ES35209577302742069253,6137.07,2024-01-28T00:56:18,Amurrio,expenses,leisure,-43.38,24129.78
buyer_3,Ana,Piñeiro,1989-08-23,25810029G,ana.piñeiro@megacloud.online,485584,ES35209577302742069253,6137.07,2024-01-30T21:00:55,Amurrio,expenses,leisure,-23.36,24106.42
buyer_3,Ana,Piñeiro,1989-08-23,25810029G,ana.piñeiro@megacloud.online,485584,ES35209577302742069253,6137.07,2024-01-30T09:41:41,Amurrio,expenses,cash,-100.0,24006.42
buyer_3,Ana,Piñeiro,1989-08-23,25810029G,ana.piñeiro@megacloud.online,485584,ES35209577302742069253,6137.07,2024-02-01T08:22:22,Amurrio,incomes,salary,3331.83,27338.25
buyer_3,Ana,Piñeiro,1989-08-23,25810029G,ana.piñeiro@megacloud.online,485584,ES35209577302742069253,6137.07,2024-02-01T08:22:22,Amurrio,incomes,salary_partner,3655.4,30993.65
buyer_3,Ana,Piñeiro,1989-08-23,25810029G,ana.piñeiro@megacloud.online,485584,ES35209577302742069253,6137.07,2024-02-01T08:22:22,Amurrio,incomes,extra_income,379.94,31373.59
buyer_3,Ana,Piñeiro,1989-08-23,25810029G,ana.piñeiro@megacloud.online,485584,ES35209577302742069253,6137.07,2024-02-01T12:15:43,Amurrio,expenses,cash,-100.0,31273.59
buyer_3,Ana,Piñeiro,1989-08-23,25810029G,ana.piñeiro@megacloud.online,485584,ES35209577302742069253,6137.07,2024-02-02T22:48:51,Amurrio,expenses,clothing,-130.12,31143.47
buyer_3,Ana,Piñeiro,1989-08-23,25810029G,ana.piñeiro@megacloud.online,485584,ES35209577302742069253,6137.07,2024-02-04T15:02:26,Amurrio,expenses,mortgage,-2944.37,28199.1
buyer_3,Ana,Piñeiro,1989-08-23,25810029G,ana.piñeiro@megacloud.online,485584,ES35209577302742069253,6137.07,2024-02-04T10:40:08,Amurrio,expenses,transport,-87.44,28111.66
buyer_3,Ana,Piñeiro,1989-08-23,25810029G,ana.piñeiro@megacloud.online,485584,ES35209577302742069253,6137.07,2024-02-04T17:05:51,Amurrio,expenses,leisure,-78.03,28033.63
buyer_3,Ana,Piñeiro,1989-08-23,25810029G,ana.piñeiro@megacloud.online,485584,ES35209577302742069253,6137.07,2024-02-05T17:43:24,Amurrio,expenses,phone,-149.19,27884.44
buyer_3,Ana,Piñeiro,1989-08-23,25810029G,ana.piñeiro@megacloud.online,485584,ES35209577302742069253,6137.07,2024-02-05T16:48:01,Amurrio,expenses,leisure,-80.43,27804.01
buyer_3,Ana,Piñeiro,1989-08-23,25810029G,ana.piñeiro@megacloud.online,485584,ES35209577302742069253,6137.07,2024-02-06T09:13:18,Amurrio,expenses,electricity,-239.85,27564.16
buyer_3,Ana,Piñeiro,1989-08-23,25810029G,ana.piñeiro@megacloud.online,485584,ES35209577302742069253,6137.07,2024-02-07T22:01:25,Amurrio,expenses,water,-81.62,27482.54
buyer_3,Ana,Piñeiro,1989-08-23,25810029G,ana.piñeiro@megacloud.online,485584,ES35209577302742069253,6137.07,2024-02-07T11:09:52,Amurrio,expenses,internet,-146.73,27335.81
buyer_3,Ana,Piñeiro,1989-08-23,25810029G,ana.piñeiro@megacloud.online,485584,ES35209577302742069253,6137.07,2024-02-07T16:49:08,Amurrio,expenses,gifts,-107.55,27228.26
buyer_3,Ana,Piñeiro,1989-08-23,25810029G,ana.piñeiro@megacloud.online,485584,ES35209577302742069253,6137.07,2024-02-08T14:04:58,Amurrio,expenses,gas,-237.4,26990.86
buyer_3,Ana,Piñeiro,1989-08-23,25810029G,ana.piñeiro@megacloud.online,485584,ES35209577302742069253,6137.07,2024-02-08T11:29:15,Amurrio,expenses,cash,-100.0,26890.86
buyer_3,Ana,Piñeiro,1989-08-23,25810029G,ana.piñeiro@megacloud.online,485584,ES35209577302742069253,6137.07,2024-02-09T15:47:59,Amurrio,expenses,repairs,-178.69,26712.17
buyer_3,Ana,Piñeiro,1989-08-23,25810029G,ana.piñeiro@megacloud.online,485584,ES35209577302742069253,6137.07,2024-02-10T08:35:00,Amurrio,expenses,education,-56.45,26655.72
buyer_3,Ana,Piñeiro,1989-08-23,25810029G,ana.piñeiro@megacloud.online,485584,ES35209577302742069253,6137.07,2024-02-11T08:10:34,Amurrio,expenses,cash,-100.0,26555.72
buyer_3,Ana,Piñeiro,1989-08-23,25810029G,ana.piñeiro@megacloud.online,485584,ES35209577302742069253,6137.07,2024-02-11T22:59:10,Amurrio,expenses,gifts,-334.78,26220.94
buyer_3,Ana,Piñeiro,1989-08-23,25810029G,ana.piñeiro@megacloud.online,485584,ES35209577302742069253,6137.07,2024-02-12T22:31:02,Amurrio,expenses,repairs,-185.06,26035.88
buyer_3,Ana,Piñeiro,1989-08-23,25810029G,ana.piñeiro@megacloud.online,485584,ES35209577302742069253,6137.07,2024-02-13T15:17:44,Amurrio,expenses,cash,-100.0,25935.88
buyer_3,Ana,Piñeiro,1989-08-23,25810029G,ana.piñeiro@megacloud.online,485584,ES35209577302742069253,6137.07,2024-02-14T16:25:16,Amurrio,expenses,food,-91.76,25844.12
buyer_3,Ana,Piñeiro,1989-08-23,25810029G,ana.piñeiro@megacloud.online,485584,ES35209577302742069253,6137.07,2024-02-14T10:13:30,Amurrio,expenses,healthcare,-41.52,25802.6
buyer_3,Ana,Piñeiro,1989-08-23,25810029G,ana.piñeiro@megacloud.online,485584,ES35209577302742069253,6137.07,2024-02-15T10:12:51,Amurrio,expenses,cash,-100.0,25702.6
buyer_3,Ana,Piñeiro,1989-08-23,25810029G,ana.piñeiro@megacloud.online,485584,ES35209577302742069253,6137.07,2024-02-16T13:49:04,Amurrio,expenses,transport,-75.27,25627.33
buyer_3,Ana,Piñeiro,1989-08-23,25810029G,ana.piñeiro@megacloud.online,485584,ES35209577302742069253,6137.07,2024-02-16T10:52:49,Amurrio,expenses,cash,-100.0,25527.33
buyer_3,Ana,Piñeiro,1989-08-23,25810029G,ana.piñeiro@megacloud.online,485584,ES35209577302742069253,6137.07,2024-02-17T23:04:08,Amurrio,expenses,transport,-79.48,25447.85
buyer_3,Ana,Piñeiro,1989-08-23,25810029G,ana.piñeiro@megacloud.online,485584,ES35209577302742069253,6137.07,2024-02-18T08:19:34,Amurrio,expenses,leisure,-19.39,25428.46
buyer_3,Ana,Piñeiro,1989-08-23,25810029G,ana.piñeiro@megacloud.online,485584,ES35209577302742069253,6137.07,2024-02-19T16:23:50,Amurrio,expenses,clothing,-153.1,25275.36
buyer_3,Ana,Piñeiro,1989-08-23,25810029G,ana.piñeiro@megacloud.online,485584,ES35209577302742069253,6137.07,2024-02-20T08:39:23,Amurrio,expenses,transport,-66.8,25208.56
buyer_3,Ana,Piñeiro,1989-08-23,25810029G,ana.piñeiro@megacloud.online,485584,ES35209577302742069253,6137.07,2024-02-21T08:49:51,Amurrio,expenses,transport,-79.82,25128.74
buyer_3,Ana,Piñeiro,1989-08-23,25810029G,ana.piñeiro@megacloud.online,485584,ES35209577302742069253,6137.07,2024-02-23T16:36:31,Amurrio,expenses,food,-103.73,25025.01
buyer_3,Ana,Piñeiro,1989-08-23,25810029G,ana.piñeiro@megacloud.online,485584,ES35209577302742069253,6137.07,2024-02-23T01:06:25,Amurrio,expenses,transport,-74.26,24950.75
buyer_3,Ana,Piñeiro,1989-08-23,25810029G,ana.piñeiro@megacloud.online,485584,ES35209577302742069253,6137.07,2024-02-23T18:41:38,Amurrio,expenses,healthcare,-140.57,24810.18
buyer_3,Ana,Piñeiro,1989-08-23,25810029G,ana.piñeiro@megacloud.online,485584,ES35209577302742069253,6137.07,2024-02-25T22:17:20,Amurrio,expenses,cash,-100.0,24710.18
buyer_3,Ana,Piñeiro,1989-08-23,25810029G,ana.piñeiro@megacloud.online,485584,ES35209577302742069253,6137.07,2024-02-25T14:26:56,Amurrio,expenses,appliances,-92.14,24618.04
buyer_3,Ana,Piñeiro,1989-08-23,25810029G,ana.piñeiro@megacloud.online,485584,ES35209577302742069253,6137.07,2024-02-26T12:08:02,Amurrio,expenses,gifts,-814.05,23803.99
buyer_3,Ana,Piñeiro,1989-08-23,25810029G,ana.piñeiro@megacloud.online,485584,ES35209577302742069253,6137.07,2024-02-27T22:25:26,Amurrio,expenses,transport,-58.34,23745.65
buyer_3,Ana,Piñeiro,1989-08-23,25810029G,ana.piñeiro@megacloud.online,485584,ES35209577302742069253,6137.07,2024-03-01T11:37:03,Amurrio,incomes,salary,3331.83,27077.48
buyer_3,Ana,Piñeiro,1989-08-23,25810029G,ana.piñeiro@megacloud.online,485584,ES35209577302742069253,6137.07,2024-03-01T11:37:03,Amurrio,incomes,salary_partner,3655.4,30732.88
buyer_3,Ana,Piñeiro,1989-08-23,25810029G,ana.piñeiro@megacloud.online,485584,ES35209577302742069253,6137.07,2024-03-01T18:26:17,Amurrio,expenses,food,-115.5,30617.38
buyer_3,Ana,Piñeiro,1989-08-23,25810029G,ana.piñeiro@megacloud.online,485584,ES35209577302742069253,6137.07,2024-03-01T16:24:05,Amurrio,expenses,transport,-63.59,30553.79
buyer_3,Ana,Piñeiro,1989-08-23,25810029G,ana.piñeiro@megacloud.online,485584,ES35209577302742069253,6137.07,2024-03-04T18:35:50,Amurrio,expenses,mortgage,-2944.37,27609.42
buyer_3,Ana,Piñeiro,1989-08-23,25810029G,ana.piñeiro@megacloud.online,485584,ES35209577302742069253,6137.07,2024-03-04T14:08:39,Amurrio,expenses,leisure,-26.42,27583.0
buyer_3,Ana,Piñeiro,1989-08-23,25810029G,ana.piñeiro@megacloud.online,485584,ES35209577302742069253,6137.07,2024-03-04T10:13:07,Amurrio,expenses,cash,-100.0,27483.0
buyer_3,Ana,Piñeiro,1989-08-23,25810029G,ana.piñeiro@megacloud.online,485584,ES35209577302742069253,6137.07,2024-03-05T16:59:43,Amurrio,expenses,cash,-100.0,27383.0
buyer_3,Ana,Piñeiro,1989-08-23,25810029G,ana.piñeiro@megacloud.online,485584,ES35209577302742069253,6137.07,2024-03-06T11:34:31,Amurrio,expenses,gas,-270.75,27112.25
buyer_3,Ana,Piñeiro,1989-08-23,25810029G,ana.piñeiro@megacloud.online,485584,ES35209577302742069253,6137.07,2024-03-06T15:19:04,Amurrio,expenses,internet,-146.73,26965.52
buyer_3,Ana,Piñeiro,1989-08-23,25810029G,ana.piñeiro@megacloud.online,485584,ES35209577302742069253,6137.07,2024-03-08T13:19:39,Amurrio,expenses,electricity,-101.65,26863.87
buyer_3,Ana,Piñeiro,1989-08-23,25810029G,ana.piñeiro@megacloud.online,485584,ES35209577302742069253,6137.07,2024-03-08T12:34:38,Amurrio,expenses,phone,-137.14,26726.73
buyer_3,Ana,Piñeiro,1989-08-23,25810029G,ana.piñeiro@megacloud.online,485584,ES35209577302742069253,6137.07,2024-03-08T09:16:48,Amurrio,expenses,water,-142.89,26583.84
buyer_3,Ana,Piñeiro,1989-08-23,25810029G,ana.piñeiro@megacloud.online,485584,ES35209577302742069253,6137.07,2024-03-08T08:13:09,Amurrio,expenses,leisure,-80.05,26503.79
buyer_3,Ana,Piñeiro,1989-08-23,25810029G,ana.piñeiro@megacloud.online,485584,ES35209577302742069253,6137.07,2024-03-08T10:29:01,Amurrio,expenses,cash,-100.0,26403.79
buyer_3,Ana,Piñeiro,1989-08-23,25810029G,ana.piñeiro@megacloud.online,485584,ES35209577302742069253,6137.07,2024-03-09T09:53:09,Amurrio,expenses,transport,-65.7,26338.09
buyer_3,Ana,Piñeiro,1989-08-23,25810029G,ana.piñeiro@megacloud.online,485584,ES35209577302742069253,6137.07,2024-03-10T08:40:41,Amurrio,expenses,transport,-50.66,26287.43
buyer_3,Ana,Piñeiro,1989-08-23,25810029G,ana.piñeiro@megacloud.online,485584,ES35209577302742069253,6137.07,2024-03-10T14:31:17,Amurrio,expenses,clothing,-68.68,26218.75
buyer_3,Ana,Piñeiro,1989-08-23,25810029G,ana.piñeiro@megacloud.online,485584,ES35209577302742069253,6137.07,2024-03-12T19:17:10,Amurrio,expenses,travel,-1206.28,25012.47
buyer_3,Ana,Piñeiro,1989-08-23,25810029G,ana.piñeiro@megacloud.online,485584,ES35209577302742069253,6137.07,2024-03-16T08:28:09,Amurrio,expenses,repairs,-242.38,24770.09
buyer_3,Ana,Piñeiro,1989-08-23,25810029G,ana.piñeiro@megacloud.online,485584,ES35209577302742069253,6137.07,2024-03-19T01:59:08,Amurrio,expenses,leisure,-35.44,24734.65
buyer_3,Ana,Piñeiro,1989-08-23,25810029G,ana.piñeiro@megacloud.online,485584,ES35209577302742069253,6137.07,2024-03-19T17:48:44,Amurrio,expenses,education,-63.1,24671.55
buyer_3,Ana,Piñeiro,1989-08-23,25810029G,ana.piñeiro@megacloud.online,485584,ES35209577302742069253,6137.07,2024-03-20T11:40:53,Amurrio,expenses,gifts,-267.37,24404.18
buyer_3,Ana,Piñeiro,1989-08-23,25810029G,ana.piñeiro@megacloud.online,485584,ES35209577302742069253,6137.07,2024-03-23T09:31:16,Amurrio,expenses,transport,-56.89,24347.29
buyer_3,Ana,Piñeiro,1989-08-23,25810029G,ana.piñeiro@megacloud.online,485584,ES35209577302742069253,6137.07,2024-03-23T15:08:24,Amurrio,expenses,education,-42.67,24304.62
buyer_3,Ana,Piñeiro,1989-08-23,25810029G,ana.piñeiro@megacloud.online,485584,ES35209577302742069253,6137.07,2024-03-24T02:46:50,Amurrio,expenses,cash,-100.0,24204.62
buyer_3,Ana,Piñeiro,1989-08-23,25810029G,ana.piñeiro@megacloud.online,485584,ES35209577302742069253,6137.07,2024-03-25T23:29:34,Amurrio,expenses,food,-119.68,24084.94
buyer_3,Ana,Piñeiro,1989-08-23,25810029G,ana.piñeiro@megacloud.online,485584,ES35209577302742069253,6137.07,2024-03-29T15:58:16,Amurrio,expenses,appliances,-206.27,23878.67
buyer_3,Ana,Piñeiro,1989-08-23,25810029G,ana.piñeiro@megacloud.online,485584,ES35209577302742069253,6137.07,2024-03-31T14:32:09,Amurrio,expenses,transport,-87.55,23791.12
buyer_3,Ana,Piñeiro,1989-08-23,25810029G,ana.piñeiro@megacloud.online,485584,ES35209577302742069253,6137.07,2024-04-01T10:01:19,Amurrio,incomes,salary,3331.83,27122.95
buyer_3,Ana,Piñeiro,1989-08-23,25810029G,ana.piñeiro@megacloud.online,485584,ES35209577302742069253,6137.07,2024-04-01T10:01:19,Amurrio,incomes,salary_partner,3655.4,30778.35
buyer_3,Ana,Piñeiro,1989-08-23,25810029G,ana.piñeiro@megacloud.online,485584,ES35209577302742069253,6137.07,2024-04-04T18:06:23,Amurrio,expenses,mortgage,-2944.37,27833.98
buyer_3,Ana,Piñeiro,1989-08-23,25810029G,ana.piñeiro@megacloud.online,485584,ES35209577302742069253,6137.07,2024-04-05T12:08:43,Amurrio,expenses,gas,-242.33,27591.65
buyer_3,Ana,Piñeiro,1989-08-23,25810029G,ana.piñeiro@megacloud.online,485584,ES35209577302742069253,6137.07,2024-04-05T12:38:53,Amurrio,expenses,transport,-61.42,27530.23
buyer_3,Ana,Piñeiro,1989-08-23,25810029G,ana.piñeiro@megacloud.online,485584,ES35209577302742069253,6137.07,2024-04-06T16:41:14,Amurrio,expenses,water,-152.53,27377.7
buyer_3,Ana,Piñeiro,1989-08-23,25810029G,ana.piñeiro@megacloud.online,485584,ES35209577302742069253,6137.07,2024-04-07T09:04:46,Amurrio,expenses,leisure,-81.91,27295.79
buyer_3,Ana,Piñeiro,1989-08-23,25810029G,ana.piñeiro@megacloud.online,485584,ES35209577302742069253,6137.07,2024-04-08T08:46:09,Amurrio,expenses,phone,-117.18,27178.61
buyer_3,Ana,Piñeiro,1989-08-23,25810029G,ana.piñeiro@megacloud.online,485584,ES35209577302742069253,6137.07,2024-04-08T19:03:06,Amurrio,expenses,electricity,-223.16,26955.45
buyer_3,Ana,Piñeiro,1989-08-23,25810029G,ana.piñeiro@megacloud.online,485584,ES35209577302742069253,6137.07,2024-04-08T09:29:15,Amurrio,expenses,internet,-146.73,26808.72
buyer_3,Ana,Piñeiro,1989-08-23,25810029G,ana.piñeiro@megacloud.online,485584,ES35209577302742069253,6137.07,2024-04-09T09:36:32,Amurrio,expenses,food,-108.18,26700.54
buyer_3,Ana,Piñeiro,1989-08-23,25810029G,ana.piñeiro@megacloud.online,485584,ES35209577302742069253,6137.07,2024-04-10T12:39:21,Amurrio,expenses,cash,-100.0,26600.54
buyer_3,Ana,Piñeiro,1989-08-23,25810029G,ana.piñeiro@megacloud.online,485584,ES35209577302742069253,6137.07,2024-04-11T09:26:25,Amurrio,expenses,healthcare,-43.66,26556.88
buyer_3,Ana,Piñeiro,1989-08-23,25810029G,ana.piñeiro@megacloud.online,485584,ES35209577302742069253,6137.07,2024-04-11T06:54:43,Amurrio,expenses,education,-58.46,26498.42
buyer_3,Ana,Piñeiro,1989-08-23,25810029G,ana.piñeiro@megacloud.online,485584,ES35209577302742069253,6137.07,2024-04-13T13:00:39,Amurrio,expenses,food,-100.14,26398.28
buyer_3,Ana,Piñeiro,1989-08-23,25810029G,ana.piñeiro@megacloud.online,485584,ES35209577302742069253,6137.07,2024-04-15T11:22:13,Amurrio,expenses,food,-79.5,26318.78
buyer_3,Ana,Piñeiro,1989-08-23,25810029G,ana.piñeiro@megacloud.online,485584,ES35209577302742069253,6137.07,2024-04-15T19:49:02,Amurrio,expenses,repairs,-283.26,26035.52
buyer_3,Ana,Piñeiro,1989-08-23,25810029G,ana.piñeiro@megacloud.online,485584,ES35209577302742069253,6137.07,2024-04-17T10:59:06,Amurrio,expenses,food,-121.41,25914.11
buyer_3,Ana,Piñeiro,1989-08-23,25810029G,ana.piñeiro@megacloud.online,485584,ES35209577302742069253,6137.07,2024-04-17T11:45:44,Amurrio,expenses,travel,-1145.87,24768.24
buyer_3,Ana,Piñeiro,1989-08-23,25810029G,ana.piñeiro@megacloud.online,485584,ES35209577302742069253,6137.07,2024-04-19T21:34:57,Amurrio,expenses,appliances,-115.39,24652.85
buyer_3,Ana,Piñeiro,1989-08-23,25810029G,ana.piñeiro@megacloud.online,485584,ES35209577302742069253,6137.07,2024-04-20T01:46:03,Amurrio,expenses,transport,-76.95,24575.9
buyer_3,Ana,Piñeiro,1989-08-23,25810029G,ana.piñeiro@megacloud.online,485584,ES35209577302742069253,6137.07,2024-04-20T10:40:16,Amurrio,expenses,travel,-464.49,24111.41
buyer_3,Ana,Piñeiro,1989-08-23,25810029G,ana.piñeiro@megacloud.online,485584,ES35209577302742069253,6137.07,2024-04-21T21:04:58,Amurrio,expenses,cash,-100.0,24011.41
buyer_3,Ana,Piñeiro,1989-08-23,25810029G,ana.piñeiro@megacloud.online,485584,ES35209577302742069253,6137.07,2024-04-23T10:56:13,Amurrio,expenses,travel,-341.6,23669.81
buyer_3,Ana,Piñeiro,1989-08-23,25810029G,ana.piñeiro@megacloud.online,485584,ES35209577302742069253,6137.07,2024-04-23T16:42:59,Amurrio,expenses,gifts,-146.6,23523.21
buyer_3,Ana,Piñeiro,1989-08-23,25810029G,ana.piñeiro@megacloud.online,485584,ES35209577302742069253,6137.07,2024-04-27T17:17:48,Amurrio,expenses,clothing,-148.28,23374.93
buyer_3,Ana,Piñeiro,1989-08-23,25810029G,ana.piñeiro@megacloud.online,485584,ES35209577302742069253,6137.07,2024-04-28T12:10:01,Amurrio,expenses,food,-68.55,23306.38
buyer_3,Ana,Piñeiro,1989-08-23,25810029G,ana.piñeiro@megacloud.online,485584,ES35209577302742069253,6137.07,2024-04-29T10:55:16,Amurrio,expenses,food,-105.33,23201.05
buyer_3,Ana,Piñeiro,1989-08-23,25810029G,ana.piñeiro@megacloud.online,485584,ES35209577302742069253,6137.07,2024-04-30T12:16:44,Amurrio,expenses,gifts,-761.09,22439.96
buyer_3,Ana,Piñeiro,1989-08-23,25810029G,ana.piñeiro@megacloud.online,485584,ES35209577302742069253,6137.07,2024-05-01T08:08:10,Amurrio,incomes,salary,3331.83,25771.79
buyer_3,Ana,Piñeiro,1989-08-23,25810029G,ana.piñeiro@megacloud.online,485584,ES35209577302742069253,6137.07,2024-05-01T08:08:10,Amurrio,incomes,salary_partner,3655.4,29427.19
buyer_3,Ana,Piñeiro,1989-08-23,25810029G,ana.piñeiro@megacloud.online,485584,ES35209577302742069253,6137.07,2024-05-04T12:27:51,Amurrio,expenses,mortgage,-2944.37,26482.82
buyer_3,Ana,Piñeiro,1989-08-23,25810029G,ana.piñeiro@megacloud.online,485584,ES35209577302742069253,6137.07,2024-05-05T18:15:04,Amurrio,expenses,internet,-146.73,26336.09
buyer_3,Ana,Piñeiro,1989-08-23,25810029G,ana.piñeiro@megacloud.online,485584,ES35209577302742069253,6137.07,2024-05-05T08:55:23,Amurrio,expenses,transport,-46.15,26289.94
buyer_3,Ana,Piñeiro,1989-08-23,25810029G,ana.piñeiro@megacloud.online,485584,ES35209577302742069253,6137.07,2024-05-07T14:39:53,Amurrio,expenses,phone,-117.43,26172.51
buyer_3,Ana,Piñeiro,1989-08-23,25810029G,ana.piñeiro@megacloud.online,485584,ES35209577302742069253,6137.07,2024-05-08T14:31:13,Amurrio,expenses,water,-116.72,26055.79
buyer_3,Ana,Piñeiro,1989-08-23,25810029G,ana.piñeiro@megacloud.online,485584,ES35209577302742069253,6137.07,2024-05-08T16:48:08,Amurrio,expenses,electricity,-168.33,25887.46
buyer_3,Ana,Piñeiro,1989-08-23,25810029G,ana.piñeiro@megacloud.online,485584,ES35209577302742069253,6137.07,2024-05-08T12:43:29,Amurrio,expenses,gas,-215.89,25671.57
buyer_3,Ana,Piñeiro,1989-08-23,25810029G,ana.piñeiro@megacloud.online,485584,ES35209577302742069253,6137.07,2024-05-08T10:15:37,Amurrio,expenses,food,-122.53,25549.04
buyer_3,Ana,Piñeiro,1989-08-23,25810029G,ana.piñeiro@megacloud.online,485584,ES35209577302742069253,6137.07,2024-05-09T19:23:08,Amurrio,expenses,cash,-100.0,25449.04
buyer_3,Ana,Piñeiro,1989-08-23,25810029G,ana.piñeiro@megacloud.online,485584,ES35209577302742069253,6137.07,2024-05-10T17:46:31,Amurrio,expenses,repairs,-328.25,25120.79
buyer_3,Ana,Piñeiro,1989-08-23,25810029G,ana.piñeiro@megacloud.online,485584,ES35209577302742069253,6137.07,2024-05-11T17:50:24,Amurrio,expenses,transport,-66.25,25054.54
buyer_3,Ana,Piñeiro,1989-08-23,25810029G,ana.piñeiro@megacloud.online,485584,ES35209577302742069253,6137.07,2024-05-12T11:26:50,Amurrio,expenses,food,-86.18,24968.36
buyer_3,Ana,Piñeiro,1989-08-23,25810029G,ana.piñeiro@megacloud.online,485584,ES35209577302742069253,6137.07,2024-05-12T10:55:15,Amurrio,expenses,transport,-78.46,24889.9
buyer_3,Ana,Piñeiro,1989-08-23,25810029G,ana.piñeiro@megacloud.online,485584,ES35209577302742069253,6137.07,2024-05-12T23:05:32,Amurrio,expenses,leisure,-66.81,24823.09
buyer_3,Ana,Piñeiro,1989-08-23,25810029G,ana.piñeiro@megacloud.online,485584,ES35209577302742069253,6137.07,2024-05-14T15:50:02,Amurrio,expenses,cash,-100.0,24723.09
buyer_3,Ana,Piñeiro,1989-08-23,25810029G,ana.piñeiro@megacloud.online,485584,ES35209577302742069253,6137.07,2024-05-15T15:53:33,Amurrio,expenses,healthcare,-92.92,24630.17
buyer_3,Ana,Piñeiro,1989-08-23,25810029G,ana.piñeiro@megacloud.online,485584,ES35209577302742069253,6137.07,2024-05-17T16:13:27,Amurrio,expenses,transport,-62.82,24567.35
buyer_3,Ana,Piñeiro,1989-08-23,25810029G,ana.piñeiro@megacloud.online,485584,ES35209577302742069253,6137.07,2024-05-19T12:28:33,Amurrio,expenses,travel,-386.07,24181.28
buyer_3,Ana,Piñeiro,1989-08-23,25810029G,ana.piñeiro@megacloud.online,485584,ES35209577302742069253,6137.07,2024-05-21T11:10:17,Amurrio,expenses,transport,-49.81,24131.47
buyer_3,Ana,Piñeiro,1989-08-23,25810029G,ana.piñeiro@megacloud.online,485584,ES35209577302742069253,6137.07,2024-05-22T10:36:45,Amurrio,expenses,cash,-100.0,24031.47
buyer_3,Ana,Piñeiro,1989-08-23,25810029G,ana.piñeiro@megacloud.online,485584,ES35209577302742069253,6137.07,2024-05-24T16:39:43,Amurrio,expenses,transport,-50.31,23981.16
buyer_3,Ana,Piñeiro,1989-08-23,25810029G,ana.piñeiro@megacloud.online,485584,ES35209577302742069253,6137.07,2024-05-24T09:54:09,Amurrio,expenses,clothing,-72.11,23909.05
buyer_3,Ana,Piñeiro,1989-08-23,25810029G,ana.piñeiro@megacloud.online,485584,ES35209577302742069253,6137.07,2024-05-25T20:55:18,Amurrio,expenses,food,-99.18,23809.87
buyer_3,Ana,Piñeiro,1989-08-23,25810029G,ana.piñeiro@megacloud.online,485584,ES35209577302742069253,6137.07,2024-05-25T20:46:36,Amurrio,expenses,leisure,-70.92,23738.95
buyer_3,Ana,Piñeiro,1989-08-23,25810029G,ana.piñeiro@megacloud.online,485584,ES35209577302742069253,6137.07,2024-05-25T22:16:42,Amurrio,expenses,cash,-100.0,23638.95
buyer_3,Ana,Piñeiro,1989-08-23,25810029G,ana.piñeiro@megacloud.online,485584,ES35209577302742069253,6137.07,2024-05-26T03:44:14,Amurrio,expenses,transport,-50.32,23588.63
buyer_3,Ana,Piñeiro,1989-08-23,25810029G,ana.piñeiro@megacloud.online,485584,ES35209577302742069253,6137.07,2024-05-26T07:02:25,Amurrio,expenses,cash,-100.0,23488.63
buyer_3,Ana,Piñeiro,1989-08-23,25810029G,ana.piñeiro@megacloud.online,485584,ES35209577302742069253,6137.07,2024-05-26T16:01:21,Amurrio,expenses,repairs,-79.21,23409.42
buyer_3,Ana,Piñeiro,1989-08-23,25810029G,ana.piñeiro@megacloud.online,485584,ES35209577302742069253,6137.07,2024-05-30T16:37:50,Amurrio,expenses,gifts,-815.42,22594.0
buyer_3,Ana,Piñeiro,1989-08-23,25810029G,ana.piñeiro@megacloud.online,485584,ES35209577302742069253,6137.07,2024-06-01T19:20:27,Amurrio,incomes,salary,3331.83,25925.83
buyer_3,Ana,Piñeiro,1989-08-23,25810029G,ana.piñeiro@megacloud.online,485584,ES35209577302742069253,6137.07,2024-06-01T19:20:27,Amurrio,incomes,salary_partner,3655.4,29581.23
buyer_3,Ana,Piñeiro,1989-08-23,25810029G,ana.piñeiro@megacloud.online,485584,ES35209577302742069253,6137.07,2024-06-01T19:20:27,Amurrio,incomes,extra_income,379.94,29961.17
buyer_3,Ana,Piñeiro,1989-08-23,25810029G,ana.piñeiro@megacloud.online,485584,ES35209577302742069253,6137.07,2024-06-01T19:20:27,Amurrio,incomes,salary_bonus,2657.11,32618.28
buyer_3,Ana,Piñeiro,1989-08-23,25810029G,ana.piñeiro@megacloud.online,485584,ES35209577302742069253,6137.07,2024-06-01T19:20:27,Amurrio,incomes,salary_partner_bonus,2784.94,35403.22
buyer_3,Ana,Piñeiro,1989-08-23,25810029G,ana.piñeiro@megacloud.online,485584,ES35209577302742069253,6137.07,2024-06-01T13:01:34,Amurrio,expenses,food,-97.92,35305.3
buyer_3,Ana,Piñeiro,1989-08-23,25810029G,ana.piñeiro@megacloud.online,485584,ES35209577302742069253,6137.07,2024-06-04T11:17:56,Amurrio,expenses,mortgage,-2944.37,32360.93
buyer_3,Ana,Piñeiro,1989-08-23,25810029G,ana.piñeiro@megacloud.online,485584,ES35209577302742069253,6137.07,2024-06-04T12:17:35,Amurrio,expenses,transport,-88.85,32272.08
buyer_3,Ana,Piñeiro,1989-08-23,25810029G,ana.piñeiro@megacloud.online,485584,ES35209577302742069253,6137.07,2024-06-05T20:06:16,Amurrio,expenses,water,-135.89,32136.19
buyer_3,Ana,Piñeiro,1989-08-23,25810029G,ana.piñeiro@megacloud.online,485584,ES35209577302742069253,6137.07,2024-06-05T07:52:29,Amurrio,expenses,electricity,-107.89,32028.3
buyer_3,Ana,Piñeiro,1989-08-23,25810029G,ana.piñeiro@megacloud.online,485584,ES35209577302742069253,6137.07,2024-06-05T15:52:08,Amurrio,expenses,internet,-146.73,31881.57
buyer_3,Ana,Piñeiro,1989-08-23,25810029G,ana.piñeiro@megacloud.online,485584,ES35209577302742069253,6137.07,2024-06-06T15:50:52,Amurrio,expenses,phone,-140.16,31741.41
buyer_3,Ana,Piñeiro,1989-08-23,25810029G,ana.piñeiro@megacloud.online,485584,ES35209577302742069253,6137.07,2024-06-06T22:37:22,Amurrio,expenses,gifts,-320.09,31421.32
buyer_3,Ana,Piñeiro,1989-08-23,25810029G,ana.piñeiro@megacloud.online,485584,ES35209577302742069253,6137.07,2024-06-07T20:43:40,Amurrio,expenses,clothing,-56.74,31364.58
buyer_3,Ana,Piñeiro,1989-08-23,25810029G,ana.piñeiro@megacloud.online,485584,ES35209577302742069253,6137.07,2024-06-08T19:46:24,Amurrio,expenses,gas,-318.77,31045.81
buyer_3,Ana,Piñeiro,1989-08-23,25810029G,ana.piñeiro@megacloud.online,485584,ES35209577302742069253,6137.07,2024-06-08T10:58:25,Amurrio,expenses,leisure,-64.45,30981.36
buyer_3,Ana,Piñeiro,1989-08-23,25810029G,ana.piñeiro@megacloud.online,485584,ES35209577302742069253,6137.07,2024-06-10T21:57:42,Amurrio,expenses,food,-85.23,30896.13
buyer_3,Ana,Piñeiro,1989-08-23,25810029G,ana.piñeiro@megacloud.online,485584,ES35209577302742069253,6137.07,2024-06-10T14:54:51,Amurrio,expenses,cash,-100.0,30796.13
buyer_3,Ana,Piñeiro,1989-08-23,25810029G,ana.piñeiro@megacloud.online,485584,ES35209577302742069253,6137.07,2024-06-11T09:28:34,Amurrio,expenses,food,-65.13,30731.0
buyer_3,Ana,Piñeiro,1989-08-23,25810029G,ana.piñeiro@megacloud.online,485584,ES35209577302742069253,6137.07,2024-06-12T17:28:47,Amurrio,expenses,education,-73.43,30657.57
buyer_3,Ana,Piñeiro,1989-08-23,25810029G,ana.piñeiro@megacloud.online,485584,ES35209577302742069253,6137.07,2024-06-15T12:52:55,Amurrio,expenses,cash,-100.0,30557.57
buyer_3,Ana,Piñeiro,1989-08-23,25810029G,ana.piñeiro@megacloud.online,485584,ES35209577302742069253,6137.07,2024-06-16T20:20:28,Amurrio,expenses,appliances,-289.37,30268.2
buyer_3,Ana,Piñeiro,1989-08-23,25810029G,ana.piñeiro@megacloud.online,485584,ES35209577302742069253,6137.07,2024-06-17T09:52:29,Amurrio,expenses,transport,-53.53,30214.67
buyer_3,Ana,Piñeiro,1989-08-23,25810029G,ana.piñeiro@megacloud.online,485584,ES35209577302742069253,6137.07,2024-06-17T17:50:25,Amurrio,expenses,cash,-100.0,30114.67
buyer_3,Ana,Piñeiro,1989-08-23,25810029G,ana.piñeiro@megacloud.online,485584,ES35209577302742069253,6137.07,2024-06-17T15:50:50,Amurrio,expenses,repairs,-301.51,29813.16
buyer_3,Ana,Piñeiro,1989-08-23,25810029G,ana.piñeiro@megacloud.online,485584,ES35209577302742069253,6137.07,2024-06-18T08:09:41,Amurrio,expenses,gifts,-188.52,29624.64
buyer_3,Ana,Piñeiro,1989-08-23,25810029G,ana.piñeiro@megacloud.online,485584,ES35209577302742069253,6137.07,2024-06-20T18:34:59,Amurrio,expenses,gifts,-552.04,29072.6
buyer_3,Ana,Piñeiro,1989-08-23,25810029G,ana.piñeiro@megacloud.online,485584,ES35209577302742069253,6137.07,2024-06-21T21:07:38,Amurrio,expenses,food,-73.32,28999.28
buyer_3,Ana,Piñeiro,1989-08-23,25810029G,ana.piñeiro@megacloud.online,485584,ES35209577302742069253,6137.07,2024-06-21T12:25:23,Amurrio,expenses,education,-68.55,28930.73
buyer_3,Ana,Piñeiro,1989-08-23,25810029G,ana.piñeiro@megacloud.online,485584,ES35209577302742069253,6137.07,2024-06-24T15:59:31,Amurrio,expenses,cash,-100.0,28830.73
buyer_3,Ana,Piñeiro,1989-08-23,25810029G,ana.piñeiro@megacloud.online,485584,ES35209577302742069253,6137.07,2024-06-26T15:55:40,Amurrio,expenses,repairs,-213.77,28616.96
buyer_3,Ana,Piñeiro,1989-08-23,25810029G,ana.piñeiro@megacloud.online,485584,ES35209577302742069253,6137.07,2024-06-30T13:39:44,Amurrio,expenses,education,-45.97,28570.99
buyer_3,Ana,Piñeiro,1989-08-23,25810029G,ana.piñeiro@megacloud.online,485584,ES35209577302742069253,6137.07,2024-06-30T13:20:05,Amurrio,expenses,travel,-542.07,28028.92
buyer_3,Ana,Piñeiro,1989-08-23,25810029G,ana.piñeiro@megacloud.online,485584,ES35209577302742069253,6137.07,2024-06-30T05:25:03,Amurrio,expenses,repairs,-161.53,27867.39
buyer_3,Ana,Piñeiro,1989-08-23,25810029G,ana.piñeiro@megacloud.online,485584,ES35209577302742069253,6137.07,2024-07-01T17:27:12,Amurrio,incomes,salary,3331.83,31199.22
buyer_3,Ana,Piñeiro,1989-08-23,25810029G,ana.piñeiro@megacloud.online,485584,ES35209577302742069253,6137.07,2024-07-01T17:27:12,Amurrio,incomes,salary_partner,3655.4,34854.62
buyer_3,Ana,Piñeiro,1989-08-23,25810029G,ana.piñeiro@megacloud.online,485584,ES35209577302742069253,6137.07,2024-07-01T17:14:05,Amurrio,expenses,transport,-49.71,34804.91
buyer_3,Ana,Piñeiro,1989-08-23,25810029G,ana.piñeiro@megacloud.online,485584,ES35209577302742069253,6137.07,2024-07-01T15:56:27,Amurrio,expenses,gifts,-54.09,34750.82
buyer_3,Ana,Piñeiro,1989-08-23,25810029G,ana.piñeiro@megacloud.online,485584,ES35209577302742069253,6137.07,2024-07-04T05:06:50,Amurrio,expenses,mortgage,-2944.37,31806.45
buyer_3,Ana,Piñeiro,1989-08-23,25810029G,ana.piñeiro@megacloud.online,485584,ES35209577302742069253,6137.07,2024-07-04T22:32:47,Amurrio,expenses,clothing,-83.37,31723.08
buyer_3,Ana,Piñeiro,1989-08-23,25810029G,ana.piñeiro@megacloud.online,485584,ES35209577302742069253,6137.07,2024-07-05T14:03:14,Amurrio,expenses,phone,-145.77,31577.31
buyer_3,Ana,Piñeiro,1989-08-23,25810029G,ana.piñeiro@megacloud.online,485584,ES35209577302742069253,6137.07,2024-07-05T18:06:35,Amurrio,expenses,cash,-100.0,31477.31
buyer_3,Ana,Piñeiro,1989-08-23,25810029G,ana.piñeiro@megacloud.online,485584,ES35209577302742069253,6137.07,2024-07-06T16:48:15,Amurrio,expenses,water,-145.44,31331.87
buyer_3,Ana,Piñeiro,1989-08-23,25810029G,ana.piñeiro@megacloud.online,485584,ES35209577302742069253,6137.07,2024-07-06T23:07:01,Amurrio,expenses,electricity,-265.7,31066.17
buyer_3,Ana,Piñeiro,1989-08-23,25810029G,ana.piñeiro@megacloud.online,485584,ES35209577302742069253,6137.07,2024-07-06T00:31:03,Amurrio,expenses,gas,-128.36,30937.81
buyer_3,Ana,Piñeiro,1989-08-23,25810029G,ana.piñeiro@megacloud.online,485584,ES35209577302742069253,6137.07,2024-07-06T13:52:47,Amurrio,expenses,transport,-55.11,30882.7
buyer_3,Ana,Piñeiro,1989-08-23,25810029G,ana.piñeiro@megacloud.online,485584,ES35209577302742069253,6137.07,2024-07-08T10:00:19,Amurrio,expenses,internet,-146.73,30735.97
buyer_3,Ana,Piñeiro,1989-08-23,25810029G,ana.piñeiro@megacloud.online,485584,ES35209577302742069253,6137.07,2024-07-08T21:42:58,Amurrio,expenses,clothing,-46.17,30689.8
buyer_3,Ana,Piñeiro,1989-08-23,25810029G,ana.piñeiro@megacloud.online,485584,ES35209577302742069253,6137.07,2024-07-09T23:19:06,Amurrio,expenses,leisure,-43.54,30646.26
buyer_3,Ana,Piñeiro,1989-08-23,25810029G,ana.piñeiro@megacloud.online,485584,ES35209577302742069253,6137.07,2024-07-09T09:02:43,Amurrio,expenses,clothing,-157.2,30489.06
buyer_3,Ana,Piñeiro,1989-08-23,25810029G,ana.piñeiro@megacloud.online,485584,ES35209577302742069253,6137.07,2024-07-12T13:08:15,Amurrio,expenses,healthcare,-70.74,30418.32
buyer_3,Ana,Piñeiro,1989-08-23,25810029G,ana.piñeiro@megacloud.online,485584,ES35209577302742069253,6137.07,2024-07-13T11:27:40,Amurrio,expenses,food,-105.15,30313.17
buyer_3,Ana,Piñeiro,1989-08-23,25810029G,ana.piñeiro@megacloud.online,485584,ES35209577302742069253,6137.07,2024-07-13T20:33:49,Amurrio,expenses,leisure,-37.35,30275.82
buyer_3,Ana,Piñeiro,1989-08-23,25810029G,ana.piñeiro@megacloud.online,485584,ES35209577302742069253,6137.07,2024-07-16T14:33:01,Amurrio,expenses,repairs,-184.13,30091.69
buyer_3,Ana,Piñeiro,1989-08-23,25810029G,ana.piñeiro@megacloud.online,485584,ES35209577302742069253,6137.07,2024-07-19T19:04:55,Amurrio,expenses,repairs,-163.2,29928.49
buyer_3,Ana,Piñeiro,1989-08-23,25810029G,ana.piñeiro@megacloud.online,485584,ES35209577302742069253,6137.07,2024-07-21T18:16:26,Amurrio,expenses,education,-76.77,29851.72
buyer_3,Ana,Piñeiro,1989-08-23,25810029G,ana.piñeiro@megacloud.online,485584,ES35209577302742069253,6137.07,2024-07-21T10:41:48,Amurrio,expenses,repairs,-176.79,29674.93
buyer_3,Ana,Piñeiro,1989-08-23,25810029G,ana.piñeiro@megacloud.online,485584,ES35209577302742069253,6137.07,2024-07-23T15:02:56,Amurrio,expenses,cash,-100.0,29574.93
buyer_3,Ana,Piñeiro,1989-08-23,25810029G,ana.piñeiro@megacloud.online,485584,ES35209577302742069253,6137.07,2024-07-25T16:04:40,Amurrio,expenses,food,-95.51,29479.42
buyer_3,Ana,Piñeiro,1989-08-23,25810029G,ana.piñeiro@megacloud.online,485584,ES35209577302742069253,6137.07,2024-07-27T07:03:47,Amurrio,expenses,transport,-40.47,29438.95
buyer_3,Ana,Piñeiro,1989-08-23,25810029G,ana.piñeiro@megacloud.online,485584,ES35209577302742069253,6137.07,2024-07-29T08:52:39,Amurrio,expenses,cash,-100.0,29338.95
buyer_3,Ana,Piñeiro,1989-08-23,25810029G,ana.piñeiro@megacloud.online,485584,ES35209577302742069253,6137.07,2024-07-30T12:48:08,Amurrio,expenses,food,-61.31,29277.64
buyer_3,Ana,Piñeiro,1989-08-23,25810029G,ana.piñeiro@megacloud.online,485584,ES35209577302742069253,6137.07,2024-07-31T14:36:17,Amurrio,expenses,cash,-100.0,29177.64
buyer_3,Ana,Piñeiro,1989-08-23,25810029G,ana.piñeiro@megacloud.online,485584,ES35209577302742069253,6137.07,2024-08-01T12:25:09,Amurrio,incomes,salary,3331.83,32509.47
buyer_3,Ana,Piñeiro,1989-08-23,25810029G,ana.piñeiro@megacloud.online,485584,ES35209577302742069253,6137.07,2024-08-01T12:25:09,Amurrio,incomes,salary_partner,3655.4,36164.87
buyer_3,Ana,Piñeiro,1989-08-23,25810029G,ana.piñeiro@megacloud.online,485584,ES35209577302742069253,6137.07,2024-08-02T11:30:26,Amurrio,expenses,repairs,-283.95,35880.92
buyer_3,Ana,Piñeiro,1989-08-23,25810029G,ana.piñeiro@megacloud.online,485584,ES35209577302742069253,6137.07,2024-08-03T10:28:05,Amurrio,expenses,repairs,-96.37,35784.55
buyer_3,Ana,Piñeiro,1989-08-23,25810029G,ana.piñeiro@megacloud.online,485584,ES35209577302742069253,6137.07,2024-08-04T20:47:06,Amurrio,expenses,mortgage,-2944.37,32840.18
buyer_3,Ana,Piñeiro,1989-08-23,25810029G,ana.piñeiro@megacloud.online,485584,ES35209577302742069253,6137.07,2024-08-05T23:14:12,Amurrio,expenses,water,-81.3,32758.88
buyer_3,Ana,Piñeiro,1989-08-23,25810029G,ana.piñeiro@megacloud.online,485584,ES35209577302742069253,6137.07,2024-08-05T16:50:44,Amurrio,expenses,electricity,-78.95,32679.93
buyer_3,Ana,Piñeiro,1989-08-23,25810029G,ana.piñeiro@megacloud.online,485584,ES35209577302742069253,6137.07,2024-08-05T10:41:54,Amurrio,expenses,healthcare,-41.1,32638.83
buyer_3,Ana,Piñeiro,1989-08-23,25810029G,ana.piñeiro@megacloud.online,485584,ES35209577302742069253,6137.07,2024-08-06T12:48:17,Amurrio,expenses,phone,-135.83,32503.0
buyer_3,Ana,Piñeiro,1989-08-23,25810029G,ana.piñeiro@megacloud.online,485584,ES35209577302742069253,6137.07,2024-08-06T13:57:45,Amurrio,expenses,transport,-47.33,32455.67
buyer_3,Ana,Piñeiro,1989-08-23,25810029G,ana.piñeiro@megacloud.online,485584,ES35209577302742069253,6137.07,2024-08-07T11:43:22,Amurrio,expenses,transport,-51.77,32403.9
buyer_3,Ana,Piñeiro,1989-08-23,25810029G,ana.piñeiro@megacloud.online,485584,ES35209577302742069253,6137.07,2024-08-08T18:15:54,Amurrio,expenses,gas,-165.81,32238.09
buyer_3,Ana,Piñeiro,1989-08-23,25810029G,ana.piñeiro@megacloud.online,485584,ES35209577302742069253,6137.07,2024-08-08T12:24:57,Amurrio,expenses,internet,-146.73,32091.36
buyer_3,Ana,Piñeiro,1989-08-23,25810029G,ana.piñeiro@megacloud.online,485584,ES35209577302742069253,6137.07,2024-08-08T19:40:30,Amurrio,expenses,repairs,-85.67,32005.69
buyer_3,Ana,Piñeiro,1989-08-23,25810029G,ana.piñeiro@megacloud.online,485584,ES35209577302742069253,6137.07,2024-08-10T20:55:11,Amurrio,expenses,leisure,-71.49,31934.2
buyer_3,Ana,Piñeiro,1989-08-23,25810029G,ana.piñeiro@megacloud.online,485584,ES35209577302742069253,6137.07,2024-08-10T05:55:07,Amurrio,expenses,cash,-100.0,31834.2
buyer_3,Ana,Piñeiro,1989-08-23,25810029G,ana.piñeiro@megacloud.online,485584,ES35209577302742069253,6137.07,2024-08-11T13:43:38,Amurrio,expenses,clothing,-145.11,31689.09
buyer_3,Ana,Piñeiro,1989-08-23,25810029G,ana.piñeiro@megacloud.online,485584,ES35209577302742069253,6137.07,2024-08-12T12:31:50,Amurrio,expenses,transport,-42.49,31646.6
buyer_3,Ana,Piñeiro,1989-08-23,25810029G,ana.piñeiro@megacloud.online,485584,ES35209577302742069253,6137.07,2024-08-12T05:32:42,Amurrio,expenses,repairs,-175.08,31471.52
buyer_3,Ana,Piñeiro,1989-08-23,25810029G,ana.piñeiro@megacloud.online,485584,ES35209577302742069253,6137.07,2024-08-14T13:11:16,Amurrio,expenses,leisure,-42.4,31429.12
buyer_3,Ana,Piñeiro,1989-08-23,25810029G,ana.piñeiro@megacloud.online,485584,ES35209577302742069253,6137.07,2024-08-15T06:51:58,Amurrio,expenses,food,-117.06,31312.06
buyer_3,Ana,Piñeiro,1989-08-23,25810029G,ana.piñeiro@megacloud.online,485584,ES35209577302742069253,6137.07,2024-08-16T14:43:12,Amurrio,expenses,food,-64.55,31247.51
buyer_3,Ana,Piñeiro,1989-08-23,25810029G,ana.piñeiro@megacloud.online,485584,ES35209577302742069253,6137.07,2024-08-17T20:16:08,Amurrio,expenses,leisure,-81.82,31165.69
buyer_3,Ana,Piñeiro,1989-08-23,25810029G,ana.piñeiro@megacloud.online,485584,ES35209577302742069253,6137.07,2024-08-18T17:13:03,Amurrio,expenses,food,-86.81,31078.88
buyer_3,Ana,Piñeiro,1989-08-23,25810029G,ana.piñeiro@megacloud.online,485584,ES35209577302742069253,6137.07,2024-08-19T17:49:55,Amurrio,expenses,leisure,-36.02,31042.86
buyer_3,Ana,Piñeiro,1989-08-23,25810029G,ana.piñeiro@megacloud.online,485584,ES35209577302742069253,6137.07,2024-08-20T16:35:45,Amurrio,expenses,food,-92.34,30950.52
buyer_3,Ana,Piñeiro,1989-08-23,25810029G,ana.piñeiro@megacloud.online,485584,ES35209577302742069253,6137.07,2024-08-20T17:04:39,Amurrio,expenses,repairs,-134.26,30816.26
buyer_3,Ana,Piñeiro,1989-08-23,25810029G,ana.piñeiro@megacloud.online,485584,ES35209577302742069253,6137.07,2024-08-21T13:35:43,Amurrio,expenses,cash,-100.0,30716.26
buyer_3,Ana,Piñeiro,1989-08-23,25810029G,ana.piñeiro@megacloud.online,485584,ES35209577302742069253,6137.07,2024-08-22T15:25:25,Amurrio,expenses,transport,-41.0,30675.26
buyer_3,Ana,Piñeiro,1989-08-23,25810029G,ana.piñeiro@megacloud.online,485584,ES35209577302742069253,6137.07,2024-08-22T08:15:28,Amurrio,expenses,clothing,-133.93,30541.33
buyer_3,Ana,Piñeiro,1989-08-23,25810029G,ana.piñeiro@megacloud.online,485584,ES35209577302742069253,6137.07,2024-08-22T13:46:37,Amurrio,expenses,gifts,-265.75,30275.58
buyer_3,Ana,Piñeiro,1989-08-23,25810029G,ana.piñeiro@megacloud.online,485584,ES35209577302742069253,6137.07,2024-08-23T14:27:01,Amurrio,expenses,appliances,-220.11,30055.47
buyer_3,Ana,Piñeiro,1989-08-23,25810029G,ana.piñeiro@megacloud.online,485584,ES35209577302742069253,6137.07,2024-08-25T03:40:30,Amurrio,expenses,education,-47.27,30008.2
buyer_3,Ana,Piñeiro,1989-08-23,25810029G,ana.piñeiro@megacloud.online,485584,ES35209577302742069253,6137.07,2024-08-26T10:41:40,Amurrio,expenses,cash,-100.0,29908.2
buyer_3,Ana,Piñeiro,1989-08-23,25810029G,ana.piñeiro@megacloud.online,485584,ES35209577302742069253,6137.07,2024-08-28T15:59:27,Amurrio,expenses,leisure,-47.29,29860.91
buyer_3,Ana,Piñeiro,1989-08-23,25810029G,ana.piñeiro@megacloud.online,485584,ES35209577302742069253,6137.07,2024-08-29T21:19:26,Amurrio,expenses,leisure,-41.63,29819.28
buyer_3,Ana,Piñeiro,1989-08-23,25810029G,ana.piñeiro@megacloud.online,485584,ES35209577302742069253,6137.07,2024-08-30T09:45:34,Amurrio,expenses,cash,-100.0,29719.28
buyer_3,Ana,Piñeiro,1989-08-23,25810029G,ana.piñeiro@megacloud.online,485584,ES35209577302742069253,6137.07,2024-09-01T20:05:59,Amurrio,incomes,salary,3331.83,33051.11
buyer_3,Ana,Piñeiro,1989-08-23,25810029G,ana.piñeiro@megacloud.online,485584,ES35209577302742069253,6137.07,2024-09-01T20:05:59,Amurrio,incomes,salary_partner,3655.4,36706.51
buyer_3,Ana,Piñeiro,1989-08-23,25810029G,ana.piñeiro@megacloud.online,485584,ES35209577302742069253,6137.07,2024-09-01T20:05:59,Amurrio,incomes,extra_income,379.94,37086.45
buyer_3,Ana,Piñeiro,1989-08-23,25810029G,ana.piñeiro@megacloud.online,485584,ES35209577302742069253,6137.07,2024-09-02T13:10:52,Amurrio,expenses,food,-113.94,36972.51
buyer_3,Ana,Piñeiro,1989-08-23,25810029G,ana.piñeiro@megacloud.online,485584,ES35209577302742069253,6137.07,2024-09-02T20:09:01,Amurrio,expenses,cash,-100.0,36872.51
buyer_3,Ana,Piñeiro,1989-08-23,25810029G,ana.piñeiro@megacloud.online,485584,ES35209577302742069253,6137.07,2024-09-02T09:51:33,Amurrio,expenses,appliances,-164.12,36708.39
buyer_3,Ana,Piñeiro,1989-08-23,25810029G,ana.piñeiro@megacloud.online,485584,ES35209577302742069253,6137.07,2024-09-03T15:40:44,Amurrio,expenses,repairs,-110.17,36598.22
buyer_3,Ana,Piñeiro,1989-08-23,25810029G,ana.piñeiro@megacloud.online,485584,ES35209577302742069253,6137.07,2024-09-04T15:11:35,Amurrio,expenses,mortgage,-2944.37,33653.85
buyer_3,Ana,Piñeiro,1989-08-23,25810029G,ana.piñeiro@megacloud.online,485584,ES35209577302742069253,6137.07,2024-09-05T16:23:50,Amurrio,expenses,phone,-130.7,33523.15
buyer_3,Ana,Piñeiro,1989-08-23,25810029G,ana.piñeiro@megacloud.online,485584,ES35209577302742069253,6137.07,2024-09-05T09:09:26,Amurrio,expenses,transport,-72.12,33451.03
buyer_3,Ana,Piñeiro,1989-08-23,25810029G,ana.piñeiro@megacloud.online,485584,ES35209577302742069253,6137.07,2024-09-06T08:37:49,Amurrio,expenses,water,-93.81,33357.22
buyer_3,Ana,Piñeiro,1989-08-23,25810029G,ana.piñeiro@megacloud.online,485584,ES35209577302742069253,6137.07,2024-09-06T14:57:09,Amurrio,expenses,electricity,-84.85,33272.37
buyer_3,Ana,Piñeiro,1989-08-23,25810029G,ana.piñeiro@megacloud.online,485584,ES35209577302742069253,6137.07,2024-09-07T12:39:10,Amurrio,expenses,leisure,-53.5,33218.87
buyer_3,Ana,Piñeiro,1989-08-23,25810029G,ana.piñeiro@megacloud.online,485584,ES35209577302742069253,6137.07,2024-09-08T03:59:58,Amurrio,expenses,gas,-293.5,32925.37
buyer_3,Ana,Piñeiro,1989-08-23,25810029G,ana.piñeiro@megacloud.online,485584,ES35209577302742069253,6137.07,2024-09-08T10:57:36,Amurrio,expenses,internet,-146.73,32778.64
buyer_3,Ana,Piñeiro,1989-08-23,25810029G,ana.piñeiro@megacloud.online,485584,ES35209577302742069253,6137.07,2024-09-10T09:42:22,Amurrio,expenses,gifts,-250.01,32528.63
buyer_3,Ana,Piñeiro,1989-08-23,25810029G,ana.piñeiro@megacloud.online,485584,ES35209577302742069253,6137.07,2024-09-13T02:08:47,Amurrio,expenses,transport,-74.11,32454.52
buyer_3,Ana,Piñeiro,1989-08-23,25810029G,ana.piñeiro@megacloud.online,485584,ES35209577302742069253,6137.07,2024-09-13T12:06:56,Amurrio,expenses,education,-66.25,32388.27
buyer_3,Ana,Piñeiro,1989-08-23,25810029G,ana.piñeiro@megacloud.online,485584,ES35209577302742069253,6137.07,2024-09-15T17:21:21,Amurrio,expenses,cash,-100.0,32288.27
buyer_3,Ana,Piñeiro,1989-08-23,25810029G,ana.piñeiro@megacloud.online,485584,ES35209577302742069253,6137.07,2024-09-18T21:03:48,Amurrio,expenses,food,-71.38,32216.89
buyer_3,Ana,Piñeiro,1989-08-23,25810029G,ana.piñeiro@megacloud.online,485584,ES35209577302742069253,6137.07,2024-09-18T11:09:03,Amurrio,expenses,cash,-100.0,32116.89
buyer_3,Ana,Piñeiro,1989-08-23,25810029G,ana.piñeiro@megacloud.online,485584,ES35209577302742069253,6137.07,2024-09-21T19:31:59,Amurrio,expenses,food,-113.9,32002.99
buyer_3,Ana,Piñeiro,1989-08-23,25810029G,ana.piñeiro@megacloud.online,485584,ES35209577302742069253,6137.07,2024-09-23T17:32:22,Amurrio,expenses,food,-96.27,31906.72
buyer_3,Ana,Piñeiro,1989-08-23,25810029G,ana.piñeiro@megacloud.online,485584,ES35209577302742069253,6137.07,2024-09-23T17:26:42,Amurrio,expenses,transport,-79.45,31827.27
buyer_3,Ana,Piñeiro,1989-08-23,25810029G,ana.piñeiro@megacloud.online,485584,ES35209577302742069253,6137.07,2024-09-24T17:06:51,Amurrio,expenses,transport,-44.72,31782.55
buyer_3,Ana,Piñeiro,1989-08-23,25810029G,ana.piñeiro@megacloud.online,485584,ES35209577302742069253,6137.07,2024-09-25T11:23:38,Amurrio,expenses,leisure,-18.99,31763.56
buyer_3,Ana,Piñeiro,1989-08-23,25810029G,ana.piñeiro@megacloud.online,485584,ES35209577302742069253,6137.07,2024-09-25T09:53:18,Amurrio,expenses,cash,-100.0,31663.56
buyer_3,Ana,Piñeiro,1989-08-23,25810029G,ana.piñeiro@megacloud.online,485584,ES35209577302742069253,6137.07,2024-09-27T16:45:21,Amurrio,expenses,clothing,-73.92,31589.64
buyer_3,Ana,Piñeiro,1989-08-23,25810029G,ana.piñeiro@megacloud.online,485584,ES35209577302742069253,6137.07,2024-09-29T10:54:35,Amurrio,expenses,food,-91.58,31498.06
buyer_3,Ana,Piñeiro,1989-08-23,25810029G,ana.piñeiro@megacloud.online,485584,ES35209577302742069253,6137.07,2024-09-29T10:04:26,Amurrio,expenses,cash,-100.0,31398.06
buyer_3,Ana,Piñeiro,1989-08-23,25810029G,ana.piñeiro@megacloud.online,485584,ES35209577302742069253,6137.07,2024-10-01T15:38:23,Amurrio,incomes,salary,3331.83,34729.89
buyer_3,Ana,Piñeiro,1989-08-23,25810029G,ana.piñeiro@megacloud.online,485584,ES35209577302742069253,6137.07,2024-10-01T15:38:23,Amurrio,incomes,salary_partner,3655.4,38385.29
buyer_3,Ana,Piñeiro,1989-08-23,25810029G,ana.piñeiro@megacloud.online,485584,ES35209577302742069253,6137.07,2024-10-01T20:47:03,Amurrio,expenses,cash,-100.0,38285.29
buyer_3,Ana,Piñeiro,1989-08-23,25810029G,ana.piñeiro@megacloud.online,485584,ES35209577302742069253,6137.07,2024-10-02T21:48:27,Amurrio,expenses,food,-93.91,38191.38
buyer_3,Ana,Piñeiro,1989-08-23,25810029G,ana.piñeiro@megacloud.online,485584,ES35209577302742069253,6137.07,2024-10-02T21:47:39,Amurrio,expenses,cash,-100.0,38091.38
buyer_3,Ana,Piñeiro,1989-08-23,25810029G,ana.piñeiro@megacloud.online,485584,ES35209577302742069253,6137.07,2024-10-03T08:46:35,Amurrio,expenses,transport,-59.96,38031.42
buyer_3,Ana,Piñeiro,1989-08-23,25810029G,ana.piñeiro@megacloud.online,485584,ES35209577302742069253,6137.07,2024-10-04T01:40:36,Amurrio,expenses,mortgage,-2944.37,35087.05
buyer_3,Ana,Piñeiro,1989-08-23,25810029G,ana.piñeiro@megacloud.online,485584,ES35209577302742069253,6137.07,2024-10-05T09:53:19,Amurrio,expenses,gas,-240.7,34846.35
buyer_3,Ana,Piñeiro,1989-08-23,25810029G,ana.piñeiro@megacloud.online,485584,ES35209577302742069253,6137.07,2024-10-05T01:03:58,Amurrio,expenses,phone,-121.17,34725.18
buyer_3,Ana,Piñeiro,1989-08-23,25810029G,ana.piñeiro@megacloud.online,485584,ES35209577302742069253,6137.07,2024-10-05T10:51:40,Amurrio,expenses,transport,-67.66,34657.52
buyer_3,Ana,Piñeiro,1989-08-23,25810029G,ana.piñeiro@megacloud.online,485584,ES35209577302742069253,6137.07,2024-10-05T16:20:24,Amurrio,expenses,leisure,-50.88,34606.64
buyer_3,Ana,Piñeiro,1989-08-23,25810029G,ana.piñeiro@megacloud.online,485584,ES35209577302742069253,6137.07,2024-10-05T05:46:06,Amurrio,expenses,education,-64.58,34542.06
buyer_3,Ana,Piñeiro,1989-08-23,25810029G,ana.piñeiro@megacloud.online,485584,ES35209577302742069253,6137.07,2024-10-06T16:52:41,Amurrio,expenses,water,-103.36,34438.7
buyer_3,Ana,Piñeiro,1989-08-23,25810029G,ana.piñeiro@megacloud.online,485584,ES35209577302742069253,6137.07,2024-10-08T14:24:18,Amurrio,expenses,electricity,-174.16,34264.54
buyer_3,Ana,Piñeiro,1989-08-23,25810029G,ana.piñeiro@megacloud.online,485584,ES35209577302742069253,6137.07,2024-10-08T10:50:05,Amurrio,expenses,internet,-146.73,34117.81
buyer_4,Jorge,Moreno,1974-05-23,32144178E,jorge.moreno@coolnet.site,679449,ES86209540321172255358,5267.8,2022-01-01T14:47:35,Galdakao,incomes,salary,2839.93,8107.73
buyer_4,Jorge,Moreno,1974-05-23,32144178E,jorge.moreno@coolnet.site,679449,ES86209540321172255358,5267.8,2022-01-02T12:14:07,Galdakao,expenses,leisure,-51.13,8056.6
buyer_4,Jorge,Moreno,1974-05-23,32144178E,jorge.moreno@coolnet.site,679449,ES86209540321172255358,5267.8,2022-01-02T08:46:42,Galdakao,expenses,cash,-100.0,7956.6
buyer_4,Jorge,Moreno,1974-05-23,32144178E,jorge.moreno@coolnet.site,679449,ES86209540321172255358,5267.8,2022-01-04T16:29:12,Galdakao,expenses,mortgage,-1267.06,6689.54
buyer_4,Jorge,Moreno,1974-05-23,32144178E,jorge.moreno@coolnet.site,679449,ES86209540321172255358,5267.8,2022-01-06T17:21:54,Galdakao,expenses,gas,-63.53,6626.01
buyer_4,Jorge,Moreno,1974-05-23,32144178E,jorge.moreno@coolnet.site,679449,ES86209540321172255358,5267.8,2022-01-06T13:17:40,Galdakao,expenses,phone,-53.31,6572.7
buyer_4,Jorge,Moreno,1974-05-23,32144178E,jorge.moreno@coolnet.site,679449,ES86209540321172255358,5267.8,2022-01-06T10:29:44,Galdakao,expenses,food,-94.36,6478.34
buyer_4,Jorge,Moreno,1974-05-23,32144178E,jorge.moreno@coolnet.site,679449,ES86209540321172255358,5267.8,2022-01-08T14:35:57,Galdakao,expenses,water,-37.81,6440.53
buyer_4,Jorge,Moreno,1974-05-23,32144178E,jorge.moreno@coolnet.site,679449,ES86209540321172255358,5267.8,2022-01-08T09:53:52,Galdakao,expenses,electricity,-72.15,6368.38
buyer_4,Jorge,Moreno,1974-05-23,32144178E,jorge.moreno@coolnet.site,679449,ES86209540321172255358,5267.8,2022-01-08T09:55:15,Galdakao,expenses,internet,-59.64,6308.74
buyer_4,Jorge,Moreno,1974-05-23,32144178E,jorge.moreno@coolnet.site,679449,ES86209540321172255358,5267.8,2022-01-09T08:52:07,Galdakao,expenses,food,-95.95,6212.79
buyer_4,Jorge,Moreno,1974-05-23,32144178E,jorge.moreno@coolnet.site,679449,ES86209540321172255358,5267.8,2022-01-09T13:33:46,Galdakao,expenses,children,-1110.0634166666664,5102.73
buyer_4,Jorge,Moreno,1974-05-23,32144178E,jorge.moreno@coolnet.site,679449,ES86209540321172255358,5267.8,2022-01-14T18:32:13,Galdakao,expenses,leisure,-34.94,5067.79
buyer_4,Jorge,Moreno,1974-05-23,32144178E,jorge.moreno@coolnet.site,679449,ES86209540321172255358,5267.8,2022-01-14T18:19:19,Galdakao,expenses,appliances,-149.54,4918.25
buyer_4,Jorge,Moreno,1974-05-23,32144178E,jorge.moreno@coolnet.site,679449,ES86209540321172255358,5267.8,2022-01-15T17:43:01,Galdakao,expenses,transport,-81.65,4836.6
buyer_4,Jorge,Moreno,1974-05-23,32144178E,jorge.moreno@coolnet.site,679449,ES86209540321172255358,5267.8,2022-01-15T19:40:23,Galdakao,expenses,gifts,-221.42,4615.18
buyer_4,Jorge,Moreno,1974-05-23,32144178E,jorge.moreno@coolnet.site,679449,ES86209540321172255358,5267.8,2022-01-16T08:43:50,Galdakao,expenses,cash,-100.0,4515.18
buyer_4,Jorge,Moreno,1974-05-23,32144178E,jorge.moreno@coolnet.site,679449,ES86209540321172255358,5267.8,2022-01-17T16:09:39,Galdakao,expenses,education,-65.96,4449.22
buyer_4,Jorge,Moreno,1974-05-23,32144178E,jorge.moreno@coolnet.site,679449,ES86209540321172255358,5267.8,2022-01-17T13:25:06,Galdakao,expenses,travel,-710.91,3738.31
buyer_4,Jorge,Moreno,1974-05-23,32144178E,jorge.moreno@coolnet.site,679449,ES86209540321172255358,5267.8,2022-01-18T18:13:39,Galdakao,expenses,clothing,-59.53,3678.78
buyer_4,Jorge,Moreno,1974-05-23,32144178E,jorge.moreno@coolnet.site,679449,ES86209540321172255358,5267.8,2022-01-18T03:56:37,Galdakao,expenses,education,-66.36,3612.42
buyer_4,Jorge,Moreno,1974-05-23,32144178E,jorge.moreno@coolnet.site,679449,ES86209540321172255358,5267.8,2022-01-20T12:48:34,Galdakao,expenses,cash,-100.0,3512.42
buyer_4,Jorge,Moreno,1974-05-23,32144178E,jorge.moreno@coolnet.site,679449,ES86209540321172255358,5267.8,2022-01-24T12:28:51,Galdakao,expenses,gifts,-617.28,2895.14
buyer_4,Jorge,Moreno,1974-05-23,32144178E,jorge.moreno@coolnet.site,679449,ES86209540321172255358,5267.8,2022-01-25T20:51:56,Galdakao,expenses,education,-55.17,2839.97
buyer_4,Jorge,Moreno,1974-05-23,32144178E,jorge.moreno@coolnet.site,679449,ES86209540321172255358,5267.8,2022-01-25T21:57:16,Galdakao,expenses,gifts,-106.63,2733.34
buyer_4,Jorge,Moreno,1974-05-23,32144178E,jorge.moreno@coolnet.site,679449,ES86209540321172255358,5267.8,2022-01-26T13:06:08,Galdakao,expenses,cash,-100.0,2633.34
buyer_4,Jorge,Moreno,1974-05-23,32144178E,jorge.moreno@coolnet.site,679449,ES86209540321172255358,5267.8,2022-01-30T11:25:02,Galdakao,expenses,cash,-100.0,2533.34
buyer_4,Jorge,Moreno,1974-05-23,32144178E,jorge.moreno@coolnet.site,679449,ES86209540321172255358,5267.8,2022-02-01T03:24:33,Galdakao,incomes,salary,2839.93,5373.27
buyer_4,Jorge,Moreno,1974-05-23,32144178E,jorge.moreno@coolnet.site,679449,ES86209540321172255358,5267.8,2022-02-01T11:35:30,Galdakao,expenses,gifts,-559.52,4813.75
buyer_4,Jorge,Moreno,1974-05-23,32144178E,jorge.moreno@coolnet.site,679449,ES86209540321172255358,5267.8,2022-02-03T22:24:25,Galdakao,expenses,food,-70.5,4743.25
buyer_4,Jorge,Moreno,1974-05-23,32144178E,jorge.moreno@coolnet.site,679449,ES86209540321172255358,5267.8,2022-02-04T08:12:44,Galdakao,expenses,mortgage,-1267.06,3476.19
buyer_4,Jorge,Moreno,1974-05-23,32144178E,jorge.moreno@coolnet.site,679449,ES86209540321172255358,5267.8,2022-02-05T16:07:04,Galdakao,expenses,internet,-59.64,3416.55
buyer_4,Jorge,Moreno,1974-05-23,32144178E,jorge.moreno@coolnet.site,679449,ES86209540321172255358,5267.8,2022-02-06T13:04:17,Galdakao,expenses,transport,-67.39,3349.16
buyer_4,Jorge,Moreno,1974-05-23,32144178E,jorge.moreno@coolnet.site,679449,ES86209540321172255358,5267.8,2022-02-06T07:28:45,Galdakao,expenses,education,-56.17,3292.99
buyer_4,Jorge,Moreno,1974-05-23,32144178E,jorge.moreno@coolnet.site,679449,ES86209540321172255358,5267.8,2022-02-07T08:03:45,Galdakao,expenses,phone,-54.73,3238.26
buyer_4,Jorge,Moreno,1974-05-23,32144178E,jorge.moreno@coolnet.site,679449,ES86209540321172255358,5267.8,2022-02-08T16:03:44,Galdakao,expenses,water,-58.84,3179.42
buyer_4,Jorge,Moreno,1974-05-23,32144178E,jorge.moreno@coolnet.site,679449,ES86209540321172255358,5267.8,2022-02-08T11:05:37,Galdakao,expenses,electricity,-85.88,3093.54
buyer_4,Jorge,Moreno,1974-05-23,32144178E,jorge.moreno@coolnet.site,679449,ES86209540321172255358,5267.8,2022-02-08T20:55:31,Galdakao,expenses,gas,-63.29,3030.25
buyer_4,Jorge,Moreno,1974-05-23,32144178E,jorge.moreno@coolnet.site,679449,ES86209540321172255358,5267.8,2022-02-09T04:03:20,Galdakao,expenses,transport,-51.7,2978.55
buyer_4,Jorge,Moreno,1974-05-23,32144178E,jorge.moreno@coolnet.site,679449,ES86209540321172255358,5267.8,2022-02-09T14:09:54,Galdakao,expenses,leisure,-76.84,2901.71
buyer_4,Jorge,Moreno,1974-05-23,32144178E,jorge.moreno@coolnet.site,679449,ES86209540321172255358,5267.8,2022-02-10T12:13:04,Galdakao,expenses,repairs,-256.95,2644.76
buyer_4,Jorge,Moreno,1974-05-23,32144178E,jorge.moreno@coolnet.site,679449,ES86209540321172255358,5267.8,2022-02-11T12:12:12,Galdakao,expenses,leisure,-44.59,2600.17
buyer_4,Jorge,Moreno,1974-05-23,32144178E,jorge.moreno@coolnet.site,679449,ES86209540321172255358,5267.8,2022-02-11T11:33:33,Galdakao,expenses,cash,-100.0,2500.17
buyer_4,Jorge,Moreno,1974-05-23,32144178E,jorge.moreno@coolnet.site,679449,ES86209540321172255358,5267.8,2022-02-11T22:05:42,Galdakao,expenses,gifts,-251.23,2248.94
buyer_4,Jorge,Moreno,1974-05-23,32144178E,jorge.moreno@coolnet.site,679449,ES86209540321172255358,5267.8,2022-02-12T11:50:55,Galdakao,expenses,transport,-83.84,2165.1
buyer_4,Jorge,Moreno,1974-05-23,32144178E,jorge.moreno@coolnet.site,679449,ES86209540321172255358,5267.8,2022-02-12T15:29:58,Galdakao,expenses,cash,-100.0,2065.1
buyer_4,Jorge,Moreno,1974-05-23,32144178E,jorge.moreno@coolnet.site,679449,ES86209540321172255358,5267.8,2022-02-12T20:22:19,Galdakao,expenses,gifts,-510.0,1555.1
buyer_4,Jorge,Moreno,1974-05-23,32144178E,jorge.moreno@coolnet.site,679449,ES86209540321172255358,5267.8,2022-02-14T23:28:15,Galdakao,expenses,transport,-40.0,1515.1
buyer_4,Jorge,Moreno,1974-05-23,32144178E,jorge.moreno@coolnet.site,679449,ES86209540321172255358,5267.8,2022-02-16T15:14:22,Galdakao,expenses,leisure,-69.07,1446.03
buyer_4,Jorge,Moreno,1974-05-23,32144178E,jorge.moreno@coolnet.site,679449,ES86209540321172255358,5267.8,2022-02-21T20:38:34,Galdakao,expenses,cash,-100.0,1346.03
buyer_4,Jorge,Moreno,1974-05-23,32144178E,jorge.moreno@coolnet.site,679449,ES86209540321172255358,5267.8,2022-02-23T11:11:37,Galdakao,expenses,leisure,-59.37,1286.66
buyer_4,Jorge,Moreno,1974-05-23,32144178E,jorge.moreno@coolnet.site,679449,ES86209540321172255358,5267.8,2022-02-23T18:33:33,Galdakao,expenses,clothing,-126.72,1159.94
buyer_4,Jorge,Moreno,1974-05-23,32144178E,jorge.moreno@coolnet.site,679449,ES86209540321172255358,5267.8,2022-02-24T06:01:33,Galdakao,expenses,cash,-100.0,1059.94
buyer_4,Jorge,Moreno,1974-05-23,32144178E,jorge.moreno@coolnet.site,679449,ES86209540321172255358,5267.8,2022-02-25T16:11:01,Galdakao,expenses,food,-121.44,938.5
buyer_4,Jorge,Moreno,1974-05-23,32144178E,jorge.moreno@coolnet.site,679449,ES86209540321172255358,5267.8,2022-02-25T12:56:27,Galdakao,expenses,transport,-82.68,855.82
buyer_4,Jorge,Moreno,1974-05-23,32144178E,jorge.moreno@coolnet.site,679449,ES86209540321172255358,5267.8,2022-02-27T13:33:32,Galdakao,expenses,transport,-82.34,773.48
buyer_4,Jorge,Moreno,1974-05-23,32144178E,jorge.moreno@coolnet.site,679449,ES86209540321172255358,5267.8,2022-03-01T14:14:38,Galdakao,incomes,salary,2839.93,3613.41
buyer_4,Jorge,Moreno,1974-05-23,32144178E,jorge.moreno@coolnet.site,679449,ES86209540321172255358,5267.8,2022-03-01T08:48:05,Galdakao,expenses,cash,-100.0,3513.41
buyer_4,Jorge,Moreno,1974-05-23,32144178E,jorge.moreno@coolnet.site,679449,ES86209540321172255358,5267.8,2022-03-02T12:30:06,Galdakao,expenses,healthcare,-52.9,3460.51
buyer_4,Jorge,Moreno,1974-05-23,32144178E,jorge.moreno@coolnet.site,679449,ES86209540321172255358,5267.8,2022-03-04T20:58:30,Galdakao,expenses,mortgage,-1267.06,2193.45
buyer_4,Jorge,Moreno,1974-05-23,32144178E,jorge.moreno@coolnet.site,679449,ES86209540321172255358,5267.8,2022-03-04T14:55:49,Galdakao,expenses,gifts,-573.02,1620.43
buyer_4,Jorge,Moreno,1974-05-23,32144178E,jorge.moreno@coolnet.site,679449,ES86209540321172255358,5267.8,2022-03-05T15:31:37,Galdakao,expenses,internet,-59.64,1560.79
buyer_4,Jorge,Moreno,1974-05-23,32144178E,jorge.moreno@coolnet.site,679449,ES86209540321172255358,5267.8,2022-03-05T14:43:55,Galdakao,expenses,phone,-47.06,1513.73
buyer_4,Jorge,Moreno,1974-05-23,32144178E,jorge.moreno@coolnet.site,679449,ES86209540321172255358,5267.8,2022-03-06T15:14:17,Galdakao,expenses,water,-40.27,1473.46
buyer_4,Jorge,Moreno,1974-05-23,32144178E,jorge.moreno@coolnet.site,679449,ES86209540321172255358,5267.8,2022-03-06T13:07:48,Galdakao,expenses,gas,-107.37,1366.09
buyer_4,Jorge,Moreno,1974-05-23,32144178E,jorge.moreno@coolnet.site,679449,ES86209540321172255358,5267.8,2022-03-06T11:01:12,Galdakao,expenses,cash,-100.0,1266.09
buyer_4,Jorge,Moreno,1974-05-23,32144178E,jorge.moreno@coolnet.site,679449,ES86209540321172255358,5267.8,2022-03-06T17:15:27,Galdakao,expenses,repairs,-175.34,1090.75
buyer_4,Jorge,Moreno,1974-05-23,32144178E,jorge.moreno@coolnet.site,679449,ES86209540321172255358,5267.8,2022-03-06T19:01:53,Galdakao,expenses,children,-401.28,689.47
buyer_4,Jorge,Moreno,1974-05-23,32144178E,jorge.moreno@coolnet.site,679449,ES86209540321172255358,5267.8,2022-03-07T16:11:10,Galdakao,expenses,electricity,-31.82,657.65
buyer_4,Jorge,Moreno,1974-05-23,32144178E,jorge.moreno@coolnet.site,679449,ES86209540321172255358,5267.8,2022-03-12T16:23:18,Galdakao,expenses,cash,-100.0,557.65
buyer_4,Jorge,Moreno,1974-05-23,32144178E,jorge.moreno@coolnet.site,679449,ES86209540321172255358,5267.8,2022-03-13T14:48:37,Galdakao,expenses,education,-69.42,488.23
buyer_4,Jorge,Moreno,1974-05-23,32144178E,jorge.moreno@coolnet.site,679449,ES86209540321172255358,5267.8,2022-03-13T14:36:58,Galdakao,expenses,cash,-100.0,388.23
buyer_4,Jorge,Moreno,1974-05-23,32144178E,jorge.moreno@coolnet.site,679449,ES86209540321172255358,5267.8,2022-03-13T18:13:50,Galdakao,expenses,gifts,-502.53,-114.3
buyer_4,Jorge,Moreno,1974-05-23,32144178E,jorge.moreno@coolnet.site,679449,ES86209540321172255358,5267.8,2022-03-15T17:45:48,Galdakao,expenses,transport,-47.89,-162.19
buyer_4,Jorge,Moreno,1974-05-23,32144178E,jorge.moreno@coolnet.site,679449,ES86209540321172255358,5267.8,2022-03-15T13:33:42,Galdakao,expenses,leisure,-42.67,-204.86
buyer_4,Jorge,Moreno,1974-05-23,32144178E,jorge.moreno@coolnet.site,679449,ES86209540321172255358,5267.8,2022-03-18T09:10:43,Galdakao,expenses,transport,-66.2,-271.06
buyer_4,Jorge,Moreno,1974-05-23,32144178E,jorge.moreno@coolnet.site,679449,ES86209540321172255358,5267.8,2022-03-23T08:47:31,Galdakao,expenses,transport,-68.96,-340.02
buyer_4,Jorge,Moreno,1974-05-23,32144178E,jorge.moreno@coolnet.site,679449,ES86209540321172255358,5267.8,2022-03-25T04:10:53,Galdakao,expenses,food,-114.86,-454.88
buyer_4,Jorge,Moreno,1974-05-23,32144178E,jorge.moreno@coolnet.site,679449,ES86209540321172255358,5267.8,2022-03-25T12:59:37,Galdakao,expenses,transport,-83.83,-538.71
buyer_4,Jorge,Moreno,1974-05-23,32144178E,jorge.moreno@coolnet.site,679449,ES86209540321172255358,5267.8,2022-03-26T16:06:40,Galdakao,expenses,food,-77.53,-616.24
buyer_4,Jorge,Moreno,1974-05-23,32144178E,jorge.moreno@coolnet.site,679449,ES86209540321172255358,5267.8,2022-03-26T19:04:12,Galdakao,expenses,cash,-100.0,-716.24
buyer_4,Jorge,Moreno,1974-05-23,32144178E,jorge.moreno@coolnet.site,679449,ES86209540321172255358,5267.8,2022-03-29T10:36:24,Galdakao,expenses,food,-75.31,-791.55
buyer_4,Jorge,Moreno,1974-05-23,32144178E,jorge.moreno@coolnet.site,679449,ES86209540321172255358,5267.8,2022-03-30T15:24:53,Galdakao,expenses,appliances,-102.95,-894.5
buyer_4,Jorge,Moreno,1974-05-23,32144178E,jorge.moreno@coolnet.site,679449,ES86209540321172255358,5267.8,2022-03-31T17:58:39,Galdakao,expenses,education,-74.83,-969.33
buyer_4,Jorge,Moreno,1974-05-23,32144178E,jorge.moreno@coolnet.site,679449,ES86209540321172255358,5267.8,2022-04-01T10:48:40,Galdakao,incomes,salary,2839.93,1870.6
buyer_4,Jorge,Moreno,1974-05-23,32144178E,jorge.moreno@coolnet.site,679449,ES86209540321172255358,5267.8,2022-04-01T10:48:40,Galdakao,incomes,extra_income,338.65,2209.25
buyer_4,Jorge,Moreno,1974-05-23,32144178E,jorge.moreno@coolnet.site,679449,ES86209540321172255358,5267.8,2022-04-04T10:42:36,Galdakao,expenses,mortgage,-1267.06,942.19
buyer_4,Jorge,Moreno,1974-05-23,32144178E,jorge.moreno@coolnet.site,679449,ES86209540321172255358,5267.8,2022-04-04T20:18:29,Galdakao,expenses,food,-94.62,847.57
buyer_4,Jorge,Moreno,1974-05-23,32144178E,jorge.moreno@coolnet.site,679449,ES86209540321172255358,5267.8,2022-04-05T18:03:23,Galdakao,expenses,electricity,-97.67,749.9
buyer_4,Jorge,Moreno,1974-05-23,32144178E,jorge.moreno@coolnet.site,679449,ES86209540321172255358,5267.8,2022-04-05T17:55:06,Galdakao,expenses,appliances,-168.85,581.05
buyer_4,Jorge,Moreno,1974-05-23,32144178E,jorge.moreno@coolnet.site,679449,ES86209540321172255358,5267.8,2022-04-07T20:19:40,Galdakao,expenses,gas,-102.32,478.73
buyer_4,Jorge,Moreno,1974-05-23,32144178E,jorge.moreno@coolnet.site,679449,ES86209540321172255358,5267.8,2022-04-07T21:25:58,Galdakao,expenses,internet,-59.64,419.09
buyer_4,Jorge,Moreno,1974-05-23,32144178E,jorge.moreno@coolnet.site,679449,ES86209540321172255358,5267.8,2022-04-08T07:57:29,Galdakao,expenses,phone,-48.82,370.27
buyer_4,Jorge,Moreno,1974-05-23,32144178E,jorge.moreno@coolnet.site,679449,ES86209540321172255358,5267.8,2022-04-08T11:44:07,Galdakao,expenses,water,-40.61,329.66
buyer_4,Jorge,Moreno,1974-05-23,32144178E,jorge.moreno@coolnet.site,679449,ES86209540321172255358,5267.8,2022-04-10T12:31:48,Galdakao,expenses,cash,-100.0,229.66
buyer_4,Jorge,Moreno,1974-05-23,32144178E,jorge.moreno@coolnet.site,679449,ES86209540321172255358,5267.8,2022-04-12T11:09:50,Galdakao,expenses,cash,-100.0,129.66
buyer_4,Jorge,Moreno,1974-05-23,32144178E,jorge.moreno@coolnet.site,679449,ES86209540321172255358,5267.8,2022-04-13T15:35:32,Galdakao,expenses,clothing,-95.57,34.09
buyer_4,Jorge,Moreno,1974-05-23,32144178E,jorge.moreno@coolnet.site,679449,ES86209540321172255358,5267.8,2022-04-14T20:18:33,Galdakao,expenses,transport,-49.19,-15.1
buyer_4,Jorge,Moreno,1974-05-23,32144178E,jorge.moreno@coolnet.site,679449,ES86209540321172255358,5267.8,2022-04-16T10:18:36,Galdakao,expenses,transport,-77.65,-92.75
buyer_4,Jorge,Moreno,1974-05-23,32144178E,jorge.moreno@coolnet.site,679449,ES86209540321172255358,5267.8,2022-04-17T11:44:20,Galdakao,expenses,children,-1206.0134166666664,-1298.76
buyer_4,Jorge,Moreno,1974-05-23,32144178E,jorge.moreno@coolnet.site,679449,ES86209540321172255358,5267.8,2022-04-18T16:50:31,Galdakao,expenses,food,-76.47,-1375.23
buyer_4,Jorge,Moreno,1974-05-23,32144178E,jorge.moreno@coolnet.site,679449,ES86209540321172255358,5267.8,2022-04-19T17:58:49,Galdakao,expenses,food,-122.98,-1498.21
buyer_4,Jorge,Moreno,1974-05-23,32144178E,jorge.moreno@coolnet.site,679449,ES86209540321172255358,5267.8,2022-04-21T12:20:56,Galdakao,expenses,food,-111.7,-1609.91
buyer_4,Jorge,Moreno,1974-05-23,32144178E,jorge.moreno@coolnet.site,679449,ES86209540321172255358,5267.8,2022-04-21T16:27:32,Galdakao,expenses,education,-67.46,-1677.37
buyer_4,Jorge,Moreno,1974-05-23,32144178E,jorge.moreno@coolnet.site,679449,ES86209540321172255358,5267.8,2022-04-22T16:45:23,Galdakao,expenses,education,-52.83,-1730.2
buyer_4,Jorge,Moreno,1974-05-23,32144178E,jorge.moreno@coolnet.site,679449,ES86209540321172255358,5267.8,2022-04-24T14:25:34,Galdakao,expenses,repairs,-115.01,-1845.21
buyer_4,Jorge,Moreno,1974-05-23,32144178E,jorge.moreno@coolnet.site,679449,ES86209540321172255358,5267.8,2022-04-27T15:21:00,Galdakao,expenses,food,-106.04,-1951.25
buyer_4,Jorge,Moreno,1974-05-23,32144178E,jorge.moreno@coolnet.site,679449,ES86209540321172255358,5267.8,2022-04-27T10:03:49,Galdakao,expenses,transport,-73.16,-2024.41
buyer_4,Jorge,Moreno,1974-05-23,32144178E,jorge.moreno@coolnet.site,679449,ES86209540321172255358,5267.8,2022-04-27T09:51:04,Galdakao,expenses,education,-64.1,-2088.51
buyer_4,Jorge,Moreno,1974-05-23,32144178E,jorge.moreno@coolnet.site,679449,ES86209540321172255358,5267.8,2022-04-29T14:16:54,Galdakao,expenses,leisure,-76.2,-2164.71
buyer_4,Jorge,Moreno,1974-05-23,32144178E,jorge.moreno@coolnet.site,679449,ES86209540321172255358,5267.8,2022-04-29T12:32:47,Galdakao,expenses,healthcare,-172.01,-2336.72
buyer_4,Jorge,Moreno,1974-05-23,32144178E,jorge.moreno@coolnet.site,679449,ES86209540321172255358,5267.8,2022-04-29T18:38:19,Galdakao,expenses,education,-71.16,-2407.88
buyer_4,Jorge,Moreno,1974-05-23,32144178E,jorge.moreno@coolnet.site,679449,ES86209540321172255358,5267.8,2022-05-01T10:12:56,Galdakao,incomes,salary,2839.93,432.05
buyer_4,Jorge,Moreno,1974-05-23,32144178E,jorge.moreno@coolnet.site,679449,ES86209540321172255358,5267.8,2022-05-02T08:03:53,Galdakao,expenses,leisure,-26.33,405.72
buyer_4,Jorge,Moreno,1974-05-23,32144178E,jorge.moreno@coolnet.site,679449,ES86209540321172255358,5267.8,2022-05-04T16:14:03,Galdakao,expenses,mortgage,-1267.06,-861.34
buyer_4,Jorge,Moreno,1974-05-23,32144178E,jorge.moreno@coolnet.site,679449,ES86209540321172255358,5267.8,2022-05-04T14:24:34,Galdakao,expenses,food,-61.52,-922.86
buyer_4,Jorge,Moreno,1974-05-23,32144178E,jorge.moreno@coolnet.site,679449,ES86209540321172255358,5267.8,2022-05-04T08:19:35,Galdakao,expenses,transport,-85.26,-1008.12
buyer_4,Jorge,Moreno,1974-05-23,32144178E,jorge.moreno@coolnet.site,679449,ES86209540321172255358,5267.8,2022-05-05T18:40:06,Galdakao,expenses,gas,-49.21,-1057.33
buyer_4,Jorge,Moreno,1974-05-23,32144178E,jorge.moreno@coolnet.site,679449,ES86209540321172255358,5267.8,2022-05-06T20:33:05,Galdakao,expenses,water,-47.31,-1104.64
buyer_4,Jorge,Moreno,1974-05-23,32144178E,jorge.moreno@coolnet.site,679449,ES86209540321172255358,5267.8,2022-05-06T02:13:02,Galdakao,expenses,repairs,-253.77,-1358.41
buyer_4,Jorge,Moreno,1974-05-23,32144178E,jorge.moreno@coolnet.site,679449,ES86209540321172255358,5267.8,2022-05-07T17:05:04,Galdakao,expenses,phone,-52.61,-1411.02
buyer_4,Jorge,Moreno,1974-05-23,32144178E,jorge.moreno@coolnet.site,679449,ES86209540321172255358,5267.8,2022-05-08T08:58:33,Galdakao,expenses,electricity,-125.49,-1536.51
buyer_4,Jorge,Moreno,1974-05-23,32144178E,jorge.moreno@coolnet.site,679449,ES86209540321172255358,5267.8,2022-05-08T23:57:33,Galdakao,expenses,internet,-59.64,-1596.15
buyer_4,Jorge,Moreno,1974-05-23,32144178E,jorge.moreno@coolnet.site,679449,ES86209540321172255358,5267.8,2022-05-09T08:26:49,Galdakao,expenses,transport,-81.95,-1678.1
buyer_4,Jorge,Moreno,1974-05-23,32144178E,jorge.moreno@coolnet.site,679449,ES86209540321172255358,5267.8,2022-05-09T15:19:12,Galdakao,expenses,education,-60.44,-1738.54
buyer_4,Jorge,Moreno,1974-05-23,32144178E,jorge.moreno@coolnet.site,679449,ES86209540321172255358,5267.8,2022-05-10T11:49:58,Galdakao,expenses,leisure,-37.94,-1776.48
buyer_4,Jorge,Moreno,1974-05-23,32144178E,jorge.moreno@coolnet.site,679449,ES86209540321172255358,5267.8,2022-05-10T12:31:43,Galdakao,expenses,repairs,-263.11,-2039.59
buyer_4,Jorge,Moreno,1974-05-23,32144178E,jorge.moreno@coolnet.site,679449,ES86209540321172255358,5267.8,2022-05-10T20:53:21,Galdakao,expenses,gifts,-613.25,-2652.84
buyer_4,Jorge,Moreno,1974-05-23,32144178E,jorge.moreno@coolnet.site,679449,ES86209540321172255358,5267.8,2022-05-12T01:25:41,Galdakao,expenses,repairs,-156.06,-2808.9
buyer_4,Jorge,Moreno,1974-05-23,32144178E,jorge.moreno@coolnet.site,679449,ES86209540321172255358,5267.8,2022-05-13T18:14:33,Galdakao,expenses,cash,-100.0,-2908.9
buyer_4,Jorge,Moreno,1974-05-23,32144178E,jorge.moreno@coolnet.site,679449,ES86209540321172255358,5267.8,2022-05-16T09:35:37,Galdakao,expenses,food,-116.05,-3024.95
buyer_4,Jorge,Moreno,1974-05-23,32144178E,jorge.moreno@coolnet.site,679449,ES86209540321172255358,5267.8,2022-05-17T16:20:34,Galdakao,expenses,food,-123.69,-3148.64
buyer_4,Jorge,Moreno,1974-05-23,32144178E,jorge.moreno@coolnet.site,679449,ES86209540321172255358,5267.8,2022-05-17T23:41:58,Galdakao,expenses,clothing,-138.34,-3286.98
buyer_4,Jorge,Moreno,1974-05-23,32144178E,jorge.moreno@coolnet.site,679449,ES86209540321172255358,5267.8,2022-05-19T17:39:50,Galdakao,expenses,food,-109.78,-3396.76
buyer_4,Jorge,Moreno,1974-05-23,32144178E,jorge.moreno@coolnet.site,679449,ES86209540321172255358,5267.8,2022-05-19T09:30:13,Galdakao,expenses,education,-48.2,-3444.96
buyer_4,Jorge,Moreno,1974-05-23,32144178E,jorge.moreno@coolnet.site,679449,ES86209540321172255358,5267.8,2022-05-19T19:41:44,Galdakao,expenses,cash,-100.0,-3544.96
buyer_4,Jorge,Moreno,1974-05-23,32144178E,jorge.moreno@coolnet.site,679449,ES86209540321172255358,5267.8,2022-05-20T16:51:03,Galdakao,expenses,food,-90.98,-3635.94
buyer_4,Jorge,Moreno,1974-05-23,32144178E,jorge.moreno@coolnet.site,679449,ES86209540321172255358,5267.8,2022-05-20T20:42:47,Galdakao,expenses,education,-73.52,-3709.46
buyer_4,Jorge,Moreno,1974-05-23,32144178E,jorge.moreno@coolnet.site,679449,ES86209540321172255358,5267.8,2022-05-21T10:44:23,Galdakao,expenses,gifts,-494.27,-4203.73
buyer_4,Jorge,Moreno,1974-05-23,32144178E,jorge.moreno@coolnet.site,679449,ES86209540321172255358,5267.8,2022-05-22T10:16:21,Galdakao,expenses,transport,-53.96,-4257.69
buyer_4,Jorge,Moreno,1974-05-23,32144178E,jorge.moreno@coolnet.site,679449,ES86209540321172255358,5267.8,2022-05-26T20:46:55,Galdakao,expenses,children,-506.54,-4764.23
buyer_4,Jorge,Moreno,1974-05-23,32144178E,jorge.moreno@coolnet.site,679449,ES86209540321172255358,5267.8,2022-05-27T16:12:51,Galdakao,expenses,clothing,-108.5,-4872.73
buyer_4,Jorge,Moreno,1974-05-23,32144178E,jorge.moreno@coolnet.site,679449,ES86209540321172255358,5267.8,2022-05-27T21:09:12,Galdakao,expenses,healthcare,-53.46,-4926.19
buyer_4,Jorge,Moreno,1974-05-23,32144178E,jorge.moreno@coolnet.site,679449,ES86209540321172255358,5267.8,2022-05-28T14:58:04,Galdakao,expenses,food,-88.81,-5015.0
buyer_4,Jorge,Moreno,1974-05-23,32144178E,jorge.moreno@coolnet.site,679449,ES86209540321172255358,5267.8,2022-05-28T23:58:10,Galdakao,expenses,repairs,-30.73,-5045.73
buyer_4,Jorge,Moreno,1974-05-23,32144178E,jorge.moreno@coolnet.site,679449,ES86209540321172255358,5267.8,2022-05-30T02:17:10,Galdakao,expenses,transport,-40.33,-5086.06
buyer_4,Jorge,Moreno,1974-05-23,32144178E,jorge.moreno@coolnet.site,679449,ES86209540321172255358,5267.8,2022-05-31T18:00:27,Galdakao,expenses,food,-60.35,-5146.41
buyer_4,Jorge,Moreno,1974-05-23,32144178E,jorge.moreno@coolnet.site,679449,ES86209540321172255358,5267.8,2022-06-01T13:01:30,Galdakao,incomes,salary,2839.93,-2306.48
buyer_4,Jorge,Moreno,1974-05-23,32144178E,jorge.moreno@coolnet.site,679449,ES86209540321172255358,5267.8,2022-06-01T13:01:30,Galdakao,incomes,salary_bonus,2033.62,-272.86
buyer_4,Jorge,Moreno,1974-05-23,32144178E,jorge.moreno@coolnet.site,679449,ES86209540321172255358,5267.8,2022-06-02T17:41:20,Galdakao,expenses,repairs,-200.39,-473.25
buyer_4,Jorge,Moreno,1974-05-23,32144178E,jorge.moreno@coolnet.site,679449,ES86209540321172255358,5267.8,2022-06-04T19:03:35,Galdakao,expenses,mortgage,-1267.06,-1740.31
buyer_4,Jorge,Moreno,1974-05-23,32144178E,jorge.moreno@coolnet.site,679449,ES86209540321172255358,5267.8,2022-06-05T18:49:25,Galdakao,expenses,water,-60.55,-1800.86
buyer_4,Jorge,Moreno,1974-05-23,32144178E,jorge.moreno@coolnet.site,679449,ES86209540321172255358,5267.8,2022-06-06T19:52:01,Galdakao,expenses,internet,-59.64,-1860.5
buyer_4,Jorge,Moreno,1974-05-23,32144178E,jorge.moreno@coolnet.site,679449,ES86209540321172255358,5267.8,2022-06-06T12:10:20,Galdakao,expenses,transport,-54.09,-1914.59
buyer_4,Jorge,Moreno,1974-05-23,32144178E,jorge.moreno@coolnet.site,679449,ES86209540321172255358,5267.8,2022-06-07T13:07:30,Galdakao,expenses,electricity,-49.35,-1963.94
buyer_4,Jorge,Moreno,1974-05-23,32144178E,jorge.moreno@coolnet.site,679449,ES86209540321172255358,5267.8,2022-06-07T14:08:07,Galdakao,expenses,phone,-61.3,-2025.24
buyer_4,Jorge,Moreno,1974-05-23,32144178E,jorge.moreno@coolnet.site,679449,ES86209540321172255358,5267.8,2022-06-08T12:40:34,Galdakao,expenses,gas,-45.7,-2070.94
buyer_4,Jorge,Moreno,1974-05-23,32144178E,jorge.moreno@coolnet.site,679449,ES86209540321172255358,5267.8,2022-06-09T23:19:45,Galdakao,expenses,cash,-100.0,-2170.94
buyer_4,Jorge,Moreno,1974-05-23,32144178E,jorge.moreno@coolnet.site,679449,ES86209540321172255358,5267.8,2022-06-11T10:32:22,Galdakao,expenses,gifts,-116.43,-2287.37
buyer_4,Jorge,Moreno,1974-05-23,32144178E,jorge.moreno@coolnet.site,679449,ES86209540321172255358,5267.8,2022-06-12T12:17:32,Galdakao,expenses,healthcare,-144.91,-2432.28
buyer_4,Jorge,Moreno,1974-05-23,32144178E,jorge.moreno@coolnet.site,679449,ES86209540321172255358,5267.8,2022-06-12T19:30:15,Galdakao,expenses,cash,-100.0,-2532.28
buyer_4,Jorge,Moreno,1974-05-23,32144178E,jorge.moreno@coolnet.site,679449,ES86209540321172255358,5267.8,2022-06-12T15:52:17,Galdakao,expenses,repairs,-307.46,-2839.74
buyer_4,Jorge,Moreno,1974-05-23,32144178E,jorge.moreno@coolnet.site,679449,ES86209540321172255358,5267.8,2022-06-13T11:05:00,Galdakao,expenses,food,-83.63,-2923.37
buyer_4,Jorge,Moreno,1974-05-23,32144178E,jorge.moreno@coolnet.site,679449,ES86209540321172255358,5267.8,2022-06-13T15:29:46,Galdakao,expenses,repairs,-188.88,-3112.25
buyer_4,Jorge,Moreno,1974-05-23,32144178E,jorge.moreno@coolnet.site,679449,ES86209540321172255358,5267.8,2022-06-15T08:23:41,Galdakao,expenses,education,-64.99,-3177.24
buyer_4,Jorge,Moreno,1974-05-23,32144178E,jorge.moreno@coolnet.site,679449,ES86209540321172255358,5267.8,2022-06-16T20:25:46,Galdakao,expenses,food,-85.29,-3262.53
buyer_4,Jorge,Moreno,1974-05-23,32144178E,jorge.moreno@coolnet.site,679449,ES86209540321172255358,5267.8,2022-06-17T23:16:33,Galdakao,expenses,transport,-69.59,-3332.12
buyer_4,Jorge,Moreno,1974-05-23,32144178E,jorge.moreno@coolnet.site,679449,ES86209540321172255358,5267.8,2022-06-18T14:58:13,Galdakao,expenses,cash,-100.0,-3432.12
buyer_4,Jorge,Moreno,1974-05-23,32144178E,jorge.moreno@coolnet.site,679449,ES86209540321172255358,5267.8,2022-06-19T12:05:09,Galdakao,expenses,food,-123.42,-3555.54
buyer_4,Jorge,Moreno,1974-05-23,32144178E,jorge.moreno@coolnet.site,679449,ES86209540321172255358,5267.8,2022-06-19T09:47:57,Galdakao,expenses,gifts,-95.65,-3651.19
buyer_4,Jorge,Moreno,1974-05-23,32144178E,jorge.moreno@coolnet.site,679449,ES86209540321172255358,5267.8,2022-06-24T18:32:26,Galdakao,expenses,clothing,-119.86,-3771.05
buyer_4,Jorge,Moreno,1974-05-23,32144178E,jorge.moreno@coolnet.site,679449,ES86209540321172255358,5267.8,2022-06-25T11:29:08,Galdakao,expenses,food,-60.78,-3831.83
buyer_4,Jorge,Moreno,1974-05-23,32144178E,jorge.moreno@coolnet.site,679449,ES86209540321172255358,5267.8,2022-06-26T08:26:57,Galdakao,expenses,food,-121.42,-3953.25
buyer_4,Jorge,Moreno,1974-05-23,32144178E,jorge.moreno@coolnet.site,679449,ES86209540321172255358,5267.8,2022-06-26T17:58:01,Galdakao,expenses,gifts,-102.61,-4055.86
buyer_4,Jorge,Moreno,1974-05-23,32144178E,jorge.moreno@coolnet.site,679449,ES86209540321172255358,5267.8,2022-06-28T11:57:47,Galdakao,expenses,leisure,-70.61,-4126.47
buyer_4,Jorge,Moreno,1974-05-23,32144178E,jorge.moreno@coolnet.site,679449,ES86209540321172255358,5267.8,2022-06-30T16:13:52,Galdakao,expenses,healthcare,-39.66,-4166.13
buyer_4,Jorge,Moreno,1974-05-23,32144178E,jorge.moreno@coolnet.site,679449,ES86209540321172255358,5267.8,2022-07-01T22:09:38,Galdakao,incomes,salary,2839.93,-1326.2
buyer_4,Jorge,Moreno,1974-05-23,32144178E,jorge.moreno@coolnet.site,679449,ES86209540321172255358,5267.8,2022-07-01T22:09:38,Galdakao,incomes,extra_income,338.65,-987.55
buyer_4,Jorge,Moreno,1974-05-23,32144178E,jorge.moreno@coolnet.site,679449,ES86209540321172255358,5267.8,2022-07-02T14:54:11,Galdakao,expenses,leisure,-53.31,-1040.86
buyer_4,Jorge,Moreno,1974-05-23,32144178E,jorge.moreno@coolnet.site,679449,ES86209540321172255358,5267.8,2022-07-04T17:11:35,Galdakao,expenses,mortgage,-1267.06,-2307.92
buyer_4,Jorge,Moreno,1974-05-23,32144178E,jorge.moreno@coolnet.site,679449,ES86209540321172255358,5267.8,2022-07-05T11:00:34,Galdakao,expenses,electricity,-102.92,-2410.84
buyer_4,Jorge,Moreno,1974-05-23,32144178E,jorge.moreno@coolnet.site,679449,ES86209540321172255358,5267.8,2022-07-06T10:32:28,Galdakao,expenses,internet,-59.64,-2470.48
buyer_4,Jorge,Moreno,1974-05-23,32144178E,jorge.moreno@coolnet.site,679449,ES86209540321172255358,5267.8,2022-07-06T16:46:14,Galdakao,expenses,cash,-100.0,-2570.48
buyer_4,Jorge,Moreno,1974-05-23,32144178E,jorge.moreno@coolnet.site,679449,ES86209540321172255358,5267.8,2022-07-06T18:45:37,Galdakao,expenses,gifts,-315.72,-2886.2
buyer_4,Jorge,Moreno,1974-05-23,32144178E,jorge.moreno@coolnet.site,679449,ES86209540321172255358,5267.8,2022-07-07T00:10:38,Galdakao,expenses,leisure,-69.83,-2956.03
buyer_4,Jorge,Moreno,1974-05-23,32144178E,jorge.moreno@coolnet.site,679449,ES86209540321172255358,5267.8,2022-07-07T20:56:50,Galdakao,expenses,healthcare,-81.94,-3037.97
buyer_4,Jorge,Moreno,1974-05-23,32144178E,jorge.moreno@coolnet.site,679449,ES86209540321172255358,5267.8,2022-07-07T20:11:22,Galdakao,expenses,cash,-100.0,-3137.97
buyer_4,Jorge,Moreno,1974-05-23,32144178E,jorge.moreno@coolnet.site,679449,ES86209540321172255358,5267.8,2022-07-08T09:27:52,Galdakao,expenses,water,-33.93,-3171.9
buyer_4,Jorge,Moreno,1974-05-23,32144178E,jorge.moreno@coolnet.site,679449,ES86209540321172255358,5267.8,2022-07-08T06:42:21,Galdakao,expenses,gas,-149.56,-3321.46
buyer_4,Jorge,Moreno,1974-05-23,32144178E,jorge.moreno@coolnet.site,679449,ES86209540321172255358,5267.8,2022-07-08T08:31:25,Galdakao,expenses,phone,-62.19,-3383.65
buyer_4,Jorge,Moreno,1974-05-23,32144178E,jorge.moreno@coolnet.site,679449,ES86209540321172255358,5267.8,2022-07-09T14:50:13,Galdakao,expenses,food,-92.17,-3475.82
buyer_4,Jorge,Moreno,1974-05-23,32144178E,jorge.moreno@coolnet.site,679449,ES86209540321172255358,5267.8,2022-07-09T21:05:02,Galdakao,expenses,gifts,-626.3,-4102.12
buyer_4,Jorge,Moreno,1974-05-23,32144178E,jorge.moreno@coolnet.site,679449,ES86209540321172255358,5267.8,2022-07-11T17:05:44,Galdakao,expenses,healthcare,-77.88,-4180.0
buyer_4,Jorge,Moreno,1974-05-23,32144178E,jorge.moreno@coolnet.site,679449,ES86209540321172255358,5267.8,2022-07-13T20:03:05,Galdakao,expenses,clothing,-55.94,-4235.94
buyer_4,Jorge,Moreno,1974-05-23,32144178E,jorge.moreno@coolnet.site,679449,ES86209540321172255358,5267.8,2022-07-14T19:27:09,Galdakao,expenses,healthcare,-154.24,-4390.18
buyer_4,Jorge,Moreno,1974-05-23,32144178E,jorge.moreno@coolnet.site,679449,ES86209540321172255358,5267.8,2022-07-15T09:54:10,Galdakao,expenses,clothing,-45.85,-4436.03
buyer_4,Jorge,Moreno,1974-05-23,32144178E,jorge.moreno@coolnet.site,679449,ES86209540321172255358,5267.8,2022-07-16T12:30:41,Galdakao,expenses,food,-97.1,-4533.13
buyer_4,Jorge,Moreno,1974-05-23,32144178E,jorge.moreno@coolnet.site,679449,ES86209540321172255358,5267.8,2022-07-18T01:51:48,Galdakao,expenses,repairs,-325.51,-4858.64
buyer_4,Jorge,Moreno,1974-05-23,32144178E,jorge.moreno@coolnet.site,679449,ES86209540321172255358,5267.8,2022-07-20T03:26:28,Galdakao,expenses,education,-72.55,-4931.19
buyer_4,Jorge,Moreno,1974-05-23,32144178E,jorge.moreno@coolnet.site,679449,ES86209540321172255358,5267.8,2022-07-21T12:17:54,Galdakao,expenses,cash,-100.0,-5031.19
buyer_4,Jorge,Moreno,1974-05-23,32144178E,jorge.moreno@coolnet.site,679449,ES86209540321172255358,5267.8,2022-07-23T08:46:02,Galdakao,expenses,cash,-100.0,-5131.19
buyer_4,Jorge,Moreno,1974-05-23,32144178E,jorge.moreno@coolnet.site,679449,ES86209540321172255358,5267.8,2022-07-24T09:14:26,Galdakao,expenses,repairs,-67.0,-5198.19
buyer_4,Jorge,Moreno,1974-05-23,32144178E,jorge.moreno@coolnet.site,679449,ES86209540321172255358,5267.8,2022-07-25T10:49:32,Galdakao,expenses,repairs,-251.16,-5449.35
buyer_4,Jorge,Moreno,1974-05-23,32144178E,jorge.moreno@coolnet.site,679449,ES86209540321172255358,5267.8,2022-07-26T16:05:41,Galdakao,expenses,cash,-100.0,-5549.35
buyer_4,Jorge,Moreno,1974-05-23,32144178E,jorge.moreno@coolnet.site,679449,ES86209540321172255358,5267.8,2022-07-27T09:52:20,Galdakao,expenses,leisure,-51.08,-5600.43
buyer_4,Jorge,Moreno,1974-05-23,32144178E,jorge.moreno@coolnet.site,679449,ES86209540321172255358,5267.8,2022-07-28T07:42:09,Galdakao,expenses,leisure,-69.4,-5669.83
buyer_4,Jorge,Moreno,1974-05-23,32144178E,jorge.moreno@coolnet.site,679449,ES86209540321172255358,5267.8,2022-07-29T09:53:03,Galdakao,expenses,education,-65.31,-5735.14
buyer_4,Jorge,Moreno,1974-05-23,32144178E,jorge.moreno@coolnet.site,679449,ES86209540321172255358,5267.8,2022-08-01T15:34:12,Galdakao,incomes,salary,2839.93,-2895.21
buyer_4,Jorge,Moreno,1974-05-23,32144178E,jorge.moreno@coolnet.site,679449,ES86209540321172255358,5267.8,2022-08-02T19:44:16,Galdakao,expenses,food,-60.82,-2956.03
buyer_4,Jorge,Moreno,1974-05-23,32144178E,jorge.moreno@coolnet.site,679449,ES86209540321172255358,5267.8,2022-08-02T14:23:32,Galdakao,expenses,clothing,-144.14,-3100.17
buyer_4,Jorge,Moreno,1974-05-23,32144178E,jorge.moreno@coolnet.site,679449,ES86209540321172255358,5267.8,2022-08-02T20:48:17,Galdakao,expenses,healthcare,-68.84,-3169.01
buyer_4,Jorge,Moreno,1974-05-23,32144178E,jorge.moreno@coolnet.site,679449,ES86209540321172255358,5267.8,2022-08-02T21:29:58,Galdakao,expenses,cash,-100.0,-3269.01
buyer_4,Jorge,Moreno,1974-05-23,32144178E,jorge.moreno@coolnet.site,679449,ES86209540321172255358,5267.8,2022-08-04T20:26:15,Galdakao,expenses,mortgage,-1267.06,-4536.07
buyer_4,Jorge,Moreno,1974-05-23,32144178E,jorge.moreno@coolnet.site,679449,ES86209540321172255358,5267.8,2022-08-04T12:33:15,Galdakao,expenses,leisure,-36.02,-4572.09
buyer_4,Jorge,Moreno,1974-05-23,32144178E,jorge.moreno@coolnet.site,679449,ES86209540321172255358,5267.8,2022-08-04T15:27:14,Galdakao,expenses,appliances,-169.53,-4741.62
buyer_4,Jorge,Moreno,1974-05-23,32144178E,jorge.moreno@coolnet.site,679449,ES86209540321172255358,5267.8,2022-08-04T13:05:08,Galdakao,expenses,repairs,-250.16,-4991.78
buyer_4,Jorge,Moreno,1974-05-23,32144178E,jorge.moreno@coolnet.site,679449,ES86209540321172255358,5267.8,2022-08-05T15:30:54,Galdakao,expenses,gas,-122.8,-5114.58
buyer_4,Jorge,Moreno,1974-05-23,32144178E,jorge.moreno@coolnet.site,679449,ES86209540321172255358,5267.8,2022-08-05T08:18:34,Galdakao,expenses,phone,-44.59,-5159.17
buyer_4,Jorge,Moreno,1974-05-23,32144178E,jorge.moreno@coolnet.site,679449,ES86209540321172255358,5267.8,2022-08-06T07:02:51,Galdakao,expenses,internet,-59.64,-5218.81
buyer_4,Jorge,Moreno,1974-05-23,32144178E,jorge.moreno@coolnet.site,679449,ES86209540321172255358,5267.8,2022-08-06T18:10:01,Galdakao,expenses,leisure,-26.31,-5245.12
buyer_4,Jorge,Moreno,1974-05-23,32144178E,jorge.moreno@coolnet.site,679449,ES86209540321172255358,5267.8,2022-08-07T18:21:35,Galdakao,expenses,cash,-100.0,-5345.12
buyer_4,Jorge,Moreno,1974-05-23,32144178E,jorge.moreno@coolnet.site,679449,ES86209540321172255358,5267.8,2022-08-07T11:06:04,Galdakao,expenses,repairs,-95.84,-5440.96
buyer_4,Jorge,Moreno,1974-05-23,32144178E,jorge.moreno@coolnet.site,679449,ES86209540321172255358,5267.8,2022-08-08T09:59:45,Galdakao,expenses,water,-38.73,-5479.69
buyer_4,Jorge,Moreno,1974-05-23,32144178E,jorge.moreno@coolnet.site,679449,ES86209540321172255358,5267.8,2022-08-08T16:28:41,Galdakao,expenses,electricity,-123.66,-5603.35
buyer_4,Jorge,Moreno,1974-05-23,32144178E,jorge.moreno@coolnet.site,679449,ES86209540321172255358,5267.8,2022-08-08T15:24:41,Galdakao,expenses,clothing,-85.77,-5689.12
buyer_4,Jorge,Moreno,1974-05-23,32144178E,jorge.moreno@coolnet.site,679449,ES86209540321172255358,5267.8,2022-08-09T18:53:03,Galdakao,expenses,food,-101.26,-5790.38
buyer_4,Jorge,Moreno,1974-05-23,32144178E,jorge.moreno@coolnet.site,679449,ES86209540321172255358,5267.8,2022-08-11T11:33:35,Galdakao,expenses,leisure,-40.41,-5830.79
buyer_4,Jorge,Moreno,1974-05-23,32144178E,jorge.moreno@coolnet.site,679449,ES86209540321172255358,5267.8,2022-08-12T18:06:01,Galdakao,expenses,children,-682.13,-6512.92
buyer_4,Jorge,Moreno,1974-05-23,32144178E,jorge.moreno@coolnet.site,679449,ES86209540321172255358,5267.8,2022-08-13T08:05:31,Galdakao,expenses,leisure,-32.48,-6545.4
buyer_4,Jorge,Moreno,1974-05-23,32144178E,jorge.moreno@coolnet.site,679449,ES86209540321172255358,5267.8,2022-08-13T21:43:56,Galdakao,expenses,appliances,-109.54,-6654.94
buyer_4,Jorge,Moreno,1974-05-23,32144178E,jorge.moreno@coolnet.site,679449,ES86209540321172255358,5267.8,2022-08-13T23:08:41,Galdakao,expenses,repairs,-303.63,-6958.57
buyer_4,Jorge,Moreno,1974-05-23,32144178E,jorge.moreno@coolnet.site,679449,ES86209540321172255358,5267.8,2022-08-15T15:39:20,Galdakao,expenses,leisure,-49.14,-7007.71
buyer_4,Jorge,Moreno,1974-05-23,32144178E,jorge.moreno@coolnet.site,679449,ES86209540321172255358,5267.8,2022-08-15T23:04:08,Galdakao,expenses,gifts,-35.97,-7043.68
buyer_4,Jorge,Moreno,1974-05-23,32144178E,jorge.moreno@coolnet.site,679449,ES86209540321172255358,5267.8,2022-08-16T18:18:27,Galdakao,expenses,cash,-100.0,-7143.68
buyer_4,Jorge,Moreno,1974-05-23,32144178E,jorge.moreno@coolnet.site,679449,ES86209540321172255358,5267.8,2022-08-17T16:43:06,Galdakao,expenses,leisure,-82.72,-7226.4
buyer_4,Jorge,Moreno,1974-05-23,32144178E,jorge.moreno@coolnet.site,679449,ES86209540321172255358,5267.8,2022-08-17T14:26:51,Galdakao,expenses,repairs,-98.91,-7325.31
buyer_4,Jorge,Moreno,1974-05-23,32144178E,jorge.moreno@coolnet.site,679449,ES86209540321172255358,5267.8,2022-08-22T14:40:18,Galdakao,expenses,clothing,-153.48,-7478.79
buyer_4,Jorge,Moreno,1974-05-23,32144178E,jorge.moreno@coolnet.site,679449,ES86209540321172255358,5267.8,2022-08-24T14:00:06,Galdakao,expenses,leisure,-53.33,-7532.12
buyer_4,Jorge,Moreno,1974-05-23,32144178E,jorge.moreno@coolnet.site,679449,ES86209540321172255358,5267.8,2022-08-28T08:51:07,Galdakao,expenses,appliances,-154.16,-7686.28
buyer_4,Jorge,Moreno,1974-05-23,32144178E,jorge.moreno@coolnet.site,679449,ES86209540321172255358,5267.8,2022-08-29T14:47:06,Galdakao,expenses,transport,-75.63,-7761.91
buyer_4,Jorge,Moreno,1974-05-23,32144178E,jorge.moreno@coolnet.site,679449,ES86209540321172255358,5267.8,2022-08-31T20:01:31,Galdakao,expenses,food,-80.19,-7842.1
buyer_4,Jorge,Moreno,1974-05-23,32144178E,jorge.moreno@coolnet.site,679449,ES86209540321172255358,5267.8,2022-08-31T14:28:45,Galdakao,expenses,cash,-100.0,-7942.1
buyer_4,Jorge,Moreno,1974-05-23,32144178E,jorge.moreno@coolnet.site,679449,ES86209540321172255358,5267.8,2022-09-01T11:46:05,Galdakao,incomes,salary,2839.93,-5102.17
buyer_4,Jorge,Moreno,1974-05-23,32144178E,jorge.moreno@coolnet.site,679449,ES86209540321172255358,5267.8,2022-09-01T09:46:41,Galdakao,expenses,car,-346.11,-5448.28
buyer_4,Jorge,Moreno,1974-05-23,32144178E,jorge.moreno@coolnet.site,679449,ES86209540321172255358,5267.8,2022-09-02T12:15:53,Galdakao,expenses,transport,-53.69,-5501.97
buyer_4,Jorge,Moreno,1974-05-23,32144178E,jorge.moreno@coolnet.site,679449,ES86209540321172255358,5267.8,2022-09-03T11:12:23,Galdakao,expenses,healthcare,-142.84,-5644.81
buyer_4,Jorge,Moreno,1974-05-23,32144178E,jorge.moreno@coolnet.site,679449,ES86209540321172255358,5267.8,2022-09-03T15:00:40,Galdakao,expenses,children,-1063.1734166666665,-6707.98
buyer_4,Jorge,Moreno,1974-05-23,32144178E,jorge.moreno@coolnet.site,679449,ES86209540321172255358,5267.8,2022-09-04T15:40:45,Galdakao,expenses,mortgage,-1267.06,-7975.04
buyer_4,Jorge,Moreno,1974-05-23,32144178E,jorge.moreno@coolnet.site,679449,ES86209540321172255358,5267.8,2022-09-06T19:33:01,Galdakao,expenses,cash,-100.0,-8075.04
buyer_4,Jorge,Moreno,1974-05-23,32144178E,jorge.moreno@coolnet.site,679449,ES86209540321172255358,5267.8,2022-09-06T23:46:57,Galdakao,expenses,children,-1106.0134166666664,-9181.05
buyer_4,Jorge,Moreno,1974-05-23,32144178E,jorge.moreno@coolnet.site,679449,ES86209540321172255358,5267.8,2022-09-07T13:07:17,Galdakao,expenses,gas,-97.39,-9278.44
buyer_4,Jorge,Moreno,1974-05-23,32144178E,jorge.moreno@coolnet.site,679449,ES86209540321172255358,5267.8,2022-09-07T13:14:03,Galdakao,expenses,education,-72.87,-9351.31
buyer_4,Jorge,Moreno,1974-05-23,32144178E,jorge.moreno@coolnet.site,679449,ES86209540321172255358,5267.8,2022-09-08T08:09:55,Galdakao,expenses,water,-47.12,-9398.43
buyer_4,Jorge,Moreno,1974-05-23,32144178E,jorge.moreno@coolnet.site,679449,ES86209540321172255358,5267.8,2022-09-08T18:20:39,Galdakao,expenses,electricity,-37.13,-9435.56
buyer_4,Jorge,Moreno,1974-05-23,32144178E,jorge.moreno@coolnet.site,679449,ES86209540321172255358,5267.8,2022-09-08T17:24:39,Galdakao,expenses,internet,-59.64,-9495.2
buyer_4,Jorge,Moreno,1974-05-23,32144178E,jorge.moreno@coolnet.site,679449,ES86209540321172255358,5267.8,2022-09-08T18:47:02,Galdakao,expenses,phone,-46.58,-9541.78
buyer_4,Jorge,Moreno,1974-05-23,32144178E,jorge.moreno@coolnet.site,679449,ES86209540321172255358,5267.8,2022-09-08T15:37:47,Galdakao,expenses,cash,-100.0,-9641.78
buyer_4,Jorge,Moreno,1974-05-23,32144178E,jorge.moreno@coolnet.site,679449,ES86209540321172255358,5267.8,2022-09-08T02:18:46,Galdakao,expenses,repairs,-125.82,-9767.6
buyer_4,Jorge,Moreno,1974-05-23,32144178E,jorge.moreno@coolnet.site,679449,ES86209540321172255358,5267.8,2022-09-10T20:43:45,Galdakao,expenses,healthcare,-153.99,-9921.59
buyer_4,Jorge,Moreno,1974-05-23,32144178E,jorge.moreno@coolnet.site,679449,ES86209540321172255358,5267.8,2022-09-10T21:46:11,Galdakao,expenses,cash,-100.0,-10021.59
buyer_4,Jorge,Moreno,1974-05-23,32144178E,jorge.moreno@coolnet.site,679449,ES86209540321172255358,5267.8,2022-09-11T13:49:24,Galdakao,expenses,food,-76.92,-10098.51
buyer_4,Jorge,Moreno,1974-05-23,32144178E,jorge.moreno@coolnet.site,679449,ES86209540321172255358,5267.8,2022-09-11T19:15:01,Galdakao,expenses,children,-805.78,-10904.29
buyer_4,Jorge,Moreno,1974-05-23,32144178E,jorge.moreno@coolnet.site,679449,ES86209540321172255358,5267.8,2022-09-13T20:03:51,Galdakao,expenses,transport,-66.71,-10971.0
buyer_4,Jorge,Moreno,1974-05-23,32144178E,jorge.moreno@coolnet.site,679449,ES86209540321172255358,5267.8,2022-09-14T11:14:33,Galdakao,expenses,leisure,-43.93,-11014.93
buyer_4,Jorge,Moreno,1974-05-23,32144178E,jorge.moreno@coolnet.site,679449,ES86209540321172255358,5267.8,2022-09-14T19:55:39,Galdakao,expenses,children,-1162.0834166666664,-12177.01
buyer_4,Jorge,Moreno,1974-05-23,32144178E,jorge.moreno@coolnet.site,679449,ES86209540321172255358,5267.8,2022-09-16T00:40:09,Galdakao,expenses,food,-71.19,-12248.2
buyer_4,Jorge,Moreno,1974-05-23,32144178E,jorge.moreno@coolnet.site,679449,ES86209540321172255358,5267.8,2022-09-16T13:14:01,Galdakao,expenses,clothing,-73.09,-12321.29
buyer_4,Jorge,Moreno,1974-05-23,32144178E,jorge.moreno@coolnet.site,679449,ES86209540321172255358,5267.8,2022-09-16T02:37:19,Galdakao,expenses,cash,-100.0,-12421.29
buyer_4,Jorge,Moreno,1974-05-23,32144178E,jorge.moreno@coolnet.site,679449,ES86209540321172255358,5267.8,2022-09-17T21:28:29,Galdakao,expenses,healthcare,-89.17,-12510.46
buyer_4,Jorge,Moreno,1974-05-23,32144178E,jorge.moreno@coolnet.site,679449,ES86209540321172255358,5267.8,2022-09-17T08:39:06,Galdakao,expenses,education,-50.85,-12561.31
buyer_4,Jorge,Moreno,1974-05-23,32144178E,jorge.moreno@coolnet.site,679449,ES86209540321172255358,5267.8,2022-09-18T15:22:45,Galdakao,expenses,food,-117.72,-12679.03
buyer_4,Jorge,Moreno,1974-05-23,32144178E,jorge.moreno@coolnet.site,679449,ES86209540321172255358,5267.8,2022-09-18T23:43:50,Galdakao,expenses,cash,-100.0,-12779.03
buyer_4,Jorge,Moreno,1974-05-23,32144178E,jorge.moreno@coolnet.site,679449,ES86209540321172255358,5267.8,2022-09-19T19:23:49,Galdakao,expenses,cash,-100.0,-12879.03
buyer_4,Jorge,Moreno,1974-05-23,32144178E,jorge.moreno@coolnet.site,679449,ES86209540321172255358,5267.8,2022-09-19T08:54:57,Galdakao,expenses,travel,-765.38,-13644.41
buyer_4,Jorge,Moreno,1974-05-23,32144178E,jorge.moreno@coolnet.site,679449,ES86209540321172255358,5267.8,2022-09-20T09:22:04,Galdakao,expenses,cash,-100.0,-13744.41
buyer_4,Jorge,Moreno,1974-05-23,32144178E,jorge.moreno@coolnet.site,679449,ES86209540321172255358,5267.8,2022-09-22T15:50:55,Galdakao,expenses,repairs,-221.81,-13966.22
buyer_4,Jorge,Moreno,1974-05-23,32144178E,jorge.moreno@coolnet.site,679449,ES86209540321172255358,5267.8,2022-09-26T11:10:48,Galdakao,expenses,cash,-100.0,-14066.22
buyer_4,Jorge,Moreno,1974-05-23,32144178E,jorge.moreno@coolnet.site,679449,ES86209540321172255358,5267.8,2022-09-26T15:53:43,Galdakao,expenses,children,-1106.0134166666664,-15172.23
buyer_4,Jorge,Moreno,1974-05-23,32144178E,jorge.moreno@coolnet.site,679449,ES86209540321172255358,5267.8,2022-09-27T06:46:03,Galdakao,expenses,leisure,-34.01,-15206.24
buyer_4,Jorge,Moreno,1974-05-23,32144178E,jorge.moreno@coolnet.site,679449,ES86209540321172255358,5267.8,2022-09-27T09:44:12,Galdakao,expenses,repairs,-134.92,-15341.16
buyer_4,Jorge,Moreno,1974-05-23,32144178E,jorge.moreno@coolnet.site,679449,ES86209540321172255358,5267.8,2022-09-30T12:28:06,Galdakao,expenses,food,-77.43,-15418.59
buyer_4,Jorge,Moreno,1974-05-23,32144178E,jorge.moreno@coolnet.site,679449,ES86209540321172255358,5267.8,2022-09-30T15:49:53,Galdakao,expenses,cash,-100.0,-15518.59
buyer_4,Jorge,Moreno,1974-05-23,32144178E,jorge.moreno@coolnet.site,679449,ES86209540321172255358,5267.8,2022-09-30T14:29:25,Galdakao,expenses,gifts,-236.79,-15755.38
buyer_4,Jorge,Moreno,1974-05-23,32144178E,jorge.moreno@coolnet.site,679449,ES86209540321172255358,5267.8,2022-10-01T08:53:51,Galdakao,incomes,salary,2839.93,-12915.45
buyer_4,Jorge,Moreno,1974-05-23,32144178E,jorge.moreno@coolnet.site,679449,ES86209540321172255358,5267.8,2022-10-01T17:52:37,Galdakao,expenses,cash,-100.0,-13015.45
buyer_4,Jorge,Moreno,1974-05-23,32144178E,jorge.moreno@coolnet.site,679449,ES86209540321172255358,5267.8,2022-10-01T20:56:13,Galdakao,expenses,travel,-701.83,-13717.28
buyer_4,Jorge,Moreno,1974-05-23,32144178E,jorge.moreno@coolnet.site,679449,ES86209540321172255358,5267.8,2022-10-04T12:25:44,Galdakao,expenses,mortgage,-1267.06,-14984.34
buyer_4,Jorge,Moreno,1974-05-23,32144178E,jorge.moreno@coolnet.site,679449,ES86209540321172255358,5267.8,2022-10-04T17:41:34,Galdakao,expenses,clothing,-111.27,-15095.61
buyer_4,Jorge,Moreno,1974-05-23,32144178E,jorge.moreno@coolnet.site,679449,ES86209540321172255358,5267.8,2022-10-05T00:35:15,Galdakao,expenses,phone,-45.69,-15141.3
buyer_4,Jorge,Moreno,1974-05-23,32144178E,jorge.moreno@coolnet.site,679449,ES86209540321172255358,5267.8,2022-10-05T12:57:22,Galdakao,expenses,clothing,-118.58,-15259.88
buyer_4,Jorge,Moreno,1974-05-23,32144178E,jorge.moreno@coolnet.site,679449,ES86209540321172255358,5267.8,2022-10-06T16:10:20,Galdakao,expenses,appliances,-334.66,-15594.54
buyer_4,Jorge,Moreno,1974-05-23,32144178E,jorge.moreno@coolnet.site,679449,ES86209540321172255358,5267.8,2022-10-07T16:07:08,Galdakao,expenses,gas,-89.66,-15684.2
buyer_4,Jorge,Moreno,1974-05-23,32144178E,jorge.moreno@coolnet.site,679449,ES86209540321172255358,5267.8,2022-10-07T08:59:34,Galdakao,expenses,cash,-100.0,-15784.2
buyer_4,Jorge,Moreno,1974-05-23,32144178E,jorge.moreno@coolnet.site,679449,ES86209540321172255358,5267.8,2022-10-07T08:28:38,Galdakao,expenses,appliances,-394.66,-16178.86
buyer_4,Jorge,Moreno,1974-05-23,32144178E,jorge.moreno@coolnet.site,679449,ES86209540321172255358,5267.8,2022-10-08T02:11:45,Galdakao,expenses,electricity,-92.35,-16271.21
buyer_4,Jorge,Moreno,1974-05-23,32144178E,jorge.moreno@coolnet.site,679449,ES86209540321172255358,5267.8,2022-10-08T08:52:49,Galdakao,expenses,internet,-59.64,-16330.85
buyer_4,Jorge,Moreno,1974-05-23,32144178E,jorge.moreno@coolnet.site,679449,ES86209540321172255358,5267.8,2022-10-08T08:52:15,Galdakao,expenses,water,-57.25,-16388.1
buyer_4,Jorge,Moreno,1974-05-23,32144178E,jorge.moreno@coolnet.site,679449,ES86209540321172255358,5267.8,2022-10-08T17:30:05,Galdakao,expenses,transport,-76.27,-16464.37
buyer_4,Jorge,Moreno,1974-05-23,32144178E,jorge.moreno@coolnet.site,679449,ES86209540321172255358,5267.8,2022-10-11T22:07:45,Galdakao,expenses,leisure,-52.23,-16516.6
buyer_4,Jorge,Moreno,1974-05-23,32144178E,jorge.moreno@coolnet.site,679449,ES86209540321172255358,5267.8,2022-10-11T10:04:26,Galdakao,expenses,healthcare,-139.26,-16655.86
buyer_4,Jorge,Moreno,1974-05-23,32144178E,jorge.moreno@coolnet.site,679449,ES86209540321172255358,5267.8,2022-10-12T02:22:31,Galdakao,expenses,cash,-100.0,-16755.86
buyer_4,Jorge,Moreno,1974-05-23,32144178E,jorge.moreno@coolnet.site,679449,ES86209540321172255358,5267.8,2022-10-13T11:04:40,Galdakao,expenses,food,-123.76,-16879.62
buyer_4,Jorge,Moreno,1974-05-23,32144178E,jorge.moreno@coolnet.site,679449,ES86209540321172255358,5267.8,2022-10-14T10:52:06,Galdakao,expenses,cash,-100.0,-16979.62
buyer_4,Jorge,Moreno,1974-05-23,32144178E,jorge.moreno@coolnet.site,679449,ES86209540321172255358,5267.8,2022-10-16T03:26:01,Galdakao,expenses,healthcare,-67.62,-17047.24
buyer_4,Jorge,Moreno,1974-05-23,32144178E,jorge.moreno@coolnet.site,679449,ES86209540321172255358,5267.8,2022-10-21T12:26:37,Galdakao,expenses,food,-82.19,-17129.43
buyer_4,Jorge,Moreno,1974-05-23,32144178E,jorge.moreno@coolnet.site,679449,ES86209540321172255358,5267.8,2022-10-21T23:38:15,Galdakao,expenses,transport,-44.29,-17173.72
buyer_4,Jorge,Moreno,1974-05-23,32144178E,jorge.moreno@coolnet.site,679449,ES86209540321172255358,5267.8,2022-10-21T05:44:18,Galdakao,expenses,clothing,-120.72,-17294.44
buyer_4,Jorge,Moreno,1974-05-23,32144178E,jorge.moreno@coolnet.site,679449,ES86209540321172255358,5267.8,2022-10-21T17:37:11,Galdakao,expenses,cash,-100.0,-17394.44
buyer_4,Jorge,Moreno,1974-05-23,32144178E,jorge.moreno@coolnet.site,679449,ES86209540321172255358,5267.8,2022-10-24T06:12:35,Galdakao,expenses,cash,-100.0,-17494.44
buyer_4,Jorge,Moreno,1974-05-23,32144178E,jorge.moreno@coolnet.site,679449,ES86209540321172255358,5267.8,2022-10-25T16:59:28,Galdakao,expenses,healthcare,-133.67,-17628.11
buyer_4,Jorge,Moreno,1974-05-23,32144178E,jorge.moreno@coolnet.site,679449,ES86209540321172255358,5267.8,2022-10-25T08:38:44,Galdakao,expenses,cash,-100.0,-17728.11
buyer_4,Jorge,Moreno,1974-05-23,32144178E,jorge.moreno@coolnet.site,679449,ES86209540321172255358,5267.8,2022-10-25T11:16:00,Galdakao,expenses,gifts,-835.95,-18564.06
buyer_4,Jorge,Moreno,1974-05-23,32144178E,jorge.moreno@coolnet.site,679449,ES86209540321172255358,5267.8,2022-10-28T12:06:58,Galdakao,expenses,transport,-45.31,-18609.37
buyer_4,Jorge,Moreno,1974-05-23,32144178E,jorge.moreno@coolnet.site,679449,ES86209540321172255358,5267.8,2022-10-29T19:28:06,Galdakao,expenses,repairs,-277.32,-18886.69
buyer_4,Jorge,Moreno,1974-05-23,32144178E,jorge.moreno@coolnet.site,679449,ES86209540321172255358,5267.8,2022-10-31T14:03:58,Galdakao,expenses,food,-77.57,-18964.26
buyer_4,Jorge,Moreno,1974-05-23,32144178E,jorge.moreno@coolnet.site,679449,ES86209540321172255358,5267.8,2022-11-01T14:19:21,Galdakao,incomes,salary,2839.93,-16124.33
buyer_4,Jorge,Moreno,1974-05-23,32144178E,jorge.moreno@coolnet.site,679449,ES86209540321172255358,5267.8,2022-11-01T14:19:21,Galdakao,incomes,extra_income,338.65,-15785.68
buyer_4,Jorge,Moreno,1974-05-23,32144178E,jorge.moreno@coolnet.site,679449,ES86209540321172255358,5267.8,2022-11-01T14:45:01,Galdakao,expenses,healthcare,-183.2,-15968.88
buyer_4,Jorge,Moreno,1974-05-23,32144178E,jorge.moreno@coolnet.site,679449,ES86209540321172255358,5267.8,2022-11-03T08:10:00,Galdakao,expenses,appliances,-343.37,-16312.25
buyer_4,Jorge,Moreno,1974-05-23,32144178E,jorge.moreno@coolnet.site,679449,ES86209540321172255358,5267.8,2022-11-04T02:39:59,Galdakao,expenses,mortgage,-1267.06,-17579.31
buyer_4,Jorge,Moreno,1974-05-23,32144178E,jorge.moreno@coolnet.site,679449,ES86209540321172255358,5267.8,2022-11-04T12:01:23,Galdakao,expenses,gifts,-802.82,-18382.13
buyer_4,Jorge,Moreno,1974-05-23,32144178E,jorge.moreno@coolnet.site,679449,ES86209540321172255358,5267.8,2022-11-05T11:17:20,Galdakao,expenses,gas,-97.41,-18479.54
buyer_4,Jorge,Moreno,1974-05-23,32144178E,jorge.moreno@coolnet.site,679449,ES86209540321172255358,5267.8,2022-11-05T17:29:00,Galdakao,expenses,internet,-59.64,-18539.18
buyer_4,Jorge,Moreno,1974-05-23,32144178E,jorge.moreno@coolnet.site,679449,ES86209540321172255358,5267.8,2022-11-05T18:49:49,Galdakao,expenses,food,-87.39,-18626.57
buyer_4,Jorge,Moreno,1974-05-23,32144178E,jorge.moreno@coolnet.site,679449,ES86209540321172255358,5267.8,2022-11-05T10:04:28,Galdakao,expenses,leisure,-72.27,-18698.84
buyer_4,Jorge,Moreno,1974-05-23,32144178E,jorge.moreno@coolnet.site,679449,ES86209540321172255358,5267.8,2022-11-06T20:16:24,Galdakao,expenses,electricity,-110.15,-18808.99
buyer_4,Jorge,Moreno,1974-05-23,32144178E,jorge.moreno@coolnet.site,679449,ES86209540321172255358,5267.8,2022-11-06T08:25:08,Galdakao,expenses,food,-112.17,-18921.16
buyer_4,Jorge,Moreno,1974-05-23,32144178E,jorge.moreno@coolnet.site,679449,ES86209540321172255358,5267.8,2022-11-06T15:49:10,Galdakao,expenses,gifts,-396.7,-19317.86
buyer_4,Jorge,Moreno,1974-05-23,32144178E,jorge.moreno@coolnet.site,679449,ES86209540321172255358,5267.8,2022-11-07T13:32:47,Galdakao,expenses,education,-70.75,-19388.61
buyer_4,Jorge,Moreno,1974-05-23,32144178E,jorge.moreno@coolnet.site,679449,ES86209540321172255358,5267.8,2022-11-07T08:05:25,Galdakao,expenses,cash,-100.0,-19488.61
buyer_4,Jorge,Moreno,1974-05-23,32144178E,jorge.moreno@coolnet.site,679449,ES86209540321172255358,5267.8,2022-11-08T19:23:37,Galdakao,expenses,water,-30.8,-19519.41
buyer_4,Jorge,Moreno,1974-05-23,32144178E,jorge.moreno@coolnet.site,679449,ES86209540321172255358,5267.8,2022-11-08T08:15:17,Galdakao,expenses,phone,-45.48,-19564.89
buyer_4,Jorge,Moreno,1974-05-23,32144178E,jorge.moreno@coolnet.site,679449,ES86209540321172255358,5267.8,2022-11-08T17:09:36,Galdakao,expenses,leisure,-81.74,-19646.63
buyer_4,Jorge,Moreno,1974-05-23,32144178E,jorge.moreno@coolnet.site,679449,ES86209540321172255358,5267.8,2022-11-09T08:37:25,Galdakao,expenses,travel,-1131.73,-20778.36
buyer_4,Jorge,Moreno,1974-05-23,32144178E,jorge.moreno@coolnet.site,679449,ES86209540321172255358,5267.8,2022-11-13T20:07:18,Galdakao,expenses,appliances,-148.72,-20927.08
buyer_4,Jorge,Moreno,1974-05-23,32144178E,jorge.moreno@coolnet.site,679449,ES86209540321172255358,5267.8,2022-11-15T18:15:52,Galdakao,expenses,leisure,-64.63,-20991.71
buyer_4,Jorge,Moreno,1974-05-23,32144178E,jorge.moreno@coolnet.site,679449,ES86209540321172255358,5267.8,2022-11-15T01:30:10,Galdakao,expenses,children,-774.72,-21766.43
buyer_4,Jorge,Moreno,1974-05-23,32144178E,jorge.moreno@coolnet.site,679449,ES86209540321172255358,5267.8,2022-11-16T12:26:45,Galdakao,expenses,transport,-86.58,-21853.01
buyer_4,Jorge,Moreno,1974-05-23,32144178E,jorge.moreno@coolnet.site,679449,ES86209540321172255358,5267.8,2022-11-17T20:42:25,Galdakao,expenses,clothing,-120.71,-21973.72
buyer_4,Jorge,Moreno,1974-05-23,32144178E,jorge.moreno@coolnet.site,679449,ES86209540321172255358,5267.8,2022-11-19T11:06:22,Galdakao,expenses,cash,-100.0,-22073.72
buyer_4,Jorge,Moreno,1974-05-23,32144178E,jorge.moreno@coolnet.site,679449,ES86209540321172255358,5267.8,2022-11-23T20:32:23,Galdakao,expenses,repairs,-295.2,-22368.92
buyer_4,Jorge,Moreno,1974-05-23,32144178E,jorge.moreno@coolnet.site,679449,ES86209540321172255358,5267.8,2022-11-24T15:28:43,Galdakao,expenses,repairs,-222.55,-22591.47
buyer_4,Jorge,Moreno,1974-05-23,32144178E,jorge.moreno@coolnet.site,679449,ES86209540321172255358,5267.8,2022-11-25T18:34:32,Galdakao,expenses,cash,-100.0,-22691.47
buyer_4,Jorge,Moreno,1974-05-23,32144178E,jorge.moreno@coolnet.site,679449,ES86209540321172255358,5267.8,2022-11-26T17:24:09,Galdakao,expenses,cash,-100.0,-22791.47
buyer_4,Jorge,Moreno,1974-05-23,32144178E,jorge.moreno@coolnet.site,679449,ES86209540321172255358,5267.8,2022-11-29T17:10:10,Galdakao,expenses,leisure,-83.5,-22874.97
buyer_4,Jorge,Moreno,1974-05-23,32144178E,jorge.moreno@coolnet.site,679449,ES86209540321172255358,5267.8,2022-11-30T16:17:58,Galdakao,expenses,leisure,-49.94,-22924.91
buyer_4,Jorge,Moreno,1974-05-23,32144178E,jorge.moreno@coolnet.site,679449,ES86209540321172255358,5267.8,2022-12-01T16:47:45,Galdakao,incomes,salary,2839.93,-20084.98
buyer_4,Jorge,Moreno,1974-05-23,32144178E,jorge.moreno@coolnet.site,679449,ES86209540321172255358,5267.8,2022-12-01T16:47:45,Galdakao,incomes,salary_bonus,2149.18,-17935.8
buyer_4,Jorge,Moreno,1974-05-23,32144178E,jorge.moreno@coolnet.site,679449,ES86209540321172255358,5267.8,2022-12-04T22:02:51,Galdakao,expenses,mortgage,-1267.06,-19202.86
buyer_4,Jorge,Moreno,1974-05-23,32144178E,jorge.moreno@coolnet.site,679449,ES86209540321172255358,5267.8,2022-12-04T08:19:21,Galdakao,expenses,travel,-503.13,-19705.99
buyer_4,Jorge,Moreno,1974-05-23,32144178E,jorge.moreno@coolnet.site,679449,ES86209540321172255358,5267.8,2022-12-06T19:30:01,Galdakao,expenses,phone,-44.18,-19750.17
buyer_4,Jorge,Moreno,1974-05-23,32144178E,jorge.moreno@coolnet.site,679449,ES86209540321172255358,5267.8,2022-12-06T10:27:16,Galdakao,expenses,children,-795.84,-20546.01
buyer_4,Jorge,Moreno,1974-05-23,32144178E,jorge.moreno@coolnet.site,679449,ES86209540321172255358,5267.8,2022-12-07T16:27:52,Galdakao,expenses,leisure,-73.47,-20619.48
buyer_4,Jorge,Moreno,1974-05-23,32144178E,jorge.moreno@coolnet.site,679449,ES86209540321172255358,5267.8,2022-12-07T16:54:21,Galdakao,expenses,clothing,-135.06,-20754.54
buyer_4,Jorge,Moreno,1974-05-23,32144178E,jorge.moreno@coolnet.site,679449,ES86209540321172255358,5267.8,2022-12-07T18:15:39,Galdakao,expenses,education,-42.24,-20796.78
buyer_4,Jorge,Moreno,1974-05-23,32144178E,jorge.moreno@coolnet.site,679449,ES86209540321172255358,5267.8,2022-12-08T14:54:47,Galdakao,expenses,water,-62.83,-20859.61
buyer_4,Jorge,Moreno,1974-05-23,32144178E,jorge.moreno@coolnet.site,679449,ES86209540321172255358,5267.8,2022-12-08T15:55:11,Galdakao,expenses,electricity,-84.8,-20944.41
buyer_4,Jorge,Moreno,1974-05-23,32144178E,jorge.moreno@coolnet.site,679449,ES86209540321172255358,5267.8,2022-12-08T06:42:38,Galdakao,expenses,gas,-110.48,-21054.89
buyer_4,Jorge,Moreno,1974-05-23,32144178E,jorge.moreno@coolnet.site,679449,ES86209540321172255358,5267.8,2022-12-08T18:47:12,Galdakao,expenses,internet,-59.64,-21114.53
buyer_4,Jorge,Moreno,1974-05-23,32144178E,jorge.moreno@coolnet.site,679449,ES86209540321172255358,5267.8,2022-12-08T16:14:40,Galdakao,expenses,cash,-100.0,-21214.53
buyer_4,Jorge,Moreno,1974-05-23,32144178E,jorge.moreno@coolnet.site,679449,ES86209540321172255358,5267.8,2022-12-09T09:54:54,Galdakao,expenses,education,-59.81,-21274.34
buyer_4,Jorge,Moreno,1974-05-23,32144178E,jorge.moreno@coolnet.site,679449,ES86209540321172255358,5267.8,2022-12-09T04:28:50,Galdakao,expenses,appliances,-135.28,-21409.62
buyer_4,Jorge,Moreno,1974-05-23,32144178E,jorge.moreno@coolnet.site,679449,ES86209540321172255358,5267.8,2022-12-09T19:32:02,Galdakao,expenses,repairs,-145.59,-21555.21
buyer_4,Jorge,Moreno,1974-05-23,32144178E,jorge.moreno@coolnet.site,679449,ES86209540321172255358,5267.8,2022-12-11T18:49:22,Galdakao,expenses,gifts,-82.33,-21637.54
buyer_4,Jorge,Moreno,1974-05-23,32144178E,jorge.moreno@coolnet.site,679449,ES86209540321172255358,5267.8,2022-12-12T13:01:36,Galdakao,expenses,repairs,-320.36,-21957.9
buyer_4,Jorge,Moreno,1974-05-23,32144178E,jorge.moreno@coolnet.site,679449,ES86209540321172255358,5267.8,2022-12-14T12:57:25,Galdakao,expenses,leisure,-63.18,-22021.08
buyer_4,Jorge,Moreno,1974-05-23,32144178E,jorge.moreno@coolnet.site,679449,ES86209540321172255358,5267.8,2022-12-14T08:44:45,Galdakao,expenses,cash,-100.0,-22121.08
buyer_4,Jorge,Moreno,1974-05-23,32144178E,jorge.moreno@coolnet.site,679449,ES86209540321172255358,5267.8,2022-12-15T09:13:17,Galdakao,expenses,cash,-100.0,-22221.08
buyer_4,Jorge,Moreno,1974-05-23,32144178E,jorge.moreno@coolnet.site,679449,ES86209540321172255358,5267.8,2022-12-17T10:44:47,Galdakao,expenses,gifts,-834.9,-23055.98
buyer_4,Jorge,Moreno,1974-05-23,32144178E,jorge.moreno@coolnet.site,679449,ES86209540321172255358,5267.8,2022-12-18T16:57:13,Galdakao,expenses,leisure,-56.23,-23112.21
buyer_4,Jorge,Moreno,1974-05-23,32144178E,jorge.moreno@coolnet.site,679449,ES86209540321172255358,5267.8,2022-12-19T20:55:59,Galdakao,expenses,repairs,-113.1,-23225.31
buyer_4,Jorge,Moreno,1974-05-23,32144178E,jorge.moreno@coolnet.site,679449,ES86209540321172255358,5267.8,2022-12-20T15:52:35,Galdakao,expenses,cash,-100.0,-23325.31
buyer_4,Jorge,Moreno,1974-05-23,32144178E,jorge.moreno@coolnet.site,679449,ES86209540321172255358,5267.8,2022-12-21T09:11:02,Galdakao,expenses,clothing,-154.13,-23479.44
buyer_4,Jorge,Moreno,1974-05-23,32144178E,jorge.moreno@coolnet.site,679449,ES86209540321172255358,5267.8,2022-12-22T20:26:47,Galdakao,expenses,cash,-100.0,-23579.44
buyer_4,Jorge,Moreno,1974-05-23,32144178E,jorge.moreno@coolnet.site,679449,ES86209540321172255358,5267.8,2022-12-24T18:53:48,Galdakao,expenses,healthcare,-146.0,-23725.44
buyer_4,Jorge,Moreno,1974-05-23,32144178E,jorge.moreno@coolnet.site,679449,ES86209540321172255358,5267.8,2022-12-24T14:28:52,Galdakao,expenses,education,-74.03,-23799.47
buyer_4,Jorge,Moreno,1974-05-23,32144178E,jorge.moreno@coolnet.site,679449,ES86209540321172255358,5267.8,2022-12-24T23:37:57,Galdakao,expenses,children,-985.9834166666665,-24785.45
buyer_4,Jorge,Moreno,1974-05-23,32144178E,jorge.moreno@coolnet.site,679449,ES86209540321172255358,5267.8,2022-12-25T20:22:13,Galdakao,expenses,children,-1206.0134166666664,-25991.46
buyer_4,Jorge,Moreno,1974-05-23,32144178E,jorge.moreno@coolnet.site,679449,ES86209540321172255358,5267.8,2022-12-26T16:33:01,Galdakao,expenses,cash,-100.0,-26091.46
buyer_4,Jorge,Moreno,1974-05-23,32144178E,jorge.moreno@coolnet.site,679449,ES86209540321172255358,5267.8,2022-12-26T03:33:07,Galdakao,expenses,appliances,-254.18,-26345.64
buyer_4,Jorge,Moreno,1974-05-23,32144178E,jorge.moreno@coolnet.site,679449,ES86209540321172255358,5267.8,2022-12-27T12:45:58,Galdakao,expenses,transport,-76.79,-26422.43
buyer_4,Jorge,Moreno,1974-05-23,32144178E,jorge.moreno@coolnet.site,679449,ES86209540321172255358,5267.8,2022-12-30T10:58:58,Galdakao,expenses,clothing,-108.96,-26531.39
buyer_4,Jorge,Moreno,1974-05-23,32144178E,jorge.moreno@coolnet.site,679449,ES86209540321172255358,5267.8,2022-12-31T15:14:29,Galdakao,expenses,food,-114.23,-26645.62
buyer_4,Jorge,Moreno,1974-05-23,32144178E,jorge.moreno@coolnet.site,679449,ES86209540321172255358,5267.8,2022-12-31T08:18:32,Galdakao,expenses,leisure,-58.75,-26704.37
buyer_4,Jorge,Moreno,1974-05-23,32144178E,jorge.moreno@coolnet.site,679449,ES86209540321172255358,5267.8,2022-12-31T08:36:58,Galdakao,expenses,clothing,-138.6,-26842.97
buyer_4,Jorge,Moreno,1974-05-23,32144178E,jorge.moreno@coolnet.site,679449,ES86209540321172255358,5267.8,2023-01-01T12:17:55,Galdakao,incomes,salary,2938.4,-23904.57
buyer_4,Jorge,Moreno,1974-05-23,32144178E,jorge.moreno@coolnet.site,679449,ES86209540321172255358,5267.8,2023-01-02T22:06:44,Galdakao,expenses,cash,-100.0,-24004.57
buyer_4,Jorge,Moreno,1974-05-23,32144178E,jorge.moreno@coolnet.site,679449,ES86209540321172255358,5267.8,2023-01-03T11:19:04,Galdakao,expenses,food,-98.13,-24102.7
buyer_4,Jorge,Moreno,1974-05-23,32144178E,jorge.moreno@coolnet.site,679449,ES86209540321172255358,5267.8,2023-01-03T19:07:58,Galdakao,expenses,leisure,-32.43,-24135.13
buyer_4,Jorge,Moreno,1974-05-23,32144178E,jorge.moreno@coolnet.site,679449,ES86209540321172255358,5267.8,2023-01-04T09:13:29,Galdakao,expenses,mortgage,-1482.67,-25617.8
buyer_4,Jorge,Moreno,1974-05-23,32144178E,jorge.moreno@coolnet.site,679449,ES86209540321172255358,5267.8,2023-01-04T07:00:17,Galdakao,expenses,transport,-68.88,-25686.68
buyer_4,Jorge,Moreno,1974-05-23,32144178E,jorge.moreno@coolnet.site,679449,ES86209540321172255358,5267.8,2023-01-05T13:02:54,Galdakao,expenses,electricity,-99.62,-25786.3
buyer_4,Jorge,Moreno,1974-05-23,32144178E,jorge.moreno@coolnet.site,679449,ES86209540321172255358,5267.8,2023-01-05T15:43:24,Galdakao,expenses,phone,-49.9,-25836.2
buyer_4,Jorge,Moreno,1974-05-23,32144178E,jorge.moreno@coolnet.site,679449,ES86209540321172255358,5267.8,2023-01-05T14:44:45,Galdakao,expenses,transport,-67.4,-25903.6
buyer_4,Jorge,Moreno,1974-05-23,32144178E,jorge.moreno@coolnet.site,679449,ES86209540321172255358,5267.8,2023-01-06T17:58:03,Galdakao,expenses,appliances,-151.06,-26054.66
buyer_4,Jorge,Moreno,1974-05-23,32144178E,jorge.moreno@coolnet.site,679449,ES86209540321172255358,5267.8,2023-01-07T17:47:41,Galdakao,expenses,food,-67.39,-26122.05
buyer_4,Jorge,Moreno,1974-05-23,32144178E,jorge.moreno@coolnet.site,679449,ES86209540321172255358,5267.8,2023-01-07T20:19:45,Galdakao,expenses,leisure,-43.4,-26165.45
buyer_4,Jorge,Moreno,1974-05-23,32144178E,jorge.moreno@coolnet.site,679449,ES86209540321172255358,5267.8,2023-01-07T22:39:18,Galdakao,expenses,children,-805.0030833333337,-26970.45
buyer_4,Jorge,Moreno,1974-05-23,32144178E,jorge.moreno@coolnet.site,679449,ES86209540321172255358,5267.8,2023-01-08T16:54:47,Galdakao,expenses,water,-65.09,-27035.54
buyer_4,Jorge,Moreno,1974-05-23,32144178E,jorge.moreno@coolnet.site,679449,ES86209540321172255358,5267.8,2023-01-08T10:52:20,Galdakao,expenses,gas,-142.87,-27178.41
buyer_4,Jorge,Moreno,1974-05-23,32144178E,jorge.moreno@coolnet.site,679449,ES86209540321172255358,5267.8,2023-01-08T17:28:49,Galdakao,expenses,internet,-61.71,-27240.12
buyer_4,Jorge,Moreno,1974-05-23,32144178E,jorge.moreno@coolnet.site,679449,ES86209540321172255358,5267.8,2023-01-08T20:30:24,Galdakao,expenses,food,-121.63,-27361.75
buyer_4,Jorge,Moreno,1974-05-23,32144178E,jorge.moreno@coolnet.site,679449,ES86209540321172255358,5267.8,2023-01-08T17:50:49,Galdakao,expenses,clothing,-98.56,-27460.31
buyer_4,Jorge,Moreno,1974-05-23,32144178E,jorge.moreno@coolnet.site,679449,ES86209540321172255358,5267.8,2023-01-08T23:19:17,Galdakao,expenses,cash,-100.0,-27560.31
buyer_4,Jorge,Moreno,1974-05-23,32144178E,jorge.moreno@coolnet.site,679449,ES86209540321172255358,5267.8,2023-01-10T17:12:45,Galdakao,expenses,gifts,-230.95,-27791.26
buyer_4,Jorge,Moreno,1974-05-23,32144178E,jorge.moreno@coolnet.site,679449,ES86209540321172255358,5267.8,2023-01-11T08:45:37,Galdakao,expenses,cash,-100.0,-27891.26
buyer_4,Jorge,Moreno,1974-05-23,32144178E,jorge.moreno@coolnet.site,679449,ES86209540321172255358,5267.8,2023-01-12T09:30:28,Galdakao,expenses,leisure,-36.68,-27927.94
buyer_4,Jorge,Moreno,1974-05-23,32144178E,jorge.moreno@coolnet.site,679449,ES86209540321172255358,5267.8,2023-01-13T20:57:48,Galdakao,expenses,cash,-100.0,-28027.94
buyer_4,Jorge,Moreno,1974-05-23,32144178E,jorge.moreno@coolnet.site,679449,ES86209540321172255358,5267.8,2023-01-14T11:01:12,Galdakao,expenses,clothing,-82.68,-28110.62
buyer_4,Jorge,Moreno,1974-05-23,32144178E,jorge.moreno@coolnet.site,679449,ES86209540321172255358,5267.8,2023-01-16T15:14:20,Galdakao,expenses,food,-116.56,-28227.18
buyer_4,Jorge,Moreno,1974-05-23,32144178E,jorge.moreno@coolnet.site,679449,ES86209540321172255358,5267.8,2023-01-16T03:43:22,Galdakao,expenses,healthcare,-119.85,-28347.03
buyer_4,Jorge,Moreno,1974-05-23,32144178E,jorge.moreno@coolnet.site,679449,ES86209540321172255358,5267.8,2023-01-16T23:26:55,Galdakao,expenses,education,-50.23,-28397.26
buyer_4,Jorge,Moreno,1974-05-23,32144178E,jorge.moreno@coolnet.site,679449,ES86209540321172255358,5267.8,2023-01-18T20:46:02,Galdakao,expenses,cash,-100.0,-28497.26
buyer_4,Jorge,Moreno,1974-05-23,32144178E,jorge.moreno@coolnet.site,679449,ES86209540321172255358,5267.8,2023-01-19T16:36:01,Galdakao,expenses,food,-118.9,-28616.16
buyer_4,Jorge,Moreno,1974-05-23,32144178E,jorge.moreno@coolnet.site,679449,ES86209540321172255358,5267.8,2023-01-19T10:45:49,Galdakao,expenses,cash,-100.0,-28716.16
buyer_4,Jorge,Moreno,1974-05-23,32144178E,jorge.moreno@coolnet.site,679449,ES86209540321172255358,5267.8,2023-01-19T12:04:25,Galdakao,expenses,repairs,-318.08,-29034.24
buyer_4,Jorge,Moreno,1974-05-23,32144178E,jorge.moreno@coolnet.site,679449,ES86209540321172255358,5267.8,2023-01-20T17:53:16,Galdakao,expenses,food,-74.49,-29108.73
buyer_4,Jorge,Moreno,1974-05-23,32144178E,jorge.moreno@coolnet.site,679449,ES86209540321172255358,5267.8,2023-01-20T22:29:25,Galdakao,expenses,cash,-100.0,-29208.73
buyer_4,Jorge,Moreno,1974-05-23,32144178E,jorge.moreno@coolnet.site,679449,ES86209540321172255358,5267.8,2023-01-21T07:19:41,Galdakao,expenses,cash,-100.0,-29308.73
buyer_4,Jorge,Moreno,1974-05-23,32144178E,jorge.moreno@coolnet.site,679449,ES86209540321172255358,5267.8,2023-01-22T19:42:23,Galdakao,expenses,transport,-46.03,-29354.76
buyer_4,Jorge,Moreno,1974-05-23,32144178E,jorge.moreno@coolnet.site,679449,ES86209540321172255358,5267.8,2023-01-22T09:27:04,Galdakao,expenses,cash,-100.0,-29454.76
buyer_4,Jorge,Moreno,1974-05-23,32144178E,jorge.moreno@coolnet.site,679449,ES86209540321172255358,5267.8,2023-01-23T14:48:56,Galdakao,expenses,clothing,-151.47,-29606.23
buyer_4,Jorge,Moreno,1974-05-23,32144178E,jorge.moreno@coolnet.site,679449,ES86209540321172255358,5267.8,2023-01-23T17:08:52,Galdakao,expenses,cash,-100.0,-29706.23
buyer_4,Jorge,Moreno,1974-05-23,32144178E,jorge.moreno@coolnet.site,679449,ES86209540321172255358,5267.8,2023-01-25T12:20:57,Galdakao,expenses,cash,-100.0,-29806.23
buyer_4,Jorge,Moreno,1974-05-23,32144178E,jorge.moreno@coolnet.site,679449,ES86209540321172255358,5267.8,2023-01-27T07:06:16,Galdakao,expenses,clothing,-99.04,-29905.27
buyer_4,Jorge,Moreno,1974-05-23,32144178E,jorge.moreno@coolnet.site,679449,ES86209540321172255358,5267.8,2023-01-27T11:32:04,Galdakao,expenses,education,-44.52,-29949.79
buyer_4,Jorge,Moreno,1974-05-23,32144178E,jorge.moreno@coolnet.site,679449,ES86209540321172255358,5267.8,2023-01-28T14:07:43,Galdakao,expenses,leisure,-48.83,-29998.62
buyer_4,Jorge,Moreno,1974-05-23,32144178E,jorge.moreno@coolnet.site,679449,ES86209540321172255358,5267.8,2023-01-29T15:01:22,Galdakao,expenses,healthcare,-72.34,-30070.96
buyer_4,Jorge,Moreno,1974-05-23,32144178E,jorge.moreno@coolnet.site,679449,ES86209540321172255358,5267.8,2023-01-30T11:46:49,Galdakao,expenses,travel,-805.23,-30876.19
buyer_4,Jorge,Moreno,1974-05-23,32144178E,jorge.moreno@coolnet.site,679449,ES86209540321172255358,5267.8,2023-01-31T09:11:24,Galdakao,expenses,food,-104.89,-30981.08
buyer_4,Jorge,Moreno,1974-05-23,32144178E,jorge.moreno@coolnet.site,679449,ES86209540321172255358,5267.8,2023-02-01T13:10:07,Galdakao,incomes,salary,2938.4,-28042.68
buyer_4,Jorge,Moreno,1974-05-23,32144178E,jorge.moreno@coolnet.site,679449,ES86209540321172255358,5267.8,2023-02-01T10:21:12,Galdakao,expenses,food,-96.8,-28139.48
buyer_4,Jorge,Moreno,1974-05-23,32144178E,jorge.moreno@coolnet.site,679449,ES86209540321172255358,5267.8,2023-02-01T19:42:24,Galdakao,expenses,leisure,-26.6,-28166.08
buyer_4,Jorge,Moreno,1974-05-23,32144178E,jorge.moreno@coolnet.site,679449,ES86209540321172255358,5267.8,2023-02-01T17:16:32,Galdakao,expenses,cash,-100.0,-28266.08
buyer_4,Jorge,Moreno,1974-05-23,32144178E,jorge.moreno@coolnet.site,679449,ES86209540321172255358,5267.8,2023-02-04T05:35:21,Galdakao,expenses,mortgage,-1482.67,-29748.75
buyer_4,Jorge,Moreno,1974-05-23,32144178E,jorge.moreno@coolnet.site,679449,ES86209540321172255358,5267.8,2023-02-04T23:51:28,Galdakao,expenses,transport,-89.15,-29837.9
buyer_4,Jorge,Moreno,1974-05-23,32144178E,jorge.moreno@coolnet.site,679449,ES86209540321172255358,5267.8,2023-02-05T23:37:57,Galdakao,expenses,internet,-61.71,-29899.61
buyer_4,Jorge,Moreno,1974-05-23,32144178E,jorge.moreno@coolnet.site,679449,ES86209540321172255358,5267.8,2023-02-05T12:26:30,Galdakao,expenses,phone,-60.49,-29960.1
buyer_4,Jorge,Moreno,1974-05-23,32144178E,jorge.moreno@coolnet.site,679449,ES86209540321172255358,5267.8,2023-02-05T09:37:49,Galdakao,expenses,leisure,-37.74,-29997.84
buyer_4,Jorge,Moreno,1974-05-23,32144178E,jorge.moreno@coolnet.site,679449,ES86209540321172255358,5267.8,2023-02-06T13:09:57,Galdakao,expenses,electricity,-110.43,-30108.27
buyer_4,Jorge,Moreno,1974-05-23,32144178E,jorge.moreno@coolnet.site,679449,ES86209540321172255358,5267.8,2023-02-07T08:04:33,Galdakao,expenses,gas,-73.54,-30181.81
buyer_4,Jorge,Moreno,1974-05-23,32144178E,jorge.moreno@coolnet.site,679449,ES86209540321172255358,5267.8,2023-02-07T07:05:42,Galdakao,expenses,cash,-100.0,-30281.81
buyer_4,Jorge,Moreno,1974-05-23,32144178E,jorge.moreno@coolnet.site,679449,ES86209540321172255358,5267.8,2023-02-08T17:07:06,Galdakao,expenses,water,-47.45,-30329.26
buyer_4,Jorge,Moreno,1974-05-23,32144178E,jorge.moreno@coolnet.site,679449,ES86209540321172255358,5267.8,2023-02-08T19:11:00,Galdakao,expenses,transport,-59.34,-30388.6
buyer_4,Jorge,Moreno,1974-05-23,32144178E,jorge.moreno@coolnet.site,679449,ES86209540321172255358,5267.8,2023-02-10T14:01:48,Galdakao,expenses,leisure,-25.92,-30414.52
buyer_4,Jorge,Moreno,1974-05-23,32144178E,jorge.moreno@coolnet.site,679449,ES86209540321172255358,5267.8,2023-02-13T14:28:42,Galdakao,expenses,transport,-79.56,-30494.08
buyer_4,Jorge,Moreno,1974-05-23,32144178E,jorge.moreno@coolnet.site,679449,ES86209540321172255358,5267.8,2023-02-15T00:08:59,Galdakao,expenses,clothing,-153.41,-30647.49
buyer_4,Jorge,Moreno,1974-05-23,32144178E,jorge.moreno@coolnet.site,679449,ES86209540321172255358,5267.8,2023-02-18T15:40:58,Galdakao,expenses,cash,-100.0,-30747.49
buyer_4,Jorge,Moreno,1974-05-23,32144178E,jorge.moreno@coolnet.site,679449,ES86209540321172255358,5267.8,2023-02-19T09:05:46,Galdakao,expenses,transport,-53.19,-30800.68
buyer_4,Jorge,Moreno,1974-05-23,32144178E,jorge.moreno@coolnet.site,679449,ES86209540321172255358,5267.8,2023-02-20T12:34:09,Galdakao,expenses,clothing,-134.84,-30935.52
buyer_4,Jorge,Moreno,1974-05-23,32144178E,jorge.moreno@coolnet.site,679449,ES86209540321172255358,5267.8,2023-02-20T13:12:37,Galdakao,expenses,gifts,-565.36,-31500.88
buyer_4,Jorge,Moreno,1974-05-23,32144178E,jorge.moreno@coolnet.site,679449,ES86209540321172255358,5267.8,2023-02-21T17:51:28,Galdakao,expenses,transport,-74.34,-31575.22
buyer_4,Jorge,Moreno,1974-05-23,32144178E,jorge.moreno@coolnet.site,679449,ES86209540321172255358,5267.8,2023-02-25T09:56:40,Galdakao,expenses,cash,-100.0,-31675.22
buyer_4,Jorge,Moreno,1974-05-23,32144178E,jorge.moreno@coolnet.site,679449,ES86209540321172255358,5267.8,2023-02-26T22:54:44,Galdakao,expenses,food,-71.86,-31747.08
buyer_4,Jorge,Moreno,1974-05-23,32144178E,jorge.moreno@coolnet.site,679449,ES86209540321172255358,5267.8,2023-03-01T18:16:40,Galdakao,incomes,salary,2938.4,-28808.68
buyer_4,Jorge,Moreno,1974-05-23,32144178E,jorge.moreno@coolnet.site,679449,ES86209540321172255358,5267.8,2023-03-01T18:16:40,Galdakao,incomes,extra_income,338.65,-28470.03
buyer_4,Jorge,Moreno,1974-05-23,32144178E,jorge.moreno@coolnet.site,679449,ES86209540321172255358,5267.8,2023-03-02T11:28:27,Galdakao,expenses,healthcare,-116.7,-28586.73
buyer_4,Jorge,Moreno,1974-05-23,32144178E,jorge.moreno@coolnet.site,679449,ES86209540321172255358,5267.8,2023-03-03T18:56:06,Galdakao,expenses,gifts,-673.03,-29259.76
buyer_4,Jorge,Moreno,1974-05-23,32144178E,jorge.moreno@coolnet.site,679449,ES86209540321172255358,5267.8,2023-03-04T11:03:55,Galdakao,expenses,mortgage,-1482.67,-30742.43
buyer_4,Jorge,Moreno,1974-05-23,32144178E,jorge.moreno@coolnet.site,679449,ES86209540321172255358,5267.8,2023-03-04T14:07:48,Galdakao,expenses,transport,-47.62,-30790.05
buyer_4,Jorge,Moreno,1974-05-23,32144178E,jorge.moreno@coolnet.site,679449,ES86209540321172255358,5267.8,2023-03-04T10:13:57,Galdakao,expenses,leisure,-33.13,-30823.18
buyer_4,Jorge,Moreno,1974-05-23,32144178E,jorge.moreno@coolnet.site,679449,ES86209540321172255358,5267.8,2023-03-04T04:04:07,Galdakao,expenses,clothing,-72.2,-30895.38
buyer_4,Jorge,Moreno,1974-05-23,32144178E,jorge.moreno@coolnet.site,679449,ES86209540321172255358,5267.8,2023-03-05T12:17:18,Galdakao,expenses,phone,-45.73,-30941.11
buyer_4,Jorge,Moreno,1974-05-23,32144178E,jorge.moreno@coolnet.site,679449,ES86209540321172255358,5267.8,2023-03-07T08:04:47,Galdakao,expenses,gas,-62.13,-31003.24
buyer_4,Jorge,Moreno,1974-05-23,32144178E,jorge.moreno@coolnet.site,679449,ES86209540321172255358,5267.8,2023-03-07T09:19:11,Galdakao,expenses,cash,-100.0,-31103.24
buyer_4,Jorge,Moreno,1974-05-23,32144178E,jorge.moreno@coolnet.site,679449,ES86209540321172255358,5267.8,2023-03-08T15:40:42,Galdakao,expenses,water,-60.53,-31163.77
buyer_4,Jorge,Moreno,1974-05-23,32144178E,jorge.moreno@coolnet.site,679449,ES86209540321172255358,5267.8,2023-03-08T13:15:36,Galdakao,expenses,electricity,-110.59,-31274.36
buyer_4,Jorge,Moreno,1974-05-23,32144178E,jorge.moreno@coolnet.site,679449,ES86209540321172255358,5267.8,2023-03-08T09:34:51,Galdakao,expenses,internet,-61.71,-31336.07
buyer_4,Jorge,Moreno,1974-05-23,32144178E,jorge.moreno@coolnet.site,679449,ES86209540321172255358,5267.8,2023-03-08T17:53:39,Galdakao,expenses,healthcare,-187.44,-31523.51
buyer_4,Jorge,Moreno,1974-05-23,32144178E,jorge.moreno@coolnet.site,679449,ES86209540321172255358,5267.8,2023-03-09T14:28:32,Galdakao,expenses,children,-915.7930833333337,-32439.3
buyer_4,Jorge,Moreno,1974-05-23,32144178E,jorge.moreno@coolnet.site,679449,ES86209540321172255358,5267.8,2023-03-10T15:25:57,Galdakao,expenses,food,-122.47,-32561.77
buyer_4,Jorge,Moreno,1974-05-23,32144178E,jorge.moreno@coolnet.site,679449,ES86209540321172255358,5267.8,2023-03-11T17:07:59,Galdakao,expenses,education,-71.63,-32633.4
buyer_4,Jorge,Moreno,1974-05-23,32144178E,jorge.moreno@coolnet.site,679449,ES86209540321172255358,5267.8,2023-03-14T11:47:43,Galdakao,expenses,transport,-84.29,-32717.69
buyer_4,Jorge,Moreno,1974-05-23,32144178E,jorge.moreno@coolnet.site,679449,ES86209540321172255358,5267.8,2023-03-14T13:29:01,Galdakao,expenses,cash,-100.0,-32817.69
buyer_4,Jorge,Moreno,1974-05-23,32144178E,jorge.moreno@coolnet.site,679449,ES86209540321172255358,5267.8,2023-03-14T03:39:00,Galdakao,expenses,repairs,-191.87,-33009.56
buyer_4,Jorge,Moreno,1974-05-23,32144178E,jorge.moreno@coolnet.site,679449,ES86209540321172255358,5267.8,2023-03-17T11:04:15,Galdakao,expenses,transport,-50.11,-33059.67
buyer_4,Jorge,Moreno,1974-05-23,32144178E,jorge.moreno@coolnet.site,679449,ES86209540321172255358,5267.8,2023-03-17T14:43:13,Galdakao,expenses,healthcare,-110.5,-33170.17
buyer_4,Jorge,Moreno,1974-05-23,32144178E,jorge.moreno@coolnet.site,679449,ES86209540321172255358,5267.8,2023-03-17T15:00:25,Galdakao,expenses,cash,-100.0,-33270.17
buyer_4,Jorge,Moreno,1974-05-23,32144178E,jorge.moreno@coolnet.site,679449,ES86209540321172255358,5267.8,2023-03-17T13:56:57,Galdakao,expenses,gifts,-441.23,-33711.4
buyer_4,Jorge,Moreno,1974-05-23,32144178E,jorge.moreno@coolnet.site,679449,ES86209540321172255358,5267.8,2023-03-18T09:03:22,Galdakao,expenses,clothing,-92.8,-33804.2
buyer_4,Jorge,Moreno,1974-05-23,32144178E,jorge.moreno@coolnet.site,679449,ES86209540321172255358,5267.8,2023-03-20T09:43:34,Galdakao,expenses,clothing,-125.17,-33929.37
buyer_4,Jorge,Moreno,1974-05-23,32144178E,jorge.moreno@coolnet.site,679449,ES86209540321172255358,5267.8,2023-03-21T02:10:08,Galdakao,expenses,travel,-467.72,-34397.09
buyer_4,Jorge,Moreno,1974-05-23,32144178E,jorge.moreno@coolnet.site,679449,ES86209540321172255358,5267.8,2023-03-23T09:33:46,Galdakao,expenses,cash,-100.0,-34497.09
buyer_4,Jorge,Moreno,1974-05-23,32144178E,jorge.moreno@coolnet.site,679449,ES86209540321172255358,5267.8,2023-03-23T15:51:23,Galdakao,expenses,gifts,-549.65,-35046.74
buyer_4,Jorge,Moreno,1974-05-23,32144178E,jorge.moreno@coolnet.site,679449,ES86209540321172255358,5267.8,2023-03-26T12:16:26,Galdakao,expenses,food,-98.75,-35145.49
buyer_4,Jorge,Moreno,1974-05-23,32144178E,jorge.moreno@coolnet.site,679449,ES86209540321172255358,5267.8,2023-03-26T16:07:00,Galdakao,expenses,cash,-100.0,-35245.49
buyer_4,Jorge,Moreno,1974-05-23,32144178E,jorge.moreno@coolnet.site,679449,ES86209540321172255358,5267.8,2023-03-28T06:29:47,Galdakao,expenses,food,-75.45,-35320.94
buyer_4,Jorge,Moreno,1974-05-23,32144178E,jorge.moreno@coolnet.site,679449,ES86209540321172255358,5267.8,2023-03-28T08:31:17,Galdakao,expenses,leisure,-55.75,-35376.69
buyer_4,Jorge,Moreno,1974-05-23,32144178E,jorge.moreno@coolnet.site,679449,ES86209540321172255358,5267.8,2023-03-29T16:44:56,Galdakao,expenses,clothing,-49.59,-35426.28
buyer_4,Jorge,Moreno,1974-05-23,32144178E,jorge.moreno@coolnet.site,679449,ES86209540321172255358,5267.8,2023-03-29T19:11:23,Galdakao,expenses,healthcare,-65.49,-35491.77
buyer_4,Jorge,Moreno,1974-05-23,32144178E,jorge.moreno@coolnet.site,679449,ES86209540321172255358,5267.8,2023-04-01T19:46:17,Galdakao,incomes,salary,2938.4,-32553.37
buyer_4,Jorge,Moreno,1974-05-23,32144178E,jorge.moreno@coolnet.site,679449,ES86209540321172255358,5267.8,2023-04-01T15:39:39,Galdakao,expenses,leisure,-59.98,-32613.35
buyer_4,Jorge,Moreno,1974-05-23,32144178E,jorge.moreno@coolnet.site,679449,ES86209540321172255358,5267.8,2023-04-04T10:13:56,Galdakao,expenses,mortgage,-1482.67,-34096.02
buyer_4,Jorge,Moreno,1974-05-23,32144178E,jorge.moreno@coolnet.site,679449,ES86209540321172255358,5267.8,2023-04-04T07:07:15,Galdakao,expenses,education,-75.8,-34171.82
buyer_4,Jorge,Moreno,1974-05-23,32144178E,jorge.moreno@coolnet.site,679449,ES86209540321172255358,5267.8,2023-04-05T08:04:03,Galdakao,expenses,electricity,-64.27,-34236.09
buyer_4,Jorge,Moreno,1974-05-23,32144178E,jorge.moreno@coolnet.site,679449,ES86209540321172255358,5267.8,2023-04-05T15:35:13,Galdakao,expenses,gas,-146.57,-34382.66
buyer_4,Jorge,Moreno,1974-05-23,32144178E,jorge.moreno@coolnet.site,679449,ES86209540321172255358,5267.8,2023-04-05T13:44:01,Galdakao,expenses,internet,-61.71,-34444.37
buyer_4,Jorge,Moreno,1974-05-23,32144178E,jorge.moreno@coolnet.site,679449,ES86209540321172255358,5267.8,2023-04-05T17:59:14,Galdakao,expenses,phone,-55.35,-34499.72
buyer_4,Jorge,Moreno,1974-05-23,32144178E,jorge.moreno@coolnet.site,679449,ES86209540321172255358,5267.8,2023-04-05T20:53:01,Galdakao,expenses,appliances,-319.14,-34818.86
buyer_4,Jorge,Moreno,1974-05-23,32144178E,jorge.moreno@coolnet.site,679449,ES86209540321172255358,5267.8,2023-04-06T16:34:54,Galdakao,expenses,food,-122.46,-34941.32
buyer_4,Jorge,Moreno,1974-05-23,32144178E,jorge.moreno@coolnet.site,679449,ES86209540321172255358,5267.8,2023-04-08T09:53:39,Galdakao,expenses,water,-59.91,-35001.23
buyer_4,Jorge,Moreno,1974-05-23,32144178E,jorge.moreno@coolnet.site,679449,ES86209540321172255358,5267.8,2023-04-08T08:06:51,Galdakao,expenses,repairs,-227.85,-35229.08
buyer_4,Jorge,Moreno,1974-05-23,32144178E,jorge.moreno@coolnet.site,679449,ES86209540321172255358,5267.8,2023-04-09T22:54:20,Galdakao,expenses,food,-70.91,-35299.99
buyer_4,Jorge,Moreno,1974-05-23,32144178E,jorge.moreno@coolnet.site,679449,ES86209540321172255358,5267.8,2023-04-09T08:25:02,Galdakao,expenses,leisure,-39.95,-35339.94
buyer_4,Jorge,Moreno,1974-05-23,32144178E,jorge.moreno@coolnet.site,679449,ES86209540321172255358,5267.8,2023-04-09T09:41:25,Galdakao,expenses,gifts,-271.42,-35611.36
buyer_4,Jorge,Moreno,1974-05-23,32144178E,jorge.moreno@coolnet.site,679449,ES86209540321172255358,5267.8,2023-04-10T20:00:59,Galdakao,expenses,food,-68.6,-35679.96
buyer_4,Jorge,Moreno,1974-05-23,32144178E,jorge.moreno@coolnet.site,679449,ES86209540321172255358,5267.8,2023-04-13T13:19:03,Galdakao,expenses,food,-110.06,-35790.02
buyer_4,Jorge,Moreno,1974-05-23,32144178E,jorge.moreno@coolnet.site,679449,ES86209540321172255358,5267.8,2023-04-14T23:56:19,Galdakao,expenses,cash,-100.0,-35890.02
buyer_4,Jorge,Moreno,1974-05-23,32144178E,jorge.moreno@coolnet.site,679449,ES86209540321172255358,5267.8,2023-04-15T10:47:45,Galdakao,expenses,education,-57.09,-35947.11
buyer_4,Jorge,Moreno,1974-05-23,32144178E,jorge.moreno@coolnet.site,679449,ES86209540321172255358,5267.8,2023-04-17T12:48:28,Galdakao,expenses,transport,-78.5,-36025.61
buyer_4,Jorge,Moreno,1974-05-23,32144178E,jorge.moreno@coolnet.site,679449,ES86209540321172255358,5267.8,2023-04-18T17:49:01,Galdakao,expenses,transport,-60.74,-36086.35
buyer_4,Jorge,Moreno,1974-05-23,32144178E,jorge.moreno@coolnet.site,679449,ES86209540321172255358,5267.8,2023-04-19T13:38:38,Galdakao,expenses,food,-113.32,-36199.67
buyer_4,Jorge,Moreno,1974-05-23,32144178E,jorge.moreno@coolnet.site,679449,ES86209540321172255358,5267.8,2023-04-20T20:19:08,Galdakao,expenses,food,-123.84,-36323.51
buyer_4,Jorge,Moreno,1974-05-23,32144178E,jorge.moreno@coolnet.site,679449,ES86209540321172255358,5267.8,2023-04-20T09:29:52,Galdakao,expenses,repairs,-324.03,-36647.54
buyer_4,Jorge,Moreno,1974-05-23,32144178E,jorge.moreno@coolnet.site,679449,ES86209540321172255358,5267.8,2023-04-23T14:59:19,Galdakao,expenses,appliances,-168.58,-36816.12
buyer_4,Jorge,Moreno,1974-05-23,32144178E,jorge.moreno@coolnet.site,679449,ES86209540321172255358,5267.8,2023-04-24T22:12:22,Galdakao,expenses,cash,-100.0,-36916.12
buyer_4,Jorge,Moreno,1974-05-23,32144178E,jorge.moreno@coolnet.site,679449,ES86209540321172255358,5267.8,2023-04-25T16:02:45,Galdakao,expenses,food,-73.59,-36989.71
buyer_4,Jorge,Moreno,1974-05-23,32144178E,jorge.moreno@coolnet.site,679449,ES86209540321172255358,5267.8,2023-04-25T19:52:37,Galdakao,expenses,cash,-100.0,-37089.71
buyer_4,Jorge,Moreno,1974-05-23,32144178E,jorge.moreno@coolnet.site,679449,ES86209540321172255358,5267.8,2023-04-26T15:59:18,Galdakao,expenses,food,-111.44,-37201.15
buyer_4,Jorge,Moreno,1974-05-23,32144178E,jorge.moreno@coolnet.site,679449,ES86209540321172255358,5267.8,2023-04-29T14:03:24,Galdakao,expenses,repairs,-232.3,-37433.45
buyer_4,Jorge,Moreno,1974-05-23,32144178E,jorge.moreno@coolnet.site,679449,ES86209540321172255358,5267.8,2023-05-01T21:55:02,Galdakao,incomes,salary,2938.4,-34495.05
buyer_4,Jorge,Moreno,1974-05-23,32144178E,jorge.moreno@coolnet.site,679449,ES86209540321172255358,5267.8,2023-05-01T16:18:57,Galdakao,expenses,leisure,-70.73,-34565.78
buyer_4,Jorge,Moreno,1974-05-23,32144178E,jorge.moreno@coolnet.site,679449,ES86209540321172255358,5267.8,2023-05-02T17:56:02,Galdakao,expenses,food,-109.67,-34675.45
buyer_4,Jorge,Moreno,1974-05-23,32144178E,jorge.moreno@coolnet.site,679449,ES86209540321172255358,5267.8,2023-05-02T08:32:12,Galdakao,expenses,gifts,-602.05,-35277.5
buyer_4,Jorge,Moreno,1974-05-23,32144178E,jorge.moreno@coolnet.site,679449,ES86209540321172255358,5267.8,2023-05-04T06:31:54,Galdakao,expenses,mortgage,-1482.67,-36760.17
buyer_4,Jorge,Moreno,1974-05-23,32144178E,jorge.moreno@coolnet.site,679449,ES86209540321172255358,5267.8,2023-05-04T20:27:42,Galdakao,expenses,healthcare,-104.73,-36864.9
buyer_4,Jorge,Moreno,1974-05-23,32144178E,jorge.moreno@coolnet.site,679449,ES86209540321172255358,5267.8,2023-05-06T09:53:09,Galdakao,expenses,water,-42.45,-36907.35
buyer_4,Jorge,Moreno,1974-05-23,32144178E,jorge.moreno@coolnet.site,679449,ES86209540321172255358,5267.8,2023-05-06T11:18:28,Galdakao,expenses,gas,-162.35,-37069.7
buyer_4,Jorge,Moreno,1974-05-23,32144178E,jorge.moreno@coolnet.site,679449,ES86209540321172255358,5267.8,2023-05-06T20:19:59,Galdakao,expenses,phone,-56.86,-37126.56
buyer_4,Jorge,Moreno,1974-05-23,32144178E,jorge.moreno@coolnet.site,679449,ES86209540321172255358,5267.8,2023-05-06T01:40:54,Galdakao,expenses,leisure,-81.63,-37208.19
buyer_4,Jorge,Moreno,1974-05-23,32144178E,jorge.moreno@coolnet.site,679449,ES86209540321172255358,5267.8,2023-05-06T16:32:14,Galdakao,expenses,cash,-100.0,-37308.19
buyer_4,Jorge,Moreno,1974-05-23,32144178E,jorge.moreno@coolnet.site,679449,ES86209540321172255358,5267.8,2023-05-08T20:45:58,Galdakao,expenses,internet,-61.71,-37369.9
buyer_4,Jorge,Moreno,1974-05-23,32144178E,jorge.moreno@coolnet.site,679449,ES86209540321172255358,5267.8,2023-05-08T08:37:24,Galdakao,expenses,electricity,-96.68,-37466.58
buyer_4,Jorge,Moreno,1974-05-23,32144178E,jorge.moreno@coolnet.site,679449,ES86209540321172255358,5267.8,2023-05-08T01:19:53,Galdakao,expenses,transport,-65.88,-37532.46
buyer_4,Jorge,Moreno,1974-05-23,32144178E,jorge.moreno@coolnet.site,679449,ES86209540321172255358,5267.8,2023-05-10T12:17:33,Galdakao,expenses,food,-66.0,-37598.46
buyer_4,Jorge,Moreno,1974-05-23,32144178E,jorge.moreno@coolnet.site,679449,ES86209540321172255358,5267.8,2023-05-10T09:38:08,Galdakao,expenses,leisure,-79.01,-37677.47
buyer_4,Jorge,Moreno,1974-05-23,32144178E,jorge.moreno@coolnet.site,679449,ES86209540321172255358,5267.8,2023-05-11T09:56:46,Galdakao,expenses,education,-43.58,-37721.05
buyer_4,Jorge,Moreno,1974-05-23,32144178E,jorge.moreno@coolnet.site,679449,ES86209540321172255358,5267.8,2023-05-12T12:26:46,Galdakao,expenses,education,-42.45,-37763.5
buyer_4,Jorge,Moreno,1974-05-23,32144178E,jorge.moreno@coolnet.site,679449,ES86209540321172255358,5267.8,2023-05-13T09:42:45,Galdakao,expenses,food,-71.21,-37834.71
buyer_4,Jorge,Moreno,1974-05-23,32144178E,jorge.moreno@coolnet.site,679449,ES86209540321172255358,5267.8,2023-05-14T06:25:12,Galdakao,expenses,food,-91.19,-37925.9
buyer_4,Jorge,Moreno,1974-05-23,32144178E,jorge.moreno@coolnet.site,679449,ES86209540321172255358,5267.8,2023-05-15T13:47:10,Galdakao,expenses,food,-87.05,-38012.95
buyer_4,Jorge,Moreno,1974-05-23,32144178E,jorge.moreno@coolnet.site,679449,ES86209540321172255358,5267.8,2023-05-16T12:55:41,Galdakao,expenses,children,-623.71,-38636.66
buyer_4,Jorge,Moreno,1974-05-23,32144178E,jorge.moreno@coolnet.site,679449,ES86209540321172255358,5267.8,2023-05-17T23:45:11,Galdakao,expenses,cash,-100.0,-38736.66
buyer_4,Jorge,Moreno,1974-05-23,32144178E,jorge.moreno@coolnet.site,679449,ES86209540321172255358,5267.8,2023-05-18T13:08:31,Galdakao,expenses,children,-915.7930833333337,-39652.45
buyer_4,Jorge,Moreno,1974-05-23,32144178E,jorge.moreno@coolnet.site,679449,ES86209540321172255358,5267.8,2023-05-20T10:49:12,Galdakao,expenses,food,-79.91,-39732.36
buyer_4,Jorge,Moreno,1974-05-23,32144178E,jorge.moreno@coolnet.site,679449,ES86209540321172255358,5267.8,2023-05-21T23:22:02,Galdakao,expenses,leisure,-84.36,-39816.72
buyer_4,Jorge,Moreno,1974-05-23,32144178E,jorge.moreno@coolnet.site,679449,ES86209540321172255358,5267.8,2023-05-23T03:18:11,Galdakao,expenses,cash,-100.0,-39916.72
buyer_4,Jorge,Moreno,1974-05-23,32144178E,jorge.moreno@coolnet.site,679449,ES86209540321172255358,5267.8,2023-05-24T17:56:02,Galdakao,expenses,education,-60.9,-39977.62
buyer_4,Jorge,Moreno,1974-05-23,32144178E,jorge.moreno@coolnet.site,679449,ES86209540321172255358,5267.8,2023-05-24T19:52:27,Galdakao,expenses,travel,-603.49,-40581.11
buyer_4,Jorge,Moreno,1974-05-23,32144178E,jorge.moreno@coolnet.site,679449,ES86209540321172255358,5267.8,2023-05-25T23:53:46,Galdakao,expenses,transport,-77.89,-40659.0
buyer_4,Jorge,Moreno,1974-05-23,32144178E,jorge.moreno@coolnet.site,679449,ES86209540321172255358,5267.8,2023-05-27T17:27:03,Galdakao,expenses,cash,-100.0,-40759.0
buyer_4,Jorge,Moreno,1974-05-23,32144178E,jorge.moreno@coolnet.site,679449,ES86209540321172255358,5267.8,2023-05-30T14:47:40,Galdakao,expenses,healthcare,-42.33,-40801.33
buyer_4,Jorge,Moreno,1974-05-23,32144178E,jorge.moreno@coolnet.site,679449,ES86209540321172255358,5267.8,2023-06-01T08:57:53,Galdakao,incomes,salary,2938.4,-37862.93
buyer_4,Jorge,Moreno,1974-05-23,32144178E,jorge.moreno@coolnet.site,679449,ES86209540321172255358,5267.8,2023-06-01T08:57:53,Galdakao,incomes,extra_income,338.65,-37524.28
buyer_4,Jorge,Moreno,1974-05-23,32144178E,jorge.moreno@coolnet.site,679449,ES86209540321172255358,5267.8,2023-06-01T08:57:53,Galdakao,incomes,salary_bonus,2231.6,-35292.68
buyer_4,Jorge,Moreno,1974-05-23,32144178E,jorge.moreno@coolnet.site,679449,ES86209540321172255358,5267.8,2023-06-01T19:06:44,Galdakao,expenses,gifts,-130.85,-35423.53
buyer_4,Jorge,Moreno,1974-05-23,32144178E,jorge.moreno@coolnet.site,679449,ES86209540321172255358,5267.8,2023-06-02T12:32:21,Galdakao,expenses,gifts,-508.7,-35932.23
buyer_4,Jorge,Moreno,1974-05-23,32144178E,jorge.moreno@coolnet.site,679449,ES86209540321172255358,5267.8,2023-06-02T13:44:44,Galdakao,expenses,children,-407.0930833333337,-36339.32
buyer_4,Jorge,Moreno,1974-05-23,32144178E,jorge.moreno@coolnet.site,679449,ES86209540321172255358,5267.8,2023-06-03T05:53:19,Galdakao,expenses,food,-119.76,-36459.08
buyer_4,Jorge,Moreno,1974-05-23,32144178E,jorge.moreno@coolnet.site,679449,ES86209540321172255358,5267.8,2023-06-04T13:20:50,Galdakao,expenses,mortgage,-1482.67,-37941.75
buyer_4,Jorge,Moreno,1974-05-23,32144178E,jorge.moreno@coolnet.site,679449,ES86209540321172255358,5267.8,2023-06-05T12:39:27,Galdakao,expenses,gas,-118.75,-38060.5
buyer_4,Jorge,Moreno,1974-05-23,32144178E,jorge.moreno@coolnet.site,679449,ES86209540321172255358,5267.8,2023-06-05T19:46:05,Galdakao,expenses,internet,-61.71,-38122.21
buyer_4,Jorge,Moreno,1974-05-23,32144178E,jorge.moreno@coolnet.site,679449,ES86209540321172255358,5267.8,2023-06-05T09:50:44,Galdakao,expenses,phone,-61.27,-38183.48
buyer_4,Jorge,Moreno,1974-05-23,32144178E,jorge.moreno@coolnet.site,679449,ES86209540321172255358,5267.8,2023-06-05T11:36:22,Galdakao,expenses,gifts,-828.76,-39012.24
buyer_4,Jorge,Moreno,1974-05-23,32144178E,jorge.moreno@coolnet.site,679449,ES86209540321172255358,5267.8,2023-06-06T20:25:50,Galdakao,expenses,repairs,-269.93,-39282.17
buyer_4,Jorge,Moreno,1974-05-23,32144178E,jorge.moreno@coolnet.site,679449,ES86209540321172255358,5267.8,2023-06-07T22:43:17,Galdakao,expenses,water,-34.23,-39316.4
buyer_4,Jorge,Moreno,1974-05-23,32144178E,jorge.moreno@coolnet.site,679449,ES86209540321172255358,5267.8,2023-06-07T12:57:29,Galdakao,expenses,food,-92.71,-39409.11
buyer_4,Jorge,Moreno,1974-05-23,32144178E,jorge.moreno@coolnet.site,679449,ES86209540321172255358,5267.8,2023-06-07T17:46:27,Galdakao,expenses,cash,-100.0,-39509.11
buyer_4,Jorge,Moreno,1974-05-23,32144178E,jorge.moreno@coolnet.site,679449,ES86209540321172255358,5267.8,2023-06-08T09:39:13,Galdakao,expenses,electricity,-118.78,-39627.89
buyer_4,Jorge,Moreno,1974-05-23,32144178E,jorge.moreno@coolnet.site,679449,ES86209540321172255358,5267.8,2023-06-10T10:39:01,Galdakao,expenses,food,-117.34,-39745.23
buyer_4,Jorge,Moreno,1974-05-23,32144178E,jorge.moreno@coolnet.site,679449,ES86209540321172255358,5267.8,2023-06-10T17:38:15,Galdakao,expenses,gifts,-658.24,-40403.47
buyer_4,Jorge,Moreno,1974-05-23,32144178E,jorge.moreno@coolnet.site,679449,ES86209540321172255358,5267.8,2023-06-11T13:06:06,Galdakao,expenses,transport,-85.55,-40489.02
buyer_4,Jorge,Moreno,1974-05-23,32144178E,jorge.moreno@coolnet.site,679449,ES86209540321172255358,5267.8,2023-06-13T17:30:52,Galdakao,expenses,leisure,-28.78,-40517.8
buyer_4,Jorge,Moreno,1974-05-23,32144178E,jorge.moreno@coolnet.site,679449,ES86209540321172255358,5267.8,2023-06-15T09:09:41,Galdakao,expenses,transport,-59.64,-40577.44
buyer_4,Jorge,Moreno,1974-05-23,32144178E,jorge.moreno@coolnet.site,679449,ES86209540321172255358,5267.8,2023-06-16T23:28:12,Galdakao,expenses,clothing,-145.76,-40723.2
buyer_4,Jorge,Moreno,1974-05-23,32144178E,jorge.moreno@coolnet.site,679449,ES86209540321172255358,5267.8,2023-06-18T11:44:56,Galdakao,expenses,gifts,-553.46,-41276.66
buyer_4,Jorge,Moreno,1974-05-23,32144178E,jorge.moreno@coolnet.site,679449,ES86209540321172255358,5267.8,2023-06-19T12:56:11,Galdakao,expenses,leisure,-82.81,-41359.47
buyer_4,Jorge,Moreno,1974-05-23,32144178E,jorge.moreno@coolnet.site,679449,ES86209540321172255358,5267.8,2023-06-19T02:36:35,Galdakao,expenses,cash,-100.0,-41459.47
buyer_4,Jorge,Moreno,1974-05-23,32144178E,jorge.moreno@coolnet.site,679449,ES86209540321172255358,5267.8,2023-06-22T20:18:20,Galdakao,expenses,cash,-100.0,-41559.47
buyer_4,Jorge,Moreno,1974-05-23,32144178E,jorge.moreno@coolnet.site,679449,ES86209540321172255358,5267.8,2023-06-22T04:15:32,Galdakao,expenses,gifts,-87.26,-41646.73
buyer_4,Jorge,Moreno,1974-05-23,32144178E,jorge.moreno@coolnet.site,679449,ES86209540321172255358,5267.8,2023-06-24T16:37:17,Galdakao,expenses,leisure,-20.55,-41667.28
buyer_4,Jorge,Moreno,1974-05-23,32144178E,jorge.moreno@coolnet.site,679449,ES86209540321172255358,5267.8,2023-06-25T10:46:05,Galdakao,expenses,appliances,-287.43,-41954.71
buyer_4,Jorge,Moreno,1974-05-23,32144178E,jorge.moreno@coolnet.site,679449,ES86209540321172255358,5267.8,2023-06-26T10:59:06,Galdakao,expenses,leisure,-53.57,-42008.28
buyer_4,Jorge,Moreno,1974-05-23,32144178E,jorge.moreno@coolnet.site,679449,ES86209540321172255358,5267.8,2023-06-29T08:56:34,Galdakao,expenses,clothing,-55.37,-42063.65
buyer_4,Jorge,Moreno,1974-05-23,32144178E,jorge.moreno@coolnet.site,679449,ES86209540321172255358,5267.8,2023-06-29T19:08:13,Galdakao,expenses,cash,-100.0,-42163.65
buyer_4,Jorge,Moreno,1974-05-23,32144178E,jorge.moreno@coolnet.site,679449,ES86209540321172255358,5267.8,2023-07-01T09:25:49,Galdakao,incomes,salary,2938.4,-39225.25
buyer_4,Jorge,Moreno,1974-05-23,32144178E,jorge.moreno@coolnet.site,679449,ES86209540321172255358,5267.8,2023-07-01T20:19:46,Galdakao,expenses,repairs,-40.2,-39265.45
buyer_4,Jorge,Moreno,1974-05-23,32144178E,jorge.moreno@coolnet.site,679449,ES86209540321172255358,5267.8,2023-07-02T11:49:51,Galdakao,expenses,food,-123.09,-39388.54
buyer_4,Jorge,Moreno,1974-05-23,32144178E,jorge.moreno@coolnet.site,679449,ES86209540321172255358,5267.8,2023-07-03T20:14:40,Galdakao,expenses,gifts,-27.98,-39416.52
buyer_4,Jorge,Moreno,1974-05-23,32144178E,jorge.moreno@coolnet.site,679449,ES86209540321172255358,5267.8,2023-07-04T19:37:30,Galdakao,expenses,mortgage,-1482.67,-40899.19
buyer_4,Jorge,Moreno,1974-05-23,32144178E,jorge.moreno@coolnet.site,679449,ES86209540321172255358,5267.8,2023-07-05T22:42:59,Galdakao,expenses,water,-34.25,-40933.44
buyer_4,Jorge,Moreno,1974-05-23,32144178E,jorge.moreno@coolnet.site,679449,ES86209540321172255358,5267.8,2023-07-05T10:42:37,Galdakao,expenses,gas,-96.06,-41029.5
buyer_4,Jorge,Moreno,1974-05-23,32144178E,jorge.moreno@coolnet.site,679449,ES86209540321172255358,5267.8,2023-07-05T10:11:22,Galdakao,expenses,phone,-48.61,-41078.11
buyer_4,Jorge,Moreno,1974-05-23,32144178E,jorge.moreno@coolnet.site,679449,ES86209540321172255358,5267.8,2023-07-06T15:18:45,Galdakao,expenses,food,-113.62,-41191.73
buyer_4,Jorge,Moreno,1974-05-23,32144178E,jorge.moreno@coolnet.site,679449,ES86209540321172255358,5267.8,2023-07-06T19:09:29,Galdakao,expenses,gifts,-505.03,-41696.76
buyer_4,Jorge,Moreno,1974-05-23,32144178E,jorge.moreno@coolnet.site,679449,ES86209540321172255358,5267.8,2023-07-07T18:21:54,Galdakao,expenses,electricity,-116.36,-41813.12
buyer_4,Jorge,Moreno,1974-05-23,32144178E,jorge.moreno@coolnet.site,679449,ES86209540321172255358,5267.8,2023-07-07T20:21:40,Galdakao,expenses,cash,-100.0,-41913.12
buyer_4,Jorge,Moreno,1974-05-23,32144178E,jorge.moreno@coolnet.site,679449,ES86209540321172255358,5267.8,2023-07-08T08:24:09,Galdakao,expenses,internet,-61.71,-41974.83
buyer_4,Jorge,Moreno,1974-05-23,32144178E,jorge.moreno@coolnet.site,679449,ES86209540321172255358,5267.8,2023-07-11T19:37:32,Galdakao,expenses,transport,-65.47,-42040.3
buyer_4,Jorge,Moreno,1974-05-23,32144178E,jorge.moreno@coolnet.site,679449,ES86209540321172255358,5267.8,2023-07-18T15:23:38,Galdakao,expenses,repairs,-170.03,-42210.33
buyer_4,Jorge,Moreno,1974-05-23,32144178E,jorge.moreno@coolnet.site,679449,ES86209540321172255358,5267.8,2023-07-19T14:17:17,Galdakao,expenses,healthcare,-39.55,-42249.88
buyer_4,Jorge,Moreno,1974-05-23,32144178E,jorge.moreno@coolnet.site,679449,ES86209540321172255358,5267.8,2023-07-20T12:26:13,Galdakao,expenses,transport,-62.52,-42312.4
buyer_4,Jorge,Moreno,1974-05-23,32144178E,jorge.moreno@coolnet.site,679449,ES86209540321172255358,5267.8,2023-07-21T17:14:54,Galdakao,expenses,appliances,-399.7,-42712.1
buyer_4,Jorge,Moreno,1974-05-23,32144178E,jorge.moreno@coolnet.site,679449,ES86209540321172255358,5267.8,2023-07-22T00:34:55,Galdakao,expenses,leisure,-60.28,-42772.38
buyer_4,Jorge,Moreno,1974-05-23,32144178E,jorge.moreno@coolnet.site,679449,ES86209540321172255358,5267.8,2023-07-25T08:52:59,Galdakao,expenses,food,-102.93,-42875.31
buyer_4,Jorge,Moreno,1974-05-23,32144178E,jorge.moreno@coolnet.site,679449,ES86209540321172255358,5267.8,2023-07-25T21:32:27,Galdakao,expenses,leisure,-82.69,-42958.0
buyer_4,Jorge,Moreno,1974-05-23,32144178E,jorge.moreno@coolnet.site,679449,ES86209540321172255358,5267.8,2023-07-26T16:34:46,Galdakao,expenses,cash,-100.0,-43058.0
buyer_4,Jorge,Moreno,1974-05-23,32144178E,jorge.moreno@coolnet.site,679449,ES86209540321172255358,5267.8,2023-07-26T17:29:42,Galdakao,expenses,appliances,-150.07,-43208.07
buyer_4,Jorge,Moreno,1974-05-23,32144178E,jorge.moreno@coolnet.site,679449,ES86209540321172255358,5267.8,2023-07-27T17:13:26,Galdakao,expenses,cash,-100.0,-43308.07
buyer_4,Jorge,Moreno,1974-05-23,32144178E,jorge.moreno@coolnet.site,679449,ES86209540321172255358,5267.8,2023-07-28T14:37:26,Galdakao,expenses,food,-72.24,-43380.31
buyer_4,Jorge,Moreno,1974-05-23,32144178E,jorge.moreno@coolnet.site,679449,ES86209540321172255358,5267.8,2023-07-28T22:37:53,Galdakao,expenses,transport,-55.64,-43435.95
buyer_4,Jorge,Moreno,1974-05-23,32144178E,jorge.moreno@coolnet.site,679449,ES86209540321172255358,5267.8,2023-07-29T14:30:49,Galdakao,expenses,gifts,-50.15,-43486.1
buyer_4,Jorge,Moreno,1974-05-23,32144178E,jorge.moreno@coolnet.site,679449,ES86209540321172255358,5267.8,2023-07-30T14:28:16,Galdakao,expenses,education,-42.73,-43528.83
buyer_4,Jorge,Moreno,1974-05-23,32144178E,jorge.moreno@coolnet.site,679449,ES86209540321172255358,5267.8,2023-07-30T16:27:43,Galdakao,expenses,cash,-100.0,-43628.83
buyer_4,Jorge,Moreno,1974-05-23,32144178E,jorge.moreno@coolnet.site,679449,ES86209540321172255358,5267.8,2023-08-01T17:21:24,Galdakao,incomes,salary,2938.4,-40690.43
buyer_4,Jorge,Moreno,1974-05-23,32144178E,jorge.moreno@coolnet.site,679449,ES86209540321172255358,5267.8,2023-08-01T19:15:11,Galdakao,expenses,food,-95.76,-40786.19
buyer_4,Jorge,Moreno,1974-05-23,32144178E,jorge.moreno@coolnet.site,679449,ES86209540321172255358,5267.8,2023-08-02T22:11:24,Galdakao,expenses,education,-68.92,-40855.11
buyer_4,Jorge,Moreno,1974-05-23,32144178E,jorge.moreno@coolnet.site,679449,ES86209540321172255358,5267.8,2023-08-03T14:05:31,Galdakao,expenses,food,-62.69,-40917.8
buyer_4,Jorge,Moreno,1974-05-23,32144178E,jorge.moreno@coolnet.site,679449,ES86209540321172255358,5267.8,2023-08-04T16:40:58,Galdakao,expenses,mortgage,-1482.67,-42400.47
buyer_4,Jorge,Moreno,1974-05-23,32144178E,jorge.moreno@coolnet.site,679449,ES86209540321172255358,5267.8,2023-08-04T11:19:01,Galdakao,expenses,transport,-77.17,-42477.64
buyer_4,Jorge,Moreno,1974-05-23,32144178E,jorge.moreno@coolnet.site,679449,ES86209540321172255358,5267.8,2023-08-05T23:34:41,Galdakao,expenses,internet,-61.71,-42539.35
buyer_4,Jorge,Moreno,1974-05-23,32144178E,jorge.moreno@coolnet.site,679449,ES86209540321172255358,5267.8,2023-08-05T20:35:12,Galdakao,expenses,phone,-45.07,-42584.42
buyer_4,Jorge,Moreno,1974-05-23,32144178E,jorge.moreno@coolnet.site,679449,ES86209540321172255358,5267.8,2023-08-05T18:58:46,Galdakao,expenses,clothing,-113.14,-42697.56
buyer_4,Jorge,Moreno,1974-05-23,32144178E,jorge.moreno@coolnet.site,679449,ES86209540321172255358,5267.8,2023-08-06T19:32:06,Galdakao,expenses,gas,-113.48,-42811.04
buyer_4,Jorge,Moreno,1974-05-23,32144178E,jorge.moreno@coolnet.site,679449,ES86209540321172255358,5267.8,2023-08-07T22:00:11,Galdakao,expenses,water,-49.35,-42860.39
buyer_4,Jorge,Moreno,1974-05-23,32144178E,jorge.moreno@coolnet.site,679449,ES86209540321172255358,5267.8,2023-08-07T13:22:41,Galdakao,expenses,food,-110.23,-42970.62
buyer_4,Jorge,Moreno,1974-05-23,32144178E,jorge.moreno@coolnet.site,679449,ES86209540321172255358,5267.8,2023-08-08T15:12:21,Galdakao,expenses,electricity,-45.18,-43015.8
buyer_4,Jorge,Moreno,1974-05-23,32144178E,jorge.moreno@coolnet.site,679449,ES86209540321172255358,5267.8,2023-08-08T08:24:56,Galdakao,expenses,leisure,-23.95,-43039.75
buyer_4,Jorge,Moreno,1974-05-23,32144178E,jorge.moreno@coolnet.site,679449,ES86209540321172255358,5267.8,2023-08-08T17:02:10,Galdakao,expenses,children,-629.95,-43669.7
buyer_4,Jorge,Moreno,1974-05-23,32144178E,jorge.moreno@coolnet.site,679449,ES86209540321172255358,5267.8,2023-08-09T15:22:21,Galdakao,expenses,cash,-100.0,-43769.7
buyer_4,Jorge,Moreno,1974-05-23,32144178E,jorge.moreno@coolnet.site,679449,ES86209540321172255358,5267.8,2023-08-10T18:15:06,Galdakao,expenses,cash,-100.0,-43869.7
buyer_4,Jorge,Moreno,1974-05-23,32144178E,jorge.moreno@coolnet.site,679449,ES86209540321172255358,5267.8,2023-08-10T20:33:56,Galdakao,expenses,appliances,-259.41,-44129.11
buyer_4,Jorge,Moreno,1974-05-23,32144178E,jorge.moreno@coolnet.site,679449,ES86209540321172255358,5267.8,2023-08-10T22:32:17,Galdakao,expenses,repairs,-198.08,-44327.19
buyer_4,Jorge,Moreno,1974-05-23,32144178E,jorge.moreno@coolnet.site,679449,ES86209540321172255358,5267.8,2023-08-11T18:44:07,Galdakao,expenses,transport,-61.48,-44388.67
buyer_4,Jorge,Moreno,1974-05-23,32144178E,jorge.moreno@coolnet.site,679449,ES86209540321172255358,5267.8,2023-08-14T11:19:07,Galdakao,expenses,transport,-67.18,-44455.85
buyer_4,Jorge,Moreno,1974-05-23,32144178E,jorge.moreno@coolnet.site,679449,ES86209540321172255358,5267.8,2023-08-18T16:15:42,Galdakao,expenses,transport,-76.95,-44532.8
buyer_4,Jorge,Moreno,1974-05-23,32144178E,jorge.moreno@coolnet.site,679449,ES86209540321172255358,5267.8,2023-08-18T13:29:46,Galdakao,expenses,cash,-100.0,-44632.8
buyer_4,Jorge,Moreno,1974-05-23,32144178E,jorge.moreno@coolnet.site,679449,ES86209540321172255358,5267.8,2023-08-18T09:18:50,Galdakao,expenses,children,-652.8,-45285.6
buyer_4,Jorge,Moreno,1974-05-23,32144178E,jorge.moreno@coolnet.site,679449,ES86209540321172255358,5267.8,2023-08-20T09:15:43,Galdakao,expenses,healthcare,-171.68,-45457.28
buyer_4,Jorge,Moreno,1974-05-23,32144178E,jorge.moreno@coolnet.site,679449,ES86209540321172255358,5267.8,2023-08-23T18:02:47,Galdakao,expenses,cash,-100.0,-45557.28
buyer_4,Jorge,Moreno,1974-05-23,32144178E,jorge.moreno@coolnet.site,679449,ES86209540321172255358,5267.8,2023-08-24T14:02:47,Galdakao,expenses,cash,-100.0,-45657.28
buyer_4,Jorge,Moreno,1974-05-23,32144178E,jorge.moreno@coolnet.site,679449,ES86209540321172255358,5267.8,2023-08-25T17:31:54,Galdakao,expenses,transport,-83.89,-45741.17
buyer_4,Jorge,Moreno,1974-05-23,32144178E,jorge.moreno@coolnet.site,679449,ES86209540321172255358,5267.8,2023-08-25T16:20:21,Galdakao,expenses,leisure,-66.05,-45807.22
buyer_4,Jorge,Moreno,1974-05-23,32144178E,jorge.moreno@coolnet.site,679449,ES86209540321172255358,5267.8,2023-08-26T03:20:16,Galdakao,expenses,cash,-100.0,-45907.22
buyer_4,Jorge,Moreno,1974-05-23,32144178E,jorge.moreno@coolnet.site,679449,ES86209540321172255358,5267.8,2023-08-28T13:43:42,Galdakao,expenses,transport,-80.89,-45988.11
buyer_4,Jorge,Moreno,1974-05-23,32144178E,jorge.moreno@coolnet.site,679449,ES86209540321172255358,5267.8,2023-08-30T22:21:00,Galdakao,expenses,leisure,-56.03,-46044.14
buyer_4,Jorge,Moreno,1974-05-23,32144178E,jorge.moreno@coolnet.site,679449,ES86209540321172255358,5267.8,2023-08-30T08:15:24,Galdakao,expenses,education,-56.4,-46100.54
buyer_4,Jorge,Moreno,1974-05-23,32144178E,jorge.moreno@coolnet.site,679449,ES86209540321172255358,5267.8,2023-09-01T00:35:39,Galdakao,incomes,salary,2938.4,-43162.14
buyer_4,Jorge,Moreno,1974-05-23,32144178E,jorge.moreno@coolnet.site,679449,ES86209540321172255358,5267.8,2023-09-01T19:02:38,Galdakao,expenses,cash,-100.0,-43262.14
buyer_4,Jorge,Moreno,1974-05-23,32144178E,jorge.moreno@coolnet.site,679449,ES86209540321172255358,5267.8,2023-09-01T19:40:34,Galdakao,expenses,gifts,-686.05,-43948.19
buyer_4,Jorge,Moreno,1974-05-23,32144178E,jorge.moreno@coolnet.site,679449,ES86209540321172255358,5267.8,2023-09-02T17:42:45,Galdakao,expenses,food,-104.49,-44052.68
buyer_4,Jorge,Moreno,1974-05-23,32144178E,jorge.moreno@coolnet.site,679449,ES86209540321172255358,5267.8,2023-09-02T19:18:43,Galdakao,expenses,repairs,-313.41,-44366.09
buyer_4,Jorge,Moreno,1974-05-23,32144178E,jorge.moreno@coolnet.site,679449,ES86209540321172255358,5267.8,2023-09-03T08:36:59,Galdakao,expenses,leisure,-58.08,-44424.17
buyer_4,Jorge,Moreno,1974-05-23,32144178E,jorge.moreno@coolnet.site,679449,ES86209540321172255358,5267.8,2023-09-04T09:20:39,Galdakao,expenses,mortgage,-1482.67,-45906.84
buyer_4,Jorge,Moreno,1974-05-23,32144178E,jorge.moreno@coolnet.site,679449,ES86209540321172255358,5267.8,2023-09-05T15:08:02,Galdakao,expenses,internet,-61.71,-45968.55
buyer_4,Jorge,Moreno,1974-05-23,32144178E,jorge.moreno@coolnet.site,679449,ES86209540321172255358,5267.8,2023-09-06T16:58:20,Galdakao,expenses,water,-57.73,-46026.28
buyer_4,Jorge,Moreno,1974-05-23,32144178E,jorge.moreno@coolnet.site,679449,ES86209540321172255358,5267.8,2023-09-06T09:50:43,Galdakao,expenses,leisure,-68.99,-46095.27
buyer_4,Jorge,Moreno,1974-05-23,32144178E,jorge.moreno@coolnet.site,679449,ES86209540321172255358,5267.8,2023-09-06T09:59:13,Galdakao,expenses,healthcare,-163.64,-46258.91
buyer_4,Jorge,Moreno,1974-05-23,32144178E,jorge.moreno@coolnet.site,679449,ES86209540321172255358,5267.8,2023-09-07T08:40:34,Galdakao,expenses,clothing,-141.75,-46400.66
buyer_4,Jorge,Moreno,1974-05-23,32144178E,jorge.moreno@coolnet.site,679449,ES86209540321172255358,5267.8,2023-09-08T20:43:18,Galdakao,expenses,electricity,-36.86,-46437.52
buyer_4,Jorge,Moreno,1974-05-23,32144178E,jorge.moreno@coolnet.site,679449,ES86209540321172255358,5267.8,2023-09-08T20:57:20,Galdakao,expenses,gas,-86.3,-46523.82
buyer_4,Jorge,Moreno,1974-05-23,32144178E,jorge.moreno@coolnet.site,679449,ES86209540321172255358,5267.8,2023-09-08T14:16:41,Galdakao,expenses,phone,-55.65,-46579.47
buyer_4,Jorge,Moreno,1974-05-23,32144178E,jorge.moreno@coolnet.site,679449,ES86209540321172255358,5267.8,2023-09-09T08:02:26,Galdakao,expenses,leisure,-44.01,-46623.48
buyer_4,Jorge,Moreno,1974-05-23,32144178E,jorge.moreno@coolnet.site,679449,ES86209540321172255358,5267.8,2023-09-11T11:30:08,Galdakao,expenses,gifts,-379.61,-47003.09
buyer_4,Jorge,Moreno,1974-05-23,32144178E,jorge.moreno@coolnet.site,679449,ES86209540321172255358,5267.8,2023-09-12T13:43:30,Galdakao,expenses,repairs,-311.47,-47314.56
buyer_4,Jorge,Moreno,1974-05-23,32144178E,jorge.moreno@coolnet.site,679449,ES86209540321172255358,5267.8,2023-09-14T22:22:04,Galdakao,expenses,children,-915.7930833333337,-48230.35
buyer_4,Jorge,Moreno,1974-05-23,32144178E,jorge.moreno@coolnet.site,679449,ES86209540321172255358,5267.8,2023-09-15T11:36:48,Galdakao,expenses,cash,-100.0,-48330.35
buyer_4,Jorge,Moreno,1974-05-23,32144178E,jorge.moreno@coolnet.site,679449,ES86209540321172255358,5267.8,2023-09-18T14:47:31,Galdakao,expenses,food,-107.43,-48437.78
buyer_4,Jorge,Moreno,1974-05-23,32144178E,jorge.moreno@coolnet.site,679449,ES86209540321172255358,5267.8,2023-09-21T14:13:43,Galdakao,expenses,gifts,-448.07,-48885.85
buyer_4,Jorge,Moreno,1974-05-23,32144178E,jorge.moreno@coolnet.site,679449,ES86209540321172255358,5267.8,2023-09-23T16:42:43,Galdakao,expenses,cash,-100.0,-48985.85
buyer_4,Jorge,Moreno,1974-05-23,32144178E,jorge.moreno@coolnet.site,679449,ES86209540321172255358,5267.8,2023-09-23T01:32:12,Galdakao,expenses,appliances,-194.77,-49180.62
buyer_4,Jorge,Moreno,1974-05-23,32144178E,jorge.moreno@coolnet.site,679449,ES86209540321172255358,5267.8,2023-09-26T10:18:46,Galdakao,expenses,education,-57.61,-49238.23
buyer_4,Jorge,Moreno,1974-05-23,32144178E,jorge.moreno@coolnet.site,679449,ES86209540321172255358,5267.8,2023-09-26T10:45:22,Galdakao,expenses,cash,-100.0,-49338.23
buyer_4,Jorge,Moreno,1974-05-23,32144178E,jorge.moreno@coolnet.site,679449,ES86209540321172255358,5267.8,2023-09-29T16:57:55,Galdakao,expenses,clothing,-73.48,-49411.71
buyer_4,Jorge,Moreno,1974-05-23,32144178E,jorge.moreno@coolnet.site,679449,ES86209540321172255358,5267.8,2023-09-30T12:27:29,Galdakao,expenses,leisure,-73.0,-49484.71
buyer_4,Jorge,Moreno,1974-05-23,32144178E,jorge.moreno@coolnet.site,679449,ES86209540321172255358,5267.8,2023-10-01T08:36:38,Galdakao,incomes,salary,2938.4,-46546.31
buyer_4,Jorge,Moreno,1974-05-23,32144178E,jorge.moreno@coolnet.site,679449,ES86209540321172255358,5267.8,2023-10-01T08:36:38,Galdakao,incomes,extra_income,338.65,-46207.66
buyer_4,Jorge,Moreno,1974-05-23,32144178E,jorge.moreno@coolnet.site,679449,ES86209540321172255358,5267.8,2023-10-01T16:24:09,Galdakao,expenses,repairs,-289.92,-46497.58
buyer_4,Jorge,Moreno,1974-05-23,32144178E,jorge.moreno@coolnet.site,679449,ES86209540321172255358,5267.8,2023-10-02T12:18:37,Galdakao,expenses,leisure,-76.21,-46573.79
buyer_4,Jorge,Moreno,1974-05-23,32144178E,jorge.moreno@coolnet.site,679449,ES86209540321172255358,5267.8,2023-10-02T08:23:21,Galdakao,expenses,cash,-100.0,-46673.79
buyer_4,Jorge,Moreno,1974-05-23,32144178E,jorge.moreno@coolnet.site,679449,ES86209540321172255358,5267.8,2023-10-03T10:24:05,Galdakao,expenses,children,-915.7930833333337,-47589.58
buyer_4,Jorge,Moreno,1974-05-23,32144178E,jorge.moreno@coolnet.site,679449,ES86209540321172255358,5267.8,2023-10-04T23:50:06,Galdakao,expenses,mortgage,-1482.67,-49072.25
buyer_4,Jorge,Moreno,1974-05-23,32144178E,jorge.moreno@coolnet.site,679449,ES86209540321172255358,5267.8,2023-10-04T09:10:52,Galdakao,expenses,cash,-100.0,-49172.25
buyer_4,Jorge,Moreno,1974-05-23,32144178E,jorge.moreno@coolnet.site,679449,ES86209540321172255358,5267.8,2023-10-05T17:21:55,Galdakao,expenses,electricity,-53.07,-49225.32
buyer_4,Jorge,Moreno,1974-05-23,32144178E,jorge.moreno@coolnet.site,679449,ES86209540321172255358,5267.8,2023-10-05T12:37:29,Galdakao,expenses,healthcare,-46.27,-49271.59
buyer_4,Jorge,Moreno,1974-05-23,32144178E,jorge.moreno@coolnet.site,679449,ES86209540321172255358,5267.8,2023-10-05T08:37:40,Galdakao,expenses,cash,-100.0,-49371.59
buyer_4,Jorge,Moreno,1974-05-23,32144178E,jorge.moreno@coolnet.site,679449,ES86209540321172255358,5267.8,2023-10-06T19:33:10,Galdakao,expenses,transport,-88.22,-49459.81
buyer_4,Jorge,Moreno,1974-05-23,32144178E,jorge.moreno@coolnet.site,679449,ES86209540321172255358,5267.8,2023-10-07T14:58:45,Galdakao,expenses,water,-30.59,-49490.4
buyer_4,Jorge,Moreno,1974-05-23,32144178E,jorge.moreno@coolnet.site,679449,ES86209540321172255358,5267.8,2023-10-07T22:33:16,Galdakao,expenses,food,-78.55,-49568.95
buyer_4,Jorge,Moreno,1974-05-23,32144178E,jorge.moreno@coolnet.site,679449,ES86209540321172255358,5267.8,2023-10-07T11:55:40,Galdakao,expenses,transport,-85.19,-49654.14
buyer_4,Jorge,Moreno,1974-05-23,32144178E,jorge.moreno@coolnet.site,679449,ES86209540321172255358,5267.8,2023-10-07T18:44:22,Galdakao,expenses,leisure,-22.07,-49676.21
buyer_4,Jorge,Moreno,1974-05-23,32144178E,jorge.moreno@coolnet.site,679449,ES86209540321172255358,5267.8,2023-10-07T18:56:09,Galdakao,expenses,gifts,-83.29,-49759.5
buyer_4,Jorge,Moreno,1974-05-23,32144178E,jorge.moreno@coolnet.site,679449,ES86209540321172255358,5267.8,2023-10-08T14:18:08,Galdakao,expenses,gas,-102.24,-49861.74
buyer_4,Jorge,Moreno,1974-05-23,32144178E,jorge.moreno@coolnet.site,679449,ES86209540321172255358,5267.8,2023-10-08T18:21:05,Galdakao,expenses,internet,-61.71,-49923.45
buyer_4,Jorge,Moreno,1974-05-23,32144178E,jorge.moreno@coolnet.site,679449,ES86209540321172255358,5267.8,2023-10-08T20:59:43,Galdakao,expenses,phone,-46.65,-49970.1
buyer_4,Jorge,Moreno,1974-05-23,32144178E,jorge.moreno@coolnet.site,679449,ES86209540321172255358,5267.8,2023-10-08T18:55:50,Galdakao,expenses,food,-99.33,-50069.43
buyer_4,Jorge,Moreno,1974-05-23,32144178E,jorge.moreno@coolnet.site,679449,ES86209540321172255358,5267.8,2023-10-10T17:16:36,Galdakao,expenses,repairs,-227.21,-50296.64
buyer_4,Jorge,Moreno,1974-05-23,32144178E,jorge.moreno@coolnet.site,679449,ES86209540321172255358,5267.8,2023-10-11T13:22:08,Galdakao,expenses,leisure,-22.21,-50318.85
buyer_4,Jorge,Moreno,1974-05-23,32144178E,jorge.moreno@coolnet.site,679449,ES86209540321172255358,5267.8,2023-10-12T13:50:29,Galdakao,expenses,leisure,-37.14,-50355.99
buyer_4,Jorge,Moreno,1974-05-23,32144178E,jorge.moreno@coolnet.site,679449,ES86209540321172255358,5267.8,2023-10-12T15:59:25,Galdakao,expenses,travel,-747.69,-51103.68
buyer_4,Jorge,Moreno,1974-05-23,32144178E,jorge.moreno@coolnet.site,679449,ES86209540321172255358,5267.8,2023-10-14T08:38:30,Galdakao,expenses,food,-102.95,-51206.63
buyer_4,Jorge,Moreno,1974-05-23,32144178E,jorge.moreno@coolnet.site,679449,ES86209540321172255358,5267.8,2023-10-14T11:35:15,Galdakao,expenses,gifts,-410.06,-51616.69
buyer_4,Jorge,Moreno,1974-05-23,32144178E,jorge.moreno@coolnet.site,679449,ES86209540321172255358,5267.8,2023-10-18T12:48:14,Galdakao,expenses,education,-75.29,-51691.98
buyer_4,Jorge,Moreno,1974-05-23,32144178E,jorge.moreno@coolnet.site,679449,ES86209540321172255358,5267.8,2023-10-21T14:19:00,Galdakao,expenses,transport,-46.67,-51738.65
buyer_4,Jorge,Moreno,1974-05-23,32144178E,jorge.moreno@coolnet.site,679449,ES86209540321172255358,5267.8,2023-10-21T09:33:48,Galdakao,expenses,cash,-100.0,-51838.65
buyer_4,Jorge,Moreno,1974-05-23,32144178E,jorge.moreno@coolnet.site,679449,ES86209540321172255358,5267.8,2023-10-22T22:16:50,Galdakao,expenses,education,-47.01,-51885.66
buyer_4,Jorge,Moreno,1974-05-23,32144178E,jorge.moreno@coolnet.site,679449,ES86209540321172255358,5267.8,2023-10-23T15:51:05,Galdakao,expenses,food,-121.21,-52006.87
buyer_4,Jorge,Moreno,1974-05-23,32144178E,jorge.moreno@coolnet.site,679449,ES86209540321172255358,5267.8,2023-10-23T10:50:34,Galdakao,expenses,leisure,-23.64,-52030.51
buyer_4,Jorge,Moreno,1974-05-23,32144178E,jorge.moreno@coolnet.site,679449,ES86209540321172255358,5267.8,2023-10-24T10:34:29,Galdakao,expenses,food,-92.48,-52122.99
buyer_4,Jorge,Moreno,1974-05-23,32144178E,jorge.moreno@coolnet.site,679449,ES86209540321172255358,5267.8,2023-10-29T17:58:01,Galdakao,expenses,cash,-100.0,-52222.99
buyer_4,Jorge,Moreno,1974-05-23,32144178E,jorge.moreno@coolnet.site,679449,ES86209540321172255358,5267.8,2023-10-31T18:01:54,Galdakao,expenses,leisure,-33.67,-52256.66
buyer_4,Jorge,Moreno,1974-05-23,32144178E,jorge.moreno@coolnet.site,679449,ES86209540321172255358,5267.8,2023-11-01T22:32:58,Galdakao,incomes,salary,2938.4,-49318.26
buyer_4,Jorge,Moreno,1974-05-23,32144178E,jorge.moreno@coolnet.site,679449,ES86209540321172255358,5267.8,2023-11-01T16:06:45,Galdakao,expenses,education,-69.73,-49387.99
buyer_4,Jorge,Moreno,1974-05-23,32144178E,jorge.moreno@coolnet.site,679449,ES86209540321172255358,5267.8,2023-11-02T16:26:31,Galdakao,expenses,food,-121.05,-49509.04
buyer_4,Jorge,Moreno,1974-05-23,32144178E,jorge.moreno@coolnet.site,679449,ES86209540321172255358,5267.8,2023-11-02T12:08:33,Galdakao,expenses,cash,-100.0,-49609.04
buyer_4,Jorge,Moreno,1974-05-23,32144178E,jorge.moreno@coolnet.site,679449,ES86209540321172255358,5267.8,2023-11-03T19:03:19,Galdakao,expenses,cash,-100.0,-49709.04
buyer_4,Jorge,Moreno,1974-05-23,32144178E,jorge.moreno@coolnet.site,679449,ES86209540321172255358,5267.8,2023-11-04T07:45:47,Galdakao,expenses,mortgage,-1482.67,-51191.71
buyer_4,Jorge,Moreno,1974-05-23,32144178E,jorge.moreno@coolnet.site,679449,ES86209540321172255358,5267.8,2023-11-04T17:48:57,Galdakao,expenses,education,-66.92,-51258.63
buyer_4,Jorge,Moreno,1974-05-23,32144178E,jorge.moreno@coolnet.site,679449,ES86209540321172255358,5267.8,2023-11-05T18:17:05,Galdakao,expenses,gas,-80.66,-51339.29
buyer_4,Jorge,Moreno,1974-05-23,32144178E,jorge.moreno@coolnet.site,679449,ES86209540321172255358,5267.8,2023-11-05T19:06:10,Galdakao,expenses,cash,-100.0,-51439.29
buyer_4,Jorge,Moreno,1974-05-23,32144178E,jorge.moreno@coolnet.site,679449,ES86209540321172255358,5267.8,2023-11-06T14:20:46,Galdakao,expenses,electricity,-50.82,-51490.11
buyer_4,Jorge,Moreno,1974-05-23,32144178E,jorge.moreno@coolnet.site,679449,ES86209540321172255358,5267.8,2023-11-06T13:09:35,Galdakao,expenses,phone,-58.04,-51548.15
buyer_4,Jorge,Moreno,1974-05-23,32144178E,jorge.moreno@coolnet.site,679449,ES86209540321172255358,5267.8,2023-11-07T11:04:31,Galdakao,expenses,repairs,-97.0,-51645.15
buyer_4,Jorge,Moreno,1974-05-23,32144178E,jorge.moreno@coolnet.site,679449,ES86209540321172255358,5267.8,2023-11-08T18:08:02,Galdakao,expenses,water,-54.1,-51699.25
buyer_4,Jorge,Moreno,1974-05-23,32144178E,jorge.moreno@coolnet.site,679449,ES86209540321172255358,5267.8,2023-11-08T11:01:15,Galdakao,expenses,internet,-61.71,-51760.96
buyer_4,Jorge,Moreno,1974-05-23,32144178E,jorge.moreno@coolnet.site,679449,ES86209540321172255358,5267.8,2023-11-09T08:42:42,Galdakao,expenses,clothing,-69.83,-51830.79
buyer_4,Jorge,Moreno,1974-05-23,32144178E,jorge.moreno@coolnet.site,679449,ES86209540321172255358,5267.8,2023-11-09T11:29:43,Galdakao,expenses,travel,-331.58,-52162.37
buyer_4,Jorge,Moreno,1974-05-23,32144178E,jorge.moreno@coolnet.site,679449,ES86209540321172255358,5267.8,2023-11-10T17:29:06,Galdakao,expenses,leisure,-23.03,-52185.4
buyer_4,Jorge,Moreno,1974-05-23,32144178E,jorge.moreno@coolnet.site,679449,ES86209540321172255358,5267.8,2023-11-11T19:16:42,Galdakao,expenses,food,-81.7,-52267.1
buyer_4,Jorge,Moreno,1974-05-23,32144178E,jorge.moreno@coolnet.site,679449,ES86209540321172255358,5267.8,2023-11-11T02:31:32,Galdakao,expenses,appliances,-182.39,-52449.49
buyer_4,Jorge,Moreno,1974-05-23,32144178E,jorge.moreno@coolnet.site,679449,ES86209540321172255358,5267.8,2023-11-11T14:56:20,Galdakao,expenses,children,-651.7030833333338,-53101.19
buyer_4,Jorge,Moreno,1974-05-23,32144178E,jorge.moreno@coolnet.site,679449,ES86209540321172255358,5267.8,2023-11-12T14:30:50,Galdakao,expenses,clothing,-54.98,-53156.17
buyer_4,Jorge,Moreno,1974-05-23,32144178E,jorge.moreno@coolnet.site,679449,ES86209540321172255358,5267.8,2023-11-13T13:54:28,Galdakao,expenses,transport,-42.76,-53198.93
buyer_4,Jorge,Moreno,1974-05-23,32144178E,jorge.moreno@coolnet.site,679449,ES86209540321172255358,5267.8,2023-11-14T19:05:28,Galdakao,expenses,leisure,-61.33,-53260.26
buyer_4,Jorge,Moreno,1974-05-23,32144178E,jorge.moreno@coolnet.site,679449,ES86209540321172255358,5267.8,2023-11-15T12:16:56,Galdakao,expenses,leisure,-26.23,-53286.49
buyer_4,Jorge,Moreno,1974-05-23,32144178E,jorge.moreno@coolnet.site,679449,ES86209540321172255358,5267.8,2023-11-15T15:55:13,Galdakao,expenses,clothing,-61.03,-53347.52
buyer_4,Jorge,Moreno,1974-05-23,32144178E,jorge.moreno@coolnet.site,679449,ES86209540321172255358,5267.8,2023-11-17T08:58:18,Galdakao,expenses,food,-84.6,-53432.12
buyer_4,Jorge,Moreno,1974-05-23,32144178E,jorge.moreno@coolnet.site,679449,ES86209540321172255358,5267.8,2023-11-17T14:25:28,Galdakao,expenses,clothing,-156.58,-53588.7
buyer_4,Jorge,Moreno,1974-05-23,32144178E,jorge.moreno@coolnet.site,679449,ES86209540321172255358,5267.8,2023-11-17T21:56:07,Galdakao,expenses,repairs,-136.41,-53725.11
buyer_4,Jorge,Moreno,1974-05-23,32144178E,jorge.moreno@coolnet.site,679449,ES86209540321172255358,5267.8,2023-11-17T18:35:39,Galdakao,expenses,children,-538.2030833333337,-54263.31
buyer_4,Jorge,Moreno,1974-05-23,32144178E,jorge.moreno@coolnet.site,679449,ES86209540321172255358,5267.8,2023-11-24T11:33:14,Galdakao,expenses,food,-87.12,-54350.43
buyer_4,Jorge,Moreno,1974-05-23,32144178E,jorge.moreno@coolnet.site,679449,ES86209540321172255358,5267.8,2023-11-25T10:12:46,Galdakao,expenses,transport,-76.33,-54426.76
buyer_4,Jorge,Moreno,1974-05-23,32144178E,jorge.moreno@coolnet.site,679449,ES86209540321172255358,5267.8,2023-11-25T10:02:52,Galdakao,expenses,cash,-100.0,-54526.76
buyer_4,Jorge,Moreno,1974-05-23,32144178E,jorge.moreno@coolnet.site,679449,ES86209540321172255358,5267.8,2023-11-25T14:18:08,Galdakao,expenses,gifts,-79.38,-54606.14
buyer_4,Jorge,Moreno,1974-05-23,32144178E,jorge.moreno@coolnet.site,679449,ES86209540321172255358,5267.8,2023-11-26T11:33:11,Galdakao,expenses,gifts,-419.57,-55025.71
buyer_4,Jorge,Moreno,1974-05-23,32144178E,jorge.moreno@coolnet.site,679449,ES86209540321172255358,5267.8,2023-11-27T22:51:15,Galdakao,expenses,cash,-100.0,-55125.71
buyer_4,Jorge,Moreno,1974-05-23,32144178E,jorge.moreno@coolnet.site,679449,ES86209540321172255358,5267.8,2023-11-28T09:07:29,Galdakao,expenses,cash,-100.0,-55225.71
buyer_4,Jorge,Moreno,1974-05-23,32144178E,jorge.moreno@coolnet.site,679449,ES86209540321172255358,5267.8,2023-11-30T08:05:39,Galdakao,expenses,food,-84.3,-55310.01
buyer_4,Jorge,Moreno,1974-05-23,32144178E,jorge.moreno@coolnet.site,679449,ES86209540321172255358,5267.8,2023-11-30T13:55:57,Galdakao,expenses,leisure,-59.93,-55369.94
buyer_4,Jorge,Moreno,1974-05-23,32144178E,jorge.moreno@coolnet.site,679449,ES86209540321172255358,5267.8,2023-12-01T14:39:31,Galdakao,incomes,salary,2938.4,-52431.54
buyer_4,Jorge,Moreno,1974-05-23,32144178E,jorge.moreno@coolnet.site,679449,ES86209540321172255358,5267.8,2023-12-01T14:39:31,Galdakao,incomes,salary_bonus,2184.19,-50247.35
buyer_4,Jorge,Moreno,1974-05-23,32144178E,jorge.moreno@coolnet.site,679449,ES86209540321172255358,5267.8,2023-12-04T19:00:56,Galdakao,expenses,mortgage,-1482.67,-51730.02
buyer_4,Jorge,Moreno,1974-05-23,32144178E,jorge.moreno@coolnet.site,679449,ES86209540321172255358,5267.8,2023-12-04T11:15:29,Galdakao,expenses,repairs,-280.58,-52010.6
buyer_4,Jorge,Moreno,1974-05-23,32144178E,jorge.moreno@coolnet.site,679449,ES86209540321172255358,5267.8,2023-12-04T09:27:56,Galdakao,expenses,gifts,-497.16,-52507.76
buyer_4,Jorge,Moreno,1974-05-23,32144178E,jorge.moreno@coolnet.site,679449,ES86209540321172255358,5267.8,2023-12-05T10:37:11,Galdakao,expenses,internet,-61.71,-52569.47
buyer_4,Jorge,Moreno,1974-05-23,32144178E,jorge.moreno@coolnet.site,679449,ES86209540321172255358,5267.8,2023-12-05T18:22:18,Galdakao,expenses,food,-106.41,-52675.88
buyer_4,Jorge,Moreno,1974-05-23,32144178E,jorge.moreno@coolnet.site,679449,ES86209540321172255358,5267.8,2023-12-06T17:10:03,Galdakao,expenses,water,-50.72,-52726.6
buyer_4,Jorge,Moreno,1974-05-23,32144178E,jorge.moreno@coolnet.site,679449,ES86209540321172255358,5267.8,2023-12-06T09:01:26,Galdakao,expenses,electricity,-123.02,-52849.62
buyer_4,Jorge,Moreno,1974-05-23,32144178E,jorge.moreno@coolnet.site,679449,ES86209540321172255358,5267.8,2023-12-06T08:52:51,Galdakao,expenses,education,-55.65,-52905.27
buyer_4,Jorge,Moreno,1974-05-23,32144178E,jorge.moreno@coolnet.site,679449,ES86209540321172255358,5267.8,2023-12-07T03:05:03,Galdakao,expenses,food,-88.55,-52993.82
buyer_4,Jorge,Moreno,1974-05-23,32144178E,jorge.moreno@coolnet.site,679449,ES86209540321172255358,5267.8,2023-12-08T14:02:46,Galdakao,expenses,gas,-126.59,-53120.41
buyer_4,Jorge,Moreno,1974-05-23,32144178E,jorge.moreno@coolnet.site,679449,ES86209540321172255358,5267.8,2023-12-08T18:14:59,Galdakao,expenses,phone,-60.88,-53181.29
buyer_4,Jorge,Moreno,1974-05-23,32144178E,jorge.moreno@coolnet.site,679449,ES86209540321172255358,5267.8,2023-12-11T10:10:33,Galdakao,expenses,clothing,-116.61,-53297.9
buyer_4,Jorge,Moreno,1974-05-23,32144178E,jorge.moreno@coolnet.site,679449,ES86209540321172255358,5267.8,2023-12-11T13:54:06,Galdakao,expenses,repairs,-192.32,-53490.22
buyer_4,Jorge,Moreno,1974-05-23,32144178E,jorge.moreno@coolnet.site,679449,ES86209540321172255358,5267.8,2023-12-12T11:51:36,Galdakao,expenses,cash,-100.0,-53590.22
buyer_4,Jorge,Moreno,1974-05-23,32144178E,jorge.moreno@coolnet.site,679449,ES86209540321172255358,5267.8,2023-12-13T00:12:16,Galdakao,expenses,cash,-100.0,-53690.22
buyer_4,Jorge,Moreno,1974-05-23,32144178E,jorge.moreno@coolnet.site,679449,ES86209540321172255358,5267.8,2023-12-15T11:58:08,Galdakao,expenses,leisure,-24.43,-53714.65
buyer_4,Jorge,Moreno,1974-05-23,32144178E,jorge.moreno@coolnet.site,679449,ES86209540321172255358,5267.8,2023-12-15T10:30:50,Galdakao,expenses,cash,-100.0,-53814.65
buyer_4,Jorge,Moreno,1974-05-23,32144178E,jorge.moreno@coolnet.site,679449,ES86209540321172255358,5267.8,2023-12-17T12:07:09,Galdakao,expenses,food,-64.61,-53879.26
buyer_4,Jorge,Moreno,1974-05-23,32144178E,jorge.moreno@coolnet.site,679449,ES86209540321172255358,5267.8,2023-12-19T14:49:52,Galdakao,expenses,clothing,-132.77,-54012.03
buyer_4,Jorge,Moreno,1974-05-23,32144178E,jorge.moreno@coolnet.site,679449,ES86209540321172255358,5267.8,2023-12-20T14:57:33,Galdakao,expenses,leisure,-35.4,-54047.43
buyer_4,Jorge,Moreno,1974-05-23,32144178E,jorge.moreno@coolnet.site,679449,ES86209540321172255358,5267.8,2023-12-21T17:37:08,Galdakao,expenses,food,-84.73,-54132.16
buyer_4,Jorge,Moreno,1974-05-23,32144178E,jorge.moreno@coolnet.site,679449,ES86209540321172255358,5267.8,2023-12-21T16:08:09,Galdakao,expenses,repairs,-95.48,-54227.64
buyer_4,Jorge,Moreno,1974-05-23,32144178E,jorge.moreno@coolnet.site,679449,ES86209540321172255358,5267.8,2023-12-23T07:47:37,Galdakao,expenses,cash,-100.0,-54327.64
buyer_4,Jorge,Moreno,1974-05-23,32144178E,jorge.moreno@coolnet.site,679449,ES86209540321172255358,5267.8,2023-12-26T10:41:02,Galdakao,expenses,cash,-100.0,-54427.64
buyer_4,Jorge,Moreno,1974-05-23,32144178E,jorge.moreno@coolnet.site,679449,ES86209540321172255358,5267.8,2023-12-27T17:15:23,Galdakao,expenses,leisure,-31.17,-54458.81
buyer_4,Jorge,Moreno,1974-05-23,32144178E,jorge.moreno@coolnet.site,679449,ES86209540321172255358,5267.8,2023-12-28T08:25:16,Galdakao,expenses,cash,-100.0,-54558.81
buyer_4,Jorge,Moreno,1974-05-23,32144178E,jorge.moreno@coolnet.site,679449,ES86209540321172255358,5267.8,2023-12-30T04:30:19,Galdakao,expenses,leisure,-42.62,-54601.43
buyer_4,Jorge,Moreno,1974-05-23,32144178E,jorge.moreno@coolnet.site,679449,ES86209540321172255358,5267.8,2023-12-31T15:48:36,Galdakao,expenses,food,-76.3,-54677.73
buyer_4,Jorge,Moreno,1974-05-23,32144178E,jorge.moreno@coolnet.site,679449,ES86209540321172255358,5267.8,2024-01-01T23:01:53,Galdakao,incomes,salary,3022.42,-51655.31
buyer_4,Jorge,Moreno,1974-05-23,32144178E,jorge.moreno@coolnet.site,679449,ES86209540321172255358,5267.8,2024-01-01T23:01:53,Galdakao,incomes,extra_income,338.65,-51316.66
buyer_4,Jorge,Moreno,1974-05-23,32144178E,jorge.moreno@coolnet.site,679449,ES86209540321172255358,5267.8,2024-01-02T18:17:58,Galdakao,expenses,cash,-100.0,-51416.66
buyer_4,Jorge,Moreno,1974-05-23,32144178E,jorge.moreno@coolnet.site,679449,ES86209540321172255358,5267.8,2024-01-03T09:03:30,Galdakao,expenses,cash,-100.0,-51516.66
buyer_4,Jorge,Moreno,1974-05-23,32144178E,jorge.moreno@coolnet.site,679449,ES86209540321172255358,5267.8,2024-01-04T15:44:13,Galdakao,expenses,mortgage,-1369.63,-52886.29
buyer_4,Jorge,Moreno,1974-05-23,32144178E,jorge.moreno@coolnet.site,679449,ES86209540321172255358,5267.8,2024-01-05T08:00:04,Galdakao,expenses,electricity,-92.19,-52978.48
buyer_4,Jorge,Moreno,1974-05-23,32144178E,jorge.moreno@coolnet.site,679449,ES86209540321172255358,5267.8,2024-01-05T20:12:20,Galdakao,expenses,internet,-63.47,-53041.95
buyer_4,Jorge,Moreno,1974-05-23,32144178E,jorge.moreno@coolnet.site,679449,ES86209540321172255358,5267.8,2024-01-06T12:49:26,Galdakao,expenses,gas,-125.14,-53167.09
buyer_4,Jorge,Moreno,1974-05-23,32144178E,jorge.moreno@coolnet.site,679449,ES86209540321172255358,5267.8,2024-01-07T12:45:28,Galdakao,expenses,clothing,-141.99,-53309.08
buyer_4,Jorge,Moreno,1974-05-23,32144178E,jorge.moreno@coolnet.site,679449,ES86209540321172255358,5267.8,2024-01-08T13:03:21,Galdakao,expenses,phone,-46.16,-53355.24
buyer_4,Jorge,Moreno,1974-05-23,32144178E,jorge.moreno@coolnet.site,679449,ES86209540321172255358,5267.8,2024-01-08T10:34:37,Galdakao,expenses,water,-37.08,-53392.32
buyer_4,Jorge,Moreno,1974-05-23,32144178E,jorge.moreno@coolnet.site,679449,ES86209540321172255358,5267.8,2024-01-08T10:00:51,Galdakao,expenses,gifts,-554.19,-53946.51
buyer_4,Jorge,Moreno,1974-05-23,32144178E,jorge.moreno@coolnet.site,679449,ES86209540321172255358,5267.8,2024-01-09T20:39:31,Galdakao,expenses,food,-120.3,-54066.81
buyer_4,Jorge,Moreno,1974-05-23,32144178E,jorge.moreno@coolnet.site,679449,ES86209540321172255358,5267.8,2024-01-10T11:01:30,Galdakao,expenses,transport,-50.18,-54116.99
buyer_4,Jorge,Moreno,1974-05-23,32144178E,jorge.moreno@coolnet.site,679449,ES86209540321172255358,5267.8,2024-01-10T08:49:04,Galdakao,expenses,clothing,-61.88,-54178.87
buyer_4,Jorge,Moreno,1974-05-23,32144178E,jorge.moreno@coolnet.site,679449,ES86209540321172255358,5267.8,2024-01-12T14:53:59,Galdakao,expenses,cash,-100.0,-54278.87
buyer_4,Jorge,Moreno,1974-05-23,32144178E,jorge.moreno@coolnet.site,679449,ES86209540321172255358,5267.8,2024-01-13T06:55:50,Galdakao,expenses,clothing,-64.35,-54343.22
buyer_4,Jorge,Moreno,1974-05-23,32144178E,jorge.moreno@coolnet.site,679449,ES86209540321172255358,5267.8,2024-01-14T20:53:27,Galdakao,expenses,leisure,-47.65,-54390.87
buyer_4,Jorge,Moreno,1974-05-23,32144178E,jorge.moreno@coolnet.site,679449,ES86209540321172255358,5267.8,2024-01-14T22:28:47,Galdakao,expenses,cash,-100.0,-54490.87
buyer_4,Jorge,Moreno,1974-05-23,32144178E,jorge.moreno@coolnet.site,679449,ES86209540321172255358,5267.8,2024-01-15T14:21:27,Galdakao,expenses,education,-45.1,-54535.97
buyer_4,Jorge,Moreno,1974-05-23,32144178E,jorge.moreno@coolnet.site,679449,ES86209540321172255358,5267.8,2024-01-15T20:19:52,Galdakao,expenses,gifts,-416.5,-54952.47
buyer_4,Jorge,Moreno,1974-05-23,32144178E,jorge.moreno@coolnet.site,679449,ES86209540321172255358,5267.8,2024-01-16T04:55:57,Galdakao,expenses,food,-61.25,-55013.72
buyer_4,Jorge,Moreno,1974-05-23,32144178E,jorge.moreno@coolnet.site,679449,ES86209540321172255358,5267.8,2024-01-18T19:50:24,Galdakao,expenses,repairs,-302.39,-55316.11
buyer_4,Jorge,Moreno,1974-05-23,32144178E,jorge.moreno@coolnet.site,679449,ES86209540321172255358,5267.8,2024-01-19T00:12:08,Galdakao,expenses,food,-82.73,-55398.84
buyer_4,Jorge,Moreno,1974-05-23,32144178E,jorge.moreno@coolnet.site,679449,ES86209540321172255358,5267.8,2024-01-19T13:29:19,Galdakao,expenses,leisure,-32.22,-55431.06
buyer_4,Jorge,Moreno,1974-05-23,32144178E,jorge.moreno@coolnet.site,679449,ES86209540321172255358,5267.8,2024-01-19T08:35:17,Galdakao,expenses,gifts,-299.62,-55730.68
buyer_4,Jorge,Moreno,1974-05-23,32144178E,jorge.moreno@coolnet.site,679449,ES86209540321172255358,5267.8,2024-01-20T10:17:04,Galdakao,expenses,children,-821.04,-56551.72
buyer_4,Jorge,Moreno,1974-05-23,32144178E,jorge.moreno@coolnet.site,679449,ES86209540321172255358,5267.8,2024-01-21T21:10:20,Galdakao,expenses,food,-73.43,-56625.15
buyer_4,Jorge,Moreno,1974-05-23,32144178E,jorge.moreno@coolnet.site,679449,ES86209540321172255358,5267.8,2024-01-21T03:34:32,Galdakao,expenses,leisure,-22.27,-56647.42
buyer_4,Jorge,Moreno,1974-05-23,32144178E,jorge.moreno@coolnet.site,679449,ES86209540321172255358,5267.8,2024-01-21T15:35:42,Galdakao,expenses,education,-53.35,-56700.77
buyer_4,Jorge,Moreno,1974-05-23,32144178E,jorge.moreno@coolnet.site,679449,ES86209540321172255358,5267.8,2024-01-22T14:42:09,Galdakao,expenses,food,-66.35,-56767.12
buyer_4,Jorge,Moreno,1974-05-23,32144178E,jorge.moreno@coolnet.site,679449,ES86209540321172255358,5267.8,2024-01-22T17:20:58,Galdakao,expenses,cash,-100.0,-56867.12
buyer_4,Jorge,Moreno,1974-05-23,32144178E,jorge.moreno@coolnet.site,679449,ES86209540321172255358,5267.8,2024-01-22T19:53:02,Galdakao,expenses,travel,-354.76,-57221.88
buyer_4,Jorge,Moreno,1974-05-23,32144178E,jorge.moreno@coolnet.site,679449,ES86209540321172255358,5267.8,2024-01-23T17:52:11,Galdakao,expenses,food,-74.0,-57295.88
buyer_4,Jorge,Moreno,1974-05-23,32144178E,jorge.moreno@coolnet.site,679449,ES86209540321172255358,5267.8,2024-01-24T13:19:50,Galdakao,expenses,leisure,-31.86,-57327.74
buyer_4,Jorge,Moreno,1974-05-23,32144178E,jorge.moreno@coolnet.site,679449,ES86209540321172255358,5267.8,2024-01-26T16:02:04,Galdakao,expenses,gifts,-334.68,-57662.42
buyer_4,Jorge,Moreno,1974-05-23,32144178E,jorge.moreno@coolnet.site,679449,ES86209540321172255358,5267.8,2024-01-27T08:20:20,Galdakao,expenses,food,-66.96,-57729.38
buyer_4,Jorge,Moreno,1974-05-23,32144178E,jorge.moreno@coolnet.site,679449,ES86209540321172255358,5267.8,2024-01-27T17:09:18,Galdakao,expenses,gifts,-780.09,-58509.47
buyer_4,Jorge,Moreno,1974-05-23,32144178E,jorge.moreno@coolnet.site,679449,ES86209540321172255358,5267.8,2024-01-29T22:45:05,Galdakao,expenses,transport,-56.01,-58565.48
buyer_4,Jorge,Moreno,1974-05-23,32144178E,jorge.moreno@coolnet.site,679449,ES86209540321172255358,5267.8,2024-01-30T15:57:17,Galdakao,expenses,food,-80.86,-58646.34
buyer_4,Jorge,Moreno,1974-05-23,32144178E,jorge.moreno@coolnet.site,679449,ES86209540321172255358,5267.8,2024-01-30T08:24:16,Galdakao,expenses,education,-77.95,-58724.29
buyer_4,Jorge,Moreno,1974-05-23,32144178E,jorge.moreno@coolnet.site,679449,ES86209540321172255358,5267.8,2024-02-01T22:42:05,Galdakao,incomes,salary,3022.42,-55701.87
buyer_4,Jorge,Moreno,1974-05-23,32144178E,jorge.moreno@coolnet.site,679449,ES86209540321172255358,5267.8,2024-02-01T18:40:24,Galdakao,expenses,leisure,-20.06,-55721.93
buyer_4,Jorge,Moreno,1974-05-23,32144178E,jorge.moreno@coolnet.site,679449,ES86209540321172255358,5267.8,2024-02-02T14:20:06,Galdakao,expenses,education,-57.97,-55779.9
buyer_4,Jorge,Moreno,1974-05-23,32144178E,jorge.moreno@coolnet.site,679449,ES86209540321172255358,5267.8,2024-02-02T20:34:39,Galdakao,expenses,cash,-100.0,-55879.9
buyer_4,Jorge,Moreno,1974-05-23,32144178E,jorge.moreno@coolnet.site,679449,ES86209540321172255358,5267.8,2024-02-03T12:29:38,Galdakao,expenses,repairs,-216.15,-56096.05
buyer_4,Jorge,Moreno,1974-05-23,32144178E,jorge.moreno@coolnet.site,679449,ES86209540321172255358,5267.8,2024-02-04T00:50:31,Galdakao,expenses,mortgage,-1369.63,-57465.68
buyer_4,Jorge,Moreno,1974-05-23,32144178E,jorge.moreno@coolnet.site,679449,ES86209540321172255358,5267.8,2024-02-04T17:24:13,Galdakao,expenses,transport,-88.93,-57554.61
buyer_4,Jorge,Moreno,1974-05-23,32144178E,jorge.moreno@coolnet.site,679449,ES86209540321172255358,5267.8,2024-02-04T20:58:23,Galdakao,expenses,cash,-100.0,-57654.61
buyer_4,Jorge,Moreno,1974-05-23,32144178E,jorge.moreno@coolnet.site,679449,ES86209540321172255358,5267.8,2024-02-05T14:58:58,Galdakao,expenses,electricity,-89.54,-57744.15
buyer_4,Jorge,Moreno,1974-05-23,32144178E,jorge.moreno@coolnet.site,679449,ES86209540321172255358,5267.8,2024-02-05T10:02:54,Galdakao,expenses,leisure,-69.2,-57813.35
buyer_4,Jorge,Moreno,1974-05-23,32144178E,jorge.moreno@coolnet.site,679449,ES86209540321172255358,5267.8,2024-02-06T10:05:52,Galdakao,expenses,water,-51.32,-57864.67
buyer_4,Jorge,Moreno,1974-05-23,32144178E,jorge.moreno@coolnet.site,679449,ES86209540321172255358,5267.8,2024-02-06T18:00:46,Galdakao,expenses,phone,-45.36,-57910.03
buyer_4,Jorge,Moreno,1974-05-23,32144178E,jorge.moreno@coolnet.site,679449,ES86209540321172255358,5267.8,2024-02-06T10:24:17,Galdakao,expenses,repairs,-311.55,-58221.58
buyer_4,Jorge,Moreno,1974-05-23,32144178E,jorge.moreno@coolnet.site,679449,ES86209540321172255358,5267.8,2024-02-07T16:47:12,Galdakao,expenses,food,-89.47,-58311.05
buyer_4,Jorge,Moreno,1974-05-23,32144178E,jorge.moreno@coolnet.site,679449,ES86209540321172255358,5267.8,2024-02-07T09:18:42,Galdakao,expenses,leisure,-57.88,-58368.93
buyer_4,Jorge,Moreno,1974-05-23,32144178E,jorge.moreno@coolnet.site,679449,ES86209540321172255358,5267.8,2024-02-08T10:00:10,Galdakao,expenses,gas,-104.48,-58473.41
buyer_4,Jorge,Moreno,1974-05-23,32144178E,jorge.moreno@coolnet.site,679449,ES86209540321172255358,5267.8,2024-02-08T21:00:19,Galdakao,expenses,internet,-63.47,-58536.88
buyer_4,Jorge,Moreno,1974-05-23,32144178E,jorge.moreno@coolnet.site,679449,ES86209540321172255358,5267.8,2024-02-09T22:04:43,Galdakao,expenses,children,-848.06,-59384.94
buyer_4,Jorge,Moreno,1974-05-23,32144178E,jorge.moreno@coolnet.site,679449,ES86209540321172255358,5267.8,2024-02-10T18:10:47,Galdakao,expenses,clothing,-150.39,-59535.33
buyer_4,Jorge,Moreno,1974-05-23,32144178E,jorge.moreno@coolnet.site,679449,ES86209540321172255358,5267.8,2024-02-16T15:12:58,Galdakao,expenses,food,-116.99,-59652.32
buyer_4,Jorge,Moreno,1974-05-23,32144178E,jorge.moreno@coolnet.site,679449,ES86209540321172255358,5267.8,2024-02-16T10:28:44,Galdakao,expenses,clothing,-146.04,-59798.36
buyer_4,Jorge,Moreno,1974-05-23,32144178E,jorge.moreno@coolnet.site,679449,ES86209540321172255358,5267.8,2024-02-16T13:28:53,Galdakao,expenses,cash,-100.0,-59898.36
buyer_4,Jorge,Moreno,1974-05-23,32144178E,jorge.moreno@coolnet.site,679449,ES86209540321172255358,5267.8,2024-02-17T20:12:09,Galdakao,expenses,food,-119.94,-60018.3
buyer_4,Jorge,Moreno,1974-05-23,32144178E,jorge.moreno@coolnet.site,679449,ES86209540321172255358,5267.8,2024-02-17T16:00:38,Galdakao,expenses,cash,-100.0,-60118.3
buyer_4,Jorge,Moreno,1974-05-23,32144178E,jorge.moreno@coolnet.site,679449,ES86209540321172255358,5267.8,2024-02-20T09:43:16,Galdakao,expenses,leisure,-61.81,-60180.11
buyer_4,Jorge,Moreno,1974-05-23,32144178E,jorge.moreno@coolnet.site,679449,ES86209540321172255358,5267.8,2024-02-21T16:23:14,Galdakao,expenses,leisure,-29.0,-60209.11
buyer_4,Jorge,Moreno,1974-05-23,32144178E,jorge.moreno@coolnet.site,679449,ES86209540321172255358,5267.8,2024-02-21T17:22:29,Galdakao,expenses,clothing,-123.26,-60332.37
buyer_4,Jorge,Moreno,1974-05-23,32144178E,jorge.moreno@coolnet.site,679449,ES86209540321172255358,5267.8,2024-02-21T17:59:55,Galdakao,expenses,cash,-100.0,-60432.37
buyer_4,Jorge,Moreno,1974-05-23,32144178E,jorge.moreno@coolnet.site,679449,ES86209540321172255358,5267.8,2024-02-22T14:15:33,Galdakao,expenses,clothing,-69.88,-60502.25
buyer_4,Jorge,Moreno,1974-05-23,32144178E,jorge.moreno@coolnet.site,679449,ES86209540321172255358,5267.8,2024-02-23T11:56:19,Galdakao,expenses,food,-60.51,-60562.76
buyer_4,Jorge,Moreno,1974-05-23,32144178E,jorge.moreno@coolnet.site,679449,ES86209540321172255358,5267.8,2024-02-23T09:08:28,Galdakao,expenses,healthcare,-150.84,-60713.6
buyer_4,Jorge,Moreno,1974-05-23,32144178E,jorge.moreno@coolnet.site,679449,ES86209540321172255358,5267.8,2024-02-23T18:37:37,Galdakao,expenses,repairs,-316.74,-61030.34
buyer_4,Jorge,Moreno,1974-05-23,32144178E,jorge.moreno@coolnet.site,679449,ES86209540321172255358,5267.8,2024-02-24T19:30:24,Galdakao,expenses,clothing,-154.74,-61185.08
buyer_4,Jorge,Moreno,1974-05-23,32144178E,jorge.moreno@coolnet.site,679449,ES86209540321172255358,5267.8,2024-02-24T08:47:23,Galdakao,expenses,cash,-100.0,-61285.08
buyer_4,Jorge,Moreno,1974-05-23,32144178E,jorge.moreno@coolnet.site,679449,ES86209540321172255358,5267.8,2024-02-24T20:09:33,Galdakao,expenses,gifts,-159.38,-61444.46
buyer_4,Jorge,Moreno,1974-05-23,32144178E,jorge.moreno@coolnet.site,679449,ES86209540321172255358,5267.8,2024-02-25T08:41:17,Galdakao,expenses,transport,-47.86,-61492.32
buyer_4,Jorge,Moreno,1974-05-23,32144178E,jorge.moreno@coolnet.site,679449,ES86209540321172255358,5267.8,2024-02-25T12:34:17,Galdakao,expenses,cash,-100.0,-61592.32
buyer_4,Jorge,Moreno,1974-05-23,32144178E,jorge.moreno@coolnet.site,679449,ES86209540321172255358,5267.8,2024-02-26T15:49:55,Galdakao,expenses,food,-77.62,-61669.94
buyer_4,Jorge,Moreno,1974-05-23,32144178E,jorge.moreno@coolnet.site,679449,ES86209540321172255358,5267.8,2024-02-26T14:43:25,Galdakao,expenses,leisure,-38.32,-61708.26
buyer_4,Jorge,Moreno,1974-05-23,32144178E,jorge.moreno@coolnet.site,679449,ES86209540321172255358,5267.8,2024-02-28T10:23:34,Galdakao,expenses,food,-66.31,-61774.57
buyer_4,Jorge,Moreno,1974-05-23,32144178E,jorge.moreno@coolnet.site,679449,ES86209540321172255358,5267.8,2024-02-28T16:51:26,Galdakao,expenses,cash,-100.0,-61874.57
buyer_4,Jorge,Moreno,1974-05-23,32144178E,jorge.moreno@coolnet.site,679449,ES86209540321172255358,5267.8,2024-02-29T15:46:02,Galdakao,expenses,travel,-328.79,-62203.36
buyer_4,Jorge,Moreno,1974-05-23,32144178E,jorge.moreno@coolnet.site,679449,ES86209540321172255358,5267.8,2024-03-01T16:19:20,Galdakao,incomes,salary,3022.42,-59180.94
buyer_4,Jorge,Moreno,1974-05-23,32144178E,jorge.moreno@coolnet.site,679449,ES86209540321172255358,5267.8,2024-03-04T15:25:21,Galdakao,expenses,mortgage,-1369.63,-60550.57
buyer_4,Jorge,Moreno,1974-05-23,32144178E,jorge.moreno@coolnet.site,679449,ES86209540321172255358,5267.8,2024-03-05T15:53:04,Galdakao,expenses,gas,-156.66,-60707.23
buyer_4,Jorge,Moreno,1974-05-23,32144178E,jorge.moreno@coolnet.site,679449,ES86209540321172255358,5267.8,2024-03-05T03:03:03,Galdakao,expenses,phone,-46.41,-60753.64
buyer_4,Jorge,Moreno,1974-05-23,32144178E,jorge.moreno@coolnet.site,679449,ES86209540321172255358,5267.8,2024-03-07T16:28:15,Galdakao,expenses,electricity,-101.13,-60854.77
buyer_4,Jorge,Moreno,1974-05-23,32144178E,jorge.moreno@coolnet.site,679449,ES86209540321172255358,5267.8,2024-03-08T17:22:26,Galdakao,expenses,water,-58.19,-60912.96
buyer_4,Jorge,Moreno,1974-05-23,32144178E,jorge.moreno@coolnet.site,679449,ES86209540321172255358,5267.8,2024-03-08T09:58:29,Galdakao,expenses,internet,-63.47,-60976.43
buyer_4,Jorge,Moreno,1974-05-23,32144178E,jorge.moreno@coolnet.site,679449,ES86209540321172255358,5267.8,2024-03-09T13:31:08,Galdakao,expenses,clothing,-89.67,-61066.1
buyer_4,Jorge,Moreno,1974-05-23,32144178E,jorge.moreno@coolnet.site,679449,ES86209540321172255358,5267.8,2024-03-11T15:06:25,Galdakao,expenses,transport,-42.37,-61108.47
buyer_4,Jorge,Moreno,1974-05-23,32144178E,jorge.moreno@coolnet.site,679449,ES86209540321172255358,5267.8,2024-03-12T18:56:49,Galdakao,expenses,cash,-100.0,-61208.47
buyer_4,Jorge,Moreno,1974-05-23,32144178E,jorge.moreno@coolnet.site,679449,ES86209540321172255358,5267.8,2024-03-12T16:32:15,Galdakao,expenses,gifts,-212.12,-61420.59
buyer_4,Jorge,Moreno,1974-05-23,32144178E,jorge.moreno@coolnet.site,679449,ES86209540321172255358,5267.8,2024-03-13T15:24:02,Galdakao,expenses,leisure,-41.44,-61462.03
buyer_4,Jorge,Moreno,1974-05-23,32144178E,jorge.moreno@coolnet.site,679449,ES86209540321172255358,5267.8,2024-03-14T14:47:42,Galdakao,expenses,cash,-100.0,-61562.03
buyer_4,Jorge,Moreno,1974-05-23,32144178E,jorge.moreno@coolnet.site,679449,ES86209540321172255358,5267.8,2024-03-15T22:30:37,Galdakao,expenses,leisure,-59.06,-61621.09
buyer_4,Jorge,Moreno,1974-05-23,32144178E,jorge.moreno@coolnet.site,679449,ES86209540321172255358,5267.8,2024-03-22T16:13:47,Galdakao,expenses,transport,-73.72,-61694.81
buyer_4,Jorge,Moreno,1974-05-23,32144178E,jorge.moreno@coolnet.site,679449,ES86209540321172255358,5267.8,2024-03-24T16:17:35,Galdakao,expenses,food,-123.75,-61818.56
buyer_4,Jorge,Moreno,1974-05-23,32144178E,jorge.moreno@coolnet.site,679449,ES86209540321172255358,5267.8,2024-03-25T18:11:58,Galdakao,expenses,education,-54.9,-61873.46
buyer_4,Jorge,Moreno,1974-05-23,32144178E,jorge.moreno@coolnet.site,679449,ES86209540321172255358,5267.8,2024-03-27T14:53:57,Galdakao,expenses,food,-92.13,-61965.59
buyer_4,Jorge,Moreno,1974-05-23,32144178E,jorge.moreno@coolnet.site,679449,ES86209540321172255358,5267.8,2024-03-27T18:04:56,Galdakao,expenses,transport,-41.0,-62006.59
buyer_4,Jorge,Moreno,1974-05-23,32144178E,jorge.moreno@coolnet.site,679449,ES86209540321172255358,5267.8,2024-03-28T14:31:58,Galdakao,expenses,clothing,-106.5,-62113.09
buyer_4,Jorge,Moreno,1974-05-23,32144178E,jorge.moreno@coolnet.site,679449,ES86209540321172255358,5267.8,2024-03-28T23:49:55,Galdakao,expenses,gifts,-180.82,-62293.91
buyer_4,Jorge,Moreno,1974-05-23,32144178E,jorge.moreno@coolnet.site,679449,ES86209540321172255358,5267.8,2024-03-29T16:29:07,Galdakao,expenses,children,-1116.7979166666667,-63410.71
buyer_4,Jorge,Moreno,1974-05-23,32144178E,jorge.moreno@coolnet.site,679449,ES86209540321172255358,5267.8,2024-03-30T11:07:42,Galdakao,expenses,healthcare,-179.44,-63590.15
buyer_4,Jorge,Moreno,1974-05-23,32144178E,jorge.moreno@coolnet.site,679449,ES86209540321172255358,5267.8,2024-03-30T15:12:40,Galdakao,expenses,education,-50.14,-63640.29
buyer_4,Jorge,Moreno,1974-05-23,32144178E,jorge.moreno@coolnet.site,679449,ES86209540321172255358,5267.8,2024-04-01T11:54:20,Galdakao,incomes,salary,3022.42,-60617.87
buyer_4,Jorge,Moreno,1974-05-23,32144178E,jorge.moreno@coolnet.site,679449,ES86209540321172255358,5267.8,2024-04-01T11:54:20,Galdakao,incomes,extra_income,338.65,-60279.22
buyer_4,Jorge,Moreno,1974-05-23,32144178E,jorge.moreno@coolnet.site,679449,ES86209540321172255358,5267.8,2024-04-01T20:26:33,Galdakao,expenses,cash,-100.0,-60379.22
buyer_4,Jorge,Moreno,1974-05-23,32144178E,jorge.moreno@coolnet.site,679449,ES86209540321172255358,5267.8,2024-04-02T19:54:45,Galdakao,expenses,transport,-78.21,-60457.43
buyer_4,Jorge,Moreno,1974-05-23,32144178E,jorge.moreno@coolnet.site,679449,ES86209540321172255358,5267.8,2024-04-02T10:38:17,Galdakao,expenses,repairs,-275.11,-60732.54
buyer_4,Jorge,Moreno,1974-05-23,32144178E,jorge.moreno@coolnet.site,679449,ES86209540321172255358,5267.8,2024-04-03T15:22:31,Galdakao,expenses,cash,-100.0,-60832.54
buyer_4,Jorge,Moreno,1974-05-23,32144178E,jorge.moreno@coolnet.site,679449,ES86209540321172255358,5267.8,2024-04-04T12:00:40,Galdakao,expenses,mortgage,-1369.63,-62202.17
buyer_4,Jorge,Moreno,1974-05-23,32144178E,jorge.moreno@coolnet.site,679449,ES86209540321172255358,5267.8,2024-04-04T15:44:30,Galdakao,expenses,food,-84.69,-62286.86
buyer_4,Jorge,Moreno,1974-05-23,32144178E,jorge.moreno@coolnet.site,679449,ES86209540321172255358,5267.8,2024-04-06T15:44:39,Galdakao,expenses,water,-53.25,-62340.11
buyer_4,Jorge,Moreno,1974-05-23,32144178E,jorge.moreno@coolnet.site,679449,ES86209540321172255358,5267.8,2024-04-06T12:30:48,Galdakao,expenses,gifts,-279.4,-62619.51
buyer_4,Jorge,Moreno,1974-05-23,32144178E,jorge.moreno@coolnet.site,679449,ES86209540321172255358,5267.8,2024-04-07T13:07:32,Galdakao,expenses,electricity,-130.17,-62749.68
buyer_4,Jorge,Moreno,1974-05-23,32144178E,jorge.moreno@coolnet.site,679449,ES86209540321172255358,5267.8,2024-04-07T13:44:59,Galdakao,expenses,internet,-63.47,-62813.15
buyer_4,Jorge,Moreno,1974-05-23,32144178E,jorge.moreno@coolnet.site,679449,ES86209540321172255358,5267.8,2024-04-08T16:31:24,Galdakao,expenses,gas,-88.08,-62901.23
buyer_4,Jorge,Moreno,1974-05-23,32144178E,jorge.moreno@coolnet.site,679449,ES86209540321172255358,5267.8,2024-04-08T19:46:50,Galdakao,expenses,phone,-53.06,-62954.29
buyer_4,Jorge,Moreno,1974-05-23,32144178E,jorge.moreno@coolnet.site,679449,ES86209540321172255358,5267.8,2024-04-08T10:41:45,Galdakao,expenses,healthcare,-185.03,-63139.32
buyer_4,Jorge,Moreno,1974-05-23,32144178E,jorge.moreno@coolnet.site,679449,ES86209540321172255358,5267.8,2024-04-09T23:23:51,Galdakao,expenses,repairs,-59.98,-63199.3
buyer_4,Jorge,Moreno,1974-05-23,32144178E,jorge.moreno@coolnet.site,679449,ES86209540321172255358,5267.8,2024-04-10T01:05:23,Galdakao,expenses,cash,-100.0,-63299.3
buyer_4,Jorge,Moreno,1974-05-23,32144178E,jorge.moreno@coolnet.site,679449,ES86209540321172255358,5267.8,2024-04-12T10:33:29,Galdakao,expenses,transport,-43.27,-63342.57
buyer_4,Jorge,Moreno,1974-05-23,32144178E,jorge.moreno@coolnet.site,679449,ES86209540321172255358,5267.8,2024-04-14T22:46:40,Galdakao,expenses,transport,-68.33,-63410.9
buyer_4,Jorge,Moreno,1974-05-23,32144178E,jorge.moreno@coolnet.site,679449,ES86209540321172255358,5267.8,2024-04-14T01:22:53,Galdakao,expenses,cash,-100.0,-63510.9
buyer_4,Jorge,Moreno,1974-05-23,32144178E,jorge.moreno@coolnet.site,679449,ES86209540321172255358,5267.8,2024-04-15T17:31:40,Galdakao,expenses,education,-55.54,-63566.44
buyer_4,Jorge,Moreno,1974-05-23,32144178E,jorge.moreno@coolnet.site,679449,ES86209540321172255358,5267.8,2024-04-16T12:04:48,Galdakao,expenses,cash,-100.0,-63666.44
buyer_4,Jorge,Moreno,1974-05-23,32144178E,jorge.moreno@coolnet.site,679449,ES86209540321172255358,5267.8,2024-04-19T08:05:47,Galdakao,expenses,food,-114.94,-63781.38
buyer_4,Jorge,Moreno,1974-05-23,32144178E,jorge.moreno@coolnet.site,679449,ES86209540321172255358,5267.8,2024-04-19T17:28:08,Galdakao,expenses,clothing,-129.74,-63911.12
buyer_4,Jorge,Moreno,1974-05-23,32144178E,jorge.moreno@coolnet.site,679449,ES86209540321172255358,5267.8,2024-04-19T15:33:29,Galdakao,expenses,education,-66.49,-63977.61
buyer_4,Jorge,Moreno,1974-05-23,32144178E,jorge.moreno@coolnet.site,679449,ES86209540321172255358,5267.8,2024-04-21T15:28:57,Galdakao,expenses,transport,-43.63,-64021.24
buyer_4,Jorge,Moreno,1974-05-23,32144178E,jorge.moreno@coolnet.site,679449,ES86209540321172255358,5267.8,2024-04-21T15:12:51,Galdakao,expenses,gifts,-458.52,-64479.76
buyer_4,Jorge,Moreno,1974-05-23,32144178E,jorge.moreno@coolnet.site,679449,ES86209540321172255358,5267.8,2024-04-23T14:40:16,Galdakao,expenses,transport,-83.12,-64562.88
buyer_4,Jorge,Moreno,1974-05-23,32144178E,jorge.moreno@coolnet.site,679449,ES86209540321172255358,5267.8,2024-04-23T13:11:05,Galdakao,expenses,leisure,-31.86,-64594.74
buyer_4,Jorge,Moreno,1974-05-23,32144178E,jorge.moreno@coolnet.site,679449,ES86209540321172255358,5267.8,2024-04-24T13:26:42,Galdakao,expenses,clothing,-71.01,-64665.75
buyer_4,Jorge,Moreno,1974-05-23,32144178E,jorge.moreno@coolnet.site,679449,ES86209540321172255358,5267.8,2024-04-27T22:08:21,Galdakao,expenses,food,-110.79,-64776.54
buyer_4,Jorge,Moreno,1974-05-23,32144178E,jorge.moreno@coolnet.site,679449,ES86209540321172255358,5267.8,2024-04-29T10:50:54,Galdakao,expenses,food,-120.62,-64897.16
buyer_4,Jorge,Moreno,1974-05-23,32144178E,jorge.moreno@coolnet.site,679449,ES86209540321172255358,5267.8,2024-04-29T04:59:15,Galdakao,expenses,transport,-44.54,-64941.7
buyer_4,Jorge,Moreno,1974-05-23,32144178E,jorge.moreno@coolnet.site,679449,ES86209540321172255358,5267.8,2024-05-01T21:16:40,Galdakao,incomes,salary,3022.42,-61919.28
buyer_4,Jorge,Moreno,1974-05-23,32144178E,jorge.moreno@coolnet.site,679449,ES86209540321172255358,5267.8,2024-05-04T17:53:28,Galdakao,expenses,mortgage,-1369.63,-63288.91
buyer_4,Jorge,Moreno,1974-05-23,32144178E,jorge.moreno@coolnet.site,679449,ES86209540321172255358,5267.8,2024-05-04T09:05:06,Galdakao,expenses,repairs,-91.71,-63380.62
buyer_4,Jorge,Moreno,1974-05-23,32144178E,jorge.moreno@coolnet.site,679449,ES86209540321172255358,5267.8,2024-05-05T08:47:15,Galdakao,expenses,internet,-63.47,-63444.09
buyer_4,Jorge,Moreno,1974-05-23,32144178E,jorge.moreno@coolnet.site,679449,ES86209540321172255358,5267.8,2024-05-06T22:56:52,Galdakao,expenses,electricity,-130.64,-63574.73
buyer_4,Jorge,Moreno,1974-05-23,32144178E,jorge.moreno@coolnet.site,679449,ES86209540321172255358,5267.8,2024-05-06T18:55:07,Galdakao,expenses,phone,-51.4,-63626.13
buyer_4,Jorge,Moreno,1974-05-23,32144178E,jorge.moreno@coolnet.site,679449,ES86209540321172255358,5267.8,2024-05-07T14:49:50,Galdakao,expenses,food,-114.48,-63740.61
buyer_4,Jorge,Moreno,1974-05-23,32144178E,jorge.moreno@coolnet.site,679449,ES86209540321172255358,5267.8,2024-05-07T16:49:46,Galdakao,expenses,gifts,-170.58,-63911.19
buyer_4,Jorge,Moreno,1974-05-23,32144178E,jorge.moreno@coolnet.site,679449,ES86209540321172255358,5267.8,2024-05-08T21:47:32,Galdakao,expenses,water,-44.38,-63955.57
buyer_4,Jorge,Moreno,1974-05-23,32144178E,jorge.moreno@coolnet.site,679449,ES86209540321172255358,5267.8,2024-05-08T17:53:48,Galdakao,expenses,gas,-169.71,-64125.28
buyer_4,Jorge,Moreno,1974-05-23,32144178E,jorge.moreno@coolnet.site,679449,ES86209540321172255358,5267.8,2024-05-10T17:04:59,Galdakao,expenses,healthcare,-67.77,-64193.05
buyer_4,Jorge,Moreno,1974-05-23,32144178E,jorge.moreno@coolnet.site,679449,ES86209540321172255358,5267.8,2024-05-10T17:48:24,Galdakao,expenses,appliances,-247.55,-64440.6
buyer_4,Jorge,Moreno,1974-05-23,32144178E,jorge.moreno@coolnet.site,679449,ES86209540321172255358,5267.8,2024-05-11T11:10:59,Galdakao,expenses,transport,-60.53,-64501.13
buyer_4,Jorge,Moreno,1974-05-23,32144178E,jorge.moreno@coolnet.site,679449,ES86209540321172255358,5267.8,2024-05-16T18:13:16,Galdakao,expenses,clothing,-61.0,-64562.13
buyer_4,Jorge,Moreno,1974-05-23,32144178E,jorge.moreno@coolnet.site,679449,ES86209540321172255358,5267.8,2024-05-17T00:08:01,Galdakao,expenses,food,-79.09,-64641.22
buyer_4,Jorge,Moreno,1974-05-23,32144178E,jorge.moreno@coolnet.site,679449,ES86209540321172255358,5267.8,2024-05-17T21:02:46,Galdakao,expenses,leisure,-74.73,-64715.95
buyer_4,Jorge,Moreno,1974-05-23,32144178E,jorge.moreno@coolnet.site,679449,ES86209540321172255358,5267.8,2024-05-17T13:41:19,Galdakao,expenses,cash,-100.0,-64815.95
buyer_4,Jorge,Moreno,1974-05-23,32144178E,jorge.moreno@coolnet.site,679449,ES86209540321172255358,5267.8,2024-05-20T17:58:22,Galdakao,expenses,clothing,-132.1,-64948.05
buyer_4,Jorge,Moreno,1974-05-23,32144178E,jorge.moreno@coolnet.site,679449,ES86209540321172255358,5267.8,2024-05-21T18:43:01,Galdakao,expenses,leisure,-51.86,-64999.91
buyer_4,Jorge,Moreno,1974-05-23,32144178E,jorge.moreno@coolnet.site,679449,ES86209540321172255358,5267.8,2024-05-25T13:55:48,Galdakao,expenses,food,-76.25,-65076.16
buyer_4,Jorge,Moreno,1974-05-23,32144178E,jorge.moreno@coolnet.site,679449,ES86209540321172255358,5267.8,2024-05-27T15:41:59,Galdakao,expenses,healthcare,-91.03,-65167.19
buyer_4,Jorge,Moreno,1974-05-23,32144178E,jorge.moreno@coolnet.site,679449,ES86209540321172255358,5267.8,2024-05-29T11:36:32,Galdakao,expenses,children,-1116.7979166666667,-66283.99
buyer_4,Jorge,Moreno,1974-05-23,32144178E,jorge.moreno@coolnet.site,679449,ES86209540321172255358,5267.8,2024-05-31T23:43:40,Galdakao,expenses,clothing,-86.34,-66370.33
buyer_4,Jorge,Moreno,1974-05-23,32144178E,jorge.moreno@coolnet.site,679449,ES86209540321172255358,5267.8,2024-06-01T10:54:04,Galdakao,incomes,salary,3022.42,-63347.91
buyer_4,Jorge,Moreno,1974-05-23,32144178E,jorge.moreno@coolnet.site,679449,ES86209540321172255358,5267.8,2024-06-01T10:54:04,Galdakao,incomes,salary_bonus,2385.28,-60962.63
buyer_4,Jorge,Moreno,1974-05-23,32144178E,jorge.moreno@coolnet.site,679449,ES86209540321172255358,5267.8,2024-06-01T16:23:24,Galdakao,expenses,food,-117.61,-61080.24
buyer_4,Jorge,Moreno,1974-05-23,32144178E,jorge.moreno@coolnet.site,679449,ES86209540321172255358,5267.8,2024-06-01T13:14:30,Galdakao,expenses,cash,-100.0,-61180.24
buyer_4,Jorge,Moreno,1974-05-23,32144178E,jorge.moreno@coolnet.site,679449,ES86209540321172255358,5267.8,2024-06-02T17:23:50,Galdakao,expenses,food,-115.95,-61296.19
buyer_4,Jorge,Moreno,1974-05-23,32144178E,jorge.moreno@coolnet.site,679449,ES86209540321172255358,5267.8,2024-06-02T15:38:35,Galdakao,expenses,education,-53.47,-61349.66
buyer_4,Jorge,Moreno,1974-05-23,32144178E,jorge.moreno@coolnet.site,679449,ES86209540321172255358,5267.8,2024-06-04T04:17:06,Galdakao,expenses,mortgage,-1369.63,-62719.29
buyer_4,Jorge,Moreno,1974-05-23,32144178E,jorge.moreno@coolnet.site,679449,ES86209540321172255358,5267.8,2024-06-05T17:59:55,Galdakao,expenses,internet,-63.47,-62782.76
buyer_4,Jorge,Moreno,1974-05-23,32144178E,jorge.moreno@coolnet.site,679449,ES86209540321172255358,5267.8,2024-06-05T16:25:44,Galdakao,expenses,phone,-46.96,-62829.72
buyer_4,Jorge,Moreno,1974-05-23,32144178E,jorge.moreno@coolnet.site,679449,ES86209540321172255358,5267.8,2024-06-05T11:30:03,Galdakao,expenses,cash,-100.0,-62929.72
buyer_4,Jorge,Moreno,1974-05-23,32144178E,jorge.moreno@coolnet.site,679449,ES86209540321172255358,5267.8,2024-06-08T14:00:07,Galdakao,expenses,water,-33.15,-62962.87
buyer_4,Jorge,Moreno,1974-05-23,32144178E,jorge.moreno@coolnet.site,679449,ES86209540321172255358,5267.8,2024-06-08T20:31:13,Galdakao,expenses,electricity,-104.42,-63067.29
buyer_4,Jorge,Moreno,1974-05-23,32144178E,jorge.moreno@coolnet.site,679449,ES86209540321172255358,5267.8,2024-06-08T08:00:55,Galdakao,expenses,gas,-62.28,-63129.57
buyer_4,Jorge,Moreno,1974-05-23,32144178E,jorge.moreno@coolnet.site,679449,ES86209540321172255358,5267.8,2024-06-10T11:39:37,Galdakao,expenses,leisure,-55.8,-63185.37
buyer_4,Jorge,Moreno,1974-05-23,32144178E,jorge.moreno@coolnet.site,679449,ES86209540321172255358,5267.8,2024-06-10T17:44:41,Galdakao,expenses,cash,-100.0,-63285.37
buyer_4,Jorge,Moreno,1974-05-23,32144178E,jorge.moreno@coolnet.site,679449,ES86209540321172255358,5267.8,2024-06-11T19:50:51,Galdakao,expenses,gifts,-312.25,-63597.62
buyer_4,Jorge,Moreno,1974-05-23,32144178E,jorge.moreno@coolnet.site,679449,ES86209540321172255358,5267.8,2024-06-16T10:50:58,Galdakao,expenses,leisure,-49.8,-63647.42
buyer_4,Jorge,Moreno,1974-05-23,32144178E,jorge.moreno@coolnet.site,679449,ES86209540321172255358,5267.8,2024-06-16T17:11:44,Galdakao,expenses,appliances,-393.73,-64041.15
buyer_4,Jorge,Moreno,1974-05-23,32144178E,jorge.moreno@coolnet.site,679449,ES86209540321172255358,5267.8,2024-06-17T06:39:21,Galdakao,expenses,cash,-100.0,-64141.15
buyer_4,Jorge,Moreno,1974-05-23,32144178E,jorge.moreno@coolnet.site,679449,ES86209540321172255358,5267.8,2024-06-18T15:26:15,Galdakao,expenses,gifts,-300.94,-64442.09
buyer_4,Jorge,Moreno,1974-05-23,32144178E,jorge.moreno@coolnet.site,679449,ES86209540321172255358,5267.8,2024-06-22T08:12:06,Galdakao,expenses,transport,-60.82,-64502.91
buyer_4,Jorge,Moreno,1974-05-23,32144178E,jorge.moreno@coolnet.site,679449,ES86209540321172255358,5267.8,2024-06-23T04:46:31,Galdakao,expenses,education,-76.03,-64578.94
buyer_4,Jorge,Moreno,1974-05-23,32144178E,jorge.moreno@coolnet.site,679449,ES86209540321172255358,5267.8,2024-06-23T08:39:24,Galdakao,expenses,cash,-100.0,-64678.94
buyer_4,Jorge,Moreno,1974-05-23,32144178E,jorge.moreno@coolnet.site,679449,ES86209540321172255358,5267.8,2024-06-24T11:26:10,Galdakao,expenses,repairs,-212.99,-64891.93
buyer_4,Jorge,Moreno,1974-05-23,32144178E,jorge.moreno@coolnet.site,679449,ES86209540321172255358,5267.8,2024-06-26T11:49:10,Galdakao,expenses,food,-110.82,-65002.75
buyer_4,Jorge,Moreno,1974-05-23,32144178E,jorge.moreno@coolnet.site,679449,ES86209540321172255358,5267.8,2024-06-26T21:25:03,Galdakao,expenses,cash,-100.0,-65102.75
buyer_4,Jorge,Moreno,1974-05-23,32144178E,jorge.moreno@coolnet.site,679449,ES86209540321172255358,5267.8,2024-06-27T13:10:13,Galdakao,expenses,transport,-81.47,-65184.22
buyer_4,Jorge,Moreno,1974-05-23,32144178E,jorge.moreno@coolnet.site,679449,ES86209540321172255358,5267.8,2024-06-27T13:58:43,Galdakao,expenses,cash,-100.0,-65284.22
buyer_4,Jorge,Moreno,1974-05-23,32144178E,jorge.moreno@coolnet.site,679449,ES86209540321172255358,5267.8,2024-06-27T13:13:45,Galdakao,expenses,appliances,-257.21,-65541.43
buyer_4,Jorge,Moreno,1974-05-23,32144178E,jorge.moreno@coolnet.site,679449,ES86209540321172255358,5267.8,2024-06-28T22:01:20,Galdakao,expenses,transport,-79.22,-65620.65
buyer_4,Jorge,Moreno,1974-05-23,32144178E,jorge.moreno@coolnet.site,679449,ES86209540321172255358,5267.8,2024-06-28T10:40:35,Galdakao,expenses,cash,-100.0,-65720.65
buyer_4,Jorge,Moreno,1974-05-23,32144178E,jorge.moreno@coolnet.site,679449,ES86209540321172255358,5267.8,2024-06-30T05:53:49,Galdakao,expenses,transport,-84.23,-65804.88
buyer_4,Jorge,Moreno,1974-05-23,32144178E,jorge.moreno@coolnet.site,679449,ES86209540321172255358,5267.8,2024-06-30T08:02:00,Galdakao,expenses,cash,-100.0,-65904.88
buyer_4,Jorge,Moreno,1974-05-23,32144178E,jorge.moreno@coolnet.site,679449,ES86209540321172255358,5267.8,2024-07-01T11:05:16,Galdakao,incomes,salary,3022.42,-62882.46
buyer_4,Jorge,Moreno,1974-05-23,32144178E,jorge.moreno@coolnet.site,679449,ES86209540321172255358,5267.8,2024-07-01T11:05:16,Galdakao,incomes,extra_income,338.65,-62543.81
buyer_4,Jorge,Moreno,1974-05-23,32144178E,jorge.moreno@coolnet.site,679449,ES86209540321172255358,5267.8,2024-07-01T16:41:08,Galdakao,expenses,children,-815.62,-63359.43
buyer_4,Jorge,Moreno,1974-05-23,32144178E,jorge.moreno@coolnet.site,679449,ES86209540321172255358,5267.8,2024-07-02T13:08:38,Galdakao,expenses,repairs,-76.74,-63436.17
buyer_4,Jorge,Moreno,1974-05-23,32144178E,jorge.moreno@coolnet.site,679449,ES86209540321172255358,5267.8,2024-07-04T15:15:28,Galdakao,expenses,mortgage,-1369.63,-64805.8
buyer_4,Jorge,Moreno,1974-05-23,32144178E,jorge.moreno@coolnet.site,679449,ES86209540321172255358,5267.8,2024-07-04T08:53:26,Galdakao,expenses,food,-81.55,-64887.35
buyer_4,Jorge,Moreno,1974-05-23,32144178E,jorge.moreno@coolnet.site,679449,ES86209540321172255358,5267.8,2024-07-04T20:31:11,Galdakao,expenses,cash,-100.0,-64987.35
buyer_4,Jorge,Moreno,1974-05-23,32144178E,jorge.moreno@coolnet.site,679449,ES86209540321172255358,5267.8,2024-07-05T17:25:58,Galdakao,expenses,food,-94.63,-65081.98
buyer_4,Jorge,Moreno,1974-05-23,32144178E,jorge.moreno@coolnet.site,679449,ES86209540321172255358,5267.8,2024-07-06T21:55:12,Galdakao,expenses,electricity,-135.48,-65217.46
buyer_4,Jorge,Moreno,1974-05-23,32144178E,jorge.moreno@coolnet.site,679449,ES86209540321172255358,5267.8,2024-07-06T19:50:05,Galdakao,expenses,phone,-51.16,-65268.62
buyer_4,Jorge,Moreno,1974-05-23,32144178E,jorge.moreno@coolnet.site,679449,ES86209540321172255358,5267.8,2024-07-08T12:04:14,Galdakao,expenses,gas,-96.74,-65365.36
buyer_4,Jorge,Moreno,1974-05-23,32144178E,jorge.moreno@coolnet.site,679449,ES86209540321172255358,5267.8,2024-07-08T07:27:31,Galdakao,expenses,water,-30.58,-65395.94
buyer_4,Jorge,Moreno,1974-05-23,32144178E,jorge.moreno@coolnet.site,679449,ES86209540321172255358,5267.8,2024-07-08T15:58:06,Galdakao,expenses,internet,-63.47,-65459.41
buyer_4,Jorge,Moreno,1974-05-23,32144178E,jorge.moreno@coolnet.site,679449,ES86209540321172255358,5267.8,2024-07-09T19:56:27,Galdakao,expenses,education,-73.96,-65533.37
buyer_4,Jorge,Moreno,1974-05-23,32144178E,jorge.moreno@coolnet.site,679449,ES86209540321172255358,5267.8,2024-07-09T03:45:10,Galdakao,expenses,cash,-100.0,-65633.37
buyer_4,Jorge,Moreno,1974-05-23,32144178E,jorge.moreno@coolnet.site,679449,ES86209540321172255358,5267.8,2024-07-10T19:13:06,Galdakao,expenses,food,-61.97,-65695.34
buyer_4,Jorge,Moreno,1974-05-23,32144178E,jorge.moreno@coolnet.site,679449,ES86209540321172255358,5267.8,2024-07-14T20:51:08,Galdakao,expenses,food,-97.45,-65792.79
buyer_4,Jorge,Moreno,1974-05-23,32144178E,jorge.moreno@coolnet.site,679449,ES86209540321172255358,5267.8,2024-07-16T09:54:13,Galdakao,expenses,leisure,-80.23,-65873.02
buyer_4,Jorge,Moreno,1974-05-23,32144178E,jorge.moreno@coolnet.site,679449,ES86209540321172255358,5267.8,2024-07-16T03:39:24,Galdakao,expenses,repairs,-255.03,-66128.05
buyer_4,Jorge,Moreno,1974-05-23,32144178E,jorge.moreno@coolnet.site,679449,ES86209540321172255358,5267.8,2024-07-17T14:22:23,Galdakao,expenses,appliances,-139.3,-66267.35
buyer_4,Jorge,Moreno,1974-05-23,32144178E,jorge.moreno@coolnet.site,679449,ES86209540321172255358,5267.8,2024-07-19T13:24:56,Galdakao,expenses,leisure,-24.88,-66292.23
buyer_4,Jorge,Moreno,1974-05-23,32144178E,jorge.moreno@coolnet.site,679449,ES86209540321172255358,5267.8,2024-07-19T10:15:33,Galdakao,expenses,cash,-100.0,-66392.23
buyer_4,Jorge,Moreno,1974-05-23,32144178E,jorge.moreno@coolnet.site,679449,ES86209540321172255358,5267.8,2024-07-20T09:37:17,Galdakao,expenses,cash,-100.0,-66492.23
buyer_4,Jorge,Moreno,1974-05-23,32144178E,jorge.moreno@coolnet.site,679449,ES86209540321172255358,5267.8,2024-07-22T19:48:43,Galdakao,expenses,leisure,-28.0,-66520.23
buyer_4,Jorge,Moreno,1974-05-23,32144178E,jorge.moreno@coolnet.site,679449,ES86209540321172255358,5267.8,2024-07-24T12:58:43,Galdakao,expenses,clothing,-132.36,-66652.59
buyer_4,Jorge,Moreno,1974-05-23,32144178E,jorge.moreno@coolnet.site,679449,ES86209540321172255358,5267.8,2024-07-25T08:19:32,Galdakao,expenses,repairs,-260.14,-66912.73
buyer_4,Jorge,Moreno,1974-05-23,32144178E,jorge.moreno@coolnet.site,679449,ES86209540321172255358,5267.8,2024-07-26T13:50:36,Galdakao,expenses,leisure,-72.91,-66985.64
buyer_4,Jorge,Moreno,1974-05-23,32144178E,jorge.moreno@coolnet.site,679449,ES86209540321172255358,5267.8,2024-07-26T15:07:47,Galdakao,expenses,gifts,-255.76,-67241.4
buyer_4,Jorge,Moreno,1974-05-23,32144178E,jorge.moreno@coolnet.site,679449,ES86209540321172255358,5267.8,2024-07-30T19:48:10,Galdakao,expenses,food,-89.53,-67330.93
buyer_4,Jorge,Moreno,1974-05-23,32144178E,jorge.moreno@coolnet.site,679449,ES86209540321172255358,5267.8,2024-07-31T13:35:30,Galdakao,expenses,healthcare,-149.45,-67480.38
buyer_4,Jorge,Moreno,1974-05-23,32144178E,jorge.moreno@coolnet.site,679449,ES86209540321172255358,5267.8,2024-08-01T19:21:27,Galdakao,incomes,salary,3022.42,-64457.96
buyer_4,Jorge,Moreno,1974-05-23,32144178E,jorge.moreno@coolnet.site,679449,ES86209540321172255358,5267.8,2024-08-01T12:09:37,Galdakao,expenses,leisure,-41.02,-64498.98
buyer_4,Jorge,Moreno,1974-05-23,32144178E,jorge.moreno@coolnet.site,679449,ES86209540321172255358,5267.8,2024-08-02T21:26:45,Galdakao,expenses,education,-64.58,-64563.56
buyer_4,Jorge,Moreno,1974-05-23,32144178E,jorge.moreno@coolnet.site,679449,ES86209540321172255358,5267.8,2024-08-04T14:08:41,Galdakao,expenses,mortgage,-1369.63,-65933.19
buyer_4,Jorge,Moreno,1974-05-23,32144178E,jorge.moreno@coolnet.site,679449,ES86209540321172255358,5267.8,2024-08-04T12:32:15,Galdakao,expenses,education,-73.13,-66006.32
buyer_4,Jorge,Moreno,1974-05-23,32144178E,jorge.moreno@coolnet.site,679449,ES86209540321172255358,5267.8,2024-08-06T08:45:34,Galdakao,expenses,electricity,-87.53,-66093.85
buyer_4,Jorge,Moreno,1974-05-23,32144178E,jorge.moreno@coolnet.site,679449,ES86209540321172255358,5267.8,2024-08-06T10:28:43,Galdakao,expenses,leisure,-82.47,-66176.32
buyer_4,Jorge,Moreno,1974-05-23,32144178E,jorge.moreno@coolnet.site,679449,ES86209540321172255358,5267.8,2024-08-06T12:39:52,Galdakao,expenses,gifts,-471.97,-66648.29
buyer_4,Jorge,Moreno,1974-05-23,32144178E,jorge.moreno@coolnet.site,679449,ES86209540321172255358,5267.8,2024-08-07T08:12:58,Galdakao,expenses,water,-39.23,-66687.52
buyer_4,Jorge,Moreno,1974-05-23,32144178E,jorge.moreno@coolnet.site,679449,ES86209540321172255358,5267.8,2024-08-07T19:49:18,Galdakao,expenses,internet,-63.47,-66750.99
buyer_4,Jorge,Moreno,1974-05-23,32144178E,jorge.moreno@coolnet.site,679449,ES86209540321172255358,5267.8,2024-08-08T14:58:02,Galdakao,expenses,gas,-116.01,-66867.0
buyer_4,Jorge,Moreno,1974-05-23,32144178E,jorge.moreno@coolnet.site,679449,ES86209540321172255358,5267.8,2024-08-08T09:31:58,Galdakao,expenses,phone,-66.72,-66933.72
buyer_4,Jorge,Moreno,1974-05-23,32144178E,jorge.moreno@coolnet.site,679449,ES86209540321172255358,5267.8,2024-08-09T16:21:12,Galdakao,expenses,leisure,-36.94,-66970.66
buyer_4,Jorge,Moreno,1974-05-23,32144178E,jorge.moreno@coolnet.site,679449,ES86209540321172255358,5267.8,2024-08-09T09:48:42,Galdakao,expenses,clothing,-136.84,-67107.5
buyer_4,Jorge,Moreno,1974-05-23,32144178E,jorge.moreno@coolnet.site,679449,ES86209540321172255358,5267.8,2024-08-10T14:38:50,Galdakao,expenses,transport,-54.25,-67161.75
buyer_4,Jorge,Moreno,1974-05-23,32144178E,jorge.moreno@coolnet.site,679449,ES86209540321172255358,5267.8,2024-08-10T15:13:08,Galdakao,expenses,cash,-100.0,-67261.75
buyer_4,Jorge,Moreno,1974-05-23,32144178E,jorge.moreno@coolnet.site,679449,ES86209540321172255358,5267.8,2024-08-10T16:46:10,Galdakao,expenses,gifts,-802.72,-68064.47
buyer_4,Jorge,Moreno,1974-05-23,32144178E,jorge.moreno@coolnet.site,679449,ES86209540321172255358,5267.8,2024-08-11T18:43:34,Galdakao,expenses,clothing,-89.06,-68153.53
buyer_4,Jorge,Moreno,1974-05-23,32144178E,jorge.moreno@coolnet.site,679449,ES86209540321172255358,5267.8,2024-08-12T13:19:59,Galdakao,expenses,transport,-87.34,-68240.87
buyer_4,Jorge,Moreno,1974-05-23,32144178E,jorge.moreno@coolnet.site,679449,ES86209540321172255358,5267.8,2024-08-13T14:02:16,Galdakao,expenses,cash,-100.0,-68340.87
buyer_4,Jorge,Moreno,1974-05-23,32144178E,jorge.moreno@coolnet.site,679449,ES86209540321172255358,5267.8,2024-08-14T16:03:14,Galdakao,expenses,leisure,-71.89,-68412.76
buyer_4,Jorge,Moreno,1974-05-23,32144178E,jorge.moreno@coolnet.site,679449,ES86209540321172255358,5267.8,2024-08-16T21:02:43,Galdakao,expenses,gifts,-724.85,-69137.61
buyer_4,Jorge,Moreno,1974-05-23,32144178E,jorge.moreno@coolnet.site,679449,ES86209540321172255358,5267.8,2024-08-17T06:07:23,Galdakao,expenses,repairs,-223.23,-69360.84
buyer_4,Jorge,Moreno,1974-05-23,32144178E,jorge.moreno@coolnet.site,679449,ES86209540321172255358,5267.8,2024-08-18T09:21:51,Galdakao,expenses,food,-124.67,-69485.51
buyer_4,Jorge,Moreno,1974-05-23,32144178E,jorge.moreno@coolnet.site,679449,ES86209540321172255358,5267.8,2024-08-19T17:09:16,Galdakao,expenses,cash,-100.0,-69585.51
buyer_4,Jorge,Moreno,1974-05-23,32144178E,jorge.moreno@coolnet.site,679449,ES86209540321172255358,5267.8,2024-08-20T19:22:54,Galdakao,expenses,healthcare,-92.2,-69677.71
buyer_4,Jorge,Moreno,1974-05-23,32144178E,jorge.moreno@coolnet.site,679449,ES86209540321172255358,5267.8,2024-08-21T18:37:07,Galdakao,expenses,transport,-84.97,-69762.68
buyer_4,Jorge,Moreno,1974-05-23,32144178E,jorge.moreno@coolnet.site,679449,ES86209540321172255358,5267.8,2024-08-25T08:54:03,Galdakao,expenses,food,-80.67,-69843.35
buyer_4,Jorge,Moreno,1974-05-23,32144178E,jorge.moreno@coolnet.site,679449,ES86209540321172255358,5267.8,2024-08-25T18:01:36,Galdakao,expenses,cash,-100.0,-69943.35
buyer_4,Jorge,Moreno,1974-05-23,32144178E,jorge.moreno@coolnet.site,679449,ES86209540321172255358,5267.8,2024-08-26T20:55:54,Galdakao,expenses,transport,-89.6,-70032.95
buyer_4,Jorge,Moreno,1974-05-23,32144178E,jorge.moreno@coolnet.site,679449,ES86209540321172255358,5267.8,2024-08-27T02:45:54,Galdakao,expenses,education,-59.13,-70092.08
buyer_4,Jorge,Moreno,1974-05-23,32144178E,jorge.moreno@coolnet.site,679449,ES86209540321172255358,5267.8,2024-08-28T09:07:35,Galdakao,expenses,food,-61.88,-70153.96
buyer_4,Jorge,Moreno,1974-05-23,32144178E,jorge.moreno@coolnet.site,679449,ES86209540321172255358,5267.8,2024-08-29T04:35:37,Galdakao,expenses,cash,-100.0,-70253.96
buyer_4,Jorge,Moreno,1974-05-23,32144178E,jorge.moreno@coolnet.site,679449,ES86209540321172255358,5267.8,2024-08-31T15:17:07,Galdakao,expenses,healthcare,-47.41,-70301.37
buyer_4,Jorge,Moreno,1974-05-23,32144178E,jorge.moreno@coolnet.site,679449,ES86209540321172255358,5267.8,2024-09-01T17:42:00,Galdakao,incomes,salary,3022.42,-67278.95
buyer_4,Jorge,Moreno,1974-05-23,32144178E,jorge.moreno@coolnet.site,679449,ES86209540321172255358,5267.8,2024-09-02T09:57:59,Galdakao,expenses,clothing,-140.67,-67419.62
buyer_4,Jorge,Moreno,1974-05-23,32144178E,jorge.moreno@coolnet.site,679449,ES86209540321172255358,5267.8,2024-09-02T16:49:25,Galdakao,expenses,cash,-100.0,-67519.62
buyer_4,Jorge,Moreno,1974-05-23,32144178E,jorge.moreno@coolnet.site,679449,ES86209540321172255358,5267.8,2024-09-03T15:19:32,Galdakao,expenses,cash,-100.0,-67619.62
buyer_4,Jorge,Moreno,1974-05-23,32144178E,jorge.moreno@coolnet.site,679449,ES86209540321172255358,5267.8,2024-09-04T09:31:12,Galdakao,expenses,mortgage,-1369.63,-68989.25
buyer_4,Jorge,Moreno,1974-05-23,32144178E,jorge.moreno@coolnet.site,679449,ES86209540321172255358,5267.8,2024-09-04T16:49:50,Galdakao,expenses,leisure,-79.02,-69068.27
buyer_4,Jorge,Moreno,1974-05-23,32144178E,jorge.moreno@coolnet.site,679449,ES86209540321172255358,5267.8,2024-09-04T11:36:33,Galdakao,expenses,cash,-100.0,-69168.27
buyer_4,Jorge,Moreno,1974-05-23,32144178E,jorge.moreno@coolnet.site,679449,ES86209540321172255358,5267.8,2024-09-05T11:51:22,Galdakao,expenses,water,-37.48,-69205.75
buyer_4,Jorge,Moreno,1974-05-23,32144178E,jorge.moreno@coolnet.site,679449,ES86209540321172255358,5267.8,2024-09-05T10:44:22,Galdakao,expenses,food,-104.31,-69310.06
buyer_4,Jorge,Moreno,1974-05-23,32144178E,jorge.moreno@coolnet.site,679449,ES86209540321172255358,5267.8,2024-09-06T11:28:44,Galdakao,expenses,education,-73.04,-69383.1
buyer_4,Jorge,Moreno,1974-05-23,32144178E,jorge.moreno@coolnet.site,679449,ES86209540321172255358,5267.8,2024-09-07T11:21:28,Galdakao,expenses,phone,-56.66,-69439.76
buyer_4,Jorge,Moreno,1974-05-23,32144178E,jorge.moreno@coolnet.site,679449,ES86209540321172255358,5267.8,2024-09-08T10:47:22,Galdakao,expenses,internet,-63.47,-69503.23
buyer_4,Jorge,Moreno,1974-05-23,32144178E,jorge.moreno@coolnet.site,679449,ES86209540321172255358,5267.8,2024-09-08T12:35:04,Galdakao,expenses,electricity,-60.84,-69564.07
buyer_4,Jorge,Moreno,1974-05-23,32144178E,jorge.moreno@coolnet.site,679449,ES86209540321172255358,5267.8,2024-09-08T18:41:58,Galdakao,expenses,gas,-65.52,-69629.59
buyer_4,Jorge,Moreno,1974-05-23,32144178E,jorge.moreno@coolnet.site,679449,ES86209540321172255358,5267.8,2024-09-08T10:40:37,Galdakao,expenses,leisure,-37.5,-69667.09
buyer_4,Jorge,Moreno,1974-05-23,32144178E,jorge.moreno@coolnet.site,679449,ES86209540321172255358,5267.8,2024-09-08T09:35:35,Galdakao,expenses,cash,-100.0,-69767.09
buyer_4,Jorge,Moreno,1974-05-23,32144178E,jorge.moreno@coolnet.site,679449,ES86209540321172255358,5267.8,2024-09-09T19:45:15,Galdakao,expenses,food,-119.57,-69886.66
buyer_4,Jorge,Moreno,1974-05-23,32144178E,jorge.moreno@coolnet.site,679449,ES86209540321172255358,5267.8,2024-09-09T06:17:26,Galdakao,expenses,appliances,-370.95,-70257.61
buyer_4,Jorge,Moreno,1974-05-23,32144178E,jorge.moreno@coolnet.site,679449,ES86209540321172255358,5267.8,2024-09-10T09:12:21,Galdakao,expenses,education,-75.27,-70332.88
buyer_4,Jorge,Moreno,1974-05-23,32144178E,jorge.moreno@coolnet.site,679449,ES86209540321172255358,5267.8,2024-09-12T14:27:30,Galdakao,expenses,transport,-48.68,-70381.56
buyer_4,Jorge,Moreno,1974-05-23,32144178E,jorge.moreno@coolnet.site,679449,ES86209540321172255358,5267.8,2024-09-14T13:29:19,Galdakao,expenses,gifts,-566.26,-70947.82
buyer_4,Jorge,Moreno,1974-05-23,32144178E,jorge.moreno@coolnet.site,679449,ES86209540321172255358,5267.8,2024-09-15T10:30:06,Galdakao,expenses,food,-96.07,-71043.89
buyer_4,Jorge,Moreno,1974-05-23,32144178E,jorge.moreno@coolnet.site,679449,ES86209540321172255358,5267.8,2024-09-15T19:20:22,Galdakao,expenses,gifts,-97.49,-71141.38
buyer_4,Jorge,Moreno,1974-05-23,32144178E,jorge.moreno@coolnet.site,679449,ES86209540321172255358,5267.8,2024-09-16T16:27:59,Galdakao,expenses,cash,-100.0,-71241.38
buyer_4,Jorge,Moreno,1974-05-23,32144178E,jorge.moreno@coolnet.site,679449,ES86209540321172255358,5267.8,2024-09-16T14:12:21,Galdakao,expenses,appliances,-406.3,-71647.68
buyer_4,Jorge,Moreno,1974-05-23,32144178E,jorge.moreno@coolnet.site,679449,ES86209540321172255358,5267.8,2024-09-16T04:04:24,Galdakao,expenses,gifts,-195.25,-71842.93
buyer_4,Jorge,Moreno,1974-05-23,32144178E,jorge.moreno@coolnet.site,679449,ES86209540321172255358,5267.8,2024-09-17T05:12:12,Galdakao,expenses,leisure,-61.73,-71904.66
buyer_4,Jorge,Moreno,1974-05-23,32144178E,jorge.moreno@coolnet.site,679449,ES86209540321172255358,5267.8,2024-09-19T21:07:31,Galdakao,expenses,food,-80.11,-71984.77
buyer_4,Jorge,Moreno,1974-05-23,32144178E,jorge.moreno@coolnet.site,679449,ES86209540321172255358,5267.8,2024-09-19T16:12:51,Galdakao,expenses,gifts,-244.48,-72229.25
buyer_4,Jorge,Moreno,1974-05-23,32144178E,jorge.moreno@coolnet.site,679449,ES86209540321172255358,5267.8,2024-09-20T12:27:01,Galdakao,expenses,food,-60.7,-72289.95
buyer_4,Jorge,Moreno,1974-05-23,32144178E,jorge.moreno@coolnet.site,679449,ES86209540321172255358,5267.8,2024-09-21T12:35:58,Galdakao,expenses,gifts,-824.96,-73114.91
buyer_4,Jorge,Moreno,1974-05-23,32144178E,jorge.moreno@coolnet.site,679449,ES86209540321172255358,5267.8,2024-09-21T10:18:08,Galdakao,expenses,children,-291.8379166666666,-73406.75
buyer_4,Jorge,Moreno,1974-05-23,32144178E,jorge.moreno@coolnet.site,679449,ES86209540321172255358,5267.8,2024-09-23T21:41:01,Galdakao,expenses,transport,-43.54,-73450.29
buyer_4,Jorge,Moreno,1974-05-23,32144178E,jorge.moreno@coolnet.site,679449,ES86209540321172255358,5267.8,2024-09-23T21:56:38,Galdakao,expenses,leisure,-54.08,-73504.37
buyer_4,Jorge,Moreno,1974-05-23,32144178E,jorge.moreno@coolnet.site,679449,ES86209540321172255358,5267.8,2024-09-24T08:15:21,Galdakao,expenses,cash,-100.0,-73604.37
buyer_4,Jorge,Moreno,1974-05-23,32144178E,jorge.moreno@coolnet.site,679449,ES86209540321172255358,5267.8,2024-09-25T20:59:10,Galdakao,expenses,education,-60.59,-73664.96
buyer_4,Jorge,Moreno,1974-05-23,32144178E,jorge.moreno@coolnet.site,679449,ES86209540321172255358,5267.8,2024-09-26T08:53:37,Galdakao,expenses,cash,-100.0,-73764.96
buyer_4,Jorge,Moreno,1974-05-23,32144178E,jorge.moreno@coolnet.site,679449,ES86209540321172255358,5267.8,2024-10-01T17:44:25,Galdakao,incomes,salary,3022.42,-70742.54
buyer_4,Jorge,Moreno,1974-05-23,32144178E,jorge.moreno@coolnet.site,679449,ES86209540321172255358,5267.8,2024-10-01T17:44:25,Galdakao,incomes,extra_income,338.65,-70403.89
buyer_4,Jorge,Moreno,1974-05-23,32144178E,jorge.moreno@coolnet.site,679449,ES86209540321172255358,5267.8,2024-10-02T13:47:29,Galdakao,expenses,food,-111.95,-70515.84
buyer_4,Jorge,Moreno,1974-05-23,32144178E,jorge.moreno@coolnet.site,679449,ES86209540321172255358,5267.8,2024-10-03T11:50:06,Galdakao,expenses,food,-97.49,-70613.33
buyer_4,Jorge,Moreno,1974-05-23,32144178E,jorge.moreno@coolnet.site,679449,ES86209540321172255358,5267.8,2024-10-03T18:55:10,Galdakao,expenses,healthcare,-96.94,-70710.27
buyer_4,Jorge,Moreno,1974-05-23,32144178E,jorge.moreno@coolnet.site,679449,ES86209540321172255358,5267.8,2024-10-03T10:08:45,Galdakao,expenses,cash,-100.0,-70810.27
buyer_4,Jorge,Moreno,1974-05-23,32144178E,jorge.moreno@coolnet.site,679449,ES86209540321172255358,5267.8,2024-10-04T20:14:26,Galdakao,expenses,mortgage,-1369.63,-72179.9
buyer_4,Jorge,Moreno,1974-05-23,32144178E,jorge.moreno@coolnet.site,679449,ES86209540321172255358,5267.8,2024-10-05T09:23:27,Galdakao,expenses,electricity,-100.31,-72280.21
buyer_4,Jorge,Moreno,1974-05-23,32144178E,jorge.moreno@coolnet.site,679449,ES86209540321172255358,5267.8,2024-10-05T10:18:10,Galdakao,expenses,internet,-63.47,-72343.68
buyer_4,Jorge,Moreno,1974-05-23,32144178E,jorge.moreno@coolnet.site,679449,ES86209540321172255358,5267.8,2024-10-05T09:09:46,Galdakao,expenses,phone,-55.53,-72399.21
buyer_4,Jorge,Moreno,1974-05-23,32144178E,jorge.moreno@coolnet.site,679449,ES86209540321172255358,5267.8,2024-10-06T17:51:41,Galdakao,expenses,leisure,-84.66,-72483.87
buyer_4,Jorge,Moreno,1974-05-23,32144178E,jorge.moreno@coolnet.site,679449,ES86209540321172255358,5267.8,2024-10-07T09:28:39,Galdakao,expenses,water,-55.32,-72539.19
buyer_4,Jorge,Moreno,1974-05-23,32144178E,jorge.moreno@coolnet.site,679449,ES86209540321172255358,5267.8,2024-10-07T18:16:47,Galdakao,expenses,gifts,-141.26,-72680.45
buyer_4,Jorge,Moreno,1974-05-23,32144178E,jorge.moreno@coolnet.site,679449,ES86209540321172255358,5267.8,2024-10-08T19:19:34,Galdakao,expenses,gas,-162.87,-72843.32
buyer_4,Jorge,Moreno,1974-05-23,32144178E,jorge.moreno@coolnet.site,679449,ES86209540321172255358,5267.8,2024-10-08T21:10:38,Galdakao,expenses,transport,-69.96,-72913.28
buyer_4,Jorge,Moreno,1974-05-23,32144178E,jorge.moreno@coolnet.site,679449,ES86209540321172255358,5267.8,2024-10-08T15:25:20,Galdakao,expenses,cash,-100.0,-73013.28
buyer_4,Jorge,Moreno,1974-05-23,32144178E,jorge.moreno@coolnet.site,679449,ES86209540321172255358,5267.8,2024-10-09T14:16:54,Galdakao,expenses,transport,-69.63,-73082.91
buyer_4,Jorge,Moreno,1974-05-23,32144178E,jorge.moreno@coolnet.site,679449,ES86209540321172255358,5267.8,2024-10-09T12:16:03,Galdakao,expenses,gifts,-180.36,-73263.27
buyer_4,Jorge,Moreno,1974-05-23,32144178E,jorge.moreno@coolnet.site,679449,ES86209540321172255358,5267.8,2024-10-10T12:45:53,Galdakao,expenses,food,-67.14,-73330.41
buyer_5,Sara,Gurrutxaga,1994-03-12,01695532H,sara.gurrutxaga@smartapp.app,126346,ES11209547113786786463,1216.37,2022-01-01T05:15:20,Donostia,incomes,salary,2874.8,4091.17
buyer_5,Sara,Gurrutxaga,1994-03-12,01695532H,sara.gurrutxaga@smartapp.app,126346,ES11209547113786786463,1216.37,2022-01-01T05:15:20,Donostia,incomes,salary_partner,3005.77,7096.94
buyer_5,Sara,Gurrutxaga,1994-03-12,01695532H,sara.gurrutxaga@smartapp.app,126346,ES11209547113786786463,1216.37,2022-01-01T13:37:04,Donostia,expenses,food,-60.71,7036.23
buyer_5,Sara,Gurrutxaga,1994-03-12,01695532H,sara.gurrutxaga@smartapp.app,126346,ES11209547113786786463,1216.37,2022-01-01T18:06:39,Donostia,expenses,cash,-100.0,6936.23
buyer_5,Sara,Gurrutxaga,1994-03-12,01695532H,sara.gurrutxaga@smartapp.app,126346,ES11209547113786786463,1216.37,2022-01-03T19:01:27,Donostia,expenses,clothing,-49.52,6886.71
buyer_5,Sara,Gurrutxaga,1994-03-12,01695532H,sara.gurrutxaga@smartapp.app,126346,ES11209547113786786463,1216.37,2022-01-04T09:02:48,Donostia,expenses,mortgage,-2550.4,4336.31
buyer_5,Sara,Gurrutxaga,1994-03-12,01695532H,sara.gurrutxaga@smartapp.app,126346,ES11209547113786786463,1216.37,2022-01-04T18:15:19,Donostia,expenses,transport,-65.53,4270.78
buyer_5,Sara,Gurrutxaga,1994-03-12,01695532H,sara.gurrutxaga@smartapp.app,126346,ES11209547113786786463,1216.37,2022-01-04T08:35:36,Donostia,expenses,leisure,-83.92,4186.86
buyer_5,Sara,Gurrutxaga,1994-03-12,01695532H,sara.gurrutxaga@smartapp.app,126346,ES11209547113786786463,1216.37,2022-01-04T12:33:15,Donostia,expenses,clothing,-116.07,4070.79
buyer_5,Sara,Gurrutxaga,1994-03-12,01695532H,sara.gurrutxaga@smartapp.app,126346,ES11209547113786786463,1216.37,2022-01-06T23:37:30,Donostia,expenses,electricity,-130.08,3940.71
buyer_5,Sara,Gurrutxaga,1994-03-12,01695532H,sara.gurrutxaga@smartapp.app,126346,ES11209547113786786463,1216.37,2022-01-06T13:55:47,Donostia,expenses,internet,-123.49,3817.22
buyer_5,Sara,Gurrutxaga,1994-03-12,01695532H,sara.gurrutxaga@smartapp.app,126346,ES11209547113786786463,1216.37,2022-01-08T19:22:09,Donostia,expenses,gas,-176.97,3640.25
buyer_5,Sara,Gurrutxaga,1994-03-12,01695532H,sara.gurrutxaga@smartapp.app,126346,ES11209547113786786463,1216.37,2022-01-08T11:45:14,Donostia,expenses,water,-103.26,3536.99
buyer_5,Sara,Gurrutxaga,1994-03-12,01695532H,sara.gurrutxaga@smartapp.app,126346,ES11209547113786786463,1216.37,2022-01-08T18:55:10,Donostia,expenses,phone,-94.06,3442.93
buyer_5,Sara,Gurrutxaga,1994-03-12,01695532H,sara.gurrutxaga@smartapp.app,126346,ES11209547113786786463,1216.37,2022-01-08T15:33:45,Donostia,expenses,education,-58.82,3384.11
buyer_5,Sara,Gurrutxaga,1994-03-12,01695532H,sara.gurrutxaga@smartapp.app,126346,ES11209547113786786463,1216.37,2022-01-09T10:38:35,Donostia,expenses,transport,-79.86,3304.25
buyer_5,Sara,Gurrutxaga,1994-03-12,01695532H,sara.gurrutxaga@smartapp.app,126346,ES11209547113786786463,1216.37,2022-01-10T13:53:57,Donostia,expenses,appliances,-264.25,3040.0
buyer_5,Sara,Gurrutxaga,1994-03-12,01695532H,sara.gurrutxaga@smartapp.app,126346,ES11209547113786786463,1216.37,2022-01-10T23:18:13,Donostia,expenses,repairs,-178.11,2861.89
buyer_5,Sara,Gurrutxaga,1994-03-12,01695532H,sara.gurrutxaga@smartapp.app,126346,ES11209547113786786463,1216.37,2022-01-11T12:30:02,Donostia,expenses,food,-91.66,2770.23
buyer_5,Sara,Gurrutxaga,1994-03-12,01695532H,sara.gurrutxaga@smartapp.app,126346,ES11209547113786786463,1216.37,2022-01-11T09:37:23,Donostia,expenses,clothing,-55.25,2714.98
buyer_5,Sara,Gurrutxaga,1994-03-12,01695532H,sara.gurrutxaga@smartapp.app,126346,ES11209547113786786463,1216.37,2022-01-12T04:31:25,Donostia,expenses,food,-83.61,2631.37
buyer_5,Sara,Gurrutxaga,1994-03-12,01695532H,sara.gurrutxaga@smartapp.app,126346,ES11209547113786786463,1216.37,2022-01-12T11:18:51,Donostia,expenses,leisure,-76.41,2554.96
buyer_5,Sara,Gurrutxaga,1994-03-12,01695532H,sara.gurrutxaga@smartapp.app,126346,ES11209547113786786463,1216.37,2022-01-13T20:01:25,Donostia,expenses,cash,-100.0,2454.96
buyer_5,Sara,Gurrutxaga,1994-03-12,01695532H,sara.gurrutxaga@smartapp.app,126346,ES11209547113786786463,1216.37,2022-01-15T13:16:10,Donostia,expenses,travel,-809.46,1645.5
buyer_5,Sara,Gurrutxaga,1994-03-12,01695532H,sara.gurrutxaga@smartapp.app,126346,ES11209547113786786463,1216.37,2022-01-15T08:27:18,Donostia,expenses,gifts,-114.45,1531.05
buyer_5,Sara,Gurrutxaga,1994-03-12,01695532H,sara.gurrutxaga@smartapp.app,126346,ES11209547113786786463,1216.37,2022-01-17T09:45:07,Donostia,expenses,transport,-50.71,1480.34
buyer_5,Sara,Gurrutxaga,1994-03-12,01695532H,sara.gurrutxaga@smartapp.app,126346,ES11209547113786786463,1216.37,2022-01-18T16:19:50,Donostia,expenses,gifts,-623.85,856.49
buyer_5,Sara,Gurrutxaga,1994-03-12,01695532H,sara.gurrutxaga@smartapp.app,126346,ES11209547113786786463,1216.37,2022-01-19T10:01:06,Donostia,expenses,transport,-60.98,795.51
buyer_5,Sara,Gurrutxaga,1994-03-12,01695532H,sara.gurrutxaga@smartapp.app,126346,ES11209547113786786463,1216.37,2022-01-19T14:33:30,Donostia,expenses,healthcare,-54.57,740.94
buyer_5,Sara,Gurrutxaga,1994-03-12,01695532H,sara.gurrutxaga@smartapp.app,126346,ES11209547113786786463,1216.37,2022-01-20T13:34:41,Donostia,expenses,food,-74.3,666.64
buyer_5,Sara,Gurrutxaga,1994-03-12,01695532H,sara.gurrutxaga@smartapp.app,126346,ES11209547113786786463,1216.37,2022-01-22T11:08:11,Donostia,expenses,education,-50.07,616.57
buyer_5,Sara,Gurrutxaga,1994-03-12,01695532H,sara.gurrutxaga@smartapp.app,126346,ES11209547113786786463,1216.37,2022-01-23T11:57:48,Donostia,expenses,leisure,-80.36,536.21
buyer_5,Sara,Gurrutxaga,1994-03-12,01695532H,sara.gurrutxaga@smartapp.app,126346,ES11209547113786786463,1216.37,2022-01-26T18:19:23,Donostia,expenses,clothing,-124.95,411.26
buyer_5,Sara,Gurrutxaga,1994-03-12,01695532H,sara.gurrutxaga@smartapp.app,126346,ES11209547113786786463,1216.37,2022-01-26T18:22:48,Donostia,expenses,education,-51.1,360.16
buyer_5,Sara,Gurrutxaga,1994-03-12,01695532H,sara.gurrutxaga@smartapp.app,126346,ES11209547113786786463,1216.37,2022-01-26T18:27:22,Donostia,expenses,cash,-100.0,260.16
buyer_5,Sara,Gurrutxaga,1994-03-12,01695532H,sara.gurrutxaga@smartapp.app,126346,ES11209547113786786463,1216.37,2022-01-27T18:31:37,Donostia,expenses,transport,-47.04,213.12
buyer_5,Sara,Gurrutxaga,1994-03-12,01695532H,sara.gurrutxaga@smartapp.app,126346,ES11209547113786786463,1216.37,2022-01-29T13:48:02,Donostia,expenses,education,-55.79,157.33
buyer_5,Sara,Gurrutxaga,1994-03-12,01695532H,sara.gurrutxaga@smartapp.app,126346,ES11209547113786786463,1216.37,2022-01-30T15:16:42,Donostia,expenses,food,-108.62,48.71
buyer_5,Sara,Gurrutxaga,1994-03-12,01695532H,sara.gurrutxaga@smartapp.app,126346,ES11209547113786786463,1216.37,2022-01-31T16:48:51,Donostia,expenses,food,-61.85,-13.14
buyer_5,Sara,Gurrutxaga,1994-03-12,01695532H,sara.gurrutxaga@smartapp.app,126346,ES11209547113786786463,1216.37,2022-02-01T15:44:40,Donostia,incomes,salary,2874.8,2861.66
buyer_5,Sara,Gurrutxaga,1994-03-12,01695532H,sara.gurrutxaga@smartapp.app,126346,ES11209547113786786463,1216.37,2022-02-01T15:44:40,Donostia,incomes,salary_partner,3005.77,5867.43
buyer_5,Sara,Gurrutxaga,1994-03-12,01695532H,sara.gurrutxaga@smartapp.app,126346,ES11209547113786786463,1216.37,2022-02-02T18:58:36,Donostia,expenses,clothing,-81.11,5786.32
buyer_5,Sara,Gurrutxaga,1994-03-12,01695532H,sara.gurrutxaga@smartapp.app,126346,ES11209547113786786463,1216.37,2022-02-03T09:21:20,Donostia,expenses,healthcare,-47.2,5739.12
buyer_5,Sara,Gurrutxaga,1994-03-12,01695532H,sara.gurrutxaga@smartapp.app,126346,ES11209547113786786463,1216.37,2022-02-03T04:50:34,Donostia,expenses,cash,-100.0,5639.12
buyer_5,Sara,Gurrutxaga,1994-03-12,01695532H,sara.gurrutxaga@smartapp.app,126346,ES11209547113786786463,1216.37,2022-02-04T20:01:41,Donostia,expenses,mortgage,-2550.4,3088.72
buyer_5,Sara,Gurrutxaga,1994-03-12,01695532H,sara.gurrutxaga@smartapp.app,126346,ES11209547113786786463,1216.37,2022-02-04T02:42:37,Donostia,expenses,transport,-85.51,3003.21
buyer_5,Sara,Gurrutxaga,1994-03-12,01695532H,sara.gurrutxaga@smartapp.app,126346,ES11209547113786786463,1216.37,2022-02-05T15:46:50,Donostia,expenses,gas,-253.99,2749.22
buyer_5,Sara,Gurrutxaga,1994-03-12,01695532H,sara.gurrutxaga@smartapp.app,126346,ES11209547113786786463,1216.37,2022-02-06T23:51:47,Donostia,expenses,internet,-123.49,2625.73
buyer_5,Sara,Gurrutxaga,1994-03-12,01695532H,sara.gurrutxaga@smartapp.app,126346,ES11209547113786786463,1216.37,2022-02-06T23:17:29,Donostia,expenses,phone,-95.19,2530.54
buyer_5,Sara,Gurrutxaga,1994-03-12,01695532H,sara.gurrutxaga@smartapp.app,126346,ES11209547113786786463,1216.37,2022-02-07T13:06:21,Donostia,expenses,cash,-100.0,2430.54
buyer_5,Sara,Gurrutxaga,1994-03-12,01695532H,sara.gurrutxaga@smartapp.app,126346,ES11209547113786786463,1216.37,2022-02-08T09:03:18,Donostia,expenses,electricity,-114.46,2316.08
buyer_5,Sara,Gurrutxaga,1994-03-12,01695532H,sara.gurrutxaga@smartapp.app,126346,ES11209547113786786463,1216.37,2022-02-08T10:27:16,Donostia,expenses,water,-80.87,2235.21
buyer_5,Sara,Gurrutxaga,1994-03-12,01695532H,sara.gurrutxaga@smartapp.app,126346,ES11209547113786786463,1216.37,2022-02-10T23:50:02,Donostia,expenses,appliances,-180.38,2054.83
buyer_5,Sara,Gurrutxaga,1994-03-12,01695532H,sara.gurrutxaga@smartapp.app,126346,ES11209547113786786463,1216.37,2022-02-11T05:32:39,Donostia,expenses,transport,-68.03,1986.8
buyer_5,Sara,Gurrutxaga,1994-03-12,01695532H,sara.gurrutxaga@smartapp.app,126346,ES11209547113786786463,1216.37,2022-02-11T15:01:50,Donostia,expenses,repairs,-237.8,1749.0
buyer_5,Sara,Gurrutxaga,1994-03-12,01695532H,sara.gurrutxaga@smartapp.app,126346,ES11209547113786786463,1216.37,2022-02-12T01:25:14,Donostia,expenses,transport,-69.77,1679.23
buyer_5,Sara,Gurrutxaga,1994-03-12,01695532H,sara.gurrutxaga@smartapp.app,126346,ES11209547113786786463,1216.37,2022-02-12T10:46:37,Donostia,expenses,cash,-100.0,1579.23
buyer_5,Sara,Gurrutxaga,1994-03-12,01695532H,sara.gurrutxaga@smartapp.app,126346,ES11209547113786786463,1216.37,2022-02-14T19:41:16,Donostia,expenses,cash,-100.0,1479.23
buyer_5,Sara,Gurrutxaga,1994-03-12,01695532H,sara.gurrutxaga@smartapp.app,126346,ES11209547113786786463,1216.37,2022-02-16T05:23:57,Donostia,expenses,education,-73.03,1406.2
buyer_5,Sara,Gurrutxaga,1994-03-12,01695532H,sara.gurrutxaga@smartapp.app,126346,ES11209547113786786463,1216.37,2022-02-17T17:42:47,Donostia,expenses,cash,-100.0,1306.2
buyer_5,Sara,Gurrutxaga,1994-03-12,01695532H,sara.gurrutxaga@smartapp.app,126346,ES11209547113786786463,1216.37,2022-02-20T18:27:21,Donostia,expenses,leisure,-38.84,1267.36
buyer_5,Sara,Gurrutxaga,1994-03-12,01695532H,sara.gurrutxaga@smartapp.app,126346,ES11209547113786786463,1216.37,2022-02-21T15:00:32,Donostia,expenses,food,-96.77,1170.59
buyer_5,Sara,Gurrutxaga,1994-03-12,01695532H,sara.gurrutxaga@smartapp.app,126346,ES11209547113786786463,1216.37,2022-02-21T15:24:06,Donostia,expenses,transport,-45.23,1125.36
buyer_5,Sara,Gurrutxaga,1994-03-12,01695532H,sara.gurrutxaga@smartapp.app,126346,ES11209547113786786463,1216.37,2022-02-23T16:01:49,Donostia,expenses,transport,-72.89,1052.47
buyer_5,Sara,Gurrutxaga,1994-03-12,01695532H,sara.gurrutxaga@smartapp.app,126346,ES11209547113786786463,1216.37,2022-02-24T12:06:17,Donostia,expenses,leisure,-68.58,983.89
buyer_5,Sara,Gurrutxaga,1994-03-12,01695532H,sara.gurrutxaga@smartapp.app,126346,ES11209547113786786463,1216.37,2022-02-24T13:34:03,Donostia,expenses,repairs,-226.9,756.99
buyer_5,Sara,Gurrutxaga,1994-03-12,01695532H,sara.gurrutxaga@smartapp.app,126346,ES11209547113786786463,1216.37,2022-02-26T17:50:12,Donostia,expenses,education,-57.27,699.72
buyer_5,Sara,Gurrutxaga,1994-03-12,01695532H,sara.gurrutxaga@smartapp.app,126346,ES11209547113786786463,1216.37,2022-02-27T11:03:52,Donostia,expenses,food,-81.38,618.34
buyer_5,Sara,Gurrutxaga,1994-03-12,01695532H,sara.gurrutxaga@smartapp.app,126346,ES11209547113786786463,1216.37,2022-02-28T12:20:11,Donostia,expenses,food,-116.01,502.33
buyer_5,Sara,Gurrutxaga,1994-03-12,01695532H,sara.gurrutxaga@smartapp.app,126346,ES11209547113786786463,1216.37,2022-02-28T14:40:11,Donostia,expenses,gifts,-62.22,440.11
buyer_5,Sara,Gurrutxaga,1994-03-12,01695532H,sara.gurrutxaga@smartapp.app,126346,ES11209547113786786463,1216.37,2022-03-01T12:44:51,Donostia,incomes,salary,2874.8,3314.91
buyer_5,Sara,Gurrutxaga,1994-03-12,01695532H,sara.gurrutxaga@smartapp.app,126346,ES11209547113786786463,1216.37,2022-03-01T12:44:51,Donostia,incomes,salary_partner,3005.77,6320.68
buyer_5,Sara,Gurrutxaga,1994-03-12,01695532H,sara.gurrutxaga@smartapp.app,126346,ES11209547113786786463,1216.37,2022-03-01T12:44:51,Donostia,incomes,extra_income,437.28,6757.96
buyer_5,Sara,Gurrutxaga,1994-03-12,01695532H,sara.gurrutxaga@smartapp.app,126346,ES11209547113786786463,1216.37,2022-03-01T14:52:24,Donostia,expenses,cash,-100.0,6657.96
buyer_5,Sara,Gurrutxaga,1994-03-12,01695532H,sara.gurrutxaga@smartapp.app,126346,ES11209547113786786463,1216.37,2022-03-04T14:40:55,Donostia,expenses,mortgage,-2550.4,4107.56
buyer_5,Sara,Gurrutxaga,1994-03-12,01695532H,sara.gurrutxaga@smartapp.app,126346,ES11209547113786786463,1216.37,2022-03-05T19:36:20,Donostia,expenses,water,-63.91,4043.65
buyer_5,Sara,Gurrutxaga,1994-03-12,01695532H,sara.gurrutxaga@smartapp.app,126346,ES11209547113786786463,1216.37,2022-03-06T13:30:03,Donostia,expenses,transport,-62.06,3981.59
buyer_5,Sara,Gurrutxaga,1994-03-12,01695532H,sara.gurrutxaga@smartapp.app,126346,ES11209547113786786463,1216.37,2022-03-07T16:55:53,Donostia,expenses,leisure,-82.1,3899.49
buyer_5,Sara,Gurrutxaga,1994-03-12,01695532H,sara.gurrutxaga@smartapp.app,126346,ES11209547113786786463,1216.37,2022-03-08T04:51:28,Donostia,expenses,gas,-97.32,3802.17
buyer_5,Sara,Gurrutxaga,1994-03-12,01695532H,sara.gurrutxaga@smartapp.app,126346,ES11209547113786786463,1216.37,2022-03-08T08:29:05,Donostia,expenses,electricity,-238.97,3563.2
buyer_5,Sara,Gurrutxaga,1994-03-12,01695532H,sara.gurrutxaga@smartapp.app,126346,ES11209547113786786463,1216.37,2022-03-08T13:03:31,Donostia,expenses,internet,-123.49,3439.71
buyer_5,Sara,Gurrutxaga,1994-03-12,01695532H,sara.gurrutxaga@smartapp.app,126346,ES11209547113786786463,1216.37,2022-03-08T16:49:24,Donostia,expenses,phone,-112.73,3326.98
buyer_5,Sara,Gurrutxaga,1994-03-12,01695532H,sara.gurrutxaga@smartapp.app,126346,ES11209547113786786463,1216.37,2022-03-08T20:45:31,Donostia,expenses,food,-74.53,3252.45
buyer_5,Sara,Gurrutxaga,1994-03-12,01695532H,sara.gurrutxaga@smartapp.app,126346,ES11209547113786786463,1216.37,2022-03-08T19:44:06,Donostia,expenses,cash,-100.0,3152.45
buyer_5,Sara,Gurrutxaga,1994-03-12,01695532H,sara.gurrutxaga@smartapp.app,126346,ES11209547113786786463,1216.37,2022-03-10T18:38:47,Donostia,expenses,repairs,-138.63,3013.82
buyer_5,Sara,Gurrutxaga,1994-03-12,01695532H,sara.gurrutxaga@smartapp.app,126346,ES11209547113786786463,1216.37,2022-03-11T22:55:11,Donostia,expenses,food,-112.73,2901.09
buyer_5,Sara,Gurrutxaga,1994-03-12,01695532H,sara.gurrutxaga@smartapp.app,126346,ES11209547113786786463,1216.37,2022-03-12T12:00:57,Donostia,expenses,transport,-47.4,2853.69
buyer_5,Sara,Gurrutxaga,1994-03-12,01695532H,sara.gurrutxaga@smartapp.app,126346,ES11209547113786786463,1216.37,2022-03-14T03:43:04,Donostia,expenses,leisure,-25.22,2828.47
buyer_5,Sara,Gurrutxaga,1994-03-12,01695532H,sara.gurrutxaga@smartapp.app,126346,ES11209547113786786463,1216.37,2022-03-14T10:31:11,Donostia,expenses,cash,-100.0,2728.47
buyer_5,Sara,Gurrutxaga,1994-03-12,01695532H,sara.gurrutxaga@smartapp.app,126346,ES11209547113786786463,1216.37,2022-03-16T08:47:35,Donostia,expenses,leisure,-72.42,2656.05
buyer_5,Sara,Gurrutxaga,1994-03-12,01695532H,sara.gurrutxaga@smartapp.app,126346,ES11209547113786786463,1216.37,2022-03-16T08:06:03,Donostia,expenses,gifts,-289.85,2366.2
buyer_5,Sara,Gurrutxaga,1994-03-12,01695532H,sara.gurrutxaga@smartapp.app,126346,ES11209547113786786463,1216.37,2022-03-17T08:55:37,Donostia,expenses,cash,-100.0,2266.2
buyer_5,Sara,Gurrutxaga,1994-03-12,01695532H,sara.gurrutxaga@smartapp.app,126346,ES11209547113786786463,1216.37,2022-03-17T20:09:42,Donostia,expenses,appliances,-301.75,1964.45
buyer_5,Sara,Gurrutxaga,1994-03-12,01695532H,sara.gurrutxaga@smartapp.app,126346,ES11209547113786786463,1216.37,2022-03-18T14:32:38,Donostia,expenses,healthcare,-56.68,1907.77
buyer_5,Sara,Gurrutxaga,1994-03-12,01695532H,sara.gurrutxaga@smartapp.app,126346,ES11209547113786786463,1216.37,2022-03-20T14:45:05,Donostia,expenses,transport,-64.13,1843.64
buyer_5,Sara,Gurrutxaga,1994-03-12,01695532H,sara.gurrutxaga@smartapp.app,126346,ES11209547113786786463,1216.37,2022-03-20T00:13:13,Donostia,expenses,cash,-100.0,1743.64
buyer_5,Sara,Gurrutxaga,1994-03-12,01695532H,sara.gurrutxaga@smartapp.app,126346,ES11209547113786786463,1216.37,2022-03-23T22:23:39,Donostia,expenses,cash,-100.0,1643.64
buyer_5,Sara,Gurrutxaga,1994-03-12,01695532H,sara.gurrutxaga@smartapp.app,126346,ES11209547113786786463,1216.37,2022-03-25T18:58:35,Donostia,expenses,healthcare,-64.09,1579.55
buyer_5,Sara,Gurrutxaga,1994-03-12,01695532H,sara.gurrutxaga@smartapp.app,126346,ES11209547113786786463,1216.37,2022-03-27T12:25:28,Donostia,expenses,leisure,-37.93,1541.62
buyer_5,Sara,Gurrutxaga,1994-03-12,01695532H,sara.gurrutxaga@smartapp.app,126346,ES11209547113786786463,1216.37,2022-03-29T14:42:53,Donostia,expenses,cash,-100.0,1441.62
buyer_5,Sara,Gurrutxaga,1994-03-12,01695532H,sara.gurrutxaga@smartapp.app,126346,ES11209547113786786463,1216.37,2022-04-01T14:36:41,Donostia,incomes,salary,2874.8,4316.42
buyer_5,Sara,Gurrutxaga,1994-03-12,01695532H,sara.gurrutxaga@smartapp.app,126346,ES11209547113786786463,1216.37,2022-04-01T14:36:41,Donostia,incomes,salary_partner,3005.77,7322.19
buyer_5,Sara,Gurrutxaga,1994-03-12,01695532H,sara.gurrutxaga@smartapp.app,126346,ES11209547113786786463,1216.37,2022-04-02T20:05:05,Donostia,expenses,repairs,-235.87,7086.32
buyer_5,Sara,Gurrutxaga,1994-03-12,01695532H,sara.gurrutxaga@smartapp.app,126346,ES11209547113786786463,1216.37,2022-04-04T20:39:48,Donostia,expenses,mortgage,-2550.4,4535.92
buyer_5,Sara,Gurrutxaga,1994-03-12,01695532H,sara.gurrutxaga@smartapp.app,126346,ES11209547113786786463,1216.37,2022-04-05T20:12:56,Donostia,expenses,water,-104.87,4431.05
buyer_5,Sara,Gurrutxaga,1994-03-12,01695532H,sara.gurrutxaga@smartapp.app,126346,ES11209547113786786463,1216.37,2022-04-05T20:29:57,Donostia,expenses,electricity,-173.5,4257.55
buyer_5,Sara,Gurrutxaga,1994-03-12,01695532H,sara.gurrutxaga@smartapp.app,126346,ES11209547113786786463,1216.37,2022-04-05T14:38:01,Donostia,expenses,internet,-123.49,4134.06
buyer_5,Sara,Gurrutxaga,1994-03-12,01695532H,sara.gurrutxaga@smartapp.app,126346,ES11209547113786786463,1216.37,2022-04-05T15:52:37,Donostia,expenses,food,-119.1,4014.96
buyer_5,Sara,Gurrutxaga,1994-03-12,01695532H,sara.gurrutxaga@smartapp.app,126346,ES11209547113786786463,1216.37,2022-04-05T12:05:36,Donostia,expenses,clothing,-129.46,3885.5
buyer_5,Sara,Gurrutxaga,1994-03-12,01695532H,sara.gurrutxaga@smartapp.app,126346,ES11209547113786786463,1216.37,2022-04-06T09:48:25,Donostia,expenses,transport,-76.75,3808.75
buyer_5,Sara,Gurrutxaga,1994-03-12,01695532H,sara.gurrutxaga@smartapp.app,126346,ES11209547113786786463,1216.37,2022-04-06T18:50:46,Donostia,expenses,repairs,-82.27,3726.48
buyer_5,Sara,Gurrutxaga,1994-03-12,01695532H,sara.gurrutxaga@smartapp.app,126346,ES11209547113786786463,1216.37,2022-04-07T12:55:48,Donostia,expenses,gas,-260.07,3466.41
buyer_5,Sara,Gurrutxaga,1994-03-12,01695532H,sara.gurrutxaga@smartapp.app,126346,ES11209547113786786463,1216.37,2022-04-08T10:25:30,Donostia,expenses,phone,-111.05,3355.36
buyer_5,Sara,Gurrutxaga,1994-03-12,01695532H,sara.gurrutxaga@smartapp.app,126346,ES11209547113786786463,1216.37,2022-04-08T15:12:28,Donostia,expenses,cash,-100.0,3255.36
buyer_5,Sara,Gurrutxaga,1994-03-12,01695532H,sara.gurrutxaga@smartapp.app,126346,ES11209547113786786463,1216.37,2022-04-09T11:20:40,Donostia,expenses,leisure,-63.28,3192.08
buyer_5,Sara,Gurrutxaga,1994-03-12,01695532H,sara.gurrutxaga@smartapp.app,126346,ES11209547113786786463,1216.37,2022-04-10T14:47:29,Donostia,expenses,transport,-74.34,3117.74
buyer_5,Sara,Gurrutxaga,1994-03-12,01695532H,sara.gurrutxaga@smartapp.app,126346,ES11209547113786786463,1216.37,2022-04-10T11:18:47,Donostia,expenses,cash,-100.0,3017.74
buyer_5,Sara,Gurrutxaga,1994-03-12,01695532H,sara.gurrutxaga@smartapp.app,126346,ES11209547113786786463,1216.37,2022-04-13T13:46:30,Donostia,expenses,leisure,-46.99,2970.75
buyer_5,Sara,Gurrutxaga,1994-03-12,01695532H,sara.gurrutxaga@smartapp.app,126346,ES11209547113786786463,1216.37,2022-04-17T22:21:12,Donostia,expenses,clothing,-115.95,2854.8
buyer_5,Sara,Gurrutxaga,1994-03-12,01695532H,sara.gurrutxaga@smartapp.app,126346,ES11209547113786786463,1216.37,2022-04-18T20:29:36,Donostia,expenses,cash,-100.0,2754.8
buyer_5,Sara,Gurrutxaga,1994-03-12,01695532H,sara.gurrutxaga@smartapp.app,126346,ES11209547113786786463,1216.37,2022-04-19T11:52:07,Donostia,expenses,leisure,-39.2,2715.6
buyer_5,Sara,Gurrutxaga,1994-03-12,01695532H,sara.gurrutxaga@smartapp.app,126346,ES11209547113786786463,1216.37,2022-04-20T20:48:20,Donostia,expenses,repairs,-241.03,2474.57
buyer_5,Sara,Gurrutxaga,1994-03-12,01695532H,sara.gurrutxaga@smartapp.app,126346,ES11209547113786786463,1216.37,2022-04-25T10:39:44,Donostia,expenses,cash,-100.0,2374.57
buyer_5,Sara,Gurrutxaga,1994-03-12,01695532H,sara.gurrutxaga@smartapp.app,126346,ES11209547113786786463,1216.37,2022-04-25T16:24:30,Donostia,expenses,repairs,-102.48,2272.09
buyer_5,Sara,Gurrutxaga,1994-03-12,01695532H,sara.gurrutxaga@smartapp.app,126346,ES11209547113786786463,1216.37,2022-04-27T08:22:06,Donostia,expenses,food,-108.02,2164.07
buyer_5,Sara,Gurrutxaga,1994-03-12,01695532H,sara.gurrutxaga@smartapp.app,126346,ES11209547113786786463,1216.37,2022-04-29T13:08:42,Donostia,expenses,transport,-44.27,2119.8
buyer_5,Sara,Gurrutxaga,1994-03-12,01695532H,sara.gurrutxaga@smartapp.app,126346,ES11209547113786786463,1216.37,2022-04-29T14:25:35,Donostia,expenses,healthcare,-82.34,2037.46
buyer_5,Sara,Gurrutxaga,1994-03-12,01695532H,sara.gurrutxaga@smartapp.app,126346,ES11209547113786786463,1216.37,2022-04-29T19:41:04,Donostia,expenses,gifts,-843.19,1194.27
buyer_5,Sara,Gurrutxaga,1994-03-12,01695532H,sara.gurrutxaga@smartapp.app,126346,ES11209547113786786463,1216.37,2022-04-30T20:09:54,Donostia,expenses,leisure,-67.58,1126.69
buyer_5,Sara,Gurrutxaga,1994-03-12,01695532H,sara.gurrutxaga@smartapp.app,126346,ES11209547113786786463,1216.37,2022-05-01T15:04:37,Donostia,incomes,salary,2874.8,4001.49
buyer_5,Sara,Gurrutxaga,1994-03-12,01695532H,sara.gurrutxaga@smartapp.app,126346,ES11209547113786786463,1216.37,2022-05-01T15:04:37,Donostia,incomes,salary_partner,3005.77,7007.26
buyer_5,Sara,Gurrutxaga,1994-03-12,01695532H,sara.gurrutxaga@smartapp.app,126346,ES11209547113786786463,1216.37,2022-05-01T11:11:12,Donostia,expenses,leisure,-58.57,6948.69
buyer_5,Sara,Gurrutxaga,1994-03-12,01695532H,sara.gurrutxaga@smartapp.app,126346,ES11209547113786786463,1216.37,2022-05-02T10:47:53,Donostia,expenses,gifts,-590.22,6358.47
buyer_5,Sara,Gurrutxaga,1994-03-12,01695532H,sara.gurrutxaga@smartapp.app,126346,ES11209547113786786463,1216.37,2022-05-04T15:24:13,Donostia,expenses,mortgage,-2550.4,3808.07
buyer_5,Sara,Gurrutxaga,1994-03-12,01695532H,sara.gurrutxaga@smartapp.app,126346,ES11209547113786786463,1216.37,2022-05-04T18:51:48,Donostia,expenses,food,-89.01,3719.06
buyer_5,Sara,Gurrutxaga,1994-03-12,01695532H,sara.gurrutxaga@smartapp.app,126346,ES11209547113786786463,1216.37,2022-05-04T21:49:17,Donostia,expenses,cash,-100.0,3619.06
buyer_5,Sara,Gurrutxaga,1994-03-12,01695532H,sara.gurrutxaga@smartapp.app,126346,ES11209547113786786463,1216.37,2022-05-05T19:26:26,Donostia,expenses,gas,-105.53,3513.53
buyer_5,Sara,Gurrutxaga,1994-03-12,01695532H,sara.gurrutxaga@smartapp.app,126346,ES11209547113786786463,1216.37,2022-05-05T15:19:09,Donostia,expenses,leisure,-74.33,3439.2
buyer_5,Sara,Gurrutxaga,1994-03-12,01695532H,sara.gurrutxaga@smartapp.app,126346,ES11209547113786786463,1216.37,2022-05-05T13:05:14,Donostia,expenses,cash,-100.0,3339.2
buyer_5,Sara,Gurrutxaga,1994-03-12,01695532H,sara.gurrutxaga@smartapp.app,126346,ES11209547113786786463,1216.37,2022-05-06T10:12:21,Donostia,expenses,water,-113.45,3225.75
buyer_5,Sara,Gurrutxaga,1994-03-12,01695532H,sara.gurrutxaga@smartapp.app,126346,ES11209547113786786463,1216.37,2022-05-06T09:43:59,Donostia,expenses,electricity,-108.84,3116.91
buyer_5,Sara,Gurrutxaga,1994-03-12,01695532H,sara.gurrutxaga@smartapp.app,126346,ES11209547113786786463,1216.37,2022-05-06T06:10:32,Donostia,expenses,phone,-107.45,3009.46
buyer_5,Sara,Gurrutxaga,1994-03-12,01695532H,sara.gurrutxaga@smartapp.app,126346,ES11209547113786786463,1216.37,2022-05-07T17:33:49,Donostia,expenses,food,-68.93,2940.53
buyer_5,Sara,Gurrutxaga,1994-03-12,01695532H,sara.gurrutxaga@smartapp.app,126346,ES11209547113786786463,1216.37,2022-05-08T21:55:30,Donostia,expenses,internet,-123.49,2817.04
buyer_5,Sara,Gurrutxaga,1994-03-12,01695532H,sara.gurrutxaga@smartapp.app,126346,ES11209547113786786463,1216.37,2022-05-08T15:04:49,Donostia,expenses,cash,-100.0,2717.04
buyer_5,Sara,Gurrutxaga,1994-03-12,01695532H,sara.gurrutxaga@smartapp.app,126346,ES11209547113786786463,1216.37,2022-05-09T12:27:26,Donostia,expenses,clothing,-138.77,2578.27
buyer_5,Sara,Gurrutxaga,1994-03-12,01695532H,sara.gurrutxaga@smartapp.app,126346,ES11209547113786786463,1216.37,2022-05-09T16:02:19,Donostia,expenses,cash,-100.0,2478.27
buyer_5,Sara,Gurrutxaga,1994-03-12,01695532H,sara.gurrutxaga@smartapp.app,126346,ES11209547113786786463,1216.37,2022-05-11T16:00:44,Donostia,expenses,leisure,-19.56,2458.71
buyer_5,Sara,Gurrutxaga,1994-03-12,01695532H,sara.gurrutxaga@smartapp.app,126346,ES11209547113786786463,1216.37,2022-05-12T13:20:41,Donostia,expenses,transport,-61.15,2397.56
buyer_5,Sara,Gurrutxaga,1994-03-12,01695532H,sara.gurrutxaga@smartapp.app,126346,ES11209547113786786463,1216.37,2022-05-13T15:23:18,Donostia,expenses,travel,-724.41,1673.15
buyer_5,Sara,Gurrutxaga,1994-03-12,01695532H,sara.gurrutxaga@smartapp.app,126346,ES11209547113786786463,1216.37,2022-05-13T17:05:08,Donostia,expenses,gifts,-193.32,1479.83
buyer_5,Sara,Gurrutxaga,1994-03-12,01695532H,sara.gurrutxaga@smartapp.app,126346,ES11209547113786786463,1216.37,2022-05-14T11:28:03,Donostia,expenses,food,-103.23,1376.6
buyer_5,Sara,Gurrutxaga,1994-03-12,01695532H,sara.gurrutxaga@smartapp.app,126346,ES11209547113786786463,1216.37,2022-05-17T11:29:48,Donostia,expenses,education,-57.74,1318.86
buyer_5,Sara,Gurrutxaga,1994-03-12,01695532H,sara.gurrutxaga@smartapp.app,126346,ES11209547113786786463,1216.37,2022-05-18T14:34:30,Donostia,expenses,food,-75.13,1243.73
buyer_5,Sara,Gurrutxaga,1994-03-12,01695532H,sara.gurrutxaga@smartapp.app,126346,ES11209547113786786463,1216.37,2022-05-18T11:24:48,Donostia,expenses,transport,-87.57,1156.16
buyer_5,Sara,Gurrutxaga,1994-03-12,01695532H,sara.gurrutxaga@smartapp.app,126346,ES11209547113786786463,1216.37,2022-05-20T09:18:38,Donostia,expenses,cash,-100.0,1056.16
buyer_5,Sara,Gurrutxaga,1994-03-12,01695532H,sara.gurrutxaga@smartapp.app,126346,ES11209547113786786463,1216.37,2022-05-20T18:11:55,Donostia,expenses,appliances,-172.53,883.63
buyer_5,Sara,Gurrutxaga,1994-03-12,01695532H,sara.gurrutxaga@smartapp.app,126346,ES11209547113786786463,1216.37,2022-05-22T16:19:57,Donostia,expenses,food,-97.6,786.03
buyer_5,Sara,Gurrutxaga,1994-03-12,01695532H,sara.gurrutxaga@smartapp.app,126346,ES11209547113786786463,1216.37,2022-05-22T14:51:42,Donostia,expenses,repairs,-282.0,504.03
buyer_5,Sara,Gurrutxaga,1994-03-12,01695532H,sara.gurrutxaga@smartapp.app,126346,ES11209547113786786463,1216.37,2022-05-23T20:46:20,Donostia,expenses,transport,-48.55,455.48
buyer_5,Sara,Gurrutxaga,1994-03-12,01695532H,sara.gurrutxaga@smartapp.app,126346,ES11209547113786786463,1216.37,2022-05-24T17:28:26,Donostia,expenses,cash,-100.0,355.48
buyer_5,Sara,Gurrutxaga,1994-03-12,01695532H,sara.gurrutxaga@smartapp.app,126346,ES11209547113786786463,1216.37,2022-05-25T19:14:19,Donostia,expenses,gifts,-811.36,-455.88
buyer_5,Sara,Gurrutxaga,1994-03-12,01695532H,sara.gurrutxaga@smartapp.app,126346,ES11209547113786786463,1216.37,2022-05-27T19:39:33,Donostia,expenses,leisure,-83.04,-538.92
buyer_5,Sara,Gurrutxaga,1994-03-12,01695532H,sara.gurrutxaga@smartapp.app,126346,ES11209547113786786463,1216.37,2022-05-27T20:41:31,Donostia,expenses,education,-42.41,-581.33
buyer_5,Sara,Gurrutxaga,1994-03-12,01695532H,sara.gurrutxaga@smartapp.app,126346,ES11209547113786786463,1216.37,2022-05-27T09:47:15,Donostia,expenses,travel,-567.1,-1148.43
buyer_5,Sara,Gurrutxaga,1994-03-12,01695532H,sara.gurrutxaga@smartapp.app,126346,ES11209547113786786463,1216.37,2022-06-01T10:23:01,Donostia,incomes,salary,2874.8,1726.37
buyer_5,Sara,Gurrutxaga,1994-03-12,01695532H,sara.gurrutxaga@smartapp.app,126346,ES11209547113786786463,1216.37,2022-06-01T10:23:01,Donostia,incomes,salary_partner,3005.77,4732.14
buyer_5,Sara,Gurrutxaga,1994-03-12,01695532H,sara.gurrutxaga@smartapp.app,126346,ES11209547113786786463,1216.37,2022-06-01T10:23:01,Donostia,incomes,salary_bonus,2176.55,6908.69
buyer_5,Sara,Gurrutxaga,1994-03-12,01695532H,sara.gurrutxaga@smartapp.app,126346,ES11209547113786786463,1216.37,2022-06-01T10:23:01,Donostia,incomes,salary_partner_bonus,2114.01,9022.7
buyer_5,Sara,Gurrutxaga,1994-03-12,01695532H,sara.gurrutxaga@smartapp.app,126346,ES11209547113786786463,1216.37,2022-06-01T08:44:36,Donostia,expenses,food,-107.04,8915.66
buyer_5,Sara,Gurrutxaga,1994-03-12,01695532H,sara.gurrutxaga@smartapp.app,126346,ES11209547113786786463,1216.37,2022-06-03T08:35:42,Donostia,expenses,repairs,-280.28,8635.38
buyer_5,Sara,Gurrutxaga,1994-03-12,01695532H,sara.gurrutxaga@smartapp.app,126346,ES11209547113786786463,1216.37,2022-06-04T16:36:06,Donostia,expenses,mortgage,-2550.4,6084.98
buyer_5,Sara,Gurrutxaga,1994-03-12,01695532H,sara.gurrutxaga@smartapp.app,126346,ES11209547113786786463,1216.37,2022-06-04T21:53:29,Donostia,expenses,food,-123.29,5961.69
buyer_5,Sara,Gurrutxaga,1994-03-12,01695532H,sara.gurrutxaga@smartapp.app,126346,ES11209547113786786463,1216.37,2022-06-04T10:03:25,Donostia,expenses,transport,-64.98,5896.71
buyer_5,Sara,Gurrutxaga,1994-03-12,01695532H,sara.gurrutxaga@smartapp.app,126346,ES11209547113786786463,1216.37,2022-06-06T16:59:22,Donostia,expenses,electricity,-196.19,5700.52
buyer_5,Sara,Gurrutxaga,1994-03-12,01695532H,sara.gurrutxaga@smartapp.app,126346,ES11209547113786786463,1216.37,2022-06-06T15:42:55,Donostia,expenses,gas,-275.73,5424.79
buyer_5,Sara,Gurrutxaga,1994-03-12,01695532H,sara.gurrutxaga@smartapp.app,126346,ES11209547113786786463,1216.37,2022-06-06T20:55:31,Donostia,expenses,food,-84.6,5340.19
buyer_5,Sara,Gurrutxaga,1994-03-12,01695532H,sara.gurrutxaga@smartapp.app,126346,ES11209547113786786463,1216.37,2022-06-07T11:05:00,Donostia,expenses,phone,-93.74,5246.45
buyer_5,Sara,Gurrutxaga,1994-03-12,01695532H,sara.gurrutxaga@smartapp.app,126346,ES11209547113786786463,1216.37,2022-06-07T14:16:44,Donostia,expenses,cash,-100.0,5146.45
buyer_5,Sara,Gurrutxaga,1994-03-12,01695532H,sara.gurrutxaga@smartapp.app,126346,ES11209547113786786463,1216.37,2022-06-08T19:00:09,Donostia,expenses,internet,-123.49,5022.96
buyer_5,Sara,Gurrutxaga,1994-03-12,01695532H,sara.gurrutxaga@smartapp.app,126346,ES11209547113786786463,1216.37,2022-06-08T12:58:00,Donostia,expenses,water,-128.91,4894.05
buyer_5,Sara,Gurrutxaga,1994-03-12,01695532H,sara.gurrutxaga@smartapp.app,126346,ES11209547113786786463,1216.37,2022-06-08T10:10:42,Donostia,expenses,leisure,-34.4,4859.65
buyer_5,Sara,Gurrutxaga,1994-03-12,01695532H,sara.gurrutxaga@smartapp.app,126346,ES11209547113786786463,1216.37,2022-06-09T10:37:28,Donostia,expenses,transport,-50.97,4808.68
buyer_5,Sara,Gurrutxaga,1994-03-12,01695532H,sara.gurrutxaga@smartapp.app,126346,ES11209547113786786463,1216.37,2022-06-12T15:03:46,Donostia,expenses,transport,-41.82,4766.86
buyer_5,Sara,Gurrutxaga,1994-03-12,01695532H,sara.gurrutxaga@smartapp.app,126346,ES11209547113786786463,1216.37,2022-06-12T16:41:58,Donostia,expenses,cash,-100.0,4666.86
buyer_5,Sara,Gurrutxaga,1994-03-12,01695532H,sara.gurrutxaga@smartapp.app,126346,ES11209547113786786463,1216.37,2022-06-15T16:25:28,Donostia,expenses,leisure,-43.38,4623.48
buyer_5,Sara,Gurrutxaga,1994-03-12,01695532H,sara.gurrutxaga@smartapp.app,126346,ES11209547113786786463,1216.37,2022-06-16T15:57:52,Donostia,expenses,cash,-100.0,4523.48
buyer_5,Sara,Gurrutxaga,1994-03-12,01695532H,sara.gurrutxaga@smartapp.app,126346,ES11209547113786786463,1216.37,2022-06-17T21:55:59,Donostia,expenses,transport,-76.0,4447.48
buyer_5,Sara,Gurrutxaga,1994-03-12,01695532H,sara.gurrutxaga@smartapp.app,126346,ES11209547113786786463,1216.37,2022-06-18T18:40:24,Donostia,expenses,transport,-78.75,4368.73
buyer_5,Sara,Gurrutxaga,1994-03-12,01695532H,sara.gurrutxaga@smartapp.app,126346,ES11209547113786786463,1216.37,2022-06-18T18:19:30,Donostia,expenses,repairs,-281.12,4087.61
buyer_5,Sara,Gurrutxaga,1994-03-12,01695532H,sara.gurrutxaga@smartapp.app,126346,ES11209547113786786463,1216.37,2022-06-19T16:21:15,Donostia,expenses,leisure,-22.85,4064.76
buyer_5,Sara,Gurrutxaga,1994-03-12,01695532H,sara.gurrutxaga@smartapp.app,126346,ES11209547113786786463,1216.37,2022-06-20T22:40:49,Donostia,expenses,education,-56.07,4008.69
buyer_5,Sara,Gurrutxaga,1994-03-12,01695532H,sara.gurrutxaga@smartapp.app,126346,ES11209547113786786463,1216.37,2022-06-20T18:36:54,Donostia,expenses,repairs,-117.24,3891.45
buyer_5,Sara,Gurrutxaga,1994-03-12,01695532H,sara.gurrutxaga@smartapp.app,126346,ES11209547113786786463,1216.37,2022-06-23T21:35:08,Donostia,expenses,food,-122.66,3768.79
buyer_5,Sara,Gurrutxaga,1994-03-12,01695532H,sara.gurrutxaga@smartapp.app,126346,ES11209547113786786463,1216.37,2022-06-25T14:19:24,Donostia,expenses,transport,-76.36,3692.43
buyer_5,Sara,Gurrutxaga,1994-03-12,01695532H,sara.gurrutxaga@smartapp.app,126346,ES11209547113786786463,1216.37,2022-06-26T04:47:02,Donostia,expenses,food,-96.18,3596.25
buyer_5,Sara,Gurrutxaga,1994-03-12,01695532H,sara.gurrutxaga@smartapp.app,126346,ES11209547113786786463,1216.37,2022-06-26T10:38:14,Donostia,expenses,leisure,-68.06,3528.19
buyer_5,Sara,Gurrutxaga,1994-03-12,01695532H,sara.gurrutxaga@smartapp.app,126346,ES11209547113786786463,1216.37,2022-06-26T09:05:58,Donostia,expenses,clothing,-98.65,3429.54
buyer_5,Sara,Gurrutxaga,1994-03-12,01695532H,sara.gurrutxaga@smartapp.app,126346,ES11209547113786786463,1216.37,2022-06-26T16:23:36,Donostia,expenses,repairs,-208.05,3221.49
buyer_5,Sara,Gurrutxaga,1994-03-12,01695532H,sara.gurrutxaga@smartapp.app,126346,ES11209547113786786463,1216.37,2022-06-28T15:53:09,Donostia,expenses,food,-67.24,3154.25
buyer_5,Sara,Gurrutxaga,1994-03-12,01695532H,sara.gurrutxaga@smartapp.app,126346,ES11209547113786786463,1216.37,2022-06-29T22:39:02,Donostia,expenses,leisure,-77.06,3077.19
buyer_5,Sara,Gurrutxaga,1994-03-12,01695532H,sara.gurrutxaga@smartapp.app,126346,ES11209547113786786463,1216.37,2022-06-29T08:31:41,Donostia,expenses,cash,-100.0,2977.19
buyer_5,Sara,Gurrutxaga,1994-03-12,01695532H,sara.gurrutxaga@smartapp.app,126346,ES11209547113786786463,1216.37,2022-07-01T06:59:33,Donostia,incomes,salary,2874.8,5851.99
buyer_5,Sara,Gurrutxaga,1994-03-12,01695532H,sara.gurrutxaga@smartapp.app,126346,ES11209547113786786463,1216.37,2022-07-01T06:59:33,Donostia,incomes,salary_partner,3005.77,8857.76
buyer_5,Sara,Gurrutxaga,1994-03-12,01695532H,sara.gurrutxaga@smartapp.app,126346,ES11209547113786786463,1216.37,2022-07-01T06:59:33,Donostia,incomes,extra_income,437.28,9295.04
buyer_5,Sara,Gurrutxaga,1994-03-12,01695532H,sara.gurrutxaga@smartapp.app,126346,ES11209547113786786463,1216.37,2022-07-04T11:45:46,Donostia,expenses,mortgage,-2550.4,6744.64
buyer_5,Sara,Gurrutxaga,1994-03-12,01695532H,sara.gurrutxaga@smartapp.app,126346,ES11209547113786786463,1216.37,2022-07-04T09:55:22,Donostia,expenses,leisure,-50.15,6694.49
buyer_5,Sara,Gurrutxaga,1994-03-12,01695532H,sara.gurrutxaga@smartapp.app,126346,ES11209547113786786463,1216.37,2022-07-06T10:08:55,Donostia,expenses,internet,-123.49,6571.0
buyer_5,Sara,Gurrutxaga,1994-03-12,01695532H,sara.gurrutxaga@smartapp.app,126346,ES11209547113786786463,1216.37,2022-07-06T17:46:28,Donostia,expenses,phone,-122.6,6448.4
buyer_5,Sara,Gurrutxaga,1994-03-12,01695532H,sara.gurrutxaga@smartapp.app,126346,ES11209547113786786463,1216.37,2022-07-06T16:38:38,Donostia,expenses,leisure,-43.3,6405.1
buyer_5,Sara,Gurrutxaga,1994-03-12,01695532H,sara.gurrutxaga@smartapp.app,126346,ES11209547113786786463,1216.37,2022-07-07T13:54:06,Donostia,expenses,gas,-105.41,6299.69
buyer_5,Sara,Gurrutxaga,1994-03-12,01695532H,sara.gurrutxaga@smartapp.app,126346,ES11209547113786786463,1216.37,2022-07-07T16:39:53,Donostia,expenses,repairs,-272.26,6027.43
buyer_5,Sara,Gurrutxaga,1994-03-12,01695532H,sara.gurrutxaga@smartapp.app,126346,ES11209547113786786463,1216.37,2022-07-08T19:55:56,Donostia,expenses,water,-60.21,5967.22
buyer_5,Sara,Gurrutxaga,1994-03-12,01695532H,sara.gurrutxaga@smartapp.app,126346,ES11209547113786786463,1216.37,2022-07-08T10:01:21,Donostia,expenses,electricity,-166.03,5801.19
buyer_5,Sara,Gurrutxaga,1994-03-12,01695532H,sara.gurrutxaga@smartapp.app,126346,ES11209547113786786463,1216.37,2022-07-08T17:21:14,Donostia,expenses,gifts,-630.56,5170.63
buyer_5,Sara,Gurrutxaga,1994-03-12,01695532H,sara.gurrutxaga@smartapp.app,126346,ES11209547113786786463,1216.37,2022-07-09T16:27:35,Donostia,expenses,transport,-81.45,5089.18
buyer_5,Sara,Gurrutxaga,1994-03-12,01695532H,sara.gurrutxaga@smartapp.app,126346,ES11209547113786786463,1216.37,2022-07-10T08:33:26,Donostia,expenses,food,-63.62,5025.56
buyer_5,Sara,Gurrutxaga,1994-03-12,01695532H,sara.gurrutxaga@smartapp.app,126346,ES11209547113786786463,1216.37,2022-07-10T17:54:10,Donostia,expenses,leisure,-65.78,4959.78
buyer_5,Sara,Gurrutxaga,1994-03-12,01695532H,sara.gurrutxaga@smartapp.app,126346,ES11209547113786786463,1216.37,2022-07-13T14:34:34,Donostia,expenses,food,-64.84,4894.94
buyer_5,Sara,Gurrutxaga,1994-03-12,01695532H,sara.gurrutxaga@smartapp.app,126346,ES11209547113786786463,1216.37,2022-07-14T23:18:50,Donostia,expenses,food,-85.46,4809.48
buyer_5,Sara,Gurrutxaga,1994-03-12,01695532H,sara.gurrutxaga@smartapp.app,126346,ES11209547113786786463,1216.37,2022-07-14T12:11:37,Donostia,expenses,repairs,-208.07,4601.41
buyer_5,Sara,Gurrutxaga,1994-03-12,01695532H,sara.gurrutxaga@smartapp.app,126346,ES11209547113786786463,1216.37,2022-07-17T11:12:37,Donostia,expenses,clothing,-64.68,4536.73
buyer_5,Sara,Gurrutxaga,1994-03-12,01695532H,sara.gurrutxaga@smartapp.app,126346,ES11209547113786786463,1216.37,2022-07-18T20:45:37,Donostia,expenses,repairs,-31.28,4505.45
buyer_5,Sara,Gurrutxaga,1994-03-12,01695532H,sara.gurrutxaga@smartapp.app,126346,ES11209547113786786463,1216.37,2022-07-20T18:56:45,Donostia,expenses,healthcare,-77.36,4428.09
buyer_5,Sara,Gurrutxaga,1994-03-12,01695532H,sara.gurrutxaga@smartapp.app,126346,ES11209547113786786463,1216.37,2022-07-21T13:31:08,Donostia,expenses,cash,-100.0,4328.09
buyer_5,Sara,Gurrutxaga,1994-03-12,01695532H,sara.gurrutxaga@smartapp.app,126346,ES11209547113786786463,1216.37,2022-07-25T15:48:56,Donostia,expenses,transport,-84.25,4243.84
buyer_5,Sara,Gurrutxaga,1994-03-12,01695532H,sara.gurrutxaga@smartapp.app,126346,ES11209547113786786463,1216.37,2022-07-26T08:32:14,Donostia,expenses,cash,-100.0,4143.84
buyer_5,Sara,Gurrutxaga,1994-03-12,01695532H,sara.gurrutxaga@smartapp.app,126346,ES11209547113786786463,1216.37,2022-07-27T20:46:44,Donostia,expenses,food,-101.19,4042.65
buyer_5,Sara,Gurrutxaga,1994-03-12,01695532H,sara.gurrutxaga@smartapp.app,126346,ES11209547113786786463,1216.37,2022-07-27T09:30:22,Donostia,expenses,transport,-62.11,3980.54
buyer_5,Sara,Gurrutxaga,1994-03-12,01695532H,sara.gurrutxaga@smartapp.app,126346,ES11209547113786786463,1216.37,2022-07-28T20:11:08,Donostia,expenses,leisure,-76.77,3903.77
buyer_5,Sara,Gurrutxaga,1994-03-12,01695532H,sara.gurrutxaga@smartapp.app,126346,ES11209547113786786463,1216.37,2022-07-31T12:00:55,Donostia,expenses,education,-45.02,3858.75
buyer_5,Sara,Gurrutxaga,1994-03-12,01695532H,sara.gurrutxaga@smartapp.app,126346,ES11209547113786786463,1216.37,2022-07-31T18:36:33,Donostia,expenses,repairs,-191.53,3667.22
buyer_5,Sara,Gurrutxaga,1994-03-12,01695532H,sara.gurrutxaga@smartapp.app,126346,ES11209547113786786463,1216.37,2022-08-01T20:58:58,Donostia,incomes,salary,2874.8,6542.02
buyer_5,Sara,Gurrutxaga,1994-03-12,01695532H,sara.gurrutxaga@smartapp.app,126346,ES11209547113786786463,1216.37,2022-08-01T20:58:58,Donostia,incomes,salary_partner,3005.77,9547.79
buyer_5,Sara,Gurrutxaga,1994-03-12,01695532H,sara.gurrutxaga@smartapp.app,126346,ES11209547113786786463,1216.37,2022-08-01T08:41:22,Donostia,expenses,food,-60.37,9487.42
buyer_5,Sara,Gurrutxaga,1994-03-12,01695532H,sara.gurrutxaga@smartapp.app,126346,ES11209547113786786463,1216.37,2022-08-01T23:11:51,Donostia,expenses,appliances,-272.47,9214.95
buyer_5,Sara,Gurrutxaga,1994-03-12,01695532H,sara.gurrutxaga@smartapp.app,126346,ES11209547113786786463,1216.37,2022-08-03T18:08:17,Donostia,expenses,leisure,-46.83,9168.12
buyer_5,Sara,Gurrutxaga,1994-03-12,01695532H,sara.gurrutxaga@smartapp.app,126346,ES11209547113786786463,1216.37,2022-08-03T22:58:03,Donostia,expenses,gifts,-238.62,8929.5
buyer_5,Sara,Gurrutxaga,1994-03-12,01695532H,sara.gurrutxaga@smartapp.app,126346,ES11209547113786786463,1216.37,2022-08-04T21:56:11,Donostia,expenses,mortgage,-2550.4,6379.1
buyer_5,Sara,Gurrutxaga,1994-03-12,01695532H,sara.gurrutxaga@smartapp.app,126346,ES11209547113786786463,1216.37,2022-08-05T13:18:38,Donostia,expenses,water,-119.25,6259.85
buyer_5,Sara,Gurrutxaga,1994-03-12,01695532H,sara.gurrutxaga@smartapp.app,126346,ES11209547113786786463,1216.37,2022-08-05T20:49:49,Donostia,expenses,phone,-119.8,6140.05
buyer_5,Sara,Gurrutxaga,1994-03-12,01695532H,sara.gurrutxaga@smartapp.app,126346,ES11209547113786786463,1216.37,2022-08-05T18:15:44,Donostia,expenses,healthcare,-110.96,6029.09
buyer_5,Sara,Gurrutxaga,1994-03-12,01695532H,sara.gurrutxaga@smartapp.app,126346,ES11209547113786786463,1216.37,2022-08-06T10:12:34,Donostia,expenses,electricity,-146.49,5882.6
buyer_5,Sara,Gurrutxaga,1994-03-12,01695532H,sara.gurrutxaga@smartapp.app,126346,ES11209547113786786463,1216.37,2022-08-06T07:40:17,Donostia,expenses,internet,-123.49,5759.11
buyer_5,Sara,Gurrutxaga,1994-03-12,01695532H,sara.gurrutxaga@smartapp.app,126346,ES11209547113786786463,1216.37,2022-08-06T18:39:19,Donostia,expenses,healthcare,-176.16,5582.95
buyer_5,Sara,Gurrutxaga,1994-03-12,01695532H,sara.gurrutxaga@smartapp.app,126346,ES11209547113786786463,1216.37,2022-08-07T00:49:01,Donostia,expenses,gas,-129.07,5453.88
buyer_5,Sara,Gurrutxaga,1994-03-12,01695532H,sara.gurrutxaga@smartapp.app,126346,ES11209547113786786463,1216.37,2022-08-07T18:22:36,Donostia,expenses,appliances,-308.48,5145.4
buyer_5,Sara,Gurrutxaga,1994-03-12,01695532H,sara.gurrutxaga@smartapp.app,126346,ES11209547113786786463,1216.37,2022-08-09T18:08:53,Donostia,expenses,food,-78.03,5067.37
buyer_5,Sara,Gurrutxaga,1994-03-12,01695532H,sara.gurrutxaga@smartapp.app,126346,ES11209547113786786463,1216.37,2022-08-10T16:25:05,Donostia,expenses,healthcare,-155.87,4911.5
buyer_5,Sara,Gurrutxaga,1994-03-12,01695532H,sara.gurrutxaga@smartapp.app,126346,ES11209547113786786463,1216.37,2022-08-10T13:58:14,Donostia,expenses,repairs,-290.58,4620.92
buyer_5,Sara,Gurrutxaga,1994-03-12,01695532H,sara.gurrutxaga@smartapp.app,126346,ES11209547113786786463,1216.37,2022-08-11T06:01:01,Donostia,expenses,leisure,-51.4,4569.52
buyer_5,Sara,Gurrutxaga,1994-03-12,01695532H,sara.gurrutxaga@smartapp.app,126346,ES11209547113786786463,1216.37,2022-08-13T18:37:24,Donostia,expenses,food,-61.15,4508.37
buyer_5,Sara,Gurrutxaga,1994-03-12,01695532H,sara.gurrutxaga@smartapp.app,126346,ES11209547113786786463,1216.37,2022-08-14T13:12:54,Donostia,expenses,cash,-100.0,4408.37
buyer_5,Sara,Gurrutxaga,1994-03-12,01695532H,sara.gurrutxaga@smartapp.app,126346,ES11209547113786786463,1216.37,2022-08-15T11:08:15,Donostia,expenses,clothing,-99.9,4308.47
buyer_5,Sara,Gurrutxaga,1994-03-12,01695532H,sara.gurrutxaga@smartapp.app,126346,ES11209547113786786463,1216.37,2022-08-19T04:24:20,Donostia,expenses,food,-90.68,4217.79
buyer_5,Sara,Gurrutxaga,1994-03-12,01695532H,sara.gurrutxaga@smartapp.app,126346,ES11209547113786786463,1216.37,2022-08-19T19:03:00,Donostia,expenses,education,-74.72,4143.07
buyer_5,Sara,Gurrutxaga,1994-03-12,01695532H,sara.gurrutxaga@smartapp.app,126346,ES11209547113786786463,1216.37,2022-08-19T19:45:26,Donostia,expenses,cash,-100.0,4043.07
buyer_5,Sara,Gurrutxaga,1994-03-12,01695532H,sara.gurrutxaga@smartapp.app,126346,ES11209547113786786463,1216.37,2022-08-21T00:38:15,Donostia,expenses,healthcare,-188.91,3854.16
buyer_5,Sara,Gurrutxaga,1994-03-12,01695532H,sara.gurrutxaga@smartapp.app,126346,ES11209547113786786463,1216.37,2022-08-22T11:55:18,Donostia,expenses,clothing,-138.02,3716.14
buyer_5,Sara,Gurrutxaga,1994-03-12,01695532H,sara.gurrutxaga@smartapp.app,126346,ES11209547113786786463,1216.37,2022-08-23T13:48:29,Donostia,expenses,gifts,-31.44,3684.7
buyer_5,Sara,Gurrutxaga,1994-03-12,01695532H,sara.gurrutxaga@smartapp.app,126346,ES11209547113786786463,1216.37,2022-08-24T10:05:31,Donostia,expenses,cash,-100.0,3584.7
buyer_5,Sara,Gurrutxaga,1994-03-12,01695532H,sara.gurrutxaga@smartapp.app,126346,ES11209547113786786463,1216.37,2022-08-24T18:46:25,Donostia,expenses,gifts,-701.62,2883.08
buyer_5,Sara,Gurrutxaga,1994-03-12,01695532H,sara.gurrutxaga@smartapp.app,126346,ES11209547113786786463,1216.37,2022-08-26T06:17:38,Donostia,expenses,food,-101.13,2781.95
buyer_5,Sara,Gurrutxaga,1994-03-12,01695532H,sara.gurrutxaga@smartapp.app,126346,ES11209547113786786463,1216.37,2022-08-26T18:04:43,Donostia,expenses,cash,-100.0,2681.95
buyer_5,Sara,Gurrutxaga,1994-03-12,01695532H,sara.gurrutxaga@smartapp.app,126346,ES11209547113786786463,1216.37,2022-08-28T08:35:12,Donostia,expenses,leisure,-25.67,2656.28
buyer_5,Sara,Gurrutxaga,1994-03-12,01695532H,sara.gurrutxaga@smartapp.app,126346,ES11209547113786786463,1216.37,2022-08-29T16:25:21,Donostia,expenses,food,-103.37,2552.91
buyer_5,Sara,Gurrutxaga,1994-03-12,01695532H,sara.gurrutxaga@smartapp.app,126346,ES11209547113786786463,1216.37,2022-08-29T15:56:24,Donostia,expenses,clothing,-73.03,2479.88
buyer_5,Sara,Gurrutxaga,1994-03-12,01695532H,sara.gurrutxaga@smartapp.app,126346,ES11209547113786786463,1216.37,2022-08-31T11:11:16,Donostia,expenses,transport,-60.47,2419.41
buyer_5,Sara,Gurrutxaga,1994-03-12,01695532H,sara.gurrutxaga@smartapp.app,126346,ES11209547113786786463,1216.37,2022-09-01T08:42:22,Donostia,incomes,salary,2874.8,5294.21
buyer_5,Sara,Gurrutxaga,1994-03-12,01695532H,sara.gurrutxaga@smartapp.app,126346,ES11209547113786786463,1216.37,2022-09-01T08:42:22,Donostia,incomes,salary_partner,3005.77,8299.98
buyer_5,Sara,Gurrutxaga,1994-03-12,01695532H,sara.gurrutxaga@smartapp.app,126346,ES11209547113786786463,1216.37,2022-09-02T01:35:13,Donostia,expenses,transport,-80.55,8219.43
buyer_5,Sara,Gurrutxaga,1994-03-12,01695532H,sara.gurrutxaga@smartapp.app,126346,ES11209547113786786463,1216.37,2022-09-04T19:35:44,Donostia,expenses,mortgage,-2550.4,5669.03
buyer_5,Sara,Gurrutxaga,1994-03-12,01695532H,sara.gurrutxaga@smartapp.app,126346,ES11209547113786786463,1216.37,2022-09-04T17:48:38,Donostia,expenses,food,-103.07,5565.96
buyer_5,Sara,Gurrutxaga,1994-03-12,01695532H,sara.gurrutxaga@smartapp.app,126346,ES11209547113786786463,1216.37,2022-09-04T20:05:56,Donostia,expenses,leisure,-55.95,5510.01
buyer_5,Sara,Gurrutxaga,1994-03-12,01695532H,sara.gurrutxaga@smartapp.app,126346,ES11209547113786786463,1216.37,2022-09-04T14:45:27,Donostia,expenses,cash,-100.0,5410.01
buyer_5,Sara,Gurrutxaga,1994-03-12,01695532H,sara.gurrutxaga@smartapp.app,126346,ES11209547113786786463,1216.37,2022-09-04T17:29:35,Donostia,expenses,travel,-432.99,4977.02
buyer_5,Sara,Gurrutxaga,1994-03-12,01695532H,sara.gurrutxaga@smartapp.app,126346,ES11209547113786786463,1216.37,2022-09-05T15:13:49,Donostia,expenses,phone,-123.56,4853.46
buyer_5,Sara,Gurrutxaga,1994-03-12,01695532H,sara.gurrutxaga@smartapp.app,126346,ES11209547113786786463,1216.37,2022-09-05T10:21:30,Donostia,expenses,cash,-100.0,4753.46
buyer_5,Sara,Gurrutxaga,1994-03-12,01695532H,sara.gurrutxaga@smartapp.app,126346,ES11209547113786786463,1216.37,2022-09-06T09:48:17,Donostia,expenses,water,-120.7,4632.76
buyer_5,Sara,Gurrutxaga,1994-03-12,01695532H,sara.gurrutxaga@smartapp.app,126346,ES11209547113786786463,1216.37,2022-09-06T19:15:40,Donostia,expenses,electricity,-180.25,4452.51
buyer_5,Sara,Gurrutxaga,1994-03-12,01695532H,sara.gurrutxaga@smartapp.app,126346,ES11209547113786786463,1216.37,2022-09-07T07:46:19,Donostia,expenses,leisure,-43.76,4408.75
buyer_5,Sara,Gurrutxaga,1994-03-12,01695532H,sara.gurrutxaga@smartapp.app,126346,ES11209547113786786463,1216.37,2022-09-08T09:54:42,Donostia,expenses,internet,-123.49,4285.26
buyer_5,Sara,Gurrutxaga,1994-03-12,01695532H,sara.gurrutxaga@smartapp.app,126346,ES11209547113786786463,1216.37,2022-09-08T15:25:21,Donostia,expenses,gas,-173.79,4111.47
buyer_5,Sara,Gurrutxaga,1994-03-12,01695532H,sara.gurrutxaga@smartapp.app,126346,ES11209547113786786463,1216.37,2022-09-08T17:07:28,Donostia,expenses,transport,-51.2,4060.27
buyer_5,Sara,Gurrutxaga,1994-03-12,01695532H,sara.gurrutxaga@smartapp.app,126346,ES11209547113786786463,1216.37,2022-09-08T20:16:42,Donostia,expenses,education,-65.24,3995.03
buyer_5,Sara,Gurrutxaga,1994-03-12,01695532H,sara.gurrutxaga@smartapp.app,126346,ES11209547113786786463,1216.37,2022-09-09T15:00:22,Donostia,expenses,leisure,-19.86,3975.17
buyer_5,Sara,Gurrutxaga,1994-03-12,01695532H,sara.gurrutxaga@smartapp.app,126346,ES11209547113786786463,1216.37,2022-09-10T12:54:12,Donostia,expenses,leisure,-68.01,3907.16
buyer_5,Sara,Gurrutxaga,1994-03-12,01695532H,sara.gurrutxaga@smartapp.app,126346,ES11209547113786786463,1216.37,2022-09-11T17:12:48,Donostia,expenses,cash,-100.0,3807.16
buyer_5,Sara,Gurrutxaga,1994-03-12,01695532H,sara.gurrutxaga@smartapp.app,126346,ES11209547113786786463,1216.37,2022-09-11T15:44:26,Donostia,expenses,gifts,-828.68,2978.48
buyer_5,Sara,Gurrutxaga,1994-03-12,01695532H,sara.gurrutxaga@smartapp.app,126346,ES11209547113786786463,1216.37,2022-09-12T08:42:49,Donostia,expenses,healthcare,-111.59,2866.89
buyer_5,Sara,Gurrutxaga,1994-03-12,01695532H,sara.gurrutxaga@smartapp.app,126346,ES11209547113786786463,1216.37,2022-09-14T11:43:54,Donostia,expenses,transport,-47.89,2819.0
buyer_5,Sara,Gurrutxaga,1994-03-12,01695532H,sara.gurrutxaga@smartapp.app,126346,ES11209547113786786463,1216.37,2022-09-14T19:37:05,Donostia,expenses,education,-43.25,2775.75
buyer_5,Sara,Gurrutxaga,1994-03-12,01695532H,sara.gurrutxaga@smartapp.app,126346,ES11209547113786786463,1216.37,2022-09-15T20:24:28,Donostia,expenses,transport,-57.92,2717.83
buyer_5,Sara,Gurrutxaga,1994-03-12,01695532H,sara.gurrutxaga@smartapp.app,126346,ES11209547113786786463,1216.37,2022-09-15T18:39:28,Donostia,expenses,clothing,-53.67,2664.16
buyer_5,Sara,Gurrutxaga,1994-03-12,01695532H,sara.gurrutxaga@smartapp.app,126346,ES11209547113786786463,1216.37,2022-09-17T14:41:19,Donostia,expenses,transport,-55.78,2608.38
buyer_5,Sara,Gurrutxaga,1994-03-12,01695532H,sara.gurrutxaga@smartapp.app,126346,ES11209547113786786463,1216.37,2022-09-18T18:01:13,Donostia,expenses,leisure,-32.51,2575.87
buyer_5,Sara,Gurrutxaga,1994-03-12,01695532H,sara.gurrutxaga@smartapp.app,126346,ES11209547113786786463,1216.37,2022-09-20T18:35:14,Donostia,expenses,food,-65.08,2510.79
buyer_5,Sara,Gurrutxaga,1994-03-12,01695532H,sara.gurrutxaga@smartapp.app,126346,ES11209547113786786463,1216.37,2022-09-20T14:12:03,Donostia,expenses,repairs,-115.49,2395.3
buyer_5,Sara,Gurrutxaga,1994-03-12,01695532H,sara.gurrutxaga@smartapp.app,126346,ES11209547113786786463,1216.37,2022-09-21T19:53:28,Donostia,expenses,food,-68.81,2326.49
buyer_5,Sara,Gurrutxaga,1994-03-12,01695532H,sara.gurrutxaga@smartapp.app,126346,ES11209547113786786463,1216.37,2022-09-21T10:47:05,Donostia,expenses,gifts,-160.08,2166.41
buyer_5,Sara,Gurrutxaga,1994-03-12,01695532H,sara.gurrutxaga@smartapp.app,126346,ES11209547113786786463,1216.37,2022-09-23T12:07:05,Donostia,expenses,cash,-100.0,2066.41
buyer_5,Sara,Gurrutxaga,1994-03-12,01695532H,sara.gurrutxaga@smartapp.app,126346,ES11209547113786786463,1216.37,2022-09-24T19:21:31,Donostia,expenses,cash,-100.0,1966.41
buyer_5,Sara,Gurrutxaga,1994-03-12,01695532H,sara.gurrutxaga@smartapp.app,126346,ES11209547113786786463,1216.37,2022-09-26T10:17:48,Donostia,expenses,food,-100.26,1866.15
buyer_5,Sara,Gurrutxaga,1994-03-12,01695532H,sara.gurrutxaga@smartapp.app,126346,ES11209547113786786463,1216.37,2022-09-26T15:40:17,Donostia,expenses,leisure,-41.04,1825.11
buyer_5,Sara,Gurrutxaga,1994-03-12,01695532H,sara.gurrutxaga@smartapp.app,126346,ES11209547113786786463,1216.37,2022-09-26T11:31:20,Donostia,expenses,education,-77.01,1748.1
buyer_5,Sara,Gurrutxaga,1994-03-12,01695532H,sara.gurrutxaga@smartapp.app,126346,ES11209547113786786463,1216.37,2022-09-27T06:58:19,Donostia,expenses,gifts,-139.12,1608.98
buyer_5,Sara,Gurrutxaga,1994-03-12,01695532H,sara.gurrutxaga@smartapp.app,126346,ES11209547113786786463,1216.37,2022-09-28T04:56:35,Donostia,expenses,appliances,-146.12,1462.86
buyer_5,Sara,Gurrutxaga,1994-03-12,01695532H,sara.gurrutxaga@smartapp.app,126346,ES11209547113786786463,1216.37,2022-09-29T22:04:59,Donostia,expenses,food,-118.01,1344.85
buyer_5,Sara,Gurrutxaga,1994-03-12,01695532H,sara.gurrutxaga@smartapp.app,126346,ES11209547113786786463,1216.37,2022-09-30T16:38:27,Donostia,expenses,cash,-100.0,1244.85
buyer_5,Sara,Gurrutxaga,1994-03-12,01695532H,sara.gurrutxaga@smartapp.app,126346,ES11209547113786786463,1216.37,2022-10-01T10:08:17,Donostia,incomes,salary,2874.8,4119.65
buyer_5,Sara,Gurrutxaga,1994-03-12,01695532H,sara.gurrutxaga@smartapp.app,126346,ES11209547113786786463,1216.37,2022-10-01T10:08:17,Donostia,incomes,salary_partner,3005.77,7125.42
buyer_5,Sara,Gurrutxaga,1994-03-12,01695532H,sara.gurrutxaga@smartapp.app,126346,ES11209547113786786463,1216.37,2022-10-01T12:39:54,Donostia,expenses,food,-95.15,7030.27
buyer_5,Sara,Gurrutxaga,1994-03-12,01695532H,sara.gurrutxaga@smartapp.app,126346,ES11209547113786786463,1216.37,2022-10-01T18:44:10,Donostia,expenses,repairs,-105.58,6924.69
buyer_5,Sara,Gurrutxaga,1994-03-12,01695532H,sara.gurrutxaga@smartapp.app,126346,ES11209547113786786463,1216.37,2022-10-04T20:58:37,Donostia,expenses,mortgage,-2550.4,4374.29
buyer_5,Sara,Gurrutxaga,1994-03-12,01695532H,sara.gurrutxaga@smartapp.app,126346,ES11209547113786786463,1216.37,2022-10-04T11:39:21,Donostia,expenses,cash,-100.0,4274.29
buyer_5,Sara,Gurrutxaga,1994-03-12,01695532H,sara.gurrutxaga@smartapp.app,126346,ES11209547113786786463,1216.37,2022-10-04T23:50:19,Donostia,expenses,appliances,-419.39,3854.9
buyer_5,Sara,Gurrutxaga,1994-03-12,01695532H,sara.gurrutxaga@smartapp.app,126346,ES11209547113786786463,1216.37,2022-10-05T15:19:05,Donostia,expenses,water,-99.68,3755.22
buyer_5,Sara,Gurrutxaga,1994-03-12,01695532H,sara.gurrutxaga@smartapp.app,126346,ES11209547113786786463,1216.37,2022-10-07T12:40:51,Donostia,expenses,internet,-123.49,3631.73
buyer_5,Sara,Gurrutxaga,1994-03-12,01695532H,sara.gurrutxaga@smartapp.app,126346,ES11209547113786786463,1216.37,2022-10-08T14:29:18,Donostia,expenses,electricity,-126.67,3505.06
buyer_5,Sara,Gurrutxaga,1994-03-12,01695532H,sara.gurrutxaga@smartapp.app,126346,ES11209547113786786463,1216.37,2022-10-08T18:42:27,Donostia,expenses,gas,-304.09,3200.97
buyer_5,Sara,Gurrutxaga,1994-03-12,01695532H,sara.gurrutxaga@smartapp.app,126346,ES11209547113786786463,1216.37,2022-10-08T15:37:43,Donostia,expenses,phone,-115.18,3085.79
buyer_5,Sara,Gurrutxaga,1994-03-12,01695532H,sara.gurrutxaga@smartapp.app,126346,ES11209547113786786463,1216.37,2022-10-08T20:28:16,Donostia,expenses,transport,-41.04,3044.75
buyer_5,Sara,Gurrutxaga,1994-03-12,01695532H,sara.gurrutxaga@smartapp.app,126346,ES11209547113786786463,1216.37,2022-10-08T11:15:17,Donostia,expenses,leisure,-30.78,3013.97
buyer_5,Sara,Gurrutxaga,1994-03-12,01695532H,sara.gurrutxaga@smartapp.app,126346,ES11209547113786786463,1216.37,2022-10-08T21:31:41,Donostia,expenses,cash,-100.0,2913.97
buyer_5,Sara,Gurrutxaga,1994-03-12,01695532H,sara.gurrutxaga@smartapp.app,126346,ES11209547113786786463,1216.37,2022-10-10T21:39:23,Donostia,expenses,transport,-61.07,2852.9
buyer_5,Sara,Gurrutxaga,1994-03-12,01695532H,sara.gurrutxaga@smartapp.app,126346,ES11209547113786786463,1216.37,2022-10-10T14:43:41,Donostia,expenses,healthcare,-187.89,2665.01
buyer_5,Sara,Gurrutxaga,1994-03-12,01695532H,sara.gurrutxaga@smartapp.app,126346,ES11209547113786786463,1216.37,2022-10-13T11:30:26,Donostia,expenses,food,-116.94,2548.07
buyer_5,Sara,Gurrutxaga,1994-03-12,01695532H,sara.gurrutxaga@smartapp.app,126346,ES11209547113786786463,1216.37,2022-10-13T18:06:29,Donostia,expenses,education,-72.38,2475.69
buyer_5,Sara,Gurrutxaga,1994-03-12,01695532H,sara.gurrutxaga@smartapp.app,126346,ES11209547113786786463,1216.37,2022-10-14T11:10:44,Donostia,expenses,transport,-53.24,2422.45
buyer_5,Sara,Gurrutxaga,1994-03-12,01695532H,sara.gurrutxaga@smartapp.app,126346,ES11209547113786786463,1216.37,2022-10-14T13:31:56,Donostia,expenses,clothing,-123.14,2299.31
buyer_5,Sara,Gurrutxaga,1994-03-12,01695532H,sara.gurrutxaga@smartapp.app,126346,ES11209547113786786463,1216.37,2022-10-17T05:08:39,Donostia,expenses,food,-97.68,2201.63
buyer_5,Sara,Gurrutxaga,1994-03-12,01695532H,sara.gurrutxaga@smartapp.app,126346,ES11209547113786786463,1216.37,2022-10-17T12:25:20,Donostia,expenses,gifts,-114.01,2087.62
buyer_5,Sara,Gurrutxaga,1994-03-12,01695532H,sara.gurrutxaga@smartapp.app,126346,ES11209547113786786463,1216.37,2022-10-18T00:18:30,Donostia,expenses,transport,-45.14,2042.48
buyer_5,Sara,Gurrutxaga,1994-03-12,01695532H,sara.gurrutxaga@smartapp.app,126346,ES11209547113786786463,1216.37,2022-10-18T16:48:38,Donostia,expenses,cash,-100.0,1942.48
buyer_5,Sara,Gurrutxaga,1994-03-12,01695532H,sara.gurrutxaga@smartapp.app,126346,ES11209547113786786463,1216.37,2022-10-19T15:50:24,Donostia,expenses,healthcare,-117.28,1825.2
buyer_5,Sara,Gurrutxaga,1994-03-12,01695532H,sara.gurrutxaga@smartapp.app,126346,ES11209547113786786463,1216.37,2022-10-20T13:44:12,Donostia,expenses,food,-114.4,1710.8
buyer_5,Sara,Gurrutxaga,1994-03-12,01695532H,sara.gurrutxaga@smartapp.app,126346,ES11209547113786786463,1216.37,2022-10-20T16:55:34,Donostia,expenses,leisure,-78.72,1632.08
buyer_5,Sara,Gurrutxaga,1994-03-12,01695532H,sara.gurrutxaga@smartapp.app,126346,ES11209547113786786463,1216.37,2022-10-20T10:07:29,Donostia,expenses,repairs,-119.88,1512.2
buyer_5,Sara,Gurrutxaga,1994-03-12,01695532H,sara.gurrutxaga@smartapp.app,126346,ES11209547113786786463,1216.37,2022-10-21T13:29:22,Donostia,expenses,leisure,-78.06,1434.14
buyer_5,Sara,Gurrutxaga,1994-03-12,01695532H,sara.gurrutxaga@smartapp.app,126346,ES11209547113786786463,1216.37,2022-10-23T10:40:11,Donostia,expenses,cash,-100.0,1334.14
buyer_5,Sara,Gurrutxaga,1994-03-12,01695532H,sara.gurrutxaga@smartapp.app,126346,ES11209547113786786463,1216.37,2022-10-24T14:09:30,Donostia,expenses,food,-121.17,1212.97
buyer_5,Sara,Gurrutxaga,1994-03-12,01695532H,sara.gurrutxaga@smartapp.app,126346,ES11209547113786786463,1216.37,2022-10-24T08:50:44,Donostia,expenses,leisure,-30.59,1182.38
buyer_5,Sara,Gurrutxaga,1994-03-12,01695532H,sara.gurrutxaga@smartapp.app,126346,ES11209547113786786463,1216.37,2022-10-24T20:21:59,Donostia,expenses,cash,-100.0,1082.38
buyer_5,Sara,Gurrutxaga,1994-03-12,01695532H,sara.gurrutxaga@smartapp.app,126346,ES11209547113786786463,1216.37,2022-10-29T08:59:05,Donostia,expenses,cash,-100.0,982.38
buyer_5,Sara,Gurrutxaga,1994-03-12,01695532H,sara.gurrutxaga@smartapp.app,126346,ES11209547113786786463,1216.37,2022-10-30T08:09:36,Donostia,expenses,transport,-48.37,934.01
buyer_5,Sara,Gurrutxaga,1994-03-12,01695532H,sara.gurrutxaga@smartapp.app,126346,ES11209547113786786463,1216.37,2022-10-31T11:46:27,Donostia,expenses,leisure,-78.44,855.57
buyer_5,Sara,Gurrutxaga,1994-03-12,01695532H,sara.gurrutxaga@smartapp.app,126346,ES11209547113786786463,1216.37,2022-11-01T20:08:53,Donostia,incomes,salary,2874.8,3730.37
buyer_5,Sara,Gurrutxaga,1994-03-12,01695532H,sara.gurrutxaga@smartapp.app,126346,ES11209547113786786463,1216.37,2022-11-01T20:08:53,Donostia,incomes,salary_partner,3005.77,6736.14
buyer_5,Sara,Gurrutxaga,1994-03-12,01695532H,sara.gurrutxaga@smartapp.app,126346,ES11209547113786786463,1216.37,2022-11-01T20:08:53,Donostia,incomes,extra_income,437.28,7173.42
buyer_5,Sara,Gurrutxaga,1994-03-12,01695532H,sara.gurrutxaga@smartapp.app,126346,ES11209547113786786463,1216.37,2022-11-01T19:34:28,Donostia,expenses,clothing,-64.11,7109.31
buyer_5,Sara,Gurrutxaga,1994-03-12,01695532H,sara.gurrutxaga@smartapp.app,126346,ES11209547113786786463,1216.37,2022-11-03T18:37:31,Donostia,expenses,clothing,-71.68,7037.63
buyer_5,Sara,Gurrutxaga,1994-03-12,01695532H,sara.gurrutxaga@smartapp.app,126346,ES11209547113786786463,1216.37,2022-11-04T12:34:41,Donostia,expenses,mortgage,-2550.4,4487.23
buyer_5,Sara,Gurrutxaga,1994-03-12,01695532H,sara.gurrutxaga@smartapp.app,126346,ES11209547113786786463,1216.37,2022-11-04T21:19:58,Donostia,expenses,food,-69.96,4417.27
buyer_5,Sara,Gurrutxaga,1994-03-12,01695532H,sara.gurrutxaga@smartapp.app,126346,ES11209547113786786463,1216.37,2022-11-05T14:01:22,Donostia,expenses,cash,-100.0,4317.27
buyer_5,Sara,Gurrutxaga,1994-03-12,01695532H,sara.gurrutxaga@smartapp.app,126346,ES11209547113786786463,1216.37,2022-11-05T20:29:26,Donostia,expenses,repairs,-116.26,4201.01
buyer_5,Sara,Gurrutxaga,1994-03-12,01695532H,sara.gurrutxaga@smartapp.app,126346,ES11209547113786786463,1216.37,2022-11-06T19:32:54,Donostia,expenses,water,-105.89,4095.12
buyer_5,Sara,Gurrutxaga,1994-03-12,01695532H,sara.gurrutxaga@smartapp.app,126346,ES11209547113786786463,1216.37,2022-11-06T17:21:24,Donostia,expenses,gas,-133.84,3961.28
buyer_5,Sara,Gurrutxaga,1994-03-12,01695532H,sara.gurrutxaga@smartapp.app,126346,ES11209547113786786463,1216.37,2022-11-06T09:03:53,Donostia,expenses,cash,-100.0,3861.28
buyer_5,Sara,Gurrutxaga,1994-03-12,01695532H,sara.gurrutxaga@smartapp.app,126346,ES11209547113786786463,1216.37,2022-11-07T15:21:11,Donostia,expenses,gifts,-270.09,3591.19
buyer_5,Sara,Gurrutxaga,1994-03-12,01695532H,sara.gurrutxaga@smartapp.app,126346,ES11209547113786786463,1216.37,2022-11-08T14:45:06,Donostia,expenses,electricity,-102.49,3488.7
buyer_5,Sara,Gurrutxaga,1994-03-12,01695532H,sara.gurrutxaga@smartapp.app,126346,ES11209547113786786463,1216.37,2022-11-08T17:13:04,Donostia,expenses,internet,-123.49,3365.21
buyer_5,Sara,Gurrutxaga,1994-03-12,01695532H,sara.gurrutxaga@smartapp.app,126346,ES11209547113786786463,1216.37,2022-11-08T03:39:34,Donostia,expenses,phone,-105.78,3259.43
buyer_5,Sara,Gurrutxaga,1994-03-12,01695532H,sara.gurrutxaga@smartapp.app,126346,ES11209547113786786463,1216.37,2022-11-08T22:55:12,Donostia,expenses,leisure,-50.75,3208.68
buyer_5,Sara,Gurrutxaga,1994-03-12,01695532H,sara.gurrutxaga@smartapp.app,126346,ES11209547113786786463,1216.37,2022-11-08T09:44:13,Donostia,expenses,cash,-100.0,3108.68
buyer_5,Sara,Gurrutxaga,1994-03-12,01695532H,sara.gurrutxaga@smartapp.app,126346,ES11209547113786786463,1216.37,2022-11-08T01:31:13,Donostia,expenses,appliances,-182.18,2926.5
buyer_5,Sara,Gurrutxaga,1994-03-12,01695532H,sara.gurrutxaga@smartapp.app,126346,ES11209547113786786463,1216.37,2022-11-12T14:44:49,Donostia,expenses,leisure,-60.09,2866.41
buyer_5,Sara,Gurrutxaga,1994-03-12,01695532H,sara.gurrutxaga@smartapp.app,126346,ES11209547113786786463,1216.37,2022-11-13T08:41:33,Donostia,expenses,food,-84.8,2781.61
buyer_5,Sara,Gurrutxaga,1994-03-12,01695532H,sara.gurrutxaga@smartapp.app,126346,ES11209547113786786463,1216.37,2022-11-13T05:05:42,Donostia,expenses,transport,-62.83,2718.78
buyer_5,Sara,Gurrutxaga,1994-03-12,01695532H,sara.gurrutxaga@smartapp.app,126346,ES11209547113786786463,1216.37,2022-11-13T18:57:54,Donostia,expenses,healthcare,-119.79,2598.99
buyer_5,Sara,Gurrutxaga,1994-03-12,01695532H,sara.gurrutxaga@smartapp.app,126346,ES11209547113786786463,1216.37,2022-11-15T13:21:30,Donostia,expenses,transport,-80.51,2518.48
buyer_5,Sara,Gurrutxaga,1994-03-12,01695532H,sara.gurrutxaga@smartapp.app,126346,ES11209547113786786463,1216.37,2022-11-19T16:57:43,Donostia,expenses,food,-72.98,2445.5
buyer_5,Sara,Gurrutxaga,1994-03-12,01695532H,sara.gurrutxaga@smartapp.app,126346,ES11209547113786786463,1216.37,2022-11-19T14:28:58,Donostia,expenses,leisure,-42.48,2403.02
buyer_5,Sara,Gurrutxaga,1994-03-12,01695532H,sara.gurrutxaga@smartapp.app,126346,ES11209547113786786463,1216.37,2022-11-21T09:13:15,Donostia,expenses,travel,-825.36,1577.66
buyer_5,Sara,Gurrutxaga,1994-03-12,01695532H,sara.gurrutxaga@smartapp.app,126346,ES11209547113786786463,1216.37,2022-11-21T09:50:33,Donostia,expenses,repairs,-146.08,1431.58
buyer_5,Sara,Gurrutxaga,1994-03-12,01695532H,sara.gurrutxaga@smartapp.app,126346,ES11209547113786786463,1216.37,2022-11-21T23:14:02,Donostia,expenses,gifts,-27.55,1404.03
buyer_5,Sara,Gurrutxaga,1994-03-12,01695532H,sara.gurrutxaga@smartapp.app,126346,ES11209547113786786463,1216.37,2022-11-24T10:27:45,Donostia,expenses,transport,-42.39,1361.64
buyer_5,Sara,Gurrutxaga,1994-03-12,01695532H,sara.gurrutxaga@smartapp.app,126346,ES11209547113786786463,1216.37,2022-11-26T21:41:20,Donostia,expenses,cash,-100.0,1261.64
buyer_5,Sara,Gurrutxaga,1994-03-12,01695532H,sara.gurrutxaga@smartapp.app,126346,ES11209547113786786463,1216.37,2022-11-27T21:41:20,Donostia,expenses,leisure,-30.54,1231.1
buyer_5,Sara,Gurrutxaga,1994-03-12,01695532H,sara.gurrutxaga@smartapp.app,126346,ES11209547113786786463,1216.37,2022-11-27T11:39:52,Donostia,expenses,repairs,-30.13,1200.97
buyer_5,Sara,Gurrutxaga,1994-03-12,01695532H,sara.gurrutxaga@smartapp.app,126346,ES11209547113786786463,1216.37,2022-11-28T07:10:21,Donostia,expenses,repairs,-202.28,998.69
buyer_5,Sara,Gurrutxaga,1994-03-12,01695532H,sara.gurrutxaga@smartapp.app,126346,ES11209547113786786463,1216.37,2022-11-28T01:27:50,Donostia,expenses,gifts,-124.09,874.6
buyer_5,Sara,Gurrutxaga,1994-03-12,01695532H,sara.gurrutxaga@smartapp.app,126346,ES11209547113786786463,1216.37,2022-11-30T12:53:09,Donostia,expenses,transport,-41.12,833.48
buyer_5,Sara,Gurrutxaga,1994-03-12,01695532H,sara.gurrutxaga@smartapp.app,126346,ES11209547113786786463,1216.37,2022-11-30T09:57:54,Donostia,expenses,cash,-100.0,733.48
buyer_5,Sara,Gurrutxaga,1994-03-12,01695532H,sara.gurrutxaga@smartapp.app,126346,ES11209547113786786463,1216.37,2022-11-30T14:37:43,Donostia,expenses,repairs,-325.72,407.76
buyer_5,Sara,Gurrutxaga,1994-03-12,01695532H,sara.gurrutxaga@smartapp.app,126346,ES11209547113786786463,1216.37,2022-12-01T19:05:10,Donostia,incomes,salary,2874.8,3282.56
buyer_5,Sara,Gurrutxaga,1994-03-12,01695532H,sara.gurrutxaga@smartapp.app,126346,ES11209547113786786463,1216.37,2022-12-01T19:05:10,Donostia,incomes,salary_partner,3005.77,6288.33
buyer_5,Sara,Gurrutxaga,1994-03-12,01695532H,sara.gurrutxaga@smartapp.app,126346,ES11209547113786786463,1216.37,2022-12-01T19:05:10,Donostia,incomes,salary_bonus,2228.82,8517.15
buyer_5,Sara,Gurrutxaga,1994-03-12,01695532H,sara.gurrutxaga@smartapp.app,126346,ES11209547113786786463,1216.37,2022-12-01T19:05:10,Donostia,incomes,salary_partner_bonus,2224.21,10741.36
buyer_5,Sara,Gurrutxaga,1994-03-12,01695532H,sara.gurrutxaga@smartapp.app,126346,ES11209547113786786463,1216.37,2022-12-01T08:22:55,Donostia,expenses,cash,-100.0,10641.36
buyer_5,Sara,Gurrutxaga,1994-03-12,01695532H,sara.gurrutxaga@smartapp.app,126346,ES11209547113786786463,1216.37,2022-12-04T20:15:54,Donostia,expenses,mortgage,-2550.4,8090.96
buyer_5,Sara,Gurrutxaga,1994-03-12,01695532H,sara.gurrutxaga@smartapp.app,126346,ES11209547113786786463,1216.37,2022-12-05T20:05:42,Donostia,expenses,water,-81.52,8009.44
buyer_5,Sara,Gurrutxaga,1994-03-12,01695532H,sara.gurrutxaga@smartapp.app,126346,ES11209547113786786463,1216.37,2022-12-05T15:32:25,Donostia,expenses,phone,-129.03,7880.41
buyer_5,Sara,Gurrutxaga,1994-03-12,01695532H,sara.gurrutxaga@smartapp.app,126346,ES11209547113786786463,1216.37,2022-12-05T10:56:40,Donostia,expenses,cash,-100.0,7780.41
buyer_5,Sara,Gurrutxaga,1994-03-12,01695532H,sara.gurrutxaga@smartapp.app,126346,ES11209547113786786463,1216.37,2022-12-06T02:38:10,Donostia,expenses,leisure,-80.5,7699.91
buyer_5,Sara,Gurrutxaga,1994-03-12,01695532H,sara.gurrutxaga@smartapp.app,126346,ES11209547113786786463,1216.37,2022-12-06T02:35:19,Donostia,expenses,education,-47.21,7652.7
buyer_5,Sara,Gurrutxaga,1994-03-12,01695532H,sara.gurrutxaga@smartapp.app,126346,ES11209547113786786463,1216.37,2022-12-06T15:01:17,Donostia,expenses,cash,-100.0,7552.7
buyer_5,Sara,Gurrutxaga,1994-03-12,01695532H,sara.gurrutxaga@smartapp.app,126346,ES11209547113786786463,1216.37,2022-12-07T22:41:33,Donostia,expenses,gas,-303.4,7249.3
buyer_5,Sara,Gurrutxaga,1994-03-12,01695532H,sara.gurrutxaga@smartapp.app,126346,ES11209547113786786463,1216.37,2022-12-07T18:16:32,Donostia,expenses,internet,-123.49,7125.81
buyer_5,Sara,Gurrutxaga,1994-03-12,01695532H,sara.gurrutxaga@smartapp.app,126346,ES11209547113786786463,1216.37,2022-12-07T15:56:13,Donostia,expenses,transport,-65.49,7060.32
buyer_5,Sara,Gurrutxaga,1994-03-12,01695532H,sara.gurrutxaga@smartapp.app,126346,ES11209547113786786463,1216.37,2022-12-08T00:06:21,Donostia,expenses,electricity,-83.68,6976.64
buyer_5,Sara,Gurrutxaga,1994-03-12,01695532H,sara.gurrutxaga@smartapp.app,126346,ES11209547113786786463,1216.37,2022-12-08T11:14:44,Donostia,expenses,cash,-100.0,6876.64
buyer_5,Sara,Gurrutxaga,1994-03-12,01695532H,sara.gurrutxaga@smartapp.app,126346,ES11209547113786786463,1216.37,2022-12-09T18:13:17,Donostia,expenses,education,-43.21,6833.43
buyer_5,Sara,Gurrutxaga,1994-03-12,01695532H,sara.gurrutxaga@smartapp.app,126346,ES11209547113786786463,1216.37,2022-12-09T12:37:31,Donostia,expenses,cash,-100.0,6733.43
buyer_5,Sara,Gurrutxaga,1994-03-12,01695532H,sara.gurrutxaga@smartapp.app,126346,ES11209547113786786463,1216.37,2022-12-10T01:45:54,Donostia,expenses,clothing,-155.35,6578.08
buyer_5,Sara,Gurrutxaga,1994-03-12,01695532H,sara.gurrutxaga@smartapp.app,126346,ES11209547113786786463,1216.37,2022-12-11T15:02:46,Donostia,expenses,leisure,-26.94,6551.14
buyer_5,Sara,Gurrutxaga,1994-03-12,01695532H,sara.gurrutxaga@smartapp.app,126346,ES11209547113786786463,1216.37,2022-12-12T19:59:48,Donostia,expenses,food,-122.88,6428.26
buyer_5,Sara,Gurrutxaga,1994-03-12,01695532H,sara.gurrutxaga@smartapp.app,126346,ES11209547113786786463,1216.37,2022-12-12T15:13:57,Donostia,expenses,gifts,-646.94,5781.32
buyer_5,Sara,Gurrutxaga,1994-03-12,01695532H,sara.gurrutxaga@smartapp.app,126346,ES11209547113786786463,1216.37,2022-12-17T11:39:30,Donostia,expenses,cash,-100.0,5681.32
buyer_5,Sara,Gurrutxaga,1994-03-12,01695532H,sara.gurrutxaga@smartapp.app,126346,ES11209547113786786463,1216.37,2022-12-19T08:46:46,Donostia,expenses,food,-87.69,5593.63
buyer_5,Sara,Gurrutxaga,1994-03-12,01695532H,sara.gurrutxaga@smartapp.app,126346,ES11209547113786786463,1216.37,2022-12-20T16:53:08,Donostia,expenses,education,-72.65,5520.98
buyer_5,Sara,Gurrutxaga,1994-03-12,01695532H,sara.gurrutxaga@smartapp.app,126346,ES11209547113786786463,1216.37,2022-12-22T12:06:45,Donostia,expenses,transport,-80.05,5440.93
buyer_5,Sara,Gurrutxaga,1994-03-12,01695532H,sara.gurrutxaga@smartapp.app,126346,ES11209547113786786463,1216.37,2022-12-22T11:46:21,Donostia,expenses,travel,-783.99,4656.94
buyer_5,Sara,Gurrutxaga,1994-03-12,01695532H,sara.gurrutxaga@smartapp.app,126346,ES11209547113786786463,1216.37,2022-12-23T09:32:52,Donostia,expenses,cash,-100.0,4556.94
buyer_5,Sara,Gurrutxaga,1994-03-12,01695532H,sara.gurrutxaga@smartapp.app,126346,ES11209547113786786463,1216.37,2022-12-28T21:04:41,Donostia,expenses,transport,-66.66,4490.28
buyer_5,Sara,Gurrutxaga,1994-03-12,01695532H,sara.gurrutxaga@smartapp.app,126346,ES11209547113786786463,1216.37,2022-12-28T07:07:10,Donostia,expenses,gifts,-407.06,4083.22
buyer_5,Sara,Gurrutxaga,1994-03-12,01695532H,sara.gurrutxaga@smartapp.app,126346,ES11209547113786786463,1216.37,2022-12-29T14:16:41,Donostia,expenses,food,-97.52,3985.7
buyer_5,Sara,Gurrutxaga,1994-03-12,01695532H,sara.gurrutxaga@smartapp.app,126346,ES11209547113786786463,1216.37,2022-12-30T19:42:43,Donostia,expenses,food,-123.64,3862.06
buyer_5,Sara,Gurrutxaga,1994-03-12,01695532H,sara.gurrutxaga@smartapp.app,126346,ES11209547113786786463,1216.37,2022-12-30T05:30:17,Donostia,expenses,leisure,-39.7,3822.36
buyer_5,Sara,Gurrutxaga,1994-03-12,01695532H,sara.gurrutxaga@smartapp.app,126346,ES11209547113786786463,1216.37,2022-12-31T22:57:23,Donostia,expenses,leisure,-27.44,3794.92
buyer_5,Sara,Gurrutxaga,1994-03-12,01695532H,sara.gurrutxaga@smartapp.app,126346,ES11209547113786786463,1216.37,2022-12-31T08:03:39,Donostia,expenses,healthcare,-90.29,3704.63
buyer_5,Sara,Gurrutxaga,1994-03-12,01695532H,sara.gurrutxaga@smartapp.app,126346,ES11209547113786786463,1216.37,2023-01-01T15:08:02,Donostia,incomes,salary,2964.06,6668.69
buyer_5,Sara,Gurrutxaga,1994-03-12,01695532H,sara.gurrutxaga@smartapp.app,126346,ES11209547113786786463,1216.37,2023-01-01T15:08:02,Donostia,incomes,salary_partner,3099.1,9767.79
buyer_5,Sara,Gurrutxaga,1994-03-12,01695532H,sara.gurrutxaga@smartapp.app,126346,ES11209547113786786463,1216.37,2023-01-03T22:04:46,Donostia,expenses,food,-69.58,9698.21
buyer_5,Sara,Gurrutxaga,1994-03-12,01695532H,sara.gurrutxaga@smartapp.app,126346,ES11209547113786786463,1216.37,2023-01-03T13:25:18,Donostia,expenses,healthcare,-66.61,9631.6
buyer_5,Sara,Gurrutxaga,1994-03-12,01695532H,sara.gurrutxaga@smartapp.app,126346,ES11209547113786786463,1216.37,2023-01-04T08:48:51,Donostia,expenses,mortgage,-2639.94,6991.66
buyer_5,Sara,Gurrutxaga,1994-03-12,01695532H,sara.gurrutxaga@smartapp.app,126346,ES11209547113786786463,1216.37,2023-01-05T19:50:11,Donostia,expenses,education,-60.1,6931.56
buyer_5,Sara,Gurrutxaga,1994-03-12,01695532H,sara.gurrutxaga@smartapp.app,126346,ES11209547113786786463,1216.37,2023-01-05T23:56:46,Donostia,expenses,repairs,-233.04,6698.52
buyer_5,Sara,Gurrutxaga,1994-03-12,01695532H,sara.gurrutxaga@smartapp.app,126346,ES11209547113786786463,1216.37,2023-01-06T13:22:28,Donostia,expenses,cash,-100.0,6598.52
buyer_5,Sara,Gurrutxaga,1994-03-12,01695532H,sara.gurrutxaga@smartapp.app,126346,ES11209547113786786463,1216.37,2023-01-08T11:39:53,Donostia,expenses,water,-130.44,6468.08
buyer_5,Sara,Gurrutxaga,1994-03-12,01695532H,sara.gurrutxaga@smartapp.app,126346,ES11209547113786786463,1216.37,2023-01-08T17:57:52,Donostia,expenses,electricity,-145.48,6322.6
buyer_5,Sara,Gurrutxaga,1994-03-12,01695532H,sara.gurrutxaga@smartapp.app,126346,ES11209547113786786463,1216.37,2023-01-08T12:48:47,Donostia,expenses,gas,-123.47,6199.13
buyer_5,Sara,Gurrutxaga,1994-03-12,01695532H,sara.gurrutxaga@smartapp.app,126346,ES11209547113786786463,1216.37,2023-01-08T12:43:03,Donostia,expenses,internet,-127.33,6071.8
buyer_5,Sara,Gurrutxaga,1994-03-12,01695532H,sara.gurrutxaga@smartapp.app,126346,ES11209547113786786463,1216.37,2023-01-08T15:32:38,Donostia,expenses,phone,-128.95,5942.85
buyer_5,Sara,Gurrutxaga,1994-03-12,01695532H,sara.gurrutxaga@smartapp.app,126346,ES11209547113786786463,1216.37,2023-01-09T13:22:38,Donostia,expenses,cash,-100.0,5842.85
buyer_5,Sara,Gurrutxaga,1994-03-12,01695532H,sara.gurrutxaga@smartapp.app,126346,ES11209547113786786463,1216.37,2023-01-10T04:04:42,Donostia,expenses,leisure,-61.99,5780.86
buyer_5,Sara,Gurrutxaga,1994-03-12,01695532H,sara.gurrutxaga@smartapp.app,126346,ES11209547113786786463,1216.37,2023-01-11T07:18:50,Donostia,expenses,transport,-50.08,5730.78
buyer_5,Sara,Gurrutxaga,1994-03-12,01695532H,sara.gurrutxaga@smartapp.app,126346,ES11209547113786786463,1216.37,2023-01-11T01:17:49,Donostia,expenses,healthcare,-150.42,5580.36
buyer_5,Sara,Gurrutxaga,1994-03-12,01695532H,sara.gurrutxaga@smartapp.app,126346,ES11209547113786786463,1216.37,2023-01-12T21:06:24,Donostia,expenses,food,-72.93,5507.43
buyer_5,Sara,Gurrutxaga,1994-03-12,01695532H,sara.gurrutxaga@smartapp.app,126346,ES11209547113786786463,1216.37,2023-01-12T11:19:16,Donostia,expenses,transport,-41.05,5466.38
buyer_5,Sara,Gurrutxaga,1994-03-12,01695532H,sara.gurrutxaga@smartapp.app,126346,ES11209547113786786463,1216.37,2023-01-13T08:54:45,Donostia,expenses,leisure,-84.11,5382.27
buyer_5,Sara,Gurrutxaga,1994-03-12,01695532H,sara.gurrutxaga@smartapp.app,126346,ES11209547113786786463,1216.37,2023-01-14T16:45:34,Donostia,expenses,cash,-100.0,5282.27
buyer_5,Sara,Gurrutxaga,1994-03-12,01695532H,sara.gurrutxaga@smartapp.app,126346,ES11209547113786786463,1216.37,2023-01-15T11:54:02,Donostia,expenses,repairs,-210.4,5071.87
buyer_5,Sara,Gurrutxaga,1994-03-12,01695532H,sara.gurrutxaga@smartapp.app,126346,ES11209547113786786463,1216.37,2023-01-16T13:35:27,Donostia,expenses,education,-66.0,5005.87
buyer_5,Sara,Gurrutxaga,1994-03-12,01695532H,sara.gurrutxaga@smartapp.app,126346,ES11209547113786786463,1216.37,2023-01-18T12:24:13,Donostia,expenses,gifts,-636.94,4368.93
buyer_5,Sara,Gurrutxaga,1994-03-12,01695532H,sara.gurrutxaga@smartapp.app,126346,ES11209547113786786463,1216.37,2023-01-20T18:54:33,Donostia,expenses,gifts,-656.9,3712.03
buyer_5,Sara,Gurrutxaga,1994-03-12,01695532H,sara.gurrutxaga@smartapp.app,126346,ES11209547113786786463,1216.37,2023-01-24T23:28:30,Donostia,expenses,food,-79.17,3632.86
buyer_5,Sara,Gurrutxaga,1994-03-12,01695532H,sara.gurrutxaga@smartapp.app,126346,ES11209547113786786463,1216.37,2023-01-24T11:44:09,Donostia,expenses,healthcare,-187.16,3445.7
buyer_5,Sara,Gurrutxaga,1994-03-12,01695532H,sara.gurrutxaga@smartapp.app,126346,ES11209547113786786463,1216.37,2023-01-26T08:06:25,Donostia,expenses,food,-101.78,3343.92
buyer_5,Sara,Gurrutxaga,1994-03-12,01695532H,sara.gurrutxaga@smartapp.app,126346,ES11209547113786786463,1216.37,2023-01-30T10:04:46,Donostia,expenses,food,-123.33,3220.59
buyer_5,Sara,Gurrutxaga,1994-03-12,01695532H,sara.gurrutxaga@smartapp.app,126346,ES11209547113786786463,1216.37,2023-01-30T17:44:51,Donostia,expenses,cash,-100.0,3120.59
buyer_5,Sara,Gurrutxaga,1994-03-12,01695532H,sara.gurrutxaga@smartapp.app,126346,ES11209547113786786463,1216.37,2023-02-01T08:11:35,Donostia,incomes,salary,2964.06,6084.65
buyer_5,Sara,Gurrutxaga,1994-03-12,01695532H,sara.gurrutxaga@smartapp.app,126346,ES11209547113786786463,1216.37,2023-02-01T08:11:35,Donostia,incomes,salary_partner,3099.1,9183.75
buyer_5,Sara,Gurrutxaga,1994-03-12,01695532H,sara.gurrutxaga@smartapp.app,126346,ES11209547113786786463,1216.37,2023-02-01T08:11:35,Donostia,incomes,extra_income,437.28,9621.03
buyer_5,Sara,Gurrutxaga,1994-03-12,01695532H,sara.gurrutxaga@smartapp.app,126346,ES11209547113786786463,1216.37,2023-02-02T21:59:57,Donostia,expenses,leisure,-24.78,9596.25
buyer_5,Sara,Gurrutxaga,1994-03-12,01695532H,sara.gurrutxaga@smartapp.app,126346,ES11209547113786786463,1216.37,2023-02-03T10:49:15,Donostia,expenses,transport,-58.5,9537.75
buyer_5,Sara,Gurrutxaga,1994-03-12,01695532H,sara.gurrutxaga@smartapp.app,126346,ES11209547113786786463,1216.37,2023-02-04T19:06:37,Donostia,expenses,mortgage,-2639.94,6897.81
buyer_5,Sara,Gurrutxaga,1994-03-12,01695532H,sara.gurrutxaga@smartapp.app,126346,ES11209547113786786463,1216.37,2023-02-04T16:50:07,Donostia,expenses,leisure,-79.89,6817.92
buyer_5,Sara,Gurrutxaga,1994-03-12,01695532H,sara.gurrutxaga@smartapp.app,126346,ES11209547113786786463,1216.37,2023-02-05T11:41:40,Donostia,expenses,water,-80.97,6736.95
buyer_5,Sara,Gurrutxaga,1994-03-12,01695532H,sara.gurrutxaga@smartapp.app,126346,ES11209547113786786463,1216.37,2023-02-05T15:20:43,Donostia,expenses,electricity,-136.41,6600.54
buyer_5,Sara,Gurrutxaga,1994-03-12,01695532H,sara.gurrutxaga@smartapp.app,126346,ES11209547113786786463,1216.37,2023-02-05T19:55:53,Donostia,expenses,phone,-123.2,6477.34
buyer_5,Sara,Gurrutxaga,1994-03-12,01695532H,sara.gurrutxaga@smartapp.app,126346,ES11209547113786786463,1216.37,2023-02-06T12:53:21,Donostia,expenses,gas,-282.67,6194.67
buyer_5,Sara,Gurrutxaga,1994-03-12,01695532H,sara.gurrutxaga@smartapp.app,126346,ES11209547113786786463,1216.37,2023-02-06T10:03:01,Donostia,expenses,healthcare,-112.29,6082.38
buyer_5,Sara,Gurrutxaga,1994-03-12,01695532H,sara.gurrutxaga@smartapp.app,126346,ES11209547113786786463,1216.37,2023-02-06T16:17:11,Donostia,expenses,cash,-100.0,5982.38
buyer_5,Sara,Gurrutxaga,1994-03-12,01695532H,sara.gurrutxaga@smartapp.app,126346,ES11209547113786786463,1216.37,2023-02-06T12:26:25,Donostia,expenses,gifts,-540.25,5442.13
buyer_5,Sara,Gurrutxaga,1994-03-12,01695532H,sara.gurrutxaga@smartapp.app,126346,ES11209547113786786463,1216.37,2023-02-07T09:00:25,Donostia,expenses,transport,-48.37,5393.76
buyer_5,Sara,Gurrutxaga,1994-03-12,01695532H,sara.gurrutxaga@smartapp.app,126346,ES11209547113786786463,1216.37,2023-02-07T14:17:19,Donostia,expenses,leisure,-19.6,5374.16
buyer_5,Sara,Gurrutxaga,1994-03-12,01695532H,sara.gurrutxaga@smartapp.app,126346,ES11209547113786786463,1216.37,2023-02-07T15:53:31,Donostia,expenses,gifts,-298.11,5076.05
buyer_5,Sara,Gurrutxaga,1994-03-12,01695532H,sara.gurrutxaga@smartapp.app,126346,ES11209547113786786463,1216.37,2023-02-08T08:39:05,Donostia,expenses,internet,-127.33,4948.72
buyer_5,Sara,Gurrutxaga,1994-03-12,01695532H,sara.gurrutxaga@smartapp.app,126346,ES11209547113786786463,1216.37,2023-02-08T08:03:57,Donostia,expenses,food,-82.82,4865.9
buyer_5,Sara,Gurrutxaga,1994-03-12,01695532H,sara.gurrutxaga@smartapp.app,126346,ES11209547113786786463,1216.37,2023-02-10T17:59:35,Donostia,expenses,transport,-51.58,4814.32
buyer_5,Sara,Gurrutxaga,1994-03-12,01695532H,sara.gurrutxaga@smartapp.app,126346,ES11209547113786786463,1216.37,2023-02-12T22:05:54,Donostia,expenses,food,-102.83,4711.49
buyer_5,Sara,Gurrutxaga,1994-03-12,01695532H,sara.gurrutxaga@smartapp.app,126346,ES11209547113786786463,1216.37,2023-02-13T18:49:42,Donostia,expenses,education,-77.77,4633.72
buyer_5,Sara,Gurrutxaga,1994-03-12,01695532H,sara.gurrutxaga@smartapp.app,126346,ES11209547113786786463,1216.37,2023-02-13T21:22:40,Donostia,expenses,cash,-100.0,4533.72
buyer_5,Sara,Gurrutxaga,1994-03-12,01695532H,sara.gurrutxaga@smartapp.app,126346,ES11209547113786786463,1216.37,2023-02-14T16:58:36,Donostia,expenses,food,-93.88,4439.84
buyer_5,Sara,Gurrutxaga,1994-03-12,01695532H,sara.gurrutxaga@smartapp.app,126346,ES11209547113786786463,1216.37,2023-02-15T08:50:06,Donostia,expenses,education,-43.97,4395.87
buyer_5,Sara,Gurrutxaga,1994-03-12,01695532H,sara.gurrutxaga@smartapp.app,126346,ES11209547113786786463,1216.37,2023-02-15T14:35:45,Donostia,expenses,appliances,-379.74,4016.13
buyer_5,Sara,Gurrutxaga,1994-03-12,01695532H,sara.gurrutxaga@smartapp.app,126346,ES11209547113786786463,1216.37,2023-02-19T14:21:30,Donostia,expenses,transport,-42.5,3973.63
buyer_5,Sara,Gurrutxaga,1994-03-12,01695532H,sara.gurrutxaga@smartapp.app,126346,ES11209547113786786463,1216.37,2023-02-23T05:07:46,Donostia,expenses,travel,-740.72,3232.91
buyer_5,Sara,Gurrutxaga,1994-03-12,01695532H,sara.gurrutxaga@smartapp.app,126346,ES11209547113786786463,1216.37,2023-02-24T09:01:09,Donostia,expenses,food,-76.74,3156.17
buyer_5,Sara,Gurrutxaga,1994-03-12,01695532H,sara.gurrutxaga@smartapp.app,126346,ES11209547113786786463,1216.37,2023-02-24T18:43:44,Donostia,expenses,leisure,-33.96,3122.21
buyer_5,Sara,Gurrutxaga,1994-03-12,01695532H,sara.gurrutxaga@smartapp.app,126346,ES11209547113786786463,1216.37,2023-02-26T13:51:17,Donostia,expenses,leisure,-84.4,3037.81
buyer_5,Sara,Gurrutxaga,1994-03-12,01695532H,sara.gurrutxaga@smartapp.app,126346,ES11209547113786786463,1216.37,2023-02-27T18:59:31,Donostia,expenses,transport,-64.4,2973.41
buyer_5,Sara,Gurrutxaga,1994-03-12,01695532H,sara.gurrutxaga@smartapp.app,126346,ES11209547113786786463,1216.37,2023-02-28T23:54:07,Donostia,expenses,transport,-55.09,2918.32
buyer_5,Sara,Gurrutxaga,1994-03-12,01695532H,sara.gurrutxaga@smartapp.app,126346,ES11209547113786786463,1216.37,2023-03-01T16:22:55,Donostia,incomes,salary,2964.06,5882.38
buyer_5,Sara,Gurrutxaga,1994-03-12,01695532H,sara.gurrutxaga@smartapp.app,126346,ES11209547113786786463,1216.37,2023-03-01T16:22:55,Donostia,incomes,salary_partner,3099.1,8981.48
buyer_5,Sara,Gurrutxaga,1994-03-12,01695532H,sara.gurrutxaga@smartapp.app,126346,ES11209547113786786463,1216.37,2023-03-01T12:47:39,Donostia,expenses,food,-61.01,8920.47
buyer_5,Sara,Gurrutxaga,1994-03-12,01695532H,sara.gurrutxaga@smartapp.app,126346,ES11209547113786786463,1216.37,2023-03-01T08:05:54,Donostia,expenses,transport,-72.56,8847.91
buyer_5,Sara,Gurrutxaga,1994-03-12,01695532H,sara.gurrutxaga@smartapp.app,126346,ES11209547113786786463,1216.37,2023-03-03T15:45:40,Donostia,expenses,leisure,-73.82,8774.09
buyer_5,Sara,Gurrutxaga,1994-03-12,01695532H,sara.gurrutxaga@smartapp.app,126346,ES11209547113786786463,1216.37,2023-03-03T11:29:55,Donostia,expenses,cash,-100.0,8674.09
buyer_5,Sara,Gurrutxaga,1994-03-12,01695532H,sara.gurrutxaga@smartapp.app,126346,ES11209547113786786463,1216.37,2023-03-04T05:17:51,Donostia,expenses,mortgage,-2639.94,6034.15
buyer_5,Sara,Gurrutxaga,1994-03-12,01695532H,sara.gurrutxaga@smartapp.app,126346,ES11209547113786786463,1216.37,2023-03-04T14:21:56,Donostia,expenses,clothing,-111.33,5922.82
buyer_5,Sara,Gurrutxaga,1994-03-12,01695532H,sara.gurrutxaga@smartapp.app,126346,ES11209547113786786463,1216.37,2023-03-05T14:20:17,Donostia,expenses,electricity,-125.44,5797.38
buyer_5,Sara,Gurrutxaga,1994-03-12,01695532H,sara.gurrutxaga@smartapp.app,126346,ES11209547113786786463,1216.37,2023-03-05T10:16:27,Donostia,expenses,cash,-100.0,5697.38
buyer_5,Sara,Gurrutxaga,1994-03-12,01695532H,sara.gurrutxaga@smartapp.app,126346,ES11209547113786786463,1216.37,2023-03-07T09:46:25,Donostia,expenses,water,-73.26,5624.12
buyer_5,Sara,Gurrutxaga,1994-03-12,01695532H,sara.gurrutxaga@smartapp.app,126346,ES11209547113786786463,1216.37,2023-03-08T11:10:39,Donostia,expenses,gas,-136.75,5487.37
buyer_5,Sara,Gurrutxaga,1994-03-12,01695532H,sara.gurrutxaga@smartapp.app,126346,ES11209547113786786463,1216.37,2023-03-08T17:13:35,Donostia,expenses,internet,-127.33,5360.04
buyer_5,Sara,Gurrutxaga,1994-03-12,01695532H,sara.gurrutxaga@smartapp.app,126346,ES11209547113786786463,1216.37,2023-03-08T16:50:07,Donostia,expenses,phone,-117.31,5242.73
buyer_5,Sara,Gurrutxaga,1994-03-12,01695532H,sara.gurrutxaga@smartapp.app,126346,ES11209547113786786463,1216.37,2023-03-09T10:16:52,Donostia,expenses,education,-73.35,5169.38
buyer_5,Sara,Gurrutxaga,1994-03-12,01695532H,sara.gurrutxaga@smartapp.app,126346,ES11209547113786786463,1216.37,2023-03-09T15:41:26,Donostia,expenses,cash,-100.0,5069.38
buyer_5,Sara,Gurrutxaga,1994-03-12,01695532H,sara.gurrutxaga@smartapp.app,126346,ES11209547113786786463,1216.37,2023-03-10T18:28:56,Donostia,expenses,food,-100.82,4968.56
buyer_5,Sara,Gurrutxaga,1994-03-12,01695532H,sara.gurrutxaga@smartapp.app,126346,ES11209547113786786463,1216.37,2023-03-12T02:15:08,Donostia,expenses,gifts,-463.21,4505.35
buyer_5,Sara,Gurrutxaga,1994-03-12,01695532H,sara.gurrutxaga@smartapp.app,126346,ES11209547113786786463,1216.37,2023-03-13T19:36:38,Donostia,expenses,food,-113.54,4391.81
buyer_5,Sara,Gurrutxaga,1994-03-12,01695532H,sara.gurrutxaga@smartapp.app,126346,ES11209547113786786463,1216.37,2023-03-14T10:05:25,Donostia,expenses,food,-70.35,4321.46
buyer_5,Sara,Gurrutxaga,1994-03-12,01695532H,sara.gurrutxaga@smartapp.app,126346,ES11209547113786786463,1216.37,2023-03-14T12:24:18,Donostia,expenses,clothing,-136.26,4185.2
buyer_5,Sara,Gurrutxaga,1994-03-12,01695532H,sara.gurrutxaga@smartapp.app,126346,ES11209547113786786463,1216.37,2023-03-15T14:25:15,Donostia,expenses,repairs,-187.2,3998.0
buyer_5,Sara,Gurrutxaga,1994-03-12,01695532H,sara.gurrutxaga@smartapp.app,126346,ES11209547113786786463,1216.37,2023-03-16T20:44:25,Donostia,expenses,transport,-42.2,3955.8
buyer_5,Sara,Gurrutxaga,1994-03-12,01695532H,sara.gurrutxaga@smartapp.app,126346,ES11209547113786786463,1216.37,2023-03-16T13:54:35,Donostia,expenses,leisure,-63.25,3892.55
buyer_5,Sara,Gurrutxaga,1994-03-12,01695532H,sara.gurrutxaga@smartapp.app,126346,ES11209547113786786463,1216.37,2023-03-16T18:45:48,Donostia,expenses,cash,-100.0,3792.55
buyer_5,Sara,Gurrutxaga,1994-03-12,01695532H,sara.gurrutxaga@smartapp.app,126346,ES11209547113786786463,1216.37,2023-03-17T15:26:03,Donostia,expenses,food,-68.76,3723.79
buyer_5,Sara,Gurrutxaga,1994-03-12,01695532H,sara.gurrutxaga@smartapp.app,126346,ES11209547113786786463,1216.37,2023-03-17T16:23:03,Donostia,expenses,leisure,-18.67,3705.12
buyer_5,Sara,Gurrutxaga,1994-03-12,01695532H,sara.gurrutxaga@smartapp.app,126346,ES11209547113786786463,1216.37,2023-03-17T19:23:18,Donostia,expenses,healthcare,-156.56,3548.56
buyer_5,Sara,Gurrutxaga,1994-03-12,01695532H,sara.gurrutxaga@smartapp.app,126346,ES11209547113786786463,1216.37,2023-03-18T14:22:58,Donostia,expenses,leisure,-57.93,3490.63
buyer_5,Sara,Gurrutxaga,1994-03-12,01695532H,sara.gurrutxaga@smartapp.app,126346,ES11209547113786786463,1216.37,2023-03-18T11:04:14,Donostia,expenses,cash,-100.0,3390.63
buyer_5,Sara,Gurrutxaga,1994-03-12,01695532H,sara.gurrutxaga@smartapp.app,126346,ES11209547113786786463,1216.37,2023-03-21T18:05:19,Donostia,expenses,transport,-54.48,3336.15
buyer_5,Sara,Gurrutxaga,1994-03-12,01695532H,sara.gurrutxaga@smartapp.app,126346,ES11209547113786786463,1216.37,2023-03-22T15:10:01,Donostia,expenses,clothing,-102.63,3233.52
buyer_5,Sara,Gurrutxaga,1994-03-12,01695532H,sara.gurrutxaga@smartapp.app,126346,ES11209547113786786463,1216.37,2023-03-22T01:58:02,Donostia,expenses,healthcare,-92.63,3140.89
buyer_5,Sara,Gurrutxaga,1994-03-12,01695532H,sara.gurrutxaga@smartapp.app,126346,ES11209547113786786463,1216.37,2023-03-22T16:33:21,Donostia,expenses,travel,-752.53,2388.36
buyer_5,Sara,Gurrutxaga,1994-03-12,01695532H,sara.gurrutxaga@smartapp.app,126346,ES11209547113786786463,1216.37,2023-03-23T02:57:52,Donostia,expenses,cash,-100.0,2288.36
buyer_5,Sara,Gurrutxaga,1994-03-12,01695532H,sara.gurrutxaga@smartapp.app,126346,ES11209547113786786463,1216.37,2023-03-26T08:45:56,Donostia,expenses,food,-68.9,2219.46
buyer_5,Sara,Gurrutxaga,1994-03-12,01695532H,sara.gurrutxaga@smartapp.app,126346,ES11209547113786786463,1216.37,2023-03-26T23:10:51,Donostia,expenses,transport,-78.36,2141.1
buyer_5,Sara,Gurrutxaga,1994-03-12,01695532H,sara.gurrutxaga@smartapp.app,126346,ES11209547113786786463,1216.37,2023-03-26T22:30:43,Donostia,expenses,cash,-100.0,2041.1
buyer_5,Sara,Gurrutxaga,1994-03-12,01695532H,sara.gurrutxaga@smartapp.app,126346,ES11209547113786786463,1216.37,2023-03-26T13:18:21,Donostia,expenses,appliances,-97.37,1943.73
buyer_5,Sara,Gurrutxaga,1994-03-12,01695532H,sara.gurrutxaga@smartapp.app,126346,ES11209547113786786463,1216.37,2023-03-28T19:20:59,Donostia,expenses,leisure,-83.34,1860.39
buyer_5,Sara,Gurrutxaga,1994-03-12,01695532H,sara.gurrutxaga@smartapp.app,126346,ES11209547113786786463,1216.37,2023-03-28T11:01:50,Donostia,expenses,cash,-100.0,1760.39
buyer_5,Sara,Gurrutxaga,1994-03-12,01695532H,sara.gurrutxaga@smartapp.app,126346,ES11209547113786786463,1216.37,2023-03-30T09:01:22,Donostia,expenses,food,-93.89,1666.5
buyer_5,Sara,Gurrutxaga,1994-03-12,01695532H,sara.gurrutxaga@smartapp.app,126346,ES11209547113786786463,1216.37,2023-04-01T20:09:43,Donostia,incomes,salary,2964.06,4630.56
buyer_5,Sara,Gurrutxaga,1994-03-12,01695532H,sara.gurrutxaga@smartapp.app,126346,ES11209547113786786463,1216.37,2023-04-01T20:09:43,Donostia,incomes,salary_partner,3099.1,7729.66
buyer_5,Sara,Gurrutxaga,1994-03-12,01695532H,sara.gurrutxaga@smartapp.app,126346,ES11209547113786786463,1216.37,2023-04-01T17:10:56,Donostia,expenses,gifts,-225.86,7503.8
buyer_5,Sara,Gurrutxaga,1994-03-12,01695532H,sara.gurrutxaga@smartapp.app,126346,ES11209547113786786463,1216.37,2023-04-02T15:43:41,Donostia,expenses,leisure,-31.17,7472.63
buyer_5,Sara,Gurrutxaga,1994-03-12,01695532H,sara.gurrutxaga@smartapp.app,126346,ES11209547113786786463,1216.37,2023-04-04T08:42:25,Donostia,expenses,mortgage,-2639.94,4832.69
buyer_5,Sara,Gurrutxaga,1994-03-12,01695532H,sara.gurrutxaga@smartapp.app,126346,ES11209547113786786463,1216.37,2023-04-05T08:49:10,Donostia,expenses,water,-117.08,4715.61
buyer_5,Sara,Gurrutxaga,1994-03-12,01695532H,sara.gurrutxaga@smartapp.app,126346,ES11209547113786786463,1216.37,2023-04-05T11:20:14,Donostia,expenses,electricity,-241.16,4474.45
buyer_5,Sara,Gurrutxaga,1994-03-12,01695532H,sara.gurrutxaga@smartapp.app,126346,ES11209547113786786463,1216.37,2023-04-05T06:04:13,Donostia,expenses,gas,-209.61,4264.84
buyer_5,Sara,Gurrutxaga,1994-03-12,01695532H,sara.gurrutxaga@smartapp.app,126346,ES11209547113786786463,1216.37,2023-04-05T18:54:56,Donostia,expenses,cash,-100.0,4164.84
buyer_5,Sara,Gurrutxaga,1994-03-12,01695532H,sara.gurrutxaga@smartapp.app,126346,ES11209547113786786463,1216.37,2023-04-06T20:45:45,Donostia,expenses,phone,-113.99,4050.85
buyer_5,Sara,Gurrutxaga,1994-03-12,01695532H,sara.gurrutxaga@smartapp.app,126346,ES11209547113786786463,1216.37,2023-04-06T19:41:47,Donostia,expenses,clothing,-78.8,3972.05
buyer_5,Sara,Gurrutxaga,1994-03-12,01695532H,sara.gurrutxaga@smartapp.app,126346,ES11209547113786786463,1216.37,2023-04-07T18:24:34,Donostia,expenses,education,-55.78,3916.27
buyer_5,Sara,Gurrutxaga,1994-03-12,01695532H,sara.gurrutxaga@smartapp.app,126346,ES11209547113786786463,1216.37,2023-04-08T12:37:42,Donostia,expenses,internet,-127.33,3788.94
buyer_5,Sara,Gurrutxaga,1994-03-12,01695532H,sara.gurrutxaga@smartapp.app,126346,ES11209547113786786463,1216.37,2023-04-08T16:17:10,Donostia,expenses,food,-82.92,3706.02
buyer_5,Sara,Gurrutxaga,1994-03-12,01695532H,sara.gurrutxaga@smartapp.app,126346,ES11209547113786786463,1216.37,2023-04-08T12:35:37,Donostia,expenses,leisure,-51.19,3654.83
buyer_5,Sara,Gurrutxaga,1994-03-12,01695532H,sara.gurrutxaga@smartapp.app,126346,ES11209547113786786463,1216.37,2023-04-09T20:44:45,Donostia,expenses,cash,-100.0,3554.83
buyer_5,Sara,Gurrutxaga,1994-03-12,01695532H,sara.gurrutxaga@smartapp.app,126346,ES11209547113786786463,1216.37,2023-04-10T17:38:23,Donostia,expenses,education,-68.68,3486.15
buyer_5,Sara,Gurrutxaga,1994-03-12,01695532H,sara.gurrutxaga@smartapp.app,126346,ES11209547113786786463,1216.37,2023-04-13T09:54:25,Donostia,expenses,food,-123.52,3362.63
buyer_5,Sara,Gurrutxaga,1994-03-12,01695532H,sara.gurrutxaga@smartapp.app,126346,ES11209547113786786463,1216.37,2023-04-13T17:59:11,Donostia,expenses,leisure,-55.76,3306.87
buyer_5,Sara,Gurrutxaga,1994-03-12,01695532H,sara.gurrutxaga@smartapp.app,126346,ES11209547113786786463,1216.37,2023-04-14T14:20:26,Donostia,expenses,transport,-59.87,3247.0
buyer_5,Sara,Gurrutxaga,1994-03-12,01695532H,sara.gurrutxaga@smartapp.app,126346,ES11209547113786786463,1216.37,2023-04-14T21:21:31,Donostia,expenses,leisure,-21.56,3225.44
buyer_5,Sara,Gurrutxaga,1994-03-12,01695532H,sara.gurrutxaga@smartapp.app,126346,ES11209547113786786463,1216.37,2023-04-14T16:10:48,Donostia,expenses,cash,-100.0,3125.44
buyer_5,Sara,Gurrutxaga,1994-03-12,01695532H,sara.gurrutxaga@smartapp.app,126346,ES11209547113786786463,1216.37,2023-04-16T10:11:05,Donostia,expenses,healthcare,-139.0,2986.44
buyer_5,Sara,Gurrutxaga,1994-03-12,01695532H,sara.gurrutxaga@smartapp.app,126346,ES11209547113786786463,1216.37,2023-04-17T02:45:43,Donostia,expenses,cash,-100.0,2886.44
buyer_5,Sara,Gurrutxaga,1994-03-12,01695532H,sara.gurrutxaga@smartapp.app,126346,ES11209547113786786463,1216.37,2023-04-20T21:44:40,Donostia,expenses,food,-67.05,2819.39
buyer_5,Sara,Gurrutxaga,1994-03-12,01695532H,sara.gurrutxaga@smartapp.app,126346,ES11209547113786786463,1216.37,2023-04-20T22:55:43,Donostia,expenses,cash,-100.0,2719.39
buyer_5,Sara,Gurrutxaga,1994-03-12,01695532H,sara.gurrutxaga@smartapp.app,126346,ES11209547113786786463,1216.37,2023-04-21T21:45:25,Donostia,expenses,leisure,-60.75,2658.64
buyer_5,Sara,Gurrutxaga,1994-03-12,01695532H,sara.gurrutxaga@smartapp.app,126346,ES11209547113786786463,1216.37,2023-04-23T13:53:30,Donostia,expenses,food,-124.19,2534.45
buyer_5,Sara,Gurrutxaga,1994-03-12,01695532H,sara.gurrutxaga@smartapp.app,126346,ES11209547113786786463,1216.37,2023-04-26T12:23:30,Donostia,expenses,cash,-100.0,2434.45
buyer_5,Sara,Gurrutxaga,1994-03-12,01695532H,sara.gurrutxaga@smartapp.app,126346,ES11209547113786786463,1216.37,2023-04-28T00:50:46,Donostia,expenses,gifts,-80.95,2353.5
buyer_5,Sara,Gurrutxaga,1994-03-12,01695532H,sara.gurrutxaga@smartapp.app,126346,ES11209547113786786463,1216.37,2023-04-30T19:20:06,Donostia,expenses,transport,-43.84,2309.66
buyer_5,Sara,Gurrutxaga,1994-03-12,01695532H,sara.gurrutxaga@smartapp.app,126346,ES11209547113786786463,1216.37,2023-05-01T18:32:24,Donostia,incomes,salary,2964.06,5273.72
buyer_5,Sara,Gurrutxaga,1994-03-12,01695532H,sara.gurrutxaga@smartapp.app,126346,ES11209547113786786463,1216.37,2023-05-01T18:32:24,Donostia,incomes,salary_partner,3099.1,8372.82
buyer_5,Sara,Gurrutxaga,1994-03-12,01695532H,sara.gurrutxaga@smartapp.app,126346,ES11209547113786786463,1216.37,2023-05-04T13:05:28,Donostia,expenses,mortgage,-2639.94,5732.88
buyer_5,Sara,Gurrutxaga,1994-03-12,01695532H,sara.gurrutxaga@smartapp.app,126346,ES11209547113786786463,1216.37,2023-05-05T02:32:11,Donostia,expenses,water,-121.34,5611.54
buyer_5,Sara,Gurrutxaga,1994-03-12,01695532H,sara.gurrutxaga@smartapp.app,126346,ES11209547113786786463,1216.37,2023-05-05T11:06:23,Donostia,expenses,phone,-118.2,5493.34
buyer_5,Sara,Gurrutxaga,1994-03-12,01695532H,sara.gurrutxaga@smartapp.app,126346,ES11209547113786786463,1216.37,2023-05-05T16:57:15,Donostia,expenses,cash,-100.0,5393.34
buyer_5,Sara,Gurrutxaga,1994-03-12,01695532H,sara.gurrutxaga@smartapp.app,126346,ES11209547113786786463,1216.37,2023-05-06T06:39:13,Donostia,expenses,electricity,-96.92,5296.42
buyer_5,Sara,Gurrutxaga,1994-03-12,01695532H,sara.gurrutxaga@smartapp.app,126346,ES11209547113786786463,1216.37,2023-05-06T18:26:11,Donostia,expenses,internet,-127.33,5169.09
buyer_5,Sara,Gurrutxaga,1994-03-12,01695532H,sara.gurrutxaga@smartapp.app,126346,ES11209547113786786463,1216.37,2023-05-07T10:00:53,Donostia,expenses,food,-106.84,5062.25
buyer_5,Sara,Gurrutxaga,1994-03-12,01695532H,sara.gurrutxaga@smartapp.app,126346,ES11209547113786786463,1216.37,2023-05-08T19:34:46,Donostia,expenses,gas,-278.33,4783.92
buyer_5,Sara,Gurrutxaga,1994-03-12,01695532H,sara.gurrutxaga@smartapp.app,126346,ES11209547113786786463,1216.37,2023-05-08T19:04:47,Donostia,expenses,food,-69.73,4714.19
buyer_5,Sara,Gurrutxaga,1994-03-12,01695532H,sara.gurrutxaga@smartapp.app,126346,ES11209547113786786463,1216.37,2023-05-08T09:16:54,Donostia,expenses,healthcare,-129.74,4584.45
buyer_5,Sara,Gurrutxaga,1994-03-12,01695532H,sara.gurrutxaga@smartapp.app,126346,ES11209547113786786463,1216.37,2023-05-10T20:24:55,Donostia,expenses,gifts,-61.13,4523.32
buyer_5,Sara,Gurrutxaga,1994-03-12,01695532H,sara.gurrutxaga@smartapp.app,126346,ES11209547113786786463,1216.37,2023-05-12T10:26:37,Donostia,expenses,food,-97.76,4425.56
buyer_5,Sara,Gurrutxaga,1994-03-12,01695532H,sara.gurrutxaga@smartapp.app,126346,ES11209547113786786463,1216.37,2023-05-15T19:38:10,Donostia,expenses,healthcare,-111.26,4314.3
buyer_5,Sara,Gurrutxaga,1994-03-12,01695532H,sara.gurrutxaga@smartapp.app,126346,ES11209547113786786463,1216.37,2023-05-15T13:11:32,Donostia,expenses,gifts,-704.35,3609.95
buyer_5,Sara,Gurrutxaga,1994-03-12,01695532H,sara.gurrutxaga@smartapp.app,126346,ES11209547113786786463,1216.37,2023-05-17T18:19:26,Donostia,expenses,cash,-100.0,3509.95
buyer_5,Sara,Gurrutxaga,1994-03-12,01695532H,sara.gurrutxaga@smartapp.app,126346,ES11209547113786786463,1216.37,2023-05-18T23:02:30,Donostia,expenses,food,-67.03,3442.92
buyer_5,Sara,Gurrutxaga,1994-03-12,01695532H,sara.gurrutxaga@smartapp.app,126346,ES11209547113786786463,1216.37,2023-05-18T11:23:08,Donostia,expenses,repairs,-109.42,3333.5
buyer_5,Sara,Gurrutxaga,1994-03-12,01695532H,sara.gurrutxaga@smartapp.app,126346,ES11209547113786786463,1216.37,2023-05-20T09:16:46,Donostia,expenses,food,-63.04,3270.46
buyer_5,Sara,Gurrutxaga,1994-03-12,01695532H,sara.gurrutxaga@smartapp.app,126346,ES11209547113786786463,1216.37,2023-05-20T20:14:50,Donostia,expenses,leisure,-22.08,3248.38
buyer_5,Sara,Gurrutxaga,1994-03-12,01695532H,sara.gurrutxaga@smartapp.app,126346,ES11209547113786786463,1216.37,2023-05-22T13:57:25,Donostia,expenses,food,-99.96,3148.42
buyer_5,Sara,Gurrutxaga,1994-03-12,01695532H,sara.gurrutxaga@smartapp.app,126346,ES11209547113786786463,1216.37,2023-05-22T16:39:14,Donostia,expenses,repairs,-144.27,3004.15
buyer_5,Sara,Gurrutxaga,1994-03-12,01695532H,sara.gurrutxaga@smartapp.app,126346,ES11209547113786786463,1216.37,2023-05-23T15:16:28,Donostia,expenses,leisure,-37.65,2966.5
buyer_5,Sara,Gurrutxaga,1994-03-12,01695532H,sara.gurrutxaga@smartapp.app,126346,ES11209547113786786463,1216.37,2023-05-23T14:47:59,Donostia,expenses,clothing,-46.61,2919.89
buyer_5,Sara,Gurrutxaga,1994-03-12,01695532H,sara.gurrutxaga@smartapp.app,126346,ES11209547113786786463,1216.37,2023-05-26T19:26:00,Donostia,expenses,leisure,-46.83,2873.06
buyer_5,Sara,Gurrutxaga,1994-03-12,01695532H,sara.gurrutxaga@smartapp.app,126346,ES11209547113786786463,1216.37,2023-05-26T23:25:27,Donostia,expenses,clothing,-121.6,2751.46
buyer_5,Sara,Gurrutxaga,1994-03-12,01695532H,sara.gurrutxaga@smartapp.app,126346,ES11209547113786786463,1216.37,2023-05-26T12:16:06,Donostia,expenses,cash,-100.0,2651.46
buyer_5,Sara,Gurrutxaga,1994-03-12,01695532H,sara.gurrutxaga@smartapp.app,126346,ES11209547113786786463,1216.37,2023-05-27T14:16:11,Donostia,expenses,clothing,-69.04,2582.42
buyer_5,Sara,Gurrutxaga,1994-03-12,01695532H,sara.gurrutxaga@smartapp.app,126346,ES11209547113786786463,1216.37,2023-05-31T22:24:02,Donostia,expenses,cash,-100.0,2482.42
buyer_5,Sara,Gurrutxaga,1994-03-12,01695532H,sara.gurrutxaga@smartapp.app,126346,ES11209547113786786463,1216.37,2023-06-01T22:57:43,Donostia,incomes,salary,2964.06,5446.48
buyer_5,Sara,Gurrutxaga,1994-03-12,01695532H,sara.gurrutxaga@smartapp.app,126346,ES11209547113786786463,1216.37,2023-06-01T22:57:43,Donostia,incomes,salary_partner,3099.1,8545.58
buyer_5,Sara,Gurrutxaga,1994-03-12,01695532H,sara.gurrutxaga@smartapp.app,126346,ES11209547113786786463,1216.37,2023-06-01T22:57:43,Donostia,incomes,extra_income,437.28,8982.86
buyer_5,Sara,Gurrutxaga,1994-03-12,01695532H,sara.gurrutxaga@smartapp.app,126346,ES11209547113786786463,1216.37,2023-06-01T22:57:43,Donostia,incomes,salary_bonus,2321.58,11304.44
buyer_5,Sara,Gurrutxaga,1994-03-12,01695532H,sara.gurrutxaga@smartapp.app,126346,ES11209547113786786463,1216.37,2023-06-01T22:57:43,Donostia,incomes,salary_partner_bonus,2368.51,13672.95
buyer_5,Sara,Gurrutxaga,1994-03-12,01695532H,sara.gurrutxaga@smartapp.app,126346,ES11209547113786786463,1216.37,2023-06-02T19:02:51,Donostia,expenses,leisure,-76.94,13596.01
buyer_5,Sara,Gurrutxaga,1994-03-12,01695532H,sara.gurrutxaga@smartapp.app,126346,ES11209547113786786463,1216.37,2023-06-03T17:57:40,Donostia,expenses,leisure,-70.93,13525.08
buyer_5,Sara,Gurrutxaga,1994-03-12,01695532H,sara.gurrutxaga@smartapp.app,126346,ES11209547113786786463,1216.37,2023-06-04T10:39:50,Donostia,expenses,mortgage,-2639.94,10885.14
buyer_5,Sara,Gurrutxaga,1994-03-12,01695532H,sara.gurrutxaga@smartapp.app,126346,ES11209547113786786463,1216.37,2023-06-04T15:43:21,Donostia,expenses,transport,-86.91,10798.23
buyer_5,Sara,Gurrutxaga,1994-03-12,01695532H,sara.gurrutxaga@smartapp.app,126346,ES11209547113786786463,1216.37,2023-06-05T07:09:45,Donostia,expenses,water,-90.57,10707.66
buyer_5,Sara,Gurrutxaga,1994-03-12,01695532H,sara.gurrutxaga@smartapp.app,126346,ES11209547113786786463,1216.37,2023-06-06T12:13:20,Donostia,expenses,gas,-247.86,10459.8
buyer_5,Sara,Gurrutxaga,1994-03-12,01695532H,sara.gurrutxaga@smartapp.app,126346,ES11209547113786786463,1216.37,2023-06-06T08:25:38,Donostia,expenses,food,-112.03,10347.77
buyer_5,Sara,Gurrutxaga,1994-03-12,01695532H,sara.gurrutxaga@smartapp.app,126346,ES11209547113786786463,1216.37,2023-06-06T12:42:47,Donostia,expenses,clothing,-153.12,10194.65
buyer_5,Sara,Gurrutxaga,1994-03-12,01695532H,sara.gurrutxaga@smartapp.app,126346,ES11209547113786786463,1216.37,2023-06-07T23:47:55,Donostia,expenses,phone,-124.58,10070.07
buyer_5,Sara,Gurrutxaga,1994-03-12,01695532H,sara.gurrutxaga@smartapp.app,126346,ES11209547113786786463,1216.37,2023-06-08T14:23:01,Donostia,expenses,electricity,-264.1,9805.97
buyer_5,Sara,Gurrutxaga,1994-03-12,01695532H,sara.gurrutxaga@smartapp.app,126346,ES11209547113786786463,1216.37,2023-06-08T11:49:27,Donostia,expenses,internet,-127.33,9678.64
buyer_5,Sara,Gurrutxaga,1994-03-12,01695532H,sara.gurrutxaga@smartapp.app,126346,ES11209547113786786463,1216.37,2023-06-08T12:11:34,Donostia,expenses,food,-96.56,9582.08
buyer_5,Sara,Gurrutxaga,1994-03-12,01695532H,sara.gurrutxaga@smartapp.app,126346,ES11209547113786786463,1216.37,2023-06-08T18:35:21,Donostia,expenses,cash,-100.0,9482.08
buyer_5,Sara,Gurrutxaga,1994-03-12,01695532H,sara.gurrutxaga@smartapp.app,126346,ES11209547113786786463,1216.37,2023-06-08T21:51:07,Donostia,expenses,repairs,-124.36,9357.72
buyer_5,Sara,Gurrutxaga,1994-03-12,01695532H,sara.gurrutxaga@smartapp.app,126346,ES11209547113786786463,1216.37,2023-06-08T20:24:26,Donostia,expenses,gifts,-316.4,9041.32
buyer_5,Sara,Gurrutxaga,1994-03-12,01695532H,sara.gurrutxaga@smartapp.app,126346,ES11209547113786786463,1216.37,2023-06-09T19:04:30,Donostia,expenses,leisure,-32.1,9009.22
buyer_5,Sara,Gurrutxaga,1994-03-12,01695532H,sara.gurrutxaga@smartapp.app,126346,ES11209547113786786463,1216.37,2023-06-11T17:24:55,Donostia,expenses,cash,-100.0,8909.22
buyer_5,Sara,Gurrutxaga,1994-03-12,01695532H,sara.gurrutxaga@smartapp.app,126346,ES11209547113786786463,1216.37,2023-06-12T19:03:14,Donostia,expenses,cash,-100.0,8809.22
buyer_5,Sara,Gurrutxaga,1994-03-12,01695532H,sara.gurrutxaga@smartapp.app,126346,ES11209547113786786463,1216.37,2023-06-13T10:05:51,Donostia,expenses,leisure,-58.58,8750.64
buyer_5,Sara,Gurrutxaga,1994-03-12,01695532H,sara.gurrutxaga@smartapp.app,126346,ES11209547113786786463,1216.37,2023-06-15T09:05:07,Donostia,expenses,food,-110.41,8640.23
buyer_5,Sara,Gurrutxaga,1994-03-12,01695532H,sara.gurrutxaga@smartapp.app,126346,ES11209547113786786463,1216.37,2023-06-18T23:14:53,Donostia,expenses,appliances,-356.21,8284.02
buyer_5,Sara,Gurrutxaga,1994-03-12,01695532H,sara.gurrutxaga@smartapp.app,126346,ES11209547113786786463,1216.37,2023-06-20T16:47:32,Donostia,expenses,travel,-1064.27,7219.75
buyer_5,Sara,Gurrutxaga,1994-03-12,01695532H,sara.gurrutxaga@smartapp.app,126346,ES11209547113786786463,1216.37,2023-06-20T13:51:19,Donostia,expenses,repairs,-64.7,7155.05
buyer_5,Sara,Gurrutxaga,1994-03-12,01695532H,sara.gurrutxaga@smartapp.app,126346,ES11209547113786786463,1216.37,2023-06-22T09:55:33,Donostia,expenses,clothing,-154.61,7000.44
buyer_5,Sara,Gurrutxaga,1994-03-12,01695532H,sara.gurrutxaga@smartapp.app,126346,ES11209547113786786463,1216.37,2023-06-22T11:57:01,Donostia,expenses,cash,-100.0,6900.44
buyer_5,Sara,Gurrutxaga,1994-03-12,01695532H,sara.gurrutxaga@smartapp.app,126346,ES11209547113786786463,1216.37,2023-06-23T07:19:25,Donostia,expenses,transport,-41.12,6859.32
buyer_5,Sara,Gurrutxaga,1994-03-12,01695532H,sara.gurrutxaga@smartapp.app,126346,ES11209547113786786463,1216.37,2023-06-24T09:44:53,Donostia,expenses,transport,-83.77,6775.55
buyer_5,Sara,Gurrutxaga,1994-03-12,01695532H,sara.gurrutxaga@smartapp.app,126346,ES11209547113786786463,1216.37,2023-06-26T08:21:59,Donostia,expenses,food,-103.05,6672.5
buyer_5,Sara,Gurrutxaga,1994-03-12,01695532H,sara.gurrutxaga@smartapp.app,126346,ES11209547113786786463,1216.37,2023-06-26T21:27:29,Donostia,expenses,cash,-100.0,6572.5
buyer_5,Sara,Gurrutxaga,1994-03-12,01695532H,sara.gurrutxaga@smartapp.app,126346,ES11209547113786786463,1216.37,2023-06-27T16:29:33,Donostia,expenses,leisure,-23.19,6549.31
buyer_5,Sara,Gurrutxaga,1994-03-12,01695532H,sara.gurrutxaga@smartapp.app,126346,ES11209547113786786463,1216.37,2023-06-28T14:38:54,Donostia,expenses,repairs,-70.3,6479.01
buyer_5,Sara,Gurrutxaga,1994-03-12,01695532H,sara.gurrutxaga@smartapp.app,126346,ES11209547113786786463,1216.37,2023-06-29T19:01:05,Donostia,expenses,education,-60.93,6418.08
buyer_5,Sara,Gurrutxaga,1994-03-12,01695532H,sara.gurrutxaga@smartapp.app,126346,ES11209547113786786463,1216.37,2023-06-29T12:18:38,Donostia,expenses,cash,-100.0,6318.08
buyer_5,Sara,Gurrutxaga,1994-03-12,01695532H,sara.gurrutxaga@smartapp.app,126346,ES11209547113786786463,1216.37,2023-06-30T21:54:42,Donostia,expenses,gifts,-43.86,6274.22
buyer_5,Sara,Gurrutxaga,1994-03-12,01695532H,sara.gurrutxaga@smartapp.app,126346,ES11209547113786786463,1216.37,2023-07-01T16:12:54,Donostia,incomes,salary,2964.06,9238.28
buyer_5,Sara,Gurrutxaga,1994-03-12,01695532H,sara.gurrutxaga@smartapp.app,126346,ES11209547113786786463,1216.37,2023-07-01T16:12:54,Donostia,incomes,salary_partner,3099.1,12337.38
buyer_5,Sara,Gurrutxaga,1994-03-12,01695532H,sara.gurrutxaga@smartapp.app,126346,ES11209547113786786463,1216.37,2023-07-03T08:32:50,Donostia,expenses,cash,-100.0,12237.38
buyer_5,Sara,Gurrutxaga,1994-03-12,01695532H,sara.gurrutxaga@smartapp.app,126346,ES11209547113786786463,1216.37,2023-07-04T22:01:47,Donostia,expenses,mortgage,-2639.94,9597.44
buyer_5,Sara,Gurrutxaga,1994-03-12,01695532H,sara.gurrutxaga@smartapp.app,126346,ES11209547113786786463,1216.37,2023-07-06T09:58:09,Donostia,expenses,electricity,-218.66,9378.78
buyer_5,Sara,Gurrutxaga,1994-03-12,01695532H,sara.gurrutxaga@smartapp.app,126346,ES11209547113786786463,1216.37,2023-07-06T23:25:12,Donostia,expenses,internet,-127.33,9251.45
buyer_5,Sara,Gurrutxaga,1994-03-12,01695532H,sara.gurrutxaga@smartapp.app,126346,ES11209547113786786463,1216.37,2023-07-07T11:27:03,Donostia,expenses,water,-110.19,9141.26
buyer_5,Sara,Gurrutxaga,1994-03-12,01695532H,sara.gurrutxaga@smartapp.app,126346,ES11209547113786786463,1216.37,2023-07-08T16:08:13,Donostia,expenses,gas,-92.61,9048.65
buyer_5,Sara,Gurrutxaga,1994-03-12,01695532H,sara.gurrutxaga@smartapp.app,126346,ES11209547113786786463,1216.37,2023-07-08T21:00:25,Donostia,expenses,phone,-125.06,8923.59
buyer_5,Sara,Gurrutxaga,1994-03-12,01695532H,sara.gurrutxaga@smartapp.app,126346,ES11209547113786786463,1216.37,2023-07-13T10:54:19,Donostia,expenses,leisure,-39.02,8884.57
buyer_5,Sara,Gurrutxaga,1994-03-12,01695532H,sara.gurrutxaga@smartapp.app,126346,ES11209547113786786463,1216.37,2023-07-14T07:23:48,Donostia,expenses,leisure,-76.69,8807.88
buyer_5,Sara,Gurrutxaga,1994-03-12,01695532H,sara.gurrutxaga@smartapp.app,126346,ES11209547113786786463,1216.37,2023-07-14T08:23:55,Donostia,expenses,cash,-100.0,8707.88
buyer_5,Sara,Gurrutxaga,1994-03-12,01695532H,sara.gurrutxaga@smartapp.app,126346,ES11209547113786786463,1216.37,2023-07-17T10:23:57,Donostia,expenses,appliances,-216.45,8491.43
buyer_5,Sara,Gurrutxaga,1994-03-12,01695532H,sara.gurrutxaga@smartapp.app,126346,ES11209547113786786463,1216.37,2023-07-18T10:51:59,Donostia,expenses,cash,-100.0,8391.43
buyer_5,Sara,Gurrutxaga,1994-03-12,01695532H,sara.gurrutxaga@smartapp.app,126346,ES11209547113786786463,1216.37,2023-07-19T14:18:42,Donostia,expenses,cash,-100.0,8291.43
buyer_5,Sara,Gurrutxaga,1994-03-12,01695532H,sara.gurrutxaga@smartapp.app,126346,ES11209547113786786463,1216.37,2023-07-20T11:58:38,Donostia,expenses,food,-120.2,8171.23
buyer_5,Sara,Gurrutxaga,1994-03-12,01695532H,sara.gurrutxaga@smartapp.app,126346,ES11209547113786786463,1216.37,2023-07-20T13:32:27,Donostia,expenses,healthcare,-78.05,8093.18
buyer_5,Sara,Gurrutxaga,1994-03-12,01695532H,sara.gurrutxaga@smartapp.app,126346,ES11209547113786786463,1216.37,2023-07-20T10:34:11,Donostia,expenses,repairs,-220.23,7872.95
buyer_5,Sara,Gurrutxaga,1994-03-12,01695532H,sara.gurrutxaga@smartapp.app,126346,ES11209547113786786463,1216.37,2023-07-21T16:08:45,Donostia,expenses,appliances,-128.01,7744.94
buyer_5,Sara,Gurrutxaga,1994-03-12,01695532H,sara.gurrutxaga@smartapp.app,126346,ES11209547113786786463,1216.37,2023-07-23T14:17:52,Donostia,expenses,food,-96.98,7647.96
buyer_5,Sara,Gurrutxaga,1994-03-12,01695532H,sara.gurrutxaga@smartapp.app,126346,ES11209547113786786463,1216.37,2023-07-23T23:34:34,Donostia,expenses,cash,-100.0,7547.96
buyer_5,Sara,Gurrutxaga,1994-03-12,01695532H,sara.gurrutxaga@smartapp.app,126346,ES11209547113786786463,1216.37,2023-07-25T10:40:56,Donostia,expenses,cash,-100.0,7447.96
buyer_5,Sara,Gurrutxaga,1994-03-12,01695532H,sara.gurrutxaga@smartapp.app,126346,ES11209547113786786463,1216.37,2023-07-26T22:04:37,Donostia,expenses,food,-99.08,7348.88
buyer_5,Sara,Gurrutxaga,1994-03-12,01695532H,sara.gurrutxaga@smartapp.app,126346,ES11209547113786786463,1216.37,2023-07-27T19:24:26,Donostia,expenses,leisure,-53.73,7295.15
buyer_5,Sara,Gurrutxaga,1994-03-12,01695532H,sara.gurrutxaga@smartapp.app,126346,ES11209547113786786463,1216.37,2023-07-27T15:51:02,Donostia,expenses,repairs,-177.23,7117.92
buyer_5,Sara,Gurrutxaga,1994-03-12,01695532H,sara.gurrutxaga@smartapp.app,126346,ES11209547113786786463,1216.37,2023-07-29T18:28:15,Donostia,expenses,appliances,-362.11,6755.81
buyer_5,Sara,Gurrutxaga,1994-03-12,01695532H,sara.gurrutxaga@smartapp.app,126346,ES11209547113786786463,1216.37,2023-07-31T04:19:56,Donostia,expenses,transport,-64.08,6691.73
buyer_5,Sara,Gurrutxaga,1994-03-12,01695532H,sara.gurrutxaga@smartapp.app,126346,ES11209547113786786463,1216.37,2023-08-01T10:54:26,Donostia,incomes,salary,2964.06,9655.79
buyer_5,Sara,Gurrutxaga,1994-03-12,01695532H,sara.gurrutxaga@smartapp.app,126346,ES11209547113786786463,1216.37,2023-08-01T10:54:26,Donostia,incomes,salary_partner,3099.1,12754.89
buyer_5,Sara,Gurrutxaga,1994-03-12,01695532H,sara.gurrutxaga@smartapp.app,126346,ES11209547113786786463,1216.37,2023-08-01T07:52:57,Donostia,expenses,food,-69.66,12685.23
buyer_5,Sara,Gurrutxaga,1994-03-12,01695532H,sara.gurrutxaga@smartapp.app,126346,ES11209547113786786463,1216.37,2023-08-02T12:54:24,Donostia,expenses,food,-107.12,12578.11
buyer_5,Sara,Gurrutxaga,1994-03-12,01695532H,sara.gurrutxaga@smartapp.app,126346,ES11209547113786786463,1216.37,2023-08-02T14:50:33,Donostia,expenses,cash,-100.0,12478.11
buyer_5,Sara,Gurrutxaga,1994-03-12,01695532H,sara.gurrutxaga@smartapp.app,126346,ES11209547113786786463,1216.37,2023-08-02T13:49:07,Donostia,expenses,gifts,-595.21,11882.9
buyer_5,Sara,Gurrutxaga,1994-03-12,01695532H,sara.gurrutxaga@smartapp.app,126346,ES11209547113786786463,1216.37,2023-08-03T20:04:43,Donostia,expenses,cash,-100.0,11782.9
buyer_5,Sara,Gurrutxaga,1994-03-12,01695532H,sara.gurrutxaga@smartapp.app,126346,ES11209547113786786463,1216.37,2023-08-04T06:50:38,Donostia,expenses,mortgage,-2639.94,9142.96
buyer_5,Sara,Gurrutxaga,1994-03-12,01695532H,sara.gurrutxaga@smartapp.app,126346,ES11209547113786786463,1216.37,2023-08-06T14:59:29,Donostia,expenses,gas,-273.66,8869.3
buyer_5,Sara,Gurrutxaga,1994-03-12,01695532H,sara.gurrutxaga@smartapp.app,126346,ES11209547113786786463,1216.37,2023-08-08T13:06:12,Donostia,expenses,water,-107.35,8761.95
buyer_5,Sara,Gurrutxaga,1994-03-12,01695532H,sara.gurrutxaga@smartapp.app,126346,ES11209547113786786463,1216.37,2023-08-08T10:02:24,Donostia,expenses,electricity,-247.68,8514.27
buyer_5,Sara,Gurrutxaga,1994-03-12,01695532H,sara.gurrutxaga@smartapp.app,126346,ES11209547113786786463,1216.37,2023-08-08T13:08:51,Donostia,expenses,internet,-127.33,8386.94
buyer_5,Sara,Gurrutxaga,1994-03-12,01695532H,sara.gurrutxaga@smartapp.app,126346,ES11209547113786786463,1216.37,2023-08-08T16:18:56,Donostia,expenses,phone,-120.84,8266.1
buyer_5,Sara,Gurrutxaga,1994-03-12,01695532H,sara.gurrutxaga@smartapp.app,126346,ES11209547113786786463,1216.37,2023-08-09T13:31:56,Donostia,expenses,gifts,-111.94,8154.16
buyer_5,Sara,Gurrutxaga,1994-03-12,01695532H,sara.gurrutxaga@smartapp.app,126346,ES11209547113786786463,1216.37,2023-08-10T13:52:47,Donostia,expenses,leisure,-35.33,8118.83
buyer_5,Sara,Gurrutxaga,1994-03-12,01695532H,sara.gurrutxaga@smartapp.app,126346,ES11209547113786786463,1216.37,2023-08-11T19:00:36,Donostia,expenses,food,-75.96,8042.87
buyer_5,Sara,Gurrutxaga,1994-03-12,01695532H,sara.gurrutxaga@smartapp.app,126346,ES11209547113786786463,1216.37,2023-08-11T10:07:30,Donostia,expenses,transport,-87.88,7954.99
buyer_5,Sara,Gurrutxaga,1994-03-12,01695532H,sara.gurrutxaga@smartapp.app,126346,ES11209547113786786463,1216.37,2023-08-17T15:36:42,Donostia,expenses,food,-106.1,7848.89
buyer_5,Sara,Gurrutxaga,1994-03-12,01695532H,sara.gurrutxaga@smartapp.app,126346,ES11209547113786786463,1216.37,2023-08-17T20:23:34,Donostia,expenses,education,-74.01,7774.88
buyer_5,Sara,Gurrutxaga,1994-03-12,01695532H,sara.gurrutxaga@smartapp.app,126346,ES11209547113786786463,1216.37,2023-08-17T18:13:30,Donostia,expenses,cash,-100.0,7674.88
buyer_5,Sara,Gurrutxaga,1994-03-12,01695532H,sara.gurrutxaga@smartapp.app,126346,ES11209547113786786463,1216.37,2023-08-19T15:17:01,Donostia,expenses,transport,-86.28,7588.6
buyer_5,Sara,Gurrutxaga,1994-03-12,01695532H,sara.gurrutxaga@smartapp.app,126346,ES11209547113786786463,1216.37,2023-08-20T17:20:27,Donostia,expenses,food,-66.09,7522.51
buyer_5,Sara,Gurrutxaga,1994-03-12,01695532H,sara.gurrutxaga@smartapp.app,126346,ES11209547113786786463,1216.37,2023-08-21T20:37:38,Donostia,expenses,healthcare,-63.18,7459.33
buyer_5,Sara,Gurrutxaga,1994-03-12,01695532H,sara.gurrutxaga@smartapp.app,126346,ES11209547113786786463,1216.37,2023-08-23T17:00:00,Donostia,expenses,food,-112.18,7347.15
buyer_5,Sara,Gurrutxaga,1994-03-12,01695532H,sara.gurrutxaga@smartapp.app,126346,ES11209547113786786463,1216.37,2023-08-23T20:08:22,Donostia,expenses,transport,-42.41,7304.74
buyer_5,Sara,Gurrutxaga,1994-03-12,01695532H,sara.gurrutxaga@smartapp.app,126346,ES11209547113786786463,1216.37,2023-08-26T16:02:09,Donostia,expenses,food,-67.63,7237.11
buyer_5,Sara,Gurrutxaga,1994-03-12,01695532H,sara.gurrutxaga@smartapp.app,126346,ES11209547113786786463,1216.37,2023-08-28T18:27:56,Donostia,expenses,cash,-100.0,7137.11
buyer_5,Sara,Gurrutxaga,1994-03-12,01695532H,sara.gurrutxaga@smartapp.app,126346,ES11209547113786786463,1216.37,2023-08-29T03:38:54,Donostia,expenses,cash,-100.0,7037.11
buyer_5,Sara,Gurrutxaga,1994-03-12,01695532H,sara.gurrutxaga@smartapp.app,126346,ES11209547113786786463,1216.37,2023-08-30T13:55:19,Donostia,expenses,food,-63.74,6973.37
buyer_5,Sara,Gurrutxaga,1994-03-12,01695532H,sara.gurrutxaga@smartapp.app,126346,ES11209547113786786463,1216.37,2023-09-01T18:00:51,Donostia,incomes,salary,2964.06,9937.43
buyer_5,Sara,Gurrutxaga,1994-03-12,01695532H,sara.gurrutxaga@smartapp.app,126346,ES11209547113786786463,1216.37,2023-09-01T18:00:51,Donostia,incomes,salary_partner,3099.1,13036.53
buyer_5,Sara,Gurrutxaga,1994-03-12,01695532H,sara.gurrutxaga@smartapp.app,126346,ES11209547113786786463,1216.37,2023-09-01T18:00:51,Donostia,incomes,extra_income,437.28,13473.81
buyer_5,Sara,Gurrutxaga,1994-03-12,01695532H,sara.gurrutxaga@smartapp.app,126346,ES11209547113786786463,1216.37,2023-09-04T20:17:23,Donostia,expenses,mortgage,-2639.94,10833.87
buyer_5,Sara,Gurrutxaga,1994-03-12,01695532H,sara.gurrutxaga@smartapp.app,126346,ES11209547113786786463,1216.37,2023-09-05T10:46:14,Donostia,expenses,education,-62.84,10771.03
buyer_5,Sara,Gurrutxaga,1994-03-12,01695532H,sara.gurrutxaga@smartapp.app,126346,ES11209547113786786463,1216.37,2023-09-05T17:31:39,Donostia,expenses,cash,-100.0,10671.03
buyer_5,Sara,Gurrutxaga,1994-03-12,01695532H,sara.gurrutxaga@smartapp.app,126346,ES11209547113786786463,1216.37,2023-09-05T19:50:54,Donostia,expenses,repairs,-316.32,10354.71
buyer_5,Sara,Gurrutxaga,1994-03-12,01695532H,sara.gurrutxaga@smartapp.app,126346,ES11209547113786786463,1216.37,2023-09-06T18:52:15,Donostia,expenses,repairs,-130.84,10223.87
buyer_5,Sara,Gurrutxaga,1994-03-12,01695532H,sara.gurrutxaga@smartapp.app,126346,ES11209547113786786463,1216.37,2023-09-07T12:06:10,Donostia,expenses,food,-102.71,10121.16
buyer_5,Sara,Gurrutxaga,1994-03-12,01695532H,sara.gurrutxaga@smartapp.app,126346,ES11209547113786786463,1216.37,2023-09-08T15:13:32,Donostia,expenses,water,-134.57,9986.59
buyer_5,Sara,Gurrutxaga,1994-03-12,01695532H,sara.gurrutxaga@smartapp.app,126346,ES11209547113786786463,1216.37,2023-09-08T18:52:24,Donostia,expenses,electricity,-86.71,9899.88
buyer_5,Sara,Gurrutxaga,1994-03-12,01695532H,sara.gurrutxaga@smartapp.app,126346,ES11209547113786786463,1216.37,2023-09-08T12:21:57,Donostia,expenses,phone,-135.11,9764.77
buyer_5,Sara,Gurrutxaga,1994-03-12,01695532H,sara.gurrutxaga@smartapp.app,126346,ES11209547113786786463,1216.37,2023-09-08T12:55:07,Donostia,expenses,gas,-309.86,9454.91
buyer_5,Sara,Gurrutxaga,1994-03-12,01695532H,sara.gurrutxaga@smartapp.app,126346,ES11209547113786786463,1216.37,2023-09-08T10:58:03,Donostia,expenses,internet,-127.33,9327.58
buyer_5,Sara,Gurrutxaga,1994-03-12,01695532H,sara.gurrutxaga@smartapp.app,126346,ES11209547113786786463,1216.37,2023-09-08T16:27:39,Donostia,expenses,food,-123.15,9204.43
buyer_5,Sara,Gurrutxaga,1994-03-12,01695532H,sara.gurrutxaga@smartapp.app,126346,ES11209547113786786463,1216.37,2023-09-08T09:11:46,Donostia,expenses,leisure,-43.61,9160.82
buyer_5,Sara,Gurrutxaga,1994-03-12,01695532H,sara.gurrutxaga@smartapp.app,126346,ES11209547113786786463,1216.37,2023-09-09T18:31:28,Donostia,expenses,transport,-58.85,9101.97
buyer_5,Sara,Gurrutxaga,1994-03-12,01695532H,sara.gurrutxaga@smartapp.app,126346,ES11209547113786786463,1216.37,2023-09-10T19:21:29,Donostia,expenses,clothing,-89.77,9012.2
buyer_5,Sara,Gurrutxaga,1994-03-12,01695532H,sara.gurrutxaga@smartapp.app,126346,ES11209547113786786463,1216.37,2023-09-15T17:21:36,Donostia,expenses,gifts,-445.84,8566.36
buyer_5,Sara,Gurrutxaga,1994-03-12,01695532H,sara.gurrutxaga@smartapp.app,126346,ES11209547113786786463,1216.37,2023-09-17T08:57:02,Donostia,expenses,transport,-66.12,8500.24
buyer_5,Sara,Gurrutxaga,1994-03-12,01695532H,sara.gurrutxaga@smartapp.app,126346,ES11209547113786786463,1216.37,2023-09-19T13:04:08,Donostia,expenses,clothing,-140.3,8359.94
buyer_5,Sara,Gurrutxaga,1994-03-12,01695532H,sara.gurrutxaga@smartapp.app,126346,ES11209547113786786463,1216.37,2023-09-19T06:30:01,Donostia,expenses,cash,-100.0,8259.94
buyer_5,Sara,Gurrutxaga,1994-03-12,01695532H,sara.gurrutxaga@smartapp.app,126346,ES11209547113786786463,1216.37,2023-09-20T09:05:22,Donostia,expenses,healthcare,-110.03,8149.91
buyer_5,Sara,Gurrutxaga,1994-03-12,01695532H,sara.gurrutxaga@smartapp.app,126346,ES11209547113786786463,1216.37,2023-09-20T05:10:40,Donostia,expenses,cash,-100.0,8049.91
buyer_5,Sara,Gurrutxaga,1994-03-12,01695532H,sara.gurrutxaga@smartapp.app,126346,ES11209547113786786463,1216.37,2023-09-21T17:46:51,Donostia,expenses,food,-98.09,7951.82
buyer_5,Sara,Gurrutxaga,1994-03-12,01695532H,sara.gurrutxaga@smartapp.app,126346,ES11209547113786786463,1216.37,2023-09-22T19:16:46,Donostia,expenses,food,-85.38,7866.44
buyer_5,Sara,Gurrutxaga,1994-03-12,01695532H,sara.gurrutxaga@smartapp.app,126346,ES11209547113786786463,1216.37,2023-09-24T11:57:27,Donostia,expenses,transport,-62.1,7804.34
buyer_5,Sara,Gurrutxaga,1994-03-12,01695532H,sara.gurrutxaga@smartapp.app,126346,ES11209547113786786463,1216.37,2023-09-24T16:25:06,Donostia,expenses,cash,-100.0,7704.34
buyer_5,Sara,Gurrutxaga,1994-03-12,01695532H,sara.gurrutxaga@smartapp.app,126346,ES11209547113786786463,1216.37,2023-09-25T11:11:20,Donostia,expenses,transport,-44.34,7660.0
buyer_5,Sara,Gurrutxaga,1994-03-12,01695532H,sara.gurrutxaga@smartapp.app,126346,ES11209547113786786463,1216.37,2023-09-25T13:53:10,Donostia,expenses,appliances,-124.52,7535.48
buyer_5,Sara,Gurrutxaga,1994-03-12,01695532H,sara.gurrutxaga@smartapp.app,126346,ES11209547113786786463,1216.37,2023-09-27T16:57:55,Donostia,expenses,cash,-100.0,7435.48
buyer_5,Sara,Gurrutxaga,1994-03-12,01695532H,sara.gurrutxaga@smartapp.app,126346,ES11209547113786786463,1216.37,2023-09-30T12:23:14,Donostia,expenses,cash,-100.0,7335.48
buyer_5,Sara,Gurrutxaga,1994-03-12,01695532H,sara.gurrutxaga@smartapp.app,126346,ES11209547113786786463,1216.37,2023-10-01T14:14:48,Donostia,incomes,salary,2964.06,10299.54
buyer_5,Sara,Gurrutxaga,1994-03-12,01695532H,sara.gurrutxaga@smartapp.app,126346,ES11209547113786786463,1216.37,2023-10-01T14:14:48,Donostia,incomes,salary_partner,3099.1,13398.64
buyer_5,Sara,Gurrutxaga,1994-03-12,01695532H,sara.gurrutxaga@smartapp.app,126346,ES11209547113786786463,1216.37,2023-10-01T19:47:07,Donostia,expenses,food,-87.49,13311.15
buyer_5,Sara,Gurrutxaga,1994-03-12,01695532H,sara.gurrutxaga@smartapp.app,126346,ES11209547113786786463,1216.37,2023-10-02T18:33:11,Donostia,expenses,food,-75.99,13235.16
buyer_5,Sara,Gurrutxaga,1994-03-12,01695532H,sara.gurrutxaga@smartapp.app,126346,ES11209547113786786463,1216.37,2023-10-02T09:11:23,Donostia,expenses,healthcare,-67.85,13167.31
buyer_5,Sara,Gurrutxaga,1994-03-12,01695532H,sara.gurrutxaga@smartapp.app,126346,ES11209547113786786463,1216.37,2023-10-03T22:48:32,Donostia,expenses,food,-121.44,13045.87
buyer_5,Sara,Gurrutxaga,1994-03-12,01695532H,sara.gurrutxaga@smartapp.app,126346,ES11209547113786786463,1216.37,2023-10-04T19:57:25,Donostia,expenses,mortgage,-2639.94,10405.93
buyer_5,Sara,Gurrutxaga,1994-03-12,01695532H,sara.gurrutxaga@smartapp.app,126346,ES11209547113786786463,1216.37,2023-10-04T09:50:52,Donostia,expenses,cash,-100.0,10305.93
buyer_5,Sara,Gurrutxaga,1994-03-12,01695532H,sara.gurrutxaga@smartapp.app,126346,ES11209547113786786463,1216.37,2023-10-05T11:34:27,Donostia,expenses,water,-128.92,10177.01
buyer_5,Sara,Gurrutxaga,1994-03-12,01695532H,sara.gurrutxaga@smartapp.app,126346,ES11209547113786786463,1216.37,2023-10-05T17:43:01,Donostia,expenses,electricity,-91.37,10085.64
buyer_5,Sara,Gurrutxaga,1994-03-12,01695532H,sara.gurrutxaga@smartapp.app,126346,ES11209547113786786463,1216.37,2023-10-08T20:25:43,Donostia,expenses,internet,-127.33,9958.31
buyer_5,Sara,Gurrutxaga,1994-03-12,01695532H,sara.gurrutxaga@smartapp.app,126346,ES11209547113786786463,1216.37,2023-10-08T12:56:08,Donostia,expenses,phone,-126.28,9832.03
buyer_5,Sara,Gurrutxaga,1994-03-12,01695532H,sara.gurrutxaga@smartapp.app,126346,ES11209547113786786463,1216.37,2023-10-08T19:14:31,Donostia,expenses,gas,-129.29,9702.74
buyer_5,Sara,Gurrutxaga,1994-03-12,01695532H,sara.gurrutxaga@smartapp.app,126346,ES11209547113786786463,1216.37,2023-10-08T21:00:14,Donostia,expenses,leisure,-72.87,9629.87
buyer_5,Sara,Gurrutxaga,1994-03-12,01695532H,sara.gurrutxaga@smartapp.app,126346,ES11209547113786786463,1216.37,2023-10-08T18:09:55,Donostia,expenses,education,-71.24,9558.63
buyer_5,Sara,Gurrutxaga,1994-03-12,01695532H,sara.gurrutxaga@smartapp.app,126346,ES11209547113786786463,1216.37,2023-10-11T13:23:48,Donostia,expenses,food,-95.59,9463.04
buyer_5,Sara,Gurrutxaga,1994-03-12,01695532H,sara.gurrutxaga@smartapp.app,126346,ES11209547113786786463,1216.37,2023-10-11T19:09:43,Donostia,expenses,clothing,-72.05,9390.99
buyer_5,Sara,Gurrutxaga,1994-03-12,01695532H,sara.gurrutxaga@smartapp.app,126346,ES11209547113786786463,1216.37,2023-10-11T08:07:06,Donostia,expenses,travel,-526.85,8864.14
buyer_5,Sara,Gurrutxaga,1994-03-12,01695532H,sara.gurrutxaga@smartapp.app,126346,ES11209547113786786463,1216.37,2023-10-11T08:10:46,Donostia,expenses,appliances,-359.86,8504.28
buyer_5,Sara,Gurrutxaga,1994-03-12,01695532H,sara.gurrutxaga@smartapp.app,126346,ES11209547113786786463,1216.37,2023-10-12T15:56:55,Donostia,expenses,appliances,-181.94,8322.34
buyer_5,Sara,Gurrutxaga,1994-03-12,01695532H,sara.gurrutxaga@smartapp.app,126346,ES11209547113786786463,1216.37,2023-10-15T08:06:09,Donostia,expenses,healthcare,-93.45,8228.89
buyer_5,Sara,Gurrutxaga,1994-03-12,01695532H,sara.gurrutxaga@smartapp.app,126346,ES11209547113786786463,1216.37,2023-10-15T19:25:20,Donostia,expenses,cash,-100.0,8128.89
buyer_5,Sara,Gurrutxaga,1994-03-12,01695532H,sara.gurrutxaga@smartapp.app,126346,ES11209547113786786463,1216.37,2023-10-16T11:34:31,Donostia,expenses,appliances,-159.91,7968.98
buyer_5,Sara,Gurrutxaga,1994-03-12,01695532H,sara.gurrutxaga@smartapp.app,126346,ES11209547113786786463,1216.37,2023-10-17T18:33:50,Donostia,expenses,cash,-100.0,7868.98
buyer_5,Sara,Gurrutxaga,1994-03-12,01695532H,sara.gurrutxaga@smartapp.app,126346,ES11209547113786786463,1216.37,2023-10-20T18:55:12,Donostia,expenses,leisure,-20.21,7848.77
buyer_5,Sara,Gurrutxaga,1994-03-12,01695532H,sara.gurrutxaga@smartapp.app,126346,ES11209547113786786463,1216.37,2023-10-20T20:23:53,Donostia,expenses,healthcare,-180.04,7668.73
buyer_5,Sara,Gurrutxaga,1994-03-12,01695532H,sara.gurrutxaga@smartapp.app,126346,ES11209547113786786463,1216.37,2023-10-21T20:16:30,Donostia,expenses,food,-73.89,7594.84
buyer_5,Sara,Gurrutxaga,1994-03-12,01695532H,sara.gurrutxaga@smartapp.app,126346,ES11209547113786786463,1216.37,2023-10-22T10:32:21,Donostia,expenses,gifts,-759.04,6835.8
buyer_5,Sara,Gurrutxaga,1994-03-12,01695532H,sara.gurrutxaga@smartapp.app,126346,ES11209547113786786463,1216.37,2023-10-23T09:40:58,Donostia,expenses,clothing,-54.41,6781.39
buyer_5,Sara,Gurrutxaga,1994-03-12,01695532H,sara.gurrutxaga@smartapp.app,126346,ES11209547113786786463,1216.37,2023-10-25T11:43:11,Donostia,expenses,food,-116.97,6664.42
buyer_5,Sara,Gurrutxaga,1994-03-12,01695532H,sara.gurrutxaga@smartapp.app,126346,ES11209547113786786463,1216.37,2023-10-25T18:48:51,Donostia,expenses,leisure,-53.54,6610.88
buyer_5,Sara,Gurrutxaga,1994-03-12,01695532H,sara.gurrutxaga@smartapp.app,126346,ES11209547113786786463,1216.37,2023-10-26T14:37:49,Donostia,expenses,food,-89.18,6521.7
buyer_5,Sara,Gurrutxaga,1994-03-12,01695532H,sara.gurrutxaga@smartapp.app,126346,ES11209547113786786463,1216.37,2023-10-27T20:14:25,Donostia,expenses,food,-68.79,6452.91
buyer_5,Sara,Gurrutxaga,1994-03-12,01695532H,sara.gurrutxaga@smartapp.app,126346,ES11209547113786786463,1216.37,2023-10-27T15:20:38,Donostia,expenses,transport,-75.61,6377.3
buyer_5,Sara,Gurrutxaga,1994-03-12,01695532H,sara.gurrutxaga@smartapp.app,126346,ES11209547113786786463,1216.37,2023-10-28T08:53:33,Donostia,expenses,travel,-475.7,5901.6
buyer_5,Sara,Gurrutxaga,1994-03-12,01695532H,sara.gurrutxaga@smartapp.app,126346,ES11209547113786786463,1216.37,2023-10-29T11:19:38,Donostia,expenses,healthcare,-84.11,5817.49
buyer_5,Sara,Gurrutxaga,1994-03-12,01695532H,sara.gurrutxaga@smartapp.app,126346,ES11209547113786786463,1216.37,2023-10-30T16:53:25,Donostia,expenses,education,-58.31,5759.18
buyer_5,Sara,Gurrutxaga,1994-03-12,01695532H,sara.gurrutxaga@smartapp.app,126346,ES11209547113786786463,1216.37,2023-10-30T12:04:17,Donostia,expenses,repairs,-242.4,5516.78
buyer_5,Sara,Gurrutxaga,1994-03-12,01695532H,sara.gurrutxaga@smartapp.app,126346,ES11209547113786786463,1216.37,2023-11-01T14:05:18,Donostia,incomes,salary,2964.06,8480.84
buyer_5,Sara,Gurrutxaga,1994-03-12,01695532H,sara.gurrutxaga@smartapp.app,126346,ES11209547113786786463,1216.37,2023-11-01T14:05:18,Donostia,incomes,salary_partner,3099.1,11579.94
buyer_5,Sara,Gurrutxaga,1994-03-12,01695532H,sara.gurrutxaga@smartapp.app,126346,ES11209547113786786463,1216.37,2023-11-01T17:16:47,Donostia,expenses,cash,-100.0,11479.94
buyer_5,Sara,Gurrutxaga,1994-03-12,01695532H,sara.gurrutxaga@smartapp.app,126346,ES11209547113786786463,1216.37,2023-11-02T15:01:53,Donostia,expenses,leisure,-77.97,11401.97
buyer_5,Sara,Gurrutxaga,1994-03-12,01695532H,sara.gurrutxaga@smartapp.app,126346,ES11209547113786786463,1216.37,2023-11-02T20:15:29,Donostia,expenses,cash,-100.0,11301.97
buyer_5,Sara,Gurrutxaga,1994-03-12,01695532H,sara.gurrutxaga@smartapp.app,126346,ES11209547113786786463,1216.37,2023-11-04T05:46:02,Donostia,expenses,mortgage,-2639.94,8662.03
buyer_5,Sara,Gurrutxaga,1994-03-12,01695532H,sara.gurrutxaga@smartapp.app,126346,ES11209547113786786463,1216.37,2023-11-05T11:34:56,Donostia,expenses,repairs,-135.25,8526.78
buyer_5,Sara,Gurrutxaga,1994-03-12,01695532H,sara.gurrutxaga@smartapp.app,126346,ES11209547113786786463,1216.37,2023-11-06T15:36:24,Donostia,expenses,gas,-210.64,8316.14
buyer_5,Sara,Gurrutxaga,1994-03-12,01695532H,sara.gurrutxaga@smartapp.app,126346,ES11209547113786786463,1216.37,2023-11-06T20:03:05,Donostia,expenses,leisure,-22.51,8293.63
buyer_5,Sara,Gurrutxaga,1994-03-12,01695532H,sara.gurrutxaga@smartapp.app,126346,ES11209547113786786463,1216.37,2023-11-07T14:16:46,Donostia,expenses,electricity,-190.8,8102.83
buyer_5,Sara,Gurrutxaga,1994-03-12,01695532H,sara.gurrutxaga@smartapp.app,126346,ES11209547113786786463,1216.37,2023-11-07T13:36:52,Donostia,expenses,phone,-111.08,7991.75
buyer_5,Sara,Gurrutxaga,1994-03-12,01695532H,sara.gurrutxaga@smartapp.app,126346,ES11209547113786786463,1216.37,2023-11-08T00:57:19,Donostia,expenses,internet,-127.33,7864.42
buyer_5,Sara,Gurrutxaga,1994-03-12,01695532H,sara.gurrutxaga@smartapp.app,126346,ES11209547113786786463,1216.37,2023-11-08T04:53:04,Donostia,expenses,water,-89.33,7775.09
buyer_5,Sara,Gurrutxaga,1994-03-12,01695532H,sara.gurrutxaga@smartapp.app,126346,ES11209547113786786463,1216.37,2023-11-11T15:49:40,Donostia,expenses,leisure,-50.03,7725.06
buyer_5,Sara,Gurrutxaga,1994-03-12,01695532H,sara.gurrutxaga@smartapp.app,126346,ES11209547113786786463,1216.37,2023-11-12T10:20:12,Donostia,expenses,leisure,-31.68,7693.38
buyer_5,Sara,Gurrutxaga,1994-03-12,01695532H,sara.gurrutxaga@smartapp.app,126346,ES11209547113786786463,1216.37,2023-11-14T18:54:21,Donostia,expenses,clothing,-74.37,7619.01
buyer_5,Sara,Gurrutxaga,1994-03-12,01695532H,sara.gurrutxaga@smartapp.app,126346,ES11209547113786786463,1216.37,2023-11-15T12:25:46,Donostia,expenses,cash,-100.0,7519.01
buyer_5,Sara,Gurrutxaga,1994-03-12,01695532H,sara.gurrutxaga@smartapp.app,126346,ES11209547113786786463,1216.37,2023-11-15T17:52:58,Donostia,expenses,repairs,-93.68,7425.33
buyer_5,Sara,Gurrutxaga,1994-03-12,01695532H,sara.gurrutxaga@smartapp.app,126346,ES11209547113786786463,1216.37,2023-11-16T09:57:01,Donostia,expenses,leisure,-80.05,7345.28
buyer_5,Sara,Gurrutxaga,1994-03-12,01695532H,sara.gurrutxaga@smartapp.app,126346,ES11209547113786786463,1216.37,2023-11-16T12:44:44,Donostia,expenses,cash,-100.0,7245.28
buyer_5,Sara,Gurrutxaga,1994-03-12,01695532H,sara.gurrutxaga@smartapp.app,126346,ES11209547113786786463,1216.37,2023-11-17T04:15:37,Donostia,expenses,transport,-84.74,7160.54
buyer_5,Sara,Gurrutxaga,1994-03-12,01695532H,sara.gurrutxaga@smartapp.app,126346,ES11209547113786786463,1216.37,2023-11-18T16:49:47,Donostia,expenses,transport,-88.64,7071.9
buyer_5,Sara,Gurrutxaga,1994-03-12,01695532H,sara.gurrutxaga@smartapp.app,126346,ES11209547113786786463,1216.37,2023-11-19T16:59:16,Donostia,expenses,food,-119.93,6951.97
buyer_5,Sara,Gurrutxaga,1994-03-12,01695532H,sara.gurrutxaga@smartapp.app,126346,ES11209547113786786463,1216.37,2023-11-21T11:22:46,Donostia,expenses,education,-75.43,6876.54
buyer_5,Sara,Gurrutxaga,1994-03-12,01695532H,sara.gurrutxaga@smartapp.app,126346,ES11209547113786786463,1216.37,2023-11-22T20:22:47,Donostia,expenses,education,-64.1,6812.44
buyer_5,Sara,Gurrutxaga,1994-03-12,01695532H,sara.gurrutxaga@smartapp.app,126346,ES11209547113786786463,1216.37,2023-11-23T15:31:21,Donostia,expenses,food,-69.04,6743.4
buyer_5,Sara,Gurrutxaga,1994-03-12,01695532H,sara.gurrutxaga@smartapp.app,126346,ES11209547113786786463,1216.37,2023-11-23T15:44:26,Donostia,expenses,cash,-100.0,6643.4
buyer_5,Sara,Gurrutxaga,1994-03-12,01695532H,sara.gurrutxaga@smartapp.app,126346,ES11209547113786786463,1216.37,2023-11-24T13:08:36,Donostia,expenses,leisure,-71.48,6571.92
buyer_5,Sara,Gurrutxaga,1994-03-12,01695532H,sara.gurrutxaga@smartapp.app,126346,ES11209547113786786463,1216.37,2023-11-26T02:18:07,Donostia,expenses,leisure,-51.04,6520.88
buyer_5,Sara,Gurrutxaga,1994-03-12,01695532H,sara.gurrutxaga@smartapp.app,126346,ES11209547113786786463,1216.37,2023-11-30T09:42:48,Donostia,expenses,repairs,-318.0,6202.88
buyer_5,Sara,Gurrutxaga,1994-03-12,01695532H,sara.gurrutxaga@smartapp.app,126346,ES11209547113786786463,1216.37,2023-12-01T09:21:32,Donostia,incomes,salary,2964.06,9166.94
buyer_5,Sara,Gurrutxaga,1994-03-12,01695532H,sara.gurrutxaga@smartapp.app,126346,ES11209547113786786463,1216.37,2023-12-01T09:21:32,Donostia,incomes,salary_partner,3099.1,12266.04
buyer_5,Sara,Gurrutxaga,1994-03-12,01695532H,sara.gurrutxaga@smartapp.app,126346,ES11209547113786786463,1216.37,2023-12-01T09:21:32,Donostia,incomes,extra_income,437.28,12703.32
buyer_5,Sara,Gurrutxaga,1994-03-12,01695532H,sara.gurrutxaga@smartapp.app,126346,ES11209547113786786463,1216.37,2023-12-01T09:21:32,Donostia,incomes,salary_bonus,2124.53,14827.85
buyer_5,Sara,Gurrutxaga,1994-03-12,01695532H,sara.gurrutxaga@smartapp.app,126346,ES11209547113786786463,1216.37,2023-12-01T09:21:32,Donostia,incomes,salary_partner_bonus,2437.93,17265.78
buyer_5,Sara,Gurrutxaga,1994-03-12,01695532H,sara.gurrutxaga@smartapp.app,126346,ES11209547113786786463,1216.37,2023-12-02T10:04:17,Donostia,expenses,clothing,-116.05,17149.73
buyer_5,Sara,Gurrutxaga,1994-03-12,01695532H,sara.gurrutxaga@smartapp.app,126346,ES11209547113786786463,1216.37,2023-12-02T11:23:15,Donostia,expenses,cash,-100.0,17049.73
buyer_5,Sara,Gurrutxaga,1994-03-12,01695532H,sara.gurrutxaga@smartapp.app,126346,ES11209547113786786463,1216.37,2023-12-03T18:46:57,Donostia,expenses,cash,-100.0,16949.73
buyer_5,Sara,Gurrutxaga,1994-03-12,01695532H,sara.gurrutxaga@smartapp.app,126346,ES11209547113786786463,1216.37,2023-12-04T18:29:31,Donostia,expenses,mortgage,-2639.94,14309.79
buyer_5,Sara,Gurrutxaga,1994-03-12,01695532H,sara.gurrutxaga@smartapp.app,126346,ES11209547113786786463,1216.37,2023-12-04T15:28:10,Donostia,expenses,food,-106.76,14203.03
buyer_5,Sara,Gurrutxaga,1994-03-12,01695532H,sara.gurrutxaga@smartapp.app,126346,ES11209547113786786463,1216.37,2023-12-05T13:23:00,Donostia,expenses,internet,-127.33,14075.7
buyer_5,Sara,Gurrutxaga,1994-03-12,01695532H,sara.gurrutxaga@smartapp.app,126346,ES11209547113786786463,1216.37,2023-12-06T20:30:58,Donostia,expenses,electricity,-196.02,13879.68
buyer_5,Sara,Gurrutxaga,1994-03-12,01695532H,sara.gurrutxaga@smartapp.app,126346,ES11209547113786786463,1216.37,2023-12-07T10:03:02,Donostia,expenses,water,-106.01,13773.67
buyer_5,Sara,Gurrutxaga,1994-03-12,01695532H,sara.gurrutxaga@smartapp.app,126346,ES11209547113786786463,1216.37,2023-12-08T17:46:12,Donostia,expenses,gas,-334.02,13439.65
buyer_5,Sara,Gurrutxaga,1994-03-12,01695532H,sara.gurrutxaga@smartapp.app,126346,ES11209547113786786463,1216.37,2023-12-08T21:08:26,Donostia,expenses,phone,-125.61,13314.04
buyer_5,Sara,Gurrutxaga,1994-03-12,01695532H,sara.gurrutxaga@smartapp.app,126346,ES11209547113786786463,1216.37,2023-12-09T21:44:08,Donostia,expenses,food,-112.0,13202.04
buyer_5,Sara,Gurrutxaga,1994-03-12,01695532H,sara.gurrutxaga@smartapp.app,126346,ES11209547113786786463,1216.37,2023-12-09T19:35:12,Donostia,expenses,leisure,-60.61,13141.43
buyer_5,Sara,Gurrutxaga,1994-03-12,01695532H,sara.gurrutxaga@smartapp.app,126346,ES11209547113786786463,1216.37,2023-12-09T11:36:20,Donostia,expenses,gifts,-277.42,12864.01
buyer_5,Sara,Gurrutxaga,1994-03-12,01695532H,sara.gurrutxaga@smartapp.app,126346,ES11209547113786786463,1216.37,2023-12-10T20:10:36,Donostia,expenses,transport,-62.49,12801.52
buyer_5,Sara,Gurrutxaga,1994-03-12,01695532H,sara.gurrutxaga@smartapp.app,126346,ES11209547113786786463,1216.37,2023-12-10T20:42:08,Donostia,expenses,cash,-100.0,12701.52
buyer_5,Sara,Gurrutxaga,1994-03-12,01695532H,sara.gurrutxaga@smartapp.app,126346,ES11209547113786786463,1216.37,2023-12-11T15:24:14,Donostia,expenses,repairs,-276.58,12424.94
buyer_5,Sara,Gurrutxaga,1994-03-12,01695532H,sara.gurrutxaga@smartapp.app,126346,ES11209547113786786463,1216.37,2023-12-12T14:54:45,Donostia,expenses,transport,-54.49,12370.45
buyer_5,Sara,Gurrutxaga,1994-03-12,01695532H,sara.gurrutxaga@smartapp.app,126346,ES11209547113786786463,1216.37,2023-12-17T19:34:14,Donostia,expenses,education,-45.32,12325.13
buyer_5,Sara,Gurrutxaga,1994-03-12,01695532H,sara.gurrutxaga@smartapp.app,126346,ES11209547113786786463,1216.37,2023-12-25T19:35:49,Donostia,expenses,education,-76.35,12248.78
buyer_5,Sara,Gurrutxaga,1994-03-12,01695532H,sara.gurrutxaga@smartapp.app,126346,ES11209547113786786463,1216.37,2023-12-25T13:54:27,Donostia,expenses,repairs,-194.78,12054.0
buyer_5,Sara,Gurrutxaga,1994-03-12,01695532H,sara.gurrutxaga@smartapp.app,126346,ES11209547113786786463,1216.37,2023-12-26T13:52:58,Donostia,expenses,transport,-67.13,11986.87
buyer_5,Sara,Gurrutxaga,1994-03-12,01695532H,sara.gurrutxaga@smartapp.app,126346,ES11209547113786786463,1216.37,2023-12-27T02:15:09,Donostia,expenses,healthcare,-112.08,11874.79
buyer_5,Sara,Gurrutxaga,1994-03-12,01695532H,sara.gurrutxaga@smartapp.app,126346,ES11209547113786786463,1216.37,2023-12-28T06:13:46,Donostia,expenses,transport,-63.68,11811.11
buyer_5,Sara,Gurrutxaga,1994-03-12,01695532H,sara.gurrutxaga@smartapp.app,126346,ES11209547113786786463,1216.37,2023-12-28T19:46:48,Donostia,expenses,cash,-100.0,11711.11
buyer_5,Sara,Gurrutxaga,1994-03-12,01695532H,sara.gurrutxaga@smartapp.app,126346,ES11209547113786786463,1216.37,2023-12-30T03:35:38,Donostia,expenses,leisure,-57.62,11653.49
buyer_5,Sara,Gurrutxaga,1994-03-12,01695532H,sara.gurrutxaga@smartapp.app,126346,ES11209547113786786463,1216.37,2023-12-31T17:49:34,Donostia,expenses,transport,-57.11,11596.38
buyer_5,Sara,Gurrutxaga,1994-03-12,01695532H,sara.gurrutxaga@smartapp.app,126346,ES11209547113786786463,1216.37,2023-12-31T22:34:50,Donostia,expenses,appliances,-292.57,11303.81
buyer_5,Sara,Gurrutxaga,1994-03-12,01695532H,sara.gurrutxaga@smartapp.app,126346,ES11209547113786786463,1216.37,2024-01-01T13:47:30,Donostia,incomes,salary,3066.82,14370.63
buyer_5,Sara,Gurrutxaga,1994-03-12,01695532H,sara.gurrutxaga@smartapp.app,126346,ES11209547113786786463,1216.37,2024-01-01T13:47:30,Donostia,incomes,salary_partner,3206.54,17577.17
buyer_5,Sara,Gurrutxaga,1994-03-12,01695532H,sara.gurrutxaga@smartapp.app,126346,ES11209547113786786463,1216.37,2024-01-02T16:00:19,Donostia,expenses,transport,-69.6,17507.57
buyer_5,Sara,Gurrutxaga,1994-03-12,01695532H,sara.gurrutxaga@smartapp.app,126346,ES11209547113786786463,1216.37,2024-01-04T15:08:37,Donostia,expenses,mortgage,-2772.73,14734.84
buyer_5,Sara,Gurrutxaga,1994-03-12,01695532H,sara.gurrutxaga@smartapp.app,126346,ES11209547113786786463,1216.37,2024-01-05T22:55:34,Donostia,expenses,internet,-131.74,14603.1
buyer_5,Sara,Gurrutxaga,1994-03-12,01695532H,sara.gurrutxaga@smartapp.app,126346,ES11209547113786786463,1216.37,2024-01-05T19:17:31,Donostia,expenses,education,-47.64,14555.46
buyer_5,Sara,Gurrutxaga,1994-03-12,01695532H,sara.gurrutxaga@smartapp.app,126346,ES11209547113786786463,1216.37,2024-01-06T18:12:56,Donostia,expenses,phone,-108.82,14446.64
buyer_5,Sara,Gurrutxaga,1994-03-12,01695532H,sara.gurrutxaga@smartapp.app,126346,ES11209547113786786463,1216.37,2024-01-06T10:44:47,Donostia,expenses,repairs,-215.62,14231.02
buyer_5,Sara,Gurrutxaga,1994-03-12,01695532H,sara.gurrutxaga@smartapp.app,126346,ES11209547113786786463,1216.37,2024-01-07T16:19:51,Donostia,expenses,cash,-100.0,14131.02
buyer_5,Sara,Gurrutxaga,1994-03-12,01695532H,sara.gurrutxaga@smartapp.app,126346,ES11209547113786786463,1216.37,2024-01-08T13:12:58,Donostia,expenses,water,-117.88,14013.14
buyer_5,Sara,Gurrutxaga,1994-03-12,01695532H,sara.gurrutxaga@smartapp.app,126346,ES11209547113786786463,1216.37,2024-01-08T12:44:16,Donostia,expenses,electricity,-72.51,13940.63
buyer_5,Sara,Gurrutxaga,1994-03-12,01695532H,sara.gurrutxaga@smartapp.app,126346,ES11209547113786786463,1216.37,2024-01-08T09:13:19,Donostia,expenses,gas,-228.47,13712.16
buyer_5,Sara,Gurrutxaga,1994-03-12,01695532H,sara.gurrutxaga@smartapp.app,126346,ES11209547113786786463,1216.37,2024-01-08T02:37:38,Donostia,expenses,food,-76.54,13635.62
buyer_5,Sara,Gurrutxaga,1994-03-12,01695532H,sara.gurrutxaga@smartapp.app,126346,ES11209547113786786463,1216.37,2024-01-08T17:22:35,Donostia,expenses,leisure,-26.3,13609.32
buyer_5,Sara,Gurrutxaga,1994-03-12,01695532H,sara.gurrutxaga@smartapp.app,126346,ES11209547113786786463,1216.37,2024-01-12T16:50:30,Donostia,expenses,cash,-100.0,13509.32
buyer_5,Sara,Gurrutxaga,1994-03-12,01695532H,sara.gurrutxaga@smartapp.app,126346,ES11209547113786786463,1216.37,2024-01-13T16:23:57,Donostia,expenses,healthcare,-108.15,13401.17
buyer_5,Sara,Gurrutxaga,1994-03-12,01695532H,sara.gurrutxaga@smartapp.app,126346,ES11209547113786786463,1216.37,2024-01-14T18:39:36,Donostia,expenses,food,-108.93,13292.24
buyer_5,Sara,Gurrutxaga,1994-03-12,01695532H,sara.gurrutxaga@smartapp.app,126346,ES11209547113786786463,1216.37,2024-01-14T18:28:36,Donostia,expenses,transport,-77.56,13214.68
buyer_5,Sara,Gurrutxaga,1994-03-12,01695532H,sara.gurrutxaga@smartapp.app,126346,ES11209547113786786463,1216.37,2024-01-14T11:51:15,Donostia,expenses,cash,-100.0,13114.68
buyer_5,Sara,Gurrutxaga,1994-03-12,01695532H,sara.gurrutxaga@smartapp.app,126346,ES11209547113786786463,1216.37,2024-01-16T20:15:12,Donostia,expenses,cash,-100.0,13014.68
buyer_5,Sara,Gurrutxaga,1994-03-12,01695532H,sara.gurrutxaga@smartapp.app,126346,ES11209547113786786463,1216.37,2024-01-18T20:51:46,Donostia,expenses,food,-65.43,12949.25
buyer_5,Sara,Gurrutxaga,1994-03-12,01695532H,sara.gurrutxaga@smartapp.app,126346,ES11209547113786786463,1216.37,2024-01-18T14:24:01,Donostia,expenses,repairs,-188.91,12760.34
buyer_5,Sara,Gurrutxaga,1994-03-12,01695532H,sara.gurrutxaga@smartapp.app,126346,ES11209547113786786463,1216.37,2024-01-19T17:43:34,Donostia,expenses,gifts,-621.39,12138.95
buyer_5,Sara,Gurrutxaga,1994-03-12,01695532H,sara.gurrutxaga@smartapp.app,126346,ES11209547113786786463,1216.37,2024-01-20T10:23:32,Donostia,expenses,cash,-100.0,12038.95
buyer_5,Sara,Gurrutxaga,1994-03-12,01695532H,sara.gurrutxaga@smartapp.app,126346,ES11209547113786786463,1216.37,2024-01-21T08:03:06,Donostia,expenses,transport,-51.38,11987.57
buyer_5,Sara,Gurrutxaga,1994-03-12,01695532H,sara.gurrutxaga@smartapp.app,126346,ES11209547113786786463,1216.37,2024-01-22T10:11:34,Donostia,expenses,food,-60.93,11926.64
buyer_5,Sara,Gurrutxaga,1994-03-12,01695532H,sara.gurrutxaga@smartapp.app,126346,ES11209547113786786463,1216.37,2024-01-22T08:19:44,Donostia,expenses,leisure,-68.28,11858.36
buyer_5,Sara,Gurrutxaga,1994-03-12,01695532H,sara.gurrutxaga@smartapp.app,126346,ES11209547113786786463,1216.37,2024-01-22T23:23:54,Donostia,expenses,healthcare,-40.5,11817.86
buyer_5,Sara,Gurrutxaga,1994-03-12,01695532H,sara.gurrutxaga@smartapp.app,126346,ES11209547113786786463,1216.37,2024-01-26T16:51:37,Donostia,expenses,transport,-79.88,11737.98
buyer_5,Sara,Gurrutxaga,1994-03-12,01695532H,sara.gurrutxaga@smartapp.app,126346,ES11209547113786786463,1216.37,2024-01-30T13:10:13,Donostia,expenses,transport,-83.41,11654.57
buyer_5,Sara,Gurrutxaga,1994-03-12,01695532H,sara.gurrutxaga@smartapp.app,126346,ES11209547113786786463,1216.37,2024-02-01T08:20:10,Donostia,incomes,salary,3066.82,14721.39
buyer_5,Sara,Gurrutxaga,1994-03-12,01695532H,sara.gurrutxaga@smartapp.app,126346,ES11209547113786786463,1216.37,2024-02-01T08:20:10,Donostia,incomes,salary_partner,3206.54,17927.93
buyer_5,Sara,Gurrutxaga,1994-03-12,01695532H,sara.gurrutxaga@smartapp.app,126346,ES11209547113786786463,1216.37,2024-02-03T14:54:45,Donostia,expenses,food,-71.8,17856.13
buyer_5,Sara,Gurrutxaga,1994-03-12,01695532H,sara.gurrutxaga@smartapp.app,126346,ES11209547113786786463,1216.37,2024-02-04T17:25:19,Donostia,expenses,mortgage,-2772.73,15083.4
buyer_5,Sara,Gurrutxaga,1994-03-12,01695532H,sara.gurrutxaga@smartapp.app,126346,ES11209547113786786463,1216.37,2024-02-04T19:01:08,Donostia,expenses,leisure,-45.76,15037.64
buyer_5,Sara,Gurrutxaga,1994-03-12,01695532H,sara.gurrutxaga@smartapp.app,126346,ES11209547113786786463,1216.37,2024-02-04T20:31:11,Donostia,expenses,repairs,-80.76,14956.88
buyer_5,Sara,Gurrutxaga,1994-03-12,01695532H,sara.gurrutxaga@smartapp.app,126346,ES11209547113786786463,1216.37,2024-02-05T19:09:15,Donostia,expenses,food,-114.1,14842.78
buyer_5,Sara,Gurrutxaga,1994-03-12,01695532H,sara.gurrutxaga@smartapp.app,126346,ES11209547113786786463,1216.37,2024-02-06T08:29:39,Donostia,expenses,electricity,-130.35,14712.43
buyer_5,Sara,Gurrutxaga,1994-03-12,01695532H,sara.gurrutxaga@smartapp.app,126346,ES11209547113786786463,1216.37,2024-02-06T16:58:22,Donostia,expenses,internet,-131.74,14580.69
buyer_5,Sara,Gurrutxaga,1994-03-12,01695532H,sara.gurrutxaga@smartapp.app,126346,ES11209547113786786463,1216.37,2024-02-06T19:38:36,Donostia,expenses,phone,-137.45,14443.24
buyer_5,Sara,Gurrutxaga,1994-03-12,01695532H,sara.gurrutxaga@smartapp.app,126346,ES11209547113786786463,1216.37,2024-02-07T15:26:55,Donostia,expenses,food,-88.2,14355.04
buyer_5,Sara,Gurrutxaga,1994-03-12,01695532H,sara.gurrutxaga@smartapp.app,126346,ES11209547113786786463,1216.37,2024-02-07T09:07:46,Donostia,expenses,leisure,-76.45,14278.59
buyer_5,Sara,Gurrutxaga,1994-03-12,01695532H,sara.gurrutxaga@smartapp.app,126346,ES11209547113786786463,1216.37,2024-02-08T13:15:37,Donostia,expenses,water,-111.42,14167.17
buyer_5,Sara,Gurrutxaga,1994-03-12,01695532H,sara.gurrutxaga@smartapp.app,126346,ES11209547113786786463,1216.37,2024-02-08T04:38:02,Donostia,expenses,gas,-192.02,13975.15
buyer_5,Sara,Gurrutxaga,1994-03-12,01695532H,sara.gurrutxaga@smartapp.app,126346,ES11209547113786786463,1216.37,2024-02-09T08:50:12,Donostia,expenses,leisure,-74.5,13900.65
buyer_5,Sara,Gurrutxaga,1994-03-12,01695532H,sara.gurrutxaga@smartapp.app,126346,ES11209547113786786463,1216.37,2024-02-09T10:03:42,Donostia,expenses,appliances,-419.39,13481.26
buyer_5,Sara,Gurrutxaga,1994-03-12,01695532H,sara.gurrutxaga@smartapp.app,126346,ES11209547113786786463,1216.37,2024-02-10T17:37:29,Donostia,expenses,food,-88.14,13393.12
buyer_5,Sara,Gurrutxaga,1994-03-12,01695532H,sara.gurrutxaga@smartapp.app,126346,ES11209547113786786463,1216.37,2024-02-10T15:00:26,Donostia,expenses,cash,-100.0,13293.12
buyer_5,Sara,Gurrutxaga,1994-03-12,01695532H,sara.gurrutxaga@smartapp.app,126346,ES11209547113786786463,1216.37,2024-02-11T17:42:16,Donostia,expenses,food,-76.15,13216.97
buyer_5,Sara,Gurrutxaga,1994-03-12,01695532H,sara.gurrutxaga@smartapp.app,126346,ES11209547113786786463,1216.37,2024-02-11T18:47:47,Donostia,expenses,repairs,-141.02,13075.95
buyer_5,Sara,Gurrutxaga,1994-03-12,01695532H,sara.gurrutxaga@smartapp.app,126346,ES11209547113786786463,1216.37,2024-02-12T12:15:03,Donostia,expenses,food,-62.59,13013.36
buyer_5,Sara,Gurrutxaga,1994-03-12,01695532H,sara.gurrutxaga@smartapp.app,126346,ES11209547113786786463,1216.37,2024-02-14T08:33:40,Donostia,expenses,transport,-45.64,12967.72
buyer_5,Sara,Gurrutxaga,1994-03-12,01695532H,sara.gurrutxaga@smartapp.app,126346,ES11209547113786786463,1216.37,2024-02-17T14:27:23,Donostia,expenses,repairs,-40.32,12927.4
buyer_5,Sara,Gurrutxaga,1994-03-12,01695532H,sara.gurrutxaga@smartapp.app,126346,ES11209547113786786463,1216.37,2024-02-18T20:21:19,Donostia,expenses,food,-80.09,12847.31
buyer_5,Sara,Gurrutxaga,1994-03-12,01695532H,sara.gurrutxaga@smartapp.app,126346,ES11209547113786786463,1216.37,2024-02-19T20:18:09,Donostia,expenses,repairs,-106.19,12741.12
buyer_5,Sara,Gurrutxaga,1994-03-12,01695532H,sara.gurrutxaga@smartapp.app,126346,ES11209547113786786463,1216.37,2024-02-20T14:56:13,Donostia,expenses,food,-105.65,12635.47
buyer_5,Sara,Gurrutxaga,1994-03-12,01695532H,sara.gurrutxaga@smartapp.app,126346,ES11209547113786786463,1216.37,2024-02-21T08:40:54,Donostia,expenses,food,-84.65,12550.82
buyer_5,Sara,Gurrutxaga,1994-03-12,01695532H,sara.gurrutxaga@smartapp.app,126346,ES11209547113786786463,1216.37,2024-02-22T19:08:08,Donostia,expenses,leisure,-35.46,12515.36
buyer_5,Sara,Gurrutxaga,1994-03-12,01695532H,sara.gurrutxaga@smartapp.app,126346,ES11209547113786786463,1216.37,2024-02-22T09:34:50,Donostia,expenses,gifts,-85.5,12429.86
buyer_5,Sara,Gurrutxaga,1994-03-12,01695532H,sara.gurrutxaga@smartapp.app,126346,ES11209547113786786463,1216.37,2024-02-23T14:43:19,Donostia,expenses,cash,-100.0,12329.86
buyer_5,Sara,Gurrutxaga,1994-03-12,01695532H,sara.gurrutxaga@smartapp.app,126346,ES11209547113786786463,1216.37,2024-02-24T15:33:30,Donostia,expenses,food,-114.46,12215.4
buyer_5,Sara,Gurrutxaga,1994-03-12,01695532H,sara.gurrutxaga@smartapp.app,126346,ES11209547113786786463,1216.37,2024-02-25T20:53:44,Donostia,expenses,repairs,-171.57,12043.83
buyer_5,Sara,Gurrutxaga,1994-03-12,01695532H,sara.gurrutxaga@smartapp.app,126346,ES11209547113786786463,1216.37,2024-02-26T13:48:34,Donostia,expenses,education,-70.79,11973.04
buyer_5,Sara,Gurrutxaga,1994-03-12,01695532H,sara.gurrutxaga@smartapp.app,126346,ES11209547113786786463,1216.37,2024-02-27T11:18:21,Donostia,expenses,cash,-100.0,11873.04
buyer_5,Sara,Gurrutxaga,1994-03-12,01695532H,sara.gurrutxaga@smartapp.app,126346,ES11209547113786786463,1216.37,2024-02-29T17:14:05,Donostia,expenses,food,-97.76,11775.28
buyer_5,Sara,Gurrutxaga,1994-03-12,01695532H,sara.gurrutxaga@smartapp.app,126346,ES11209547113786786463,1216.37,2024-02-29T16:06:05,Donostia,expenses,repairs,-193.07,11582.21
buyer_5,Sara,Gurrutxaga,1994-03-12,01695532H,sara.gurrutxaga@smartapp.app,126346,ES11209547113786786463,1216.37,2024-03-01T20:46:19,Donostia,incomes,salary,3066.82,14649.03
buyer_5,Sara,Gurrutxaga,1994-03-12,01695532H,sara.gurrutxaga@smartapp.app,126346,ES11209547113786786463,1216.37,2024-03-01T20:46:19,Donostia,incomes,salary_partner,3206.54,17855.57
buyer_5,Sara,Gurrutxaga,1994-03-12,01695532H,sara.gurrutxaga@smartapp.app,126346,ES11209547113786786463,1216.37,2024-03-01T20:46:19,Donostia,incomes,extra_income,437.28,18292.85
buyer_5,Sara,Gurrutxaga,1994-03-12,01695532H,sara.gurrutxaga@smartapp.app,126346,ES11209547113786786463,1216.37,2024-03-01T14:26:56,Donostia,expenses,education,-72.34,18220.51
buyer_5,Sara,Gurrutxaga,1994-03-12,01695532H,sara.gurrutxaga@smartapp.app,126346,ES11209547113786786463,1216.37,2024-03-02T01:03:16,Donostia,expenses,leisure,-48.3,18172.21
buyer_5,Sara,Gurrutxaga,1994-03-12,01695532H,sara.gurrutxaga@smartapp.app,126346,ES11209547113786786463,1216.37,2024-03-02T06:09:33,Donostia,expenses,appliances,-314.97,17857.24
buyer_5,Sara,Gurrutxaga,1994-03-12,01695532H,sara.gurrutxaga@smartapp.app,126346,ES11209547113786786463,1216.37,2024-03-04T01:56:58,Donostia,expenses,mortgage,-2772.73,15084.51
buyer_5,Sara,Gurrutxaga,1994-03-12,01695532H,sara.gurrutxaga@smartapp.app,126346,ES11209547113786786463,1216.37,2024-03-05T13:48:32,Donostia,expenses,water,-121.61,14962.9
buyer_5,Sara,Gurrutxaga,1994-03-12,01695532H,sara.gurrutxaga@smartapp.app,126346,ES11209547113786786463,1216.37,2024-03-05T08:35:54,Donostia,expenses,electricity,-98.91,14863.99
buyer_5,Sara,Gurrutxaga,1994-03-12,01695532H,sara.gurrutxaga@smartapp.app,126346,ES11209547113786786463,1216.37,2024-03-05T17:46:54,Donostia,expenses,gas,-232.38,14631.61
buyer_5,Sara,Gurrutxaga,1994-03-12,01695532H,sara.gurrutxaga@smartapp.app,126346,ES11209547113786786463,1216.37,2024-03-06T16:01:06,Donostia,expenses,leisure,-82.55,14549.06
buyer_5,Sara,Gurrutxaga,1994-03-12,01695532H,sara.gurrutxaga@smartapp.app,126346,ES11209547113786786463,1216.37,2024-03-07T21:15:09,Donostia,expenses,phone,-122.83,14426.23
buyer_5,Sara,Gurrutxaga,1994-03-12,01695532H,sara.gurrutxaga@smartapp.app,126346,ES11209547113786786463,1216.37,2024-03-07T13:21:15,Donostia,expenses,cash,-100.0,14326.23
buyer_5,Sara,Gurrutxaga,1994-03-12,01695532H,sara.gurrutxaga@smartapp.app,126346,ES11209547113786786463,1216.37,2024-03-08T15:21:23,Donostia,expenses,internet,-131.74,14194.49
buyer_5,Sara,Gurrutxaga,1994-03-12,01695532H,sara.gurrutxaga@smartapp.app,126346,ES11209547113786786463,1216.37,2024-03-08T10:26:08,Donostia,expenses,transport,-48.58,14145.91
buyer_5,Sara,Gurrutxaga,1994-03-12,01695532H,sara.gurrutxaga@smartapp.app,126346,ES11209547113786786463,1216.37,2024-03-09T15:38:26,Donostia,expenses,cash,-100.0,14045.91
buyer_5,Sara,Gurrutxaga,1994-03-12,01695532H,sara.gurrutxaga@smartapp.app,126346,ES11209547113786786463,1216.37,2024-03-09T21:11:34,Donostia,expenses,repairs,-193.38,13852.53
buyer_5,Sara,Gurrutxaga,1994-03-12,01695532H,sara.gurrutxaga@smartapp.app,126346,ES11209547113786786463,1216.37,2024-03-10T18:38:45,Donostia,expenses,leisure,-68.59,13783.94
buyer_5,Sara,Gurrutxaga,1994-03-12,01695532H,sara.gurrutxaga@smartapp.app,126346,ES11209547113786786463,1216.37,2024-03-10T18:36:38,Donostia,expenses,repairs,-79.12,13704.82
buyer_5,Sara,Gurrutxaga,1994-03-12,01695532H,sara.gurrutxaga@smartapp.app,126346,ES11209547113786786463,1216.37,2024-03-11T11:45:05,Donostia,expenses,transport,-66.59,13638.23
buyer_5,Sara,Gurrutxaga,1994-03-12,01695532H,sara.gurrutxaga@smartapp.app,126346,ES11209547113786786463,1216.37,2024-03-11T12:21:50,Donostia,expenses,leisure,-69.19,13569.04
buyer_5,Sara,Gurrutxaga,1994-03-12,01695532H,sara.gurrutxaga@smartapp.app,126346,ES11209547113786786463,1216.37,2024-03-12T19:16:52,Donostia,expenses,transport,-86.44,13482.6
buyer_5,Sara,Gurrutxaga,1994-03-12,01695532H,sara.gurrutxaga@smartapp.app,126346,ES11209547113786786463,1216.37,2024-03-14T09:19:04,Donostia,expenses,transport,-47.71,13434.89
buyer_5,Sara,Gurrutxaga,1994-03-12,01695532H,sara.gurrutxaga@smartapp.app,126346,ES11209547113786786463,1216.37,2024-03-15T10:43:59,Donostia,expenses,cash,-100.0,13334.89
buyer_5,Sara,Gurrutxaga,1994-03-12,01695532H,sara.gurrutxaga@smartapp.app,126346,ES11209547113786786463,1216.37,2024-03-15T17:16:22,Donostia,expenses,repairs,-82.28,13252.61
buyer_5,Sara,Gurrutxaga,1994-03-12,01695532H,sara.gurrutxaga@smartapp.app,126346,ES11209547113786786463,1216.37,2024-03-16T23:35:51,Donostia,expenses,leisure,-71.83,13180.78
buyer_5,Sara,Gurrutxaga,1994-03-12,01695532H,sara.gurrutxaga@smartapp.app,126346,ES11209547113786786463,1216.37,2024-03-18T19:37:38,Donostia,expenses,cash,-100.0,13080.78
buyer_5,Sara,Gurrutxaga,1994-03-12,01695532H,sara.gurrutxaga@smartapp.app,126346,ES11209547113786786463,1216.37,2024-03-20T17:33:15,Donostia,expenses,transport,-69.97,13010.81
buyer_5,Sara,Gurrutxaga,1994-03-12,01695532H,sara.gurrutxaga@smartapp.app,126346,ES11209547113786786463,1216.37,2024-03-20T17:33:51,Donostia,expenses,cash,-100.0,12910.81
buyer_5,Sara,Gurrutxaga,1994-03-12,01695532H,sara.gurrutxaga@smartapp.app,126346,ES11209547113786786463,1216.37,2024-03-20T13:09:20,Donostia,expenses,appliances,-252.51,12658.3
buyer_5,Sara,Gurrutxaga,1994-03-12,01695532H,sara.gurrutxaga@smartapp.app,126346,ES11209547113786786463,1216.37,2024-03-21T03:32:46,Donostia,expenses,clothing,-55.27,12603.03
buyer_5,Sara,Gurrutxaga,1994-03-12,01695532H,sara.gurrutxaga@smartapp.app,126346,ES11209547113786786463,1216.37,2024-03-21T15:05:20,Donostia,expenses,education,-54.52,12548.51
buyer_5,Sara,Gurrutxaga,1994-03-12,01695532H,sara.gurrutxaga@smartapp.app,126346,ES11209547113786786463,1216.37,2024-03-23T15:25:45,Donostia,expenses,transport,-41.43,12507.08
buyer_5,Sara,Gurrutxaga,1994-03-12,01695532H,sara.gurrutxaga@smartapp.app,126346,ES11209547113786786463,1216.37,2024-03-23T16:33:38,Donostia,expenses,cash,-100.0,12407.08
buyer_5,Sara,Gurrutxaga,1994-03-12,01695532H,sara.gurrutxaga@smartapp.app,126346,ES11209547113786786463,1216.37,2024-03-25T18:17:16,Donostia,expenses,cash,-100.0,12307.08
buyer_5,Sara,Gurrutxaga,1994-03-12,01695532H,sara.gurrutxaga@smartapp.app,126346,ES11209547113786786463,1216.37,2024-03-25T08:38:59,Donostia,expenses,travel,-326.01,11981.07
buyer_5,Sara,Gurrutxaga,1994-03-12,01695532H,sara.gurrutxaga@smartapp.app,126346,ES11209547113786786463,1216.37,2024-03-26T15:23:31,Donostia,expenses,gifts,-753.67,11227.4
buyer_5,Sara,Gurrutxaga,1994-03-12,01695532H,sara.gurrutxaga@smartapp.app,126346,ES11209547113786786463,1216.37,2024-03-29T05:57:52,Donostia,expenses,cash,-100.0,11127.4
buyer_5,Sara,Gurrutxaga,1994-03-12,01695532H,sara.gurrutxaga@smartapp.app,126346,ES11209547113786786463,1216.37,2024-03-30T20:14:22,Donostia,expenses,food,-88.88,11038.52
buyer_5,Sara,Gurrutxaga,1994-03-12,01695532H,sara.gurrutxaga@smartapp.app,126346,ES11209547113786786463,1216.37,2024-03-30T16:40:10,Donostia,expenses,clothing,-64.77,10973.75
buyer_5,Sara,Gurrutxaga,1994-03-12,01695532H,sara.gurrutxaga@smartapp.app,126346,ES11209547113786786463,1216.37,2024-03-31T14:56:07,Donostia,expenses,cash,-100.0,10873.75
buyer_5,Sara,Gurrutxaga,1994-03-12,01695532H,sara.gurrutxaga@smartapp.app,126346,ES11209547113786786463,1216.37,2024-04-01T19:40:05,Donostia,incomes,salary,3066.82,13940.57
buyer_5,Sara,Gurrutxaga,1994-03-12,01695532H,sara.gurrutxaga@smartapp.app,126346,ES11209547113786786463,1216.37,2024-04-01T19:40:05,Donostia,incomes,salary_partner,3206.54,17147.11
buyer_5,Sara,Gurrutxaga,1994-03-12,01695532H,sara.gurrutxaga@smartapp.app,126346,ES11209547113786786463,1216.37,2024-04-01T11:54:17,Donostia,expenses,cash,-100.0,17047.11
buyer_5,Sara,Gurrutxaga,1994-03-12,01695532H,sara.gurrutxaga@smartapp.app,126346,ES11209547113786786463,1216.37,2024-04-02T09:22:12,Donostia,expenses,food,-69.81,16977.3
buyer_5,Sara,Gurrutxaga,1994-03-12,01695532H,sara.gurrutxaga@smartapp.app,126346,ES11209547113786786463,1216.37,2024-04-04T11:30:06,Donostia,expenses,mortgage,-2772.73,14204.57
buyer_5,Sara,Gurrutxaga,1994-03-12,01695532H,sara.gurrutxaga@smartapp.app,126346,ES11209547113786786463,1216.37,2024-04-04T11:28:07,Donostia,expenses,cash,-100.0,14104.57
buyer_5,Sara,Gurrutxaga,1994-03-12,01695532H,sara.gurrutxaga@smartapp.app,126346,ES11209547113786786463,1216.37,2024-04-05T10:41:27,Donostia,expenses,water,-83.73,14020.84
buyer_5,Sara,Gurrutxaga,1994-03-12,01695532H,sara.gurrutxaga@smartapp.app,126346,ES11209547113786786463,1216.37,2024-04-05T13:03:14,Donostia,expenses,electricity,-264.99,13755.85
buyer_5,Sara,Gurrutxaga,1994-03-12,01695532H,sara.gurrutxaga@smartapp.app,126346,ES11209547113786786463,1216.37,2024-04-05T13:50:58,Donostia,expenses,gas,-333.06,13422.79
buyer_5,Sara,Gurrutxaga,1994-03-12,01695532H,sara.gurrutxaga@smartapp.app,126346,ES11209547113786786463,1216.37,2024-04-05T17:25:54,Donostia,expenses,phone,-122.65,13300.14
buyer_5,Sara,Gurrutxaga,1994-03-12,01695532H,sara.gurrutxaga@smartapp.app,126346,ES11209547113786786463,1216.37,2024-04-05T20:16:24,Donostia,expenses,cash,-100.0,13200.14
buyer_5,Sara,Gurrutxaga,1994-03-12,01695532H,sara.gurrutxaga@smartapp.app,126346,ES11209547113786786463,1216.37,2024-04-08T19:37:45,Donostia,expenses,internet,-131.74,13068.4
buyer_5,Sara,Gurrutxaga,1994-03-12,01695532H,sara.gurrutxaga@smartapp.app,126346,ES11209547113786786463,1216.37,2024-04-08T14:00:43,Donostia,expenses,education,-55.21,13013.19
buyer_5,Sara,Gurrutxaga,1994-03-12,01695532H,sara.gurrutxaga@smartapp.app,126346,ES11209547113786786463,1216.37,2024-04-09T18:50:44,Donostia,expenses,leisure,-81.31,12931.88
buyer_5,Sara,Gurrutxaga,1994-03-12,01695532H,sara.gurrutxaga@smartapp.app,126346,ES11209547113786786463,1216.37,2024-04-09T09:34:20,Donostia,expenses,healthcare,-189.29,12742.59
buyer_5,Sara,Gurrutxaga,1994-03-12,01695532H,sara.gurrutxaga@smartapp.app,126346,ES11209547113786786463,1216.37,2024-04-10T18:36:24,Donostia,expenses,cash,-100.0,12642.59
buyer_5,Sara,Gurrutxaga,1994-03-12,01695532H,sara.gurrutxaga@smartapp.app,126346,ES11209547113786786463,1216.37,2024-04-11T16:31:04,Donostia,expenses,cash,-100.0,12542.59
buyer_5,Sara,Gurrutxaga,1994-03-12,01695532H,sara.gurrutxaga@smartapp.app,126346,ES11209547113786786463,1216.37,2024-04-12T14:28:01,Donostia,expenses,cash,-100.0,12442.59
buyer_5,Sara,Gurrutxaga,1994-03-12,01695532H,sara.gurrutxaga@smartapp.app,126346,ES11209547113786786463,1216.37,2024-04-14T09:24:45,Donostia,expenses,appliances,-360.59,12082.0
buyer_5,Sara,Gurrutxaga,1994-03-12,01695532H,sara.gurrutxaga@smartapp.app,126346,ES11209547113786786463,1216.37,2024-04-15T14:32:24,Donostia,expenses,leisure,-37.95,12044.05
buyer_5,Sara,Gurrutxaga,1994-03-12,01695532H,sara.gurrutxaga@smartapp.app,126346,ES11209547113786786463,1216.37,2024-04-16T15:07:46,Donostia,expenses,gifts,-581.45,11462.6
buyer_5,Sara,Gurrutxaga,1994-03-12,01695532H,sara.gurrutxaga@smartapp.app,126346,ES11209547113786786463,1216.37,2024-04-18T15:37:12,Donostia,expenses,food,-94.62,11367.98
buyer_5,Sara,Gurrutxaga,1994-03-12,01695532H,sara.gurrutxaga@smartapp.app,126346,ES11209547113786786463,1216.37,2024-04-19T15:18:44,Donostia,expenses,food,-63.72,11304.26
buyer_5,Sara,Gurrutxaga,1994-03-12,01695532H,sara.gurrutxaga@smartapp.app,126346,ES11209547113786786463,1216.37,2024-04-19T08:19:36,Donostia,expenses,clothing,-135.25,11169.01
buyer_5,Sara,Gurrutxaga,1994-03-12,01695532H,sara.gurrutxaga@smartapp.app,126346,ES11209547113786786463,1216.37,2024-04-20T14:24:34,Donostia,expenses,food,-89.95,11079.06
buyer_5,Sara,Gurrutxaga,1994-03-12,01695532H,sara.gurrutxaga@smartapp.app,126346,ES11209547113786786463,1216.37,2024-04-20T11:05:36,Donostia,expenses,repairs,-69.14,11009.92
buyer_5,Sara,Gurrutxaga,1994-03-12,01695532H,sara.gurrutxaga@smartapp.app,126346,ES11209547113786786463,1216.37,2024-04-23T15:26:45,Donostia,expenses,food,-101.02,10908.9
buyer_5,Sara,Gurrutxaga,1994-03-12,01695532H,sara.gurrutxaga@smartapp.app,126346,ES11209547113786786463,1216.37,2024-04-23T19:45:11,Donostia,expenses,gifts,-215.15,10693.75
buyer_5,Sara,Gurrutxaga,1994-03-12,01695532H,sara.gurrutxaga@smartapp.app,126346,ES11209547113786786463,1216.37,2024-04-25T11:08:59,Donostia,expenses,education,-73.03,10620.72
buyer_5,Sara,Gurrutxaga,1994-03-12,01695532H,sara.gurrutxaga@smartapp.app,126346,ES11209547113786786463,1216.37,2024-04-25T15:17:14,Donostia,expenses,appliances,-104.62,10516.1
buyer_5,Sara,Gurrutxaga,1994-03-12,01695532H,sara.gurrutxaga@smartapp.app,126346,ES11209547113786786463,1216.37,2024-04-26T17:35:39,Donostia,expenses,food,-88.88,10427.22
buyer_5,Sara,Gurrutxaga,1994-03-12,01695532H,sara.gurrutxaga@smartapp.app,126346,ES11209547113786786463,1216.37,2024-04-27T15:01:33,Donostia,expenses,transport,-86.62,10340.6
buyer_5,Sara,Gurrutxaga,1994-03-12,01695532H,sara.gurrutxaga@smartapp.app,126346,ES11209547113786786463,1216.37,2024-04-27T16:43:05,Donostia,expenses,repairs,-71.58,10269.02
buyer_5,Sara,Gurrutxaga,1994-03-12,01695532H,sara.gurrutxaga@smartapp.app,126346,ES11209547113786786463,1216.37,2024-04-28T12:06:05,Donostia,expenses,food,-69.2,10199.82
buyer_5,Sara,Gurrutxaga,1994-03-12,01695532H,sara.gurrutxaga@smartapp.app,126346,ES11209547113786786463,1216.37,2024-04-30T17:38:20,Donostia,expenses,leisure,-64.91,10134.91
buyer_5,Sara,Gurrutxaga,1994-03-12,01695532H,sara.gurrutxaga@smartapp.app,126346,ES11209547113786786463,1216.37,2024-05-01T23:08:25,Donostia,incomes,salary,3066.82,13201.73
buyer_5,Sara,Gurrutxaga,1994-03-12,01695532H,sara.gurrutxaga@smartapp.app,126346,ES11209547113786786463,1216.37,2024-05-01T23:08:25,Donostia,incomes,salary_partner,3206.54,16408.27
buyer_5,Sara,Gurrutxaga,1994-03-12,01695532H,sara.gurrutxaga@smartapp.app,126346,ES11209547113786786463,1216.37,2024-05-01T23:01:59,Donostia,expenses,food,-89.83,16318.44
buyer_5,Sara,Gurrutxaga,1994-03-12,01695532H,sara.gurrutxaga@smartapp.app,126346,ES11209547113786786463,1216.37,2024-05-02T08:33:21,Donostia,expenses,cash,-100.0,16218.44
buyer_5,Sara,Gurrutxaga,1994-03-12,01695532H,sara.gurrutxaga@smartapp.app,126346,ES11209547113786786463,1216.37,2024-05-04T19:00:43,Donostia,expenses,mortgage,-2772.73,13445.71
buyer_5,Sara,Gurrutxaga,1994-03-12,01695532H,sara.gurrutxaga@smartapp.app,126346,ES11209547113786786463,1216.37,2024-05-05T10:13:48,Donostia,expenses,cash,-100.0,13345.71
buyer_5,Sara,Gurrutxaga,1994-03-12,01695532H,sara.gurrutxaga@smartapp.app,126346,ES11209547113786786463,1216.37,2024-05-06T16:29:26,Donostia,expenses,phone,-131.23,13214.48
buyer_5,Sara,Gurrutxaga,1994-03-12,01695532H,sara.gurrutxaga@smartapp.app,126346,ES11209547113786786463,1216.37,2024-05-07T22:35:20,Donostia,expenses,transport,-45.59,13168.89
buyer_5,Sara,Gurrutxaga,1994-03-12,01695532H,sara.gurrutxaga@smartapp.app,126346,ES11209547113786786463,1216.37,2024-05-07T19:31:52,Donostia,expenses,cash,-100.0,13068.89
buyer_5,Sara,Gurrutxaga,1994-03-12,01695532H,sara.gurrutxaga@smartapp.app,126346,ES11209547113786786463,1216.37,2024-05-08T23:31:01,Donostia,expenses,water,-92.66,12976.23
buyer_5,Sara,Gurrutxaga,1994-03-12,01695532H,sara.gurrutxaga@smartapp.app,126346,ES11209547113786786463,1216.37,2024-05-08T12:23:22,Donostia,expenses,electricity,-254.67,12721.56
buyer_5,Sara,Gurrutxaga,1994-03-12,01695532H,sara.gurrutxaga@smartapp.app,126346,ES11209547113786786463,1216.37,2024-05-08T15:34:53,Donostia,expenses,gas,-124.35,12597.21
buyer_5,Sara,Gurrutxaga,1994-03-12,01695532H,sara.gurrutxaga@smartapp.app,126346,ES11209547113786786463,1216.37,2024-05-08T17:34:27,Donostia,expenses,internet,-131.74,12465.47
buyer_5,Sara,Gurrutxaga,1994-03-12,01695532H,sara.gurrutxaga@smartapp.app,126346,ES11209547113786786463,1216.37,2024-05-10T04:17:16,Donostia,expenses,food,-96.01,12369.46
buyer_5,Sara,Gurrutxaga,1994-03-12,01695532H,sara.gurrutxaga@smartapp.app,126346,ES11209547113786786463,1216.37,2024-05-12T12:54:17,Donostia,expenses,transport,-89.3,12280.16
buyer_5,Sara,Gurrutxaga,1994-03-12,01695532H,sara.gurrutxaga@smartapp.app,126346,ES11209547113786786463,1216.37,2024-05-13T20:38:07,Donostia,expenses,education,-73.39,12206.77
buyer_5,Sara,Gurrutxaga,1994-03-12,01695532H,sara.gurrutxaga@smartapp.app,126346,ES11209547113786786463,1216.37,2024-05-16T20:09:08,Donostia,expenses,cash,-100.0,12106.77
buyer_5,Sara,Gurrutxaga,1994-03-12,01695532H,sara.gurrutxaga@smartapp.app,126346,ES11209547113786786463,1216.37,2024-05-18T14:38:14,Donostia,expenses,education,-78.41,12028.36
buyer_5,Sara,Gurrutxaga,1994-03-12,01695532H,sara.gurrutxaga@smartapp.app,126346,ES11209547113786786463,1216.37,2024-05-19T16:23:01,Donostia,expenses,transport,-83.18,11945.18
buyer_5,Sara,Gurrutxaga,1994-03-12,01695532H,sara.gurrutxaga@smartapp.app,126346,ES11209547113786786463,1216.37,2024-05-20T11:45:09,Donostia,expenses,repairs,-129.2,11815.98
buyer_5,Sara,Gurrutxaga,1994-03-12,01695532H,sara.gurrutxaga@smartapp.app,126346,ES11209547113786786463,1216.37,2024-05-21T20:25:46,Donostia,expenses,food,-61.27,11754.71
buyer_5,Sara,Gurrutxaga,1994-03-12,01695532H,sara.gurrutxaga@smartapp.app,126346,ES11209547113786786463,1216.37,2024-05-22T19:12:41,Donostia,expenses,education,-69.78,11684.93
buyer_5,Sara,Gurrutxaga,1994-03-12,01695532H,sara.gurrutxaga@smartapp.app,126346,ES11209547113786786463,1216.37,2024-05-24T08:32:37,Donostia,expenses,gifts,-483.58,11201.35
buyer_5,Sara,Gurrutxaga,1994-03-12,01695532H,sara.gurrutxaga@smartapp.app,126346,ES11209547113786786463,1216.37,2024-05-25T20:28:07,Donostia,expenses,appliances,-248.42,10952.93
buyer_5,Sara,Gurrutxaga,1994-03-12,01695532H,sara.gurrutxaga@smartapp.app,126346,ES11209547113786786463,1216.37,2024-05-26T19:40:40,Donostia,expenses,education,-73.65,10879.28
buyer_5,Sara,Gurrutxaga,1994-03-12,01695532H,sara.gurrutxaga@smartapp.app,126346,ES11209547113786786463,1216.37,2024-05-28T19:06:20,Donostia,expenses,gifts,-147.59,10731.69
buyer_5,Sara,Gurrutxaga,1994-03-12,01695532H,sara.gurrutxaga@smartapp.app,126346,ES11209547113786786463,1216.37,2024-05-31T20:32:56,Donostia,expenses,leisure,-41.62,10690.07
buyer_5,Sara,Gurrutxaga,1994-03-12,01695532H,sara.gurrutxaga@smartapp.app,126346,ES11209547113786786463,1216.37,2024-05-31T15:59:30,Donostia,expenses,gifts,-619.43,10070.64
buyer_5,Sara,Gurrutxaga,1994-03-12,01695532H,sara.gurrutxaga@smartapp.app,126346,ES11209547113786786463,1216.37,2024-06-01T20:05:50,Donostia,incomes,salary,3066.82,13137.46
buyer_5,Sara,Gurrutxaga,1994-03-12,01695532H,sara.gurrutxaga@smartapp.app,126346,ES11209547113786786463,1216.37,2024-06-01T20:05:50,Donostia,incomes,salary_partner,3206.54,16344.0
buyer_5,Sara,Gurrutxaga,1994-03-12,01695532H,sara.gurrutxaga@smartapp.app,126346,ES11209547113786786463,1216.37,2024-06-01T20:05:50,Donostia,incomes,salary_bonus,2234.29,18578.29
buyer_5,Sara,Gurrutxaga,1994-03-12,01695532H,sara.gurrutxaga@smartapp.app,126346,ES11209547113786786463,1216.37,2024-06-01T20:05:50,Donostia,incomes,salary_partner_bonus,2298.65,20876.94
buyer_5,Sara,Gurrutxaga,1994-03-12,01695532H,sara.gurrutxaga@smartapp.app,126346,ES11209547113786786463,1216.37,2024-06-01T22:00:16,Donostia,expenses,gifts,-714.44,20162.5
buyer_5,Sara,Gurrutxaga,1994-03-12,01695532H,sara.gurrutxaga@smartapp.app,126346,ES11209547113786786463,1216.37,2024-06-02T17:43:16,Donostia,expenses,appliances,-210.33,19952.17
buyer_5,Sara,Gurrutxaga,1994-03-12,01695532H,sara.gurrutxaga@smartapp.app,126346,ES11209547113786786463,1216.37,2024-06-04T11:16:08,Donostia,expenses,mortgage,-2772.73,17179.44
buyer_5,Sara,Gurrutxaga,1994-03-12,01695532H,sara.gurrutxaga@smartapp.app,126346,ES11209547113786786463,1216.37,2024-06-06T08:08:23,Donostia,expenses,leisure,-80.72,17098.72
buyer_5,Sara,Gurrutxaga,1994-03-12,01695532H,sara.gurrutxaga@smartapp.app,126346,ES11209547113786786463,1216.37,2024-06-06T20:57:52,Donostia,expenses,repairs,-97.74,17000.98
buyer_5,Sara,Gurrutxaga,1994-03-12,01695532H,sara.gurrutxaga@smartapp.app,126346,ES11209547113786786463,1216.37,2024-06-06T13:53:11,Donostia,expenses,gifts,-504.6,16496.38
buyer_5,Sara,Gurrutxaga,1994-03-12,01695532H,sara.gurrutxaga@smartapp.app,126346,ES11209547113786786463,1216.37,2024-06-07T14:17:50,Donostia,expenses,water,-110.83,16385.55
buyer_5,Sara,Gurrutxaga,1994-03-12,01695532H,sara.gurrutxaga@smartapp.app,126346,ES11209547113786786463,1216.37,2024-06-07T17:30:59,Donostia,expenses,gas,-189.16,16196.39
buyer_5,Sara,Gurrutxaga,1994-03-12,01695532H,sara.gurrutxaga@smartapp.app,126346,ES11209547113786786463,1216.37,2024-06-08T16:49:56,Donostia,expenses,internet,-131.74,16064.65
buyer_5,Sara,Gurrutxaga,1994-03-12,01695532H,sara.gurrutxaga@smartapp.app,126346,ES11209547113786786463,1216.37,2024-06-08T14:47:15,Donostia,expenses,electricity,-281.85,15782.8
buyer_5,Sara,Gurrutxaga,1994-03-12,01695532H,sara.gurrutxaga@smartapp.app,126346,ES11209547113786786463,1216.37,2024-06-08T21:37:17,Donostia,expenses,phone,-136.29,15646.51
buyer_5,Sara,Gurrutxaga,1994-03-12,01695532H,sara.gurrutxaga@smartapp.app,126346,ES11209547113786786463,1216.37,2024-06-09T04:54:59,Donostia,expenses,food,-121.7,15524.81
buyer_5,Sara,Gurrutxaga,1994-03-12,01695532H,sara.gurrutxaga@smartapp.app,126346,ES11209547113786786463,1216.37,2024-06-10T03:29:55,Donostia,expenses,food,-78.93,15445.88
buyer_5,Sara,Gurrutxaga,1994-03-12,01695532H,sara.gurrutxaga@smartapp.app,126346,ES11209547113786786463,1216.37,2024-06-11T17:38:26,Donostia,expenses,appliances,-334.59,15111.29
buyer_5,Sara,Gurrutxaga,1994-03-12,01695532H,sara.gurrutxaga@smartapp.app,126346,ES11209547113786786463,1216.37,2024-06-12T18:03:31,Donostia,expenses,healthcare,-78.81,15032.48
buyer_5,Sara,Gurrutxaga,1994-03-12,01695532H,sara.gurrutxaga@smartapp.app,126346,ES11209547113786786463,1216.37,2024-06-12T09:23:26,Donostia,expenses,appliances,-139.55,14892.93
buyer_5,Sara,Gurrutxaga,1994-03-12,01695532H,sara.gurrutxaga@smartapp.app,126346,ES11209547113786786463,1216.37,2024-06-16T18:09:20,Donostia,expenses,leisure,-47.17,14845.76
buyer_5,Sara,Gurrutxaga,1994-03-12,01695532H,sara.gurrutxaga@smartapp.app,126346,ES11209547113786786463,1216.37,2024-06-18T20:20:36,Donostia,expenses,repairs,-192.49,14653.27
buyer_5,Sara,Gurrutxaga,1994-03-12,01695532H,sara.gurrutxaga@smartapp.app,126346,ES11209547113786786463,1216.37,2024-06-19T09:15:42,Donostia,expenses,food,-67.73,14585.54
buyer_5,Sara,Gurrutxaga,1994-03-12,01695532H,sara.gurrutxaga@smartapp.app,126346,ES11209547113786786463,1216.37,2024-06-19T21:19:05,Donostia,expenses,healthcare,-100.56,14484.98
buyer_5,Sara,Gurrutxaga,1994-03-12,01695532H,sara.gurrutxaga@smartapp.app,126346,ES11209547113786786463,1216.37,2024-06-20T04:03:54,Donostia,expenses,food,-98.77,14386.21
buyer_5,Sara,Gurrutxaga,1994-03-12,01695532H,sara.gurrutxaga@smartapp.app,126346,ES11209547113786786463,1216.37,2024-06-23T16:21:59,Donostia,expenses,cash,-100.0,14286.21
buyer_5,Sara,Gurrutxaga,1994-03-12,01695532H,sara.gurrutxaga@smartapp.app,126346,ES11209547113786786463,1216.37,2024-06-23T20:31:18,Donostia,expenses,repairs,-106.72,14179.49
buyer_5,Sara,Gurrutxaga,1994-03-12,01695532H,sara.gurrutxaga@smartapp.app,126346,ES11209547113786786463,1216.37,2024-06-25T17:45:21,Donostia,expenses,transport,-57.37,14122.12
buyer_5,Sara,Gurrutxaga,1994-03-12,01695532H,sara.gurrutxaga@smartapp.app,126346,ES11209547113786786463,1216.37,2024-06-25T10:16:22,Donostia,expenses,cash,-100.0,14022.12
buyer_5,Sara,Gurrutxaga,1994-03-12,01695532H,sara.gurrutxaga@smartapp.app,126346,ES11209547113786786463,1216.37,2024-06-27T04:18:23,Donostia,expenses,transport,-83.65,13938.47
buyer_5,Sara,Gurrutxaga,1994-03-12,01695532H,sara.gurrutxaga@smartapp.app,126346,ES11209547113786786463,1216.37,2024-06-28T14:50:46,Donostia,expenses,leisure,-50.0,13888.47
buyer_5,Sara,Gurrutxaga,1994-03-12,01695532H,sara.gurrutxaga@smartapp.app,126346,ES11209547113786786463,1216.37,2024-06-30T17:28:09,Donostia,expenses,food,-65.33,13823.14
buyer_5,Sara,Gurrutxaga,1994-03-12,01695532H,sara.gurrutxaga@smartapp.app,126346,ES11209547113786786463,1216.37,2024-06-30T12:21:38,Donostia,expenses,cash,-100.0,13723.14
buyer_5,Sara,Gurrutxaga,1994-03-12,01695532H,sara.gurrutxaga@smartapp.app,126346,ES11209547113786786463,1216.37,2024-07-01T10:10:38,Donostia,incomes,salary,3066.82,16789.96
buyer_5,Sara,Gurrutxaga,1994-03-12,01695532H,sara.gurrutxaga@smartapp.app,126346,ES11209547113786786463,1216.37,2024-07-01T10:10:38,Donostia,incomes,salary_partner,3206.54,19996.5
buyer_5,Sara,Gurrutxaga,1994-03-12,01695532H,sara.gurrutxaga@smartapp.app,126346,ES11209547113786786463,1216.37,2024-07-01T10:10:38,Donostia,incomes,extra_income,437.28,20433.78
buyer_5,Sara,Gurrutxaga,1994-03-12,01695532H,sara.gurrutxaga@smartapp.app,126346,ES11209547113786786463,1216.37,2024-07-02T14:14:23,Donostia,expenses,cash,-100.0,20333.78
buyer_5,Sara,Gurrutxaga,1994-03-12,01695532H,sara.gurrutxaga@smartapp.app,126346,ES11209547113786786463,1216.37,2024-07-03T06:43:54,Donostia,expenses,cash,-100.0,20233.78
buyer_5,Sara,Gurrutxaga,1994-03-12,01695532H,sara.gurrutxaga@smartapp.app,126346,ES11209547113786786463,1216.37,2024-07-03T09:26:16,Donostia,expenses,appliances,-335.48,19898.3
buyer_5,Sara,Gurrutxaga,1994-03-12,01695532H,sara.gurrutxaga@smartapp.app,126346,ES11209547113786786463,1216.37,2024-07-04T09:10:26,Donostia,expenses,mortgage,-2772.73,17125.57
buyer_5,Sara,Gurrutxaga,1994-03-12,01695532H,sara.gurrutxaga@smartapp.app,126346,ES11209547113786786463,1216.37,2024-07-05T16:14:12,Donostia,expenses,water,-97.89,17027.68
buyer_5,Sara,Gurrutxaga,1994-03-12,01695532H,sara.gurrutxaga@smartapp.app,126346,ES11209547113786786463,1216.37,2024-07-05T11:26:52,Donostia,expenses,electricity,-219.15,16808.53
buyer_5,Sara,Gurrutxaga,1994-03-12,01695532H,sara.gurrutxaga@smartapp.app,126346,ES11209547113786786463,1216.37,2024-07-05T20:06:38,Donostia,expenses,cash,-100.0,16708.53
buyer_5,Sara,Gurrutxaga,1994-03-12,01695532H,sara.gurrutxaga@smartapp.app,126346,ES11209547113786786463,1216.37,2024-07-06T12:11:35,Donostia,expenses,food,-107.56,16600.97
buyer_5,Sara,Gurrutxaga,1994-03-12,01695532H,sara.gurrutxaga@smartapp.app,126346,ES11209547113786786463,1216.37,2024-07-07T11:13:14,Donostia,expenses,phone,-115.42,16485.55
buyer_5,Sara,Gurrutxaga,1994-03-12,01695532H,sara.gurrutxaga@smartapp.app,126346,ES11209547113786786463,1216.37,2024-07-07T11:30:32,Donostia,expenses,food,-111.84,16373.71
buyer_5,Sara,Gurrutxaga,1994-03-12,01695532H,sara.gurrutxaga@smartapp.app,126346,ES11209547113786786463,1216.37,2024-07-07T19:45:28,Donostia,expenses,transport,-42.7,16331.01
buyer_5,Sara,Gurrutxaga,1994-03-12,01695532H,sara.gurrutxaga@smartapp.app,126346,ES11209547113786786463,1216.37,2024-07-08T05:02:21,Donostia,expenses,gas,-220.03,16110.98
buyer_5,Sara,Gurrutxaga,1994-03-12,01695532H,sara.gurrutxaga@smartapp.app,126346,ES11209547113786786463,1216.37,2024-07-08T18:29:45,Donostia,expenses,internet,-131.74,15979.24
buyer_5,Sara,Gurrutxaga,1994-03-12,01695532H,sara.gurrutxaga@smartapp.app,126346,ES11209547113786786463,1216.37,2024-07-08T08:56:17,Donostia,expenses,food,-97.97,15881.27
buyer_5,Sara,Gurrutxaga,1994-03-12,01695532H,sara.gurrutxaga@smartapp.app,126346,ES11209547113786786463,1216.37,2024-07-12T23:58:36,Donostia,expenses,leisure,-47.53,15833.74
buyer_5,Sara,Gurrutxaga,1994-03-12,01695532H,sara.gurrutxaga@smartapp.app,126346,ES11209547113786786463,1216.37,2024-07-13T14:55:28,Donostia,expenses,education,-62.96,15770.78
buyer_5,Sara,Gurrutxaga,1994-03-12,01695532H,sara.gurrutxaga@smartapp.app,126346,ES11209547113786786463,1216.37,2024-07-18T05:09:53,Donostia,expenses,education,-66.58,15704.2
buyer_5,Sara,Gurrutxaga,1994-03-12,01695532H,sara.gurrutxaga@smartapp.app,126346,ES11209547113786786463,1216.37,2024-07-19T11:08:45,Donostia,expenses,food,-62.14,15642.06
buyer_5,Sara,Gurrutxaga,1994-03-12,01695532H,sara.gurrutxaga@smartapp.app,126346,ES11209547113786786463,1216.37,2024-07-19T20:53:25,Donostia,expenses,appliances,-341.02,15301.04
buyer_5,Sara,Gurrutxaga,1994-03-12,01695532H,sara.gurrutxaga@smartapp.app,126346,ES11209547113786786463,1216.37,2024-07-20T20:22:26,Donostia,expenses,appliances,-354.09,14946.95
buyer_5,Sara,Gurrutxaga,1994-03-12,01695532H,sara.gurrutxaga@smartapp.app,126346,ES11209547113786786463,1216.37,2024-07-21T14:30:22,Donostia,expenses,leisure,-48.29,14898.66
buyer_5,Sara,Gurrutxaga,1994-03-12,01695532H,sara.gurrutxaga@smartapp.app,126346,ES11209547113786786463,1216.37,2024-07-25T14:13:10,Donostia,expenses,clothing,-69.45,14829.21
buyer_5,Sara,Gurrutxaga,1994-03-12,01695532H,sara.gurrutxaga@smartapp.app,126346,ES11209547113786786463,1216.37,2024-07-26T05:43:59,Donostia,expenses,leisure,-35.39,14793.82
buyer_5,Sara,Gurrutxaga,1994-03-12,01695532H,sara.gurrutxaga@smartapp.app,126346,ES11209547113786786463,1216.37,2024-07-26T13:42:22,Donostia,expenses,cash,-100.0,14693.82
buyer_5,Sara,Gurrutxaga,1994-03-12,01695532H,sara.gurrutxaga@smartapp.app,126346,ES11209547113786786463,1216.37,2024-07-26T17:47:04,Donostia,expenses,travel,-883.0,13810.82
buyer_5,Sara,Gurrutxaga,1994-03-12,01695532H,sara.gurrutxaga@smartapp.app,126346,ES11209547113786786463,1216.37,2024-07-29T23:54:09,Donostia,expenses,transport,-76.4,13734.42
buyer_5,Sara,Gurrutxaga,1994-03-12,01695532H,sara.gurrutxaga@smartapp.app,126346,ES11209547113786786463,1216.37,2024-07-29T11:11:12,Donostia,expenses,cash,-100.0,13634.42
buyer_5,Sara,Gurrutxaga,1994-03-12,01695532H,sara.gurrutxaga@smartapp.app,126346,ES11209547113786786463,1216.37,2024-07-30T12:43:50,Donostia,expenses,leisure,-79.6,13554.82
buyer_5,Sara,Gurrutxaga,1994-03-12,01695532H,sara.gurrutxaga@smartapp.app,126346,ES11209547113786786463,1216.37,2024-07-30T15:28:39,Donostia,expenses,gifts,-802.33,12752.49
buyer_5,Sara,Gurrutxaga,1994-03-12,01695532H,sara.gurrutxaga@smartapp.app,126346,ES11209547113786786463,1216.37,2024-07-31T16:00:26,Donostia,expenses,food,-69.83,12682.66
buyer_5,Sara,Gurrutxaga,1994-03-12,01695532H,sara.gurrutxaga@smartapp.app,126346,ES11209547113786786463,1216.37,2024-07-31T14:10:02,Donostia,expenses,repairs,-215.79,12466.87
buyer_5,Sara,Gurrutxaga,1994-03-12,01695532H,sara.gurrutxaga@smartapp.app,126346,ES11209547113786786463,1216.37,2024-08-01T09:10:36,Donostia,incomes,salary,3066.82,15533.69
buyer_5,Sara,Gurrutxaga,1994-03-12,01695532H,sara.gurrutxaga@smartapp.app,126346,ES11209547113786786463,1216.37,2024-08-01T09:10:36,Donostia,incomes,salary_partner,3206.54,18740.23
buyer_5,Sara,Gurrutxaga,1994-03-12,01695532H,sara.gurrutxaga@smartapp.app,126346,ES11209547113786786463,1216.37,2024-08-02T18:00:56,Donostia,expenses,food,-65.84,18674.39
buyer_5,Sara,Gurrutxaga,1994-03-12,01695532H,sara.gurrutxaga@smartapp.app,126346,ES11209547113786786463,1216.37,2024-08-04T16:55:01,Donostia,expenses,mortgage,-2772.73,15901.66
buyer_5,Sara,Gurrutxaga,1994-03-12,01695532H,sara.gurrutxaga@smartapp.app,126346,ES11209547113786786463,1216.37,2024-08-04T18:01:36,Donostia,expenses,food,-63.51,15838.15
buyer_5,Sara,Gurrutxaga,1994-03-12,01695532H,sara.gurrutxaga@smartapp.app,126346,ES11209547113786786463,1216.37,2024-08-04T06:54:17,Donostia,expenses,repairs,-218.86,15619.29
buyer_5,Sara,Gurrutxaga,1994-03-12,01695532H,sara.gurrutxaga@smartapp.app,126346,ES11209547113786786463,1216.37,2024-08-05T22:48:45,Donostia,expenses,cash,-100.0,15519.29
buyer_5,Sara,Gurrutxaga,1994-03-12,01695532H,sara.gurrutxaga@smartapp.app,126346,ES11209547113786786463,1216.37,2024-08-06T18:23:53,Donostia,expenses,internet,-131.74,15387.55
buyer_5,Sara,Gurrutxaga,1994-03-12,01695532H,sara.gurrutxaga@smartapp.app,126346,ES11209547113786786463,1216.37,2024-08-06T10:27:44,Donostia,expenses,phone,-98.33,15289.22
buyer_5,Sara,Gurrutxaga,1994-03-12,01695532H,sara.gurrutxaga@smartapp.app,126346,ES11209547113786786463,1216.37,2024-08-06T14:27:00,Donostia,expenses,food,-98.82,15190.4
buyer_5,Sara,Gurrutxaga,1994-03-12,01695532H,sara.gurrutxaga@smartapp.app,126346,ES11209547113786786463,1216.37,2024-08-06T15:18:29,Donostia,expenses,transport,-77.49,15112.91
buyer_5,Sara,Gurrutxaga,1994-03-12,01695532H,sara.gurrutxaga@smartapp.app,126346,ES11209547113786786463,1216.37,2024-08-06T19:41:57,Donostia,expenses,gifts,-115.67,14997.24
buyer_5,Sara,Gurrutxaga,1994-03-12,01695532H,sara.gurrutxaga@smartapp.app,126346,ES11209547113786786463,1216.37,2024-08-07T18:29:08,Donostia,expenses,water,-69.07,14928.17
buyer_5,Sara,Gurrutxaga,1994-03-12,01695532H,sara.gurrutxaga@smartapp.app,126346,ES11209547113786786463,1216.37,2024-08-08T19:44:24,Donostia,expenses,electricity,-191.85,14736.32
buyer_5,Sara,Gurrutxaga,1994-03-12,01695532H,sara.gurrutxaga@smartapp.app,126346,ES11209547113786786463,1216.37,2024-08-08T14:33:27,Donostia,expenses,gas,-231.58,14504.74
buyer_5,Sara,Gurrutxaga,1994-03-12,01695532H,sara.gurrutxaga@smartapp.app,126346,ES11209547113786786463,1216.37,2024-08-09T23:06:05,Donostia,expenses,gifts,-493.32,14011.42
buyer_5,Sara,Gurrutxaga,1994-03-12,01695532H,sara.gurrutxaga@smartapp.app,126346,ES11209547113786786463,1216.37,2024-08-10T13:07:54,Donostia,expenses,cash,-100.0,13911.42
buyer_5,Sara,Gurrutxaga,1994-03-12,01695532H,sara.gurrutxaga@smartapp.app,126346,ES11209547113786786463,1216.37,2024-08-14T18:48:09,Donostia,expenses,food,-117.61,13793.81
buyer_5,Sara,Gurrutxaga,1994-03-12,01695532H,sara.gurrutxaga@smartapp.app,126346,ES11209547113786786463,1216.37,2024-08-18T16:39:39,Donostia,expenses,food,-77.03,13716.78
buyer_5,Sara,Gurrutxaga,1994-03-12,01695532H,sara.gurrutxaga@smartapp.app,126346,ES11209547113786786463,1216.37,2024-08-22T23:37:16,Donostia,expenses,transport,-88.3,13628.48
buyer_5,Sara,Gurrutxaga,1994-03-12,01695532H,sara.gurrutxaga@smartapp.app,126346,ES11209547113786786463,1216.37,2024-08-24T12:04:27,Donostia,expenses,food,-100.16,13528.32
buyer_5,Sara,Gurrutxaga,1994-03-12,01695532H,sara.gurrutxaga@smartapp.app,126346,ES11209547113786786463,1216.37,2024-08-26T10:16:28,Donostia,expenses,transport,-44.95,13483.37
buyer_5,Sara,Gurrutxaga,1994-03-12,01695532H,sara.gurrutxaga@smartapp.app,126346,ES11209547113786786463,1216.37,2024-08-26T16:12:26,Donostia,expenses,leisure,-78.41,13404.96
buyer_5,Sara,Gurrutxaga,1994-03-12,01695532H,sara.gurrutxaga@smartapp.app,126346,ES11209547113786786463,1216.37,2024-08-29T11:42:25,Donostia,expenses,leisure,-37.6,13367.36
buyer_5,Sara,Gurrutxaga,1994-03-12,01695532H,sara.gurrutxaga@smartapp.app,126346,ES11209547113786786463,1216.37,2024-08-29T13:18:00,Donostia,expenses,cash,-100.0,13267.36
buyer_5,Sara,Gurrutxaga,1994-03-12,01695532H,sara.gurrutxaga@smartapp.app,126346,ES11209547113786786463,1216.37,2024-08-30T16:38:23,Donostia,expenses,leisure,-51.08,13216.28
buyer_5,Sara,Gurrutxaga,1994-03-12,01695532H,sara.gurrutxaga@smartapp.app,126346,ES11209547113786786463,1216.37,2024-08-31T19:39:38,Donostia,expenses,food,-73.59,13142.69
buyer_5,Sara,Gurrutxaga,1994-03-12,01695532H,sara.gurrutxaga@smartapp.app,126346,ES11209547113786786463,1216.37,2024-08-31T11:35:18,Donostia,expenses,repairs,-276.63,12866.06
buyer_5,Sara,Gurrutxaga,1994-03-12,01695532H,sara.gurrutxaga@smartapp.app,126346,ES11209547113786786463,1216.37,2024-09-01T18:14:34,Donostia,incomes,salary,3066.82,15932.88
buyer_5,Sara,Gurrutxaga,1994-03-12,01695532H,sara.gurrutxaga@smartapp.app,126346,ES11209547113786786463,1216.37,2024-09-01T18:14:34,Donostia,incomes,salary_partner,3206.54,19139.42
buyer_5,Sara,Gurrutxaga,1994-03-12,01695532H,sara.gurrutxaga@smartapp.app,126346,ES11209547113786786463,1216.37,2024-09-01T21:27:48,Donostia,expenses,gifts,-510.27,18629.15
buyer_5,Sara,Gurrutxaga,1994-03-12,01695532H,sara.gurrutxaga@smartapp.app,126346,ES11209547113786786463,1216.37,2024-09-02T18:43:28,Donostia,expenses,cash,-100.0,18529.15
buyer_5,Sara,Gurrutxaga,1994-03-12,01695532H,sara.gurrutxaga@smartapp.app,126346,ES11209547113786786463,1216.37,2024-09-03T11:56:53,Donostia,expenses,repairs,-124.17,18404.98
buyer_5,Sara,Gurrutxaga,1994-03-12,01695532H,sara.gurrutxaga@smartapp.app,126346,ES11209547113786786463,1216.37,2024-09-04T23:51:55,Donostia,expenses,mortgage,-2772.73,15632.25
buyer_5,Sara,Gurrutxaga,1994-03-12,01695532H,sara.gurrutxaga@smartapp.app,126346,ES11209547113786786463,1216.37,2024-09-04T17:49:05,Donostia,expenses,cash,-100.0,15532.25
buyer_5,Sara,Gurrutxaga,1994-03-12,01695532H,sara.gurrutxaga@smartapp.app,126346,ES11209547113786786463,1216.37,2024-09-05T09:58:47,Donostia,expenses,gas,-120.77,15411.48
buyer_5,Sara,Gurrutxaga,1994-03-12,01695532H,sara.gurrutxaga@smartapp.app,126346,ES11209547113786786463,1216.37,2024-09-05T17:48:41,Donostia,expenses,internet,-131.74,15279.74
buyer_5,Sara,Gurrutxaga,1994-03-12,01695532H,sara.gurrutxaga@smartapp.app,126346,ES11209547113786786463,1216.37,2024-09-06T12:41:35,Donostia,expenses,transport,-78.36,15201.38
buyer_5,Sara,Gurrutxaga,1994-03-12,01695532H,sara.gurrutxaga@smartapp.app,126346,ES11209547113786786463,1216.37,2024-09-07T08:08:16,Donostia,expenses,electricity,-147.03,15054.35
buyer_5,Sara,Gurrutxaga,1994-03-12,01695532H,sara.gurrutxaga@smartapp.app,126346,ES11209547113786786463,1216.37,2024-09-07T17:33:22,Donostia,expenses,gifts,-775.55,14278.8
buyer_5,Sara,Gurrutxaga,1994-03-12,01695532H,sara.gurrutxaga@smartapp.app,126346,ES11209547113786786463,1216.37,2024-09-08T20:31:44,Donostia,expenses,water,-96.55,14182.25
buyer_5,Sara,Gurrutxaga,1994-03-12,01695532H,sara.gurrutxaga@smartapp.app,126346,ES11209547113786786463,1216.37,2024-09-08T04:26:06,Donostia,expenses,phone,-120.16,14062.09
buyer_5,Sara,Gurrutxaga,1994-03-12,01695532H,sara.gurrutxaga@smartapp.app,126346,ES11209547113786786463,1216.37,2024-09-09T14:50:47,Donostia,expenses,clothing,-103.38,13958.71
buyer_5,Sara,Gurrutxaga,1994-03-12,01695532H,sara.gurrutxaga@smartapp.app,126346,ES11209547113786786463,1216.37,2024-09-10T23:59:04,Donostia,expenses,leisure,-58.28,13900.43
buyer_5,Sara,Gurrutxaga,1994-03-12,01695532H,sara.gurrutxaga@smartapp.app,126346,ES11209547113786786463,1216.37,2024-09-11T18:33:31,Donostia,expenses,cash,-100.0,13800.43
buyer_5,Sara,Gurrutxaga,1994-03-12,01695532H,sara.gurrutxaga@smartapp.app,126346,ES11209547113786786463,1216.37,2024-09-15T15:55:56,Donostia,expenses,clothing,-123.78,13676.65
buyer_5,Sara,Gurrutxaga,1994-03-12,01695532H,sara.gurrutxaga@smartapp.app,126346,ES11209547113786786463,1216.37,2024-09-15T13:50:03,Donostia,expenses,repairs,-316.7,13359.95
buyer_5,Sara,Gurrutxaga,1994-03-12,01695532H,sara.gurrutxaga@smartapp.app,126346,ES11209547113786786463,1216.37,2024-09-16T12:46:28,Donostia,expenses,food,-91.74,13268.21
buyer_5,Sara,Gurrutxaga,1994-03-12,01695532H,sara.gurrutxaga@smartapp.app,126346,ES11209547113786786463,1216.37,2024-09-16T12:05:56,Donostia,expenses,cash,-100.0,13168.21
buyer_5,Sara,Gurrutxaga,1994-03-12,01695532H,sara.gurrutxaga@smartapp.app,126346,ES11209547113786786463,1216.37,2024-09-17T11:28:52,Donostia,expenses,food,-121.04,13047.17
buyer_5,Sara,Gurrutxaga,1994-03-12,01695532H,sara.gurrutxaga@smartapp.app,126346,ES11209547113786786463,1216.37,2024-09-17T08:06:25,Donostia,expenses,transport,-48.21,12998.96
buyer_5,Sara,Gurrutxaga,1994-03-12,01695532H,sara.gurrutxaga@smartapp.app,126346,ES11209547113786786463,1216.37,2024-09-17T05:34:37,Donostia,expenses,appliances,-231.58,12767.38
buyer_5,Sara,Gurrutxaga,1994-03-12,01695532H,sara.gurrutxaga@smartapp.app,126346,ES11209547113786786463,1216.37,2024-09-19T10:41:58,Donostia,expenses,leisure,-67.56,12699.82
buyer_5,Sara,Gurrutxaga,1994-03-12,01695532H,sara.gurrutxaga@smartapp.app,126346,ES11209547113786786463,1216.37,2024-09-19T19:53:39,Donostia,expenses,cash,-100.0,12599.82
buyer_5,Sara,Gurrutxaga,1994-03-12,01695532H,sara.gurrutxaga@smartapp.app,126346,ES11209547113786786463,1216.37,2024-09-21T14:57:16,Donostia,expenses,cash,-100.0,12499.82
buyer_5,Sara,Gurrutxaga,1994-03-12,01695532H,sara.gurrutxaga@smartapp.app,126346,ES11209547113786786463,1216.37,2024-09-23T13:17:30,Donostia,expenses,education,-48.93,12450.89
buyer_5,Sara,Gurrutxaga,1994-03-12,01695532H,sara.gurrutxaga@smartapp.app,126346,ES11209547113786786463,1216.37,2024-09-23T14:37:27,Donostia,expenses,cash,-100.0,12350.89
buyer_5,Sara,Gurrutxaga,1994-03-12,01695532H,sara.gurrutxaga@smartapp.app,126346,ES11209547113786786463,1216.37,2024-09-24T18:51:42,Donostia,expenses,cash,-100.0,12250.89
buyer_5,Sara,Gurrutxaga,1994-03-12,01695532H,sara.gurrutxaga@smartapp.app,126346,ES11209547113786786463,1216.37,2024-09-26T20:34:35,Donostia,expenses,repairs,-296.41,11954.48
buyer_5,Sara,Gurrutxaga,1994-03-12,01695532H,sara.gurrutxaga@smartapp.app,126346,ES11209547113786786463,1216.37,2024-10-01T09:19:16,Donostia,incomes,salary,3066.82,15021.3
buyer_5,Sara,Gurrutxaga,1994-03-12,01695532H,sara.gurrutxaga@smartapp.app,126346,ES11209547113786786463,1216.37,2024-10-01T09:19:16,Donostia,incomes,salary_partner,3206.54,18227.84
buyer_5,Sara,Gurrutxaga,1994-03-12,01695532H,sara.gurrutxaga@smartapp.app,126346,ES11209547113786786463,1216.37,2024-10-01T09:19:16,Donostia,incomes,extra_income,437.28,18665.12
buyer_5,Sara,Gurrutxaga,1994-03-12,01695532H,sara.gurrutxaga@smartapp.app,126346,ES11209547113786786463,1216.37,2024-10-02T08:07:55,Donostia,expenses,food,-102.25,18562.87
buyer_5,Sara,Gurrutxaga,1994-03-12,01695532H,sara.gurrutxaga@smartapp.app,126346,ES11209547113786786463,1216.37,2024-10-02T17:03:25,Donostia,expenses,leisure,-81.91,18480.96
buyer_5,Sara,Gurrutxaga,1994-03-12,01695532H,sara.gurrutxaga@smartapp.app,126346,ES11209547113786786463,1216.37,2024-10-02T11:58:59,Donostia,expenses,cash,-100.0,18380.96
buyer_5,Sara,Gurrutxaga,1994-03-12,01695532H,sara.gurrutxaga@smartapp.app,126346,ES11209547113786786463,1216.37,2024-10-03T20:07:24,Donostia,expenses,cash,-100.0,18280.96
buyer_5,Sara,Gurrutxaga,1994-03-12,01695532H,sara.gurrutxaga@smartapp.app,126346,ES11209547113786786463,1216.37,2024-10-04T18:27:45,Donostia,expenses,mortgage,-2772.73,15508.23
buyer_5,Sara,Gurrutxaga,1994-03-12,01695532H,sara.gurrutxaga@smartapp.app,126346,ES11209547113786786463,1216.37,2024-10-04T15:05:55,Donostia,expenses,leisure,-27.2,15481.03
buyer_5,Sara,Gurrutxaga,1994-03-12,01695532H,sara.gurrutxaga@smartapp.app,126346,ES11209547113786786463,1216.37,2024-10-04T18:17:46,Donostia,expenses,gifts,-457.1,15023.93
buyer_5,Sara,Gurrutxaga,1994-03-12,01695532H,sara.gurrutxaga@smartapp.app,126346,ES11209547113786786463,1216.37,2024-10-05T20:23:25,Donostia,expenses,water,-113.1,14910.83
buyer_5,Sara,Gurrutxaga,1994-03-12,01695532H,sara.gurrutxaga@smartapp.app,126346,ES11209547113786786463,1216.37,2024-10-05T13:28:35,Donostia,expenses,leisure,-45.31,14865.52
buyer_5,Sara,Gurrutxaga,1994-03-12,01695532H,sara.gurrutxaga@smartapp.app,126346,ES11209547113786786463,1216.37,2024-10-06T00:53:21,Donostia,expenses,electricity,-153.97,14711.55
buyer_5,Sara,Gurrutxaga,1994-03-12,01695532H,sara.gurrutxaga@smartapp.app,126346,ES11209547113786786463,1216.37,2024-10-06T11:47:50,Donostia,expenses,phone,-138.13,14573.42
buyer_5,Sara,Gurrutxaga,1994-03-12,01695532H,sara.gurrutxaga@smartapp.app,126346,ES11209547113786786463,1216.37,2024-10-06T18:23:52,Donostia,expenses,education,-46.48,14526.94
buyer_5,Sara,Gurrutxaga,1994-03-12,01695532H,sara.gurrutxaga@smartapp.app,126346,ES11209547113786786463,1216.37,2024-10-08T09:03:10,Donostia,expenses,gas,-183.79,14343.15
buyer_5,Sara,Gurrutxaga,1994-03-12,01695532H,sara.gurrutxaga@smartapp.app,126346,ES11209547113786786463,1216.37,2024-10-08T08:48:18,Donostia,expenses,internet,-131.74,14211.41
buyer_5,Sara,Gurrutxaga,1994-03-12,01695532H,sara.gurrutxaga@smartapp.app,126346,ES11209547113786786463,1216.37,2024-10-10T18:21:37,Donostia,expenses,transport,-67.59,14143.82
buyer_5,Sara,Gurrutxaga,1994-03-12,01695532H,sara.gurrutxaga@smartapp.app,126346,ES11209547113786786463,1216.37,2024-10-10T19:51:18,Donostia,expenses,healthcare,-80.09,14063.73
buyer_6,Manuel,Rodríguez,1979-02-14,48702192Z,manuel.rodríguez@smartdev.org,107107,ES88209540227161223022,1256.82,2022-01-01T10:10:02,Vitoria-Gasteiz,incomes,salary,1304.03,2560.85
buyer_6,Manuel,Rodríguez,1979-02-14,48702192Z,manuel.rodríguez@smartdev.org,107107,ES88209540227161223022,1256.82,2022-01-01T13:35:13,Vitoria-Gasteiz,expenses,cash,-100.0,2460.85
buyer_6,Manuel,Rodríguez,1979-02-14,48702192Z,manuel.rodríguez@smartdev.org,107107,ES88209540227161223022,1256.82,2022-01-02T19:37:10,Vitoria-Gasteiz,expenses,transport,-73.24,2387.61
buyer_6,Manuel,Rodríguez,1979-02-14,48702192Z,manuel.rodríguez@smartdev.org,107107,ES88209540227161223022,1256.82,2022-01-02T13:01:37,Vitoria-Gasteiz,expenses,healthcare,-125.0,2262.61
buyer_6,Manuel,Rodríguez,1979-02-14,48702192Z,manuel.rodríguez@smartdev.org,107107,ES88209540227161223022,1256.82,2022-01-02T20:56:06,Vitoria-Gasteiz,expenses,cash,-100.0,2162.61
buyer_6,Manuel,Rodríguez,1979-02-14,48702192Z,manuel.rodríguez@smartdev.org,107107,ES88209540227161223022,1256.82,2022-01-04T18:06:11,Vitoria-Gasteiz,expenses,mortgage,-544.7,1617.91
buyer_6,Manuel,Rodríguez,1979-02-14,48702192Z,manuel.rodríguez@smartdev.org,107107,ES88209540227161223022,1256.82,2022-01-05T15:52:13,Vitoria-Gasteiz,expenses,gas,-19.62,1598.29
buyer_6,Manuel,Rodríguez,1979-02-14,48702192Z,manuel.rodríguez@smartdev.org,107107,ES88209540227161223022,1256.82,2022-01-05T22:53:54,Vitoria-Gasteiz,expenses,internet,-27.38,1570.91
buyer_6,Manuel,Rodríguez,1979-02-14,48702192Z,manuel.rodríguez@smartdev.org,107107,ES88209540227161223022,1256.82,2022-01-06T20:36:48,Vitoria-Gasteiz,expenses,water,-15.77,1555.14
buyer_6,Manuel,Rodríguez,1979-02-14,48702192Z,manuel.rodríguez@smartdev.org,107107,ES88209540227161223022,1256.82,2022-01-06T04:33:18,Vitoria-Gasteiz,expenses,transport,-88.63,1466.51
buyer_6,Manuel,Rodríguez,1979-02-14,48702192Z,manuel.rodríguez@smartdev.org,107107,ES88209540227161223022,1256.82,2022-01-07T20:08:38,Vitoria-Gasteiz,expenses,food,-71.79,1394.72
buyer_6,Manuel,Rodríguez,1979-02-14,48702192Z,manuel.rodríguez@smartdev.org,107107,ES88209540227161223022,1256.82,2022-01-07T06:01:53,Vitoria-Gasteiz,expenses,leisure,-47.02,1347.7
buyer_6,Manuel,Rodríguez,1979-02-14,48702192Z,manuel.rodríguez@smartdev.org,107107,ES88209540227161223022,1256.82,2022-01-07T16:18:27,Vitoria-Gasteiz,expenses,clothing,-61.88,1285.82
buyer_6,Manuel,Rodríguez,1979-02-14,48702192Z,manuel.rodríguez@smartdev.org,107107,ES88209540227161223022,1256.82,2022-01-08T23:02:16,Vitoria-Gasteiz,expenses,electricity,-33.72,1252.1
buyer_6,Manuel,Rodríguez,1979-02-14,48702192Z,manuel.rodríguez@smartdev.org,107107,ES88209540227161223022,1256.82,2022-01-08T08:29:57,Vitoria-Gasteiz,expenses,phone,-21.29,1230.81
buyer_6,Manuel,Rodríguez,1979-02-14,48702192Z,manuel.rodríguez@smartdev.org,107107,ES88209540227161223022,1256.82,2022-01-08T15:51:42,Vitoria-Gasteiz,expenses,leisure,-47.22,1183.59
buyer_6,Manuel,Rodríguez,1979-02-14,48702192Z,manuel.rodríguez@smartdev.org,107107,ES88209540227161223022,1256.82,2022-01-09T20:26:20,Vitoria-Gasteiz,expenses,gifts,-427.43,756.16
buyer_6,Manuel,Rodríguez,1979-02-14,48702192Z,manuel.rodríguez@smartdev.org,107107,ES88209540227161223022,1256.82,2022-01-10T11:29:54,Vitoria-Gasteiz,expenses,food,-87.81,668.35
buyer_6,Manuel,Rodríguez,1979-02-14,48702192Z,manuel.rodríguez@smartdev.org,107107,ES88209540227161223022,1256.82,2022-01-10T11:35:03,Vitoria-Gasteiz,expenses,leisure,-57.47,610.88
buyer_6,Manuel,Rodríguez,1979-02-14,48702192Z,manuel.rodríguez@smartdev.org,107107,ES88209540227161223022,1256.82,2022-01-10T03:06:59,Vitoria-Gasteiz,expenses,travel,-459.43,151.45
buyer_6,Manuel,Rodríguez,1979-02-14,48702192Z,manuel.rodríguez@smartdev.org,107107,ES88209540227161223022,1256.82,2022-01-10T12:08:05,Vitoria-Gasteiz,expenses,repairs,-189.45,-38.0
buyer_6,Manuel,Rodríguez,1979-02-14,48702192Z,manuel.rodríguez@smartdev.org,107107,ES88209540227161223022,1256.82,2022-01-12T17:11:24,Vitoria-Gasteiz,expenses,food,-94.44,-132.44
buyer_6,Manuel,Rodríguez,1979-02-14,48702192Z,manuel.rodríguez@smartdev.org,107107,ES88209540227161223022,1256.82,2022-01-12T18:08:10,Vitoria-Gasteiz,expenses,education,-54.32,-186.76
buyer_6,Manuel,Rodríguez,1979-02-14,48702192Z,manuel.rodríguez@smartdev.org,107107,ES88209540227161223022,1256.82,2022-01-13T20:42:42,Vitoria-Gasteiz,expenses,transport,-55.09,-241.85
buyer_6,Manuel,Rodríguez,1979-02-14,48702192Z,manuel.rodríguez@smartdev.org,107107,ES88209540227161223022,1256.82,2022-01-13T09:59:23,Vitoria-Gasteiz,expenses,leisure,-74.03,-315.88
buyer_6,Manuel,Rodríguez,1979-02-14,48702192Z,manuel.rodríguez@smartdev.org,107107,ES88209540227161223022,1256.82,2022-01-14T15:57:25,Vitoria-Gasteiz,expenses,appliances,-403.04,-718.92
buyer_6,Manuel,Rodríguez,1979-02-14,48702192Z,manuel.rodríguez@smartdev.org,107107,ES88209540227161223022,1256.82,2022-01-15T19:39:57,Vitoria-Gasteiz,expenses,repairs,-135.66,-854.58
buyer_6,Manuel,Rodríguez,1979-02-14,48702192Z,manuel.rodríguez@smartdev.org,107107,ES88209540227161223022,1256.82,2022-01-16T12:19:48,Vitoria-Gasteiz,expenses,food,-114.93,-969.51
buyer_6,Manuel,Rodríguez,1979-02-14,48702192Z,manuel.rodríguez@smartdev.org,107107,ES88209540227161223022,1256.82,2022-01-16T12:24:44,Vitoria-Gasteiz,expenses,gifts,-658.65,-1628.16
buyer_6,Manuel,Rodríguez,1979-02-14,48702192Z,manuel.rodríguez@smartdev.org,107107,ES88209540227161223022,1256.82,2022-01-17T13:45:48,Vitoria-Gasteiz,expenses,transport,-76.01,-1704.17
buyer_6,Manuel,Rodríguez,1979-02-14,48702192Z,manuel.rodríguez@smartdev.org,107107,ES88209540227161223022,1256.82,2022-01-17T21:57:20,Vitoria-Gasteiz,expenses,cash,-100.0,-1804.17
buyer_6,Manuel,Rodríguez,1979-02-14,48702192Z,manuel.rodríguez@smartdev.org,107107,ES88209540227161223022,1256.82,2022-01-17T20:25:58,Vitoria-Gasteiz,expenses,repairs,-237.19,-2041.36
buyer_6,Manuel,Rodríguez,1979-02-14,48702192Z,manuel.rodríguez@smartdev.org,107107,ES88209540227161223022,1256.82,2022-01-18T23:56:30,Vitoria-Gasteiz,expenses,food,-107.8,-2149.16
buyer_6,Manuel,Rodríguez,1979-02-14,48702192Z,manuel.rodríguez@smartdev.org,107107,ES88209540227161223022,1256.82,2022-01-18T15:54:53,Vitoria-Gasteiz,expenses,cash,-100.0,-2249.16
buyer_6,Manuel,Rodríguez,1979-02-14,48702192Z,manuel.rodríguez@smartdev.org,107107,ES88209540227161223022,1256.82,2022-01-18T12:52:50,Vitoria-Gasteiz,expenses,appliances,-174.46,-2423.62
buyer_6,Manuel,Rodríguez,1979-02-14,48702192Z,manuel.rodríguez@smartdev.org,107107,ES88209540227161223022,1256.82,2022-01-20T19:34:56,Vitoria-Gasteiz,expenses,transport,-79.11,-2502.73
buyer_6,Manuel,Rodríguez,1979-02-14,48702192Z,manuel.rodríguez@smartdev.org,107107,ES88209540227161223022,1256.82,2022-01-21T09:05:44,Vitoria-Gasteiz,expenses,leisure,-54.89,-2557.62
buyer_6,Manuel,Rodríguez,1979-02-14,48702192Z,manuel.rodríguez@smartdev.org,107107,ES88209540227161223022,1256.82,2022-01-22T09:25:05,Vitoria-Gasteiz,expenses,leisure,-37.53,-2595.15
buyer_6,Manuel,Rodríguez,1979-02-14,48702192Z,manuel.rodríguez@smartdev.org,107107,ES88209540227161223022,1256.82,2022-01-22T06:17:07,Vitoria-Gasteiz,expenses,education,-54.68,-2649.83
buyer_6,Manuel,Rodríguez,1979-02-14,48702192Z,manuel.rodríguez@smartdev.org,107107,ES88209540227161223022,1256.82,2022-01-25T14:33:39,Vitoria-Gasteiz,expenses,food,-86.62,-2736.45
buyer_6,Manuel,Rodríguez,1979-02-14,48702192Z,manuel.rodríguez@smartdev.org,107107,ES88209540227161223022,1256.82,2022-01-25T13:32:22,Vitoria-Gasteiz,expenses,appliances,-152.57,-2889.02
buyer_6,Manuel,Rodríguez,1979-02-14,48702192Z,manuel.rodríguez@smartdev.org,107107,ES88209540227161223022,1256.82,2022-01-26T00:46:25,Vitoria-Gasteiz,expenses,food,-67.16,-2956.18
buyer_6,Manuel,Rodríguez,1979-02-14,48702192Z,manuel.rodríguez@smartdev.org,107107,ES88209540227161223022,1256.82,2022-01-26T08:08:13,Vitoria-Gasteiz,expenses,cash,-100.0,-3056.18
buyer_6,Manuel,Rodríguez,1979-02-14,48702192Z,manuel.rodríguez@smartdev.org,107107,ES88209540227161223022,1256.82,2022-01-27T16:34:22,Vitoria-Gasteiz,expenses,leisure,-35.97,-3092.15
buyer_6,Manuel,Rodríguez,1979-02-14,48702192Z,manuel.rodríguez@smartdev.org,107107,ES88209540227161223022,1256.82,2022-01-28T15:46:54,Vitoria-Gasteiz,expenses,food,-76.0,-3168.15
buyer_6,Manuel,Rodríguez,1979-02-14,48702192Z,manuel.rodríguez@smartdev.org,107107,ES88209540227161223022,1256.82,2022-01-29T07:55:02,Vitoria-Gasteiz,expenses,cash,-100.0,-3268.15
buyer_6,Manuel,Rodríguez,1979-02-14,48702192Z,manuel.rodríguez@smartdev.org,107107,ES88209540227161223022,1256.82,2022-02-01T21:21:45,Vitoria-Gasteiz,incomes,salary,1304.03,-1964.12
buyer_6,Manuel,Rodríguez,1979-02-14,48702192Z,manuel.rodríguez@smartdev.org,107107,ES88209540227161223022,1256.82,2022-02-01T12:57:55,Vitoria-Gasteiz,expenses,appliances,-386.03,-2350.15
buyer_6,Manuel,Rodríguez,1979-02-14,48702192Z,manuel.rodríguez@smartdev.org,107107,ES88209540227161223022,1256.82,2022-02-04T14:52:48,Vitoria-Gasteiz,expenses,mortgage,-544.7,-2894.85
buyer_6,Manuel,Rodríguez,1979-02-14,48702192Z,manuel.rodríguez@smartdev.org,107107,ES88209540227161223022,1256.82,2022-02-04T18:13:14,Vitoria-Gasteiz,expenses,education,-78.68,-2973.53
buyer_6,Manuel,Rodríguez,1979-02-14,48702192Z,manuel.rodríguez@smartdev.org,107107,ES88209540227161223022,1256.82,2022-02-05T14:44:22,Vitoria-Gasteiz,expenses,cash,-100.0,-3073.53
buyer_6,Manuel,Rodríguez,1979-02-14,48702192Z,manuel.rodríguez@smartdev.org,107107,ES88209540227161223022,1256.82,2022-02-06T13:53:45,Vitoria-Gasteiz,expenses,education,-76.41,-3149.94
buyer_6,Manuel,Rodríguez,1979-02-14,48702192Z,manuel.rodríguez@smartdev.org,107107,ES88209540227161223022,1256.82,2022-02-07T10:04:17,Vitoria-Gasteiz,expenses,gas,-62.36,-3212.3
buyer_6,Manuel,Rodríguez,1979-02-14,48702192Z,manuel.rodríguez@smartdev.org,107107,ES88209540227161223022,1256.82,2022-02-07T07:00:09,Vitoria-Gasteiz,expenses,internet,-27.38,-3239.68
buyer_6,Manuel,Rodríguez,1979-02-14,48702192Z,manuel.rodríguez@smartdev.org,107107,ES88209540227161223022,1256.82,2022-02-08T08:19:03,Vitoria-Gasteiz,expenses,water,-20.13,-3259.81
buyer_6,Manuel,Rodríguez,1979-02-14,48702192Z,manuel.rodríguez@smartdev.org,107107,ES88209540227161223022,1256.82,2022-02-08T14:51:09,Vitoria-Gasteiz,expenses,phone,-26.66,-3286.47
buyer_6,Manuel,Rodríguez,1979-02-14,48702192Z,manuel.rodríguez@smartdev.org,107107,ES88209540227161223022,1256.82,2022-02-08T22:24:59,Vitoria-Gasteiz,expenses,electricity,-29.09,-3315.56
buyer_6,Manuel,Rodríguez,1979-02-14,48702192Z,manuel.rodríguez@smartdev.org,107107,ES88209540227161223022,1256.82,2022-02-08T12:21:20,Vitoria-Gasteiz,expenses,leisure,-31.78,-3347.34
buyer_6,Manuel,Rodríguez,1979-02-14,48702192Z,manuel.rodríguez@smartdev.org,107107,ES88209540227161223022,1256.82,2022-02-14T08:29:35,Vitoria-Gasteiz,expenses,food,-66.12,-3413.46
buyer_6,Manuel,Rodríguez,1979-02-14,48702192Z,manuel.rodríguez@smartdev.org,107107,ES88209540227161223022,1256.82,2022-02-14T01:22:32,Vitoria-Gasteiz,expenses,leisure,-45.38,-3458.84
buyer_6,Manuel,Rodríguez,1979-02-14,48702192Z,manuel.rodríguez@smartdev.org,107107,ES88209540227161223022,1256.82,2022-02-15T11:23:19,Vitoria-Gasteiz,expenses,food,-98.11,-3556.95
buyer_6,Manuel,Rodríguez,1979-02-14,48702192Z,manuel.rodríguez@smartdev.org,107107,ES88209540227161223022,1256.82,2022-02-15T06:42:58,Vitoria-Gasteiz,expenses,education,-77.26,-3634.21
buyer_6,Manuel,Rodríguez,1979-02-14,48702192Z,manuel.rodríguez@smartdev.org,107107,ES88209540227161223022,1256.82,2022-02-16T11:42:53,Vitoria-Gasteiz,expenses,transport,-44.72,-3678.93
buyer_6,Manuel,Rodríguez,1979-02-14,48702192Z,manuel.rodríguez@smartdev.org,107107,ES88209540227161223022,1256.82,2022-02-16T04:16:06,Vitoria-Gasteiz,expenses,leisure,-40.94,-3719.87
buyer_6,Manuel,Rodríguez,1979-02-14,48702192Z,manuel.rodríguez@smartdev.org,107107,ES88209540227161223022,1256.82,2022-02-16T20:40:03,Vitoria-Gasteiz,expenses,cash,-100.0,-3819.87
buyer_6,Manuel,Rodríguez,1979-02-14,48702192Z,manuel.rodríguez@smartdev.org,107107,ES88209540227161223022,1256.82,2022-02-17T11:20:19,Vitoria-Gasteiz,expenses,gifts,-113.12,-3932.99
buyer_6,Manuel,Rodríguez,1979-02-14,48702192Z,manuel.rodríguez@smartdev.org,107107,ES88209540227161223022,1256.82,2022-02-18T12:17:37,Vitoria-Gasteiz,expenses,transport,-76.31,-4009.3
buyer_6,Manuel,Rodríguez,1979-02-14,48702192Z,manuel.rodríguez@smartdev.org,107107,ES88209540227161223022,1256.82,2022-02-22T22:31:43,Vitoria-Gasteiz,expenses,leisure,-25.79,-4035.09
buyer_6,Manuel,Rodríguez,1979-02-14,48702192Z,manuel.rodríguez@smartdev.org,107107,ES88209540227161223022,1256.82,2022-02-22T23:07:53,Vitoria-Gasteiz,expenses,clothing,-148.52,-4183.61
buyer_6,Manuel,Rodríguez,1979-02-14,48702192Z,manuel.rodríguez@smartdev.org,107107,ES88209540227161223022,1256.82,2022-02-24T09:41:29,Vitoria-Gasteiz,expenses,food,-113.2,-4296.81
buyer_6,Manuel,Rodríguez,1979-02-14,48702192Z,manuel.rodríguez@smartdev.org,107107,ES88209540227161223022,1256.82,2022-02-24T07:34:34,Vitoria-Gasteiz,expenses,repairs,-282.93,-4579.74
buyer_6,Manuel,Rodríguez,1979-02-14,48702192Z,manuel.rodríguez@smartdev.org,107107,ES88209540227161223022,1256.82,2022-02-25T14:00:11,Vitoria-Gasteiz,expenses,healthcare,-120.29,-4700.03
buyer_6,Manuel,Rodríguez,1979-02-14,48702192Z,manuel.rodríguez@smartdev.org,107107,ES88209540227161223022,1256.82,2022-02-25T09:24:23,Vitoria-Gasteiz,expenses,repairs,-210.74,-4910.77
buyer_6,Manuel,Rodríguez,1979-02-14,48702192Z,manuel.rodríguez@smartdev.org,107107,ES88209540227161223022,1256.82,2022-02-26T23:45:09,Vitoria-Gasteiz,expenses,leisure,-56.19,-4966.96
buyer_6,Manuel,Rodríguez,1979-02-14,48702192Z,manuel.rodríguez@smartdev.org,107107,ES88209540227161223022,1256.82,2022-02-27T18:24:32,Vitoria-Gasteiz,expenses,clothing,-97.69,-5064.65
buyer_6,Manuel,Rodríguez,1979-02-14,48702192Z,manuel.rodríguez@smartdev.org,107107,ES88209540227161223022,1256.82,2022-02-27T20:00:28,Vitoria-Gasteiz,expenses,cash,-100.0,-5164.65
buyer_6,Manuel,Rodríguez,1979-02-14,48702192Z,manuel.rodríguez@smartdev.org,107107,ES88209540227161223022,1256.82,2022-03-01T12:31:06,Vitoria-Gasteiz,incomes,salary,1304.03,-3860.62
buyer_6,Manuel,Rodríguez,1979-02-14,48702192Z,manuel.rodríguez@smartdev.org,107107,ES88209540227161223022,1256.82,2022-03-01T12:31:06,Vitoria-Gasteiz,incomes,extra_income,181.04,-3679.58
buyer_6,Manuel,Rodríguez,1979-02-14,48702192Z,manuel.rodríguez@smartdev.org,107107,ES88209540227161223022,1256.82,2022-03-02T16:57:12,Vitoria-Gasteiz,expenses,healthcare,-115.61,-3795.19
buyer_6,Manuel,Rodríguez,1979-02-14,48702192Z,manuel.rodríguez@smartdev.org,107107,ES88209540227161223022,1256.82,2022-03-02T03:19:39,Vitoria-Gasteiz,expenses,gifts,-110.12,-3905.31
buyer_6,Manuel,Rodríguez,1979-02-14,48702192Z,manuel.rodríguez@smartdev.org,107107,ES88209540227161223022,1256.82,2022-03-04T20:05:21,Vitoria-Gasteiz,expenses,mortgage,-544.7,-4450.01
buyer_6,Manuel,Rodríguez,1979-02-14,48702192Z,manuel.rodríguez@smartdev.org,107107,ES88209540227161223022,1256.82,2022-03-06T09:18:28,Vitoria-Gasteiz,expenses,repairs,-64.1,-4514.11
buyer_6,Manuel,Rodríguez,1979-02-14,48702192Z,manuel.rodríguez@smartdev.org,107107,ES88209540227161223022,1256.82,2022-03-07T17:39:27,Vitoria-Gasteiz,expenses,water,-13.65,-4527.76
buyer_6,Manuel,Rodríguez,1979-02-14,48702192Z,manuel.rodríguez@smartdev.org,107107,ES88209540227161223022,1256.82,2022-03-07T13:22:51,Vitoria-Gasteiz,expenses,phone,-25.84,-4553.6
buyer_6,Manuel,Rodríguez,1979-02-14,48702192Z,manuel.rodríguez@smartdev.org,107107,ES88209540227161223022,1256.82,2022-03-08T17:37:19,Vitoria-Gasteiz,expenses,gas,-24.82,-4578.42
buyer_6,Manuel,Rodríguez,1979-02-14,48702192Z,manuel.rodríguez@smartdev.org,107107,ES88209540227161223022,1256.82,2022-03-08T20:29:36,Vitoria-Gasteiz,expenses,electricity,-54.03,-4632.45
buyer_6,Manuel,Rodríguez,1979-02-14,48702192Z,manuel.rodríguez@smartdev.org,107107,ES88209540227161223022,1256.82,2022-03-08T17:51:10,Vitoria-Gasteiz,expenses,internet,-27.38,-4659.83
buyer_6,Manuel,Rodríguez,1979-02-14,48702192Z,manuel.rodríguez@smartdev.org,107107,ES88209540227161223022,1256.82,2022-03-14T11:39:22,Vitoria-Gasteiz,expenses,food,-100.18,-4760.01
buyer_6,Manuel,Rodríguez,1979-02-14,48702192Z,manuel.rodríguez@smartdev.org,107107,ES88209540227161223022,1256.82,2022-03-14T01:55:47,Vitoria-Gasteiz,expenses,transport,-61.5,-4821.51
buyer_6,Manuel,Rodríguez,1979-02-14,48702192Z,manuel.rodríguez@smartdev.org,107107,ES88209540227161223022,1256.82,2022-03-14T08:46:12,Vitoria-Gasteiz,expenses,clothing,-102.09,-4923.6
buyer_6,Manuel,Rodríguez,1979-02-14,48702192Z,manuel.rodríguez@smartdev.org,107107,ES88209540227161223022,1256.82,2022-03-16T12:56:08,Vitoria-Gasteiz,expenses,cash,-100.0,-5023.6
buyer_6,Manuel,Rodríguez,1979-02-14,48702192Z,manuel.rodríguez@smartdev.org,107107,ES88209540227161223022,1256.82,2022-03-16T15:35:19,Vitoria-Gasteiz,expenses,repairs,-118.29,-5141.89
buyer_6,Manuel,Rodríguez,1979-02-14,48702192Z,manuel.rodríguez@smartdev.org,107107,ES88209540227161223022,1256.82,2022-03-18T12:33:14,Vitoria-Gasteiz,expenses,clothing,-149.0,-5290.89
buyer_6,Manuel,Rodríguez,1979-02-14,48702192Z,manuel.rodríguez@smartdev.org,107107,ES88209540227161223022,1256.82,2022-03-20T08:56:08,Vitoria-Gasteiz,expenses,cash,-100.0,-5390.89
buyer_6,Manuel,Rodríguez,1979-02-14,48702192Z,manuel.rodríguez@smartdev.org,107107,ES88209540227161223022,1256.82,2022-03-22T13:24:16,Vitoria-Gasteiz,expenses,repairs,-277.25,-5668.14
buyer_6,Manuel,Rodríguez,1979-02-14,48702192Z,manuel.rodríguez@smartdev.org,107107,ES88209540227161223022,1256.82,2022-03-26T16:33:46,Vitoria-Gasteiz,expenses,transport,-44.39,-5712.53
buyer_6,Manuel,Rodríguez,1979-02-14,48702192Z,manuel.rodríguez@smartdev.org,107107,ES88209540227161223022,1256.82,2022-03-26T10:54:41,Vitoria-Gasteiz,expenses,gifts,-435.18,-6147.71
buyer_6,Manuel,Rodríguez,1979-02-14,48702192Z,manuel.rodríguez@smartdev.org,107107,ES88209540227161223022,1256.82,2022-03-28T08:56:12,Vitoria-Gasteiz,expenses,clothing,-124.86,-6272.57
buyer_6,Manuel,Rodríguez,1979-02-14,48702192Z,manuel.rodríguez@smartdev.org,107107,ES88209540227161223022,1256.82,2022-03-29T13:31:09,Vitoria-Gasteiz,expenses,repairs,-83.75,-6356.32
buyer_6,Manuel,Rodríguez,1979-02-14,48702192Z,manuel.rodríguez@smartdev.org,107107,ES88209540227161223022,1256.82,2022-03-29T20:10:50,Vitoria-Gasteiz,expenses,gifts,-547.86,-6904.18
buyer_6,Manuel,Rodríguez,1979-02-14,48702192Z,manuel.rodríguez@smartdev.org,107107,ES88209540227161223022,1256.82,2022-03-30T08:54:29,Vitoria-Gasteiz,expenses,cash,-100.0,-7004.18
buyer_6,Manuel,Rodríguez,1979-02-14,48702192Z,manuel.rodríguez@smartdev.org,107107,ES88209540227161223022,1256.82,2022-04-01T09:26:00,Vitoria-Gasteiz,incomes,salary,1304.03,-5700.15
buyer_6,Manuel,Rodríguez,1979-02-14,48702192Z,manuel.rodríguez@smartdev.org,107107,ES88209540227161223022,1256.82,2022-04-02T23:30:49,Vitoria-Gasteiz,expenses,repairs,-167.06,-5867.21
buyer_6,Manuel,Rodríguez,1979-02-14,48702192Z,manuel.rodríguez@smartdev.org,107107,ES88209540227161223022,1256.82,2022-04-03T11:22:13,Vitoria-Gasteiz,expenses,food,-86.49,-5953.7
buyer_6,Manuel,Rodríguez,1979-02-14,48702192Z,manuel.rodríguez@smartdev.org,107107,ES88209540227161223022,1256.82,2022-04-04T11:53:31,Vitoria-Gasteiz,expenses,mortgage,-544.7,-6498.4
buyer_6,Manuel,Rodríguez,1979-02-14,48702192Z,manuel.rodríguez@smartdev.org,107107,ES88209540227161223022,1256.82,2022-04-05T00:22:06,Vitoria-Gasteiz,expenses,water,-21.65,-6520.05
buyer_6,Manuel,Rodríguez,1979-02-14,48702192Z,manuel.rodríguez@smartdev.org,107107,ES88209540227161223022,1256.82,2022-04-05T10:11:15,Vitoria-Gasteiz,expenses,gas,-58.82,-6578.87
buyer_6,Manuel,Rodríguez,1979-02-14,48702192Z,manuel.rodríguez@smartdev.org,107107,ES88209540227161223022,1256.82,2022-04-06T13:57:41,Vitoria-Gasteiz,expenses,electricity,-45.42,-6624.29
buyer_6,Manuel,Rodríguez,1979-02-14,48702192Z,manuel.rodríguez@smartdev.org,107107,ES88209540227161223022,1256.82,2022-04-06T15:30:19,Vitoria-Gasteiz,expenses,phone,-22.2,-6646.49
buyer_6,Manuel,Rodríguez,1979-02-14,48702192Z,manuel.rodríguez@smartdev.org,107107,ES88209540227161223022,1256.82,2022-04-07T05:37:56,Vitoria-Gasteiz,expenses,leisure,-27.2,-6673.69
buyer_6,Manuel,Rodríguez,1979-02-14,48702192Z,manuel.rodríguez@smartdev.org,107107,ES88209540227161223022,1256.82,2022-04-08T22:54:37,Vitoria-Gasteiz,expenses,internet,-27.38,-6701.07
buyer_6,Manuel,Rodríguez,1979-02-14,48702192Z,manuel.rodríguez@smartdev.org,107107,ES88209540227161223022,1256.82,2022-04-10T23:11:00,Vitoria-Gasteiz,expenses,leisure,-71.97,-6773.04
buyer_6,Manuel,Rodríguez,1979-02-14,48702192Z,manuel.rodríguez@smartdev.org,107107,ES88209540227161223022,1256.82,2022-04-12T16:41:09,Vitoria-Gasteiz,expenses,food,-67.68,-6840.72
buyer_6,Manuel,Rodríguez,1979-02-14,48702192Z,manuel.rodríguez@smartdev.org,107107,ES88209540227161223022,1256.82,2022-04-12T10:29:08,Vitoria-Gasteiz,expenses,cash,-100.0,-6940.72
buyer_6,Manuel,Rodríguez,1979-02-14,48702192Z,manuel.rodríguez@smartdev.org,107107,ES88209540227161223022,1256.82,2022-04-12T16:44:41,Vitoria-Gasteiz,expenses,gifts,-410.3,-7351.02
buyer_6,Manuel,Rodríguez,1979-02-14,48702192Z,manuel.rodríguez@smartdev.org,107107,ES88209540227161223022,1256.82,2022-04-13T15:32:33,Vitoria-Gasteiz,expenses,food,-114.71,-7465.73
buyer_6,Manuel,Rodríguez,1979-02-14,48702192Z,manuel.rodríguez@smartdev.org,107107,ES88209540227161223022,1256.82,2022-04-13T13:52:13,Vitoria-Gasteiz,expenses,clothing,-154.46,-7620.19
buyer_6,Manuel,Rodríguez,1979-02-14,48702192Z,manuel.rodríguez@smartdev.org,107107,ES88209540227161223022,1256.82,2022-04-15T16:15:35,Vitoria-Gasteiz,expenses,transport,-60.61,-7680.8
buyer_6,Manuel,Rodríguez,1979-02-14,48702192Z,manuel.rodríguez@smartdev.org,107107,ES88209540227161223022,1256.82,2022-04-16T13:25:44,Vitoria-Gasteiz,expenses,cash,-100.0,-7780.8
buyer_6,Manuel,Rodríguez,1979-02-14,48702192Z,manuel.rodríguez@smartdev.org,107107,ES88209540227161223022,1256.82,2022-04-19T17:41:21,Vitoria-Gasteiz,expenses,healthcare,-180.55,-7961.35
buyer_6,Manuel,Rodríguez,1979-02-14,48702192Z,manuel.rodríguez@smartdev.org,107107,ES88209540227161223022,1256.82,2022-04-20T14:44:45,Vitoria-Gasteiz,expenses,cash,-100.0,-8061.35
buyer_6,Manuel,Rodríguez,1979-02-14,48702192Z,manuel.rodríguez@smartdev.org,107107,ES88209540227161223022,1256.82,2022-04-25T19:00:11,Vitoria-Gasteiz,expenses,food,-68.54,-8129.89
buyer_6,Manuel,Rodríguez,1979-02-14,48702192Z,manuel.rodríguez@smartdev.org,107107,ES88209540227161223022,1256.82,2022-04-29T20:22:42,Vitoria-Gasteiz,expenses,education,-66.21,-8196.1
buyer_6,Manuel,Rodríguez,1979-02-14,48702192Z,manuel.rodríguez@smartdev.org,107107,ES88209540227161223022,1256.82,2022-04-29T10:32:37,Vitoria-Gasteiz,expenses,repairs,-150.28,-8346.38
buyer_6,Manuel,Rodríguez,1979-02-14,48702192Z,manuel.rodríguez@smartdev.org,107107,ES88209540227161223022,1256.82,2022-04-30T13:21:39,Vitoria-Gasteiz,expenses,transport,-89.27,-8435.65
buyer_6,Manuel,Rodríguez,1979-02-14,48702192Z,manuel.rodríguez@smartdev.org,107107,ES88209540227161223022,1256.82,2022-04-30T12:01:47,Vitoria-Gasteiz,expenses,cash,-100.0,-8535.65
buyer_6,Manuel,Rodríguez,1979-02-14,48702192Z,manuel.rodríguez@smartdev.org,107107,ES88209540227161223022,1256.82,2022-05-01T13:48:29,Vitoria-Gasteiz,incomes,salary,1304.03,-7231.62
buyer_6,Manuel,Rodríguez,1979-02-14,48702192Z,manuel.rodríguez@smartdev.org,107107,ES88209540227161223022,1256.82,2022-05-01T11:56:13,Vitoria-Gasteiz,expenses,clothing,-108.23,-7339.85
buyer_6,Manuel,Rodríguez,1979-02-14,48702192Z,manuel.rodríguez@smartdev.org,107107,ES88209540227161223022,1256.82,2022-05-03T12:22:12,Vitoria-Gasteiz,expenses,repairs,-161.52,-7501.37
buyer_6,Manuel,Rodríguez,1979-02-14,48702192Z,manuel.rodríguez@smartdev.org,107107,ES88209540227161223022,1256.82,2022-05-04T05:22:10,Vitoria-Gasteiz,expenses,mortgage,-544.7,-8046.07
buyer_6,Manuel,Rodríguez,1979-02-14,48702192Z,manuel.rodríguez@smartdev.org,107107,ES88209540227161223022,1256.82,2022-05-05T13:35:59,Vitoria-Gasteiz,expenses,food,-112.41,-8158.48
buyer_6,Manuel,Rodríguez,1979-02-14,48702192Z,manuel.rodríguez@smartdev.org,107107,ES88209540227161223022,1256.82,2022-05-05T14:52:22,Vitoria-Gasteiz,expenses,cash,-100.0,-8258.48
buyer_6,Manuel,Rodríguez,1979-02-14,48702192Z,manuel.rodríguez@smartdev.org,107107,ES88209540227161223022,1256.82,2022-05-06T23:54:00,Vitoria-Gasteiz,expenses,leisure,-67.53,-8326.01
buyer_6,Manuel,Rodríguez,1979-02-14,48702192Z,manuel.rodríguez@smartdev.org,107107,ES88209540227161223022,1256.82,2022-05-06T15:51:02,Vitoria-Gasteiz,expenses,gifts,-574.95,-8900.96
buyer_6,Manuel,Rodríguez,1979-02-14,48702192Z,manuel.rodríguez@smartdev.org,107107,ES88209540227161223022,1256.82,2022-05-07T17:34:53,Vitoria-Gasteiz,expenses,electricity,-25.03,-8925.99
buyer_6,Manuel,Rodríguez,1979-02-14,48702192Z,manuel.rodríguez@smartdev.org,107107,ES88209540227161223022,1256.82,2022-05-07T10:32:00,Vitoria-Gasteiz,expenses,internet,-27.38,-8953.37
buyer_6,Manuel,Rodríguez,1979-02-14,48702192Z,manuel.rodríguez@smartdev.org,107107,ES88209540227161223022,1256.82,2022-05-07T21:10:33,Vitoria-Gasteiz,expenses,phone,-25.25,-8978.62
buyer_6,Manuel,Rodríguez,1979-02-14,48702192Z,manuel.rodríguez@smartdev.org,107107,ES88209540227161223022,1256.82,2022-05-07T07:10:10,Vitoria-Gasteiz,expenses,repairs,-262.86,-9241.48
buyer_6,Manuel,Rodríguez,1979-02-14,48702192Z,manuel.rodríguez@smartdev.org,107107,ES88209540227161223022,1256.82,2022-05-08T07:13:34,Vitoria-Gasteiz,expenses,water,-14.93,-9256.41
buyer_6,Manuel,Rodríguez,1979-02-14,48702192Z,manuel.rodríguez@smartdev.org,107107,ES88209540227161223022,1256.82,2022-05-08T18:30:14,Vitoria-Gasteiz,expenses,gas,-28.1,-9284.51
buyer_6,Manuel,Rodríguez,1979-02-14,48702192Z,manuel.rodríguez@smartdev.org,107107,ES88209540227161223022,1256.82,2022-05-08T22:24:12,Vitoria-Gasteiz,expenses,cash,-100.0,-9384.51
buyer_6,Manuel,Rodríguez,1979-02-14,48702192Z,manuel.rodríguez@smartdev.org,107107,ES88209540227161223022,1256.82,2022-05-12T14:07:24,Vitoria-Gasteiz,expenses,cash,-100.0,-9484.51
buyer_6,Manuel,Rodríguez,1979-02-14,48702192Z,manuel.rodríguez@smartdev.org,107107,ES88209540227161223022,1256.82,2022-05-13T10:58:22,Vitoria-Gasteiz,expenses,clothing,-83.73,-9568.24
buyer_6,Manuel,Rodríguez,1979-02-14,48702192Z,manuel.rodríguez@smartdev.org,107107,ES88209540227161223022,1256.82,2022-05-14T18:38:30,Vitoria-Gasteiz,expenses,leisure,-33.66,-9601.9
buyer_6,Manuel,Rodríguez,1979-02-14,48702192Z,manuel.rodríguez@smartdev.org,107107,ES88209540227161223022,1256.82,2022-05-16T09:46:23,Vitoria-Gasteiz,expenses,food,-124.46,-9726.36
buyer_6,Manuel,Rodríguez,1979-02-14,48702192Z,manuel.rodríguez@smartdev.org,107107,ES88209540227161223022,1256.82,2022-05-18T11:56:02,Vitoria-Gasteiz,expenses,leisure,-75.23,-9801.59
buyer_6,Manuel,Rodríguez,1979-02-14,48702192Z,manuel.rodríguez@smartdev.org,107107,ES88209540227161223022,1256.82,2022-05-18T13:50:57,Vitoria-Gasteiz,expenses,cash,-100.0,-9901.59
buyer_6,Manuel,Rodríguez,1979-02-14,48702192Z,manuel.rodríguez@smartdev.org,107107,ES88209540227161223022,1256.82,2022-05-20T13:04:07,Vitoria-Gasteiz,expenses,appliances,-278.65,-10180.24
buyer_6,Manuel,Rodríguez,1979-02-14,48702192Z,manuel.rodríguez@smartdev.org,107107,ES88209540227161223022,1256.82,2022-05-21T19:22:50,Vitoria-Gasteiz,expenses,transport,-44.74,-10224.98
buyer_6,Manuel,Rodríguez,1979-02-14,48702192Z,manuel.rodríguez@smartdev.org,107107,ES88209540227161223022,1256.82,2022-05-26T10:13:14,Vitoria-Gasteiz,expenses,transport,-47.17,-10272.15
buyer_6,Manuel,Rodríguez,1979-02-14,48702192Z,manuel.rodríguez@smartdev.org,107107,ES88209540227161223022,1256.82,2022-05-30T17:15:48,Vitoria-Gasteiz,expenses,food,-75.92,-10348.07
buyer_6,Manuel,Rodríguez,1979-02-14,48702192Z,manuel.rodríguez@smartdev.org,107107,ES88209540227161223022,1256.82,2022-05-31T14:09:54,Vitoria-Gasteiz,expenses,cash,-100.0,-10448.07
buyer_6,Manuel,Rodríguez,1979-02-14,48702192Z,manuel.rodríguez@smartdev.org,107107,ES88209540227161223022,1256.82,2022-05-31T17:42:41,Vitoria-Gasteiz,expenses,repairs,-181.92,-10629.99
buyer_6,Manuel,Rodríguez,1979-02-14,48702192Z,manuel.rodríguez@smartdev.org,107107,ES88209540227161223022,1256.82,2022-06-01T10:25:49,Vitoria-Gasteiz,incomes,salary,1304.03,-9325.96
buyer_6,Manuel,Rodríguez,1979-02-14,48702192Z,manuel.rodríguez@smartdev.org,107107,ES88209540227161223022,1256.82,2022-06-01T10:25:49,Vitoria-Gasteiz,incomes,extra_income,181.04,-9144.92
buyer_6,Manuel,Rodríguez,1979-02-14,48702192Z,manuel.rodríguez@smartdev.org,107107,ES88209540227161223022,1256.82,2022-06-01T10:25:49,Vitoria-Gasteiz,incomes,salary_bonus,962.67,-8182.25
buyer_6,Manuel,Rodríguez,1979-02-14,48702192Z,manuel.rodríguez@smartdev.org,107107,ES88209540227161223022,1256.82,2022-06-03T01:13:18,Vitoria-Gasteiz,expenses,transport,-73.0,-8255.25
buyer_6,Manuel,Rodríguez,1979-02-14,48702192Z,manuel.rodríguez@smartdev.org,107107,ES88209540227161223022,1256.82,2022-06-03T17:38:33,Vitoria-Gasteiz,expenses,gifts,-111.64,-8366.89
buyer_6,Manuel,Rodríguez,1979-02-14,48702192Z,manuel.rodríguez@smartdev.org,107107,ES88209540227161223022,1256.82,2022-06-04T20:53:35,Vitoria-Gasteiz,expenses,mortgage,-544.7,-8911.59
buyer_6,Manuel,Rodríguez,1979-02-14,48702192Z,manuel.rodríguez@smartdev.org,107107,ES88209540227161223022,1256.82,2022-06-04T20:26:31,Vitoria-Gasteiz,expenses,food,-81.58,-8993.17
buyer_6,Manuel,Rodríguez,1979-02-14,48702192Z,manuel.rodríguez@smartdev.org,107107,ES88209540227161223022,1256.82,2022-06-04T07:06:35,Vitoria-Gasteiz,expenses,cash,-100.0,-9093.17
buyer_6,Manuel,Rodríguez,1979-02-14,48702192Z,manuel.rodríguez@smartdev.org,107107,ES88209540227161223022,1256.82,2022-06-05T20:59:15,Vitoria-Gasteiz,expenses,food,-124.93,-9218.1
buyer_6,Manuel,Rodríguez,1979-02-14,48702192Z,manuel.rodríguez@smartdev.org,107107,ES88209540227161223022,1256.82,2022-06-05T20:07:05,Vitoria-Gasteiz,expenses,leisure,-74.05,-9292.15
buyer_6,Manuel,Rodríguez,1979-02-14,48702192Z,manuel.rodríguez@smartdev.org,107107,ES88209540227161223022,1256.82,2022-06-06T14:56:05,Vitoria-Gasteiz,expenses,electricity,-39.48,-9331.63
buyer_6,Manuel,Rodríguez,1979-02-14,48702192Z,manuel.rodríguez@smartdev.org,107107,ES88209540227161223022,1256.82,2022-06-06T09:00:28,Vitoria-Gasteiz,expenses,internet,-27.38,-9359.01
buyer_6,Manuel,Rodríguez,1979-02-14,48702192Z,manuel.rodríguez@smartdev.org,107107,ES88209540227161223022,1256.82,2022-06-06T11:31:34,Vitoria-Gasteiz,expenses,cash,-100.0,-9459.01
buyer_6,Manuel,Rodríguez,1979-02-14,48702192Z,manuel.rodríguez@smartdev.org,107107,ES88209540227161223022,1256.82,2022-06-07T15:18:39,Vitoria-Gasteiz,expenses,water,-20.13,-9479.14
buyer_6,Manuel,Rodríguez,1979-02-14,48702192Z,manuel.rodríguez@smartdev.org,107107,ES88209540227161223022,1256.82,2022-06-07T11:23:59,Vitoria-Gasteiz,expenses,phone,-26.2,-9505.34
buyer_6,Manuel,Rodríguez,1979-02-14,48702192Z,manuel.rodríguez@smartdev.org,107107,ES88209540227161223022,1256.82,2022-06-08T20:29:51,Vitoria-Gasteiz,expenses,gas,-29.3,-9534.64
buyer_6,Manuel,Rodríguez,1979-02-14,48702192Z,manuel.rodríguez@smartdev.org,107107,ES88209540227161223022,1256.82,2022-06-09T19:44:35,Vitoria-Gasteiz,expenses,transport,-74.31,-9608.95
buyer_6,Manuel,Rodríguez,1979-02-14,48702192Z,manuel.rodríguez@smartdev.org,107107,ES88209540227161223022,1256.82,2022-06-09T16:48:25,Vitoria-Gasteiz,expenses,leisure,-26.76,-9635.71
buyer_6,Manuel,Rodríguez,1979-02-14,48702192Z,manuel.rodríguez@smartdev.org,107107,ES88209540227161223022,1256.82,2022-06-10T15:06:04,Vitoria-Gasteiz,expenses,cash,-100.0,-9735.71
buyer_6,Manuel,Rodríguez,1979-02-14,48702192Z,manuel.rodríguez@smartdev.org,107107,ES88209540227161223022,1256.82,2022-06-10T23:40:55,Vitoria-Gasteiz,expenses,appliances,-278.4,-10014.11
buyer_6,Manuel,Rodríguez,1979-02-14,48702192Z,manuel.rodríguez@smartdev.org,107107,ES88209540227161223022,1256.82,2022-06-10T18:10:30,Vitoria-Gasteiz,expenses,gifts,-333.57,-10347.68
buyer_6,Manuel,Rodríguez,1979-02-14,48702192Z,manuel.rodríguez@smartdev.org,107107,ES88209540227161223022,1256.82,2022-06-11T19:52:17,Vitoria-Gasteiz,expenses,clothing,-63.31,-10410.99
buyer_6,Manuel,Rodríguez,1979-02-14,48702192Z,manuel.rodríguez@smartdev.org,107107,ES88209540227161223022,1256.82,2022-06-11T18:01:55,Vitoria-Gasteiz,expenses,appliances,-222.92,-10633.91
buyer_6,Manuel,Rodríguez,1979-02-14,48702192Z,manuel.rodríguez@smartdev.org,107107,ES88209540227161223022,1256.82,2022-06-12T10:03:23,Vitoria-Gasteiz,expenses,food,-123.73,-10757.64
buyer_6,Manuel,Rodríguez,1979-02-14,48702192Z,manuel.rodríguez@smartdev.org,107107,ES88209540227161223022,1256.82,2022-06-13T08:12:43,Vitoria-Gasteiz,expenses,transport,-45.26,-10802.9
buyer_6,Manuel,Rodríguez,1979-02-14,48702192Z,manuel.rodríguez@smartdev.org,107107,ES88209540227161223022,1256.82,2022-06-14T12:05:40,Vitoria-Gasteiz,expenses,appliances,-226.34,-11029.24
buyer_6,Manuel,Rodríguez,1979-02-14,48702192Z,manuel.rodríguez@smartdev.org,107107,ES88209540227161223022,1256.82,2022-06-15T13:32:56,Vitoria-Gasteiz,expenses,repairs,-39.79,-11069.03
buyer_6,Manuel,Rodríguez,1979-02-14,48702192Z,manuel.rodríguez@smartdev.org,107107,ES88209540227161223022,1256.82,2022-06-16T20:47:43,Vitoria-Gasteiz,expenses,food,-77.91,-11146.94
buyer_6,Manuel,Rodríguez,1979-02-14,48702192Z,manuel.rodríguez@smartdev.org,107107,ES88209540227161223022,1256.82,2022-06-19T18:59:01,Vitoria-Gasteiz,expenses,education,-69.81,-11216.75
buyer_6,Manuel,Rodríguez,1979-02-14,48702192Z,manuel.rodríguez@smartdev.org,107107,ES88209540227161223022,1256.82,2022-06-20T14:22:31,Vitoria-Gasteiz,expenses,food,-114.4,-11331.15
buyer_6,Manuel,Rodríguez,1979-02-14,48702192Z,manuel.rodríguez@smartdev.org,107107,ES88209540227161223022,1256.82,2022-06-23T09:09:12,Vitoria-Gasteiz,expenses,transport,-83.59,-11414.74
buyer_6,Manuel,Rodríguez,1979-02-14,48702192Z,manuel.rodríguez@smartdev.org,107107,ES88209540227161223022,1256.82,2022-06-23T18:21:57,Vitoria-Gasteiz,expenses,cash,-100.0,-11514.74
buyer_6,Manuel,Rodríguez,1979-02-14,48702192Z,manuel.rodríguez@smartdev.org,107107,ES88209540227161223022,1256.82,2022-06-25T13:53:24,Vitoria-Gasteiz,expenses,food,-102.59,-11617.33
buyer_6,Manuel,Rodríguez,1979-02-14,48702192Z,manuel.rodríguez@smartdev.org,107107,ES88209540227161223022,1256.82,2022-06-25T21:36:42,Vitoria-Gasteiz,expenses,repairs,-220.92,-11838.25
buyer_6,Manuel,Rodríguez,1979-02-14,48702192Z,manuel.rodríguez@smartdev.org,107107,ES88209540227161223022,1256.82,2022-06-26T21:16:45,Vitoria-Gasteiz,expenses,food,-99.12,-11937.37
buyer_6,Manuel,Rodríguez,1979-02-14,48702192Z,manuel.rodríguez@smartdev.org,107107,ES88209540227161223022,1256.82,2022-06-26T17:30:34,Vitoria-Gasteiz,expenses,gifts,-107.96,-12045.33
buyer_6,Manuel,Rodríguez,1979-02-14,48702192Z,manuel.rodríguez@smartdev.org,107107,ES88209540227161223022,1256.82,2022-06-27T18:13:43,Vitoria-Gasteiz,expenses,food,-109.67,-12155.0
buyer_6,Manuel,Rodríguez,1979-02-14,48702192Z,manuel.rodríguez@smartdev.org,107107,ES88209540227161223022,1256.82,2022-06-27T11:52:18,Vitoria-Gasteiz,expenses,education,-55.62,-12210.62
buyer_6,Manuel,Rodríguez,1979-02-14,48702192Z,manuel.rodríguez@smartdev.org,107107,ES88209540227161223022,1256.82,2022-06-28T19:49:35,Vitoria-Gasteiz,expenses,cash,-100.0,-12310.62
buyer_6,Manuel,Rodríguez,1979-02-14,48702192Z,manuel.rodríguez@smartdev.org,107107,ES88209540227161223022,1256.82,2022-06-28T22:54:30,Vitoria-Gasteiz,expenses,gifts,-690.98,-13001.6
buyer_6,Manuel,Rodríguez,1979-02-14,48702192Z,manuel.rodríguez@smartdev.org,107107,ES88209540227161223022,1256.82,2022-07-01T16:13:59,Vitoria-Gasteiz,incomes,salary,1304.03,-11697.57
buyer_6,Manuel,Rodríguez,1979-02-14,48702192Z,manuel.rodríguez@smartdev.org,107107,ES88209540227161223022,1256.82,2022-07-01T08:49:59,Vitoria-Gasteiz,expenses,food,-70.13,-11767.7
buyer_6,Manuel,Rodríguez,1979-02-14,48702192Z,manuel.rodríguez@smartdev.org,107107,ES88209540227161223022,1256.82,2022-07-01T06:43:01,Vitoria-Gasteiz,expenses,cash,-100.0,-11867.7
buyer_6,Manuel,Rodríguez,1979-02-14,48702192Z,manuel.rodríguez@smartdev.org,107107,ES88209540227161223022,1256.82,2022-07-02T12:14:50,Vitoria-Gasteiz,expenses,food,-117.62,-11985.32
buyer_6,Manuel,Rodríguez,1979-02-14,48702192Z,manuel.rodríguez@smartdev.org,107107,ES88209540227161223022,1256.82,2022-07-02T19:49:27,Vitoria-Gasteiz,expenses,gifts,-616.13,-12601.45
buyer_6,Manuel,Rodríguez,1979-02-14,48702192Z,manuel.rodríguez@smartdev.org,107107,ES88209540227161223022,1256.82,2022-07-03T20:57:41,Vitoria-Gasteiz,expenses,leisure,-52.16,-12653.61
buyer_6,Manuel,Rodríguez,1979-02-14,48702192Z,manuel.rodríguez@smartdev.org,107107,ES88209540227161223022,1256.82,2022-07-04T16:30:14,Vitoria-Gasteiz,expenses,mortgage,-544.7,-13198.31
buyer_6,Manuel,Rodríguez,1979-02-14,48702192Z,manuel.rodríguez@smartdev.org,107107,ES88209540227161223022,1256.82,2022-07-05T11:11:58,Vitoria-Gasteiz,expenses,internet,-27.38,-13225.69
buyer_6,Manuel,Rodríguez,1979-02-14,48702192Z,manuel.rodríguez@smartdev.org,107107,ES88209540227161223022,1256.82,2022-07-05T14:59:43,Vitoria-Gasteiz,expenses,phone,-21.17,-13246.86
buyer_6,Manuel,Rodríguez,1979-02-14,48702192Z,manuel.rodríguez@smartdev.org,107107,ES88209540227161223022,1256.82,2022-07-05T16:10:12,Vitoria-Gasteiz,expenses,repairs,-199.61,-13446.47
buyer_6,Manuel,Rodríguez,1979-02-14,48702192Z,manuel.rodríguez@smartdev.org,107107,ES88209540227161223022,1256.82,2022-07-06T15:58:10,Vitoria-Gasteiz,expenses,water,-19.94,-13466.41
buyer_6,Manuel,Rodríguez,1979-02-14,48702192Z,manuel.rodríguez@smartdev.org,107107,ES88209540227161223022,1256.82,2022-07-06T16:41:19,Vitoria-Gasteiz,expenses,gas,-39.59,-13506.0
buyer_6,Manuel,Rodríguez,1979-02-14,48702192Z,manuel.rodríguez@smartdev.org,107107,ES88209540227161223022,1256.82,2022-07-06T14:21:13,Vitoria-Gasteiz,expenses,food,-87.96,-13593.96
buyer_6,Manuel,Rodríguez,1979-02-14,48702192Z,manuel.rodríguez@smartdev.org,107107,ES88209540227161223022,1256.82,2022-07-06T19:23:24,Vitoria-Gasteiz,expenses,leisure,-60.85,-13654.81
buyer_6,Manuel,Rodríguez,1979-02-14,48702192Z,manuel.rodríguez@smartdev.org,107107,ES88209540227161223022,1256.82,2022-07-07T08:29:47,Vitoria-Gasteiz,expenses,food,-93.43,-13748.24
buyer_6,Manuel,Rodríguez,1979-02-14,48702192Z,manuel.rodríguez@smartdev.org,107107,ES88209540227161223022,1256.82,2022-07-07T10:30:37,Vitoria-Gasteiz,expenses,transport,-47.65,-13795.89
buyer_6,Manuel,Rodríguez,1979-02-14,48702192Z,manuel.rodríguez@smartdev.org,107107,ES88209540227161223022,1256.82,2022-07-08T17:15:05,Vitoria-Gasteiz,expenses,electricity,-53.49,-13849.38
buyer_6,Manuel,Rodríguez,1979-02-14,48702192Z,manuel.rodríguez@smartdev.org,107107,ES88209540227161223022,1256.82,2022-07-08T19:10:08,Vitoria-Gasteiz,expenses,cash,-100.0,-13949.38
buyer_6,Manuel,Rodríguez,1979-02-14,48702192Z,manuel.rodríguez@smartdev.org,107107,ES88209540227161223022,1256.82,2022-07-12T19:02:00,Vitoria-Gasteiz,expenses,food,-104.25,-14053.63
buyer_6,Manuel,Rodríguez,1979-02-14,48702192Z,manuel.rodríguez@smartdev.org,107107,ES88209540227161223022,1256.82,2022-07-12T13:33:23,Vitoria-Gasteiz,expenses,appliances,-386.32,-14439.95
buyer_6,Manuel,Rodríguez,1979-02-14,48702192Z,manuel.rodríguez@smartdev.org,107107,ES88209540227161223022,1256.82,2022-07-15T10:25:25,Vitoria-Gasteiz,expenses,leisure,-42.96,-14482.91
buyer_6,Manuel,Rodríguez,1979-02-14,48702192Z,manuel.rodríguez@smartdev.org,107107,ES88209540227161223022,1256.82,2022-07-19T08:23:40,Vitoria-Gasteiz,expenses,repairs,-322.9,-14805.81
buyer_6,Manuel,Rodríguez,1979-02-14,48702192Z,manuel.rodríguez@smartdev.org,107107,ES88209540227161223022,1256.82,2022-07-20T23:56:09,Vitoria-Gasteiz,expenses,repairs,-94.18,-14899.99
buyer_6,Manuel,Rodríguez,1979-02-14,48702192Z,manuel.rodríguez@smartdev.org,107107,ES88209540227161223022,1256.82,2022-07-21T18:03:19,Vitoria-Gasteiz,expenses,cash,-100.0,-14999.99
buyer_6,Manuel,Rodríguez,1979-02-14,48702192Z,manuel.rodríguez@smartdev.org,107107,ES88209540227161223022,1256.82,2022-07-24T09:45:14,Vitoria-Gasteiz,expenses,leisure,-75.22,-15075.21
buyer_6,Manuel,Rodríguez,1979-02-14,48702192Z,manuel.rodríguez@smartdev.org,107107,ES88209540227161223022,1256.82,2022-07-27T00:00:19,Vitoria-Gasteiz,expenses,food,-67.45,-15142.66
buyer_6,Manuel,Rodríguez,1979-02-14,48702192Z,manuel.rodríguez@smartdev.org,107107,ES88209540227161223022,1256.82,2022-07-27T19:29:57,Vitoria-Gasteiz,expenses,appliances,-235.67,-15378.33
buyer_6,Manuel,Rodríguez,1979-02-14,48702192Z,manuel.rodríguez@smartdev.org,107107,ES88209540227161223022,1256.82,2022-07-28T17:45:10,Vitoria-Gasteiz,expenses,leisure,-27.7,-15406.03
buyer_6,Manuel,Rodríguez,1979-02-14,48702192Z,manuel.rodríguez@smartdev.org,107107,ES88209540227161223022,1256.82,2022-07-29T16:10:05,Vitoria-Gasteiz,expenses,gifts,-528.03,-15934.06
buyer_6,Manuel,Rodríguez,1979-02-14,48702192Z,manuel.rodríguez@smartdev.org,107107,ES88209540227161223022,1256.82,2022-07-30T14:32:29,Vitoria-Gasteiz,expenses,food,-113.18,-16047.24
buyer_6,Manuel,Rodríguez,1979-02-14,48702192Z,manuel.rodríguez@smartdev.org,107107,ES88209540227161223022,1256.82,2022-08-01T13:20:08,Vitoria-Gasteiz,incomes,salary,1304.03,-14743.21
buyer_6,Manuel,Rodríguez,1979-02-14,48702192Z,manuel.rodríguez@smartdev.org,107107,ES88209540227161223022,1256.82,2022-08-02T18:47:37,Vitoria-Gasteiz,expenses,healthcare,-79.26,-14822.47
buyer_6,Manuel,Rodríguez,1979-02-14,48702192Z,manuel.rodríguez@smartdev.org,107107,ES88209540227161223022,1256.82,2022-08-04T10:33:24,Vitoria-Gasteiz,expenses,mortgage,-544.7,-15367.17
buyer_6,Manuel,Rodríguez,1979-02-14,48702192Z,manuel.rodríguez@smartdev.org,107107,ES88209540227161223022,1256.82,2022-08-05T15:21:02,Vitoria-Gasteiz,expenses,electricity,-45.58,-15412.75
buyer_6,Manuel,Rodríguez,1979-02-14,48702192Z,manuel.rodríguez@smartdev.org,107107,ES88209540227161223022,1256.82,2022-08-05T17:50:01,Vitoria-Gasteiz,expenses,gas,-38.48,-15451.23
buyer_6,Manuel,Rodríguez,1979-02-14,48702192Z,manuel.rodríguez@smartdev.org,107107,ES88209540227161223022,1256.82,2022-08-05T14:11:34,Vitoria-Gasteiz,expenses,internet,-27.38,-15478.61
buyer_6,Manuel,Rodríguez,1979-02-14,48702192Z,manuel.rodríguez@smartdev.org,107107,ES88209540227161223022,1256.82,2022-08-05T19:53:28,Vitoria-Gasteiz,expenses,phone,-26.46,-15505.07
buyer_6,Manuel,Rodríguez,1979-02-14,48702192Z,manuel.rodríguez@smartdev.org,107107,ES88209540227161223022,1256.82,2022-08-05T08:19:50,Vitoria-Gasteiz,expenses,leisure,-65.02,-15570.09
buyer_6,Manuel,Rodríguez,1979-02-14,48702192Z,manuel.rodríguez@smartdev.org,107107,ES88209540227161223022,1256.82,2022-08-05T11:07:17,Vitoria-Gasteiz,expenses,repairs,-150.16,-15720.25
buyer_6,Manuel,Rodríguez,1979-02-14,48702192Z,manuel.rodríguez@smartdev.org,107107,ES88209540227161223022,1256.82,2022-08-06T13:57:17,Vitoria-Gasteiz,expenses,cash,-100.0,-15820.25
buyer_6,Manuel,Rodríguez,1979-02-14,48702192Z,manuel.rodríguez@smartdev.org,107107,ES88209540227161223022,1256.82,2022-08-07T21:49:23,Vitoria-Gasteiz,expenses,transport,-73.04,-15893.29
buyer_6,Manuel,Rodríguez,1979-02-14,48702192Z,manuel.rodríguez@smartdev.org,107107,ES88209540227161223022,1256.82,2022-08-08T11:04:46,Vitoria-Gasteiz,expenses,water,-17.3,-15910.59
buyer_6,Manuel,Rodríguez,1979-02-14,48702192Z,manuel.rodríguez@smartdev.org,107107,ES88209540227161223022,1256.82,2022-08-08T22:45:50,Vitoria-Gasteiz,expenses,cash,-100.0,-16010.59
buyer_6,Manuel,Rodríguez,1979-02-14,48702192Z,manuel.rodríguez@smartdev.org,107107,ES88209540227161223022,1256.82,2022-08-09T19:22:39,Vitoria-Gasteiz,expenses,education,-62.85,-16073.44
buyer_6,Manuel,Rodríguez,1979-02-14,48702192Z,manuel.rodríguez@smartdev.org,107107,ES88209540227161223022,1256.82,2022-08-10T17:34:03,Vitoria-Gasteiz,expenses,cash,-100.0,-16173.44
buyer_6,Manuel,Rodríguez,1979-02-14,48702192Z,manuel.rodríguez@smartdev.org,107107,ES88209540227161223022,1256.82,2022-08-11T22:39:06,Vitoria-Gasteiz,expenses,transport,-80.54,-16253.98
buyer_6,Manuel,Rodríguez,1979-02-14,48702192Z,manuel.rodríguez@smartdev.org,107107,ES88209540227161223022,1256.82,2022-08-11T13:17:49,Vitoria-Gasteiz,expenses,clothing,-146.17,-16400.15
buyer_6,Manuel,Rodríguez,1979-02-14,48702192Z,manuel.rodríguez@smartdev.org,107107,ES88209540227161223022,1256.82,2022-08-11T15:07:17,Vitoria-Gasteiz,expenses,appliances,-317.71,-16717.86
buyer_6,Manuel,Rodríguez,1979-02-14,48702192Z,manuel.rodríguez@smartdev.org,107107,ES88209540227161223022,1256.82,2022-08-15T09:52:11,Vitoria-Gasteiz,expenses,food,-85.42,-16803.28
buyer_6,Manuel,Rodríguez,1979-02-14,48702192Z,manuel.rodríguez@smartdev.org,107107,ES88209540227161223022,1256.82,2022-08-15T15:04:53,Vitoria-Gasteiz,expenses,cash,-100.0,-16903.28
buyer_6,Manuel,Rodríguez,1979-02-14,48702192Z,manuel.rodríguez@smartdev.org,107107,ES88209540227161223022,1256.82,2022-08-16T09:13:43,Vitoria-Gasteiz,expenses,cash,-100.0,-17003.28
buyer_6,Manuel,Rodríguez,1979-02-14,48702192Z,manuel.rodríguez@smartdev.org,107107,ES88209540227161223022,1256.82,2022-08-19T16:45:50,Vitoria-Gasteiz,expenses,cash,-100.0,-17103.28
buyer_6,Manuel,Rodríguez,1979-02-14,48702192Z,manuel.rodríguez@smartdev.org,107107,ES88209540227161223022,1256.82,2022-08-20T10:45:12,Vitoria-Gasteiz,expenses,cash,-100.0,-17203.28
buyer_6,Manuel,Rodríguez,1979-02-14,48702192Z,manuel.rodríguez@smartdev.org,107107,ES88209540227161223022,1256.82,2022-08-21T18:27:46,Vitoria-Gasteiz,expenses,cash,-100.0,-17303.28
buyer_6,Manuel,Rodríguez,1979-02-14,48702192Z,manuel.rodríguez@smartdev.org,107107,ES88209540227161223022,1256.82,2022-08-21T23:16:21,Vitoria-Gasteiz,expenses,appliances,-139.72,-17443.0
buyer_6,Manuel,Rodríguez,1979-02-14,48702192Z,manuel.rodríguez@smartdev.org,107107,ES88209540227161223022,1256.82,2022-08-23T13:42:03,Vitoria-Gasteiz,expenses,cash,-100.0,-17543.0
buyer_6,Manuel,Rodríguez,1979-02-14,48702192Z,manuel.rodríguez@smartdev.org,107107,ES88209540227161223022,1256.82,2022-08-24T22:25:11,Vitoria-Gasteiz,expenses,transport,-55.84,-17598.84
buyer_6,Manuel,Rodríguez,1979-02-14,48702192Z,manuel.rodríguez@smartdev.org,107107,ES88209540227161223022,1256.82,2022-09-01T19:43:51,Vitoria-Gasteiz,incomes,salary,1304.03,-16294.81
buyer_6,Manuel,Rodríguez,1979-02-14,48702192Z,manuel.rodríguez@smartdev.org,107107,ES88209540227161223022,1256.82,2022-09-01T19:43:51,Vitoria-Gasteiz,incomes,extra_income,181.04,-16113.77
buyer_6,Manuel,Rodríguez,1979-02-14,48702192Z,manuel.rodríguez@smartdev.org,107107,ES88209540227161223022,1256.82,2022-09-02T21:53:09,Vitoria-Gasteiz,expenses,gifts,-497.12,-16610.89
buyer_6,Manuel,Rodríguez,1979-02-14,48702192Z,manuel.rodríguez@smartdev.org,107107,ES88209540227161223022,1256.82,2022-09-04T04:58:34,Vitoria-Gasteiz,expenses,mortgage,-544.7,-17155.59
buyer_6,Manuel,Rodríguez,1979-02-14,48702192Z,manuel.rodríguez@smartdev.org,107107,ES88209540227161223022,1256.82,2022-09-05T16:01:24,Vitoria-Gasteiz,expenses,phone,-21.18,-17176.77
buyer_6,Manuel,Rodríguez,1979-02-14,48702192Z,manuel.rodríguez@smartdev.org,107107,ES88209540227161223022,1256.82,2022-09-06T22:51:54,Vitoria-Gasteiz,expenses,water,-16.28,-17193.05
buyer_6,Manuel,Rodríguez,1979-02-14,48702192Z,manuel.rodríguez@smartdev.org,107107,ES88209540227161223022,1256.82,2022-09-06T13:46:48,Vitoria-Gasteiz,expenses,cash,-100.0,-17293.05
buyer_6,Manuel,Rodríguez,1979-02-14,48702192Z,manuel.rodríguez@smartdev.org,107107,ES88209540227161223022,1256.82,2022-09-08T16:09:41,Vitoria-Gasteiz,expenses,electricity,-19.23,-17312.28
buyer_6,Manuel,Rodríguez,1979-02-14,48702192Z,manuel.rodríguez@smartdev.org,107107,ES88209540227161223022,1256.82,2022-09-08T04:45:24,Vitoria-Gasteiz,expenses,gas,-42.36,-17354.64
buyer_6,Manuel,Rodríguez,1979-02-14,48702192Z,manuel.rodríguez@smartdev.org,107107,ES88209540227161223022,1256.82,2022-09-08T20:22:39,Vitoria-Gasteiz,expenses,internet,-27.38,-17382.02
buyer_6,Manuel,Rodríguez,1979-02-14,48702192Z,manuel.rodríguez@smartdev.org,107107,ES88209540227161223022,1256.82,2022-09-09T08:09:43,Vitoria-Gasteiz,expenses,healthcare,-74.39,-17456.41
buyer_6,Manuel,Rodríguez,1979-02-14,48702192Z,manuel.rodríguez@smartdev.org,107107,ES88209540227161223022,1256.82,2022-09-10T12:34:58,Vitoria-Gasteiz,expenses,food,-98.14,-17554.55
buyer_6,Manuel,Rodríguez,1979-02-14,48702192Z,manuel.rodríguez@smartdev.org,107107,ES88209540227161223022,1256.82,2022-09-10T09:33:28,Vitoria-Gasteiz,expenses,transport,-84.07,-17638.62
buyer_6,Manuel,Rodríguez,1979-02-14,48702192Z,manuel.rodríguez@smartdev.org,107107,ES88209540227161223022,1256.82,2022-09-13T13:41:20,Vitoria-Gasteiz,expenses,transport,-78.69,-17717.31
buyer_6,Manuel,Rodríguez,1979-02-14,48702192Z,manuel.rodríguez@smartdev.org,107107,ES88209540227161223022,1256.82,2022-09-14T16:48:14,Vitoria-Gasteiz,expenses,transport,-86.28,-17803.59
buyer_6,Manuel,Rodríguez,1979-02-14,48702192Z,manuel.rodríguez@smartdev.org,107107,ES88209540227161223022,1256.82,2022-09-14T19:18:03,Vitoria-Gasteiz,expenses,healthcare,-182.37,-17985.96
buyer_6,Manuel,Rodríguez,1979-02-14,48702192Z,manuel.rodríguez@smartdev.org,107107,ES88209540227161223022,1256.82,2022-09-15T02:26:19,Vitoria-Gasteiz,expenses,leisure,-19.54,-18005.5
buyer_6,Manuel,Rodríguez,1979-02-14,48702192Z,manuel.rodríguez@smartdev.org,107107,ES88209540227161223022,1256.82,2022-09-17T23:41:50,Vitoria-Gasteiz,expenses,leisure,-57.95,-18063.45
buyer_6,Manuel,Rodríguez,1979-02-14,48702192Z,manuel.rodríguez@smartdev.org,107107,ES88209540227161223022,1256.82,2022-09-20T08:16:03,Vitoria-Gasteiz,expenses,cash,-100.0,-18163.45
buyer_6,Manuel,Rodríguez,1979-02-14,48702192Z,manuel.rodríguez@smartdev.org,107107,ES88209540227161223022,1256.82,2022-09-21T12:40:29,Vitoria-Gasteiz,expenses,cash,-100.0,-18263.45
buyer_6,Manuel,Rodríguez,1979-02-14,48702192Z,manuel.rodríguez@smartdev.org,107107,ES88209540227161223022,1256.82,2022-09-25T19:36:34,Vitoria-Gasteiz,expenses,leisure,-65.63,-18329.08
buyer_6,Manuel,Rodríguez,1979-02-14,48702192Z,manuel.rodríguez@smartdev.org,107107,ES88209540227161223022,1256.82,2022-09-25T00:08:05,Vitoria-Gasteiz,expenses,repairs,-39.56,-18368.64
buyer_6,Manuel,Rodríguez,1979-02-14,48702192Z,manuel.rodríguez@smartdev.org,107107,ES88209540227161223022,1256.82,2022-09-26T08:50:07,Vitoria-Gasteiz,expenses,healthcare,-174.67,-18543.31
buyer_6,Manuel,Rodríguez,1979-02-14,48702192Z,manuel.rodríguez@smartdev.org,107107,ES88209540227161223022,1256.82,2022-09-26T17:33:22,Vitoria-Gasteiz,expenses,cash,-100.0,-18643.31
buyer_6,Manuel,Rodríguez,1979-02-14,48702192Z,manuel.rodríguez@smartdev.org,107107,ES88209540227161223022,1256.82,2022-09-26T08:27:35,Vitoria-Gasteiz,expenses,appliances,-343.22,-18986.53
buyer_6,Manuel,Rodríguez,1979-02-14,48702192Z,manuel.rodríguez@smartdev.org,107107,ES88209540227161223022,1256.82,2022-09-27T10:36:53,Vitoria-Gasteiz,expenses,leisure,-49.43,-19035.96
buyer_6,Manuel,Rodríguez,1979-02-14,48702192Z,manuel.rodríguez@smartdev.org,107107,ES88209540227161223022,1256.82,2022-09-28T14:35:04,Vitoria-Gasteiz,expenses,clothing,-146.43,-19182.39
buyer_6,Manuel,Rodríguez,1979-02-14,48702192Z,manuel.rodríguez@smartdev.org,107107,ES88209540227161223022,1256.82,2022-10-01T14:41:02,Vitoria-Gasteiz,incomes,salary,1304.03,-17878.36
buyer_6,Manuel,Rodríguez,1979-02-14,48702192Z,manuel.rodríguez@smartdev.org,107107,ES88209540227161223022,1256.82,2022-10-02T06:20:29,Vitoria-Gasteiz,expenses,cash,-100.0,-17978.36
buyer_6,Manuel,Rodríguez,1979-02-14,48702192Z,manuel.rodríguez@smartdev.org,107107,ES88209540227161223022,1256.82,2022-10-03T19:53:36,Vitoria-Gasteiz,expenses,cash,-100.0,-18078.36
buyer_6,Manuel,Rodríguez,1979-02-14,48702192Z,manuel.rodríguez@smartdev.org,107107,ES88209540227161223022,1256.82,2022-10-04T08:45:58,Vitoria-Gasteiz,expenses,mortgage,-544.7,-18623.06
buyer_6,Manuel,Rodríguez,1979-02-14,48702192Z,manuel.rodríguez@smartdev.org,107107,ES88209540227161223022,1256.82,2022-10-04T14:21:42,Vitoria-Gasteiz,expenses,clothing,-51.44,-18674.5
buyer_6,Manuel,Rodríguez,1979-02-14,48702192Z,manuel.rodríguez@smartdev.org,107107,ES88209540227161223022,1256.82,2022-10-04T18:05:39,Vitoria-Gasteiz,expenses,gifts,-662.77,-19337.27
buyer_6,Manuel,Rodríguez,1979-02-14,48702192Z,manuel.rodríguez@smartdev.org,107107,ES88209540227161223022,1256.82,2022-10-05T13:21:24,Vitoria-Gasteiz,expenses,gas,-58.43,-19395.7
buyer_6,Manuel,Rodríguez,1979-02-14,48702192Z,manuel.rodríguez@smartdev.org,107107,ES88209540227161223022,1256.82,2022-10-05T12:08:22,Vitoria-Gasteiz,expenses,internet,-27.38,-19423.08
buyer_6,Manuel,Rodríguez,1979-02-14,48702192Z,manuel.rodríguez@smartdev.org,107107,ES88209540227161223022,1256.82,2022-10-05T09:46:44,Vitoria-Gasteiz,expenses,food,-110.91,-19533.99
buyer_6,Manuel,Rodríguez,1979-02-14,48702192Z,manuel.rodríguez@smartdev.org,107107,ES88209540227161223022,1256.82,2022-10-05T10:27:47,Vitoria-Gasteiz,expenses,clothing,-151.82,-19685.81
buyer_6,Manuel,Rodríguez,1979-02-14,48702192Z,manuel.rodríguez@smartdev.org,107107,ES88209540227161223022,1256.82,2022-10-06T20:27:11,Vitoria-Gasteiz,expenses,water,-23.25,-19709.06
buyer_6,Manuel,Rodríguez,1979-02-14,48702192Z,manuel.rodríguez@smartdev.org,107107,ES88209540227161223022,1256.82,2022-10-06T22:43:07,Vitoria-Gasteiz,expenses,phone,-21.56,-19730.62
buyer_6,Manuel,Rodríguez,1979-02-14,48702192Z,manuel.rodríguez@smartdev.org,107107,ES88209540227161223022,1256.82,2022-10-06T18:33:53,Vitoria-Gasteiz,expenses,food,-67.09,-19797.71
buyer_6,Manuel,Rodríguez,1979-02-14,48702192Z,manuel.rodríguez@smartdev.org,107107,ES88209540227161223022,1256.82,2022-10-08T22:47:50,Vitoria-Gasteiz,expenses,electricity,-39.5,-19837.21
buyer_6,Manuel,Rodríguez,1979-02-14,48702192Z,manuel.rodríguez@smartdev.org,107107,ES88209540227161223022,1256.82,2022-10-08T09:38:00,Vitoria-Gasteiz,expenses,leisure,-66.16,-19903.37
buyer_6,Manuel,Rodríguez,1979-02-14,48702192Z,manuel.rodríguez@smartdev.org,107107,ES88209540227161223022,1256.82,2022-10-09T10:20:54,Vitoria-Gasteiz,expenses,leisure,-59.21,-19962.58
buyer_6,Manuel,Rodríguez,1979-02-14,48702192Z,manuel.rodríguez@smartdev.org,107107,ES88209540227161223022,1256.82,2022-10-11T20:44:37,Vitoria-Gasteiz,expenses,transport,-56.15,-20018.73
buyer_6,Manuel,Rodríguez,1979-02-14,48702192Z,manuel.rodríguez@smartdev.org,107107,ES88209540227161223022,1256.82,2022-10-12T05:32:01,Vitoria-Gasteiz,expenses,food,-124.67,-20143.4
buyer_6,Manuel,Rodríguez,1979-02-14,48702192Z,manuel.rodríguez@smartdev.org,107107,ES88209540227161223022,1256.82,2022-10-12T13:02:08,Vitoria-Gasteiz,expenses,repairs,-293.15,-20436.55
buyer_6,Manuel,Rodríguez,1979-02-14,48702192Z,manuel.rodríguez@smartdev.org,107107,ES88209540227161223022,1256.82,2022-10-13T04:40:34,Vitoria-Gasteiz,expenses,food,-71.7,-20508.25
buyer_6,Manuel,Rodríguez,1979-02-14,48702192Z,manuel.rodríguez@smartdev.org,107107,ES88209540227161223022,1256.82,2022-10-14T13:23:38,Vitoria-Gasteiz,expenses,cash,-100.0,-20608.25
buyer_6,Manuel,Rodríguez,1979-02-14,48702192Z,manuel.rodríguez@smartdev.org,107107,ES88209540227161223022,1256.82,2022-10-15T17:49:40,Vitoria-Gasteiz,expenses,education,-74.9,-20683.15
buyer_6,Manuel,Rodríguez,1979-02-14,48702192Z,manuel.rodríguez@smartdev.org,107107,ES88209540227161223022,1256.82,2022-10-15T13:40:28,Vitoria-Gasteiz,expenses,repairs,-90.05,-20773.2
buyer_6,Manuel,Rodríguez,1979-02-14,48702192Z,manuel.rodríguez@smartdev.org,107107,ES88209540227161223022,1256.82,2022-10-16T17:00:05,Vitoria-Gasteiz,expenses,transport,-52.97,-20826.17
buyer_6,Manuel,Rodríguez,1979-02-14,48702192Z,manuel.rodríguez@smartdev.org,107107,ES88209540227161223022,1256.82,2022-10-17T09:29:57,Vitoria-Gasteiz,expenses,appliances,-270.24,-21096.41
buyer_6,Manuel,Rodríguez,1979-02-14,48702192Z,manuel.rodríguez@smartdev.org,107107,ES88209540227161223022,1256.82,2022-10-18T01:44:13,Vitoria-Gasteiz,expenses,cash,-100.0,-21196.41
buyer_6,Manuel,Rodríguez,1979-02-14,48702192Z,manuel.rodríguez@smartdev.org,107107,ES88209540227161223022,1256.82,2022-10-19T22:09:22,Vitoria-Gasteiz,expenses,cash,-100.0,-21296.41
buyer_6,Manuel,Rodríguez,1979-02-14,48702192Z,manuel.rodríguez@smartdev.org,107107,ES88209540227161223022,1256.82,2022-10-24T21:34:56,Vitoria-Gasteiz,expenses,leisure,-57.51,-21353.92
buyer_6,Manuel,Rodríguez,1979-02-14,48702192Z,manuel.rodríguez@smartdev.org,107107,ES88209540227161223022,1256.82,2022-10-24T19:07:48,Vitoria-Gasteiz,expenses,cash,-100.0,-21453.92
buyer_6,Manuel,Rodríguez,1979-02-14,48702192Z,manuel.rodríguez@smartdev.org,107107,ES88209540227161223022,1256.82,2022-10-25T09:01:43,Vitoria-Gasteiz,expenses,cash,-100.0,-21553.92
buyer_6,Manuel,Rodríguez,1979-02-14,48702192Z,manuel.rodríguez@smartdev.org,107107,ES88209540227161223022,1256.82,2022-10-26T15:23:38,Vitoria-Gasteiz,expenses,leisure,-80.83,-21634.75
buyer_6,Manuel,Rodríguez,1979-02-14,48702192Z,manuel.rodríguez@smartdev.org,107107,ES88209540227161223022,1256.82,2022-10-27T20:00:26,Vitoria-Gasteiz,expenses,cash,-100.0,-21734.75
buyer_6,Manuel,Rodríguez,1979-02-14,48702192Z,manuel.rodríguez@smartdev.org,107107,ES88209540227161223022,1256.82,2022-10-28T22:07:47,Vitoria-Gasteiz,expenses,food,-83.31,-21818.06
buyer_6,Manuel,Rodríguez,1979-02-14,48702192Z,manuel.rodríguez@smartdev.org,107107,ES88209540227161223022,1256.82,2022-10-29T20:19:31,Vitoria-Gasteiz,expenses,transport,-40.65,-21858.71
buyer_6,Manuel,Rodríguez,1979-02-14,48702192Z,manuel.rodríguez@smartdev.org,107107,ES88209540227161223022,1256.82,2022-10-30T23:32:05,Vitoria-Gasteiz,expenses,repairs,-213.42,-22072.13
buyer_6,Manuel,Rodríguez,1979-02-14,48702192Z,manuel.rodríguez@smartdev.org,107107,ES88209540227161223022,1256.82,2022-10-31T22:42:47,Vitoria-Gasteiz,expenses,gifts,-112.12,-22184.25
buyer_6,Manuel,Rodríguez,1979-02-14,48702192Z,manuel.rodríguez@smartdev.org,107107,ES88209540227161223022,1256.82,2022-11-01T21:25:28,Vitoria-Gasteiz,incomes,salary,1304.03,-20880.22
buyer_6,Manuel,Rodríguez,1979-02-14,48702192Z,manuel.rodríguez@smartdev.org,107107,ES88209540227161223022,1256.82,2022-11-01T15:32:12,Vitoria-Gasteiz,expenses,transport,-86.97,-20967.19
buyer_6,Manuel,Rodríguez,1979-02-14,48702192Z,manuel.rodríguez@smartdev.org,107107,ES88209540227161223022,1256.82,2022-11-02T09:43:07,Vitoria-Gasteiz,expenses,transport,-82.76,-21049.95
buyer_6,Manuel,Rodríguez,1979-02-14,48702192Z,manuel.rodríguez@smartdev.org,107107,ES88209540227161223022,1256.82,2022-11-02T10:45:09,Vitoria-Gasteiz,expenses,leisure,-34.96,-21084.91
buyer_6,Manuel,Rodríguez,1979-02-14,48702192Z,manuel.rodríguez@smartdev.org,107107,ES88209540227161223022,1256.82,2022-11-02T01:42:45,Vitoria-Gasteiz,expenses,cash,-100.0,-21184.91
buyer_6,Manuel,Rodríguez,1979-02-14,48702192Z,manuel.rodríguez@smartdev.org,107107,ES88209540227161223022,1256.82,2022-11-04T09:30:09,Vitoria-Gasteiz,expenses,mortgage,-544.7,-21729.61
buyer_6,Manuel,Rodríguez,1979-02-14,48702192Z,manuel.rodríguez@smartdev.org,107107,ES88209540227161223022,1256.82,2022-11-05T18:57:46,Vitoria-Gasteiz,expenses,water,-23.88,-21753.49
buyer_6,Manuel,Rodríguez,1979-02-14,48702192Z,manuel.rodríguez@smartdev.org,107107,ES88209540227161223022,1256.82,2022-11-05T12:35:31,Vitoria-Gasteiz,expenses,education,-53.28,-21806.77
buyer_6,Manuel,Rodríguez,1979-02-14,48702192Z,manuel.rodríguez@smartdev.org,107107,ES88209540227161223022,1256.82,2022-11-05T17:19:05,Vitoria-Gasteiz,expenses,cash,-100.0,-21906.77
buyer_6,Manuel,Rodríguez,1979-02-14,48702192Z,manuel.rodríguez@smartdev.org,107107,ES88209540227161223022,1256.82,2022-11-06T20:19:37,Vitoria-Gasteiz,expenses,internet,-27.38,-21934.15
buyer_6,Manuel,Rodríguez,1979-02-14,48702192Z,manuel.rodríguez@smartdev.org,107107,ES88209540227161223022,1256.82,2022-11-06T09:39:45,Vitoria-Gasteiz,expenses,food,-119.56,-22053.71
buyer_6,Manuel,Rodríguez,1979-02-14,48702192Z,manuel.rodríguez@smartdev.org,107107,ES88209540227161223022,1256.82,2022-11-06T16:08:49,Vitoria-Gasteiz,expenses,healthcare,-87.63,-22141.34
buyer_6,Manuel,Rodríguez,1979-02-14,48702192Z,manuel.rodríguez@smartdev.org,107107,ES88209540227161223022,1256.82,2022-11-06T18:57:13,Vitoria-Gasteiz,expenses,gifts,-485.85,-22627.19
buyer_6,Manuel,Rodríguez,1979-02-14,48702192Z,manuel.rodríguez@smartdev.org,107107,ES88209540227161223022,1256.82,2022-11-08T13:23:00,Vitoria-Gasteiz,expenses,electricity,-43.19,-22670.38
buyer_6,Manuel,Rodríguez,1979-02-14,48702192Z,manuel.rodríguez@smartdev.org,107107,ES88209540227161223022,1256.82,2022-11-08T13:59:18,Vitoria-Gasteiz,expenses,gas,-50.61,-22720.99
buyer_6,Manuel,Rodríguez,1979-02-14,48702192Z,manuel.rodríguez@smartdev.org,107107,ES88209540227161223022,1256.82,2022-11-08T13:17:19,Vitoria-Gasteiz,expenses,phone,-28.63,-22749.62
buyer_6,Manuel,Rodríguez,1979-02-14,48702192Z,manuel.rodríguez@smartdev.org,107107,ES88209540227161223022,1256.82,2022-11-10T19:59:28,Vitoria-Gasteiz,expenses,repairs,-171.79,-22921.41
buyer_6,Manuel,Rodríguez,1979-02-14,48702192Z,manuel.rodríguez@smartdev.org,107107,ES88209540227161223022,1256.82,2022-11-11T08:34:55,Vitoria-Gasteiz,expenses,education,-69.01,-22990.42
buyer_6,Manuel,Rodríguez,1979-02-14,48702192Z,manuel.rodríguez@smartdev.org,107107,ES88209540227161223022,1256.82,2022-11-12T15:57:00,Vitoria-Gasteiz,expenses,transport,-77.41,-23067.83
buyer_6,Manuel,Rodríguez,1979-02-14,48702192Z,manuel.rodríguez@smartdev.org,107107,ES88209540227161223022,1256.82,2022-11-12T17:29:25,Vitoria-Gasteiz,expenses,travel,-367.11,-23434.94
buyer_6,Manuel,Rodríguez,1979-02-14,48702192Z,manuel.rodríguez@smartdev.org,107107,ES88209540227161223022,1256.82,2022-11-14T20:00:07,Vitoria-Gasteiz,expenses,food,-67.78,-23502.72
buyer_6,Manuel,Rodríguez,1979-02-14,48702192Z,manuel.rodríguez@smartdev.org,107107,ES88209540227161223022,1256.82,2022-11-15T18:00:43,Vitoria-Gasteiz,expenses,cash,-100.0,-23602.72
buyer_6,Manuel,Rodríguez,1979-02-14,48702192Z,manuel.rodríguez@smartdev.org,107107,ES88209540227161223022,1256.82,2022-11-17T09:39:53,Vitoria-Gasteiz,expenses,leisure,-57.3,-23660.02
buyer_6,Manuel,Rodríguez,1979-02-14,48702192Z,manuel.rodríguez@smartdev.org,107107,ES88209540227161223022,1256.82,2022-11-17T13:53:25,Vitoria-Gasteiz,expenses,healthcare,-135.63,-23795.65
buyer_6,Manuel,Rodríguez,1979-02-14,48702192Z,manuel.rodríguez@smartdev.org,107107,ES88209540227161223022,1256.82,2022-11-24T21:31:40,Vitoria-Gasteiz,expenses,repairs,-265.52,-24061.17
buyer_6,Manuel,Rodríguez,1979-02-14,48702192Z,manuel.rodríguez@smartdev.org,107107,ES88209540227161223022,1256.82,2022-11-24T12:16:34,Vitoria-Gasteiz,expenses,gifts,-126.24,-24187.41
buyer_6,Manuel,Rodríguez,1979-02-14,48702192Z,manuel.rodríguez@smartdev.org,107107,ES88209540227161223022,1256.82,2022-11-25T06:00:00,Vitoria-Gasteiz,expenses,clothing,-131.07,-24318.48
buyer_6,Manuel,Rodríguez,1979-02-14,48702192Z,manuel.rodríguez@smartdev.org,107107,ES88209540227161223022,1256.82,2022-11-26T01:30:12,Vitoria-Gasteiz,expenses,cash,-100.0,-24418.48
buyer_6,Manuel,Rodríguez,1979-02-14,48702192Z,manuel.rodríguez@smartdev.org,107107,ES88209540227161223022,1256.82,2022-11-26T08:20:26,Vitoria-Gasteiz,expenses,repairs,-249.84,-24668.32
buyer_6,Manuel,Rodríguez,1979-02-14,48702192Z,manuel.rodríguez@smartdev.org,107107,ES88209540227161223022,1256.82,2022-11-27T09:39:06,Vitoria-Gasteiz,expenses,food,-109.74,-24778.06
buyer_6,Manuel,Rodríguez,1979-02-14,48702192Z,manuel.rodríguez@smartdev.org,107107,ES88209540227161223022,1256.82,2022-11-28T03:19:11,Vitoria-Gasteiz,expenses,food,-83.43,-24861.49
buyer_6,Manuel,Rodríguez,1979-02-14,48702192Z,manuel.rodríguez@smartdev.org,107107,ES88209540227161223022,1256.82,2022-11-28T09:48:26,Vitoria-Gasteiz,expenses,gifts,-702.28,-25563.77
buyer_6,Manuel,Rodríguez,1979-02-14,48702192Z,manuel.rodríguez@smartdev.org,107107,ES88209540227161223022,1256.82,2022-11-29T09:30:22,Vitoria-Gasteiz,expenses,food,-109.19,-25672.96
buyer_6,Manuel,Rodríguez,1979-02-14,48702192Z,manuel.rodríguez@smartdev.org,107107,ES88209540227161223022,1256.82,2022-11-30T08:51:33,Vitoria-Gasteiz,expenses,healthcare,-120.0,-25792.96
buyer_6,Manuel,Rodríguez,1979-02-14,48702192Z,manuel.rodríguez@smartdev.org,107107,ES88209540227161223022,1256.82,2022-12-01T15:20:07,Vitoria-Gasteiz,incomes,salary,1304.03,-24488.93
buyer_6,Manuel,Rodríguez,1979-02-14,48702192Z,manuel.rodríguez@smartdev.org,107107,ES88209540227161223022,1256.82,2022-12-01T15:20:07,Vitoria-Gasteiz,incomes,extra_income,181.04,-24307.89
buyer_6,Manuel,Rodríguez,1979-02-14,48702192Z,manuel.rodríguez@smartdev.org,107107,ES88209540227161223022,1256.82,2022-12-01T15:20:07,Vitoria-Gasteiz,incomes,salary_bonus,921.88,-23386.01
buyer_6,Manuel,Rodríguez,1979-02-14,48702192Z,manuel.rodríguez@smartdev.org,107107,ES88209540227161223022,1256.82,2022-12-03T19:33:48,Vitoria-Gasteiz,expenses,transport,-70.28,-23456.29
buyer_6,Manuel,Rodríguez,1979-02-14,48702192Z,manuel.rodríguez@smartdev.org,107107,ES88209540227161223022,1256.82,2022-12-04T08:03:56,Vitoria-Gasteiz,expenses,mortgage,-544.7,-24000.99
buyer_6,Manuel,Rodríguez,1979-02-14,48702192Z,manuel.rodríguez@smartdev.org,107107,ES88209540227161223022,1256.82,2022-12-05T18:23:53,Vitoria-Gasteiz,expenses,electricity,-20.82,-24021.81
buyer_6,Manuel,Rodríguez,1979-02-14,48702192Z,manuel.rodríguez@smartdev.org,107107,ES88209540227161223022,1256.82,2022-12-05T10:14:17,Vitoria-Gasteiz,expenses,phone,-27.53,-24049.34
buyer_6,Manuel,Rodríguez,1979-02-14,48702192Z,manuel.rodríguez@smartdev.org,107107,ES88209540227161223022,1256.82,2022-12-06T10:34:27,Vitoria-Gasteiz,expenses,water,-20.18,-24069.52
buyer_6,Manuel,Rodríguez,1979-02-14,48702192Z,manuel.rodríguez@smartdev.org,107107,ES88209540227161223022,1256.82,2022-12-06T20:15:34,Vitoria-Gasteiz,expenses,gas,-40.48,-24110.0
buyer_6,Manuel,Rodríguez,1979-02-14,48702192Z,manuel.rodríguez@smartdev.org,107107,ES88209540227161223022,1256.82,2022-12-06T21:46:06,Vitoria-Gasteiz,expenses,food,-101.23,-24211.23
buyer_6,Manuel,Rodríguez,1979-02-14,48702192Z,manuel.rodríguez@smartdev.org,107107,ES88209540227161223022,1256.82,2022-12-06T00:53:04,Vitoria-Gasteiz,expenses,clothing,-112.94,-24324.17
buyer_6,Manuel,Rodríguez,1979-02-14,48702192Z,manuel.rodríguez@smartdev.org,107107,ES88209540227161223022,1256.82,2022-12-07T16:22:54,Vitoria-Gasteiz,expenses,leisure,-60.24,-24384.41
buyer_6,Manuel,Rodríguez,1979-02-14,48702192Z,manuel.rodríguez@smartdev.org,107107,ES88209540227161223022,1256.82,2022-12-08T10:26:45,Vitoria-Gasteiz,expenses,internet,-27.38,-24411.79
buyer_6,Manuel,Rodríguez,1979-02-14,48702192Z,manuel.rodríguez@smartdev.org,107107,ES88209540227161223022,1256.82,2022-12-09T14:42:58,Vitoria-Gasteiz,expenses,leisure,-25.87,-24437.66
buyer_6,Manuel,Rodríguez,1979-02-14,48702192Z,manuel.rodríguez@smartdev.org,107107,ES88209540227161223022,1256.82,2022-12-11T15:14:45,Vitoria-Gasteiz,expenses,food,-90.67,-24528.33
buyer_6,Manuel,Rodríguez,1979-02-14,48702192Z,manuel.rodríguez@smartdev.org,107107,ES88209540227161223022,1256.82,2022-12-12T16:13:13,Vitoria-Gasteiz,expenses,leisure,-18.9,-24547.23
buyer_6,Manuel,Rodríguez,1979-02-14,48702192Z,manuel.rodríguez@smartdev.org,107107,ES88209540227161223022,1256.82,2022-12-12T12:12:23,Vitoria-Gasteiz,expenses,clothing,-56.84,-24604.07
buyer_6,Manuel,Rodríguez,1979-02-14,48702192Z,manuel.rodríguez@smartdev.org,107107,ES88209540227161223022,1256.82,2022-12-13T18:44:51,Vitoria-Gasteiz,expenses,cash,-100.0,-24704.07
buyer_6,Manuel,Rodríguez,1979-02-14,48702192Z,manuel.rodríguez@smartdev.org,107107,ES88209540227161223022,1256.82,2022-12-15T08:38:14,Vitoria-Gasteiz,expenses,repairs,-327.69,-25031.76
buyer_6,Manuel,Rodríguez,1979-02-14,48702192Z,manuel.rodríguez@smartdev.org,107107,ES88209540227161223022,1256.82,2022-12-15T09:48:07,Vitoria-Gasteiz,expenses,gifts,-61.35,-25093.11
buyer_6,Manuel,Rodríguez,1979-02-14,48702192Z,manuel.rodríguez@smartdev.org,107107,ES88209540227161223022,1256.82,2022-12-16T11:14:16,Vitoria-Gasteiz,expenses,transport,-59.26,-25152.37
buyer_6,Manuel,Rodríguez,1979-02-14,48702192Z,manuel.rodríguez@smartdev.org,107107,ES88209540227161223022,1256.82,2022-12-18T16:08:59,Vitoria-Gasteiz,expenses,leisure,-79.66,-25232.03
buyer_6,Manuel,Rodríguez,1979-02-14,48702192Z,manuel.rodríguez@smartdev.org,107107,ES88209540227161223022,1256.82,2022-12-18T11:41:53,Vitoria-Gasteiz,expenses,repairs,-271.46,-25503.49
buyer_6,Manuel,Rodríguez,1979-02-14,48702192Z,manuel.rodríguez@smartdev.org,107107,ES88209540227161223022,1256.82,2022-12-19T16:26:09,Vitoria-Gasteiz,expenses,cash,-100.0,-25603.49
buyer_6,Manuel,Rodríguez,1979-02-14,48702192Z,manuel.rodríguez@smartdev.org,107107,ES88209540227161223022,1256.82,2022-12-20T23:08:22,Vitoria-Gasteiz,expenses,food,-116.76,-25720.25
buyer_6,Manuel,Rodríguez,1979-02-14,48702192Z,manuel.rodríguez@smartdev.org,107107,ES88209540227161223022,1256.82,2022-12-20T13:54:44,Vitoria-Gasteiz,expenses,repairs,-166.8,-25887.05
buyer_6,Manuel,Rodríguez,1979-02-14,48702192Z,manuel.rodríguez@smartdev.org,107107,ES88209540227161223022,1256.82,2022-12-21T22:19:46,Vitoria-Gasteiz,expenses,cash,-100.0,-25987.05
buyer_6,Manuel,Rodríguez,1979-02-14,48702192Z,manuel.rodríguez@smartdev.org,107107,ES88209540227161223022,1256.82,2022-12-23T14:12:05,Vitoria-Gasteiz,expenses,transport,-42.11,-26029.16
buyer_6,Manuel,Rodríguez,1979-02-14,48702192Z,manuel.rodríguez@smartdev.org,107107,ES88209540227161223022,1256.82,2022-12-24T15:14:15,Vitoria-Gasteiz,expenses,gifts,-374.48,-26403.64
buyer_6,Manuel,Rodríguez,1979-02-14,48702192Z,manuel.rodríguez@smartdev.org,107107,ES88209540227161223022,1256.82,2022-12-25T19:31:12,Vitoria-Gasteiz,expenses,cash,-100.0,-26503.64
buyer_6,Manuel,Rodríguez,1979-02-14,48702192Z,manuel.rodríguez@smartdev.org,107107,ES88209540227161223022,1256.82,2022-12-26T10:50:56,Vitoria-Gasteiz,expenses,healthcare,-97.07,-26600.71
buyer_6,Manuel,Rodríguez,1979-02-14,48702192Z,manuel.rodríguez@smartdev.org,107107,ES88209540227161223022,1256.82,2022-12-27T17:03:54,Vitoria-Gasteiz,expenses,leisure,-83.14,-26683.85
buyer_6,Manuel,Rodríguez,1979-02-14,48702192Z,manuel.rodríguez@smartdev.org,107107,ES88209540227161223022,1256.82,2023-01-01T11:06:32,Vitoria-Gasteiz,incomes,salary,1336.9,-25346.95
buyer_6,Manuel,Rodríguez,1979-02-14,48702192Z,manuel.rodríguez@smartdev.org,107107,ES88209540227161223022,1256.82,2023-01-01T21:44:00,Vitoria-Gasteiz,expenses,food,-92.72,-25439.67
buyer_6,Manuel,Rodríguez,1979-02-14,48702192Z,manuel.rodríguez@smartdev.org,107107,ES88209540227161223022,1256.82,2023-01-01T08:57:53,Vitoria-Gasteiz,expenses,cash,-100.0,-25539.67
buyer_6,Manuel,Rodríguez,1979-02-14,48702192Z,manuel.rodríguez@smartdev.org,107107,ES88209540227161223022,1256.82,2023-01-01T10:05:00,Vitoria-Gasteiz,expenses,appliances,-244.42,-25784.09
buyer_6,Manuel,Rodríguez,1979-02-14,48702192Z,manuel.rodríguez@smartdev.org,107107,ES88209540227161223022,1256.82,2023-01-01T14:45:49,Vitoria-Gasteiz,expenses,gifts,-250.96,-26035.05
buyer_6,Manuel,Rodríguez,1979-02-14,48702192Z,manuel.rodríguez@smartdev.org,107107,ES88209540227161223022,1256.82,2023-01-04T19:48:27,Vitoria-Gasteiz,expenses,mortgage,-555.29,-26590.34
buyer_6,Manuel,Rodríguez,1979-02-14,48702192Z,manuel.rodríguez@smartdev.org,107107,ES88209540227161223022,1256.82,2023-01-05T23:51:52,Vitoria-Gasteiz,expenses,phone,-22.41,-26612.75
buyer_6,Manuel,Rodríguez,1979-02-14,48702192Z,manuel.rodríguez@smartdev.org,107107,ES88209540227161223022,1256.82,2023-01-05T00:18:36,Vitoria-Gasteiz,expenses,healthcare,-149.5,-26762.25
buyer_6,Manuel,Rodríguez,1979-02-14,48702192Z,manuel.rodríguez@smartdev.org,107107,ES88209540227161223022,1256.82,2023-01-06T22:07:31,Vitoria-Gasteiz,expenses,gas,-21.79,-26784.04
buyer_6,Manuel,Rodríguez,1979-02-14,48702192Z,manuel.rodríguez@smartdev.org,107107,ES88209540227161223022,1256.82,2023-01-06T21:02:31,Vitoria-Gasteiz,expenses,internet,-28.07,-26812.11
buyer_6,Manuel,Rodríguez,1979-02-14,48702192Z,manuel.rodríguez@smartdev.org,107107,ES88209540227161223022,1256.82,2023-01-06T22:47:36,Vitoria-Gasteiz,expenses,transport,-81.91,-26894.02
buyer_6,Manuel,Rodríguez,1979-02-14,48702192Z,manuel.rodríguez@smartdev.org,107107,ES88209540227161223022,1256.82,2023-01-06T07:16:18,Vitoria-Gasteiz,expenses,repairs,-276.19,-27170.21
buyer_6,Manuel,Rodríguez,1979-02-14,48702192Z,manuel.rodríguez@smartdev.org,107107,ES88209540227161223022,1256.82,2023-01-08T23:51:17,Vitoria-Gasteiz,expenses,water,-27.73,-27197.94
buyer_6,Manuel,Rodríguez,1979-02-14,48702192Z,manuel.rodríguez@smartdev.org,107107,ES88209540227161223022,1256.82,2023-01-08T12:41:37,Vitoria-Gasteiz,expenses,electricity,-34.24,-27232.18
buyer_6,Manuel,Rodríguez,1979-02-14,48702192Z,manuel.rodríguez@smartdev.org,107107,ES88209540227161223022,1256.82,2023-01-09T17:45:54,Vitoria-Gasteiz,expenses,cash,-100.0,-27332.18
buyer_6,Manuel,Rodríguez,1979-02-14,48702192Z,manuel.rodríguez@smartdev.org,107107,ES88209540227161223022,1256.82,2023-01-10T13:41:54,Vitoria-Gasteiz,expenses,appliances,-81.71,-27413.89
buyer_6,Manuel,Rodríguez,1979-02-14,48702192Z,manuel.rodríguez@smartdev.org,107107,ES88209540227161223022,1256.82,2023-01-13T15:09:46,Vitoria-Gasteiz,expenses,cash,-100.0,-27513.89
buyer_6,Manuel,Rodríguez,1979-02-14,48702192Z,manuel.rodríguez@smartdev.org,107107,ES88209540227161223022,1256.82,2023-01-14T22:26:13,Vitoria-Gasteiz,expenses,food,-81.28,-27595.17
buyer_6,Manuel,Rodríguez,1979-02-14,48702192Z,manuel.rodríguez@smartdev.org,107107,ES88209540227161223022,1256.82,2023-01-15T12:40:27,Vitoria-Gasteiz,expenses,clothing,-119.85,-27715.02
buyer_6,Manuel,Rodríguez,1979-02-14,48702192Z,manuel.rodríguez@smartdev.org,107107,ES88209540227161223022,1256.82,2023-01-18T22:26:17,Vitoria-Gasteiz,expenses,cash,-100.0,-27815.02
buyer_6,Manuel,Rodríguez,1979-02-14,48702192Z,manuel.rodríguez@smartdev.org,107107,ES88209540227161223022,1256.82,2023-01-18T13:38:47,Vitoria-Gasteiz,expenses,repairs,-287.2,-28102.22
buyer_6,Manuel,Rodríguez,1979-02-14,48702192Z,manuel.rodríguez@smartdev.org,107107,ES88209540227161223022,1256.82,2023-01-19T17:41:40,Vitoria-Gasteiz,expenses,food,-77.73,-28179.95
buyer_6,Manuel,Rodríguez,1979-02-14,48702192Z,manuel.rodríguez@smartdev.org,107107,ES88209540227161223022,1256.82,2023-01-20T18:59:08,Vitoria-Gasteiz,expenses,food,-65.47,-28245.42
buyer_6,Manuel,Rodríguez,1979-02-14,48702192Z,manuel.rodríguez@smartdev.org,107107,ES88209540227161223022,1256.82,2023-01-20T11:36:44,Vitoria-Gasteiz,expenses,cash,-100.0,-28345.42
buyer_6,Manuel,Rodríguez,1979-02-14,48702192Z,manuel.rodríguez@smartdev.org,107107,ES88209540227161223022,1256.82,2023-01-21T19:40:41,Vitoria-Gasteiz,expenses,clothing,-97.92,-28443.34
buyer_6,Manuel,Rodríguez,1979-02-14,48702192Z,manuel.rodríguez@smartdev.org,107107,ES88209540227161223022,1256.82,2023-01-22T06:04:34,Vitoria-Gasteiz,expenses,cash,-100.0,-28543.34
buyer_6,Manuel,Rodríguez,1979-02-14,48702192Z,manuel.rodríguez@smartdev.org,107107,ES88209540227161223022,1256.82,2023-01-23T20:28:12,Vitoria-Gasteiz,expenses,transport,-51.25,-28594.59
buyer_6,Manuel,Rodríguez,1979-02-14,48702192Z,manuel.rodríguez@smartdev.org,107107,ES88209540227161223022,1256.82,2023-01-23T13:25:00,Vitoria-Gasteiz,expenses,healthcare,-67.68,-28662.27
buyer_6,Manuel,Rodríguez,1979-02-14,48702192Z,manuel.rodríguez@smartdev.org,107107,ES88209540227161223022,1256.82,2023-01-25T01:20:20,Vitoria-Gasteiz,expenses,transport,-87.56,-28749.83
buyer_6,Manuel,Rodríguez,1979-02-14,48702192Z,manuel.rodríguez@smartdev.org,107107,ES88209540227161223022,1256.82,2023-01-27T12:47:36,Vitoria-Gasteiz,expenses,food,-113.22,-28863.05
buyer_6,Manuel,Rodríguez,1979-02-14,48702192Z,manuel.rodríguez@smartdev.org,107107,ES88209540227161223022,1256.82,2023-01-28T12:27:28,Vitoria-Gasteiz,expenses,transport,-88.97,-28952.02
buyer_6,Manuel,Rodríguez,1979-02-14,48702192Z,manuel.rodríguez@smartdev.org,107107,ES88209540227161223022,1256.82,2023-01-31T20:17:51,Vitoria-Gasteiz,expenses,food,-111.7,-29063.72
buyer_6,Manuel,Rodríguez,1979-02-14,48702192Z,manuel.rodríguez@smartdev.org,107107,ES88209540227161223022,1256.82,2023-02-01T11:49:22,Vitoria-Gasteiz,incomes,salary,1336.9,-27726.82
buyer_6,Manuel,Rodríguez,1979-02-14,48702192Z,manuel.rodríguez@smartdev.org,107107,ES88209540227161223022,1256.82,2023-02-02T14:03:42,Vitoria-Gasteiz,expenses,appliances,-288.69,-28015.51
buyer_6,Manuel,Rodríguez,1979-02-14,48702192Z,manuel.rodríguez@smartdev.org,107107,ES88209540227161223022,1256.82,2023-02-03T18:01:36,Vitoria-Gasteiz,expenses,leisure,-55.58,-28071.09
buyer_6,Manuel,Rodríguez,1979-02-14,48702192Z,manuel.rodríguez@smartdev.org,107107,ES88209540227161223022,1256.82,2023-02-04T10:52:46,Vitoria-Gasteiz,expenses,mortgage,-555.29,-28626.38
buyer_6,Manuel,Rodríguez,1979-02-14,48702192Z,manuel.rodríguez@smartdev.org,107107,ES88209540227161223022,1256.82,2023-02-06T16:18:34,Vitoria-Gasteiz,expenses,cash,-100.0,-28726.38
buyer_6,Manuel,Rodríguez,1979-02-14,48702192Z,manuel.rodríguez@smartdev.org,107107,ES88209540227161223022,1256.82,2023-02-07T11:17:58,Vitoria-Gasteiz,expenses,phone,-26.48,-28752.86
buyer_6,Manuel,Rodríguez,1979-02-14,48702192Z,manuel.rodríguez@smartdev.org,107107,ES88209540227161223022,1256.82,2023-02-07T10:59:08,Vitoria-Gasteiz,expenses,clothing,-154.44,-28907.3
buyer_6,Manuel,Rodríguez,1979-02-14,48702192Z,manuel.rodríguez@smartdev.org,107107,ES88209540227161223022,1256.82,2023-02-07T20:25:37,Vitoria-Gasteiz,expenses,healthcare,-112.83,-29020.13
buyer_6,Manuel,Rodríguez,1979-02-14,48702192Z,manuel.rodríguez@smartdev.org,107107,ES88209540227161223022,1256.82,2023-02-08T16:53:19,Vitoria-Gasteiz,expenses,electricity,-29.92,-29050.05
buyer_6,Manuel,Rodríguez,1979-02-14,48702192Z,manuel.rodríguez@smartdev.org,107107,ES88209540227161223022,1256.82,2023-02-08T13:36:21,Vitoria-Gasteiz,expenses,internet,-28.07,-29078.12
buyer_6,Manuel,Rodríguez,1979-02-14,48702192Z,manuel.rodríguez@smartdev.org,107107,ES88209540227161223022,1256.82,2023-02-08T17:39:27,Vitoria-Gasteiz,expenses,water,-14.67,-29092.79
buyer_6,Manuel,Rodríguez,1979-02-14,48702192Z,manuel.rodríguez@smartdev.org,107107,ES88209540227161223022,1256.82,2023-02-08T15:20:57,Vitoria-Gasteiz,expenses,gas,-43.16,-29135.95
buyer_6,Manuel,Rodríguez,1979-02-14,48702192Z,manuel.rodríguez@smartdev.org,107107,ES88209540227161223022,1256.82,2023-02-10T08:55:05,Vitoria-Gasteiz,expenses,gifts,-166.4,-29302.35
buyer_6,Manuel,Rodríguez,1979-02-14,48702192Z,manuel.rodríguez@smartdev.org,107107,ES88209540227161223022,1256.82,2023-02-12T03:38:15,Vitoria-Gasteiz,expenses,education,-58.65,-29361.0
buyer_6,Manuel,Rodríguez,1979-02-14,48702192Z,manuel.rodríguez@smartdev.org,107107,ES88209540227161223022,1256.82,2023-02-12T13:01:26,Vitoria-Gasteiz,expenses,gifts,-614.25,-29975.25
buyer_6,Manuel,Rodríguez,1979-02-14,48702192Z,manuel.rodríguez@smartdev.org,107107,ES88209540227161223022,1256.82,2023-02-13T20:14:55,Vitoria-Gasteiz,expenses,cash,-100.0,-30075.25
buyer_6,Manuel,Rodríguez,1979-02-14,48702192Z,manuel.rodríguez@smartdev.org,107107,ES88209540227161223022,1256.82,2023-02-15T16:45:49,Vitoria-Gasteiz,expenses,clothing,-99.37,-30174.62
buyer_6,Manuel,Rodríguez,1979-02-14,48702192Z,manuel.rodríguez@smartdev.org,107107,ES88209540227161223022,1256.82,2023-02-16T12:31:45,Vitoria-Gasteiz,expenses,repairs,-143.25,-30317.87
buyer_6,Manuel,Rodríguez,1979-02-14,48702192Z,manuel.rodríguez@smartdev.org,107107,ES88209540227161223022,1256.82,2023-02-18T17:36:11,Vitoria-Gasteiz,expenses,transport,-88.07,-30405.94
buyer_6,Manuel,Rodríguez,1979-02-14,48702192Z,manuel.rodríguez@smartdev.org,107107,ES88209540227161223022,1256.82,2023-02-19T20:17:45,Vitoria-Gasteiz,expenses,leisure,-20.63,-30426.57
buyer_6,Manuel,Rodríguez,1979-02-14,48702192Z,manuel.rodríguez@smartdev.org,107107,ES88209540227161223022,1256.82,2023-02-21T09:18:18,Vitoria-Gasteiz,expenses,cash,-100.0,-30526.57
buyer_6,Manuel,Rodríguez,1979-02-14,48702192Z,manuel.rodríguez@smartdev.org,107107,ES88209540227161223022,1256.82,2023-02-23T16:24:23,Vitoria-Gasteiz,expenses,transport,-70.2,-30596.77
buyer_6,Manuel,Rodríguez,1979-02-14,48702192Z,manuel.rodríguez@smartdev.org,107107,ES88209540227161223022,1256.82,2023-02-23T10:40:23,Vitoria-Gasteiz,expenses,gifts,-222.16,-30818.93
buyer_6,Manuel,Rodríguez,1979-02-14,48702192Z,manuel.rodríguez@smartdev.org,107107,ES88209540227161223022,1256.82,2023-02-24T18:11:41,Vitoria-Gasteiz,expenses,gifts,-230.79,-31049.72
buyer_6,Manuel,Rodríguez,1979-02-14,48702192Z,manuel.rodríguez@smartdev.org,107107,ES88209540227161223022,1256.82,2023-02-26T20:45:11,Vitoria-Gasteiz,expenses,transport,-49.35,-31099.07
buyer_6,Manuel,Rodríguez,1979-02-14,48702192Z,manuel.rodríguez@smartdev.org,107107,ES88209540227161223022,1256.82,2023-03-01T22:10:26,Vitoria-Gasteiz,incomes,salary,1336.9,-29762.17
buyer_6,Manuel,Rodríguez,1979-02-14,48702192Z,manuel.rodríguez@smartdev.org,107107,ES88209540227161223022,1256.82,2023-03-03T22:38:08,Vitoria-Gasteiz,expenses,cash,-100.0,-29862.17
buyer_6,Manuel,Rodríguez,1979-02-14,48702192Z,manuel.rodríguez@smartdev.org,107107,ES88209540227161223022,1256.82,2023-03-04T17:22:03,Vitoria-Gasteiz,expenses,mortgage,-555.29,-30417.46
buyer_6,Manuel,Rodríguez,1979-02-14,48702192Z,manuel.rodríguez@smartdev.org,107107,ES88209540227161223022,1256.82,2023-03-04T17:26:13,Vitoria-Gasteiz,expenses,leisure,-61.2,-30478.66
buyer_6,Manuel,Rodríguez,1979-02-14,48702192Z,manuel.rodríguez@smartdev.org,107107,ES88209540227161223022,1256.82,2023-03-05T18:37:06,Vitoria-Gasteiz,expenses,cash,-100.0,-30578.66
buyer_6,Manuel,Rodríguez,1979-02-14,48702192Z,manuel.rodríguez@smartdev.org,107107,ES88209540227161223022,1256.82,2023-03-06T08:17:48,Vitoria-Gasteiz,expenses,electricity,-49.79,-30628.45
buyer_6,Manuel,Rodríguez,1979-02-14,48702192Z,manuel.rodríguez@smartdev.org,107107,ES88209540227161223022,1256.82,2023-03-06T19:38:45,Vitoria-Gasteiz,expenses,transport,-74.85,-30703.3
buyer_6,Manuel,Rodríguez,1979-02-14,48702192Z,manuel.rodríguez@smartdev.org,107107,ES88209540227161223022,1256.82,2023-03-07T13:29:28,Vitoria-Gasteiz,expenses,transport,-60.06,-30763.36
buyer_6,Manuel,Rodríguez,1979-02-14,48702192Z,manuel.rodríguez@smartdev.org,107107,ES88209540227161223022,1256.82,2023-03-07T11:21:10,Vitoria-Gasteiz,expenses,cash,-100.0,-30863.36
buyer_6,Manuel,Rodríguez,1979-02-14,48702192Z,manuel.rodríguez@smartdev.org,107107,ES88209540227161223022,1256.82,2023-03-08T04:49:23,Vitoria-Gasteiz,expenses,gas,-65.24,-30928.6
buyer_6,Manuel,Rodríguez,1979-02-14,48702192Z,manuel.rodríguez@smartdev.org,107107,ES88209540227161223022,1256.82,2023-03-08T19:11:39,Vitoria-Gasteiz,expenses,water,-16.62,-30945.22
buyer_6,Manuel,Rodríguez,1979-02-14,48702192Z,manuel.rodríguez@smartdev.org,107107,ES88209540227161223022,1256.82,2023-03-08T20:39:00,Vitoria-Gasteiz,expenses,internet,-28.07,-30973.29
buyer_6,Manuel,Rodríguez,1979-02-14,48702192Z,manuel.rodríguez@smartdev.org,107107,ES88209540227161223022,1256.82,2023-03-08T11:48:32,Vitoria-Gasteiz,expenses,phone,-26.72,-31000.01
buyer_6,Manuel,Rodríguez,1979-02-14,48702192Z,manuel.rodríguez@smartdev.org,107107,ES88209540227161223022,1256.82,2023-03-08T11:23:35,Vitoria-Gasteiz,expenses,food,-64.15,-31064.16
buyer_6,Manuel,Rodríguez,1979-02-14,48702192Z,manuel.rodríguez@smartdev.org,107107,ES88209540227161223022,1256.82,2023-03-11T09:37:26,Vitoria-Gasteiz,expenses,appliances,-101.51,-31165.67
buyer_6,Manuel,Rodríguez,1979-02-14,48702192Z,manuel.rodríguez@smartdev.org,107107,ES88209540227161223022,1256.82,2023-03-13T11:23:49,Vitoria-Gasteiz,expenses,cash,-100.0,-31265.67
buyer_6,Manuel,Rodríguez,1979-02-14,48702192Z,manuel.rodríguez@smartdev.org,107107,ES88209540227161223022,1256.82,2023-03-16T08:11:04,Vitoria-Gasteiz,expenses,repairs,-160.22,-31425.89
buyer_6,Manuel,Rodríguez,1979-02-14,48702192Z,manuel.rodríguez@smartdev.org,107107,ES88209540227161223022,1256.82,2023-03-17T19:06:50,Vitoria-Gasteiz,expenses,repairs,-240.79,-31666.68
buyer_6,Manuel,Rodríguez,1979-02-14,48702192Z,manuel.rodríguez@smartdev.org,107107,ES88209540227161223022,1256.82,2023-03-18T03:42:04,Vitoria-Gasteiz,expenses,food,-106.16,-31772.84
buyer_6,Manuel,Rodríguez,1979-02-14,48702192Z,manuel.rodríguez@smartdev.org,107107,ES88209540227161223022,1256.82,2023-03-18T15:12:17,Vitoria-Gasteiz,expenses,cash,-100.0,-31872.84
buyer_6,Manuel,Rodríguez,1979-02-14,48702192Z,manuel.rodríguez@smartdev.org,107107,ES88209540227161223022,1256.82,2023-03-19T09:27:13,Vitoria-Gasteiz,expenses,food,-87.07,-31959.91
buyer_6,Manuel,Rodríguez,1979-02-14,48702192Z,manuel.rodríguez@smartdev.org,107107,ES88209540227161223022,1256.82,2023-03-19T15:31:20,Vitoria-Gasteiz,expenses,leisure,-50.89,-32010.8
buyer_6,Manuel,Rodríguez,1979-02-14,48702192Z,manuel.rodríguez@smartdev.org,107107,ES88209540227161223022,1256.82,2023-03-20T12:57:32,Vitoria-Gasteiz,expenses,healthcare,-120.26,-32131.06
buyer_6,Manuel,Rodríguez,1979-02-14,48702192Z,manuel.rodríguez@smartdev.org,107107,ES88209540227161223022,1256.82,2023-03-23T16:46:54,Vitoria-Gasteiz,expenses,food,-77.85,-32208.91
buyer_6,Manuel,Rodríguez,1979-02-14,48702192Z,manuel.rodríguez@smartdev.org,107107,ES88209540227161223022,1256.82,2023-03-24T09:27:47,Vitoria-Gasteiz,expenses,education,-62.88,-32271.79
buyer_6,Manuel,Rodríguez,1979-02-14,48702192Z,manuel.rodríguez@smartdev.org,107107,ES88209540227161223022,1256.82,2023-03-27T08:00:27,Vitoria-Gasteiz,expenses,transport,-75.99,-32347.78
buyer_6,Manuel,Rodríguez,1979-02-14,48702192Z,manuel.rodríguez@smartdev.org,107107,ES88209540227161223022,1256.82,2023-03-27T12:11:28,Vitoria-Gasteiz,expenses,leisure,-74.29,-32422.07
buyer_6,Manuel,Rodríguez,1979-02-14,48702192Z,manuel.rodríguez@smartdev.org,107107,ES88209540227161223022,1256.82,2023-03-27T13:08:18,Vitoria-Gasteiz,expenses,repairs,-70.0,-32492.07
buyer_6,Manuel,Rodríguez,1979-02-14,48702192Z,manuel.rodríguez@smartdev.org,107107,ES88209540227161223022,1256.82,2023-03-29T22:47:56,Vitoria-Gasteiz,expenses,leisure,-30.82,-32522.89
buyer_6,Manuel,Rodríguez,1979-02-14,48702192Z,manuel.rodríguez@smartdev.org,107107,ES88209540227161223022,1256.82,2023-03-29T09:20:34,Vitoria-Gasteiz,expenses,clothing,-59.55,-32582.44
buyer_6,Manuel,Rodríguez,1979-02-14,48702192Z,manuel.rodríguez@smartdev.org,107107,ES88209540227161223022,1256.82,2023-03-30T15:08:16,Vitoria-Gasteiz,expenses,food,-96.83,-32679.27
buyer_6,Manuel,Rodríguez,1979-02-14,48702192Z,manuel.rodríguez@smartdev.org,107107,ES88209540227161223022,1256.82,2023-04-01T10:49:26,Vitoria-Gasteiz,incomes,salary,1336.9,-31342.37
buyer_6,Manuel,Rodríguez,1979-02-14,48702192Z,manuel.rodríguez@smartdev.org,107107,ES88209540227161223022,1256.82,2023-04-01T10:49:26,Vitoria-Gasteiz,incomes,extra_income,181.04,-31161.33
buyer_6,Manuel,Rodríguez,1979-02-14,48702192Z,manuel.rodríguez@smartdev.org,107107,ES88209540227161223022,1256.82,2023-04-02T19:46:50,Vitoria-Gasteiz,expenses,transport,-65.24,-31226.57
buyer_6,Manuel,Rodríguez,1979-02-14,48702192Z,manuel.rodríguez@smartdev.org,107107,ES88209540227161223022,1256.82,2023-04-04T18:31:26,Vitoria-Gasteiz,expenses,mortgage,-555.29,-31781.86
buyer_6,Manuel,Rodríguez,1979-02-14,48702192Z,manuel.rodríguez@smartdev.org,107107,ES88209540227161223022,1256.82,2023-04-07T17:51:19,Vitoria-Gasteiz,expenses,phone,-27.17,-31809.03
buyer_6,Manuel,Rodríguez,1979-02-14,48702192Z,manuel.rodríguez@smartdev.org,107107,ES88209540227161223022,1256.82,2023-04-08T10:19:05,Vitoria-Gasteiz,expenses,water,-29.01,-31838.04
buyer_6,Manuel,Rodríguez,1979-02-14,48702192Z,manuel.rodríguez@smartdev.org,107107,ES88209540227161223022,1256.82,2023-04-08T22:56:50,Vitoria-Gasteiz,expenses,gas,-24.68,-31862.72
buyer_6,Manuel,Rodríguez,1979-02-14,48702192Z,manuel.rodríguez@smartdev.org,107107,ES88209540227161223022,1256.82,2023-04-08T16:08:34,Vitoria-Gasteiz,expenses,electricity,-37.31,-31900.03
buyer_6,Manuel,Rodríguez,1979-02-14,48702192Z,manuel.rodríguez@smartdev.org,107107,ES88209540227161223022,1256.82,2023-04-08T15:39:17,Vitoria-Gasteiz,expenses,internet,-28.07,-31928.1
buyer_6,Manuel,Rodríguez,1979-02-14,48702192Z,manuel.rodríguez@smartdev.org,107107,ES88209540227161223022,1256.82,2023-04-08T06:20:32,Vitoria-Gasteiz,expenses,clothing,-100.52,-32028.62
buyer_6,Manuel,Rodríguez,1979-02-14,48702192Z,manuel.rodríguez@smartdev.org,107107,ES88209540227161223022,1256.82,2023-04-08T13:30:29,Vitoria-Gasteiz,expenses,healthcare,-93.52,-32122.14
buyer_6,Manuel,Rodríguez,1979-02-14,48702192Z,manuel.rodríguez@smartdev.org,107107,ES88209540227161223022,1256.82,2023-04-09T15:11:09,Vitoria-Gasteiz,expenses,travel,-316.8,-32438.94
buyer_6,Manuel,Rodríguez,1979-02-14,48702192Z,manuel.rodríguez@smartdev.org,107107,ES88209540227161223022,1256.82,2023-04-11T19:27:15,Vitoria-Gasteiz,expenses,leisure,-46.63,-32485.57
buyer_6,Manuel,Rodríguez,1979-02-14,48702192Z,manuel.rodríguez@smartdev.org,107107,ES88209540227161223022,1256.82,2023-04-14T15:45:54,Vitoria-Gasteiz,expenses,cash,-100.0,-32585.57
buyer_6,Manuel,Rodríguez,1979-02-14,48702192Z,manuel.rodríguez@smartdev.org,107107,ES88209540227161223022,1256.82,2023-04-15T17:47:42,Vitoria-Gasteiz,expenses,education,-70.86,-32656.43
buyer_6,Manuel,Rodríguez,1979-02-14,48702192Z,manuel.rodríguez@smartdev.org,107107,ES88209540227161223022,1256.82,2023-04-15T07:37:54,Vitoria-Gasteiz,expenses,cash,-100.0,-32756.43
buyer_6,Manuel,Rodríguez,1979-02-14,48702192Z,manuel.rodríguez@smartdev.org,107107,ES88209540227161223022,1256.82,2023-04-16T17:22:57,Vitoria-Gasteiz,expenses,transport,-41.2,-32797.63
buyer_6,Manuel,Rodríguez,1979-02-14,48702192Z,manuel.rodríguez@smartdev.org,107107,ES88209540227161223022,1256.82,2023-04-16T11:07:46,Vitoria-Gasteiz,expenses,cash,-100.0,-32897.63
buyer_6,Manuel,Rodríguez,1979-02-14,48702192Z,manuel.rodríguez@smartdev.org,107107,ES88209540227161223022,1256.82,2023-04-16T09:06:54,Vitoria-Gasteiz,expenses,travel,-320.06,-33217.69
buyer_6,Manuel,Rodríguez,1979-02-14,48702192Z,manuel.rodríguez@smartdev.org,107107,ES88209540227161223022,1256.82,2023-04-17T15:36:08,Vitoria-Gasteiz,expenses,cash,-100.0,-33317.69
buyer_6,Manuel,Rodríguez,1979-02-14,48702192Z,manuel.rodríguez@smartdev.org,107107,ES88209540227161223022,1256.82,2023-04-17T09:50:23,Vitoria-Gasteiz,expenses,gifts,-563.82,-33881.51
buyer_6,Manuel,Rodríguez,1979-02-14,48702192Z,manuel.rodríguez@smartdev.org,107107,ES88209540227161223022,1256.82,2023-04-19T13:58:30,Vitoria-Gasteiz,expenses,cash,-100.0,-33981.51
buyer_6,Manuel,Rodríguez,1979-02-14,48702192Z,manuel.rodríguez@smartdev.org,107107,ES88209540227161223022,1256.82,2023-04-19T08:08:49,Vitoria-Gasteiz,expenses,gifts,-495.83,-34477.34
buyer_6,Manuel,Rodríguez,1979-02-14,48702192Z,manuel.rodríguez@smartdev.org,107107,ES88209540227161223022,1256.82,2023-04-20T08:29:28,Vitoria-Gasteiz,expenses,transport,-42.13,-34519.47
buyer_6,Manuel,Rodríguez,1979-02-14,48702192Z,manuel.rodríguez@smartdev.org,107107,ES88209540227161223022,1256.82,2023-04-20T16:46:17,Vitoria-Gasteiz,expenses,clothing,-70.71,-34590.18
buyer_6,Manuel,Rodríguez,1979-02-14,48702192Z,manuel.rodríguez@smartdev.org,107107,ES88209540227161223022,1256.82,2023-04-23T21:42:58,Vitoria-Gasteiz,expenses,food,-99.67,-34689.85
buyer_6,Manuel,Rodríguez,1979-02-14,48702192Z,manuel.rodríguez@smartdev.org,107107,ES88209540227161223022,1256.82,2023-04-23T12:47:14,Vitoria-Gasteiz,expenses,clothing,-153.74,-34843.59
buyer_6,Manuel,Rodríguez,1979-02-14,48702192Z,manuel.rodríguez@smartdev.org,107107,ES88209540227161223022,1256.82,2023-04-25T16:15:38,Vitoria-Gasteiz,expenses,food,-123.42,-34967.01
buyer_6,Manuel,Rodríguez,1979-02-14,48702192Z,manuel.rodríguez@smartdev.org,107107,ES88209540227161223022,1256.82,2023-04-26T01:53:04,Vitoria-Gasteiz,expenses,transport,-82.54,-35049.55
buyer_6,Manuel,Rodríguez,1979-02-14,48702192Z,manuel.rodríguez@smartdev.org,107107,ES88209540227161223022,1256.82,2023-04-28T15:18:16,Vitoria-Gasteiz,expenses,transport,-77.03,-35126.58
buyer_6,Manuel,Rodríguez,1979-02-14,48702192Z,manuel.rodríguez@smartdev.org,107107,ES88209540227161223022,1256.82,2023-04-28T09:47:03,Vitoria-Gasteiz,expenses,gifts,-195.77,-35322.35
buyer_6,Manuel,Rodríguez,1979-02-14,48702192Z,manuel.rodríguez@smartdev.org,107107,ES88209540227161223022,1256.82,2023-05-01T20:13:29,Vitoria-Gasteiz,incomes,salary,1336.9,-33985.45
buyer_6,Manuel,Rodríguez,1979-02-14,48702192Z,manuel.rodríguez@smartdev.org,107107,ES88209540227161223022,1256.82,2023-05-01T09:26:11,Vitoria-Gasteiz,expenses,transport,-79.96,-34065.41
buyer_6,Manuel,Rodríguez,1979-02-14,48702192Z,manuel.rodríguez@smartdev.org,107107,ES88209540227161223022,1256.82,2023-05-01T15:22:05,Vitoria-Gasteiz,expenses,leisure,-23.65,-34089.06
buyer_6,Manuel,Rodríguez,1979-02-14,48702192Z,manuel.rodríguez@smartdev.org,107107,ES88209540227161223022,1256.82,2023-05-01T08:22:51,Vitoria-Gasteiz,expenses,repairs,-326.71,-34415.77
buyer_6,Manuel,Rodríguez,1979-02-14,48702192Z,manuel.rodríguez@smartdev.org,107107,ES88209540227161223022,1256.82,2023-05-02T06:29:22,Vitoria-Gasteiz,expenses,leisure,-34.99,-34450.76
buyer_6,Manuel,Rodríguez,1979-02-14,48702192Z,manuel.rodríguez@smartdev.org,107107,ES88209540227161223022,1256.82,2023-05-03T18:04:31,Vitoria-Gasteiz,expenses,cash,-100.0,-34550.76
buyer_6,Manuel,Rodríguez,1979-02-14,48702192Z,manuel.rodríguez@smartdev.org,107107,ES88209540227161223022,1256.82,2023-05-04T17:21:31,Vitoria-Gasteiz,expenses,mortgage,-555.29,-35106.05
buyer_6,Manuel,Rodríguez,1979-02-14,48702192Z,manuel.rodríguez@smartdev.org,107107,ES88209540227161223022,1256.82,2023-05-06T09:41:27,Vitoria-Gasteiz,expenses,water,-15.01,-35121.06
buyer_6,Manuel,Rodríguez,1979-02-14,48702192Z,manuel.rodríguez@smartdev.org,107107,ES88209540227161223022,1256.82,2023-05-06T14:16:12,Vitoria-Gasteiz,expenses,transport,-81.82,-35202.88
buyer_6,Manuel,Rodríguez,1979-02-14,48702192Z,manuel.rodríguez@smartdev.org,107107,ES88209540227161223022,1256.82,2023-05-06T09:19:21,Vitoria-Gasteiz,expenses,cash,-100.0,-35302.88
buyer_6,Manuel,Rodríguez,1979-02-14,48702192Z,manuel.rodríguez@smartdev.org,107107,ES88209540227161223022,1256.82,2023-05-07T17:37:01,Vitoria-Gasteiz,expenses,internet,-28.07,-35330.95
buyer_6,Manuel,Rodríguez,1979-02-14,48702192Z,manuel.rodríguez@smartdev.org,107107,ES88209540227161223022,1256.82,2023-05-07T12:15:55,Vitoria-Gasteiz,expenses,phone,-27.08,-35358.03
buyer_6,Manuel,Rodríguez,1979-02-14,48702192Z,manuel.rodríguez@smartdev.org,107107,ES88209540227161223022,1256.82,2023-05-07T14:10:30,Vitoria-Gasteiz,expenses,cash,-100.0,-35458.03
buyer_6,Manuel,Rodríguez,1979-02-14,48702192Z,manuel.rodríguez@smartdev.org,107107,ES88209540227161223022,1256.82,2023-05-08T15:50:01,Vitoria-Gasteiz,expenses,electricity,-22.72,-35480.75
buyer_6,Manuel,Rodríguez,1979-02-14,48702192Z,manuel.rodríguez@smartdev.org,107107,ES88209540227161223022,1256.82,2023-05-08T18:48:41,Vitoria-Gasteiz,expenses,gas,-48.42,-35529.17
buyer_6,Manuel,Rodríguez,1979-02-14,48702192Z,manuel.rodríguez@smartdev.org,107107,ES88209540227161223022,1256.82,2023-05-08T14:20:25,Vitoria-Gasteiz,expenses,leisure,-36.1,-35565.27
buyer_6,Manuel,Rodríguez,1979-02-14,48702192Z,manuel.rodríguez@smartdev.org,107107,ES88209540227161223022,1256.82,2023-05-08T19:07:22,Vitoria-Gasteiz,expenses,gifts,-673.05,-36238.32
buyer_6,Manuel,Rodríguez,1979-02-14,48702192Z,manuel.rodríguez@smartdev.org,107107,ES88209540227161223022,1256.82,2023-05-11T17:08:16,Vitoria-Gasteiz,expenses,food,-91.16,-36329.48
buyer_6,Manuel,Rodríguez,1979-02-14,48702192Z,manuel.rodríguez@smartdev.org,107107,ES88209540227161223022,1256.82,2023-05-15T10:42:15,Vitoria-Gasteiz,expenses,cash,-100.0,-36429.48
buyer_6,Manuel,Rodríguez,1979-02-14,48702192Z,manuel.rodríguez@smartdev.org,107107,ES88209540227161223022,1256.82,2023-05-17T16:41:25,Vitoria-Gasteiz,expenses,food,-110.52,-36540.0
buyer_6,Manuel,Rodríguez,1979-02-14,48702192Z,manuel.rodríguez@smartdev.org,107107,ES88209540227161223022,1256.82,2023-05-17T00:38:37,Vitoria-Gasteiz,expenses,gifts,-68.49,-36608.49
buyer_6,Manuel,Rodríguez,1979-02-14,48702192Z,manuel.rodríguez@smartdev.org,107107,ES88209540227161223022,1256.82,2023-05-19T19:39:00,Vitoria-Gasteiz,expenses,food,-114.89,-36723.38
buyer_6,Manuel,Rodríguez,1979-02-14,48702192Z,manuel.rodríguez@smartdev.org,107107,ES88209540227161223022,1256.82,2023-05-23T01:52:37,Vitoria-Gasteiz,expenses,leisure,-73.85,-36797.23
buyer_6,Manuel,Rodríguez,1979-02-14,48702192Z,manuel.rodríguez@smartdev.org,107107,ES88209540227161223022,1256.82,2023-05-25T19:21:08,Vitoria-Gasteiz,expenses,food,-77.91,-36875.14
buyer_6,Manuel,Rodríguez,1979-02-14,48702192Z,manuel.rodríguez@smartdev.org,107107,ES88209540227161223022,1256.82,2023-05-26T16:20:00,Vitoria-Gasteiz,expenses,gifts,-707.23,-37582.37
buyer_6,Manuel,Rodríguez,1979-02-14,48702192Z,manuel.rodríguez@smartdev.org,107107,ES88209540227161223022,1256.82,2023-05-27T19:37:24,Vitoria-Gasteiz,expenses,repairs,-245.1,-37827.47
buyer_6,Manuel,Rodríguez,1979-02-14,48702192Z,manuel.rodríguez@smartdev.org,107107,ES88209540227161223022,1256.82,2023-05-29T17:51:07,Vitoria-Gasteiz,expenses,food,-77.95,-37905.42
buyer_6,Manuel,Rodríguez,1979-02-14,48702192Z,manuel.rodríguez@smartdev.org,107107,ES88209540227161223022,1256.82,2023-05-29T18:58:59,Vitoria-Gasteiz,expenses,repairs,-209.41,-38114.83
buyer_6,Manuel,Rodríguez,1979-02-14,48702192Z,manuel.rodríguez@smartdev.org,107107,ES88209540227161223022,1256.82,2023-05-30T05:21:00,Vitoria-Gasteiz,expenses,transport,-62.39,-38177.22
buyer_6,Manuel,Rodríguez,1979-02-14,48702192Z,manuel.rodríguez@smartdev.org,107107,ES88209540227161223022,1256.82,2023-06-01T20:05:33,Vitoria-Gasteiz,incomes,salary,1336.9,-36840.32
buyer_6,Manuel,Rodríguez,1979-02-14,48702192Z,manuel.rodríguez@smartdev.org,107107,ES88209540227161223022,1256.82,2023-06-01T20:05:33,Vitoria-Gasteiz,incomes,salary_bonus,941.99,-35898.33
buyer_6,Manuel,Rodríguez,1979-02-14,48702192Z,manuel.rodríguez@smartdev.org,107107,ES88209540227161223022,1256.82,2023-06-01T07:18:15,Vitoria-Gasteiz,expenses,transport,-73.46,-35971.79
buyer_6,Manuel,Rodríguez,1979-02-14,48702192Z,manuel.rodríguez@smartdev.org,107107,ES88209540227161223022,1256.82,2023-06-01T04:45:52,Vitoria-Gasteiz,expenses,leisure,-84.97,-36056.76
buyer_6,Manuel,Rodríguez,1979-02-14,48702192Z,manuel.rodríguez@smartdev.org,107107,ES88209540227161223022,1256.82,2023-06-04T11:20:18,Vitoria-Gasteiz,expenses,mortgage,-555.29,-36612.05
buyer_6,Manuel,Rodríguez,1979-02-14,48702192Z,manuel.rodríguez@smartdev.org,107107,ES88209540227161223022,1256.82,2023-06-04T17:11:18,Vitoria-Gasteiz,expenses,gifts,-150.93,-36762.98
buyer_6,Manuel,Rodríguez,1979-02-14,48702192Z,manuel.rodríguez@smartdev.org,107107,ES88209540227161223022,1256.82,2023-06-05T08:37:02,Vitoria-Gasteiz,expenses,electricity,-33.77,-36796.75
buyer_6,Manuel,Rodríguez,1979-02-14,48702192Z,manuel.rodríguez@smartdev.org,107107,ES88209540227161223022,1256.82,2023-06-05T16:52:50,Vitoria-Gasteiz,expenses,cash,-100.0,-36896.75
buyer_6,Manuel,Rodríguez,1979-02-14,48702192Z,manuel.rodríguez@smartdev.org,107107,ES88209540227161223022,1256.82,2023-06-06T08:07:55,Vitoria-Gasteiz,expenses,phone,-29.28,-36926.03
buyer_6,Manuel,Rodríguez,1979-02-14,48702192Z,manuel.rodríguez@smartdev.org,107107,ES88209540227161223022,1256.82,2023-06-06T23:07:07,Vitoria-Gasteiz,expenses,cash,-100.0,-37026.03
buyer_6,Manuel,Rodríguez,1979-02-14,48702192Z,manuel.rodríguez@smartdev.org,107107,ES88209540227161223022,1256.82,2023-06-07T08:09:54,Vitoria-Gasteiz,expenses,cash,-100.0,-37126.03
buyer_6,Manuel,Rodríguez,1979-02-14,48702192Z,manuel.rodríguez@smartdev.org,107107,ES88209540227161223022,1256.82,2023-06-08T08:32:12,Vitoria-Gasteiz,expenses,water,-28.78,-37154.81
buyer_6,Manuel,Rodríguez,1979-02-14,48702192Z,manuel.rodríguez@smartdev.org,107107,ES88209540227161223022,1256.82,2023-06-08T16:10:44,Vitoria-Gasteiz,expenses,gas,-74.75,-37229.56
buyer_6,Manuel,Rodríguez,1979-02-14,48702192Z,manuel.rodríguez@smartdev.org,107107,ES88209540227161223022,1256.82,2023-06-08T11:29:37,Vitoria-Gasteiz,expenses,internet,-28.07,-37257.63
buyer_6,Manuel,Rodríguez,1979-02-14,48702192Z,manuel.rodríguez@smartdev.org,107107,ES88209540227161223022,1256.82,2023-06-08T23:09:53,Vitoria-Gasteiz,expenses,cash,-100.0,-37357.63
buyer_6,Manuel,Rodríguez,1979-02-14,48702192Z,manuel.rodríguez@smartdev.org,107107,ES88209540227161223022,1256.82,2023-06-09T18:07:20,Vitoria-Gasteiz,expenses,leisure,-23.2,-37380.83
buyer_6,Manuel,Rodríguez,1979-02-14,48702192Z,manuel.rodríguez@smartdev.org,107107,ES88209540227161223022,1256.82,2023-06-10T15:55:11,Vitoria-Gasteiz,expenses,food,-76.27,-37457.1
buyer_6,Manuel,Rodríguez,1979-02-14,48702192Z,manuel.rodríguez@smartdev.org,107107,ES88209540227161223022,1256.82,2023-06-11T00:40:44,Vitoria-Gasteiz,expenses,leisure,-34.23,-37491.33
buyer_6,Manuel,Rodríguez,1979-02-14,48702192Z,manuel.rodríguez@smartdev.org,107107,ES88209540227161223022,1256.82,2023-06-11T16:43:41,Vitoria-Gasteiz,expenses,gifts,-278.71,-37770.04
buyer_6,Manuel,Rodríguez,1979-02-14,48702192Z,manuel.rodríguez@smartdev.org,107107,ES88209540227161223022,1256.82,2023-06-12T17:07:26,Vitoria-Gasteiz,expenses,appliances,-228.11,-37998.15
buyer_6,Manuel,Rodríguez,1979-02-14,48702192Z,manuel.rodríguez@smartdev.org,107107,ES88209540227161223022,1256.82,2023-06-12T15:43:28,Vitoria-Gasteiz,expenses,repairs,-148.18,-38146.33
buyer_6,Manuel,Rodríguez,1979-02-14,48702192Z,manuel.rodríguez@smartdev.org,107107,ES88209540227161223022,1256.82,2023-06-16T20:38:02,Vitoria-Gasteiz,expenses,cash,-100.0,-38246.33
buyer_6,Manuel,Rodríguez,1979-02-14,48702192Z,manuel.rodríguez@smartdev.org,107107,ES88209540227161223022,1256.82,2023-06-17T12:37:38,Vitoria-Gasteiz,expenses,leisure,-75.26,-38321.59
buyer_6,Manuel,Rodríguez,1979-02-14,48702192Z,manuel.rodríguez@smartdev.org,107107,ES88209540227161223022,1256.82,2023-06-17T12:01:47,Vitoria-Gasteiz,expenses,cash,-100.0,-38421.59
buyer_6,Manuel,Rodríguez,1979-02-14,48702192Z,manuel.rodríguez@smartdev.org,107107,ES88209540227161223022,1256.82,2023-06-17T22:19:49,Vitoria-Gasteiz,expenses,appliances,-186.74,-38608.33
buyer_6,Manuel,Rodríguez,1979-02-14,48702192Z,manuel.rodríguez@smartdev.org,107107,ES88209540227161223022,1256.82,2023-06-17T15:22:42,Vitoria-Gasteiz,expenses,gifts,-73.13,-38681.46
buyer_6,Manuel,Rodríguez,1979-02-14,48702192Z,manuel.rodríguez@smartdev.org,107107,ES88209540227161223022,1256.82,2023-06-18T18:40:32,Vitoria-Gasteiz,expenses,repairs,-114.02,-38795.48
buyer_6,Manuel,Rodríguez,1979-02-14,48702192Z,manuel.rodríguez@smartdev.org,107107,ES88209540227161223022,1256.82,2023-06-19T23:47:42,Vitoria-Gasteiz,expenses,food,-111.66,-38907.14
buyer_6,Manuel,Rodríguez,1979-02-14,48702192Z,manuel.rodríguez@smartdev.org,107107,ES88209540227161223022,1256.82,2023-06-20T19:46:38,Vitoria-Gasteiz,expenses,education,-62.96,-38970.1
buyer_6,Manuel,Rodríguez,1979-02-14,48702192Z,manuel.rodríguez@smartdev.org,107107,ES88209540227161223022,1256.82,2023-06-26T08:01:39,Vitoria-Gasteiz,expenses,cash,-100.0,-39070.1
buyer_6,Manuel,Rodríguez,1979-02-14,48702192Z,manuel.rodríguez@smartdev.org,107107,ES88209540227161223022,1256.82,2023-06-27T23:39:47,Vitoria-Gasteiz,expenses,food,-66.12,-39136.22
buyer_6,Manuel,Rodríguez,1979-02-14,48702192Z,manuel.rodríguez@smartdev.org,107107,ES88209540227161223022,1256.82,2023-06-27T13:54:13,Vitoria-Gasteiz,expenses,clothing,-154.16,-39290.38
buyer_6,Manuel,Rodríguez,1979-02-14,48702192Z,manuel.rodríguez@smartdev.org,107107,ES88209540227161223022,1256.82,2023-06-27T06:51:53,Vitoria-Gasteiz,expenses,healthcare,-156.93,-39447.31
buyer_6,Manuel,Rodríguez,1979-02-14,48702192Z,manuel.rodríguez@smartdev.org,107107,ES88209540227161223022,1256.82,2023-06-28T02:08:23,Vitoria-Gasteiz,expenses,cash,-100.0,-39547.31
buyer_6,Manuel,Rodríguez,1979-02-14,48702192Z,manuel.rodríguez@smartdev.org,107107,ES88209540227161223022,1256.82,2023-06-29T22:47:41,Vitoria-Gasteiz,expenses,food,-99.35,-39646.66
buyer_6,Manuel,Rodríguez,1979-02-14,48702192Z,manuel.rodríguez@smartdev.org,107107,ES88209540227161223022,1256.82,2023-06-30T19:19:29,Vitoria-Gasteiz,expenses,food,-111.03,-39757.69
buyer_6,Manuel,Rodríguez,1979-02-14,48702192Z,manuel.rodríguez@smartdev.org,107107,ES88209540227161223022,1256.82,2023-06-30T17:35:07,Vitoria-Gasteiz,expenses,leisure,-66.8,-39824.49
buyer_6,Manuel,Rodríguez,1979-02-14,48702192Z,manuel.rodríguez@smartdev.org,107107,ES88209540227161223022,1256.82,2023-07-01T22:35:23,Vitoria-Gasteiz,incomes,salary,1336.9,-38487.59
buyer_6,Manuel,Rodríguez,1979-02-14,48702192Z,manuel.rodríguez@smartdev.org,107107,ES88209540227161223022,1256.82,2023-07-01T22:35:23,Vitoria-Gasteiz,incomes,extra_income,181.04,-38306.55
buyer_6,Manuel,Rodríguez,1979-02-14,48702192Z,manuel.rodríguez@smartdev.org,107107,ES88209540227161223022,1256.82,2023-07-01T03:38:54,Vitoria-Gasteiz,expenses,transport,-53.21,-38359.76
buyer_6,Manuel,Rodríguez,1979-02-14,48702192Z,manuel.rodríguez@smartdev.org,107107,ES88209540227161223022,1256.82,2023-07-01T20:56:43,Vitoria-Gasteiz,expenses,clothing,-129.34,-38489.1
buyer_6,Manuel,Rodríguez,1979-02-14,48702192Z,manuel.rodríguez@smartdev.org,107107,ES88209540227161223022,1256.82,2023-07-01T09:49:04,Vitoria-Gasteiz,expenses,cash,-100.0,-38589.1
buyer_6,Manuel,Rodríguez,1979-02-14,48702192Z,manuel.rodríguez@smartdev.org,107107,ES88209540227161223022,1256.82,2023-07-04T21:44:43,Vitoria-Gasteiz,expenses,mortgage,-555.29,-39144.39
buyer_6,Manuel,Rodríguez,1979-02-14,48702192Z,manuel.rodríguez@smartdev.org,107107,ES88209540227161223022,1256.82,2023-07-04T06:34:01,Vitoria-Gasteiz,expenses,food,-118.03,-39262.42
buyer_6,Manuel,Rodríguez,1979-02-14,48702192Z,manuel.rodríguez@smartdev.org,107107,ES88209540227161223022,1256.82,2023-07-04T19:46:44,Vitoria-Gasteiz,expenses,cash,-100.0,-39362.42
buyer_6,Manuel,Rodríguez,1979-02-14,48702192Z,manuel.rodríguez@smartdev.org,107107,ES88209540227161223022,1256.82,2023-07-05T13:40:06,Vitoria-Gasteiz,expenses,leisure,-40.53,-39402.95
buyer_6,Manuel,Rodríguez,1979-02-14,48702192Z,manuel.rodríguez@smartdev.org,107107,ES88209540227161223022,1256.82,2023-07-06T18:53:37,Vitoria-Gasteiz,expenses,internet,-28.07,-39431.02
buyer_6,Manuel,Rodríguez,1979-02-14,48702192Z,manuel.rodríguez@smartdev.org,107107,ES88209540227161223022,1256.82,2023-07-06T13:24:30,Vitoria-Gasteiz,expenses,phone,-29.4,-39460.42
buyer_6,Manuel,Rodríguez,1979-02-14,48702192Z,manuel.rodríguez@smartdev.org,107107,ES88209540227161223022,1256.82,2023-07-06T13:16:15,Vitoria-Gasteiz,expenses,transport,-85.91,-39546.33
buyer_6,Manuel,Rodríguez,1979-02-14,48702192Z,manuel.rodríguez@smartdev.org,107107,ES88209540227161223022,1256.82,2023-07-07T17:28:17,Vitoria-Gasteiz,expenses,water,-23.17,-39569.5
buyer_6,Manuel,Rodríguez,1979-02-14,48702192Z,manuel.rodríguez@smartdev.org,107107,ES88209540227161223022,1256.82,2023-07-08T08:51:26,Vitoria-Gasteiz,expenses,electricity,-19.46,-39588.96
buyer_6,Manuel,Rodríguez,1979-02-14,48702192Z,manuel.rodríguez@smartdev.org,107107,ES88209540227161223022,1256.82,2023-07-08T06:04:36,Vitoria-Gasteiz,expenses,gas,-69.8,-39658.76
buyer_6,Manuel,Rodríguez,1979-02-14,48702192Z,manuel.rodríguez@smartdev.org,107107,ES88209540227161223022,1256.82,2023-07-10T19:50:55,Vitoria-Gasteiz,expenses,transport,-84.01,-39742.77
buyer_6,Manuel,Rodríguez,1979-02-14,48702192Z,manuel.rodríguez@smartdev.org,107107,ES88209540227161223022,1256.82,2023-07-10T09:00:52,Vitoria-Gasteiz,expenses,healthcare,-160.77,-39903.54
buyer_6,Manuel,Rodríguez,1979-02-14,48702192Z,manuel.rodríguez@smartdev.org,107107,ES88209540227161223022,1256.82,2023-07-10T22:37:07,Vitoria-Gasteiz,expenses,gifts,-89.26,-39992.8
buyer_6,Manuel,Rodríguez,1979-02-14,48702192Z,manuel.rodríguez@smartdev.org,107107,ES88209540227161223022,1256.82,2023-07-12T19:07:29,Vitoria-Gasteiz,expenses,food,-100.13,-40092.93
buyer_6,Manuel,Rodríguez,1979-02-14,48702192Z,manuel.rodríguez@smartdev.org,107107,ES88209540227161223022,1256.82,2023-07-12T15:03:52,Vitoria-Gasteiz,expenses,leisure,-61.49,-40154.42
buyer_6,Manuel,Rodríguez,1979-02-14,48702192Z,manuel.rodríguez@smartdev.org,107107,ES88209540227161223022,1256.82,2023-07-13T10:42:02,Vitoria-Gasteiz,expenses,leisure,-33.02,-40187.44
buyer_6,Manuel,Rodríguez,1979-02-14,48702192Z,manuel.rodríguez@smartdev.org,107107,ES88209540227161223022,1256.82,2023-07-14T14:00:05,Vitoria-Gasteiz,expenses,transport,-66.23,-40253.67
buyer_6,Manuel,Rodríguez,1979-02-14,48702192Z,manuel.rodríguez@smartdev.org,107107,ES88209540227161223022,1256.82,2023-07-16T14:29:29,Vitoria-Gasteiz,expenses,transport,-66.74,-40320.41
buyer_6,Manuel,Rodríguez,1979-02-14,48702192Z,manuel.rodríguez@smartdev.org,107107,ES88209540227161223022,1256.82,2023-07-16T15:52:00,Vitoria-Gasteiz,expenses,leisure,-38.54,-40358.95
buyer_6,Manuel,Rodríguez,1979-02-14,48702192Z,manuel.rodríguez@smartdev.org,107107,ES88209540227161223022,1256.82,2023-07-17T17:10:23,Vitoria-Gasteiz,expenses,education,-58.22,-40417.17
buyer_6,Manuel,Rodríguez,1979-02-14,48702192Z,manuel.rodríguez@smartdev.org,107107,ES88209540227161223022,1256.82,2023-07-18T09:36:43,Vitoria-Gasteiz,expenses,cash,-100.0,-40517.17
buyer_6,Manuel,Rodríguez,1979-02-14,48702192Z,manuel.rodríguez@smartdev.org,107107,ES88209540227161223022,1256.82,2023-07-22T12:18:05,Vitoria-Gasteiz,expenses,transport,-74.68,-40591.85
buyer_6,Manuel,Rodríguez,1979-02-14,48702192Z,manuel.rodríguez@smartdev.org,107107,ES88209540227161223022,1256.82,2023-07-23T13:56:34,Vitoria-Gasteiz,expenses,cash,-100.0,-40691.85
buyer_6,Manuel,Rodríguez,1979-02-14,48702192Z,manuel.rodríguez@smartdev.org,107107,ES88209540227161223022,1256.82,2023-07-24T12:36:14,Vitoria-Gasteiz,expenses,cash,-100.0,-40791.85
buyer_6,Manuel,Rodríguez,1979-02-14,48702192Z,manuel.rodríguez@smartdev.org,107107,ES88209540227161223022,1256.82,2023-07-25T15:01:25,Vitoria-Gasteiz,expenses,leisure,-29.33,-40821.18
buyer_6,Manuel,Rodríguez,1979-02-14,48702192Z,manuel.rodríguez@smartdev.org,107107,ES88209540227161223022,1256.82,2023-07-25T16:15:40,Vitoria-Gasteiz,expenses,cash,-100.0,-40921.18
buyer_6,Manuel,Rodríguez,1979-02-14,48702192Z,manuel.rodríguez@smartdev.org,107107,ES88209540227161223022,1256.82,2023-07-27T15:57:17,Vitoria-Gasteiz,expenses,food,-77.34,-40998.52
buyer_6,Manuel,Rodríguez,1979-02-14,48702192Z,manuel.rodríguez@smartdev.org,107107,ES88209540227161223022,1256.82,2023-07-28T17:37:42,Vitoria-Gasteiz,expenses,gifts,-765.17,-41763.69
buyer_6,Manuel,Rodríguez,1979-02-14,48702192Z,manuel.rodríguez@smartdev.org,107107,ES88209540227161223022,1256.82,2023-07-29T12:52:06,Vitoria-Gasteiz,expenses,healthcare,-75.1,-41838.79
buyer_6,Manuel,Rodríguez,1979-02-14,48702192Z,manuel.rodríguez@smartdev.org,107107,ES88209540227161223022,1256.82,2023-07-30T12:46:12,Vitoria-Gasteiz,expenses,education,-43.91,-41882.7
buyer_6,Manuel,Rodríguez,1979-02-14,48702192Z,manuel.rodríguez@smartdev.org,107107,ES88209540227161223022,1256.82,2023-08-01T08:45:17,Vitoria-Gasteiz,incomes,salary,1336.9,-40545.8
buyer_6,Manuel,Rodríguez,1979-02-14,48702192Z,manuel.rodríguez@smartdev.org,107107,ES88209540227161223022,1256.82,2023-08-01T14:51:48,Vitoria-Gasteiz,expenses,food,-68.73,-40614.53
buyer_6,Manuel,Rodríguez,1979-02-14,48702192Z,manuel.rodríguez@smartdev.org,107107,ES88209540227161223022,1256.82,2023-08-01T22:23:52,Vitoria-Gasteiz,expenses,education,-44.13,-40658.66
buyer_6,Manuel,Rodríguez,1979-02-14,48702192Z,manuel.rodríguez@smartdev.org,107107,ES88209540227161223022,1256.82,2023-08-02T17:19:36,Vitoria-Gasteiz,expenses,cash,-100.0,-40758.66
buyer_6,Manuel,Rodríguez,1979-02-14,48702192Z,manuel.rodríguez@smartdev.org,107107,ES88209540227161223022,1256.82,2023-08-04T19:00:23,Vitoria-Gasteiz,expenses,mortgage,-555.29,-41313.95
buyer_6,Manuel,Rodríguez,1979-02-14,48702192Z,manuel.rodríguez@smartdev.org,107107,ES88209540227161223022,1256.82,2023-08-06T15:44:38,Vitoria-Gasteiz,expenses,food,-64.4,-41378.35
buyer_6,Manuel,Rodríguez,1979-02-14,48702192Z,manuel.rodríguez@smartdev.org,107107,ES88209540227161223022,1256.82,2023-08-08T09:44:48,Vitoria-Gasteiz,expenses,water,-18.08,-41396.43
buyer_6,Manuel,Rodríguez,1979-02-14,48702192Z,manuel.rodríguez@smartdev.org,107107,ES88209540227161223022,1256.82,2023-08-08T09:24:36,Vitoria-Gasteiz,expenses,electricity,-57.23,-41453.66
buyer_6,Manuel,Rodríguez,1979-02-14,48702192Z,manuel.rodríguez@smartdev.org,107107,ES88209540227161223022,1256.82,2023-08-08T15:07:49,Vitoria-Gasteiz,expenses,gas,-37.04,-41490.7
buyer_6,Manuel,Rodríguez,1979-02-14,48702192Z,manuel.rodríguez@smartdev.org,107107,ES88209540227161223022,1256.82,2023-08-08T20:57:36,Vitoria-Gasteiz,expenses,internet,-28.07,-41518.77
buyer_6,Manuel,Rodríguez,1979-02-14,48702192Z,manuel.rodríguez@smartdev.org,107107,ES88209540227161223022,1256.82,2023-08-08T08:01:23,Vitoria-Gasteiz,expenses,phone,-23.72,-41542.49
buyer_6,Manuel,Rodríguez,1979-02-14,48702192Z,manuel.rodríguez@smartdev.org,107107,ES88209540227161223022,1256.82,2023-08-08T10:52:49,Vitoria-Gasteiz,expenses,travel,-734.32,-42276.81
buyer_6,Manuel,Rodríguez,1979-02-14,48702192Z,manuel.rodríguez@smartdev.org,107107,ES88209540227161223022,1256.82,2023-08-08T19:23:18,Vitoria-Gasteiz,expenses,gifts,-26.4,-42303.21
buyer_6,Manuel,Rodríguez,1979-02-14,48702192Z,manuel.rodríguez@smartdev.org,107107,ES88209540227161223022,1256.82,2023-08-09T13:05:38,Vitoria-Gasteiz,expenses,clothing,-107.42,-42410.63
buyer_6,Manuel,Rodríguez,1979-02-14,48702192Z,manuel.rodríguez@smartdev.org,107107,ES88209540227161223022,1256.82,2023-08-10T08:37:13,Vitoria-Gasteiz,expenses,leisure,-20.91,-42431.54
buyer_6,Manuel,Rodríguez,1979-02-14,48702192Z,manuel.rodríguez@smartdev.org,107107,ES88209540227161223022,1256.82,2023-08-16T13:40:56,Vitoria-Gasteiz,expenses,leisure,-46.32,-42477.86
buyer_6,Manuel,Rodríguez,1979-02-14,48702192Z,manuel.rodríguez@smartdev.org,107107,ES88209540227161223022,1256.82,2023-08-16T14:42:00,Vitoria-Gasteiz,expenses,clothing,-132.27,-42610.13
buyer_6,Manuel,Rodríguez,1979-02-14,48702192Z,manuel.rodríguez@smartdev.org,107107,ES88209540227161223022,1256.82,2023-08-17T07:47:55,Vitoria-Gasteiz,expenses,leisure,-19.84,-42629.97
buyer_6,Manuel,Rodríguez,1979-02-14,48702192Z,manuel.rodríguez@smartdev.org,107107,ES88209540227161223022,1256.82,2023-08-17T14:36:37,Vitoria-Gasteiz,expenses,cash,-100.0,-42729.97
buyer_6,Manuel,Rodríguez,1979-02-14,48702192Z,manuel.rodríguez@smartdev.org,107107,ES88209540227161223022,1256.82,2023-08-18T09:43:40,Vitoria-Gasteiz,expenses,transport,-63.78,-42793.75
buyer_6,Manuel,Rodríguez,1979-02-14,48702192Z,manuel.rodríguez@smartdev.org,107107,ES88209540227161223022,1256.82,2023-08-19T19:44:00,Vitoria-Gasteiz,expenses,food,-67.49,-42861.24
buyer_6,Manuel,Rodríguez,1979-02-14,48702192Z,manuel.rodríguez@smartdev.org,107107,ES88209540227161223022,1256.82,2023-08-19T03:31:01,Vitoria-Gasteiz,expenses,transport,-75.55,-42936.79
buyer_6,Manuel,Rodríguez,1979-02-14,48702192Z,manuel.rodríguez@smartdev.org,107107,ES88209540227161223022,1256.82,2023-08-23T14:50:02,Vitoria-Gasteiz,expenses,healthcare,-84.71,-43021.5
buyer_6,Manuel,Rodríguez,1979-02-14,48702192Z,manuel.rodríguez@smartdev.org,107107,ES88209540227161223022,1256.82,2023-08-24T16:57:30,Vitoria-Gasteiz,expenses,leisure,-78.86,-43100.36
buyer_6,Manuel,Rodríguez,1979-02-14,48702192Z,manuel.rodríguez@smartdev.org,107107,ES88209540227161223022,1256.82,2023-08-24T20:38:05,Vitoria-Gasteiz,expenses,education,-55.98,-43156.34
buyer_6,Manuel,Rodríguez,1979-02-14,48702192Z,manuel.rodríguez@smartdev.org,107107,ES88209540227161223022,1256.82,2023-08-24T12:26:24,Vitoria-Gasteiz,expenses,cash,-100.0,-43256.34
buyer_6,Manuel,Rodríguez,1979-02-14,48702192Z,manuel.rodríguez@smartdev.org,107107,ES88209540227161223022,1256.82,2023-08-29T08:28:20,Vitoria-Gasteiz,expenses,food,-62.95,-43319.29
buyer_6,Manuel,Rodríguez,1979-02-14,48702192Z,manuel.rodríguez@smartdev.org,107107,ES88209540227161223022,1256.82,2023-08-30T18:43:06,Vitoria-Gasteiz,expenses,food,-78.79,-43398.08
buyer_6,Manuel,Rodríguez,1979-02-14,48702192Z,manuel.rodríguez@smartdev.org,107107,ES88209540227161223022,1256.82,2023-08-30T22:27:31,Vitoria-Gasteiz,expenses,appliances,-235.15,-43633.23
buyer_6,Manuel,Rodríguez,1979-02-14,48702192Z,manuel.rodríguez@smartdev.org,107107,ES88209540227161223022,1256.82,2023-08-31T19:54:34,Vitoria-Gasteiz,expenses,repairs,-198.55,-43831.78
buyer_6,Manuel,Rodríguez,1979-02-14,48702192Z,manuel.rodríguez@smartdev.org,107107,ES88209540227161223022,1256.82,2023-09-01T19:56:18,Vitoria-Gasteiz,incomes,salary,1336.9,-42494.88
buyer_6,Manuel,Rodríguez,1979-02-14,48702192Z,manuel.rodríguez@smartdev.org,107107,ES88209540227161223022,1256.82,2023-09-01T09:22:11,Vitoria-Gasteiz,expenses,food,-66.13,-42561.01
buyer_6,Manuel,Rodríguez,1979-02-14,48702192Z,manuel.rodríguez@smartdev.org,107107,ES88209540227161223022,1256.82,2023-09-03T02:53:16,Vitoria-Gasteiz,expenses,transport,-83.54,-42644.55
buyer_6,Manuel,Rodríguez,1979-02-14,48702192Z,manuel.rodríguez@smartdev.org,107107,ES88209540227161223022,1256.82,2023-09-03T10:03:56,Vitoria-Gasteiz,expenses,clothing,-109.23,-42753.78
buyer_6,Manuel,Rodríguez,1979-02-14,48702192Z,manuel.rodríguez@smartdev.org,107107,ES88209540227161223022,1256.82,2023-09-04T14:37:04,Vitoria-Gasteiz,expenses,mortgage,-555.29,-43309.07
buyer_6,Manuel,Rodríguez,1979-02-14,48702192Z,manuel.rodríguez@smartdev.org,107107,ES88209540227161223022,1256.82,2023-09-04T11:45:38,Vitoria-Gasteiz,expenses,food,-119.14,-43428.21
buyer_6,Manuel,Rodríguez,1979-02-14,48702192Z,manuel.rodríguez@smartdev.org,107107,ES88209540227161223022,1256.82,2023-09-04T12:44:00,Vitoria-Gasteiz,expenses,transport,-84.32,-43512.53
buyer_6,Manuel,Rodríguez,1979-02-14,48702192Z,manuel.rodríguez@smartdev.org,107107,ES88209540227161223022,1256.82,2023-09-05T17:21:17,Vitoria-Gasteiz,expenses,phone,-22.25,-43534.78
buyer_6,Manuel,Rodríguez,1979-02-14,48702192Z,manuel.rodríguez@smartdev.org,107107,ES88209540227161223022,1256.82,2023-09-06T20:41:08,Vitoria-Gasteiz,expenses,internet,-28.07,-43562.85
buyer_6,Manuel,Rodríguez,1979-02-14,48702192Z,manuel.rodríguez@smartdev.org,107107,ES88209540227161223022,1256.82,2023-09-06T15:48:43,Vitoria-Gasteiz,expenses,food,-76.51,-43639.36
buyer_6,Manuel,Rodríguez,1979-02-14,48702192Z,manuel.rodríguez@smartdev.org,107107,ES88209540227161223022,1256.82,2023-09-06T18:03:04,Vitoria-Gasteiz,expenses,transport,-49.53,-43688.89
buyer_6,Manuel,Rodríguez,1979-02-14,48702192Z,manuel.rodríguez@smartdev.org,107107,ES88209540227161223022,1256.82,2023-09-07T13:29:33,Vitoria-Gasteiz,expenses,electricity,-51.56,-43740.45
buyer_6,Manuel,Rodríguez,1979-02-14,48702192Z,manuel.rodríguez@smartdev.org,107107,ES88209540227161223022,1256.82,2023-09-07T23:55:05,Vitoria-Gasteiz,expenses,leisure,-44.51,-43784.96
buyer_6,Manuel,Rodríguez,1979-02-14,48702192Z,manuel.rodríguez@smartdev.org,107107,ES88209540227161223022,1256.82,2023-09-08T17:06:00,Vitoria-Gasteiz,expenses,water,-21.84,-43806.8
buyer_6,Manuel,Rodríguez,1979-02-14,48702192Z,manuel.rodríguez@smartdev.org,107107,ES88209540227161223022,1256.82,2023-09-08T16:32:31,Vitoria-Gasteiz,expenses,gas,-69.19,-43875.99
buyer_6,Manuel,Rodríguez,1979-02-14,48702192Z,manuel.rodríguez@smartdev.org,107107,ES88209540227161223022,1256.82,2023-09-10T08:20:01,Vitoria-Gasteiz,expenses,leisure,-55.87,-43931.86
buyer_6,Manuel,Rodríguez,1979-02-14,48702192Z,manuel.rodríguez@smartdev.org,107107,ES88209540227161223022,1256.82,2023-09-14T11:43:25,Vitoria-Gasteiz,expenses,cash,-100.0,-44031.86
buyer_6,Manuel,Rodríguez,1979-02-14,48702192Z,manuel.rodríguez@smartdev.org,107107,ES88209540227161223022,1256.82,2023-09-16T21:57:22,Vitoria-Gasteiz,expenses,cash,-100.0,-44131.86
buyer_6,Manuel,Rodríguez,1979-02-14,48702192Z,manuel.rodríguez@smartdev.org,107107,ES88209540227161223022,1256.82,2023-09-17T08:18:31,Vitoria-Gasteiz,expenses,appliances,-309.65,-44441.51
buyer_6,Manuel,Rodríguez,1979-02-14,48702192Z,manuel.rodríguez@smartdev.org,107107,ES88209540227161223022,1256.82,2023-09-19T09:39:23,Vitoria-Gasteiz,expenses,cash,-100.0,-44541.51
buyer_6,Manuel,Rodríguez,1979-02-14,48702192Z,manuel.rodríguez@smartdev.org,107107,ES88209540227161223022,1256.82,2023-09-20T15:05:10,Vitoria-Gasteiz,expenses,repairs,-76.58,-44618.09
buyer_6,Manuel,Rodríguez,1979-02-14,48702192Z,manuel.rodríguez@smartdev.org,107107,ES88209540227161223022,1256.82,2023-09-21T20:26:01,Vitoria-Gasteiz,expenses,transport,-48.72,-44666.81
buyer_6,Manuel,Rodríguez,1979-02-14,48702192Z,manuel.rodríguez@smartdev.org,107107,ES88209540227161223022,1256.82,2023-09-23T13:43:39,Vitoria-Gasteiz,expenses,transport,-64.61,-44731.42
buyer_6,Manuel,Rodríguez,1979-02-14,48702192Z,manuel.rodríguez@smartdev.org,107107,ES88209540227161223022,1256.82,2023-09-23T19:55:04,Vitoria-Gasteiz,expenses,leisure,-37.68,-44769.1
buyer_6,Manuel,Rodríguez,1979-02-14,48702192Z,manuel.rodríguez@smartdev.org,107107,ES88209540227161223022,1256.82,2023-09-23T19:42:45,Vitoria-Gasteiz,expenses,healthcare,-64.13,-44833.23
buyer_6,Manuel,Rodríguez,1979-02-14,48702192Z,manuel.rodríguez@smartdev.org,107107,ES88209540227161223022,1256.82,2023-09-25T00:23:59,Vitoria-Gasteiz,expenses,cash,-100.0,-44933.23
buyer_6,Manuel,Rodríguez,1979-02-14,48702192Z,manuel.rodríguez@smartdev.org,107107,ES88209540227161223022,1256.82,2023-09-25T22:36:40,Vitoria-Gasteiz,expenses,repairs,-281.53,-45214.76
buyer_6,Manuel,Rodríguez,1979-02-14,48702192Z,manuel.rodríguez@smartdev.org,107107,ES88209540227161223022,1256.82,2023-09-28T12:12:37,Vitoria-Gasteiz,expenses,transport,-64.18,-45278.94
buyer_6,Manuel,Rodríguez,1979-02-14,48702192Z,manuel.rodríguez@smartdev.org,107107,ES88209540227161223022,1256.82,2023-09-29T11:10:31,Vitoria-Gasteiz,expenses,cash,-100.0,-45378.94
buyer_6,Manuel,Rodríguez,1979-02-14,48702192Z,manuel.rodríguez@smartdev.org,107107,ES88209540227161223022,1256.82,2023-10-01T14:32:32,Vitoria-Gasteiz,incomes,salary,1336.9,-44042.04
buyer_6,Manuel,Rodríguez,1979-02-14,48702192Z,manuel.rodríguez@smartdev.org,107107,ES88209540227161223022,1256.82,2023-10-01T09:50:53,Vitoria-Gasteiz,expenses,food,-113.02,-44155.06
buyer_6,Manuel,Rodríguez,1979-02-14,48702192Z,manuel.rodríguez@smartdev.org,107107,ES88209540227161223022,1256.82,2023-10-02T19:54:45,Vitoria-Gasteiz,expenses,repairs,-153.39,-44308.45
buyer_6,Manuel,Rodríguez,1979-02-14,48702192Z,manuel.rodríguez@smartdev.org,107107,ES88209540227161223022,1256.82,2023-10-03T21:04:12,Vitoria-Gasteiz,expenses,food,-105.19,-44413.64
buyer_6,Manuel,Rodríguez,1979-02-14,48702192Z,manuel.rodríguez@smartdev.org,107107,ES88209540227161223022,1256.82,2023-10-03T11:32:04,Vitoria-Gasteiz,expenses,leisure,-28.78,-44442.42
buyer_6,Manuel,Rodríguez,1979-02-14,48702192Z,manuel.rodríguez@smartdev.org,107107,ES88209540227161223022,1256.82,2023-10-03T17:01:53,Vitoria-Gasteiz,expenses,gifts,-214.34,-44656.76
buyer_6,Manuel,Rodríguez,1979-02-14,48702192Z,manuel.rodríguez@smartdev.org,107107,ES88209540227161223022,1256.82,2023-10-04T11:10:33,Vitoria-Gasteiz,expenses,mortgage,-555.29,-45212.05
buyer_6,Manuel,Rodríguez,1979-02-14,48702192Z,manuel.rodríguez@smartdev.org,107107,ES88209540227161223022,1256.82,2023-10-04T14:22:25,Vitoria-Gasteiz,expenses,leisure,-80.95,-45293.0
buyer_6,Manuel,Rodríguez,1979-02-14,48702192Z,manuel.rodríguez@smartdev.org,107107,ES88209540227161223022,1256.82,2023-10-05T14:50:42,Vitoria-Gasteiz,expenses,water,-20.33,-45313.33
buyer_6,Manuel,Rodríguez,1979-02-14,48702192Z,manuel.rodríguez@smartdev.org,107107,ES88209540227161223022,1256.82,2023-10-05T21:34:48,Vitoria-Gasteiz,expenses,repairs,-230.3,-45543.63
buyer_6,Manuel,Rodríguez,1979-02-14,48702192Z,manuel.rodríguez@smartdev.org,107107,ES88209540227161223022,1256.82,2023-10-06T02:53:39,Vitoria-Gasteiz,expenses,transport,-70.92,-45614.55
buyer_6,Manuel,Rodríguez,1979-02-14,48702192Z,manuel.rodríguez@smartdev.org,107107,ES88209540227161223022,1256.82,2023-10-06T17:44:31,Vitoria-Gasteiz,expenses,cash,-100.0,-45714.55
buyer_6,Manuel,Rodríguez,1979-02-14,48702192Z,manuel.rodríguez@smartdev.org,107107,ES88209540227161223022,1256.82,2023-10-07T15:50:03,Vitoria-Gasteiz,expenses,gas,-38.62,-45753.17
buyer_6,Manuel,Rodríguez,1979-02-14,48702192Z,manuel.rodríguez@smartdev.org,107107,ES88209540227161223022,1256.82,2023-10-08T21:57:24,Vitoria-Gasteiz,expenses,electricity,-35.42,-45788.59
buyer_6,Manuel,Rodríguez,1979-02-14,48702192Z,manuel.rodríguez@smartdev.org,107107,ES88209540227161223022,1256.82,2023-10-08T09:03:12,Vitoria-Gasteiz,expenses,internet,-28.07,-45816.66
buyer_6,Manuel,Rodríguez,1979-02-14,48702192Z,manuel.rodríguez@smartdev.org,107107,ES88209540227161223022,1256.82,2023-10-08T13:39:10,Vitoria-Gasteiz,expenses,phone,-26.77,-45843.43
buyer_6,Manuel,Rodríguez,1979-02-14,48702192Z,manuel.rodríguez@smartdev.org,107107,ES88209540227161223022,1256.82,2023-10-08T11:36:23,Vitoria-Gasteiz,expenses,transport,-41.96,-45885.39
buyer_6,Manuel,Rodríguez,1979-02-14,48702192Z,manuel.rodríguez@smartdev.org,107107,ES88209540227161223022,1256.82,2023-10-08T09:26:57,Vitoria-Gasteiz,expenses,cash,-100.0,-45985.39
buyer_6,Manuel,Rodríguez,1979-02-14,48702192Z,manuel.rodríguez@smartdev.org,107107,ES88209540227161223022,1256.82,2023-10-09T10:56:47,Vitoria-Gasteiz,expenses,repairs,-253.21,-46238.6
buyer_6,Manuel,Rodríguez,1979-02-14,48702192Z,manuel.rodríguez@smartdev.org,107107,ES88209540227161223022,1256.82,2023-10-10T13:56:44,Vitoria-Gasteiz,expenses,cash,-100.0,-46338.6
buyer_6,Manuel,Rodríguez,1979-02-14,48702192Z,manuel.rodríguez@smartdev.org,107107,ES88209540227161223022,1256.82,2023-10-12T12:35:26,Vitoria-Gasteiz,expenses,food,-123.98,-46462.58
buyer_6,Manuel,Rodríguez,1979-02-14,48702192Z,manuel.rodríguez@smartdev.org,107107,ES88209540227161223022,1256.82,2023-10-14T20:43:29,Vitoria-Gasteiz,expenses,food,-76.04,-46538.62
buyer_6,Manuel,Rodríguez,1979-02-14,48702192Z,manuel.rodríguez@smartdev.org,107107,ES88209540227161223022,1256.82,2023-10-14T11:58:01,Vitoria-Gasteiz,expenses,transport,-84.4,-46623.02
buyer_6,Manuel,Rodríguez,1979-02-14,48702192Z,manuel.rodríguez@smartdev.org,107107,ES88209540227161223022,1256.82,2023-10-16T19:27:18,Vitoria-Gasteiz,expenses,appliances,-419.26,-47042.28
buyer_6,Manuel,Rodríguez,1979-02-14,48702192Z,manuel.rodríguez@smartdev.org,107107,ES88209540227161223022,1256.82,2023-10-18T10:58:05,Vitoria-Gasteiz,expenses,cash,-100.0,-47142.28
buyer_6,Manuel,Rodríguez,1979-02-14,48702192Z,manuel.rodríguez@smartdev.org,107107,ES88209540227161223022,1256.82,2023-10-20T13:46:07,Vitoria-Gasteiz,expenses,leisure,-41.38,-47183.66
buyer_6,Manuel,Rodríguez,1979-02-14,48702192Z,manuel.rodríguez@smartdev.org,107107,ES88209540227161223022,1256.82,2023-10-21T18:56:36,Vitoria-Gasteiz,expenses,transport,-58.6,-47242.26
buyer_6,Manuel,Rodríguez,1979-02-14,48702192Z,manuel.rodríguez@smartdev.org,107107,ES88209540227161223022,1256.82,2023-10-26T23:41:34,Vitoria-Gasteiz,expenses,food,-74.79,-47317.05
buyer_6,Manuel,Rodríguez,1979-02-14,48702192Z,manuel.rodríguez@smartdev.org,107107,ES88209540227161223022,1256.82,2023-10-26T08:45:14,Vitoria-Gasteiz,expenses,travel,-716.76,-48033.81
buyer_6,Manuel,Rodríguez,1979-02-14,48702192Z,manuel.rodríguez@smartdev.org,107107,ES88209540227161223022,1256.82,2023-10-27T22:49:54,Vitoria-Gasteiz,expenses,cash,-100.0,-48133.81
buyer_6,Manuel,Rodríguez,1979-02-14,48702192Z,manuel.rodríguez@smartdev.org,107107,ES88209540227161223022,1256.82,2023-10-27T09:34:33,Vitoria-Gasteiz,expenses,appliances,-342.15,-48475.96
buyer_6,Manuel,Rodríguez,1979-02-14,48702192Z,manuel.rodríguez@smartdev.org,107107,ES88209540227161223022,1256.82,2023-10-28T22:42:19,Vitoria-Gasteiz,expenses,repairs,-292.41,-48768.37
buyer_6,Manuel,Rodríguez,1979-02-14,48702192Z,manuel.rodríguez@smartdev.org,107107,ES88209540227161223022,1256.82,2023-10-29T17:49:07,Vitoria-Gasteiz,expenses,food,-82.19,-48850.56
buyer_6,Manuel,Rodríguez,1979-02-14,48702192Z,manuel.rodríguez@smartdev.org,107107,ES88209540227161223022,1256.82,2023-10-30T15:32:52,Vitoria-Gasteiz,expenses,leisure,-31.55,-48882.11
buyer_6,Manuel,Rodríguez,1979-02-14,48702192Z,manuel.rodríguez@smartdev.org,107107,ES88209540227161223022,1256.82,2023-10-31T16:02:58,Vitoria-Gasteiz,expenses,food,-72.13,-48954.24
buyer_6,Manuel,Rodríguez,1979-02-14,48702192Z,manuel.rodríguez@smartdev.org,107107,ES88209540227161223022,1256.82,2023-10-31T14:39:29,Vitoria-Gasteiz,expenses,transport,-79.06,-49033.3
buyer_6,Manuel,Rodríguez,1979-02-14,48702192Z,manuel.rodríguez@smartdev.org,107107,ES88209540227161223022,1256.82,2023-11-01T17:46:08,Vitoria-Gasteiz,incomes,salary,1336.9,-47696.4
buyer_6,Manuel,Rodríguez,1979-02-14,48702192Z,manuel.rodríguez@smartdev.org,107107,ES88209540227161223022,1256.82,2023-11-01T17:46:08,Vitoria-Gasteiz,incomes,extra_income,181.04,-47515.36
buyer_6,Manuel,Rodríguez,1979-02-14,48702192Z,manuel.rodríguez@smartdev.org,107107,ES88209540227161223022,1256.82,2023-11-02T00:08:43,Vitoria-Gasteiz,expenses,food,-102.04,-47617.4
buyer_6,Manuel,Rodríguez,1979-02-14,48702192Z,manuel.rodríguez@smartdev.org,107107,ES88209540227161223022,1256.82,2023-11-03T05:10:58,Vitoria-Gasteiz,expenses,transport,-57.7,-47675.1
buyer_6,Manuel,Rodríguez,1979-02-14,48702192Z,manuel.rodríguez@smartdev.org,107107,ES88209540227161223022,1256.82,2023-11-03T09:01:07,Vitoria-Gasteiz,expenses,healthcare,-71.4,-47746.5
buyer_6,Manuel,Rodríguez,1979-02-14,48702192Z,manuel.rodríguez@smartdev.org,107107,ES88209540227161223022,1256.82,2023-11-03T09:46:02,Vitoria-Gasteiz,expenses,cash,-100.0,-47846.5
buyer_6,Manuel,Rodríguez,1979-02-14,48702192Z,manuel.rodríguez@smartdev.org,107107,ES88209540227161223022,1256.82,2023-11-04T06:39:28,Vitoria-Gasteiz,expenses,mortgage,-555.29,-48401.79
buyer_6,Manuel,Rodríguez,1979-02-14,48702192Z,manuel.rodríguez@smartdev.org,107107,ES88209540227161223022,1256.82,2023-11-04T17:32:56,Vitoria-Gasteiz,expenses,appliances,-118.3,-48520.09
buyer_6,Manuel,Rodríguez,1979-02-14,48702192Z,manuel.rodríguez@smartdev.org,107107,ES88209540227161223022,1256.82,2023-11-06T03:46:49,Vitoria-Gasteiz,expenses,water,-13.93,-48534.02
buyer_6,Manuel,Rodríguez,1979-02-14,48702192Z,manuel.rodríguez@smartdev.org,107107,ES88209540227161223022,1256.82,2023-11-06T13:50:38,Vitoria-Gasteiz,expenses,travel,-317.76,-48851.78
buyer_6,Manuel,Rodríguez,1979-02-14,48702192Z,manuel.rodríguez@smartdev.org,107107,ES88209540227161223022,1256.82,2023-11-07T16:28:18,Vitoria-Gasteiz,expenses,electricity,-17.6,-48869.38
buyer_6,Manuel,Rodríguez,1979-02-14,48702192Z,manuel.rodríguez@smartdev.org,107107,ES88209540227161223022,1256.82,2023-11-07T19:15:35,Vitoria-Gasteiz,expenses,gas,-32.63,-48902.01
buyer_6,Manuel,Rodríguez,1979-02-14,48702192Z,manuel.rodríguez@smartdev.org,107107,ES88209540227161223022,1256.82,2023-11-08T21:14:57,Vitoria-Gasteiz,expenses,internet,-28.07,-48930.08
buyer_6,Manuel,Rodríguez,1979-02-14,48702192Z,manuel.rodríguez@smartdev.org,107107,ES88209540227161223022,1256.82,2023-11-08T19:45:54,Vitoria-Gasteiz,expenses,phone,-29.11,-48959.19
buyer_6,Manuel,Rodríguez,1979-02-14,48702192Z,manuel.rodríguez@smartdev.org,107107,ES88209540227161223022,1256.82,2023-11-11T17:56:46,Vitoria-Gasteiz,expenses,cash,-100.0,-49059.19
buyer_6,Manuel,Rodríguez,1979-02-14,48702192Z,manuel.rodríguez@smartdev.org,107107,ES88209540227161223022,1256.82,2023-11-12T10:51:23,Vitoria-Gasteiz,expenses,repairs,-120.9,-49180.09
buyer_6,Manuel,Rodríguez,1979-02-14,48702192Z,manuel.rodríguez@smartdev.org,107107,ES88209540227161223022,1256.82,2023-11-14T16:34:09,Vitoria-Gasteiz,expenses,cash,-100.0,-49280.09
buyer_6,Manuel,Rodríguez,1979-02-14,48702192Z,manuel.rodríguez@smartdev.org,107107,ES88209540227161223022,1256.82,2023-11-14T09:22:23,Vitoria-Gasteiz,expenses,repairs,-146.28,-49426.37
buyer_6,Manuel,Rodríguez,1979-02-14,48702192Z,manuel.rodríguez@smartdev.org,107107,ES88209540227161223022,1256.82,2023-11-15T12:56:40,Vitoria-Gasteiz,expenses,transport,-50.84,-49477.21
buyer_6,Manuel,Rodríguez,1979-02-14,48702192Z,manuel.rodríguez@smartdev.org,107107,ES88209540227161223022,1256.82,2023-11-16T09:09:52,Vitoria-Gasteiz,expenses,transport,-73.08,-49550.29
buyer_6,Manuel,Rodríguez,1979-02-14,48702192Z,manuel.rodríguez@smartdev.org,107107,ES88209540227161223022,1256.82,2023-11-16T09:28:43,Vitoria-Gasteiz,expenses,travel,-654.49,-50204.78
buyer_6,Manuel,Rodríguez,1979-02-14,48702192Z,manuel.rodríguez@smartdev.org,107107,ES88209540227161223022,1256.82,2023-11-17T02:10:40,Vitoria-Gasteiz,expenses,food,-81.51,-50286.29
buyer_6,Manuel,Rodríguez,1979-02-14,48702192Z,manuel.rodríguez@smartdev.org,107107,ES88209540227161223022,1256.82,2023-11-17T16:04:02,Vitoria-Gasteiz,expenses,clothing,-83.97,-50370.26
buyer_6,Manuel,Rodríguez,1979-02-14,48702192Z,manuel.rodríguez@smartdev.org,107107,ES88209540227161223022,1256.82,2023-11-17T19:02:45,Vitoria-Gasteiz,expenses,healthcare,-149.52,-50519.78
buyer_6,Manuel,Rodríguez,1979-02-14,48702192Z,manuel.rodríguez@smartdev.org,107107,ES88209540227161223022,1256.82,2023-11-17T13:19:05,Vitoria-Gasteiz,expenses,cash,-100.0,-50619.78
buyer_6,Manuel,Rodríguez,1979-02-14,48702192Z,manuel.rodríguez@smartdev.org,107107,ES88209540227161223022,1256.82,2023-11-21T23:33:26,Vitoria-Gasteiz,expenses,cash,-100.0,-50719.78
buyer_6,Manuel,Rodríguez,1979-02-14,48702192Z,manuel.rodríguez@smartdev.org,107107,ES88209540227161223022,1256.82,2023-11-23T10:21:25,Vitoria-Gasteiz,expenses,food,-117.12,-50836.9
buyer_6,Manuel,Rodríguez,1979-02-14,48702192Z,manuel.rodríguez@smartdev.org,107107,ES88209540227161223022,1256.82,2023-11-23T20:35:15,Vitoria-Gasteiz,expenses,transport,-41.47,-50878.37
buyer_6,Manuel,Rodríguez,1979-02-14,48702192Z,manuel.rodríguez@smartdev.org,107107,ES88209540227161223022,1256.82,2023-11-23T08:04:28,Vitoria-Gasteiz,expenses,repairs,-98.96,-50977.33
buyer_6,Manuel,Rodríguez,1979-02-14,48702192Z,manuel.rodríguez@smartdev.org,107107,ES88209540227161223022,1256.82,2023-11-27T20:19:46,Vitoria-Gasteiz,expenses,clothing,-91.39,-51068.72
buyer_6,Manuel,Rodríguez,1979-02-14,48702192Z,manuel.rodríguez@smartdev.org,107107,ES88209540227161223022,1256.82,2023-11-28T08:41:50,Vitoria-Gasteiz,expenses,leisure,-47.82,-51116.54
buyer_6,Manuel,Rodríguez,1979-02-14,48702192Z,manuel.rodríguez@smartdev.org,107107,ES88209540227161223022,1256.82,2023-11-29T08:21:58,Vitoria-Gasteiz,expenses,gifts,-324.83,-51441.37
buyer_6,Manuel,Rodríguez,1979-02-14,48702192Z,manuel.rodríguez@smartdev.org,107107,ES88209540227161223022,1256.82,2023-11-30T20:28:20,Vitoria-Gasteiz,expenses,cash,-100.0,-51541.37
buyer_6,Manuel,Rodríguez,1979-02-14,48702192Z,manuel.rodríguez@smartdev.org,107107,ES88209540227161223022,1256.82,2023-11-30T18:27:53,Vitoria-Gasteiz,expenses,repairs,-234.43,-51775.8
buyer_6,Manuel,Rodríguez,1979-02-14,48702192Z,manuel.rodríguez@smartdev.org,107107,ES88209540227161223022,1256.82,2023-12-01T11:07:00,Vitoria-Gasteiz,incomes,salary,1336.9,-50438.9
buyer_6,Manuel,Rodríguez,1979-02-14,48702192Z,manuel.rodríguez@smartdev.org,107107,ES88209540227161223022,1256.82,2023-12-01T11:07:00,Vitoria-Gasteiz,incomes,salary_bonus,1014.57,-49424.33
buyer_6,Manuel,Rodríguez,1979-02-14,48702192Z,manuel.rodríguez@smartdev.org,107107,ES88209540227161223022,1256.82,2023-12-01T05:36:53,Vitoria-Gasteiz,expenses,leisure,-80.34,-49504.67
buyer_6,Manuel,Rodríguez,1979-02-14,48702192Z,manuel.rodríguez@smartdev.org,107107,ES88209540227161223022,1256.82,2023-12-01T20:23:52,Vitoria-Gasteiz,expenses,cash,-100.0,-49604.67
buyer_6,Manuel,Rodríguez,1979-02-14,48702192Z,manuel.rodríguez@smartdev.org,107107,ES88209540227161223022,1256.82,2023-12-04T14:06:10,Vitoria-Gasteiz,expenses,mortgage,-555.29,-50159.96
buyer_6,Manuel,Rodríguez,1979-02-14,48702192Z,manuel.rodríguez@smartdev.org,107107,ES88209540227161223022,1256.82,2023-12-05T09:15:51,Vitoria-Gasteiz,expenses,electricity,-14.68,-50174.64
buyer_6,Manuel,Rodríguez,1979-02-14,48702192Z,manuel.rodríguez@smartdev.org,107107,ES88209540227161223022,1256.82,2023-12-05T13:56:15,Vitoria-Gasteiz,expenses,internet,-28.07,-50202.71
buyer_6,Manuel,Rodríguez,1979-02-14,48702192Z,manuel.rodríguez@smartdev.org,107107,ES88209540227161223022,1256.82,2023-12-06T16:47:29,Vitoria-Gasteiz,expenses,gas,-30.76,-50233.47
buyer_6,Manuel,Rodríguez,1979-02-14,48702192Z,manuel.rodríguez@smartdev.org,107107,ES88209540227161223022,1256.82,2023-12-06T08:40:27,Vitoria-Gasteiz,expenses,cash,-100.0,-50333.47
buyer_6,Manuel,Rodríguez,1979-02-14,48702192Z,manuel.rodríguez@smartdev.org,107107,ES88209540227161223022,1256.82,2023-12-08T22:25:20,Vitoria-Gasteiz,expenses,water,-19.73,-50353.2
buyer_6,Manuel,Rodríguez,1979-02-14,48702192Z,manuel.rodríguez@smartdev.org,107107,ES88209540227161223022,1256.82,2023-12-08T10:00:02,Vitoria-Gasteiz,expenses,phone,-27.93,-50381.13
buyer_6,Manuel,Rodríguez,1979-02-14,48702192Z,manuel.rodríguez@smartdev.org,107107,ES88209540227161223022,1256.82,2023-12-08T12:56:38,Vitoria-Gasteiz,expenses,appliances,-189.23,-50570.36
buyer_6,Manuel,Rodríguez,1979-02-14,48702192Z,manuel.rodríguez@smartdev.org,107107,ES88209540227161223022,1256.82,2023-12-09T09:57:18,Vitoria-Gasteiz,expenses,gifts,-422.28,-50992.64
buyer_6,Manuel,Rodríguez,1979-02-14,48702192Z,manuel.rodríguez@smartdev.org,107107,ES88209540227161223022,1256.82,2023-12-10T08:31:52,Vitoria-Gasteiz,expenses,food,-92.67,-51085.31
buyer_6,Manuel,Rodríguez,1979-02-14,48702192Z,manuel.rodríguez@smartdev.org,107107,ES88209540227161223022,1256.82,2023-12-10T14:26:33,Vitoria-Gasteiz,expenses,transport,-87.29,-51172.6
buyer_6,Manuel,Rodríguez,1979-02-14,48702192Z,manuel.rodríguez@smartdev.org,107107,ES88209540227161223022,1256.82,2023-12-10T12:16:29,Vitoria-Gasteiz,expenses,cash,-100.0,-51272.6
buyer_6,Manuel,Rodríguez,1979-02-14,48702192Z,manuel.rodríguez@smartdev.org,107107,ES88209540227161223022,1256.82,2023-12-11T16:50:35,Vitoria-Gasteiz,expenses,leisure,-70.98,-51343.58
buyer_6,Manuel,Rodríguez,1979-02-14,48702192Z,manuel.rodríguez@smartdev.org,107107,ES88209540227161223022,1256.82,2023-12-11T14:44:21,Vitoria-Gasteiz,expenses,travel,-411.97,-51755.55
buyer_6,Manuel,Rodríguez,1979-02-14,48702192Z,manuel.rodríguez@smartdev.org,107107,ES88209540227161223022,1256.82,2023-12-11T10:58:38,Vitoria-Gasteiz,expenses,gifts,-190.89,-51946.44
buyer_6,Manuel,Rodríguez,1979-02-14,48702192Z,manuel.rodríguez@smartdev.org,107107,ES88209540227161223022,1256.82,2023-12-12T21:18:44,Vitoria-Gasteiz,expenses,food,-123.83,-52070.27
buyer_6,Manuel,Rodríguez,1979-02-14,48702192Z,manuel.rodríguez@smartdev.org,107107,ES88209540227161223022,1256.82,2023-12-16T20:41:30,Vitoria-Gasteiz,expenses,transport,-55.77,-52126.04
buyer_6,Manuel,Rodríguez,1979-02-14,48702192Z,manuel.rodríguez@smartdev.org,107107,ES88209540227161223022,1256.82,2023-12-16T13:13:48,Vitoria-Gasteiz,expenses,cash,-100.0,-52226.04
buyer_6,Manuel,Rodríguez,1979-02-14,48702192Z,manuel.rodríguez@smartdev.org,107107,ES88209540227161223022,1256.82,2023-12-17T13:43:58,Vitoria-Gasteiz,expenses,leisure,-47.68,-52273.72
buyer_6,Manuel,Rodríguez,1979-02-14,48702192Z,manuel.rodríguez@smartdev.org,107107,ES88209540227161223022,1256.82,2023-12-22T19:42:48,Vitoria-Gasteiz,expenses,food,-66.34,-52340.06
buyer_6,Manuel,Rodríguez,1979-02-14,48702192Z,manuel.rodríguez@smartdev.org,107107,ES88209540227161223022,1256.82,2023-12-22T17:25:13,Vitoria-Gasteiz,expenses,gifts,-448.82,-52788.88
buyer_6,Manuel,Rodríguez,1979-02-14,48702192Z,manuel.rodríguez@smartdev.org,107107,ES88209540227161223022,1256.82,2023-12-23T10:11:55,Vitoria-Gasteiz,expenses,gifts,-161.12,-52950.0
buyer_6,Manuel,Rodríguez,1979-02-14,48702192Z,manuel.rodríguez@smartdev.org,107107,ES88209540227161223022,1256.82,2023-12-27T15:50:28,Vitoria-Gasteiz,expenses,cash,-100.0,-53050.0
buyer_6,Manuel,Rodríguez,1979-02-14,48702192Z,manuel.rodríguez@smartdev.org,107107,ES88209540227161223022,1256.82,2023-12-28T08:05:38,Vitoria-Gasteiz,expenses,clothing,-97.84,-53147.84
buyer_6,Manuel,Rodríguez,1979-02-14,48702192Z,manuel.rodríguez@smartdev.org,107107,ES88209540227161223022,1256.82,2023-12-29T11:33:03,Vitoria-Gasteiz,expenses,cash,-100.0,-53247.84
buyer_6,Manuel,Rodríguez,1979-02-14,48702192Z,manuel.rodríguez@smartdev.org,107107,ES88209540227161223022,1256.82,2023-12-30T22:26:57,Vitoria-Gasteiz,expenses,clothing,-103.23,-53351.07
buyer_6,Manuel,Rodríguez,1979-02-14,48702192Z,manuel.rodríguez@smartdev.org,107107,ES88209540227161223022,1256.82,2023-12-30T04:52:05,Vitoria-Gasteiz,expenses,repairs,-150.68,-53501.75
buyer_6,Manuel,Rodríguez,1979-02-14,48702192Z,manuel.rodríguez@smartdev.org,107107,ES88209540227161223022,1256.82,2023-12-31T11:31:51,Vitoria-Gasteiz,expenses,food,-108.61,-53610.36
buyer_6,Manuel,Rodríguez,1979-02-14,48702192Z,manuel.rodríguez@smartdev.org,107107,ES88209540227161223022,1256.82,2023-12-31T13:39:42,Vitoria-Gasteiz,expenses,leisure,-32.93,-53643.29
buyer_6,Manuel,Rodríguez,1979-02-14,48702192Z,manuel.rodríguez@smartdev.org,107107,ES88209540227161223022,1256.82,2024-01-01T05:54:20,Vitoria-Gasteiz,incomes,salary,1385.98,-52257.31
buyer_6,Manuel,Rodríguez,1979-02-14,48702192Z,manuel.rodríguez@smartdev.org,107107,ES88209540227161223022,1256.82,2024-01-03T13:38:07,Vitoria-Gasteiz,expenses,food,-100.54,-52357.85
buyer_6,Manuel,Rodríguez,1979-02-14,48702192Z,manuel.rodríguez@smartdev.org,107107,ES88209540227161223022,1256.82,2024-01-04T09:53:25,Vitoria-Gasteiz,expenses,mortgage,-526.62,-52884.47
buyer_6,Manuel,Rodríguez,1979-02-14,48702192Z,manuel.rodríguez@smartdev.org,107107,ES88209540227161223022,1256.82,2024-01-04T10:47:39,Vitoria-Gasteiz,expenses,leisure,-26.24,-52910.71
buyer_6,Manuel,Rodríguez,1979-02-14,48702192Z,manuel.rodríguez@smartdev.org,107107,ES88209540227161223022,1256.82,2024-01-04T18:47:37,Vitoria-Gasteiz,expenses,cash,-100.0,-53010.71
buyer_6,Manuel,Rodríguez,1979-02-14,48702192Z,manuel.rodríguez@smartdev.org,107107,ES88209540227161223022,1256.82,2024-01-05T16:56:25,Vitoria-Gasteiz,expenses,water,-25.39,-53036.1
buyer_6,Manuel,Rodríguez,1979-02-14,48702192Z,manuel.rodríguez@smartdev.org,107107,ES88209540227161223022,1256.82,2024-01-05T13:24:53,Vitoria-Gasteiz,expenses,gas,-37.09,-53073.19
buyer_6,Manuel,Rodríguez,1979-02-14,48702192Z,manuel.rodríguez@smartdev.org,107107,ES88209540227161223022,1256.82,2024-01-06T05:13:30,Vitoria-Gasteiz,expenses,internet,-29.11,-53102.3
buyer_6,Manuel,Rodríguez,1979-02-14,48702192Z,manuel.rodríguez@smartdev.org,107107,ES88209540227161223022,1256.82,2024-01-06T09:48:27,Vitoria-Gasteiz,expenses,leisure,-49.9,-53152.2
buyer_6,Manuel,Rodríguez,1979-02-14,48702192Z,manuel.rodríguez@smartdev.org,107107,ES88209540227161223022,1256.82,2024-01-06T05:31:13,Vitoria-Gasteiz,expenses,cash,-100.0,-53252.2
buyer_6,Manuel,Rodríguez,1979-02-14,48702192Z,manuel.rodríguez@smartdev.org,107107,ES88209540227161223022,1256.82,2024-01-07T10:24:53,Vitoria-Gasteiz,expenses,phone,-22.56,-53274.76
buyer_6,Manuel,Rodríguez,1979-02-14,48702192Z,manuel.rodríguez@smartdev.org,107107,ES88209540227161223022,1256.82,2024-01-07T16:53:10,Vitoria-Gasteiz,expenses,food,-93.9,-53368.66
buyer_6,Manuel,Rodríguez,1979-02-14,48702192Z,manuel.rodríguez@smartdev.org,107107,ES88209540227161223022,1256.82,2024-01-07T17:47:43,Vitoria-Gasteiz,expenses,leisure,-60.58,-53429.24
buyer_6,Manuel,Rodríguez,1979-02-14,48702192Z,manuel.rodríguez@smartdev.org,107107,ES88209540227161223022,1256.82,2024-01-08T08:50:36,Vitoria-Gasteiz,expenses,electricity,-30.46,-53459.7
buyer_6,Manuel,Rodríguez,1979-02-14,48702192Z,manuel.rodríguez@smartdev.org,107107,ES88209540227161223022,1256.82,2024-01-08T23:12:15,Vitoria-Gasteiz,expenses,cash,-100.0,-53559.7
buyer_6,Manuel,Rodríguez,1979-02-14,48702192Z,manuel.rodríguez@smartdev.org,107107,ES88209540227161223022,1256.82,2024-01-09T20:07:24,Vitoria-Gasteiz,expenses,food,-76.6,-53636.3
buyer_6,Manuel,Rodríguez,1979-02-14,48702192Z,manuel.rodríguez@smartdev.org,107107,ES88209540227161223022,1256.82,2024-01-11T15:36:37,Vitoria-Gasteiz,expenses,leisure,-49.76,-53686.06
buyer_6,Manuel,Rodríguez,1979-02-14,48702192Z,manuel.rodríguez@smartdev.org,107107,ES88209540227161223022,1256.82,2024-01-12T06:09:36,Vitoria-Gasteiz,expenses,clothing,-69.4,-53755.46
buyer_6,Manuel,Rodríguez,1979-02-14,48702192Z,manuel.rodríguez@smartdev.org,107107,ES88209540227161223022,1256.82,2024-01-13T21:01:56,Vitoria-Gasteiz,expenses,leisure,-51.94,-53807.4
buyer_6,Manuel,Rodríguez,1979-02-14,48702192Z,manuel.rodríguez@smartdev.org,107107,ES88209540227161223022,1256.82,2024-01-14T14:03:58,Vitoria-Gasteiz,expenses,food,-108.52,-53915.92
buyer_6,Manuel,Rodríguez,1979-02-14,48702192Z,manuel.rodríguez@smartdev.org,107107,ES88209540227161223022,1256.82,2024-01-15T17:35:24,Vitoria-Gasteiz,expenses,food,-68.23,-53984.15
buyer_6,Manuel,Rodríguez,1979-02-14,48702192Z,manuel.rodríguez@smartdev.org,107107,ES88209540227161223022,1256.82,2024-01-16T05:55:04,Vitoria-Gasteiz,expenses,leisure,-36.36,-54020.51
buyer_6,Manuel,Rodríguez,1979-02-14,48702192Z,manuel.rodríguez@smartdev.org,107107,ES88209540227161223022,1256.82,2024-01-16T20:24:04,Vitoria-Gasteiz,expenses,education,-67.97,-54088.48
buyer_6,Manuel,Rodríguez,1979-02-14,48702192Z,manuel.rodríguez@smartdev.org,107107,ES88209540227161223022,1256.82,2024-01-16T19:49:23,Vitoria-Gasteiz,expenses,gifts,-690.88,-54779.36
buyer_6,Manuel,Rodríguez,1979-02-14,48702192Z,manuel.rodríguez@smartdev.org,107107,ES88209540227161223022,1256.82,2024-01-17T15:44:07,Vitoria-Gasteiz,expenses,leisure,-38.69,-54818.05
buyer_6,Manuel,Rodríguez,1979-02-14,48702192Z,manuel.rodríguez@smartdev.org,107107,ES88209540227161223022,1256.82,2024-01-17T17:57:23,Vitoria-Gasteiz,expenses,education,-49.3,-54867.35
buyer_6,Manuel,Rodríguez,1979-02-14,48702192Z,manuel.rodríguez@smartdev.org,107107,ES88209540227161223022,1256.82,2024-01-18T21:13:28,Vitoria-Gasteiz,expenses,transport,-43.47,-54910.82
buyer_6,Manuel,Rodríguez,1979-02-14,48702192Z,manuel.rodríguez@smartdev.org,107107,ES88209540227161223022,1256.82,2024-01-19T09:41:32,Vitoria-Gasteiz,expenses,food,-60.04,-54970.86
buyer_6,Manuel,Rodríguez,1979-02-14,48702192Z,manuel.rodríguez@smartdev.org,107107,ES88209540227161223022,1256.82,2024-01-22T18:05:01,Vitoria-Gasteiz,expenses,food,-70.03,-55040.89
buyer_6,Manuel,Rodríguez,1979-02-14,48702192Z,manuel.rodríguez@smartdev.org,107107,ES88209540227161223022,1256.82,2024-01-22T17:42:07,Vitoria-Gasteiz,expenses,transport,-83.64,-55124.53
buyer_6,Manuel,Rodríguez,1979-02-14,48702192Z,manuel.rodríguez@smartdev.org,107107,ES88209540227161223022,1256.82,2024-01-22T20:46:09,Vitoria-Gasteiz,expenses,repairs,-171.0,-55295.53
buyer_6,Manuel,Rodríguez,1979-02-14,48702192Z,manuel.rodríguez@smartdev.org,107107,ES88209540227161223022,1256.82,2024-01-23T09:04:04,Vitoria-Gasteiz,expenses,leisure,-52.11,-55347.64
buyer_6,Manuel,Rodríguez,1979-02-14,48702192Z,manuel.rodríguez@smartdev.org,107107,ES88209540227161223022,1256.82,2024-01-24T17:38:05,Vitoria-Gasteiz,expenses,repairs,-178.28,-55525.92
buyer_6,Manuel,Rodríguez,1979-02-14,48702192Z,manuel.rodríguez@smartdev.org,107107,ES88209540227161223022,1256.82,2024-01-25T15:52:26,Vitoria-Gasteiz,expenses,clothing,-154.44,-55680.36
buyer_6,Manuel,Rodríguez,1979-02-14,48702192Z,manuel.rodríguez@smartdev.org,107107,ES88209540227161223022,1256.82,2024-01-26T13:01:28,Vitoria-Gasteiz,expenses,food,-111.53,-55791.89
buyer_6,Manuel,Rodríguez,1979-02-14,48702192Z,manuel.rodríguez@smartdev.org,107107,ES88209540227161223022,1256.82,2024-01-27T07:48:24,Vitoria-Gasteiz,expenses,clothing,-145.87,-55937.76
buyer_6,Manuel,Rodríguez,1979-02-14,48702192Z,manuel.rodríguez@smartdev.org,107107,ES88209540227161223022,1256.82,2024-01-28T08:04:05,Vitoria-Gasteiz,expenses,education,-70.53,-56008.29
buyer_6,Manuel,Rodríguez,1979-02-14,48702192Z,manuel.rodríguez@smartdev.org,107107,ES88209540227161223022,1256.82,2024-01-29T11:31:55,Vitoria-Gasteiz,expenses,food,-82.09,-56090.38
buyer_6,Manuel,Rodríguez,1979-02-14,48702192Z,manuel.rodríguez@smartdev.org,107107,ES88209540227161223022,1256.82,2024-01-29T14:56:13,Vitoria-Gasteiz,expenses,education,-61.1,-56151.48
buyer_6,Manuel,Rodríguez,1979-02-14,48702192Z,manuel.rodríguez@smartdev.org,107107,ES88209540227161223022,1256.82,2024-01-29T13:55:45,Vitoria-Gasteiz,expenses,cash,-100.0,-56251.48
buyer_6,Manuel,Rodríguez,1979-02-14,48702192Z,manuel.rodríguez@smartdev.org,107107,ES88209540227161223022,1256.82,2024-01-30T12:23:32,Vitoria-Gasteiz,expenses,travel,-633.85,-56885.33
buyer_6,Manuel,Rodríguez,1979-02-14,48702192Z,manuel.rodríguez@smartdev.org,107107,ES88209540227161223022,1256.82,2024-02-01T02:14:12,Vitoria-Gasteiz,incomes,salary,1385.98,-55499.35
buyer_6,Manuel,Rodríguez,1979-02-14,48702192Z,manuel.rodríguez@smartdev.org,107107,ES88209540227161223022,1256.82,2024-02-01T02:14:12,Vitoria-Gasteiz,incomes,extra_income,181.04,-55318.31
buyer_6,Manuel,Rodríguez,1979-02-14,48702192Z,manuel.rodríguez@smartdev.org,107107,ES88209540227161223022,1256.82,2024-02-01T13:19:10,Vitoria-Gasteiz,expenses,transport,-48.84,-55367.15
buyer_6,Manuel,Rodríguez,1979-02-14,48702192Z,manuel.rodríguez@smartdev.org,107107,ES88209540227161223022,1256.82,2024-02-01T10:21:10,Vitoria-Gasteiz,expenses,education,-64.56,-55431.71
buyer_6,Manuel,Rodríguez,1979-02-14,48702192Z,manuel.rodríguez@smartdev.org,107107,ES88209540227161223022,1256.82,2024-02-02T20:00:10,Vitoria-Gasteiz,expenses,repairs,-33.12,-55464.83
buyer_6,Manuel,Rodríguez,1979-02-14,48702192Z,manuel.rodríguez@smartdev.org,107107,ES88209540227161223022,1256.82,2024-02-03T21:46:27,Vitoria-Gasteiz,expenses,transport,-67.2,-55532.03
buyer_6,Manuel,Rodríguez,1979-02-14,48702192Z,manuel.rodríguez@smartdev.org,107107,ES88209540227161223022,1256.82,2024-02-04T08:33:02,Vitoria-Gasteiz,expenses,mortgage,-526.62,-56058.65
buyer_6,Manuel,Rodríguez,1979-02-14,48702192Z,manuel.rodríguez@smartdev.org,107107,ES88209540227161223022,1256.82,2024-02-04T08:39:48,Vitoria-Gasteiz,expenses,transport,-77.87,-56136.52
buyer_6,Manuel,Rodríguez,1979-02-14,48702192Z,manuel.rodríguez@smartdev.org,107107,ES88209540227161223022,1256.82,2024-02-05T15:56:55,Vitoria-Gasteiz,expenses,gas,-41.8,-56178.32
buyer_6,Manuel,Rodríguez,1979-02-14,48702192Z,manuel.rodríguez@smartdev.org,107107,ES88209540227161223022,1256.82,2024-02-06T12:21:37,Vitoria-Gasteiz,expenses,appliances,-281.98,-56460.3
buyer_6,Manuel,Rodríguez,1979-02-14,48702192Z,manuel.rodríguez@smartdev.org,107107,ES88209540227161223022,1256.82,2024-02-08T14:42:34,Vitoria-Gasteiz,expenses,water,-28.63,-56488.93
buyer_6,Manuel,Rodríguez,1979-02-14,48702192Z,manuel.rodríguez@smartdev.org,107107,ES88209540227161223022,1256.82,2024-02-08T16:41:10,Vitoria-Gasteiz,expenses,electricity,-23.75,-56512.68
buyer_6,Manuel,Rodríguez,1979-02-14,48702192Z,manuel.rodríguez@smartdev.org,107107,ES88209540227161223022,1256.82,2024-02-08T16:47:54,Vitoria-Gasteiz,expenses,internet,-29.11,-56541.79
buyer_6,Manuel,Rodríguez,1979-02-14,48702192Z,manuel.rodríguez@smartdev.org,107107,ES88209540227161223022,1256.82,2024-02-08T09:45:57,Vitoria-Gasteiz,expenses,phone,-25.73,-56567.52
buyer_6,Manuel,Rodríguez,1979-02-14,48702192Z,manuel.rodríguez@smartdev.org,107107,ES88209540227161223022,1256.82,2024-02-08T11:42:00,Vitoria-Gasteiz,expenses,cash,-100.0,-56667.52
buyer_6,Manuel,Rodríguez,1979-02-14,48702192Z,manuel.rodríguez@smartdev.org,107107,ES88209540227161223022,1256.82,2024-02-09T17:09:56,Vitoria-Gasteiz,expenses,appliances,-223.01,-56890.53
buyer_6,Manuel,Rodríguez,1979-02-14,48702192Z,manuel.rodríguez@smartdev.org,107107,ES88209540227161223022,1256.82,2024-02-10T01:44:56,Vitoria-Gasteiz,expenses,repairs,-108.28,-56998.81
buyer_6,Manuel,Rodríguez,1979-02-14,48702192Z,manuel.rodríguez@smartdev.org,107107,ES88209540227161223022,1256.82,2024-02-11T18:51:21,Vitoria-Gasteiz,expenses,repairs,-268.41,-57267.22
buyer_6,Manuel,Rodríguez,1979-02-14,48702192Z,manuel.rodríguez@smartdev.org,107107,ES88209540227161223022,1256.82,2024-02-12T08:21:14,Vitoria-Gasteiz,expenses,healthcare,-108.09,-57375.31
buyer_6,Manuel,Rodríguez,1979-02-14,48702192Z,manuel.rodríguez@smartdev.org,107107,ES88209540227161223022,1256.82,2024-02-12T20:02:42,Vitoria-Gasteiz,expenses,cash,-100.0,-57475.31
buyer_6,Manuel,Rodríguez,1979-02-14,48702192Z,manuel.rodríguez@smartdev.org,107107,ES88209540227161223022,1256.82,2024-02-13T18:25:55,Vitoria-Gasteiz,expenses,cash,-100.0,-57575.31
buyer_6,Manuel,Rodríguez,1979-02-14,48702192Z,manuel.rodríguez@smartdev.org,107107,ES88209540227161223022,1256.82,2024-02-13T16:59:57,Vitoria-Gasteiz,expenses,repairs,-250.62,-57825.93
buyer_6,Manuel,Rodríguez,1979-02-14,48702192Z,manuel.rodríguez@smartdev.org,107107,ES88209540227161223022,1256.82,2024-02-15T12:49:15,Vitoria-Gasteiz,expenses,cash,-100.0,-57925.93
buyer_6,Manuel,Rodríguez,1979-02-14,48702192Z,manuel.rodríguez@smartdev.org,107107,ES88209540227161223022,1256.82,2024-02-16T10:32:50,Vitoria-Gasteiz,expenses,cash,-100.0,-58025.93
buyer_6,Manuel,Rodríguez,1979-02-14,48702192Z,manuel.rodríguez@smartdev.org,107107,ES88209540227161223022,1256.82,2024-02-17T14:03:57,Vitoria-Gasteiz,expenses,transport,-54.9,-58080.83
buyer_6,Manuel,Rodríguez,1979-02-14,48702192Z,manuel.rodríguez@smartdev.org,107107,ES88209540227161223022,1256.82,2024-02-17T10:54:07,Vitoria-Gasteiz,expenses,leisure,-52.37,-58133.2
buyer_6,Manuel,Rodríguez,1979-02-14,48702192Z,manuel.rodríguez@smartdev.org,107107,ES88209540227161223022,1256.82,2024-02-17T12:19:29,Vitoria-Gasteiz,expenses,clothing,-91.87,-58225.07
buyer_6,Manuel,Rodríguez,1979-02-14,48702192Z,manuel.rodríguez@smartdev.org,107107,ES88209540227161223022,1256.82,2024-02-18T09:25:08,Vitoria-Gasteiz,expenses,food,-91.96,-58317.03
buyer_6,Manuel,Rodríguez,1979-02-14,48702192Z,manuel.rodríguez@smartdev.org,107107,ES88209540227161223022,1256.82,2024-02-21T10:14:50,Vitoria-Gasteiz,expenses,transport,-89.32,-58406.35
buyer_6,Manuel,Rodríguez,1979-02-14,48702192Z,manuel.rodríguez@smartdev.org,107107,ES88209540227161223022,1256.82,2024-02-22T17:00:40,Vitoria-Gasteiz,expenses,cash,-100.0,-58506.35
buyer_6,Manuel,Rodríguez,1979-02-14,48702192Z,manuel.rodríguez@smartdev.org,107107,ES88209540227161223022,1256.82,2024-02-25T09:57:50,Vitoria-Gasteiz,expenses,education,-69.39,-58575.74
buyer_6,Manuel,Rodríguez,1979-02-14,48702192Z,manuel.rodríguez@smartdev.org,107107,ES88209540227161223022,1256.82,2024-02-25T05:10:27,Vitoria-Gasteiz,expenses,repairs,-30.14,-58605.88
buyer_6,Manuel,Rodríguez,1979-02-14,48702192Z,manuel.rodríguez@smartdev.org,107107,ES88209540227161223022,1256.82,2024-02-27T17:30:42,Vitoria-Gasteiz,expenses,cash,-100.0,-58705.88
buyer_6,Manuel,Rodríguez,1979-02-14,48702192Z,manuel.rodríguez@smartdev.org,107107,ES88209540227161223022,1256.82,2024-03-01T11:03:38,Vitoria-Gasteiz,incomes,salary,1385.98,-57319.9
buyer_6,Manuel,Rodríguez,1979-02-14,48702192Z,manuel.rodríguez@smartdev.org,107107,ES88209540227161223022,1256.82,2024-03-01T21:39:00,Vitoria-Gasteiz,expenses,food,-123.77,-57443.67
buyer_6,Manuel,Rodríguez,1979-02-14,48702192Z,manuel.rodríguez@smartdev.org,107107,ES88209540227161223022,1256.82,2024-03-02T15:30:59,Vitoria-Gasteiz,expenses,healthcare,-96.92,-57540.59
buyer_6,Manuel,Rodríguez,1979-02-14,48702192Z,manuel.rodríguez@smartdev.org,107107,ES88209540227161223022,1256.82,2024-03-03T10:29:04,Vitoria-Gasteiz,expenses,leisure,-45.9,-57586.49
buyer_6,Manuel,Rodríguez,1979-02-14,48702192Z,manuel.rodríguez@smartdev.org,107107,ES88209540227161223022,1256.82,2024-03-04T13:04:18,Vitoria-Gasteiz,expenses,mortgage,-526.62,-58113.11
buyer_6,Manuel,Rodríguez,1979-02-14,48702192Z,manuel.rodríguez@smartdev.org,107107,ES88209540227161223022,1256.82,2024-03-04T09:45:37,Vitoria-Gasteiz,expenses,leisure,-79.35,-58192.46
buyer_6,Manuel,Rodríguez,1979-02-14,48702192Z,manuel.rodríguez@smartdev.org,107107,ES88209540227161223022,1256.82,2024-03-05T10:00:38,Vitoria-Gasteiz,expenses,gas,-58.54,-58251.0
buyer_6,Manuel,Rodríguez,1979-02-14,48702192Z,manuel.rodríguez@smartdev.org,107107,ES88209540227161223022,1256.82,2024-03-05T17:55:36,Vitoria-Gasteiz,expenses,internet,-29.11,-58280.11
buyer_6,Manuel,Rodríguez,1979-02-14,48702192Z,manuel.rodríguez@smartdev.org,107107,ES88209540227161223022,1256.82,2024-03-06T20:52:14,Vitoria-Gasteiz,expenses,cash,-100.0,-58380.11
buyer_6,Manuel,Rodríguez,1979-02-14,48702192Z,manuel.rodríguez@smartdev.org,107107,ES88209540227161223022,1256.82,2024-03-07T12:01:38,Vitoria-Gasteiz,expenses,water,-24.61,-58404.72
buyer_6,Manuel,Rodríguez,1979-02-14,48702192Z,manuel.rodríguez@smartdev.org,107107,ES88209540227161223022,1256.82,2024-03-07T11:03:37,Vitoria-Gasteiz,expenses,phone,-21.45,-58426.17
buyer_6,Manuel,Rodríguez,1979-02-14,48702192Z,manuel.rodríguez@smartdev.org,107107,ES88209540227161223022,1256.82,2024-03-07T11:20:32,Vitoria-Gasteiz,expenses,leisure,-80.53,-58506.7
buyer_6,Manuel,Rodríguez,1979-02-14,48702192Z,manuel.rodríguez@smartdev.org,107107,ES88209540227161223022,1256.82,2024-03-08T23:45:15,Vitoria-Gasteiz,expenses,electricity,-42.13,-58548.83
buyer_6,Manuel,Rodríguez,1979-02-14,48702192Z,manuel.rodríguez@smartdev.org,107107,ES88209540227161223022,1256.82,2024-03-10T23:27:45,Vitoria-Gasteiz,expenses,repairs,-102.12,-58650.95
buyer_6,Manuel,Rodríguez,1979-02-14,48702192Z,manuel.rodríguez@smartdev.org,107107,ES88209540227161223022,1256.82,2024-03-15T22:03:27,Vitoria-Gasteiz,expenses,cash,-100.0,-58750.95
buyer_6,Manuel,Rodríguez,1979-02-14,48702192Z,manuel.rodríguez@smartdev.org,107107,ES88209540227161223022,1256.82,2024-03-16T11:29:18,Vitoria-Gasteiz,expenses,gifts,-614.19,-59365.14
buyer_6,Manuel,Rodríguez,1979-02-14,48702192Z,manuel.rodríguez@smartdev.org,107107,ES88209540227161223022,1256.82,2024-03-17T06:42:26,Vitoria-Gasteiz,expenses,repairs,-223.65,-59588.79
buyer_6,Manuel,Rodríguez,1979-02-14,48702192Z,manuel.rodríguez@smartdev.org,107107,ES88209540227161223022,1256.82,2024-03-18T12:30:13,Vitoria-Gasteiz,expenses,food,-99.64,-59688.43
buyer_6,Manuel,Rodríguez,1979-02-14,48702192Z,manuel.rodríguez@smartdev.org,107107,ES88209540227161223022,1256.82,2024-03-18T17:55:50,Vitoria-Gasteiz,expenses,cash,-100.0,-59788.43
buyer_6,Manuel,Rodríguez,1979-02-14,48702192Z,manuel.rodríguez@smartdev.org,107107,ES88209540227161223022,1256.82,2024-03-19T01:07:08,Vitoria-Gasteiz,expenses,clothing,-76.11,-59864.54
buyer_6,Manuel,Rodríguez,1979-02-14,48702192Z,manuel.rodríguez@smartdev.org,107107,ES88209540227161223022,1256.82,2024-03-21T21:16:24,Vitoria-Gasteiz,expenses,cash,-100.0,-59964.54
buyer_6,Manuel,Rodríguez,1979-02-14,48702192Z,manuel.rodríguez@smartdev.org,107107,ES88209540227161223022,1256.82,2024-03-26T15:55:35,Vitoria-Gasteiz,expenses,cash,-100.0,-60064.54
buyer_6,Manuel,Rodríguez,1979-02-14,48702192Z,manuel.rodríguez@smartdev.org,107107,ES88209540227161223022,1256.82,2024-03-27T13:06:16,Vitoria-Gasteiz,expenses,appliances,-211.0,-60275.54
buyer_6,Manuel,Rodríguez,1979-02-14,48702192Z,manuel.rodríguez@smartdev.org,107107,ES88209540227161223022,1256.82,2024-04-01T08:02:58,Vitoria-Gasteiz,incomes,salary,1385.98,-58889.56
buyer_6,Manuel,Rodríguez,1979-02-14,48702192Z,manuel.rodríguez@smartdev.org,107107,ES88209540227161223022,1256.82,2024-04-02T11:07:59,Vitoria-Gasteiz,expenses,healthcare,-54.19,-58943.75
buyer_6,Manuel,Rodríguez,1979-02-14,48702192Z,manuel.rodríguez@smartdev.org,107107,ES88209540227161223022,1256.82,2024-04-02T08:41:25,Vitoria-Gasteiz,expenses,cash,-100.0,-59043.75
buyer_6,Manuel,Rodríguez,1979-02-14,48702192Z,manuel.rodríguez@smartdev.org,107107,ES88209540227161223022,1256.82,2024-04-02T12:56:20,Vitoria-Gasteiz,expenses,appliances,-141.41,-59185.16
buyer_6,Manuel,Rodríguez,1979-02-14,48702192Z,manuel.rodríguez@smartdev.org,107107,ES88209540227161223022,1256.82,2024-04-03T19:14:37,Vitoria-Gasteiz,expenses,repairs,-256.31,-59441.47
buyer_6,Manuel,Rodríguez,1979-02-14,48702192Z,manuel.rodríguez@smartdev.org,107107,ES88209540227161223022,1256.82,2024-04-04T11:38:50,Vitoria-Gasteiz,expenses,mortgage,-526.62,-59968.09
buyer_6,Manuel,Rodríguez,1979-02-14,48702192Z,manuel.rodríguez@smartdev.org,107107,ES88209540227161223022,1256.82,2024-04-04T13:46:17,Vitoria-Gasteiz,expenses,food,-67.56,-60035.65
buyer_6,Manuel,Rodríguez,1979-02-14,48702192Z,manuel.rodríguez@smartdev.org,107107,ES88209540227161223022,1256.82,2024-04-05T10:36:26,Vitoria-Gasteiz,expenses,food,-90.67,-60126.32
buyer_6,Manuel,Rodríguez,1979-02-14,48702192Z,manuel.rodríguez@smartdev.org,107107,ES88209540227161223022,1256.82,2024-04-05T17:49:10,Vitoria-Gasteiz,expenses,gifts,-507.97,-60634.29
buyer_6,Manuel,Rodríguez,1979-02-14,48702192Z,manuel.rodríguez@smartdev.org,107107,ES88209540227161223022,1256.82,2024-04-06T18:40:44,Vitoria-Gasteiz,expenses,electricity,-46.89,-60681.18
buyer_6,Manuel,Rodríguez,1979-02-14,48702192Z,manuel.rodríguez@smartdev.org,107107,ES88209540227161223022,1256.82,2024-04-06T19:53:23,Vitoria-Gasteiz,expenses,internet,-29.11,-60710.29
buyer_6,Manuel,Rodríguez,1979-02-14,48702192Z,manuel.rodríguez@smartdev.org,107107,ES88209540227161223022,1256.82,2024-04-06T16:13:41,Vitoria-Gasteiz,expenses,education,-71.93,-60782.22
buyer_6,Manuel,Rodríguez,1979-02-14,48702192Z,manuel.rodríguez@smartdev.org,107107,ES88209540227161223022,1256.82,2024-04-07T20:10:29,Vitoria-Gasteiz,expenses,phone,-26.73,-60808.95
buyer_6,Manuel,Rodríguez,1979-02-14,48702192Z,manuel.rodríguez@smartdev.org,107107,ES88209540227161223022,1256.82,2024-04-08T16:20:32,Vitoria-Gasteiz,expenses,gas,-34.21,-60843.16
buyer_6,Manuel,Rodríguez,1979-02-14,48702192Z,manuel.rodríguez@smartdev.org,107107,ES88209540227161223022,1256.82,2024-04-08T10:08:06,Vitoria-Gasteiz,expenses,water,-28.25,-60871.41
buyer_6,Manuel,Rodríguez,1979-02-14,48702192Z,manuel.rodríguez@smartdev.org,107107,ES88209540227161223022,1256.82,2024-04-08T11:48:24,Vitoria-Gasteiz,expenses,clothing,-151.83,-61023.24
buyer_6,Manuel,Rodríguez,1979-02-14,48702192Z,manuel.rodríguez@smartdev.org,107107,ES88209540227161223022,1256.82,2024-04-08T07:53:10,Vitoria-Gasteiz,expenses,healthcare,-156.39,-61179.63
buyer_6,Manuel,Rodríguez,1979-02-14,48702192Z,manuel.rodríguez@smartdev.org,107107,ES88209540227161223022,1256.82,2024-04-09T13:53:42,Vitoria-Gasteiz,expenses,food,-81.72,-61261.35
buyer_6,Manuel,Rodríguez,1979-02-14,48702192Z,manuel.rodríguez@smartdev.org,107107,ES88209540227161223022,1256.82,2024-04-09T18:50:58,Vitoria-Gasteiz,expenses,transport,-63.47,-61324.82
buyer_6,Manuel,Rodríguez,1979-02-14,48702192Z,manuel.rodríguez@smartdev.org,107107,ES88209540227161223022,1256.82,2024-04-09T09:04:57,Vitoria-Gasteiz,expenses,education,-64.01,-61388.83
buyer_6,Manuel,Rodríguez,1979-02-14,48702192Z,manuel.rodríguez@smartdev.org,107107,ES88209540227161223022,1256.82,2024-04-11T08:59:36,Vitoria-Gasteiz,expenses,repairs,-130.05,-61518.88
buyer_6,Manuel,Rodríguez,1979-02-14,48702192Z,manuel.rodríguez@smartdev.org,107107,ES88209540227161223022,1256.82,2024-04-12T21:49:29,Vitoria-Gasteiz,expenses,transport,-44.85,-61563.73
buyer_6,Manuel,Rodríguez,1979-02-14,48702192Z,manuel.rodríguez@smartdev.org,107107,ES88209540227161223022,1256.82,2024-04-14T10:29:41,Vitoria-Gasteiz,expenses,appliances,-82.31,-61646.04
buyer_6,Manuel,Rodríguez,1979-02-14,48702192Z,manuel.rodríguez@smartdev.org,107107,ES88209540227161223022,1256.82,2024-04-15T01:01:29,Vitoria-Gasteiz,expenses,clothing,-123.05,-61769.09
buyer_6,Manuel,Rodríguez,1979-02-14,48702192Z,manuel.rodríguez@smartdev.org,107107,ES88209540227161223022,1256.82,2024-04-16T14:25:08,Vitoria-Gasteiz,expenses,transport,-53.51,-61822.6
buyer_6,Manuel,Rodríguez,1979-02-14,48702192Z,manuel.rodríguez@smartdev.org,107107,ES88209540227161223022,1256.82,2024-04-16T16:20:47,Vitoria-Gasteiz,expenses,clothing,-64.63,-61887.23
buyer_6,Manuel,Rodríguez,1979-02-14,48702192Z,manuel.rodríguez@smartdev.org,107107,ES88209540227161223022,1256.82,2024-04-18T19:10:34,Vitoria-Gasteiz,expenses,appliances,-185.82,-62073.05
buyer_6,Manuel,Rodríguez,1979-02-14,48702192Z,manuel.rodríguez@smartdev.org,107107,ES88209540227161223022,1256.82,2024-04-19T19:08:11,Vitoria-Gasteiz,expenses,cash,-100.0,-62173.05
buyer_6,Manuel,Rodríguez,1979-02-14,48702192Z,manuel.rodríguez@smartdev.org,107107,ES88209540227161223022,1256.82,2024-04-21T09:54:49,Vitoria-Gasteiz,expenses,transport,-47.52,-62220.57
buyer_6,Manuel,Rodríguez,1979-02-14,48702192Z,manuel.rodríguez@smartdev.org,107107,ES88209540227161223022,1256.82,2024-04-23T11:55:18,Vitoria-Gasteiz,expenses,clothing,-92.94,-62313.51
buyer_6,Manuel,Rodríguez,1979-02-14,48702192Z,manuel.rodríguez@smartdev.org,107107,ES88209540227161223022,1256.82,2024-04-26T18:28:44,Vitoria-Gasteiz,expenses,transport,-43.78,-62357.29
buyer_6,Manuel,Rodríguez,1979-02-14,48702192Z,manuel.rodríguez@smartdev.org,107107,ES88209540227161223022,1256.82,2024-04-26T17:14:57,Vitoria-Gasteiz,expenses,cash,-100.0,-62457.29
buyer_6,Manuel,Rodríguez,1979-02-14,48702192Z,manuel.rodríguez@smartdev.org,107107,ES88209540227161223022,1256.82,2024-04-27T19:49:27,Vitoria-Gasteiz,expenses,cash,-100.0,-62557.29
buyer_6,Manuel,Rodríguez,1979-02-14,48702192Z,manuel.rodríguez@smartdev.org,107107,ES88209540227161223022,1256.82,2024-05-01T11:30:17,Vitoria-Gasteiz,incomes,salary,1385.98,-61171.31
buyer_6,Manuel,Rodríguez,1979-02-14,48702192Z,manuel.rodríguez@smartdev.org,107107,ES88209540227161223022,1256.82,2024-05-01T11:30:17,Vitoria-Gasteiz,incomes,extra_income,181.04,-60990.27
buyer_6,Manuel,Rodríguez,1979-02-14,48702192Z,manuel.rodríguez@smartdev.org,107107,ES88209540227161223022,1256.82,2024-05-01T11:28:31,Vitoria-Gasteiz,expenses,leisure,-50.98,-61041.25
buyer_6,Manuel,Rodríguez,1979-02-14,48702192Z,manuel.rodríguez@smartdev.org,107107,ES88209540227161223022,1256.82,2024-05-02T14:23:42,Vitoria-Gasteiz,expenses,healthcare,-91.33,-61132.58
buyer_6,Manuel,Rodríguez,1979-02-14,48702192Z,manuel.rodríguez@smartdev.org,107107,ES88209540227161223022,1256.82,2024-05-03T04:19:59,Vitoria-Gasteiz,expenses,transport,-63.56,-61196.14
buyer_6,Manuel,Rodríguez,1979-02-14,48702192Z,manuel.rodríguez@smartdev.org,107107,ES88209540227161223022,1256.82,2024-05-03T23:13:17,Vitoria-Gasteiz,expenses,cash,-100.0,-61296.14
buyer_6,Manuel,Rodríguez,1979-02-14,48702192Z,manuel.rodríguez@smartdev.org,107107,ES88209540227161223022,1256.82,2024-05-04T11:57:51,Vitoria-Gasteiz,expenses,mortgage,-526.62,-61822.76
buyer_6,Manuel,Rodríguez,1979-02-14,48702192Z,manuel.rodríguez@smartdev.org,107107,ES88209540227161223022,1256.82,2024-05-05T15:23:01,Vitoria-Gasteiz,expenses,gas,-39.44,-61862.2
buyer_6,Manuel,Rodríguez,1979-02-14,48702192Z,manuel.rodríguez@smartdev.org,107107,ES88209540227161223022,1256.82,2024-05-05T14:42:27,Vitoria-Gasteiz,expenses,phone,-26.09,-61888.29
buyer_6,Manuel,Rodríguez,1979-02-14,48702192Z,manuel.rodríguez@smartdev.org,107107,ES88209540227161223022,1256.82,2024-05-06T20:59:07,Vitoria-Gasteiz,expenses,clothing,-82.68,-61970.97
buyer_6,Manuel,Rodríguez,1979-02-14,48702192Z,manuel.rodríguez@smartdev.org,107107,ES88209540227161223022,1256.82,2024-05-07T11:54:44,Vitoria-Gasteiz,expenses,transport,-58.68,-62029.65
buyer_6,Manuel,Rodríguez,1979-02-14,48702192Z,manuel.rodríguez@smartdev.org,107107,ES88209540227161223022,1256.82,2024-05-07T05:37:24,Vitoria-Gasteiz,expenses,leisure,-68.17,-62097.82
buyer_6,Manuel,Rodríguez,1979-02-14,48702192Z,manuel.rodríguez@smartdev.org,107107,ES88209540227161223022,1256.82,2024-05-08T20:49:41,Vitoria-Gasteiz,expenses,electricity,-26.12,-62123.94
buyer_6,Manuel,Rodríguez,1979-02-14,48702192Z,manuel.rodríguez@smartdev.org,107107,ES88209540227161223022,1256.82,2024-05-08T12:48:37,Vitoria-Gasteiz,expenses,internet,-29.11,-62153.05
buyer_6,Manuel,Rodríguez,1979-02-14,48702192Z,manuel.rodríguez@smartdev.org,107107,ES88209540227161223022,1256.82,2024-05-08T15:16:35,Vitoria-Gasteiz,expenses,water,-18.32,-62171.37
buyer_6,Manuel,Rodríguez,1979-02-14,48702192Z,manuel.rodríguez@smartdev.org,107107,ES88209540227161223022,1256.82,2024-05-09T16:36:41,Vitoria-Gasteiz,expenses,clothing,-82.03,-62253.4
buyer_6,Manuel,Rodríguez,1979-02-14,48702192Z,manuel.rodríguez@smartdev.org,107107,ES88209540227161223022,1256.82,2024-05-09T18:11:17,Vitoria-Gasteiz,expenses,gifts,-203.91,-62457.31
buyer_6,Manuel,Rodríguez,1979-02-14,48702192Z,manuel.rodríguez@smartdev.org,107107,ES88209540227161223022,1256.82,2024-05-10T08:37:25,Vitoria-Gasteiz,expenses,appliances,-224.24,-62681.55
buyer_6,Manuel,Rodríguez,1979-02-14,48702192Z,manuel.rodríguez@smartdev.org,107107,ES88209540227161223022,1256.82,2024-05-12T11:29:23,Vitoria-Gasteiz,expenses,food,-98.93,-62780.48
buyer_6,Manuel,Rodríguez,1979-02-14,48702192Z,manuel.rodríguez@smartdev.org,107107,ES88209540227161223022,1256.82,2024-05-12T14:03:22,Vitoria-Gasteiz,expenses,leisure,-22.02,-62802.5
buyer_6,Manuel,Rodríguez,1979-02-14,48702192Z,manuel.rodríguez@smartdev.org,107107,ES88209540227161223022,1256.82,2024-05-13T18:21:32,Vitoria-Gasteiz,expenses,cash,-100.0,-62902.5
buyer_6,Manuel,Rodríguez,1979-02-14,48702192Z,manuel.rodríguez@smartdev.org,107107,ES88209540227161223022,1256.82,2024-05-16T08:43:08,Vitoria-Gasteiz,expenses,cash,-100.0,-63002.5
buyer_6,Manuel,Rodríguez,1979-02-14,48702192Z,manuel.rodríguez@smartdev.org,107107,ES88209540227161223022,1256.82,2024-05-20T15:04:53,Vitoria-Gasteiz,expenses,leisure,-25.98,-63028.48
buyer_6,Manuel,Rodríguez,1979-02-14,48702192Z,manuel.rodríguez@smartdev.org,107107,ES88209540227161223022,1256.82,2024-05-21T23:18:31,Vitoria-Gasteiz,expenses,cash,-100.0,-63128.48
buyer_6,Manuel,Rodríguez,1979-02-14,48702192Z,manuel.rodríguez@smartdev.org,107107,ES88209540227161223022,1256.82,2024-05-23T00:43:33,Vitoria-Gasteiz,expenses,cash,-100.0,-63228.48
buyer_6,Manuel,Rodríguez,1979-02-14,48702192Z,manuel.rodríguez@smartdev.org,107107,ES88209540227161223022,1256.82,2024-05-27T19:17:35,Vitoria-Gasteiz,expenses,food,-82.85,-63311.33
buyer_6,Manuel,Rodríguez,1979-02-14,48702192Z,manuel.rodríguez@smartdev.org,107107,ES88209540227161223022,1256.82,2024-05-27T13:43:28,Vitoria-Gasteiz,expenses,gifts,-306.82,-63618.15
buyer_6,Manuel,Rodríguez,1979-02-14,48702192Z,manuel.rodríguez@smartdev.org,107107,ES88209540227161223022,1256.82,2024-05-28T18:38:06,Vitoria-Gasteiz,expenses,gifts,-286.79,-63904.94
buyer_6,Manuel,Rodríguez,1979-02-14,48702192Z,manuel.rodríguez@smartdev.org,107107,ES88209540227161223022,1256.82,2024-05-30T10:39:13,Vitoria-Gasteiz,expenses,gifts,-268.89,-64173.83
buyer_6,Manuel,Rodríguez,1979-02-14,48702192Z,manuel.rodríguez@smartdev.org,107107,ES88209540227161223022,1256.82,2024-06-01T01:16:06,Vitoria-Gasteiz,incomes,salary,1385.98,-62787.85
buyer_6,Manuel,Rodríguez,1979-02-14,48702192Z,manuel.rodríguez@smartdev.org,107107,ES88209540227161223022,1256.82,2024-06-01T01:16:06,Vitoria-Gasteiz,incomes,salary_bonus,1029.03,-61758.82
buyer_6,Manuel,Rodríguez,1979-02-14,48702192Z,manuel.rodríguez@smartdev.org,107107,ES88209540227161223022,1256.82,2024-06-02T20:39:03,Vitoria-Gasteiz,expenses,food,-80.68,-61839.5
buyer_6,Manuel,Rodríguez,1979-02-14,48702192Z,manuel.rodríguez@smartdev.org,107107,ES88209540227161223022,1256.82,2024-06-03T04:11:56,Vitoria-Gasteiz,expenses,food,-97.18,-61936.68
buyer_6,Manuel,Rodríguez,1979-02-14,48702192Z,manuel.rodríguez@smartdev.org,107107,ES88209540227161223022,1256.82,2024-06-03T10:49:40,Vitoria-Gasteiz,expenses,cash,-100.0,-62036.68
buyer_6,Manuel,Rodríguez,1979-02-14,48702192Z,manuel.rodríguez@smartdev.org,107107,ES88209540227161223022,1256.82,2024-06-04T16:04:00,Vitoria-Gasteiz,expenses,mortgage,-526.62,-62563.3
buyer_6,Manuel,Rodríguez,1979-02-14,48702192Z,manuel.rodríguez@smartdev.org,107107,ES88209540227161223022,1256.82,2024-06-05T12:11:23,Vitoria-Gasteiz,expenses,electricity,-50.56,-62613.86
buyer_6,Manuel,Rodríguez,1979-02-14,48702192Z,manuel.rodríguez@smartdev.org,107107,ES88209540227161223022,1256.82,2024-06-05T17:23:38,Vitoria-Gasteiz,expenses,internet,-29.11,-62642.97
buyer_6,Manuel,Rodríguez,1979-02-14,48702192Z,manuel.rodríguez@smartdev.org,107107,ES88209540227161223022,1256.82,2024-06-05T18:05:39,Vitoria-Gasteiz,expenses,phone,-22.09,-62665.06
buyer_6,Manuel,Rodríguez,1979-02-14,48702192Z,manuel.rodríguez@smartdev.org,107107,ES88209540227161223022,1256.82,2024-06-06T23:32:27,Vitoria-Gasteiz,expenses,water,-22.71,-62687.77
buyer_6,Manuel,Rodríguez,1979-02-14,48702192Z,manuel.rodríguez@smartdev.org,107107,ES88209540227161223022,1256.82,2024-06-06T11:54:09,Vitoria-Gasteiz,expenses,leisure,-54.98,-62742.75
buyer_6,Manuel,Rodríguez,1979-02-14,48702192Z,manuel.rodríguez@smartdev.org,107107,ES88209540227161223022,1256.82,2024-06-07T09:02:41,Vitoria-Gasteiz,expenses,gas,-46.69,-62789.44
buyer_6,Manuel,Rodríguez,1979-02-14,48702192Z,manuel.rodríguez@smartdev.org,107107,ES88209540227161223022,1256.82,2024-06-08T19:28:25,Vitoria-Gasteiz,expenses,leisure,-80.98,-62870.42
buyer_6,Manuel,Rodríguez,1979-02-14,48702192Z,manuel.rodríguez@smartdev.org,107107,ES88209540227161223022,1256.82,2024-06-10T04:48:29,Vitoria-Gasteiz,expenses,leisure,-77.48,-62947.9
buyer_6,Manuel,Rodríguez,1979-02-14,48702192Z,manuel.rodríguez@smartdev.org,107107,ES88209540227161223022,1256.82,2024-06-12T14:31:50,Vitoria-Gasteiz,expenses,cash,-100.0,-63047.9
buyer_6,Manuel,Rodríguez,1979-02-14,48702192Z,manuel.rodríguez@smartdev.org,107107,ES88209540227161223022,1256.82,2024-06-14T15:40:55,Vitoria-Gasteiz,expenses,healthcare,-128.26,-63176.16
buyer_6,Manuel,Rodríguez,1979-02-14,48702192Z,manuel.rodríguez@smartdev.org,107107,ES88209540227161223022,1256.82,2024-06-16T16:39:22,Vitoria-Gasteiz,expenses,clothing,-129.34,-63305.5
buyer_6,Manuel,Rodríguez,1979-02-14,48702192Z,manuel.rodríguez@smartdev.org,107107,ES88209540227161223022,1256.82,2024-06-18T14:47:54,Vitoria-Gasteiz,expenses,food,-67.35,-63372.85
buyer_6,Manuel,Rodríguez,1979-02-14,48702192Z,manuel.rodríguez@smartdev.org,107107,ES88209540227161223022,1256.82,2024-06-19T19:20:18,Vitoria-Gasteiz,expenses,food,-121.38,-63494.23
buyer_6,Manuel,Rodríguez,1979-02-14,48702192Z,manuel.rodríguez@smartdev.org,107107,ES88209540227161223022,1256.82,2024-06-22T20:19:22,Vitoria-Gasteiz,expenses,transport,-46.86,-63541.09
buyer_6,Manuel,Rodríguez,1979-02-14,48702192Z,manuel.rodríguez@smartdev.org,107107,ES88209540227161223022,1256.82,2024-06-23T06:53:03,Vitoria-Gasteiz,expenses,education,-42.51,-63583.6
buyer_6,Manuel,Rodríguez,1979-02-14,48702192Z,manuel.rodríguez@smartdev.org,107107,ES88209540227161223022,1256.82,2024-06-24T08:59:40,Vitoria-Gasteiz,expenses,leisure,-18.58,-63602.18
buyer_6,Manuel,Rodríguez,1979-02-14,48702192Z,manuel.rodríguez@smartdev.org,107107,ES88209540227161223022,1256.82,2024-06-25T12:50:52,Vitoria-Gasteiz,expenses,gifts,-64.63,-63666.81
buyer_6,Manuel,Rodríguez,1979-02-14,48702192Z,manuel.rodríguez@smartdev.org,107107,ES88209540227161223022,1256.82,2024-06-28T14:56:32,Vitoria-Gasteiz,expenses,leisure,-27.79,-63694.6
buyer_6,Manuel,Rodríguez,1979-02-14,48702192Z,manuel.rodríguez@smartdev.org,107107,ES88209540227161223022,1256.82,2024-06-28T11:29:38,Vitoria-Gasteiz,expenses,clothing,-123.59,-63818.19
buyer_6,Manuel,Rodríguez,1979-02-14,48702192Z,manuel.rodríguez@smartdev.org,107107,ES88209540227161223022,1256.82,2024-06-29T13:39:20,Vitoria-Gasteiz,expenses,healthcare,-143.76,-63961.95
buyer_6,Manuel,Rodríguez,1979-02-14,48702192Z,manuel.rodríguez@smartdev.org,107107,ES88209540227161223022,1256.82,2024-06-30T11:56:14,Vitoria-Gasteiz,expenses,cash,-100.0,-64061.95
buyer_6,Manuel,Rodríguez,1979-02-14,48702192Z,manuel.rodríguez@smartdev.org,107107,ES88209540227161223022,1256.82,2024-07-01T13:54:40,Vitoria-Gasteiz,incomes,salary,1385.98,-62675.97
buyer_6,Manuel,Rodríguez,1979-02-14,48702192Z,manuel.rodríguez@smartdev.org,107107,ES88209540227161223022,1256.82,2024-07-01T17:31:39,Vitoria-Gasteiz,expenses,transport,-83.06,-62759.03
buyer_6,Manuel,Rodríguez,1979-02-14,48702192Z,manuel.rodríguez@smartdev.org,107107,ES88209540227161223022,1256.82,2024-07-04T18:57:58,Vitoria-Gasteiz,expenses,mortgage,-526.62,-63285.65
buyer_6,Manuel,Rodríguez,1979-02-14,48702192Z,manuel.rodríguez@smartdev.org,107107,ES88209540227161223022,1256.82,2024-07-04T10:18:25,Vitoria-Gasteiz,expenses,cash,-100.0,-63385.65
buyer_6,Manuel,Rodríguez,1979-02-14,48702192Z,manuel.rodríguez@smartdev.org,107107,ES88209540227161223022,1256.82,2024-07-05T16:02:17,Vitoria-Gasteiz,expenses,phone,-22.38,-63408.03
buyer_6,Manuel,Rodríguez,1979-02-14,48702192Z,manuel.rodríguez@smartdev.org,107107,ES88209540227161223022,1256.82,2024-07-06T08:14:41,Vitoria-Gasteiz,expenses,leisure,-33.23,-63441.26
buyer_6,Manuel,Rodríguez,1979-02-14,48702192Z,manuel.rodríguez@smartdev.org,107107,ES88209540227161223022,1256.82,2024-07-07T20:10:57,Vitoria-Gasteiz,expenses,gas,-76.1,-63517.36
buyer_6,Manuel,Rodríguez,1979-02-14,48702192Z,manuel.rodríguez@smartdev.org,107107,ES88209540227161223022,1256.82,2024-07-07T23:15:55,Vitoria-Gasteiz,expenses,gifts,-540.03,-64057.39
buyer_6,Manuel,Rodríguez,1979-02-14,48702192Z,manuel.rodríguez@smartdev.org,107107,ES88209540227161223022,1256.82,2024-07-08T17:39:32,Vitoria-Gasteiz,expenses,water,-20.18,-64077.57
buyer_6,Manuel,Rodríguez,1979-02-14,48702192Z,manuel.rodríguez@smartdev.org,107107,ES88209540227161223022,1256.82,2024-07-08T13:47:53,Vitoria-Gasteiz,expenses,internet,-29.11,-64106.68
buyer_6,Manuel,Rodríguez,1979-02-14,48702192Z,manuel.rodríguez@smartdev.org,107107,ES88209540227161223022,1256.82,2024-07-08T13:55:33,Vitoria-Gasteiz,expenses,electricity,-54.73,-64161.41
buyer_6,Manuel,Rodríguez,1979-02-14,48702192Z,manuel.rodríguez@smartdev.org,107107,ES88209540227161223022,1256.82,2024-07-11T08:26:19,Vitoria-Gasteiz,expenses,food,-74.85,-64236.26
buyer_6,Manuel,Rodríguez,1979-02-14,48702192Z,manuel.rodríguez@smartdev.org,107107,ES88209540227161223022,1256.82,2024-07-12T13:04:19,Vitoria-Gasteiz,expenses,gifts,-796.1,-65032.36
buyer_6,Manuel,Rodríguez,1979-02-14,48702192Z,manuel.rodríguez@smartdev.org,107107,ES88209540227161223022,1256.82,2024-07-13T23:33:34,Vitoria-Gasteiz,expenses,food,-80.78,-65113.14
buyer_6,Manuel,Rodríguez,1979-02-14,48702192Z,manuel.rodríguez@smartdev.org,107107,ES88209540227161223022,1256.82,2024-07-14T16:03:07,Vitoria-Gasteiz,expenses,travel,-604.81,-65717.95
buyer_6,Manuel,Rodríguez,1979-02-14,48702192Z,manuel.rodríguez@smartdev.org,107107,ES88209540227161223022,1256.82,2024-07-17T17:44:43,Vitoria-Gasteiz,expenses,travel,-697.0,-66414.95
buyer_6,Manuel,Rodríguez,1979-02-14,48702192Z,manuel.rodríguez@smartdev.org,107107,ES88209540227161223022,1256.82,2024-07-18T16:57:28,Vitoria-Gasteiz,expenses,food,-123.87,-66538.82
buyer_6,Manuel,Rodríguez,1979-02-14,48702192Z,manuel.rodríguez@smartdev.org,107107,ES88209540227161223022,1256.82,2024-07-20T04:14:20,Vitoria-Gasteiz,expenses,food,-77.95,-66616.77
buyer_6,Manuel,Rodríguez,1979-02-14,48702192Z,manuel.rodríguez@smartdev.org,107107,ES88209540227161223022,1256.82,2024-07-21T20:23:50,Vitoria-Gasteiz,expenses,cash,-100.0,-66716.77
buyer_6,Manuel,Rodríguez,1979-02-14,48702192Z,manuel.rodríguez@smartdev.org,107107,ES88209540227161223022,1256.82,2024-07-21T14:36:54,Vitoria-Gasteiz,expenses,repairs,-224.14,-66940.91
buyer_6,Manuel,Rodríguez,1979-02-14,48702192Z,manuel.rodríguez@smartdev.org,107107,ES88209540227161223022,1256.82,2024-07-23T12:26:41,Vitoria-Gasteiz,expenses,travel,-340.58,-67281.49
buyer_6,Manuel,Rodríguez,1979-02-14,48702192Z,manuel.rodríguez@smartdev.org,107107,ES88209540227161223022,1256.82,2024-07-24T13:37:46,Vitoria-Gasteiz,expenses,repairs,-172.69,-67454.18
buyer_6,Manuel,Rodríguez,1979-02-14,48702192Z,manuel.rodríguez@smartdev.org,107107,ES88209540227161223022,1256.82,2024-07-25T18:15:53,Vitoria-Gasteiz,expenses,transport,-80.0,-67534.18
buyer_6,Manuel,Rodríguez,1979-02-14,48702192Z,manuel.rodríguez@smartdev.org,107107,ES88209540227161223022,1256.82,2024-07-25T19:42:32,Vitoria-Gasteiz,expenses,gifts,-724.08,-68258.26
buyer_6,Manuel,Rodríguez,1979-02-14,48702192Z,manuel.rodríguez@smartdev.org,107107,ES88209540227161223022,1256.82,2024-07-26T09:35:30,Vitoria-Gasteiz,expenses,leisure,-50.54,-68308.8
buyer_6,Manuel,Rodríguez,1979-02-14,48702192Z,manuel.rodríguez@smartdev.org,107107,ES88209540227161223022,1256.82,2024-07-26T18:44:18,Vitoria-Gasteiz,expenses,repairs,-139.94,-68448.74
buyer_6,Manuel,Rodríguez,1979-02-14,48702192Z,manuel.rodríguez@smartdev.org,107107,ES88209540227161223022,1256.82,2024-07-29T02:00:48,Vitoria-Gasteiz,expenses,cash,-100.0,-68548.74
buyer_6,Manuel,Rodríguez,1979-02-14,48702192Z,manuel.rodríguez@smartdev.org,107107,ES88209540227161223022,1256.82,2024-08-01T17:04:21,Vitoria-Gasteiz,incomes,salary,1385.98,-67162.76
buyer_6,Manuel,Rodríguez,1979-02-14,48702192Z,manuel.rodríguez@smartdev.org,107107,ES88209540227161223022,1256.82,2024-08-01T17:04:21,Vitoria-Gasteiz,incomes,extra_income,181.04,-66981.72
buyer_6,Manuel,Rodríguez,1979-02-14,48702192Z,manuel.rodríguez@smartdev.org,107107,ES88209540227161223022,1256.82,2024-08-01T11:40:05,Vitoria-Gasteiz,expenses,cash,-100.0,-67081.72
buyer_6,Manuel,Rodríguez,1979-02-14,48702192Z,manuel.rodríguez@smartdev.org,107107,ES88209540227161223022,1256.82,2024-08-04T15:42:37,Vitoria-Gasteiz,expenses,mortgage,-526.62,-67608.34
buyer_6,Manuel,Rodríguez,1979-02-14,48702192Z,manuel.rodríguez@smartdev.org,107107,ES88209540227161223022,1256.82,2024-08-04T16:52:58,Vitoria-Gasteiz,expenses,leisure,-29.51,-67637.85
buyer_6,Manuel,Rodríguez,1979-02-14,48702192Z,manuel.rodríguez@smartdev.org,107107,ES88209540227161223022,1256.82,2024-08-04T12:44:04,Vitoria-Gasteiz,expenses,gifts,-577.63,-68215.48
buyer_6,Manuel,Rodríguez,1979-02-14,48702192Z,manuel.rodríguez@smartdev.org,107107,ES88209540227161223022,1256.82,2024-08-05T14:49:40,Vitoria-Gasteiz,expenses,gas,-79.27,-68294.75
buyer_6,Manuel,Rodríguez,1979-02-14,48702192Z,manuel.rodríguez@smartdev.org,107107,ES88209540227161223022,1256.82,2024-08-05T12:26:45,Vitoria-Gasteiz,expenses,phone,-24.3,-68319.05
buyer_6,Manuel,Rodríguez,1979-02-14,48702192Z,manuel.rodríguez@smartdev.org,107107,ES88209540227161223022,1256.82,2024-08-06T06:56:33,Vitoria-Gasteiz,expenses,water,-22.94,-68341.99
buyer_6,Manuel,Rodríguez,1979-02-14,48702192Z,manuel.rodríguez@smartdev.org,107107,ES88209540227161223022,1256.82,2024-08-07T09:23:10,Vitoria-Gasteiz,expenses,travel,-548.29,-68890.28
buyer_6,Manuel,Rodríguez,1979-02-14,48702192Z,manuel.rodríguez@smartdev.org,107107,ES88209540227161223022,1256.82,2024-08-08T16:23:31,Vitoria-Gasteiz,expenses,electricity,-41.3,-68931.58
buyer_6,Manuel,Rodríguez,1979-02-14,48702192Z,manuel.rodríguez@smartdev.org,107107,ES88209540227161223022,1256.82,2024-08-08T20:35:34,Vitoria-Gasteiz,expenses,internet,-29.11,-68960.69
buyer_6,Manuel,Rodríguez,1979-02-14,48702192Z,manuel.rodríguez@smartdev.org,107107,ES88209540227161223022,1256.82,2024-08-09T18:49:44,Vitoria-Gasteiz,expenses,leisure,-81.33,-69042.02
buyer_6,Manuel,Rodríguez,1979-02-14,48702192Z,manuel.rodríguez@smartdev.org,107107,ES88209540227161223022,1256.82,2024-08-09T18:23:28,Vitoria-Gasteiz,expenses,education,-46.92,-69088.94
buyer_6,Manuel,Rodríguez,1979-02-14,48702192Z,manuel.rodríguez@smartdev.org,107107,ES88209540227161223022,1256.82,2024-08-10T16:28:54,Vitoria-Gasteiz,expenses,transport,-66.78,-69155.72
buyer_6,Manuel,Rodríguez,1979-02-14,48702192Z,manuel.rodríguez@smartdev.org,107107,ES88209540227161223022,1256.82,2024-08-10T11:12:14,Vitoria-Gasteiz,expenses,leisure,-35.39,-69191.11
buyer_6,Manuel,Rodríguez,1979-02-14,48702192Z,manuel.rodríguez@smartdev.org,107107,ES88209540227161223022,1256.82,2024-08-10T08:37:47,Vitoria-Gasteiz,expenses,appliances,-272.7,-69463.81
buyer_6,Manuel,Rodríguez,1979-02-14,48702192Z,manuel.rodríguez@smartdev.org,107107,ES88209540227161223022,1256.82,2024-08-11T10:29:08,Vitoria-Gasteiz,expenses,education,-74.04,-69537.85
buyer_6,Manuel,Rodríguez,1979-02-14,48702192Z,manuel.rodríguez@smartdev.org,107107,ES88209540227161223022,1256.82,2024-08-13T16:41:50,Vitoria-Gasteiz,expenses,transport,-56.35,-69594.2
buyer_6,Manuel,Rodríguez,1979-02-14,48702192Z,manuel.rodríguez@smartdev.org,107107,ES88209540227161223022,1256.82,2024-08-14T16:18:28,Vitoria-Gasteiz,expenses,transport,-57.41,-69651.61
buyer_6,Manuel,Rodríguez,1979-02-14,48702192Z,manuel.rodríguez@smartdev.org,107107,ES88209540227161223022,1256.82,2024-08-14T19:38:14,Vitoria-Gasteiz,expenses,travel,-696.61,-70348.22
buyer_6,Manuel,Rodríguez,1979-02-14,48702192Z,manuel.rodríguez@smartdev.org,107107,ES88209540227161223022,1256.82,2024-08-15T11:53:17,Vitoria-Gasteiz,expenses,cash,-100.0,-70448.22
buyer_6,Manuel,Rodríguez,1979-02-14,48702192Z,manuel.rodríguez@smartdev.org,107107,ES88209540227161223022,1256.82,2024-08-18T14:05:58,Vitoria-Gasteiz,expenses,food,-120.73,-70568.95
buyer_6,Manuel,Rodríguez,1979-02-14,48702192Z,manuel.rodríguez@smartdev.org,107107,ES88209540227161223022,1256.82,2024-08-18T10:01:13,Vitoria-Gasteiz,expenses,appliances,-331.33,-70900.28
buyer_6,Manuel,Rodríguez,1979-02-14,48702192Z,manuel.rodríguez@smartdev.org,107107,ES88209540227161223022,1256.82,2024-08-19T18:51:39,Vitoria-Gasteiz,expenses,food,-84.8,-70985.08
buyer_6,Manuel,Rodríguez,1979-02-14,48702192Z,manuel.rodríguez@smartdev.org,107107,ES88209540227161223022,1256.82,2024-08-19T09:48:05,Vitoria-Gasteiz,expenses,leisure,-66.76,-71051.84
buyer_6,Manuel,Rodríguez,1979-02-14,48702192Z,manuel.rodríguez@smartdev.org,107107,ES88209540227161223022,1256.82,2024-08-19T18:13:28,Vitoria-Gasteiz,expenses,cash,-100.0,-71151.84
buyer_6,Manuel,Rodríguez,1979-02-14,48702192Z,manuel.rodríguez@smartdev.org,107107,ES88209540227161223022,1256.82,2024-08-20T22:13:57,Vitoria-Gasteiz,expenses,cash,-100.0,-71251.84
buyer_6,Manuel,Rodríguez,1979-02-14,48702192Z,manuel.rodríguez@smartdev.org,107107,ES88209540227161223022,1256.82,2024-08-22T08:48:21,Vitoria-Gasteiz,expenses,food,-109.38,-71361.22
buyer_6,Manuel,Rodríguez,1979-02-14,48702192Z,manuel.rodríguez@smartdev.org,107107,ES88209540227161223022,1256.82,2024-08-22T09:24:57,Vitoria-Gasteiz,expenses,cash,-100.0,-71461.22
buyer_6,Manuel,Rodríguez,1979-02-14,48702192Z,manuel.rodríguez@smartdev.org,107107,ES88209540227161223022,1256.82,2024-08-25T08:05:53,Vitoria-Gasteiz,expenses,food,-101.3,-71562.52
buyer_6,Manuel,Rodríguez,1979-02-14,48702192Z,manuel.rodríguez@smartdev.org,107107,ES88209540227161223022,1256.82,2024-08-25T16:43:19,Vitoria-Gasteiz,expenses,cash,-100.0,-71662.52
buyer_6,Manuel,Rodríguez,1979-02-14,48702192Z,manuel.rodríguez@smartdev.org,107107,ES88209540227161223022,1256.82,2024-08-27T21:49:40,Vitoria-Gasteiz,expenses,cash,-100.0,-71762.52
buyer_6,Manuel,Rodríguez,1979-02-14,48702192Z,manuel.rodríguez@smartdev.org,107107,ES88209540227161223022,1256.82,2024-08-28T17:07:53,Vitoria-Gasteiz,expenses,gifts,-148.52,-71911.04
buyer_6,Manuel,Rodríguez,1979-02-14,48702192Z,manuel.rodríguez@smartdev.org,107107,ES88209540227161223022,1256.82,2024-09-01T14:35:07,Vitoria-Gasteiz,incomes,salary,1385.98,-70525.06
buyer_6,Manuel,Rodríguez,1979-02-14,48702192Z,manuel.rodríguez@smartdev.org,107107,ES88209540227161223022,1256.82,2024-09-01T11:17:11,Vitoria-Gasteiz,expenses,leisure,-29.07,-70554.13
buyer_6,Manuel,Rodríguez,1979-02-14,48702192Z,manuel.rodríguez@smartdev.org,107107,ES88209540227161223022,1256.82,2024-09-01T13:49:44,Vitoria-Gasteiz,expenses,cash,-100.0,-70654.13
buyer_6,Manuel,Rodríguez,1979-02-14,48702192Z,manuel.rodríguez@smartdev.org,107107,ES88209540227161223022,1256.82,2024-09-02T18:21:02,Vitoria-Gasteiz,expenses,transport,-79.66,-70733.79
buyer_6,Manuel,Rodríguez,1979-02-14,48702192Z,manuel.rodríguez@smartdev.org,107107,ES88209540227161223022,1256.82,2024-09-03T08:52:27,Vitoria-Gasteiz,expenses,healthcare,-180.63,-70914.42
buyer_6,Manuel,Rodríguez,1979-02-14,48702192Z,manuel.rodríguez@smartdev.org,107107,ES88209540227161223022,1256.82,2024-09-03T08:54:37,Vitoria-Gasteiz,expenses,repairs,-204.58,-71119.0
buyer_6,Manuel,Rodríguez,1979-02-14,48702192Z,manuel.rodríguez@smartdev.org,107107,ES88209540227161223022,1256.82,2024-09-04T14:58:43,Vitoria-Gasteiz,expenses,mortgage,-526.62,-71645.62
buyer_6,Manuel,Rodríguez,1979-02-14,48702192Z,manuel.rodríguez@smartdev.org,107107,ES88209540227161223022,1256.82,2024-09-04T04:04:42,Vitoria-Gasteiz,expenses,clothing,-78.56,-71724.18
buyer_6,Manuel,Rodríguez,1979-02-14,48702192Z,manuel.rodríguez@smartdev.org,107107,ES88209540227161223022,1256.82,2024-09-05T09:28:15,Vitoria-Gasteiz,expenses,electricity,-55.08,-71779.26
buyer_6,Manuel,Rodríguez,1979-02-14,48702192Z,manuel.rodríguez@smartdev.org,107107,ES88209540227161223022,1256.82,2024-09-05T10:53:14,Vitoria-Gasteiz,expenses,internet,-29.11,-71808.37
buyer_6,Manuel,Rodríguez,1979-02-14,48702192Z,manuel.rodríguez@smartdev.org,107107,ES88209540227161223022,1256.82,2024-09-05T08:07:12,Vitoria-Gasteiz,expenses,phone,-28.0,-71836.37
buyer_6,Manuel,Rodríguez,1979-02-14,48702192Z,manuel.rodríguez@smartdev.org,107107,ES88209540227161223022,1256.82,2024-09-05T13:36:17,Vitoria-Gasteiz,expenses,cash,-100.0,-71936.37
buyer_6,Manuel,Rodríguez,1979-02-14,48702192Z,manuel.rodríguez@smartdev.org,107107,ES88209540227161223022,1256.82,2024-09-06T17:45:30,Vitoria-Gasteiz,expenses,water,-14.88,-71951.25
buyer_6,Manuel,Rodríguez,1979-02-14,48702192Z,manuel.rodríguez@smartdev.org,107107,ES88209540227161223022,1256.82,2024-09-06T20:18:10,Vitoria-Gasteiz,expenses,gas,-42.99,-71994.24
buyer_6,Manuel,Rodríguez,1979-02-14,48702192Z,manuel.rodríguez@smartdev.org,107107,ES88209540227161223022,1256.82,2024-09-08T18:27:38,Vitoria-Gasteiz,expenses,food,-106.43,-72100.67
buyer_6,Manuel,Rodríguez,1979-02-14,48702192Z,manuel.rodríguez@smartdev.org,107107,ES88209540227161223022,1256.82,2024-09-08T20:00:15,Vitoria-Gasteiz,expenses,clothing,-82.38,-72183.05
buyer_6,Manuel,Rodríguez,1979-02-14,48702192Z,manuel.rodríguez@smartdev.org,107107,ES88209540227161223022,1256.82,2024-09-09T16:25:33,Vitoria-Gasteiz,expenses,food,-112.59,-72295.64
buyer_6,Manuel,Rodríguez,1979-02-14,48702192Z,manuel.rodríguez@smartdev.org,107107,ES88209540227161223022,1256.82,2024-09-10T14:32:09,Vitoria-Gasteiz,expenses,travel,-619.66,-72915.3
buyer_6,Manuel,Rodríguez,1979-02-14,48702192Z,manuel.rodríguez@smartdev.org,107107,ES88209540227161223022,1256.82,2024-09-11T18:28:55,Vitoria-Gasteiz,expenses,leisure,-47.3,-72962.6
buyer_6,Manuel,Rodríguez,1979-02-14,48702192Z,manuel.rodríguez@smartdev.org,107107,ES88209540227161223022,1256.82,2024-09-11T09:55:52,Vitoria-Gasteiz,expenses,repairs,-256.67,-73219.27
buyer_6,Manuel,Rodríguez,1979-02-14,48702192Z,manuel.rodríguez@smartdev.org,107107,ES88209540227161223022,1256.82,2024-09-12T15:18:15,Vitoria-Gasteiz,expenses,cash,-100.0,-73319.27
buyer_6,Manuel,Rodríguez,1979-02-14,48702192Z,manuel.rodríguez@smartdev.org,107107,ES88209540227161223022,1256.82,2024-09-13T01:26:13,Vitoria-Gasteiz,expenses,food,-96.14,-73415.41
buyer_6,Manuel,Rodríguez,1979-02-14,48702192Z,manuel.rodríguez@smartdev.org,107107,ES88209540227161223022,1256.82,2024-09-13T03:15:26,Vitoria-Gasteiz,expenses,leisure,-24.11,-73439.52
buyer_6,Manuel,Rodríguez,1979-02-14,48702192Z,manuel.rodríguez@smartdev.org,107107,ES88209540227161223022,1256.82,2024-09-13T06:21:17,Vitoria-Gasteiz,expenses,education,-65.94,-73505.46
buyer_6,Manuel,Rodríguez,1979-02-14,48702192Z,manuel.rodríguez@smartdev.org,107107,ES88209540227161223022,1256.82,2024-09-15T16:38:41,Vitoria-Gasteiz,expenses,food,-93.99,-73599.45
buyer_6,Manuel,Rodríguez,1979-02-14,48702192Z,manuel.rodríguez@smartdev.org,107107,ES88209540227161223022,1256.82,2024-09-15T16:35:26,Vitoria-Gasteiz,expenses,cash,-100.0,-73699.45
buyer_6,Manuel,Rodríguez,1979-02-14,48702192Z,manuel.rodríguez@smartdev.org,107107,ES88209540227161223022,1256.82,2024-09-15T08:38:41,Vitoria-Gasteiz,expenses,gifts,-125.77,-73825.22
buyer_6,Manuel,Rodríguez,1979-02-14,48702192Z,manuel.rodríguez@smartdev.org,107107,ES88209540227161223022,1256.82,2024-09-16T12:37:59,Vitoria-Gasteiz,expenses,transport,-82.87,-73908.09
buyer_6,Manuel,Rodríguez,1979-02-14,48702192Z,manuel.rodríguez@smartdev.org,107107,ES88209540227161223022,1256.82,2024-09-17T19:14:24,Vitoria-Gasteiz,expenses,food,-110.83,-74018.92
buyer_6,Manuel,Rodríguez,1979-02-14,48702192Z,manuel.rodríguez@smartdev.org,107107,ES88209540227161223022,1256.82,2024-09-17T08:00:24,Vitoria-Gasteiz,expenses,leisure,-83.69,-74102.61
buyer_6,Manuel,Rodríguez,1979-02-14,48702192Z,manuel.rodríguez@smartdev.org,107107,ES88209540227161223022,1256.82,2024-09-17T12:41:36,Vitoria-Gasteiz,expenses,repairs,-239.43,-74342.04
buyer_6,Manuel,Rodríguez,1979-02-14,48702192Z,manuel.rodríguez@smartdev.org,107107,ES88209540227161223022,1256.82,2024-09-19T10:24:01,Vitoria-Gasteiz,expenses,cash,-100.0,-74442.04
buyer_6,Manuel,Rodríguez,1979-02-14,48702192Z,manuel.rodríguez@smartdev.org,107107,ES88209540227161223022,1256.82,2024-09-20T14:48:58,Vitoria-Gasteiz,expenses,cash,-100.0,-74542.04
buyer_6,Manuel,Rodríguez,1979-02-14,48702192Z,manuel.rodríguez@smartdev.org,107107,ES88209540227161223022,1256.82,2024-09-21T19:09:37,Vitoria-Gasteiz,expenses,cash,-100.0,-74642.04
buyer_6,Manuel,Rodríguez,1979-02-14,48702192Z,manuel.rodríguez@smartdev.org,107107,ES88209540227161223022,1256.82,2024-09-22T05:13:23,Vitoria-Gasteiz,expenses,food,-94.65,-74736.69
buyer_6,Manuel,Rodríguez,1979-02-14,48702192Z,manuel.rodríguez@smartdev.org,107107,ES88209540227161223022,1256.82,2024-09-22T16:12:37,Vitoria-Gasteiz,expenses,transport,-83.96,-74820.65
buyer_6,Manuel,Rodríguez,1979-02-14,48702192Z,manuel.rodríguez@smartdev.org,107107,ES88209540227161223022,1256.82,2024-09-22T15:37:00,Vitoria-Gasteiz,expenses,leisure,-72.93,-74893.58
buyer_6,Manuel,Rodríguez,1979-02-14,48702192Z,manuel.rodríguez@smartdev.org,107107,ES88209540227161223022,1256.82,2024-09-22T10:02:13,Vitoria-Gasteiz,expenses,clothing,-88.21,-74981.79
buyer_6,Manuel,Rodríguez,1979-02-14,48702192Z,manuel.rodríguez@smartdev.org,107107,ES88209540227161223022,1256.82,2024-09-23T18:25:34,Vitoria-Gasteiz,expenses,food,-119.4,-75101.19
buyer_6,Manuel,Rodríguez,1979-02-14,48702192Z,manuel.rodríguez@smartdev.org,107107,ES88209540227161223022,1256.82,2024-09-23T05:46:25,Vitoria-Gasteiz,expenses,clothing,-91.18,-75192.37
buyer_6,Manuel,Rodríguez,1979-02-14,48702192Z,manuel.rodríguez@smartdev.org,107107,ES88209540227161223022,1256.82,2024-09-24T20:58:13,Vitoria-Gasteiz,expenses,food,-86.31,-75278.68
buyer_6,Manuel,Rodríguez,1979-02-14,48702192Z,manuel.rodríguez@smartdev.org,107107,ES88209540227161223022,1256.82,2024-09-26T11:44:26,Vitoria-Gasteiz,expenses,leisure,-76.83,-75355.51
buyer_6,Manuel,Rodríguez,1979-02-14,48702192Z,manuel.rodríguez@smartdev.org,107107,ES88209540227161223022,1256.82,2024-09-28T13:23:07,Vitoria-Gasteiz,expenses,food,-69.82,-75425.33
buyer_6,Manuel,Rodríguez,1979-02-14,48702192Z,manuel.rodríguez@smartdev.org,107107,ES88209540227161223022,1256.82,2024-09-30T12:36:55,Vitoria-Gasteiz,expenses,food,-61.48,-75486.81
buyer_6,Manuel,Rodríguez,1979-02-14,48702192Z,manuel.rodríguez@smartdev.org,107107,ES88209540227161223022,1256.82,2024-09-30T20:23:45,Vitoria-Gasteiz,expenses,transport,-77.59,-75564.4
buyer_6,Manuel,Rodríguez,1979-02-14,48702192Z,manuel.rodríguez@smartdev.org,107107,ES88209540227161223022,1256.82,2024-10-01T18:31:41,Vitoria-Gasteiz,incomes,salary,1385.98,-74178.42
buyer_6,Manuel,Rodríguez,1979-02-14,48702192Z,manuel.rodríguez@smartdev.org,107107,ES88209540227161223022,1256.82,2024-10-01T22:27:29,Vitoria-Gasteiz,expenses,food,-95.0,-74273.42
buyer_6,Manuel,Rodríguez,1979-02-14,48702192Z,manuel.rodríguez@smartdev.org,107107,ES88209540227161223022,1256.82,2024-10-01T11:15:06,Vitoria-Gasteiz,expenses,cash,-100.0,-74373.42
buyer_6,Manuel,Rodríguez,1979-02-14,48702192Z,manuel.rodríguez@smartdev.org,107107,ES88209540227161223022,1256.82,2024-10-02T09:05:27,Vitoria-Gasteiz,expenses,cash,-100.0,-74473.42
buyer_6,Manuel,Rodríguez,1979-02-14,48702192Z,manuel.rodríguez@smartdev.org,107107,ES88209540227161223022,1256.82,2024-10-02T20:13:17,Vitoria-Gasteiz,expenses,appliances,-258.58,-74732.0
buyer_6,Manuel,Rodríguez,1979-02-14,48702192Z,manuel.rodríguez@smartdev.org,107107,ES88209540227161223022,1256.82,2024-10-04T16:09:32,Vitoria-Gasteiz,expenses,mortgage,-526.62,-75258.62
buyer_6,Manuel,Rodríguez,1979-02-14,48702192Z,manuel.rodríguez@smartdev.org,107107,ES88209540227161223022,1256.82,2024-10-05T13:37:43,Vitoria-Gasteiz,expenses,phone,-29.24,-75287.86
buyer_6,Manuel,Rodríguez,1979-02-14,48702192Z,manuel.rodríguez@smartdev.org,107107,ES88209540227161223022,1256.82,2024-10-06T05:50:29,Vitoria-Gasteiz,expenses,travel,-483.24,-75771.1
buyer_6,Manuel,Rodríguez,1979-02-14,48702192Z,manuel.rodríguez@smartdev.org,107107,ES88209540227161223022,1256.82,2024-10-07T11:45:14,Vitoria-Gasteiz,expenses,transport,-40.38,-75811.48
buyer_6,Manuel,Rodríguez,1979-02-14,48702192Z,manuel.rodríguez@smartdev.org,107107,ES88209540227161223022,1256.82,2024-10-07T19:09:18,Vitoria-Gasteiz,expenses,gifts,-376.85,-76188.33
buyer_6,Manuel,Rodríguez,1979-02-14,48702192Z,manuel.rodríguez@smartdev.org,107107,ES88209540227161223022,1256.82,2024-10-08T19:52:23,Vitoria-Gasteiz,expenses,gas,-42.46,-76230.79
buyer_6,Manuel,Rodríguez,1979-02-14,48702192Z,manuel.rodríguez@smartdev.org,107107,ES88209540227161223022,1256.82,2024-10-08T16:12:31,Vitoria-Gasteiz,expenses,water,-28.74,-76259.53
buyer_6,Manuel,Rodríguez,1979-02-14,48702192Z,manuel.rodríguez@smartdev.org,107107,ES88209540227161223022,1256.82,2024-10-08T09:30:07,Vitoria-Gasteiz,expenses,electricity,-19.71,-76279.24
buyer_6,Manuel,Rodríguez,1979-02-14,48702192Z,manuel.rodríguez@smartdev.org,107107,ES88209540227161223022,1256.82,2024-10-08T10:35:00,Vitoria-Gasteiz,expenses,internet,-29.11,-76308.35
buyer_6,Manuel,Rodríguez,1979-02-14,48702192Z,manuel.rodríguez@smartdev.org,107107,ES88209540227161223022,1256.82,2024-10-09T00:54:43,Vitoria-Gasteiz,expenses,food,-124.86,-76433.21
buyer_7,María,Valdec,1968-12-31,02529745K,maría.valdec@hyperdev.site,875013,ES22209506301220461003,7234.17,2022-01-01T10:45:01,Portugalete,incomes,salary,1531.2,8765.37
buyer_7,María,Valdec,1968-12-31,02529745K,maría.valdec@hyperdev.site,875013,ES22209506301220461003,7234.17,2022-01-03T09:09:02,Portugalete,expenses,food,-102.63,8662.74
buyer_7,María,Valdec,1968-12-31,02529745K,maría.valdec@hyperdev.site,875013,ES22209506301220461003,7234.17,2022-01-03T00:49:18,Portugalete,expenses,cash,-100.0,8562.74
buyer_7,María,Valdec,1968-12-31,02529745K,maría.valdec@hyperdev.site,875013,ES22209506301220461003,7234.17,2022-01-04T21:20:52,Portugalete,expenses,mortgage,-677.7,7885.04
buyer_7,María,Valdec,1968-12-31,02529745K,maría.valdec@hyperdev.site,875013,ES22209506301220461003,7234.17,2022-01-05T10:10:09,Portugalete,expenses,internet,-32.16,7852.88
buyer_7,María,Valdec,1968-12-31,02529745K,maría.valdec@hyperdev.site,875013,ES22209506301220461003,7234.17,2022-01-05T16:56:25,Portugalete,expenses,phone,-31.99,7820.89
buyer_7,María,Valdec,1968-12-31,02529745K,maría.valdec@hyperdev.site,875013,ES22209506301220461003,7234.17,2022-01-05T21:45:43,Portugalete,expenses,food,-93.59,7727.3
buyer_7,María,Valdec,1968-12-31,02529745K,maría.valdec@hyperdev.site,875013,ES22209506301220461003,7234.17,2022-01-06T08:34:39,Portugalete,expenses,water,-24.0,7703.3
buyer_7,María,Valdec,1968-12-31,02529745K,maría.valdec@hyperdev.site,875013,ES22209506301220461003,7234.17,2022-01-06T11:14:15,Portugalete,expenses,electricity,-54.35,7648.95
buyer_7,María,Valdec,1968-12-31,02529745K,maría.valdec@hyperdev.site,875013,ES22209506301220461003,7234.17,2022-01-07T12:00:59,Portugalete,expenses,cash,-100.0,7548.95
buyer_7,María,Valdec,1968-12-31,02529745K,maría.valdec@hyperdev.site,875013,ES22209506301220461003,7234.17,2022-01-08T20:54:52,Portugalete,expenses,gas,-72.3,7476.65
buyer_7,María,Valdec,1968-12-31,02529745K,maría.valdec@hyperdev.site,875013,ES22209506301220461003,7234.17,2022-01-09T13:15:46,Portugalete,expenses,transport,-61.33,7415.32
buyer_7,María,Valdec,1968-12-31,02529745K,maría.valdec@hyperdev.site,875013,ES22209506301220461003,7234.17,2022-01-09T08:45:20,Portugalete,expenses,leisure,-25.6,7389.72
buyer_7,María,Valdec,1968-12-31,02529745K,maría.valdec@hyperdev.site,875013,ES22209506301220461003,7234.17,2022-01-09T06:43:20,Portugalete,expenses,clothing,-147.83,7241.89
buyer_7,María,Valdec,1968-12-31,02529745K,maría.valdec@hyperdev.site,875013,ES22209506301220461003,7234.17,2022-01-10T16:01:18,Portugalete,expenses,travel,-329.55,6912.34
buyer_7,María,Valdec,1968-12-31,02529745K,maría.valdec@hyperdev.site,875013,ES22209506301220461003,7234.17,2022-01-10T11:42:06,Portugalete,expenses,appliances,-73.47,6838.87
buyer_7,María,Valdec,1968-12-31,02529745K,maría.valdec@hyperdev.site,875013,ES22209506301220461003,7234.17,2022-01-11T10:41:53,Portugalete,expenses,food,-86.96,6751.91
buyer_7,María,Valdec,1968-12-31,02529745K,maría.valdec@hyperdev.site,875013,ES22209506301220461003,7234.17,2022-01-13T22:43:24,Portugalete,expenses,gifts,-122.6,6629.31
buyer_7,María,Valdec,1968-12-31,02529745K,maría.valdec@hyperdev.site,875013,ES22209506301220461003,7234.17,2022-01-15T10:35:41,Portugalete,expenses,transport,-48.83,6580.48
buyer_7,María,Valdec,1968-12-31,02529745K,maría.valdec@hyperdev.site,875013,ES22209506301220461003,7234.17,2022-01-18T20:45:46,Portugalete,expenses,food,-124.2,6456.28
buyer_7,María,Valdec,1968-12-31,02529745K,maría.valdec@hyperdev.site,875013,ES22209506301220461003,7234.17,2022-01-19T10:41:46,Portugalete,expenses,leisure,-40.83,6415.45
buyer_7,María,Valdec,1968-12-31,02529745K,maría.valdec@hyperdev.site,875013,ES22209506301220461003,7234.17,2022-01-20T23:14:36,Portugalete,expenses,appliances,-280.18,6135.27
buyer_7,María,Valdec,1968-12-31,02529745K,maría.valdec@hyperdev.site,875013,ES22209506301220461003,7234.17,2022-01-22T16:13:59,Portugalete,expenses,cash,-100.0,6035.27
buyer_7,María,Valdec,1968-12-31,02529745K,maría.valdec@hyperdev.site,875013,ES22209506301220461003,7234.17,2022-01-23T00:40:24,Portugalete,expenses,cash,-100.0,5935.27
buyer_7,María,Valdec,1968-12-31,02529745K,maría.valdec@hyperdev.site,875013,ES22209506301220461003,7234.17,2022-01-24T18:47:28,Portugalete,expenses,transport,-53.72,5881.55
buyer_7,María,Valdec,1968-12-31,02529745K,maría.valdec@hyperdev.site,875013,ES22209506301220461003,7234.17,2022-01-27T13:40:07,Portugalete,expenses,leisure,-62.08,5819.47
buyer_7,María,Valdec,1968-12-31,02529745K,maría.valdec@hyperdev.site,875013,ES22209506301220461003,7234.17,2022-01-27T20:05:27,Portugalete,expenses,cash,-100.0,5719.47
buyer_7,María,Valdec,1968-12-31,02529745K,maría.valdec@hyperdev.site,875013,ES22209506301220461003,7234.17,2022-01-28T20:51:20,Portugalete,expenses,leisure,-80.76,5638.71
buyer_7,María,Valdec,1968-12-31,02529745K,maría.valdec@hyperdev.site,875013,ES22209506301220461003,7234.17,2022-01-28T13:08:44,Portugalete,expenses,clothing,-155.81,5482.9
buyer_7,María,Valdec,1968-12-31,02529745K,maría.valdec@hyperdev.site,875013,ES22209506301220461003,7234.17,2022-01-29T08:12:14,Portugalete,expenses,food,-123.47,5359.43
buyer_7,María,Valdec,1968-12-31,02529745K,maría.valdec@hyperdev.site,875013,ES22209506301220461003,7234.17,2022-02-01T00:46:55,Portugalete,incomes,salary,1531.2,6890.63
buyer_7,María,Valdec,1968-12-31,02529745K,maría.valdec@hyperdev.site,875013,ES22209506301220461003,7234.17,2022-02-03T16:34:35,Portugalete,expenses,healthcare,-88.08,6802.55
buyer_7,María,Valdec,1968-12-31,02529745K,maría.valdec@hyperdev.site,875013,ES22209506301220461003,7234.17,2022-02-04T01:46:37,Portugalete,expenses,mortgage,-677.7,6124.85
buyer_7,María,Valdec,1968-12-31,02529745K,maría.valdec@hyperdev.site,875013,ES22209506301220461003,7234.17,2022-02-04T09:44:55,Portugalete,expenses,food,-106.34,6018.51
buyer_7,María,Valdec,1968-12-31,02529745K,maría.valdec@hyperdev.site,875013,ES22209506301220461003,7234.17,2022-02-04T11:55:15,Portugalete,expenses,education,-69.29,5949.22
buyer_7,María,Valdec,1968-12-31,02529745K,maría.valdec@hyperdev.site,875013,ES22209506301220461003,7234.17,2022-02-05T10:57:45,Portugalete,expenses,gas,-25.1,5924.12
buyer_7,María,Valdec,1968-12-31,02529745K,maría.valdec@hyperdev.site,875013,ES22209506301220461003,7234.17,2022-02-05T14:03:22,Portugalete,expenses,phone,-29.72,5894.4
buyer_7,María,Valdec,1968-12-31,02529745K,maría.valdec@hyperdev.site,875013,ES22209506301220461003,7234.17,2022-02-05T09:57:50,Portugalete,expenses,gifts,-345.32,5549.08
buyer_7,María,Valdec,1968-12-31,02529745K,maría.valdec@hyperdev.site,875013,ES22209506301220461003,7234.17,2022-02-06T15:53:02,Portugalete,expenses,water,-24.56,5524.52
buyer_7,María,Valdec,1968-12-31,02529745K,maría.valdec@hyperdev.site,875013,ES22209506301220461003,7234.17,2022-02-06T16:04:03,Portugalete,expenses,electricity,-58.99,5465.53
buyer_7,María,Valdec,1968-12-31,02529745K,maría.valdec@hyperdev.site,875013,ES22209506301220461003,7234.17,2022-02-06T14:18:22,Portugalete,expenses,leisure,-52.06,5413.47
buyer_7,María,Valdec,1968-12-31,02529745K,maría.valdec@hyperdev.site,875013,ES22209506301220461003,7234.17,2022-02-08T13:09:55,Portugalete,expenses,internet,-32.16,5381.31
buyer_7,María,Valdec,1968-12-31,02529745K,maría.valdec@hyperdev.site,875013,ES22209506301220461003,7234.17,2022-02-10T18:27:57,Portugalete,expenses,leisure,-19.94,5361.37
buyer_7,María,Valdec,1968-12-31,02529745K,maría.valdec@hyperdev.site,875013,ES22209506301220461003,7234.17,2022-02-10T17:54:12,Portugalete,expenses,appliances,-231.74,5129.63
buyer_7,María,Valdec,1968-12-31,02529745K,maría.valdec@hyperdev.site,875013,ES22209506301220461003,7234.17,2022-02-11T19:19:39,Portugalete,expenses,clothing,-53.79,5075.84
buyer_7,María,Valdec,1968-12-31,02529745K,maría.valdec@hyperdev.site,875013,ES22209506301220461003,7234.17,2022-02-11T14:51:00,Portugalete,expenses,cash,-100.0,4975.84
buyer_7,María,Valdec,1968-12-31,02529745K,maría.valdec@hyperdev.site,875013,ES22209506301220461003,7234.17,2022-02-11T13:17:59,Portugalete,expenses,children,-177.03,4798.81
buyer_7,María,Valdec,1968-12-31,02529745K,maría.valdec@hyperdev.site,875013,ES22209506301220461003,7234.17,2022-02-12T05:16:51,Portugalete,expenses,food,-64.78,4734.03
buyer_7,María,Valdec,1968-12-31,02529745K,maría.valdec@hyperdev.site,875013,ES22209506301220461003,7234.17,2022-02-12T05:26:26,Portugalete,expenses,cash,-100.0,4634.03
buyer_7,María,Valdec,1968-12-31,02529745K,maría.valdec@hyperdev.site,875013,ES22209506301220461003,7234.17,2022-02-13T19:36:32,Portugalete,expenses,cash,-100.0,4534.03
buyer_7,María,Valdec,1968-12-31,02529745K,maría.valdec@hyperdev.site,875013,ES22209506301220461003,7234.17,2022-02-14T16:41:23,Portugalete,expenses,leisure,-42.19,4491.84
buyer_7,María,Valdec,1968-12-31,02529745K,maría.valdec@hyperdev.site,875013,ES22209506301220461003,7234.17,2022-02-14T08:20:22,Portugalete,expenses,cash,-100.0,4391.84
buyer_7,María,Valdec,1968-12-31,02529745K,maría.valdec@hyperdev.site,875013,ES22209506301220461003,7234.17,2022-02-17T23:14:09,Portugalete,expenses,food,-91.54,4300.3
buyer_7,María,Valdec,1968-12-31,02529745K,maría.valdec@hyperdev.site,875013,ES22209506301220461003,7234.17,2022-02-17T12:53:50,Portugalete,expenses,repairs,-215.57,4084.73
buyer_7,María,Valdec,1968-12-31,02529745K,maría.valdec@hyperdev.site,875013,ES22209506301220461003,7234.17,2022-02-18T13:11:32,Portugalete,expenses,transport,-71.35,4013.38
buyer_7,María,Valdec,1968-12-31,02529745K,maría.valdec@hyperdev.site,875013,ES22209506301220461003,7234.17,2022-02-19T18:52:00,Portugalete,expenses,leisure,-43.75,3969.63
buyer_7,María,Valdec,1968-12-31,02529745K,maría.valdec@hyperdev.site,875013,ES22209506301220461003,7234.17,2022-02-19T20:40:02,Portugalete,expenses,gifts,-69.4,3900.23
buyer_7,María,Valdec,1968-12-31,02529745K,maría.valdec@hyperdev.site,875013,ES22209506301220461003,7234.17,2022-02-22T15:02:55,Portugalete,expenses,food,-60.51,3839.72
buyer_7,María,Valdec,1968-12-31,02529745K,maría.valdec@hyperdev.site,875013,ES22209506301220461003,7234.17,2022-02-22T18:16:23,Portugalete,expenses,repairs,-99.15,3740.57
buyer_7,María,Valdec,1968-12-31,02529745K,maría.valdec@hyperdev.site,875013,ES22209506301220461003,7234.17,2022-02-23T17:07:00,Portugalete,expenses,cash,-100.0,3640.57
buyer_7,María,Valdec,1968-12-31,02529745K,maría.valdec@hyperdev.site,875013,ES22209506301220461003,7234.17,2022-02-23T21:06:04,Portugalete,expenses,gifts,-245.04,3395.53
buyer_7,María,Valdec,1968-12-31,02529745K,maría.valdec@hyperdev.site,875013,ES22209506301220461003,7234.17,2022-02-25T11:17:05,Portugalete,expenses,leisure,-84.63,3310.9
buyer_7,María,Valdec,1968-12-31,02529745K,maría.valdec@hyperdev.site,875013,ES22209506301220461003,7234.17,2022-02-26T18:12:36,Portugalete,expenses,clothing,-62.83,3248.07
buyer_7,María,Valdec,1968-12-31,02529745K,maría.valdec@hyperdev.site,875013,ES22209506301220461003,7234.17,2022-02-26T10:01:14,Portugalete,expenses,cash,-100.0,3148.07
buyer_7,María,Valdec,1968-12-31,02529745K,maría.valdec@hyperdev.site,875013,ES22209506301220461003,7234.17,2022-02-27T09:59:28,Portugalete,expenses,transport,-68.64,3079.43
buyer_7,María,Valdec,1968-12-31,02529745K,maría.valdec@hyperdev.site,875013,ES22209506301220461003,7234.17,2022-02-27T17:11:10,Portugalete,expenses,clothing,-102.86,2976.57
buyer_7,María,Valdec,1968-12-31,02529745K,maría.valdec@hyperdev.site,875013,ES22209506301220461003,7234.17,2022-02-27T20:14:10,Portugalete,expenses,cash,-100.0,2876.57
buyer_7,María,Valdec,1968-12-31,02529745K,maría.valdec@hyperdev.site,875013,ES22209506301220461003,7234.17,2022-03-01T09:43:20,Portugalete,incomes,salary,1531.2,4407.77
buyer_7,María,Valdec,1968-12-31,02529745K,maría.valdec@hyperdev.site,875013,ES22209506301220461003,7234.17,2022-03-01T09:43:20,Portugalete,incomes,extra_income,208.35,4616.12
buyer_7,María,Valdec,1968-12-31,02529745K,maría.valdec@hyperdev.site,875013,ES22209506301220461003,7234.17,2022-03-01T15:10:27,Portugalete,expenses,leisure,-83.0,4533.12
buyer_7,María,Valdec,1968-12-31,02529745K,maría.valdec@hyperdev.site,875013,ES22209506301220461003,7234.17,2022-03-04T10:14:52,Portugalete,expenses,mortgage,-677.7,3855.42
buyer_7,María,Valdec,1968-12-31,02529745K,maría.valdec@hyperdev.site,875013,ES22209506301220461003,7234.17,2022-03-04T20:53:45,Portugalete,expenses,transport,-73.01,3782.41
buyer_7,María,Valdec,1968-12-31,02529745K,maría.valdec@hyperdev.site,875013,ES22209506301220461003,7234.17,2022-03-05T14:29:03,Portugalete,expenses,electricity,-41.19,3741.22
buyer_7,María,Valdec,1968-12-31,02529745K,maría.valdec@hyperdev.site,875013,ES22209506301220461003,7234.17,2022-03-06T08:37:45,Portugalete,expenses,gas,-59.38,3681.84
buyer_7,María,Valdec,1968-12-31,02529745K,maría.valdec@hyperdev.site,875013,ES22209506301220461003,7234.17,2022-03-06T13:17:14,Portugalete,expenses,phone,-28.74,3653.1
buyer_7,María,Valdec,1968-12-31,02529745K,maría.valdec@hyperdev.site,875013,ES22209506301220461003,7234.17,2022-03-08T18:32:32,Portugalete,expenses,water,-31.76,3621.34
buyer_7,María,Valdec,1968-12-31,02529745K,maría.valdec@hyperdev.site,875013,ES22209506301220461003,7234.17,2022-03-08T09:31:27,Portugalete,expenses,internet,-32.16,3589.18
buyer_7,María,Valdec,1968-12-31,02529745K,maría.valdec@hyperdev.site,875013,ES22209506301220461003,7234.17,2022-03-08T08:06:10,Portugalete,expenses,food,-61.44,3527.74
buyer_7,María,Valdec,1968-12-31,02529745K,maría.valdec@hyperdev.site,875013,ES22209506301220461003,7234.17,2022-03-08T14:06:39,Portugalete,expenses,transport,-77.54,3450.2
buyer_7,María,Valdec,1968-12-31,02529745K,maría.valdec@hyperdev.site,875013,ES22209506301220461003,7234.17,2022-03-10T08:27:15,Portugalete,expenses,food,-77.24,3372.96
buyer_7,María,Valdec,1968-12-31,02529745K,maría.valdec@hyperdev.site,875013,ES22209506301220461003,7234.17,2022-03-11T10:14:23,Portugalete,expenses,transport,-76.93,3296.03
buyer_7,María,Valdec,1968-12-31,02529745K,maría.valdec@hyperdev.site,875013,ES22209506301220461003,7234.17,2022-03-11T16:22:10,Portugalete,expenses,healthcare,-102.32,3193.71
buyer_7,María,Valdec,1968-12-31,02529745K,maría.valdec@hyperdev.site,875013,ES22209506301220461003,7234.17,2022-03-11T22:13:28,Portugalete,expenses,children,-128.96,3064.75
buyer_7,María,Valdec,1968-12-31,02529745K,maría.valdec@hyperdev.site,875013,ES22209506301220461003,7234.17,2022-03-13T12:18:15,Portugalete,expenses,transport,-65.43,2999.32
buyer_7,María,Valdec,1968-12-31,02529745K,maría.valdec@hyperdev.site,875013,ES22209506301220461003,7234.17,2022-03-15T10:17:33,Portugalete,expenses,food,-90.52,2908.8
buyer_7,María,Valdec,1968-12-31,02529745K,maría.valdec@hyperdev.site,875013,ES22209506301220461003,7234.17,2022-03-15T23:28:11,Portugalete,expenses,appliances,-130.02,2778.78
buyer_7,María,Valdec,1968-12-31,02529745K,maría.valdec@hyperdev.site,875013,ES22209506301220461003,7234.17,2022-03-18T17:23:27,Portugalete,expenses,food,-75.25,2703.53
buyer_7,María,Valdec,1968-12-31,02529745K,maría.valdec@hyperdev.site,875013,ES22209506301220461003,7234.17,2022-03-19T16:08:33,Portugalete,expenses,food,-85.48,2618.05
buyer_7,María,Valdec,1968-12-31,02529745K,maría.valdec@hyperdev.site,875013,ES22209506301220461003,7234.17,2022-03-19T14:53:55,Portugalete,expenses,leisure,-65.72,2552.33
buyer_7,María,Valdec,1968-12-31,02529745K,maría.valdec@hyperdev.site,875013,ES22209506301220461003,7234.17,2022-03-19T10:47:57,Portugalete,expenses,clothing,-126.51,2425.82
buyer_7,María,Valdec,1968-12-31,02529745K,maría.valdec@hyperdev.site,875013,ES22209506301220461003,7234.17,2022-03-21T10:18:00,Portugalete,expenses,transport,-49.38,2376.44
buyer_7,María,Valdec,1968-12-31,02529745K,maría.valdec@hyperdev.site,875013,ES22209506301220461003,7234.17,2022-03-21T12:46:16,Portugalete,expenses,leisure,-27.54,2348.9
buyer_7,María,Valdec,1968-12-31,02529745K,maría.valdec@hyperdev.site,875013,ES22209506301220461003,7234.17,2022-03-23T18:41:00,Portugalete,expenses,food,-91.43,2257.47
buyer_7,María,Valdec,1968-12-31,02529745K,maría.valdec@hyperdev.site,875013,ES22209506301220461003,7234.17,2022-03-24T09:01:48,Portugalete,expenses,leisure,-71.12,2186.35
buyer_7,María,Valdec,1968-12-31,02529745K,maría.valdec@hyperdev.site,875013,ES22209506301220461003,7234.17,2022-03-24T12:25:09,Portugalete,expenses,cash,-100.0,2086.35
buyer_7,María,Valdec,1968-12-31,02529745K,maría.valdec@hyperdev.site,875013,ES22209506301220461003,7234.17,2022-03-25T20:22:45,Portugalete,expenses,leisure,-28.17,2058.18
buyer_7,María,Valdec,1968-12-31,02529745K,maría.valdec@hyperdev.site,875013,ES22209506301220461003,7234.17,2022-03-25T14:50:02,Portugalete,expenses,education,-54.81,2003.37
buyer_7,María,Valdec,1968-12-31,02529745K,maría.valdec@hyperdev.site,875013,ES22209506301220461003,7234.17,2022-03-25T05:36:33,Portugalete,expenses,cash,-100.0,1903.37
buyer_7,María,Valdec,1968-12-31,02529745K,maría.valdec@hyperdev.site,875013,ES22209506301220461003,7234.17,2022-03-30T12:40:56,Portugalete,expenses,transport,-69.01,1834.36
buyer_7,María,Valdec,1968-12-31,02529745K,maría.valdec@hyperdev.site,875013,ES22209506301220461003,7234.17,2022-03-31T18:59:19,Portugalete,expenses,food,-95.73,1738.63
buyer_7,María,Valdec,1968-12-31,02529745K,maría.valdec@hyperdev.site,875013,ES22209506301220461003,7234.17,2022-03-31T10:55:53,Portugalete,expenses,transport,-48.09,1690.54
buyer_7,María,Valdec,1968-12-31,02529745K,maría.valdec@hyperdev.site,875013,ES22209506301220461003,7234.17,2022-04-01T12:39:06,Portugalete,incomes,salary,1531.2,3221.74
buyer_7,María,Valdec,1968-12-31,02529745K,maría.valdec@hyperdev.site,875013,ES22209506301220461003,7234.17,2022-04-02T19:04:24,Portugalete,expenses,appliances,-107.07,3114.67
buyer_7,María,Valdec,1968-12-31,02529745K,maría.valdec@hyperdev.site,875013,ES22209506301220461003,7234.17,2022-04-02T19:50:28,Portugalete,expenses,gifts,-97.0,3017.67
buyer_7,María,Valdec,1968-12-31,02529745K,maría.valdec@hyperdev.site,875013,ES22209506301220461003,7234.17,2022-04-04T05:36:26,Portugalete,expenses,mortgage,-677.7,2339.97
buyer_7,María,Valdec,1968-12-31,02529745K,maría.valdec@hyperdev.site,875013,ES22209506301220461003,7234.17,2022-04-04T11:57:43,Portugalete,expenses,food,-98.74,2241.23
buyer_7,María,Valdec,1968-12-31,02529745K,maría.valdec@hyperdev.site,875013,ES22209506301220461003,7234.17,2022-04-05T19:27:59,Portugalete,expenses,phone,-27.56,2213.67
buyer_7,María,Valdec,1968-12-31,02529745K,maría.valdec@hyperdev.site,875013,ES22209506301220461003,7234.17,2022-04-05T17:38:58,Portugalete,expenses,transport,-70.32,2143.35
buyer_7,María,Valdec,1968-12-31,02529745K,maría.valdec@hyperdev.site,875013,ES22209506301220461003,7234.17,2022-04-05T14:01:59,Portugalete,expenses,repairs,-45.04,2098.31
buyer_7,María,Valdec,1968-12-31,02529745K,maría.valdec@hyperdev.site,875013,ES22209506301220461003,7234.17,2022-04-06T15:25:56,Portugalete,expenses,water,-19.75,2078.56
buyer_7,María,Valdec,1968-12-31,02529745K,maría.valdec@hyperdev.site,875013,ES22209506301220461003,7234.17,2022-04-06T15:52:08,Portugalete,expenses,clothing,-62.15,2016.41
buyer_7,María,Valdec,1968-12-31,02529745K,maría.valdec@hyperdev.site,875013,ES22209506301220461003,7234.17,2022-04-08T17:29:19,Portugalete,expenses,electricity,-62.08,1954.33
buyer_7,María,Valdec,1968-12-31,02529745K,maría.valdec@hyperdev.site,875013,ES22209506301220461003,7234.17,2022-04-08T11:15:46,Portugalete,expenses,gas,-60.6,1893.73
buyer_7,María,Valdec,1968-12-31,02529745K,maría.valdec@hyperdev.site,875013,ES22209506301220461003,7234.17,2022-04-08T08:55:29,Portugalete,expenses,internet,-32.16,1861.57
buyer_7,María,Valdec,1968-12-31,02529745K,maría.valdec@hyperdev.site,875013,ES22209506301220461003,7234.17,2022-04-10T10:12:08,Portugalete,expenses,repairs,-29.38,1832.19
buyer_7,María,Valdec,1968-12-31,02529745K,maría.valdec@hyperdev.site,875013,ES22209506301220461003,7234.17,2022-04-15T13:31:29,Portugalete,expenses,leisure,-47.28,1784.91
buyer_7,María,Valdec,1968-12-31,02529745K,maría.valdec@hyperdev.site,875013,ES22209506301220461003,7234.17,2022-04-15T17:56:34,Portugalete,expenses,cash,-100.0,1684.91
buyer_7,María,Valdec,1968-12-31,02529745K,maría.valdec@hyperdev.site,875013,ES22209506301220461003,7234.17,2022-04-18T23:23:57,Portugalete,expenses,food,-93.11,1591.8
buyer_7,María,Valdec,1968-12-31,02529745K,maría.valdec@hyperdev.site,875013,ES22209506301220461003,7234.17,2022-04-19T23:32:32,Portugalete,expenses,leisure,-45.15,1546.65
buyer_7,María,Valdec,1968-12-31,02529745K,maría.valdec@hyperdev.site,875013,ES22209506301220461003,7234.17,2022-04-21T12:31:52,Portugalete,expenses,children,-268.63,1278.02
buyer_7,María,Valdec,1968-12-31,02529745K,maría.valdec@hyperdev.site,875013,ES22209506301220461003,7234.17,2022-04-22T10:05:02,Portugalete,expenses,food,-114.84,1163.18
buyer_7,María,Valdec,1968-12-31,02529745K,maría.valdec@hyperdev.site,875013,ES22209506301220461003,7234.17,2022-04-23T17:25:17,Portugalete,expenses,food,-61.53,1101.65
buyer_7,María,Valdec,1968-12-31,02529745K,maría.valdec@hyperdev.site,875013,ES22209506301220461003,7234.17,2022-04-23T11:43:39,Portugalete,expenses,healthcare,-111.25,990.4
buyer_7,María,Valdec,1968-12-31,02529745K,maría.valdec@hyperdev.site,875013,ES22209506301220461003,7234.17,2022-04-24T09:42:19,Portugalete,expenses,food,-102.82,887.58
buyer_7,María,Valdec,1968-12-31,02529745K,maría.valdec@hyperdev.site,875013,ES22209506301220461003,7234.17,2022-04-27T16:46:51,Portugalete,expenses,cash,-100.0,787.58
buyer_7,María,Valdec,1968-12-31,02529745K,maría.valdec@hyperdev.site,875013,ES22209506301220461003,7234.17,2022-04-27T06:20:03,Portugalete,expenses,travel,-281.6,505.98
buyer_7,María,Valdec,1968-12-31,02529745K,maría.valdec@hyperdev.site,875013,ES22209506301220461003,7234.17,2022-04-28T16:41:07,Portugalete,expenses,gifts,-341.6,164.38
buyer_7,María,Valdec,1968-12-31,02529745K,maría.valdec@hyperdev.site,875013,ES22209506301220461003,7234.17,2022-04-29T20:08:46,Portugalete,expenses,cash,-100.0,64.38
buyer_7,María,Valdec,1968-12-31,02529745K,maría.valdec@hyperdev.site,875013,ES22209506301220461003,7234.17,2022-04-30T20:02:47,Portugalete,expenses,food,-72.14,-7.76
buyer_7,María,Valdec,1968-12-31,02529745K,maría.valdec@hyperdev.site,875013,ES22209506301220461003,7234.17,2022-05-01T17:50:57,Portugalete,incomes,salary,1531.2,1523.44
buyer_7,María,Valdec,1968-12-31,02529745K,maría.valdec@hyperdev.site,875013,ES22209506301220461003,7234.17,2022-05-02T14:00:57,Portugalete,expenses,cash,-100.0,1423.44
buyer_7,María,Valdec,1968-12-31,02529745K,maría.valdec@hyperdev.site,875013,ES22209506301220461003,7234.17,2022-05-04T19:24:58,Portugalete,expenses,mortgage,-677.7,745.74
buyer_7,María,Valdec,1968-12-31,02529745K,maría.valdec@hyperdev.site,875013,ES22209506301220461003,7234.17,2022-05-04T07:42:08,Portugalete,expenses,cash,-100.0,645.74
buyer_7,María,Valdec,1968-12-31,02529745K,maría.valdec@hyperdev.site,875013,ES22209506301220461003,7234.17,2022-05-05T02:11:32,Portugalete,expenses,electricity,-23.19,622.55
buyer_7,María,Valdec,1968-12-31,02529745K,maría.valdec@hyperdev.site,875013,ES22209506301220461003,7234.17,2022-05-05T16:18:03,Portugalete,expenses,internet,-32.16,590.39
buyer_7,María,Valdec,1968-12-31,02529745K,maría.valdec@hyperdev.site,875013,ES22209506301220461003,7234.17,2022-05-07T11:17:24,Portugalete,expenses,water,-25.93,564.46
buyer_7,María,Valdec,1968-12-31,02529745K,maría.valdec@hyperdev.site,875013,ES22209506301220461003,7234.17,2022-05-07T11:16:04,Portugalete,expenses,phone,-29.65,534.81
buyer_7,María,Valdec,1968-12-31,02529745K,maría.valdec@hyperdev.site,875013,ES22209506301220461003,7234.17,2022-05-07T14:02:59,Portugalete,expenses,education,-58.21,476.6
buyer_7,María,Valdec,1968-12-31,02529745K,maría.valdec@hyperdev.site,875013,ES22209506301220461003,7234.17,2022-05-08T14:55:43,Portugalete,expenses,gas,-33.7,442.9
buyer_7,María,Valdec,1968-12-31,02529745K,maría.valdec@hyperdev.site,875013,ES22209506301220461003,7234.17,2022-05-08T20:06:05,Portugalete,expenses,leisure,-26.02,416.88
buyer_7,María,Valdec,1968-12-31,02529745K,maría.valdec@hyperdev.site,875013,ES22209506301220461003,7234.17,2022-05-08T19:27:30,Portugalete,expenses,repairs,-27.46,389.42
buyer_7,María,Valdec,1968-12-31,02529745K,maría.valdec@hyperdev.site,875013,ES22209506301220461003,7234.17,2022-05-09T15:48:29,Portugalete,expenses,leisure,-82.86,306.56
buyer_7,María,Valdec,1968-12-31,02529745K,maría.valdec@hyperdev.site,875013,ES22209506301220461003,7234.17,2022-05-10T08:42:16,Portugalete,expenses,leisure,-25.22,281.34
buyer_7,María,Valdec,1968-12-31,02529745K,maría.valdec@hyperdev.site,875013,ES22209506301220461003,7234.17,2022-05-10T15:31:12,Portugalete,expenses,cash,-100.0,181.34
buyer_7,María,Valdec,1968-12-31,02529745K,maría.valdec@hyperdev.site,875013,ES22209506301220461003,7234.17,2022-05-11T14:38:04,Portugalete,expenses,transport,-88.89,92.45
buyer_7,María,Valdec,1968-12-31,02529745K,maría.valdec@hyperdev.site,875013,ES22209506301220461003,7234.17,2022-05-11T16:05:48,Portugalete,expenses,leisure,-18.58,73.87
buyer_7,María,Valdec,1968-12-31,02529745K,maría.valdec@hyperdev.site,875013,ES22209506301220461003,7234.17,2022-05-14T19:31:01,Portugalete,expenses,food,-87.09,-13.22
buyer_7,María,Valdec,1968-12-31,02529745K,maría.valdec@hyperdev.site,875013,ES22209506301220461003,7234.17,2022-05-14T14:22:26,Portugalete,expenses,travel,-281.58,-294.8
buyer_7,María,Valdec,1968-12-31,02529745K,maría.valdec@hyperdev.site,875013,ES22209506301220461003,7234.17,2022-05-15T19:14:51,Portugalete,expenses,transport,-82.22,-377.02
buyer_7,María,Valdec,1968-12-31,02529745K,maría.valdec@hyperdev.site,875013,ES22209506301220461003,7234.17,2022-05-16T00:48:45,Portugalete,expenses,healthcare,-45.21,-422.23
buyer_7,María,Valdec,1968-12-31,02529745K,maría.valdec@hyperdev.site,875013,ES22209506301220461003,7234.17,2022-05-17T14:29:42,Portugalete,expenses,cash,-100.0,-522.23
buyer_7,María,Valdec,1968-12-31,02529745K,maría.valdec@hyperdev.site,875013,ES22209506301220461003,7234.17,2022-05-17T02:25:07,Portugalete,expenses,travel,-281.7,-803.93
buyer_7,María,Valdec,1968-12-31,02529745K,maría.valdec@hyperdev.site,875013,ES22209506301220461003,7234.17,2022-05-21T17:46:10,Portugalete,expenses,healthcare,-52.86,-856.79
buyer_7,María,Valdec,1968-12-31,02529745K,maría.valdec@hyperdev.site,875013,ES22209506301220461003,7234.17,2022-05-24T04:06:29,Portugalete,expenses,transport,-82.61,-939.4
buyer_7,María,Valdec,1968-12-31,02529745K,maría.valdec@hyperdev.site,875013,ES22209506301220461003,7234.17,2022-05-31T15:45:52,Portugalete,expenses,food,-76.02,-1015.42
buyer_7,María,Valdec,1968-12-31,02529745K,maría.valdec@hyperdev.site,875013,ES22209506301220461003,7234.17,2022-06-01T15:00:31,Portugalete,incomes,salary,1531.2,515.78
buyer_7,María,Valdec,1968-12-31,02529745K,maría.valdec@hyperdev.site,875013,ES22209506301220461003,7234.17,2022-06-01T15:00:31,Portugalete,incomes,salary_bonus,1202.88,1718.66
buyer_7,María,Valdec,1968-12-31,02529745K,maría.valdec@hyperdev.site,875013,ES22209506301220461003,7234.17,2022-06-01T18:11:44,Portugalete,expenses,clothing,-93.39,1625.27
buyer_7,María,Valdec,1968-12-31,02529745K,maría.valdec@hyperdev.site,875013,ES22209506301220461003,7234.17,2022-06-01T12:07:43,Portugalete,expenses,gifts,-289.14,1336.13
buyer_7,María,Valdec,1968-12-31,02529745K,maría.valdec@hyperdev.site,875013,ES22209506301220461003,7234.17,2022-06-03T17:19:53,Portugalete,expenses,transport,-86.62,1249.51
buyer_7,María,Valdec,1968-12-31,02529745K,maría.valdec@hyperdev.site,875013,ES22209506301220461003,7234.17,2022-06-04T17:16:14,Portugalete,expenses,mortgage,-677.7,571.81
buyer_7,María,Valdec,1968-12-31,02529745K,maría.valdec@hyperdev.site,875013,ES22209506301220461003,7234.17,2022-06-04T20:00:45,Portugalete,expenses,leisure,-67.72,504.09
buyer_7,María,Valdec,1968-12-31,02529745K,maría.valdec@hyperdev.site,875013,ES22209506301220461003,7234.17,2022-06-05T23:07:25,Portugalete,expenses,gas,-28.82,475.27
buyer_7,María,Valdec,1968-12-31,02529745K,maría.valdec@hyperdev.site,875013,ES22209506301220461003,7234.17,2022-06-05T18:57:26,Portugalete,expenses,internet,-32.16,443.11
buyer_7,María,Valdec,1968-12-31,02529745K,maría.valdec@hyperdev.site,875013,ES22209506301220461003,7234.17,2022-06-06T15:40:00,Portugalete,expenses,transport,-59.63,383.48
buyer_7,María,Valdec,1968-12-31,02529745K,maría.valdec@hyperdev.site,875013,ES22209506301220461003,7234.17,2022-06-08T10:04:06,Portugalete,expenses,water,-26.82,356.66
buyer_7,María,Valdec,1968-12-31,02529745K,maría.valdec@hyperdev.site,875013,ES22209506301220461003,7234.17,2022-06-08T20:38:49,Portugalete,expenses,electricity,-36.94,319.72
buyer_7,María,Valdec,1968-12-31,02529745K,maría.valdec@hyperdev.site,875013,ES22209506301220461003,7234.17,2022-06-08T12:53:29,Portugalete,expenses,phone,-26.63,293.09
buyer_7,María,Valdec,1968-12-31,02529745K,maría.valdec@hyperdev.site,875013,ES22209506301220461003,7234.17,2022-06-08T19:44:52,Portugalete,expenses,leisure,-54.7,238.39
buyer_7,María,Valdec,1968-12-31,02529745K,maría.valdec@hyperdev.site,875013,ES22209506301220461003,7234.17,2022-06-08T17:22:22,Portugalete,expenses,healthcare,-125.8,112.59
buyer_7,María,Valdec,1968-12-31,02529745K,maría.valdec@hyperdev.site,875013,ES22209506301220461003,7234.17,2022-06-08T16:24:46,Portugalete,expenses,cash,-100.0,12.59
buyer_7,María,Valdec,1968-12-31,02529745K,maría.valdec@hyperdev.site,875013,ES22209506301220461003,7234.17,2022-06-09T18:09:07,Portugalete,expenses,transport,-64.66,-52.07
buyer_7,María,Valdec,1968-12-31,02529745K,maría.valdec@hyperdev.site,875013,ES22209506301220461003,7234.17,2022-06-09T11:37:27,Portugalete,expenses,healthcare,-42.9,-94.97
buyer_7,María,Valdec,1968-12-31,02529745K,maría.valdec@hyperdev.site,875013,ES22209506301220461003,7234.17,2022-06-09T20:40:47,Portugalete,expenses,children,-146.15,-241.12
buyer_7,María,Valdec,1968-12-31,02529745K,maría.valdec@hyperdev.site,875013,ES22209506301220461003,7234.17,2022-06-10T11:49:31,Portugalete,expenses,transport,-59.6,-300.72
buyer_7,María,Valdec,1968-12-31,02529745K,maría.valdec@hyperdev.site,875013,ES22209506301220461003,7234.17,2022-06-10T15:07:18,Portugalete,expenses,repairs,-125.69,-426.41
buyer_7,María,Valdec,1968-12-31,02529745K,maría.valdec@hyperdev.site,875013,ES22209506301220461003,7234.17,2022-06-12T14:53:32,Portugalete,expenses,leisure,-76.52,-502.93
buyer_7,María,Valdec,1968-12-31,02529745K,maría.valdec@hyperdev.site,875013,ES22209506301220461003,7234.17,2022-06-13T16:21:08,Portugalete,expenses,travel,-332.35,-835.28
buyer_7,María,Valdec,1968-12-31,02529745K,maría.valdec@hyperdev.site,875013,ES22209506301220461003,7234.17,2022-06-14T23:17:21,Portugalete,expenses,food,-124.99,-960.27
buyer_7,María,Valdec,1968-12-31,02529745K,maría.valdec@hyperdev.site,875013,ES22209506301220461003,7234.17,2022-06-15T11:43:49,Portugalete,expenses,repairs,-144.57,-1104.84
buyer_7,María,Valdec,1968-12-31,02529745K,maría.valdec@hyperdev.site,875013,ES22209506301220461003,7234.17,2022-06-16T20:27:34,Portugalete,expenses,leisure,-63.59,-1168.43
buyer_7,María,Valdec,1968-12-31,02529745K,maría.valdec@hyperdev.site,875013,ES22209506301220461003,7234.17,2022-06-17T10:37:25,Portugalete,expenses,food,-71.12,-1239.55
buyer_7,María,Valdec,1968-12-31,02529745K,maría.valdec@hyperdev.site,875013,ES22209506301220461003,7234.17,2022-06-19T10:48:33,Portugalete,expenses,travel,-284.84,-1524.39
buyer_7,María,Valdec,1968-12-31,02529745K,maría.valdec@hyperdev.site,875013,ES22209506301220461003,7234.17,2022-06-20T17:22:42,Portugalete,expenses,repairs,-289.14,-1813.53
buyer_7,María,Valdec,1968-12-31,02529745K,maría.valdec@hyperdev.site,875013,ES22209506301220461003,7234.17,2022-06-23T18:02:05,Portugalete,expenses,repairs,-207.9,-2021.43
buyer_7,María,Valdec,1968-12-31,02529745K,maría.valdec@hyperdev.site,875013,ES22209506301220461003,7234.17,2022-06-25T16:57:04,Portugalete,expenses,cash,-100.0,-2121.43
buyer_7,María,Valdec,1968-12-31,02529745K,maría.valdec@hyperdev.site,875013,ES22209506301220461003,7234.17,2022-06-25T12:35:10,Portugalete,expenses,children,-121.52,-2242.95
buyer_7,María,Valdec,1968-12-31,02529745K,maría.valdec@hyperdev.site,875013,ES22209506301220461003,7234.17,2022-06-26T12:49:49,Portugalete,expenses,leisure,-38.42,-2281.37
buyer_7,María,Valdec,1968-12-31,02529745K,maría.valdec@hyperdev.site,875013,ES22209506301220461003,7234.17,2022-06-26T17:29:24,Portugalete,expenses,cash,-100.0,-2381.37
buyer_7,María,Valdec,1968-12-31,02529745K,maría.valdec@hyperdev.site,875013,ES22209506301220461003,7234.17,2022-06-26T09:47:35,Portugalete,expenses,car,-73.15,-2454.52
buyer_7,María,Valdec,1968-12-31,02529745K,maría.valdec@hyperdev.site,875013,ES22209506301220461003,7234.17,2022-06-27T18:36:40,Portugalete,expenses,education,-65.87,-2520.39
buyer_7,María,Valdec,1968-12-31,02529745K,maría.valdec@hyperdev.site,875013,ES22209506301220461003,7234.17,2022-06-28T08:35:52,Portugalete,expenses,cash,-100.0,-2620.39
buyer_7,María,Valdec,1968-12-31,02529745K,maría.valdec@hyperdev.site,875013,ES22209506301220461003,7234.17,2022-07-01T17:30:56,Portugalete,incomes,salary,1531.2,-1089.19
buyer_7,María,Valdec,1968-12-31,02529745K,maría.valdec@hyperdev.site,875013,ES22209506301220461003,7234.17,2022-07-01T17:30:56,Portugalete,incomes,extra_income,208.35,-880.84
buyer_7,María,Valdec,1968-12-31,02529745K,maría.valdec@hyperdev.site,875013,ES22209506301220461003,7234.17,2022-07-01T21:35:25,Portugalete,expenses,children,-270.74,-1151.58
buyer_7,María,Valdec,1968-12-31,02529745K,maría.valdec@hyperdev.site,875013,ES22209506301220461003,7234.17,2022-07-03T13:47:30,Portugalete,expenses,children,-235.33,-1386.91
buyer_7,María,Valdec,1968-12-31,02529745K,maría.valdec@hyperdev.site,875013,ES22209506301220461003,7234.17,2022-07-04T19:18:47,Portugalete,expenses,mortgage,-677.7,-2064.61
buyer_7,María,Valdec,1968-12-31,02529745K,maría.valdec@hyperdev.site,875013,ES22209506301220461003,7234.17,2022-07-04T19:02:31,Portugalete,expenses,cash,-100.0,-2164.61
buyer_7,María,Valdec,1968-12-31,02529745K,maría.valdec@hyperdev.site,875013,ES22209506301220461003,7234.17,2022-07-04T17:59:38,Portugalete,expenses,gifts,-161.86,-2326.47
buyer_7,María,Valdec,1968-12-31,02529745K,maría.valdec@hyperdev.site,875013,ES22209506301220461003,7234.17,2022-07-05T16:30:58,Portugalete,expenses,transport,-79.86,-2406.33
buyer_7,María,Valdec,1968-12-31,02529745K,maría.valdec@hyperdev.site,875013,ES22209506301220461003,7234.17,2022-07-05T10:58:31,Portugalete,expenses,cash,-100.0,-2506.33
buyer_7,María,Valdec,1968-12-31,02529745K,maría.valdec@hyperdev.site,875013,ES22209506301220461003,7234.17,2022-07-07T14:27:42,Portugalete,expenses,electricity,-63.29,-2569.62
buyer_7,María,Valdec,1968-12-31,02529745K,maría.valdec@hyperdev.site,875013,ES22209506301220461003,7234.17,2022-07-07T00:02:22,Portugalete,expenses,leisure,-26.93,-2596.55
buyer_7,María,Valdec,1968-12-31,02529745K,maría.valdec@hyperdev.site,875013,ES22209506301220461003,7234.17,2022-07-07T14:58:28,Portugalete,expenses,cash,-100.0,-2696.55
buyer_7,María,Valdec,1968-12-31,02529745K,maría.valdec@hyperdev.site,875013,ES22209506301220461003,7234.17,2022-07-08T09:15:23,Portugalete,expenses,internet,-32.16,-2728.71
buyer_7,María,Valdec,1968-12-31,02529745K,maría.valdec@hyperdev.site,875013,ES22209506301220461003,7234.17,2022-07-08T04:32:01,Portugalete,expenses,water,-32.51,-2761.22
buyer_7,María,Valdec,1968-12-31,02529745K,maría.valdec@hyperdev.site,875013,ES22209506301220461003,7234.17,2022-07-08T05:55:14,Portugalete,expenses,gas,-29.44,-2790.66
buyer_7,María,Valdec,1968-12-31,02529745K,maría.valdec@hyperdev.site,875013,ES22209506301220461003,7234.17,2022-07-08T20:19:35,Portugalete,expenses,phone,-31.11,-2821.77
buyer_7,María,Valdec,1968-12-31,02529745K,maría.valdec@hyperdev.site,875013,ES22209506301220461003,7234.17,2022-07-11T13:56:41,Portugalete,expenses,education,-71.46,-2893.23
buyer_7,María,Valdec,1968-12-31,02529745K,maría.valdec@hyperdev.site,875013,ES22209506301220461003,7234.17,2022-07-12T13:32:08,Portugalete,expenses,food,-106.64,-2999.87
buyer_7,María,Valdec,1968-12-31,02529745K,maría.valdec@hyperdev.site,875013,ES22209506301220461003,7234.17,2022-07-13T12:26:03,Portugalete,expenses,leisure,-19.98,-3019.85
buyer_7,María,Valdec,1968-12-31,02529745K,maría.valdec@hyperdev.site,875013,ES22209506301220461003,7234.17,2022-07-13T12:03:57,Portugalete,expenses,education,-65.71,-3085.56
buyer_7,María,Valdec,1968-12-31,02529745K,maría.valdec@hyperdev.site,875013,ES22209506301220461003,7234.17,2022-07-15T10:50:48,Portugalete,expenses,leisure,-81.17,-3166.73
buyer_7,María,Valdec,1968-12-31,02529745K,maría.valdec@hyperdev.site,875013,ES22209506301220461003,7234.17,2022-07-16T04:42:19,Portugalete,expenses,gifts,-214.39,-3381.12
buyer_7,María,Valdec,1968-12-31,02529745K,maría.valdec@hyperdev.site,875013,ES22209506301220461003,7234.17,2022-07-18T23:32:09,Portugalete,expenses,cash,-100.0,-3481.12
buyer_7,María,Valdec,1968-12-31,02529745K,maría.valdec@hyperdev.site,875013,ES22209506301220461003,7234.17,2022-07-19T13:41:01,Portugalete,expenses,food,-66.17,-3547.29
buyer_7,María,Valdec,1968-12-31,02529745K,maría.valdec@hyperdev.site,875013,ES22209506301220461003,7234.17,2022-07-19T08:50:15,Portugalete,expenses,repairs,-184.46,-3731.75
buyer_7,María,Valdec,1968-12-31,02529745K,maría.valdec@hyperdev.site,875013,ES22209506301220461003,7234.17,2022-07-20T14:56:16,Portugalete,expenses,food,-96.34,-3828.09
buyer_7,María,Valdec,1968-12-31,02529745K,maría.valdec@hyperdev.site,875013,ES22209506301220461003,7234.17,2022-07-23T08:45:01,Portugalete,expenses,repairs,-113.18,-3941.27
buyer_7,María,Valdec,1968-12-31,02529745K,maría.valdec@hyperdev.site,875013,ES22209506301220461003,7234.17,2022-07-28T18:35:52,Portugalete,expenses,children,-309.95,-4251.22
buyer_7,María,Valdec,1968-12-31,02529745K,maría.valdec@hyperdev.site,875013,ES22209506301220461003,7234.17,2022-07-29T18:11:31,Portugalete,expenses,healthcare,-67.64,-4318.86
buyer_7,María,Valdec,1968-12-31,02529745K,maría.valdec@hyperdev.site,875013,ES22209506301220461003,7234.17,2022-07-30T02:03:39,Portugalete,expenses,cash,-100.0,-4418.86
buyer_7,María,Valdec,1968-12-31,02529745K,maría.valdec@hyperdev.site,875013,ES22209506301220461003,7234.17,2022-07-31T07:17:57,Portugalete,expenses,food,-63.07,-4481.93
buyer_7,María,Valdec,1968-12-31,02529745K,maría.valdec@hyperdev.site,875013,ES22209506301220461003,7234.17,2022-07-31T13:49:04,Portugalete,expenses,education,-49.23,-4531.16
buyer_7,María,Valdec,1968-12-31,02529745K,maría.valdec@hyperdev.site,875013,ES22209506301220461003,7234.17,2022-07-31T09:54:15,Portugalete,expenses,cash,-100.0,-4631.16
buyer_7,María,Valdec,1968-12-31,02529745K,maría.valdec@hyperdev.site,875013,ES22209506301220461003,7234.17,2022-08-01T18:33:44,Portugalete,incomes,salary,1531.2,-3099.96
buyer_7,María,Valdec,1968-12-31,02529745K,maría.valdec@hyperdev.site,875013,ES22209506301220461003,7234.17,2022-08-01T11:33:49,Portugalete,expenses,transport,-65.64,-3165.6
buyer_7,María,Valdec,1968-12-31,02529745K,maría.valdec@hyperdev.site,875013,ES22209506301220461003,7234.17,2022-08-01T10:12:02,Portugalete,expenses,healthcare,-110.22,-3275.82
buyer_7,María,Valdec,1968-12-31,02529745K,maría.valdec@hyperdev.site,875013,ES22209506301220461003,7234.17,2022-08-01T16:47:20,Portugalete,expenses,appliances,-204.19,-3480.01
buyer_7,María,Valdec,1968-12-31,02529745K,maría.valdec@hyperdev.site,875013,ES22209506301220461003,7234.17,2022-08-02T10:22:45,Portugalete,expenses,children,-331.66,-3811.67
buyer_7,María,Valdec,1968-12-31,02529745K,maría.valdec@hyperdev.site,875013,ES22209506301220461003,7234.17,2022-08-03T18:42:24,Portugalete,expenses,food,-66.1,-3877.77
buyer_7,María,Valdec,1968-12-31,02529745K,maría.valdec@hyperdev.site,875013,ES22209506301220461003,7234.17,2022-08-03T13:03:19,Portugalete,expenses,cash,-100.0,-3977.77
buyer_7,María,Valdec,1968-12-31,02529745K,maría.valdec@hyperdev.site,875013,ES22209506301220461003,7234.17,2022-08-04T11:42:31,Portugalete,expenses,mortgage,-677.7,-4655.47
buyer_7,María,Valdec,1968-12-31,02529745K,maría.valdec@hyperdev.site,875013,ES22209506301220461003,7234.17,2022-08-04T08:11:11,Portugalete,expenses,clothing,-139.02,-4794.49
buyer_7,María,Valdec,1968-12-31,02529745K,maría.valdec@hyperdev.site,875013,ES22209506301220461003,7234.17,2022-08-05T09:44:02,Portugalete,expenses,phone,-31.73,-4826.22
buyer_7,María,Valdec,1968-12-31,02529745K,maría.valdec@hyperdev.site,875013,ES22209506301220461003,7234.17,2022-08-06T12:45:49,Portugalete,expenses,water,-31.02,-4857.24
buyer_7,María,Valdec,1968-12-31,02529745K,maría.valdec@hyperdev.site,875013,ES22209506301220461003,7234.17,2022-08-06T12:22:31,Portugalete,expenses,gas,-32.19,-4889.43
buyer_7,María,Valdec,1968-12-31,02529745K,maría.valdec@hyperdev.site,875013,ES22209506301220461003,7234.17,2022-08-06T17:32:04,Portugalete,expenses,gifts,-62.34,-4951.77
buyer_7,María,Valdec,1968-12-31,02529745K,maría.valdec@hyperdev.site,875013,ES22209506301220461003,7234.17,2022-08-07T10:19:19,Portugalete,expenses,electricity,-27.08,-4978.85
buyer_7,María,Valdec,1968-12-31,02529745K,maría.valdec@hyperdev.site,875013,ES22209506301220461003,7234.17,2022-08-07T15:01:33,Portugalete,expenses,internet,-32.16,-5011.01
buyer_7,María,Valdec,1968-12-31,02529745K,maría.valdec@hyperdev.site,875013,ES22209506301220461003,7234.17,2022-08-07T11:13:43,Portugalete,expenses,food,-120.3,-5131.31
buyer_7,María,Valdec,1968-12-31,02529745K,maría.valdec@hyperdev.site,875013,ES22209506301220461003,7234.17,2022-08-07T14:47:54,Portugalete,expenses,cash,-100.0,-5231.31
buyer_7,María,Valdec,1968-12-31,02529745K,maría.valdec@hyperdev.site,875013,ES22209506301220461003,7234.17,2022-08-08T08:05:59,Portugalete,expenses,food,-84.21,-5315.52
buyer_7,María,Valdec,1968-12-31,02529745K,maría.valdec@hyperdev.site,875013,ES22209506301220461003,7234.17,2022-08-11T20:00:37,Portugalete,expenses,food,-89.46,-5404.98
buyer_7,María,Valdec,1968-12-31,02529745K,maría.valdec@hyperdev.site,875013,ES22209506301220461003,7234.17,2022-08-14T04:57:18,Portugalete,expenses,education,-71.54,-5476.52
buyer_7,María,Valdec,1968-12-31,02529745K,maría.valdec@hyperdev.site,875013,ES22209506301220461003,7234.17,2022-08-17T10:21:49,Portugalete,expenses,repairs,-158.17,-5634.69
buyer_7,María,Valdec,1968-12-31,02529745K,maría.valdec@hyperdev.site,875013,ES22209506301220461003,7234.17,2022-08-19T12:34:39,Portugalete,expenses,repairs,-181.95,-5816.64
buyer_7,María,Valdec,1968-12-31,02529745K,maría.valdec@hyperdev.site,875013,ES22209506301220461003,7234.17,2022-08-21T09:35:41,Portugalete,expenses,cash,-100.0,-5916.64
buyer_7,María,Valdec,1968-12-31,02529745K,maría.valdec@hyperdev.site,875013,ES22209506301220461003,7234.17,2022-08-22T04:03:23,Portugalete,expenses,food,-87.76,-6004.4
buyer_7,María,Valdec,1968-12-31,02529745K,maría.valdec@hyperdev.site,875013,ES22209506301220461003,7234.17,2022-08-25T19:44:55,Portugalete,expenses,gifts,-54.38,-6058.78
buyer_7,María,Valdec,1968-12-31,02529745K,maría.valdec@hyperdev.site,875013,ES22209506301220461003,7234.17,2022-08-26T14:39:36,Portugalete,expenses,food,-61.39,-6120.17
buyer_7,María,Valdec,1968-12-31,02529745K,maría.valdec@hyperdev.site,875013,ES22209506301220461003,7234.17,2022-08-27T15:57:05,Portugalete,expenses,education,-52.73,-6172.9
buyer_7,María,Valdec,1968-12-31,02529745K,maría.valdec@hyperdev.site,875013,ES22209506301220461003,7234.17,2022-08-28T09:35:48,Portugalete,expenses,gifts,-38.16,-6211.06
buyer_7,María,Valdec,1968-12-31,02529745K,maría.valdec@hyperdev.site,875013,ES22209506301220461003,7234.17,2022-08-30T08:26:44,Portugalete,expenses,transport,-41.07,-6252.13
buyer_7,María,Valdec,1968-12-31,02529745K,maría.valdec@hyperdev.site,875013,ES22209506301220461003,7234.17,2022-08-31T09:38:12,Portugalete,expenses,transport,-45.21,-6297.34
buyer_7,María,Valdec,1968-12-31,02529745K,maría.valdec@hyperdev.site,875013,ES22209506301220461003,7234.17,2022-08-31T06:31:24,Portugalete,expenses,cash,-100.0,-6397.34
buyer_7,María,Valdec,1968-12-31,02529745K,maría.valdec@hyperdev.site,875013,ES22209506301220461003,7234.17,2022-09-01T09:22:23,Portugalete,incomes,salary,1531.2,-4866.14
buyer_7,María,Valdec,1968-12-31,02529745K,maría.valdec@hyperdev.site,875013,ES22209506301220461003,7234.17,2022-09-01T18:34:26,Portugalete,expenses,healthcare,-85.95,-4952.09
buyer_7,María,Valdec,1968-12-31,02529745K,maría.valdec@hyperdev.site,875013,ES22209506301220461003,7234.17,2022-09-01T21:24:36,Portugalete,expenses,repairs,-235.69,-5187.78
buyer_7,María,Valdec,1968-12-31,02529745K,maría.valdec@hyperdev.site,875013,ES22209506301220461003,7234.17,2022-09-02T15:48:07,Portugalete,expenses,food,-88.05,-5275.83
buyer_7,María,Valdec,1968-12-31,02529745K,maría.valdec@hyperdev.site,875013,ES22209506301220461003,7234.17,2022-09-02T11:04:57,Portugalete,expenses,gifts,-53.4,-5329.23
buyer_7,María,Valdec,1968-12-31,02529745K,maría.valdec@hyperdev.site,875013,ES22209506301220461003,7234.17,2022-09-03T19:27:49,Portugalete,expenses,cash,-100.0,-5429.23
buyer_7,María,Valdec,1968-12-31,02529745K,maría.valdec@hyperdev.site,875013,ES22209506301220461003,7234.17,2022-09-04T19:04:45,Portugalete,expenses,mortgage,-677.7,-6106.93
buyer_7,María,Valdec,1968-12-31,02529745K,maría.valdec@hyperdev.site,875013,ES22209506301220461003,7234.17,2022-09-04T17:17:44,Portugalete,expenses,transport,-75.14,-6182.07
buyer_7,María,Valdec,1968-12-31,02529745K,maría.valdec@hyperdev.site,875013,ES22209506301220461003,7234.17,2022-09-05T12:19:28,Portugalete,expenses,water,-33.05,-6215.12
buyer_7,María,Valdec,1968-12-31,02529745K,maría.valdec@hyperdev.site,875013,ES22209506301220461003,7234.17,2022-09-05T13:57:41,Portugalete,expenses,phone,-32.33,-6247.45
buyer_7,María,Valdec,1968-12-31,02529745K,maría.valdec@hyperdev.site,875013,ES22209506301220461003,7234.17,2022-09-05T13:41:15,Portugalete,expenses,food,-74.66,-6322.11
buyer_7,María,Valdec,1968-12-31,02529745K,maría.valdec@hyperdev.site,875013,ES22209506301220461003,7234.17,2022-09-06T16:14:47,Portugalete,expenses,internet,-32.16,-6354.27
buyer_7,María,Valdec,1968-12-31,02529745K,maría.valdec@hyperdev.site,875013,ES22209506301220461003,7234.17,2022-09-07T18:30:09,Portugalete,expenses,gas,-40.84,-6395.11
buyer_7,María,Valdec,1968-12-31,02529745K,maría.valdec@hyperdev.site,875013,ES22209506301220461003,7234.17,2022-09-08T10:25:40,Portugalete,expenses,electricity,-38.51,-6433.62
buyer_7,María,Valdec,1968-12-31,02529745K,maría.valdec@hyperdev.site,875013,ES22209506301220461003,7234.17,2022-09-08T10:50:02,Portugalete,expenses,food,-113.49,-6547.11
buyer_7,María,Valdec,1968-12-31,02529745K,maría.valdec@hyperdev.site,875013,ES22209506301220461003,7234.17,2022-09-08T18:32:03,Portugalete,expenses,cash,-100.0,-6647.11
buyer_7,María,Valdec,1968-12-31,02529745K,maría.valdec@hyperdev.site,875013,ES22209506301220461003,7234.17,2022-09-09T03:50:00,Portugalete,expenses,cash,-100.0,-6747.11
buyer_7,María,Valdec,1968-12-31,02529745K,maría.valdec@hyperdev.site,875013,ES22209506301220461003,7234.17,2022-09-09T17:43:06,Portugalete,expenses,children,-284.61150000000004,-7031.72
buyer_7,María,Valdec,1968-12-31,02529745K,maría.valdec@hyperdev.site,875013,ES22209506301220461003,7234.17,2022-09-11T15:48:53,Portugalete,expenses,appliances,-203.49,-7235.21
buyer_7,María,Valdec,1968-12-31,02529745K,maría.valdec@hyperdev.site,875013,ES22209506301220461003,7234.17,2022-09-12T16:44:34,Portugalete,expenses,transport,-49.44,-7284.65
buyer_7,María,Valdec,1968-12-31,02529745K,maría.valdec@hyperdev.site,875013,ES22209506301220461003,7234.17,2022-09-13T01:17:29,Portugalete,expenses,leisure,-69.43,-7354.08
buyer_7,María,Valdec,1968-12-31,02529745K,maría.valdec@hyperdev.site,875013,ES22209506301220461003,7234.17,2022-09-16T23:04:22,Portugalete,expenses,education,-77.19,-7431.27
buyer_7,María,Valdec,1968-12-31,02529745K,maría.valdec@hyperdev.site,875013,ES22209506301220461003,7234.17,2022-09-16T20:41:50,Portugalete,expenses,gifts,-66.86,-7498.13
buyer_7,María,Valdec,1968-12-31,02529745K,maría.valdec@hyperdev.site,875013,ES22209506301220461003,7234.17,2022-09-18T15:21:03,Portugalete,expenses,food,-76.19,-7574.32
buyer_7,María,Valdec,1968-12-31,02529745K,maría.valdec@hyperdev.site,875013,ES22209506301220461003,7234.17,2022-09-20T18:48:37,Portugalete,expenses,transport,-44.46,-7618.78
buyer_7,María,Valdec,1968-12-31,02529745K,maría.valdec@hyperdev.site,875013,ES22209506301220461003,7234.17,2022-09-20T12:45:09,Portugalete,expenses,gifts,-79.66,-7698.44
buyer_7,María,Valdec,1968-12-31,02529745K,maría.valdec@hyperdev.site,875013,ES22209506301220461003,7234.17,2022-09-21T12:20:32,Portugalete,expenses,education,-48.67,-7747.11
buyer_7,María,Valdec,1968-12-31,02529745K,maría.valdec@hyperdev.site,875013,ES22209506301220461003,7234.17,2022-09-23T10:03:25,Portugalete,expenses,cash,-100.0,-7847.11
buyer_7,María,Valdec,1968-12-31,02529745K,maría.valdec@hyperdev.site,875013,ES22209506301220461003,7234.17,2022-09-25T09:59:28,Portugalete,expenses,transport,-59.88,-7906.99
buyer_7,María,Valdec,1968-12-31,02529745K,maría.valdec@hyperdev.site,875013,ES22209506301220461003,7234.17,2022-09-25T16:18:10,Portugalete,expenses,leisure,-84.26,-7991.25
buyer_7,María,Valdec,1968-12-31,02529745K,maría.valdec@hyperdev.site,875013,ES22209506301220461003,7234.17,2022-09-27T18:30:36,Portugalete,expenses,gifts,-365.14,-8356.39
buyer_7,María,Valdec,1968-12-31,02529745K,maría.valdec@hyperdev.site,875013,ES22209506301220461003,7234.17,2022-09-29T18:51:57,Portugalete,expenses,cash,-100.0,-8456.39
buyer_7,María,Valdec,1968-12-31,02529745K,maría.valdec@hyperdev.site,875013,ES22209506301220461003,7234.17,2022-09-29T11:22:09,Portugalete,expenses,repairs,-73.91,-8530.3
buyer_7,María,Valdec,1968-12-31,02529745K,maría.valdec@hyperdev.site,875013,ES22209506301220461003,7234.17,2022-09-30T09:08:20,Portugalete,expenses,cash,-100.0,-8630.3
buyer_7,María,Valdec,1968-12-31,02529745K,maría.valdec@hyperdev.site,875013,ES22209506301220461003,7234.17,2022-10-01T19:06:25,Portugalete,incomes,salary,1531.2,-7099.1
buyer_7,María,Valdec,1968-12-31,02529745K,maría.valdec@hyperdev.site,875013,ES22209506301220461003,7234.17,2022-10-01T19:17:32,Portugalete,expenses,cash,-100.0,-7199.1
buyer_7,María,Valdec,1968-12-31,02529745K,maría.valdec@hyperdev.site,875013,ES22209506301220461003,7234.17,2022-10-02T18:52:06,Portugalete,expenses,food,-88.47,-7287.57
buyer_7,María,Valdec,1968-12-31,02529745K,maría.valdec@hyperdev.site,875013,ES22209506301220461003,7234.17,2022-10-02T18:30:15,Portugalete,expenses,leisure,-29.45,-7317.02
buyer_7,María,Valdec,1968-12-31,02529745K,maría.valdec@hyperdev.site,875013,ES22209506301220461003,7234.17,2022-10-04T02:16:33,Portugalete,expenses,mortgage,-677.7,-7994.72
buyer_7,María,Valdec,1968-12-31,02529745K,maría.valdec@hyperdev.site,875013,ES22209506301220461003,7234.17,2022-10-04T20:39:46,Portugalete,expenses,food,-121.49,-8116.21
buyer_7,María,Valdec,1968-12-31,02529745K,maría.valdec@hyperdev.site,875013,ES22209506301220461003,7234.17,2022-10-05T21:23:20,Portugalete,expenses,gas,-23.28,-8139.49
buyer_7,María,Valdec,1968-12-31,02529745K,maría.valdec@hyperdev.site,875013,ES22209506301220461003,7234.17,2022-10-05T17:53:09,Portugalete,expenses,transport,-43.09,-8182.58
buyer_7,María,Valdec,1968-12-31,02529745K,maría.valdec@hyperdev.site,875013,ES22209506301220461003,7234.17,2022-10-06T10:59:26,Portugalete,expenses,water,-29.39,-8211.97
buyer_7,María,Valdec,1968-12-31,02529745K,maría.valdec@hyperdev.site,875013,ES22209506301220461003,7234.17,2022-10-06T11:39:02,Portugalete,expenses,phone,-23.71,-8235.68
buyer_7,María,Valdec,1968-12-31,02529745K,maría.valdec@hyperdev.site,875013,ES22209506301220461003,7234.17,2022-10-07T10:44:26,Portugalete,expenses,food,-83.19,-8318.87
buyer_7,María,Valdec,1968-12-31,02529745K,maría.valdec@hyperdev.site,875013,ES22209506301220461003,7234.17,2022-10-08T16:23:22,Portugalete,expenses,internet,-32.16,-8351.03
buyer_7,María,Valdec,1968-12-31,02529745K,maría.valdec@hyperdev.site,875013,ES22209506301220461003,7234.17,2022-10-08T11:22:19,Portugalete,expenses,electricity,-59.29,-8410.32
buyer_7,María,Valdec,1968-12-31,02529745K,maría.valdec@hyperdev.site,875013,ES22209506301220461003,7234.17,2022-10-08T13:44:55,Portugalete,expenses,cash,-100.0,-8510.32
buyer_7,María,Valdec,1968-12-31,02529745K,maría.valdec@hyperdev.site,875013,ES22209506301220461003,7234.17,2022-10-08T11:25:39,Portugalete,expenses,appliances,-213.11,-8723.43
buyer_7,María,Valdec,1968-12-31,02529745K,maría.valdec@hyperdev.site,875013,ES22209506301220461003,7234.17,2022-10-09T13:13:00,Portugalete,expenses,leisure,-60.42,-8783.85
buyer_7,María,Valdec,1968-12-31,02529745K,maría.valdec@hyperdev.site,875013,ES22209506301220461003,7234.17,2022-10-09T19:15:00,Portugalete,expenses,healthcare,-173.94,-8957.79
buyer_7,María,Valdec,1968-12-31,02529745K,maría.valdec@hyperdev.site,875013,ES22209506301220461003,7234.17,2022-10-10T20:14:23,Portugalete,expenses,food,-80.6,-9038.39
buyer_7,María,Valdec,1968-12-31,02529745K,maría.valdec@hyperdev.site,875013,ES22209506301220461003,7234.17,2022-10-11T19:01:16,Portugalete,expenses,leisure,-24.56,-9062.95
buyer_7,María,Valdec,1968-12-31,02529745K,maría.valdec@hyperdev.site,875013,ES22209506301220461003,7234.17,2022-10-12T18:46:10,Portugalete,expenses,transport,-45.81,-9108.76
buyer_7,María,Valdec,1968-12-31,02529745K,maría.valdec@hyperdev.site,875013,ES22209506301220461003,7234.17,2022-10-12T11:50:49,Portugalete,expenses,cash,-100.0,-9208.76
buyer_7,María,Valdec,1968-12-31,02529745K,maría.valdec@hyperdev.site,875013,ES22209506301220461003,7234.17,2022-10-13T15:00:42,Portugalete,expenses,transport,-71.95,-9280.71
buyer_7,María,Valdec,1968-12-31,02529745K,maría.valdec@hyperdev.site,875013,ES22209506301220461003,7234.17,2022-10-14T08:13:45,Portugalete,expenses,food,-91.85,-9372.56
buyer_7,María,Valdec,1968-12-31,02529745K,maría.valdec@hyperdev.site,875013,ES22209506301220461003,7234.17,2022-10-15T11:01:40,Portugalete,expenses,leisure,-26.62,-9399.18
buyer_7,María,Valdec,1968-12-31,02529745K,maría.valdec@hyperdev.site,875013,ES22209506301220461003,7234.17,2022-10-17T12:21:51,Portugalete,expenses,education,-54.19,-9453.37
buyer_7,María,Valdec,1968-12-31,02529745K,maría.valdec@hyperdev.site,875013,ES22209506301220461003,7234.17,2022-10-18T16:30:59,Portugalete,expenses,food,-80.69,-9534.06
buyer_7,María,Valdec,1968-12-31,02529745K,maría.valdec@hyperdev.site,875013,ES22209506301220461003,7234.17,2022-10-19T11:14:26,Portugalete,expenses,leisure,-32.14,-9566.2
buyer_7,María,Valdec,1968-12-31,02529745K,maría.valdec@hyperdev.site,875013,ES22209506301220461003,7234.17,2022-10-19T10:29:14,Portugalete,expenses,gifts,-263.56,-9829.76
buyer_7,María,Valdec,1968-12-31,02529745K,maría.valdec@hyperdev.site,875013,ES22209506301220461003,7234.17,2022-10-20T17:16:49,Portugalete,expenses,cash,-100.0,-9929.76
buyer_7,María,Valdec,1968-12-31,02529745K,maría.valdec@hyperdev.site,875013,ES22209506301220461003,7234.17,2022-10-20T08:42:08,Portugalete,expenses,car,-118.41,-10048.17
buyer_7,María,Valdec,1968-12-31,02529745K,maría.valdec@hyperdev.site,875013,ES22209506301220461003,7234.17,2022-10-21T06:24:26,Portugalete,expenses,repairs,-144.04,-10192.21
buyer_7,María,Valdec,1968-12-31,02529745K,maría.valdec@hyperdev.site,875013,ES22209506301220461003,7234.17,2022-10-23T17:31:37,Portugalete,expenses,transport,-51.48,-10243.69
buyer_7,María,Valdec,1968-12-31,02529745K,maría.valdec@hyperdev.site,875013,ES22209506301220461003,7234.17,2022-10-23T16:51:38,Portugalete,expenses,cash,-100.0,-10343.69
buyer_7,María,Valdec,1968-12-31,02529745K,maría.valdec@hyperdev.site,875013,ES22209506301220461003,7234.17,2022-10-24T15:16:52,Portugalete,expenses,food,-90.22,-10433.91
buyer_7,María,Valdec,1968-12-31,02529745K,maría.valdec@hyperdev.site,875013,ES22209506301220461003,7234.17,2022-10-24T11:24:15,Portugalete,expenses,clothing,-149.72,-10583.63
buyer_7,María,Valdec,1968-12-31,02529745K,maría.valdec@hyperdev.site,875013,ES22209506301220461003,7234.17,2022-10-25T13:21:09,Portugalete,expenses,gifts,-35.04,-10618.67
buyer_7,María,Valdec,1968-12-31,02529745K,maría.valdec@hyperdev.site,875013,ES22209506301220461003,7234.17,2022-10-27T16:55:58,Portugalete,expenses,leisure,-77.75,-10696.42
buyer_7,María,Valdec,1968-12-31,02529745K,maría.valdec@hyperdev.site,875013,ES22209506301220461003,7234.17,2022-10-29T13:27:19,Portugalete,expenses,food,-85.47,-10781.89
buyer_7,María,Valdec,1968-12-31,02529745K,maría.valdec@hyperdev.site,875013,ES22209506301220461003,7234.17,2022-10-30T18:27:48,Portugalete,expenses,education,-51.63,-10833.52
buyer_7,María,Valdec,1968-12-31,02529745K,maría.valdec@hyperdev.site,875013,ES22209506301220461003,7234.17,2022-10-31T09:37:13,Portugalete,expenses,food,-88.74,-10922.26
buyer_7,María,Valdec,1968-12-31,02529745K,maría.valdec@hyperdev.site,875013,ES22209506301220461003,7234.17,2022-11-01T16:36:53,Portugalete,incomes,salary,1531.2,-9391.06
buyer_7,María,Valdec,1968-12-31,02529745K,maría.valdec@hyperdev.site,875013,ES22209506301220461003,7234.17,2022-11-01T16:36:53,Portugalete,incomes,extra_income,208.35,-9182.71
buyer_7,María,Valdec,1968-12-31,02529745K,maría.valdec@hyperdev.site,875013,ES22209506301220461003,7234.17,2022-11-01T19:33:34,Portugalete,expenses,food,-82.81,-9265.52
buyer_7,María,Valdec,1968-12-31,02529745K,maría.valdec@hyperdev.site,875013,ES22209506301220461003,7234.17,2022-11-04T23:08:13,Portugalete,expenses,mortgage,-677.7,-9943.22
buyer_7,María,Valdec,1968-12-31,02529745K,maría.valdec@hyperdev.site,875013,ES22209506301220461003,7234.17,2022-11-05T20:00:50,Portugalete,expenses,water,-29.58,-9972.8
buyer_7,María,Valdec,1968-12-31,02529745K,maría.valdec@hyperdev.site,875013,ES22209506301220461003,7234.17,2022-11-05T11:12:04,Portugalete,expenses,electricity,-33.52,-10006.32
buyer_7,María,Valdec,1968-12-31,02529745K,maría.valdec@hyperdev.site,875013,ES22209506301220461003,7234.17,2022-11-05T12:18:58,Portugalete,expenses,food,-109.4,-10115.72
buyer_7,María,Valdec,1968-12-31,02529745K,maría.valdec@hyperdev.site,875013,ES22209506301220461003,7234.17,2022-11-06T17:46:03,Portugalete,expenses,education,-66.25,-10181.97
buyer_7,María,Valdec,1968-12-31,02529745K,maría.valdec@hyperdev.site,875013,ES22209506301220461003,7234.17,2022-11-07T09:34:05,Portugalete,expenses,gas,-38.41,-10220.38
buyer_7,María,Valdec,1968-12-31,02529745K,maría.valdec@hyperdev.site,875013,ES22209506301220461003,7234.17,2022-11-07T08:05:34,Portugalete,expenses,phone,-29.91,-10250.29
buyer_7,María,Valdec,1968-12-31,02529745K,maría.valdec@hyperdev.site,875013,ES22209506301220461003,7234.17,2022-11-08T01:36:28,Portugalete,expenses,internet,-32.16,-10282.45
buyer_7,María,Valdec,1968-12-31,02529745K,maría.valdec@hyperdev.site,875013,ES22209506301220461003,7234.17,2022-11-08T13:41:20,Portugalete,expenses,transport,-60.38,-10342.83
buyer_7,María,Valdec,1968-12-31,02529745K,maría.valdec@hyperdev.site,875013,ES22209506301220461003,7234.17,2022-11-09T19:01:03,Portugalete,expenses,transport,-45.83,-10388.66
buyer_7,María,Valdec,1968-12-31,02529745K,maría.valdec@hyperdev.site,875013,ES22209506301220461003,7234.17,2022-11-11T10:37:23,Portugalete,expenses,food,-70.52,-10459.18
buyer_7,María,Valdec,1968-12-31,02529745K,maría.valdec@hyperdev.site,875013,ES22209506301220461003,7234.17,2022-11-11T18:48:56,Portugalete,expenses,clothing,-128.61,-10587.79
buyer_7,María,Valdec,1968-12-31,02529745K,maría.valdec@hyperdev.site,875013,ES22209506301220461003,7234.17,2022-11-13T14:22:11,Portugalete,expenses,transport,-78.59,-10666.38
buyer_7,María,Valdec,1968-12-31,02529745K,maría.valdec@hyperdev.site,875013,ES22209506301220461003,7234.17,2022-11-13T18:33:53,Portugalete,expenses,clothing,-121.38,-10787.76
buyer_7,María,Valdec,1968-12-31,02529745K,maría.valdec@hyperdev.site,875013,ES22209506301220461003,7234.17,2022-11-13T16:45:19,Portugalete,expenses,healthcare,-53.02,-10840.78
buyer_7,María,Valdec,1968-12-31,02529745K,maría.valdec@hyperdev.site,875013,ES22209506301220461003,7234.17,2022-11-16T20:52:59,Portugalete,expenses,transport,-45.53,-10886.31
buyer_7,María,Valdec,1968-12-31,02529745K,maría.valdec@hyperdev.site,875013,ES22209506301220461003,7234.17,2022-11-17T13:15:20,Portugalete,expenses,transport,-54.12,-10940.43
buyer_7,María,Valdec,1968-12-31,02529745K,maría.valdec@hyperdev.site,875013,ES22209506301220461003,7234.17,2022-11-18T10:04:47,Portugalete,expenses,cash,-100.0,-11040.43
buyer_7,María,Valdec,1968-12-31,02529745K,maría.valdec@hyperdev.site,875013,ES22209506301220461003,7234.17,2022-11-21T22:44:46,Portugalete,expenses,food,-88.87,-11129.3
buyer_7,María,Valdec,1968-12-31,02529745K,maría.valdec@hyperdev.site,875013,ES22209506301220461003,7234.17,2022-11-21T17:09:12,Portugalete,expenses,leisure,-80.55,-11209.85
buyer_7,María,Valdec,1968-12-31,02529745K,maría.valdec@hyperdev.site,875013,ES22209506301220461003,7234.17,2022-11-22T20:48:48,Portugalete,expenses,transport,-55.17,-11265.02
buyer_7,María,Valdec,1968-12-31,02529745K,maría.valdec@hyperdev.site,875013,ES22209506301220461003,7234.17,2022-11-22T17:45:15,Portugalete,expenses,leisure,-45.1,-11310.12
buyer_7,María,Valdec,1968-12-31,02529745K,maría.valdec@hyperdev.site,875013,ES22209506301220461003,7234.17,2022-11-22T17:12:26,Portugalete,expenses,cash,-100.0,-11410.12
buyer_7,María,Valdec,1968-12-31,02529745K,maría.valdec@hyperdev.site,875013,ES22209506301220461003,7234.17,2022-11-23T15:55:23,Portugalete,expenses,gifts,-291.77,-11701.89
buyer_7,María,Valdec,1968-12-31,02529745K,maría.valdec@hyperdev.site,875013,ES22209506301220461003,7234.17,2022-11-25T23:49:48,Portugalete,expenses,cash,-100.0,-11801.89
buyer_7,María,Valdec,1968-12-31,02529745K,maría.valdec@hyperdev.site,875013,ES22209506301220461003,7234.17,2022-11-26T11:58:21,Portugalete,expenses,transport,-85.56,-11887.45
buyer_7,María,Valdec,1968-12-31,02529745K,maría.valdec@hyperdev.site,875013,ES22209506301220461003,7234.17,2022-11-27T17:21:10,Portugalete,expenses,transport,-53.91,-11941.36
buyer_7,María,Valdec,1968-12-31,02529745K,maría.valdec@hyperdev.site,875013,ES22209506301220461003,7234.17,2022-11-28T09:31:25,Portugalete,expenses,transport,-64.1,-12005.46
buyer_7,María,Valdec,1968-12-31,02529745K,maría.valdec@hyperdev.site,875013,ES22209506301220461003,7234.17,2022-11-29T13:32:06,Portugalete,expenses,cash,-100.0,-12105.46
buyer_7,María,Valdec,1968-12-31,02529745K,maría.valdec@hyperdev.site,875013,ES22209506301220461003,7234.17,2022-11-30T12:22:35,Portugalete,expenses,cash,-100.0,-12205.46
buyer_7,María,Valdec,1968-12-31,02529745K,maría.valdec@hyperdev.site,875013,ES22209506301220461003,7234.17,2022-12-01T10:03:27,Portugalete,incomes,salary,1531.2,-10674.26
buyer_7,María,Valdec,1968-12-31,02529745K,maría.valdec@hyperdev.site,875013,ES22209506301220461003,7234.17,2022-12-01T10:03:27,Portugalete,incomes,salary_bonus,1138.65,-9535.61
buyer_7,María,Valdec,1968-12-31,02529745K,maría.valdec@hyperdev.site,875013,ES22209506301220461003,7234.17,2022-12-01T18:10:45,Portugalete,expenses,repairs,-256.0,-9791.61
buyer_7,María,Valdec,1968-12-31,02529745K,maría.valdec@hyperdev.site,875013,ES22209506301220461003,7234.17,2022-12-02T00:29:45,Portugalete,expenses,food,-75.81,-9867.42
buyer_7,María,Valdec,1968-12-31,02529745K,maría.valdec@hyperdev.site,875013,ES22209506301220461003,7234.17,2022-12-03T20:30:35,Portugalete,expenses,food,-124.5,-9991.92
buyer_7,María,Valdec,1968-12-31,02529745K,maría.valdec@hyperdev.site,875013,ES22209506301220461003,7234.17,2022-12-04T16:51:55,Portugalete,expenses,mortgage,-677.7,-10669.62
buyer_7,María,Valdec,1968-12-31,02529745K,maría.valdec@hyperdev.site,875013,ES22209506301220461003,7234.17,2022-12-04T11:12:25,Portugalete,expenses,food,-107.85,-10777.47
buyer_7,María,Valdec,1968-12-31,02529745K,maría.valdec@hyperdev.site,875013,ES22209506301220461003,7234.17,2022-12-04T13:57:33,Portugalete,expenses,appliances,-111.85,-10889.32
buyer_7,María,Valdec,1968-12-31,02529745K,maría.valdec@hyperdev.site,875013,ES22209506301220461003,7234.17,2022-12-05T18:13:57,Portugalete,expenses,water,-33.81,-10923.13
buyer_7,María,Valdec,1968-12-31,02529745K,maría.valdec@hyperdev.site,875013,ES22209506301220461003,7234.17,2022-12-05T14:21:43,Portugalete,expenses,internet,-32.16,-10955.29
buyer_7,María,Valdec,1968-12-31,02529745K,maría.valdec@hyperdev.site,875013,ES22209506301220461003,7234.17,2022-12-05T10:38:45,Portugalete,expenses,leisure,-75.08,-11030.37
buyer_7,María,Valdec,1968-12-31,02529745K,maría.valdec@hyperdev.site,875013,ES22209506301220461003,7234.17,2022-12-05T13:48:53,Portugalete,expenses,clothing,-83.57,-11113.94
buyer_7,María,Valdec,1968-12-31,02529745K,maría.valdec@hyperdev.site,875013,ES22209506301220461003,7234.17,2022-12-05T12:33:30,Portugalete,expenses,cash,-100.0,-11213.94
buyer_7,María,Valdec,1968-12-31,02529745K,maría.valdec@hyperdev.site,875013,ES22209506301220461003,7234.17,2022-12-05T16:52:44,Portugalete,expenses,repairs,-93.31,-11307.25
buyer_7,María,Valdec,1968-12-31,02529745K,maría.valdec@hyperdev.site,875013,ES22209506301220461003,7234.17,2022-12-06T11:50:01,Portugalete,expenses,phone,-24.36,-11331.61
buyer_7,María,Valdec,1968-12-31,02529745K,maría.valdec@hyperdev.site,875013,ES22209506301220461003,7234.17,2022-12-06T03:14:56,Portugalete,expenses,transport,-85.45,-11417.06
buyer_7,María,Valdec,1968-12-31,02529745K,maría.valdec@hyperdev.site,875013,ES22209506301220461003,7234.17,2022-12-07T20:39:54,Portugalete,expenses,food,-88.99,-11506.05
buyer_7,María,Valdec,1968-12-31,02529745K,maría.valdec@hyperdev.site,875013,ES22209506301220461003,7234.17,2022-12-07T10:31:46,Portugalete,expenses,transport,-57.1,-11563.15
buyer_7,María,Valdec,1968-12-31,02529745K,maría.valdec@hyperdev.site,875013,ES22209506301220461003,7234.17,2022-12-07T19:06:16,Portugalete,expenses,leisure,-76.26,-11639.41
buyer_7,María,Valdec,1968-12-31,02529745K,maría.valdec@hyperdev.site,875013,ES22209506301220461003,7234.17,2022-12-08T23:01:13,Portugalete,expenses,electricity,-17.37,-11656.78
buyer_7,María,Valdec,1968-12-31,02529745K,maría.valdec@hyperdev.site,875013,ES22209506301220461003,7234.17,2022-12-08T11:07:05,Portugalete,expenses,gas,-80.96,-11737.74
buyer_7,María,Valdec,1968-12-31,02529745K,maría.valdec@hyperdev.site,875013,ES22209506301220461003,7234.17,2022-12-08T18:44:01,Portugalete,expenses,transport,-72.22,-11809.96
buyer_7,María,Valdec,1968-12-31,02529745K,maría.valdec@hyperdev.site,875013,ES22209506301220461003,7234.17,2022-12-10T16:55:10,Portugalete,expenses,transport,-45.93,-11855.89
buyer_7,María,Valdec,1968-12-31,02529745K,maría.valdec@hyperdev.site,875013,ES22209506301220461003,7234.17,2022-12-13T08:47:18,Portugalete,expenses,transport,-85.89,-11941.78
buyer_7,María,Valdec,1968-12-31,02529745K,maría.valdec@hyperdev.site,875013,ES22209506301220461003,7234.17,2022-12-15T20:30:13,Portugalete,expenses,food,-78.96,-12020.74
buyer_7,María,Valdec,1968-12-31,02529745K,maría.valdec@hyperdev.site,875013,ES22209506301220461003,7234.17,2022-12-15T23:19:28,Portugalete,expenses,education,-69.66,-12090.4
buyer_7,María,Valdec,1968-12-31,02529745K,maría.valdec@hyperdev.site,875013,ES22209506301220461003,7234.17,2022-12-16T18:13:07,Portugalete,expenses,clothing,-145.29,-12235.69
buyer_7,María,Valdec,1968-12-31,02529745K,maría.valdec@hyperdev.site,875013,ES22209506301220461003,7234.17,2022-12-16T14:28:16,Portugalete,expenses,cash,-100.0,-12335.69
buyer_7,María,Valdec,1968-12-31,02529745K,maría.valdec@hyperdev.site,875013,ES22209506301220461003,7234.17,2022-12-19T10:50:14,Portugalete,expenses,cash,-100.0,-12435.69
buyer_7,María,Valdec,1968-12-31,02529745K,maría.valdec@hyperdev.site,875013,ES22209506301220461003,7234.17,2022-12-20T01:35:48,Portugalete,expenses,leisure,-37.12,-12472.81
buyer_7,María,Valdec,1968-12-31,02529745K,maría.valdec@hyperdev.site,875013,ES22209506301220461003,7234.17,2022-12-21T12:23:42,Portugalete,expenses,gifts,-321.86,-12794.67
buyer_7,María,Valdec,1968-12-31,02529745K,maría.valdec@hyperdev.site,875013,ES22209506301220461003,7234.17,2022-12-23T19:18:22,Portugalete,expenses,food,-106.69,-12901.36
buyer_7,María,Valdec,1968-12-31,02529745K,maría.valdec@hyperdev.site,875013,ES22209506301220461003,7234.17,2022-12-23T14:00:24,Portugalete,expenses,leisure,-39.57,-12940.93
buyer_7,María,Valdec,1968-12-31,02529745K,maría.valdec@hyperdev.site,875013,ES22209506301220461003,7234.17,2022-12-25T16:34:19,Portugalete,expenses,food,-123.87,-13064.8
buyer_7,María,Valdec,1968-12-31,02529745K,maría.valdec@hyperdev.site,875013,ES22209506301220461003,7234.17,2022-12-26T09:32:38,Portugalete,expenses,leisure,-29.6,-13094.4
buyer_7,María,Valdec,1968-12-31,02529745K,maría.valdec@hyperdev.site,875013,ES22209506301220461003,7234.17,2022-12-27T19:41:15,Portugalete,expenses,leisure,-44.83,-13139.23
buyer_7,María,Valdec,1968-12-31,02529745K,maría.valdec@hyperdev.site,875013,ES22209506301220461003,7234.17,2022-12-27T17:54:04,Portugalete,expenses,repairs,-99.74,-13238.97
buyer_7,María,Valdec,1968-12-31,02529745K,maría.valdec@hyperdev.site,875013,ES22209506301220461003,7234.17,2022-12-29T01:17:13,Portugalete,expenses,travel,-284.7,-13523.67
buyer_7,María,Valdec,1968-12-31,02529745K,maría.valdec@hyperdev.site,875013,ES22209506301220461003,7234.17,2022-12-31T18:19:36,Portugalete,expenses,clothing,-114.2,-13637.87
buyer_7,María,Valdec,1968-12-31,02529745K,maría.valdec@hyperdev.site,875013,ES22209506301220461003,7234.17,2023-01-01T21:26:52,Portugalete,incomes,salary,1587.01,-12050.86
buyer_7,María,Valdec,1968-12-31,02529745K,maría.valdec@hyperdev.site,875013,ES22209506301220461003,7234.17,2023-01-02T23:20:35,Portugalete,expenses,leisure,-81.74,-12132.6
buyer_7,María,Valdec,1968-12-31,02529745K,maría.valdec@hyperdev.site,875013,ES22209506301220461003,7234.17,2023-01-04T09:36:59,Portugalete,expenses,mortgage,-595.89,-12728.49
buyer_7,María,Valdec,1968-12-31,02529745K,maría.valdec@hyperdev.site,875013,ES22209506301220461003,7234.17,2023-01-05T19:30:19,Portugalete,expenses,internet,-33.33,-12761.82
buyer_7,María,Valdec,1968-12-31,02529745K,maría.valdec@hyperdev.site,875013,ES22209506301220461003,7234.17,2023-01-05T20:01:05,Portugalete,expenses,phone,-33.33,-12795.15
buyer_7,María,Valdec,1968-12-31,02529745K,maría.valdec@hyperdev.site,875013,ES22209506301220461003,7234.17,2023-01-06T09:25:14,Portugalete,expenses,water,-25.01,-12820.16
buyer_7,María,Valdec,1968-12-31,02529745K,maría.valdec@hyperdev.site,875013,ES22209506301220461003,7234.17,2023-01-07T21:22:27,Portugalete,expenses,children,-100.05,-12920.21
buyer_7,María,Valdec,1968-12-31,02529745K,maría.valdec@hyperdev.site,875013,ES22209506301220461003,7234.17,2023-01-08T23:28:04,Portugalete,expenses,electricity,-52.24,-12972.45
buyer_7,María,Valdec,1968-12-31,02529745K,maría.valdec@hyperdev.site,875013,ES22209506301220461003,7234.17,2023-01-08T13:10:00,Portugalete,expenses,gas,-54.93,-13027.38
buyer_7,María,Valdec,1968-12-31,02529745K,maría.valdec@hyperdev.site,875013,ES22209506301220461003,7234.17,2023-01-09T12:35:23,Portugalete,expenses,food,-91.06,-13118.44
buyer_7,María,Valdec,1968-12-31,02529745K,maría.valdec@hyperdev.site,875013,ES22209506301220461003,7234.17,2023-01-09T17:07:57,Portugalete,expenses,repairs,-260.54,-13378.98
buyer_7,María,Valdec,1968-12-31,02529745K,maría.valdec@hyperdev.site,875013,ES22209506301220461003,7234.17,2023-01-10T01:06:03,Portugalete,expenses,transport,-74.01,-13452.99
buyer_7,María,Valdec,1968-12-31,02529745K,maría.valdec@hyperdev.site,875013,ES22209506301220461003,7234.17,2023-01-10T20:17:09,Portugalete,expenses,repairs,-175.11,-13628.1
buyer_7,María,Valdec,1968-12-31,02529745K,maría.valdec@hyperdev.site,875013,ES22209506301220461003,7234.17,2023-01-12T20:58:14,Portugalete,expenses,leisure,-46.86,-13674.96
buyer_7,María,Valdec,1968-12-31,02529745K,maría.valdec@hyperdev.site,875013,ES22209506301220461003,7234.17,2023-01-14T19:11:26,Portugalete,expenses,cash,-100.0,-13774.96
buyer_7,María,Valdec,1968-12-31,02529745K,maría.valdec@hyperdev.site,875013,ES22209506301220461003,7234.17,2023-01-15T16:42:47,Portugalete,expenses,food,-104.91,-13879.87
buyer_7,María,Valdec,1968-12-31,02529745K,maría.valdec@hyperdev.site,875013,ES22209506301220461003,7234.17,2023-01-17T21:28:23,Portugalete,expenses,gifts,-381.73,-14261.6
buyer_7,María,Valdec,1968-12-31,02529745K,maría.valdec@hyperdev.site,875013,ES22209506301220461003,7234.17,2023-01-19T17:02:21,Portugalete,expenses,children,-110.45,-14372.05
buyer_7,María,Valdec,1968-12-31,02529745K,maría.valdec@hyperdev.site,875013,ES22209506301220461003,7234.17,2023-01-23T12:15:14,Portugalete,expenses,cash,-100.0,-14472.05
buyer_7,María,Valdec,1968-12-31,02529745K,maría.valdec@hyperdev.site,875013,ES22209506301220461003,7234.17,2023-01-24T10:12:30,Portugalete,expenses,healthcare,-133.52,-14605.57
buyer_7,María,Valdec,1968-12-31,02529745K,maría.valdec@hyperdev.site,875013,ES22209506301220461003,7234.17,2023-01-25T15:48:45,Portugalete,expenses,children,-92.01,-14697.58
buyer_7,María,Valdec,1968-12-31,02529745K,maría.valdec@hyperdev.site,875013,ES22209506301220461003,7234.17,2023-01-26T17:29:21,Portugalete,expenses,transport,-77.24,-14774.82
buyer_7,María,Valdec,1968-12-31,02529745K,maría.valdec@hyperdev.site,875013,ES22209506301220461003,7234.17,2023-01-27T18:30:19,Portugalete,expenses,healthcare,-78.41,-14853.23
buyer_7,María,Valdec,1968-12-31,02529745K,maría.valdec@hyperdev.site,875013,ES22209506301220461003,7234.17,2023-01-30T15:07:08,Portugalete,expenses,healthcare,-111.31,-14964.54
buyer_7,María,Valdec,1968-12-31,02529745K,maría.valdec@hyperdev.site,875013,ES22209506301220461003,7234.17,2023-01-31T19:08:05,Portugalete,expenses,gifts,-194.32,-15158.86
buyer_7,María,Valdec,1968-12-31,02529745K,maría.valdec@hyperdev.site,875013,ES22209506301220461003,7234.17,2023-02-01T06:03:09,Portugalete,incomes,salary,1587.01,-13571.85
buyer_7,María,Valdec,1968-12-31,02529745K,maría.valdec@hyperdev.site,875013,ES22209506301220461003,7234.17,2023-02-01T06:03:09,Portugalete,incomes,extra_income,208.35,-13363.5
buyer_7,María,Valdec,1968-12-31,02529745K,maría.valdec@hyperdev.site,875013,ES22209506301220461003,7234.17,2023-02-02T11:16:03,Portugalete,expenses,cash,-100.0,-13463.5
buyer_7,María,Valdec,1968-12-31,02529745K,maría.valdec@hyperdev.site,875013,ES22209506301220461003,7234.17,2023-02-04T11:19:04,Portugalete,expenses,mortgage,-595.89,-14059.39
buyer_7,María,Valdec,1968-12-31,02529745K,maría.valdec@hyperdev.site,875013,ES22209506301220461003,7234.17,2023-02-05T14:58:08,Portugalete,expenses,water,-34.24,-14093.63
buyer_7,María,Valdec,1968-12-31,02529745K,maría.valdec@hyperdev.site,875013,ES22209506301220461003,7234.17,2023-02-05T08:04:29,Portugalete,expenses,gas,-48.78,-14142.41
buyer_7,María,Valdec,1968-12-31,02529745K,maría.valdec@hyperdev.site,875013,ES22209506301220461003,7234.17,2023-02-05T08:46:24,Portugalete,expenses,food,-65.73,-14208.14
buyer_7,María,Valdec,1968-12-31,02529745K,maría.valdec@hyperdev.site,875013,ES22209506301220461003,7234.17,2023-02-07T19:16:57,Portugalete,expenses,internet,-33.33,-14241.47
buyer_7,María,Valdec,1968-12-31,02529745K,maría.valdec@hyperdev.site,875013,ES22209506301220461003,7234.17,2023-02-07T18:03:41,Portugalete,expenses,phone,-27.94,-14269.41
buyer_7,María,Valdec,1968-12-31,02529745K,maría.valdec@hyperdev.site,875013,ES22209506301220461003,7234.17,2023-02-08T10:07:02,Portugalete,expenses,electricity,-70.86,-14340.27
buyer_7,María,Valdec,1968-12-31,02529745K,maría.valdec@hyperdev.site,875013,ES22209506301220461003,7234.17,2023-02-08T15:16:21,Portugalete,expenses,cash,-100.0,-14440.27
buyer_7,María,Valdec,1968-12-31,02529745K,maría.valdec@hyperdev.site,875013,ES22209506301220461003,7234.17,2023-02-09T19:24:01,Portugalete,expenses,cash,-100.0,-14540.27
buyer_7,María,Valdec,1968-12-31,02529745K,maría.valdec@hyperdev.site,875013,ES22209506301220461003,7234.17,2023-02-11T20:17:09,Portugalete,expenses,children,-101.63,-14641.9
buyer_7,María,Valdec,1968-12-31,02529745K,maría.valdec@hyperdev.site,875013,ES22209506301220461003,7234.17,2023-02-12T18:54:02,Portugalete,expenses,repairs,-306.1,-14948.0
buyer_7,María,Valdec,1968-12-31,02529745K,maría.valdec@hyperdev.site,875013,ES22209506301220461003,7234.17,2023-02-13T16:35:10,Portugalete,expenses,education,-46.24,-14994.24
buyer_7,María,Valdec,1968-12-31,02529745K,maría.valdec@hyperdev.site,875013,ES22209506301220461003,7234.17,2023-02-14T12:25:19,Portugalete,expenses,cash,-100.0,-15094.24
buyer_7,María,Valdec,1968-12-31,02529745K,maría.valdec@hyperdev.site,875013,ES22209506301220461003,7234.17,2023-02-15T02:18:45,Portugalete,expenses,transport,-68.57,-15162.81
buyer_7,María,Valdec,1968-12-31,02529745K,maría.valdec@hyperdev.site,875013,ES22209506301220461003,7234.17,2023-02-17T19:04:56,Portugalete,expenses,children,-353.65,-15516.46
buyer_7,María,Valdec,1968-12-31,02529745K,maría.valdec@hyperdev.site,875013,ES22209506301220461003,7234.17,2023-02-21T09:58:21,Portugalete,expenses,cash,-100.0,-15616.46
buyer_7,María,Valdec,1968-12-31,02529745K,maría.valdec@hyperdev.site,875013,ES22209506301220461003,7234.17,2023-02-21T15:06:27,Portugalete,expenses,appliances,-310.58,-15927.04
buyer_7,María,Valdec,1968-12-31,02529745K,maría.valdec@hyperdev.site,875013,ES22209506301220461003,7234.17,2023-02-23T19:57:27,Portugalete,expenses,cash,-100.0,-16027.04
buyer_7,María,Valdec,1968-12-31,02529745K,maría.valdec@hyperdev.site,875013,ES22209506301220461003,7234.17,2023-02-24T08:44:33,Portugalete,expenses,leisure,-64.42,-16091.46
buyer_7,María,Valdec,1968-12-31,02529745K,maría.valdec@hyperdev.site,875013,ES22209506301220461003,7234.17,2023-02-24T14:05:36,Portugalete,expenses,education,-42.18,-16133.64
buyer_7,María,Valdec,1968-12-31,02529745K,maría.valdec@hyperdev.site,875013,ES22209506301220461003,7234.17,2023-02-24T09:46:42,Portugalete,expenses,cash,-100.0,-16233.64
buyer_7,María,Valdec,1968-12-31,02529745K,maría.valdec@hyperdev.site,875013,ES22209506301220461003,7234.17,2023-02-25T16:36:41,Portugalete,expenses,food,-93.85,-16327.49
buyer_7,María,Valdec,1968-12-31,02529745K,maría.valdec@hyperdev.site,875013,ES22209506301220461003,7234.17,2023-02-25T13:52:33,Portugalete,expenses,education,-59.63,-16387.12
buyer_7,María,Valdec,1968-12-31,02529745K,maría.valdec@hyperdev.site,875013,ES22209506301220461003,7234.17,2023-02-25T13:32:36,Portugalete,expenses,repairs,-277.74,-16664.86
buyer_7,María,Valdec,1968-12-31,02529745K,maría.valdec@hyperdev.site,875013,ES22209506301220461003,7234.17,2023-02-26T19:29:13,Portugalete,expenses,food,-83.84,-16748.7
buyer_7,María,Valdec,1968-12-31,02529745K,maría.valdec@hyperdev.site,875013,ES22209506301220461003,7234.17,2023-02-26T20:41:39,Portugalete,expenses,leisure,-55.12,-16803.82
buyer_7,María,Valdec,1968-12-31,02529745K,maría.valdec@hyperdev.site,875013,ES22209506301220461003,7234.17,2023-02-27T01:07:02,Portugalete,expenses,transport,-75.2,-16879.02
buyer_7,María,Valdec,1968-12-31,02529745K,maría.valdec@hyperdev.site,875013,ES22209506301220461003,7234.17,2023-03-01T18:23:16,Portugalete,incomes,salary,1587.01,-15292.01
buyer_7,María,Valdec,1968-12-31,02529745K,maría.valdec@hyperdev.site,875013,ES22209506301220461003,7234.17,2023-03-02T14:08:55,Portugalete,expenses,cash,-100.0,-15392.01
buyer_7,María,Valdec,1968-12-31,02529745K,maría.valdec@hyperdev.site,875013,ES22209506301220461003,7234.17,2023-03-03T08:09:50,Portugalete,expenses,leisure,-42.21,-15434.22
buyer_7,María,Valdec,1968-12-31,02529745K,maría.valdec@hyperdev.site,875013,ES22209506301220461003,7234.17,2023-03-04T22:26:09,Portugalete,expenses,mortgage,-595.89,-16030.11
buyer_7,María,Valdec,1968-12-31,02529745K,maría.valdec@hyperdev.site,875013,ES22209506301220461003,7234.17,2023-03-05T14:42:24,Portugalete,expenses,internet,-33.33,-16063.44
buyer_7,María,Valdec,1968-12-31,02529745K,maría.valdec@hyperdev.site,875013,ES22209506301220461003,7234.17,2023-03-06T17:48:48,Portugalete,expenses,food,-66.3,-16129.74
buyer_7,María,Valdec,1968-12-31,02529745K,maría.valdec@hyperdev.site,875013,ES22209506301220461003,7234.17,2023-03-06T17:28:09,Portugalete,expenses,leisure,-34.95,-16164.69
buyer_7,María,Valdec,1968-12-31,02529745K,maría.valdec@hyperdev.site,875013,ES22209506301220461003,7234.17,2023-03-07T16:20:11,Portugalete,expenses,water,-18.94,-16183.63
buyer_7,María,Valdec,1968-12-31,02529745K,maría.valdec@hyperdev.site,875013,ES22209506301220461003,7234.17,2023-03-07T11:33:43,Portugalete,expenses,leisure,-62.52,-16246.15
buyer_7,María,Valdec,1968-12-31,02529745K,maría.valdec@hyperdev.site,875013,ES22209506301220461003,7234.17,2023-03-07T10:59:13,Portugalete,expenses,cash,-100.0,-16346.15
buyer_7,María,Valdec,1968-12-31,02529745K,maría.valdec@hyperdev.site,875013,ES22209506301220461003,7234.17,2023-03-08T14:54:22,Portugalete,expenses,electricity,-50.63,-16396.78
buyer_7,María,Valdec,1968-12-31,02529745K,maría.valdec@hyperdev.site,875013,ES22209506301220461003,7234.17,2023-03-08T06:32:29,Portugalete,expenses,gas,-45.41,-16442.19
buyer_7,María,Valdec,1968-12-31,02529745K,maría.valdec@hyperdev.site,875013,ES22209506301220461003,7234.17,2023-03-08T08:10:16,Portugalete,expenses,phone,-26.61,-16468.8
buyer_7,María,Valdec,1968-12-31,02529745K,maría.valdec@hyperdev.site,875013,ES22209506301220461003,7234.17,2023-03-11T13:20:19,Portugalete,expenses,repairs,-279.24,-16748.04
buyer_7,María,Valdec,1968-12-31,02529745K,maría.valdec@hyperdev.site,875013,ES22209506301220461003,7234.17,2023-03-12T13:36:51,Portugalete,expenses,leisure,-29.14,-16777.18
buyer_7,María,Valdec,1968-12-31,02529745K,maría.valdec@hyperdev.site,875013,ES22209506301220461003,7234.17,2023-03-13T15:43:44,Portugalete,expenses,food,-80.16,-16857.34
buyer_7,María,Valdec,1968-12-31,02529745K,maría.valdec@hyperdev.site,875013,ES22209506301220461003,7234.17,2023-03-13T08:41:32,Portugalete,expenses,transport,-72.62,-16929.96
buyer_7,María,Valdec,1968-12-31,02529745K,maría.valdec@hyperdev.site,875013,ES22209506301220461003,7234.17,2023-03-14T21:00:06,Portugalete,expenses,repairs,-244.35,-17174.31
buyer_7,María,Valdec,1968-12-31,02529745K,maría.valdec@hyperdev.site,875013,ES22209506301220461003,7234.17,2023-03-16T18:12:25,Portugalete,expenses,leisure,-35.76,-17210.07
buyer_7,María,Valdec,1968-12-31,02529745K,maría.valdec@hyperdev.site,875013,ES22209506301220461003,7234.17,2023-03-16T14:09:43,Portugalete,expenses,cash,-100.0,-17310.07
buyer_7,María,Valdec,1968-12-31,02529745K,maría.valdec@hyperdev.site,875013,ES22209506301220461003,7234.17,2023-03-19T16:02:28,Portugalete,expenses,leisure,-83.08,-17393.15
buyer_7,María,Valdec,1968-12-31,02529745K,maría.valdec@hyperdev.site,875013,ES22209506301220461003,7234.17,2023-03-20T16:36:17,Portugalete,expenses,food,-92.77,-17485.92
buyer_7,María,Valdec,1968-12-31,02529745K,maría.valdec@hyperdev.site,875013,ES22209506301220461003,7234.17,2023-03-20T20:01:20,Portugalete,expenses,cash,-100.0,-17585.92
buyer_7,María,Valdec,1968-12-31,02529745K,maría.valdec@hyperdev.site,875013,ES22209506301220461003,7234.17,2023-03-21T16:53:23,Portugalete,expenses,transport,-45.07,-17630.99
buyer_7,María,Valdec,1968-12-31,02529745K,maría.valdec@hyperdev.site,875013,ES22209506301220461003,7234.17,2023-03-21T19:10:53,Portugalete,expenses,healthcare,-89.97,-17720.96
buyer_7,María,Valdec,1968-12-31,02529745K,maría.valdec@hyperdev.site,875013,ES22209506301220461003,7234.17,2023-03-22T14:27:53,Portugalete,expenses,leisure,-79.77,-17800.73
buyer_7,María,Valdec,1968-12-31,02529745K,maría.valdec@hyperdev.site,875013,ES22209506301220461003,7234.17,2023-03-22T17:32:05,Portugalete,expenses,clothing,-115.65,-17916.38
buyer_7,María,Valdec,1968-12-31,02529745K,maría.valdec@hyperdev.site,875013,ES22209506301220461003,7234.17,2023-03-22T11:45:33,Portugalete,expenses,gifts,-35.5,-17951.88
buyer_7,María,Valdec,1968-12-31,02529745K,maría.valdec@hyperdev.site,875013,ES22209506301220461003,7234.17,2023-03-24T18:26:24,Portugalete,expenses,transport,-53.48,-18005.36
buyer_7,María,Valdec,1968-12-31,02529745K,maría.valdec@hyperdev.site,875013,ES22209506301220461003,7234.17,2023-03-24T17:01:58,Portugalete,expenses,education,-77.9,-18083.26
buyer_7,María,Valdec,1968-12-31,02529745K,maría.valdec@hyperdev.site,875013,ES22209506301220461003,7234.17,2023-03-25T08:13:55,Portugalete,expenses,appliances,-354.56,-18437.82
buyer_7,María,Valdec,1968-12-31,02529745K,maría.valdec@hyperdev.site,875013,ES22209506301220461003,7234.17,2023-03-25T15:36:00,Portugalete,expenses,gifts,-45.98,-18483.8
buyer_7,María,Valdec,1968-12-31,02529745K,maría.valdec@hyperdev.site,875013,ES22209506301220461003,7234.17,2023-03-26T11:28:05,Portugalete,expenses,cash,-100.0,-18583.8
buyer_7,María,Valdec,1968-12-31,02529745K,maría.valdec@hyperdev.site,875013,ES22209506301220461003,7234.17,2023-03-27T19:56:24,Portugalete,expenses,clothing,-136.0,-18719.8
buyer_7,María,Valdec,1968-12-31,02529745K,maría.valdec@hyperdev.site,875013,ES22209506301220461003,7234.17,2023-03-28T14:33:05,Portugalete,expenses,food,-76.89,-18796.69
buyer_7,María,Valdec,1968-12-31,02529745K,maría.valdec@hyperdev.site,875013,ES22209506301220461003,7234.17,2023-03-28T03:09:58,Portugalete,expenses,children,-177.84,-18974.53
buyer_7,María,Valdec,1968-12-31,02529745K,maría.valdec@hyperdev.site,875013,ES22209506301220461003,7234.17,2023-03-29T18:31:39,Portugalete,expenses,food,-63.0,-19037.53
buyer_7,María,Valdec,1968-12-31,02529745K,maría.valdec@hyperdev.site,875013,ES22209506301220461003,7234.17,2023-04-01T23:22:38,Portugalete,incomes,salary,1587.01,-17450.52
buyer_7,María,Valdec,1968-12-31,02529745K,maría.valdec@hyperdev.site,875013,ES22209506301220461003,7234.17,2023-04-01T18:36:00,Portugalete,expenses,education,-49.04,-17499.56
buyer_7,María,Valdec,1968-12-31,02529745K,maría.valdec@hyperdev.site,875013,ES22209506301220461003,7234.17,2023-04-01T12:59:36,Portugalete,expenses,appliances,-320.57,-17820.13
buyer_7,María,Valdec,1968-12-31,02529745K,maría.valdec@hyperdev.site,875013,ES22209506301220461003,7234.17,2023-04-02T12:44:11,Portugalete,expenses,leisure,-20.91,-17841.04
buyer_7,María,Valdec,1968-12-31,02529745K,maría.valdec@hyperdev.site,875013,ES22209506301220461003,7234.17,2023-04-02T09:58:24,Portugalete,expenses,appliances,-284.58,-18125.62
buyer_7,María,Valdec,1968-12-31,02529745K,maría.valdec@hyperdev.site,875013,ES22209506301220461003,7234.17,2023-04-04T18:18:44,Portugalete,expenses,mortgage,-595.89,-18721.51
buyer_7,María,Valdec,1968-12-31,02529745K,maría.valdec@hyperdev.site,875013,ES22209506301220461003,7234.17,2023-04-05T19:46:48,Portugalete,expenses,water,-17.23,-18738.74
buyer_7,María,Valdec,1968-12-31,02529745K,maría.valdec@hyperdev.site,875013,ES22209506301220461003,7234.17,2023-04-05T14:45:41,Portugalete,expenses,gas,-52.07,-18790.81
buyer_7,María,Valdec,1968-12-31,02529745K,maría.valdec@hyperdev.site,875013,ES22209506301220461003,7234.17,2023-04-05T13:28:34,Portugalete,expenses,transport,-45.07,-18835.88
buyer_7,María,Valdec,1968-12-31,02529745K,maría.valdec@hyperdev.site,875013,ES22209506301220461003,7234.17,2023-04-05T09:28:29,Portugalete,expenses,cash,-100.0,-18935.88
buyer_7,María,Valdec,1968-12-31,02529745K,maría.valdec@hyperdev.site,875013,ES22209506301220461003,7234.17,2023-04-07T14:37:33,Portugalete,expenses,electricity,-26.49,-18962.37
buyer_7,María,Valdec,1968-12-31,02529745K,maría.valdec@hyperdev.site,875013,ES22209506301220461003,7234.17,2023-04-07T12:22:42,Portugalete,expenses,transport,-78.4,-19040.77
buyer_7,María,Valdec,1968-12-31,02529745K,maría.valdec@hyperdev.site,875013,ES22209506301220461003,7234.17,2023-04-07T12:19:31,Portugalete,expenses,leisure,-58.13,-19098.9
buyer_7,María,Valdec,1968-12-31,02529745K,maría.valdec@hyperdev.site,875013,ES22209506301220461003,7234.17,2023-04-08T16:32:01,Portugalete,expenses,phone,-27.17,-19126.07
buyer_7,María,Valdec,1968-12-31,02529745K,maría.valdec@hyperdev.site,875013,ES22209506301220461003,7234.17,2023-04-08T08:58:10,Portugalete,expenses,internet,-33.33,-19159.4
buyer_7,María,Valdec,1968-12-31,02529745K,maría.valdec@hyperdev.site,875013,ES22209506301220461003,7234.17,2023-04-08T00:22:58,Portugalete,expenses,food,-90.78,-19250.18
buyer_7,María,Valdec,1968-12-31,02529745K,maría.valdec@hyperdev.site,875013,ES22209506301220461003,7234.17,2023-04-08T18:19:25,Portugalete,expenses,cash,-100.0,-19350.18
buyer_7,María,Valdec,1968-12-31,02529745K,maría.valdec@hyperdev.site,875013,ES22209506301220461003,7234.17,2023-04-09T09:18:54,Portugalete,expenses,food,-88.09,-19438.27
buyer_7,María,Valdec,1968-12-31,02529745K,maría.valdec@hyperdev.site,875013,ES22209506301220461003,7234.17,2023-04-09T18:02:02,Portugalete,expenses,leisure,-51.24,-19489.51
buyer_7,María,Valdec,1968-12-31,02529745K,maría.valdec@hyperdev.site,875013,ES22209506301220461003,7234.17,2023-04-11T11:12:41,Portugalete,expenses,transport,-82.69,-19572.2
buyer_7,María,Valdec,1968-12-31,02529745K,maría.valdec@hyperdev.site,875013,ES22209506301220461003,7234.17,2023-04-11T07:07:49,Portugalete,expenses,clothing,-117.61,-19689.81
buyer_7,María,Valdec,1968-12-31,02529745K,maría.valdec@hyperdev.site,875013,ES22209506301220461003,7234.17,2023-04-12T20:47:09,Portugalete,expenses,cash,-100.0,-19789.81
buyer_7,María,Valdec,1968-12-31,02529745K,maría.valdec@hyperdev.site,875013,ES22209506301220461003,7234.17,2023-04-13T04:05:37,Portugalete,expenses,education,-47.22,-19837.03
buyer_7,María,Valdec,1968-12-31,02529745K,maría.valdec@hyperdev.site,875013,ES22209506301220461003,7234.17,2023-04-17T17:58:00,Portugalete,expenses,transport,-61.6,-19898.63
buyer_7,María,Valdec,1968-12-31,02529745K,maría.valdec@hyperdev.site,875013,ES22209506301220461003,7234.17,2023-04-17T19:43:47,Portugalete,expenses,appliances,-336.28,-20234.91
buyer_7,María,Valdec,1968-12-31,02529745K,maría.valdec@hyperdev.site,875013,ES22209506301220461003,7234.17,2023-04-18T13:27:34,Portugalete,expenses,gifts,-153.51,-20388.42
buyer_7,María,Valdec,1968-12-31,02529745K,maría.valdec@hyperdev.site,875013,ES22209506301220461003,7234.17,2023-04-19T21:18:29,Portugalete,expenses,food,-75.63,-20464.05
buyer_7,María,Valdec,1968-12-31,02529745K,maría.valdec@hyperdev.site,875013,ES22209506301220461003,7234.17,2023-04-19T14:56:53,Portugalete,expenses,repairs,-130.18,-20594.23
buyer_7,María,Valdec,1968-12-31,02529745K,maría.valdec@hyperdev.site,875013,ES22209506301220461003,7234.17,2023-04-22T08:09:47,Portugalete,expenses,repairs,-313.04,-20907.27
buyer_7,María,Valdec,1968-12-31,02529745K,maría.valdec@hyperdev.site,875013,ES22209506301220461003,7234.17,2023-04-22T10:13:48,Portugalete,expenses,gifts,-30.23,-20937.5
buyer_7,María,Valdec,1968-12-31,02529745K,maría.valdec@hyperdev.site,875013,ES22209506301220461003,7234.17,2023-04-23T11:53:47,Portugalete,expenses,cash,-100.0,-21037.5
buyer_7,María,Valdec,1968-12-31,02529745K,maría.valdec@hyperdev.site,875013,ES22209506301220461003,7234.17,2023-04-23T19:24:54,Portugalete,expenses,appliances,-120.83,-21158.33
buyer_7,María,Valdec,1968-12-31,02529745K,maría.valdec@hyperdev.site,875013,ES22209506301220461003,7234.17,2023-04-25T09:35:11,Portugalete,expenses,children,-204.88,-21363.21
buyer_7,María,Valdec,1968-12-31,02529745K,maría.valdec@hyperdev.site,875013,ES22209506301220461003,7234.17,2023-04-28T14:35:16,Portugalete,expenses,leisure,-80.51,-21443.72
buyer_7,María,Valdec,1968-12-31,02529745K,maría.valdec@hyperdev.site,875013,ES22209506301220461003,7234.17,2023-04-30T13:55:48,Portugalete,expenses,appliances,-80.2,-21523.92
buyer_7,María,Valdec,1968-12-31,02529745K,maría.valdec@hyperdev.site,875013,ES22209506301220461003,7234.17,2023-05-01T13:32:25,Portugalete,incomes,salary,1587.01,-19936.91
buyer_7,María,Valdec,1968-12-31,02529745K,maría.valdec@hyperdev.site,875013,ES22209506301220461003,7234.17,2023-05-01T10:44:01,Portugalete,expenses,transport,-42.91,-19979.82
buyer_7,María,Valdec,1968-12-31,02529745K,maría.valdec@hyperdev.site,875013,ES22209506301220461003,7234.17,2023-05-01T21:52:55,Portugalete,expenses,cash,-100.0,-20079.82
buyer_7,María,Valdec,1968-12-31,02529745K,maría.valdec@hyperdev.site,875013,ES22209506301220461003,7234.17,2023-05-03T09:19:27,Portugalete,expenses,clothing,-68.43,-20148.25
buyer_7,María,Valdec,1968-12-31,02529745K,maría.valdec@hyperdev.site,875013,ES22209506301220461003,7234.17,2023-05-04T10:47:33,Portugalete,expenses,mortgage,-595.89,-20744.14
buyer_7,María,Valdec,1968-12-31,02529745K,maría.valdec@hyperdev.site,875013,ES22209506301220461003,7234.17,2023-05-05T09:44:33,Portugalete,expenses,electricity,-22.23,-20766.37
buyer_7,María,Valdec,1968-12-31,02529745K,maría.valdec@hyperdev.site,875013,ES22209506301220461003,7234.17,2023-05-05T19:28:56,Portugalete,expenses,phone,-30.88,-20797.25
buyer_7,María,Valdec,1968-12-31,02529745K,maría.valdec@hyperdev.site,875013,ES22209506301220461003,7234.17,2023-05-05T12:30:30,Portugalete,expenses,leisure,-24.6,-20821.85
buyer_7,María,Valdec,1968-12-31,02529745K,maría.valdec@hyperdev.site,875013,ES22209506301220461003,7234.17,2023-05-06T18:07:45,Portugalete,expenses,gas,-33.08,-20854.93
buyer_7,María,Valdec,1968-12-31,02529745K,maría.valdec@hyperdev.site,875013,ES22209506301220461003,7234.17,2023-05-06T16:05:08,Portugalete,expenses,clothing,-96.37,-20951.3
buyer_7,María,Valdec,1968-12-31,02529745K,maría.valdec@hyperdev.site,875013,ES22209506301220461003,7234.17,2023-05-07T14:13:01,Portugalete,expenses,water,-29.37,-20980.67
buyer_7,María,Valdec,1968-12-31,02529745K,maría.valdec@hyperdev.site,875013,ES22209506301220461003,7234.17,2023-05-07T19:20:24,Portugalete,expenses,food,-82.12,-21062.79
buyer_7,María,Valdec,1968-12-31,02529745K,maría.valdec@hyperdev.site,875013,ES22209506301220461003,7234.17,2023-05-07T12:17:05,Portugalete,expenses,repairs,-169.96,-21232.75
buyer_7,María,Valdec,1968-12-31,02529745K,maría.valdec@hyperdev.site,875013,ES22209506301220461003,7234.17,2023-05-08T08:25:39,Portugalete,expenses,internet,-33.33,-21266.08
buyer_7,María,Valdec,1968-12-31,02529745K,maría.valdec@hyperdev.site,875013,ES22209506301220461003,7234.17,2023-05-09T12:11:49,Portugalete,expenses,food,-90.95,-21357.03
buyer_7,María,Valdec,1968-12-31,02529745K,maría.valdec@hyperdev.site,875013,ES22209506301220461003,7234.17,2023-05-09T20:23:32,Portugalete,expenses,leisure,-36.51,-21393.54
buyer_7,María,Valdec,1968-12-31,02529745K,maría.valdec@hyperdev.site,875013,ES22209506301220461003,7234.17,2023-05-10T07:01:41,Portugalete,expenses,repairs,-33.89,-21427.43
buyer_7,María,Valdec,1968-12-31,02529745K,maría.valdec@hyperdev.site,875013,ES22209506301220461003,7234.17,2023-05-11T13:39:56,Portugalete,expenses,food,-83.73,-21511.16
buyer_7,María,Valdec,1968-12-31,02529745K,maría.valdec@hyperdev.site,875013,ES22209506301220461003,7234.17,2023-05-11T13:50:36,Portugalete,expenses,repairs,-286.7,-21797.86
buyer_7,María,Valdec,1968-12-31,02529745K,maría.valdec@hyperdev.site,875013,ES22209506301220461003,7234.17,2023-05-12T11:41:55,Portugalete,expenses,food,-60.57,-21858.43
buyer_7,María,Valdec,1968-12-31,02529745K,maría.valdec@hyperdev.site,875013,ES22209506301220461003,7234.17,2023-05-16T10:24:21,Portugalete,expenses,food,-86.61,-21945.04
buyer_7,María,Valdec,1968-12-31,02529745K,maría.valdec@hyperdev.site,875013,ES22209506301220461003,7234.17,2023-05-18T09:12:32,Portugalete,expenses,leisure,-24.22,-21969.26
buyer_7,María,Valdec,1968-12-31,02529745K,maría.valdec@hyperdev.site,875013,ES22209506301220461003,7234.17,2023-05-20T08:12:43,Portugalete,expenses,food,-74.07,-22043.33
buyer_7,María,Valdec,1968-12-31,02529745K,maría.valdec@hyperdev.site,875013,ES22209506301220461003,7234.17,2023-05-20T16:45:57,Portugalete,expenses,cash,-100.0,-22143.33
buyer_7,María,Valdec,1968-12-31,02529745K,maría.valdec@hyperdev.site,875013,ES22209506301220461003,7234.17,2023-05-22T09:13:14,Portugalete,expenses,food,-60.91,-22204.24
buyer_7,María,Valdec,1968-12-31,02529745K,maría.valdec@hyperdev.site,875013,ES22209506301220461003,7234.17,2023-05-22T14:42:18,Portugalete,expenses,repairs,-320.36,-22524.6
buyer_7,María,Valdec,1968-12-31,02529745K,maría.valdec@hyperdev.site,875013,ES22209506301220461003,7234.17,2023-05-24T14:51:26,Portugalete,expenses,clothing,-126.18,-22650.78
buyer_7,María,Valdec,1968-12-31,02529745K,maría.valdec@hyperdev.site,875013,ES22209506301220461003,7234.17,2023-05-29T11:05:41,Portugalete,expenses,food,-70.5,-22721.28
buyer_7,María,Valdec,1968-12-31,02529745K,maría.valdec@hyperdev.site,875013,ES22209506301220461003,7234.17,2023-05-29T21:38:50,Portugalete,expenses,leisure,-18.07,-22739.35
buyer_7,María,Valdec,1968-12-31,02529745K,maría.valdec@hyperdev.site,875013,ES22209506301220461003,7234.17,2023-05-29T12:12:03,Portugalete,expenses,gifts,-43.34,-22782.69
buyer_7,María,Valdec,1968-12-31,02529745K,maría.valdec@hyperdev.site,875013,ES22209506301220461003,7234.17,2023-05-30T15:52:05,Portugalete,expenses,transport,-45.09,-22827.78
buyer_7,María,Valdec,1968-12-31,02529745K,maría.valdec@hyperdev.site,875013,ES22209506301220461003,7234.17,2023-05-30T10:42:58,Portugalete,expenses,leisure,-22.14,-22849.92
buyer_7,María,Valdec,1968-12-31,02529745K,maría.valdec@hyperdev.site,875013,ES22209506301220461003,7234.17,2023-05-31T16:37:56,Portugalete,expenses,clothing,-143.28,-22993.2
buyer_7,María,Valdec,1968-12-31,02529745K,maría.valdec@hyperdev.site,875013,ES22209506301220461003,7234.17,2023-06-01T19:10:02,Portugalete,incomes,salary,1587.01,-21406.19
buyer_7,María,Valdec,1968-12-31,02529745K,maría.valdec@hyperdev.site,875013,ES22209506301220461003,7234.17,2023-06-01T19:10:02,Portugalete,incomes,extra_income,208.35,-21197.84
buyer_7,María,Valdec,1968-12-31,02529745K,maría.valdec@hyperdev.site,875013,ES22209506301220461003,7234.17,2023-06-01T19:10:02,Portugalete,incomes,salary_bonus,1142.29,-20055.55
buyer_7,María,Valdec,1968-12-31,02529745K,maría.valdec@hyperdev.site,875013,ES22209506301220461003,7234.17,2023-06-01T18:47:56,Portugalete,expenses,food,-102.02,-20157.57
buyer_7,María,Valdec,1968-12-31,02529745K,maría.valdec@hyperdev.site,875013,ES22209506301220461003,7234.17,2023-06-03T06:43:44,Portugalete,expenses,food,-116.24,-20273.81
buyer_7,María,Valdec,1968-12-31,02529745K,maría.valdec@hyperdev.site,875013,ES22209506301220461003,7234.17,2023-06-04T10:30:15,Portugalete,expenses,mortgage,-595.89,-20869.7
buyer_7,María,Valdec,1968-12-31,02529745K,maría.valdec@hyperdev.site,875013,ES22209506301220461003,7234.17,2023-06-04T12:52:51,Portugalete,expenses,cash,-100.0,-20969.7
buyer_7,María,Valdec,1968-12-31,02529745K,maría.valdec@hyperdev.site,875013,ES22209506301220461003,7234.17,2023-06-05T21:39:12,Portugalete,expenses,water,-28.36,-20998.06
buyer_7,María,Valdec,1968-12-31,02529745K,maría.valdec@hyperdev.site,875013,ES22209506301220461003,7234.17,2023-06-05T14:59:27,Portugalete,expenses,food,-70.26,-21068.32
buyer_7,María,Valdec,1968-12-31,02529745K,maría.valdec@hyperdev.site,875013,ES22209506301220461003,7234.17,2023-06-06T18:31:18,Portugalete,expenses,electricity,-56.08,-21124.4
buyer_7,María,Valdec,1968-12-31,02529745K,maría.valdec@hyperdev.site,875013,ES22209506301220461003,7234.17,2023-06-06T00:05:43,Portugalete,expenses,gas,-72.83,-21197.23
buyer_7,María,Valdec,1968-12-31,02529745K,maría.valdec@hyperdev.site,875013,ES22209506301220461003,7234.17,2023-06-08T17:50:10,Portugalete,expenses,phone,-35.01,-21232.24
buyer_7,María,Valdec,1968-12-31,02529745K,maría.valdec@hyperdev.site,875013,ES22209506301220461003,7234.17,2023-06-08T14:20:01,Portugalete,expenses,internet,-33.33,-21265.57
buyer_7,María,Valdec,1968-12-31,02529745K,maría.valdec@hyperdev.site,875013,ES22209506301220461003,7234.17,2023-06-09T12:22:44,Portugalete,expenses,food,-112.07,-21377.64
buyer_7,María,Valdec,1968-12-31,02529745K,maría.valdec@hyperdev.site,875013,ES22209506301220461003,7234.17,2023-06-09T22:35:58,Portugalete,expenses,repairs,-240.8,-21618.44
buyer_7,María,Valdec,1968-12-31,02529745K,maría.valdec@hyperdev.site,875013,ES22209506301220461003,7234.17,2023-06-09T20:58:52,Portugalete,expenses,children,-95.73,-21714.17
buyer_7,María,Valdec,1968-12-31,02529745K,maría.valdec@hyperdev.site,875013,ES22209506301220461003,7234.17,2023-06-10T21:33:17,Portugalete,expenses,food,-111.77,-21825.94
buyer_7,María,Valdec,1968-12-31,02529745K,maría.valdec@hyperdev.site,875013,ES22209506301220461003,7234.17,2023-06-10T11:40:42,Portugalete,expenses,clothing,-84.28,-21910.22
buyer_7,María,Valdec,1968-12-31,02529745K,maría.valdec@hyperdev.site,875013,ES22209506301220461003,7234.17,2023-06-11T20:12:02,Portugalete,expenses,gifts,-44.47,-21954.69
buyer_7,María,Valdec,1968-12-31,02529745K,maría.valdec@hyperdev.site,875013,ES22209506301220461003,7234.17,2023-06-12T09:43:08,Portugalete,expenses,leisure,-47.82,-22002.51
buyer_7,María,Valdec,1968-12-31,02529745K,maría.valdec@hyperdev.site,875013,ES22209506301220461003,7234.17,2023-06-12T09:22:38,Portugalete,expenses,travel,-331.03,-22333.54
buyer_7,María,Valdec,1968-12-31,02529745K,maría.valdec@hyperdev.site,875013,ES22209506301220461003,7234.17,2023-06-13T20:48:23,Portugalete,expenses,food,-81.81,-22415.35
buyer_7,María,Valdec,1968-12-31,02529745K,maría.valdec@hyperdev.site,875013,ES22209506301220461003,7234.17,2023-06-13T16:06:12,Portugalete,expenses,education,-64.92,-22480.27
buyer_7,María,Valdec,1968-12-31,02529745K,maría.valdec@hyperdev.site,875013,ES22209506301220461003,7234.17,2023-06-15T16:14:46,Portugalete,expenses,leisure,-76.88,-22557.15
buyer_7,María,Valdec,1968-12-31,02529745K,maría.valdec@hyperdev.site,875013,ES22209506301220461003,7234.17,2023-06-16T16:38:30,Portugalete,expenses,cash,-100.0,-22657.15
buyer_7,María,Valdec,1968-12-31,02529745K,maría.valdec@hyperdev.site,875013,ES22209506301220461003,7234.17,2023-06-19T10:48:14,Portugalete,expenses,cash,-100.0,-22757.15
buyer_7,María,Valdec,1968-12-31,02529745K,maría.valdec@hyperdev.site,875013,ES22209506301220461003,7234.17,2023-06-20T08:56:03,Portugalete,expenses,cash,-100.0,-22857.15
buyer_7,María,Valdec,1968-12-31,02529745K,maría.valdec@hyperdev.site,875013,ES22209506301220461003,7234.17,2023-06-21T19:58:46,Portugalete,expenses,leisure,-41.77,-22898.92
buyer_7,María,Valdec,1968-12-31,02529745K,maría.valdec@hyperdev.site,875013,ES22209506301220461003,7234.17,2023-06-21T10:21:24,Portugalete,expenses,appliances,-118.79,-23017.71
buyer_7,María,Valdec,1968-12-31,02529745K,maría.valdec@hyperdev.site,875013,ES22209506301220461003,7234.17,2023-06-22T11:39:19,Portugalete,expenses,leisure,-45.78,-23063.49
buyer_7,María,Valdec,1968-12-31,02529745K,maría.valdec@hyperdev.site,875013,ES22209506301220461003,7234.17,2023-06-22T12:02:45,Portugalete,expenses,clothing,-116.57,-23180.06
buyer_7,María,Valdec,1968-12-31,02529745K,maría.valdec@hyperdev.site,875013,ES22209506301220461003,7234.17,2023-06-22T20:14:08,Portugalete,expenses,cash,-100.0,-23280.06
buyer_7,María,Valdec,1968-12-31,02529745K,maría.valdec@hyperdev.site,875013,ES22209506301220461003,7234.17,2023-06-23T16:47:40,Portugalete,expenses,cash,-100.0,-23380.06
buyer_7,María,Valdec,1968-12-31,02529745K,maría.valdec@hyperdev.site,875013,ES22209506301220461003,7234.17,2023-06-26T09:53:22,Portugalete,expenses,transport,-58.07,-23438.13
buyer_7,María,Valdec,1968-12-31,02529745K,maría.valdec@hyperdev.site,875013,ES22209506301220461003,7234.17,2023-06-26T16:15:00,Portugalete,expenses,cash,-100.0,-23538.13
buyer_7,María,Valdec,1968-12-31,02529745K,maría.valdec@hyperdev.site,875013,ES22209506301220461003,7234.17,2023-06-26T06:16:25,Portugalete,expenses,appliances,-209.7,-23747.83
buyer_7,María,Valdec,1968-12-31,02529745K,maría.valdec@hyperdev.site,875013,ES22209506301220461003,7234.17,2023-06-28T07:03:55,Portugalete,expenses,food,-78.7,-23826.53
buyer_7,María,Valdec,1968-12-31,02529745K,maría.valdec@hyperdev.site,875013,ES22209506301220461003,7234.17,2023-06-29T11:18:57,Portugalete,expenses,healthcare,-104.98,-23931.51
buyer_7,María,Valdec,1968-12-31,02529745K,maría.valdec@hyperdev.site,875013,ES22209506301220461003,7234.17,2023-06-30T11:04:31,Portugalete,expenses,food,-92.83,-24024.34
buyer_7,María,Valdec,1968-12-31,02529745K,maría.valdec@hyperdev.site,875013,ES22209506301220461003,7234.17,2023-06-30T19:38:17,Portugalete,expenses,cash,-100.0,-24124.34
buyer_7,María,Valdec,1968-12-31,02529745K,maría.valdec@hyperdev.site,875013,ES22209506301220461003,7234.17,2023-07-01T15:28:04,Portugalete,incomes,salary,1587.01,-22537.33
buyer_7,María,Valdec,1968-12-31,02529745K,maría.valdec@hyperdev.site,875013,ES22209506301220461003,7234.17,2023-07-01T22:49:23,Portugalete,expenses,transport,-58.66,-22595.99
buyer_7,María,Valdec,1968-12-31,02529745K,maría.valdec@hyperdev.site,875013,ES22209506301220461003,7234.17,2023-07-03T18:56:40,Portugalete,expenses,food,-91.23,-22687.22
buyer_7,María,Valdec,1968-12-31,02529745K,maría.valdec@hyperdev.site,875013,ES22209506301220461003,7234.17,2023-07-03T15:50:31,Portugalete,expenses,leisure,-68.83,-22756.05
buyer_7,María,Valdec,1968-12-31,02529745K,maría.valdec@hyperdev.site,875013,ES22209506301220461003,7234.17,2023-07-04T12:14:48,Portugalete,expenses,mortgage,-595.89,-23351.94
buyer_7,María,Valdec,1968-12-31,02529745K,maría.valdec@hyperdev.site,875013,ES22209506301220461003,7234.17,2023-07-05T02:19:41,Portugalete,expenses,water,-18.06,-23370.0
buyer_7,María,Valdec,1968-12-31,02529745K,maría.valdec@hyperdev.site,875013,ES22209506301220461003,7234.17,2023-07-05T17:33:23,Portugalete,expenses,children,-180.21,-23550.21
buyer_7,María,Valdec,1968-12-31,02529745K,maría.valdec@hyperdev.site,875013,ES22209506301220461003,7234.17,2023-07-06T16:54:01,Portugalete,expenses,gifts,-153.36,-23703.57
buyer_7,María,Valdec,1968-12-31,02529745K,maría.valdec@hyperdev.site,875013,ES22209506301220461003,7234.17,2023-07-07T16:59:48,Portugalete,expenses,leisure,-68.02,-23771.59
buyer_7,María,Valdec,1968-12-31,02529745K,maría.valdec@hyperdev.site,875013,ES22209506301220461003,7234.17,2023-07-08T08:53:01,Portugalete,expenses,gas,-68.35,-23839.94
buyer_7,María,Valdec,1968-12-31,02529745K,maría.valdec@hyperdev.site,875013,ES22209506301220461003,7234.17,2023-07-08T19:59:48,Portugalete,expenses,phone,-24.37,-23864.31
buyer_7,María,Valdec,1968-12-31,02529745K,maría.valdec@hyperdev.site,875013,ES22209506301220461003,7234.17,2023-07-08T08:31:24,Portugalete,expenses,electricity,-20.6,-23884.91
buyer_7,María,Valdec,1968-12-31,02529745K,maría.valdec@hyperdev.site,875013,ES22209506301220461003,7234.17,2023-07-08T23:29:57,Portugalete,expenses,internet,-33.33,-23918.24
buyer_7,María,Valdec,1968-12-31,02529745K,maría.valdec@hyperdev.site,875013,ES22209506301220461003,7234.17,2023-07-08T14:52:12,Portugalete,expenses,cash,-100.0,-24018.24
buyer_7,María,Valdec,1968-12-31,02529745K,maría.valdec@hyperdev.site,875013,ES22209506301220461003,7234.17,2023-07-08T10:18:33,Portugalete,expenses,travel,-288.08,-24306.32
buyer_7,María,Valdec,1968-12-31,02529745K,maría.valdec@hyperdev.site,875013,ES22209506301220461003,7234.17,2023-07-10T04:03:04,Portugalete,expenses,transport,-73.57,-24379.89
buyer_7,María,Valdec,1968-12-31,02529745K,maría.valdec@hyperdev.site,875013,ES22209506301220461003,7234.17,2023-07-11T11:10:42,Portugalete,expenses,food,-67.52,-24447.41
buyer_7,María,Valdec,1968-12-31,02529745K,maría.valdec@hyperdev.site,875013,ES22209506301220461003,7234.17,2023-07-12T21:31:23,Portugalete,expenses,gifts,-309.87,-24757.28
buyer_7,María,Valdec,1968-12-31,02529745K,maría.valdec@hyperdev.site,875013,ES22209506301220461003,7234.17,2023-07-13T13:07:24,Portugalete,expenses,education,-77.75,-24835.03
buyer_7,María,Valdec,1968-12-31,02529745K,maría.valdec@hyperdev.site,875013,ES22209506301220461003,7234.17,2023-07-14T12:59:41,Portugalete,expenses,transport,-52.47,-24887.5
buyer_7,María,Valdec,1968-12-31,02529745K,maría.valdec@hyperdev.site,875013,ES22209506301220461003,7234.17,2023-07-16T22:52:59,Portugalete,expenses,education,-63.45,-24950.95
buyer_7,María,Valdec,1968-12-31,02529745K,maría.valdec@hyperdev.site,875013,ES22209506301220461003,7234.17,2023-07-16T14:38:34,Portugalete,expenses,cash,-100.0,-25050.95
buyer_7,María,Valdec,1968-12-31,02529745K,maría.valdec@hyperdev.site,875013,ES22209506301220461003,7234.17,2023-07-17T13:54:11,Portugalete,expenses,food,-117.21,-25168.16
buyer_7,María,Valdec,1968-12-31,02529745K,maría.valdec@hyperdev.site,875013,ES22209506301220461003,7234.17,2023-07-19T18:56:41,Portugalete,expenses,food,-71.6,-25239.76
buyer_7,María,Valdec,1968-12-31,02529745K,maría.valdec@hyperdev.site,875013,ES22209506301220461003,7234.17,2023-07-21T15:34:33,Portugalete,expenses,leisure,-59.86,-25299.62
buyer_7,María,Valdec,1968-12-31,02529745K,maría.valdec@hyperdev.site,875013,ES22209506301220461003,7234.17,2023-07-23T18:18:24,Portugalete,expenses,cash,-100.0,-25399.62
buyer_7,María,Valdec,1968-12-31,02529745K,maría.valdec@hyperdev.site,875013,ES22209506301220461003,7234.17,2023-07-23T10:18:10,Portugalete,expenses,gifts,-163.55,-25563.17
buyer_7,María,Valdec,1968-12-31,02529745K,maría.valdec@hyperdev.site,875013,ES22209506301220461003,7234.17,2023-07-24T06:40:04,Portugalete,expenses,transport,-89.95,-25653.12
buyer_7,María,Valdec,1968-12-31,02529745K,maría.valdec@hyperdev.site,875013,ES22209506301220461003,7234.17,2023-07-24T22:17:13,Portugalete,expenses,cash,-100.0,-25753.12
buyer_7,María,Valdec,1968-12-31,02529745K,maría.valdec@hyperdev.site,875013,ES22209506301220461003,7234.17,2023-07-25T13:58:09,Portugalete,expenses,education,-76.46,-25829.58
buyer_7,María,Valdec,1968-12-31,02529745K,maría.valdec@hyperdev.site,875013,ES22209506301220461003,7234.17,2023-07-25T12:21:44,Portugalete,expenses,cash,-100.0,-25929.58
buyer_7,María,Valdec,1968-12-31,02529745K,maría.valdec@hyperdev.site,875013,ES22209506301220461003,7234.17,2023-07-27T19:35:51,Portugalete,expenses,clothing,-95.66,-26025.24
buyer_7,María,Valdec,1968-12-31,02529745K,maría.valdec@hyperdev.site,875013,ES22209506301220461003,7234.17,2023-07-27T10:38:27,Portugalete,expenses,repairs,-137.73,-26162.97
buyer_7,María,Valdec,1968-12-31,02529745K,maría.valdec@hyperdev.site,875013,ES22209506301220461003,7234.17,2023-07-28T08:19:10,Portugalete,expenses,healthcare,-85.03,-26248.0
buyer_7,María,Valdec,1968-12-31,02529745K,maría.valdec@hyperdev.site,875013,ES22209506301220461003,7234.17,2023-07-28T20:40:28,Portugalete,expenses,travel,-340.03,-26588.03
buyer_7,María,Valdec,1968-12-31,02529745K,maría.valdec@hyperdev.site,875013,ES22209506301220461003,7234.17,2023-07-30T12:26:27,Portugalete,expenses,transport,-65.46,-26653.49
buyer_7,María,Valdec,1968-12-31,02529745K,maría.valdec@hyperdev.site,875013,ES22209506301220461003,7234.17,2023-08-01T12:14:43,Portugalete,incomes,salary,1587.01,-25066.48
buyer_7,María,Valdec,1968-12-31,02529745K,maría.valdec@hyperdev.site,875013,ES22209506301220461003,7234.17,2023-08-01T03:56:58,Portugalete,expenses,leisure,-67.52,-25134.0
buyer_7,María,Valdec,1968-12-31,02529745K,maría.valdec@hyperdev.site,875013,ES22209506301220461003,7234.17,2023-08-01T17:11:12,Portugalete,expenses,cash,-100.0,-25234.0
buyer_7,María,Valdec,1968-12-31,02529745K,maría.valdec@hyperdev.site,875013,ES22209506301220461003,7234.17,2023-08-01T23:39:24,Portugalete,expenses,appliances,-132.08,-25366.08
buyer_7,María,Valdec,1968-12-31,02529745K,maría.valdec@hyperdev.site,875013,ES22209506301220461003,7234.17,2023-08-01T09:14:33,Portugalete,expenses,repairs,-27.22,-25393.3
buyer_7,María,Valdec,1968-12-31,02529745K,maría.valdec@hyperdev.site,875013,ES22209506301220461003,7234.17,2023-08-02T12:52:55,Portugalete,expenses,food,-100.54,-25493.84
buyer_7,María,Valdec,1968-12-31,02529745K,maría.valdec@hyperdev.site,875013,ES22209506301220461003,7234.17,2023-08-04T20:05:09,Portugalete,expenses,mortgage,-595.89,-26089.73
buyer_7,María,Valdec,1968-12-31,02529745K,maría.valdec@hyperdev.site,875013,ES22209506301220461003,7234.17,2023-08-05T09:18:46,Portugalete,expenses,internet,-33.33,-26123.06
buyer_7,María,Valdec,1968-12-31,02529745K,maría.valdec@hyperdev.site,875013,ES22209506301220461003,7234.17,2023-08-06T16:11:29,Portugalete,expenses,electricity,-65.44,-26188.5
buyer_7,María,Valdec,1968-12-31,02529745K,maría.valdec@hyperdev.site,875013,ES22209506301220461003,7234.17,2023-08-06T16:41:46,Portugalete,expenses,phone,-29.91,-26218.41
buyer_7,María,Valdec,1968-12-31,02529745K,maría.valdec@hyperdev.site,875013,ES22209506301220461003,7234.17,2023-08-07T14:23:45,Portugalete,expenses,food,-66.68,-26285.09
buyer_7,María,Valdec,1968-12-31,02529745K,maría.valdec@hyperdev.site,875013,ES22209506301220461003,7234.17,2023-08-08T13:10:24,Portugalete,expenses,water,-18.18,-26303.27
buyer_7,María,Valdec,1968-12-31,02529745K,maría.valdec@hyperdev.site,875013,ES22209506301220461003,7234.17,2023-08-08T09:17:25,Portugalete,expenses,gas,-28.71,-26331.98
buyer_7,María,Valdec,1968-12-31,02529745K,maría.valdec@hyperdev.site,875013,ES22209506301220461003,7234.17,2023-08-08T09:46:47,Portugalete,expenses,repairs,-269.65,-26601.63
buyer_7,María,Valdec,1968-12-31,02529745K,maría.valdec@hyperdev.site,875013,ES22209506301220461003,7234.17,2023-08-09T02:34:11,Portugalete,expenses,gifts,-85.06,-26686.69
buyer_7,María,Valdec,1968-12-31,02529745K,maría.valdec@hyperdev.site,875013,ES22209506301220461003,7234.17,2023-08-10T18:59:16,Portugalete,expenses,education,-62.91,-26749.6
buyer_7,María,Valdec,1968-12-31,02529745K,maría.valdec@hyperdev.site,875013,ES22209506301220461003,7234.17,2023-08-10T07:40:56,Portugalete,expenses,gifts,-294.51,-27044.11
buyer_7,María,Valdec,1968-12-31,02529745K,maría.valdec@hyperdev.site,875013,ES22209506301220461003,7234.17,2023-08-14T17:08:49,Portugalete,expenses,leisure,-71.77,-27115.88
buyer_7,María,Valdec,1968-12-31,02529745K,maría.valdec@hyperdev.site,875013,ES22209506301220461003,7234.17,2023-08-15T04:16:15,Portugalete,expenses,food,-68.22,-27184.1
buyer_7,María,Valdec,1968-12-31,02529745K,maría.valdec@hyperdev.site,875013,ES22209506301220461003,7234.17,2023-08-16T13:03:32,Portugalete,expenses,education,-43.44,-27227.54
buyer_7,María,Valdec,1968-12-31,02529745K,maría.valdec@hyperdev.site,875013,ES22209506301220461003,7234.17,2023-08-16T19:25:44,Portugalete,expenses,repairs,-285.38,-27512.92
buyer_7,María,Valdec,1968-12-31,02529745K,maría.valdec@hyperdev.site,875013,ES22209506301220461003,7234.17,2023-08-17T04:42:01,Portugalete,expenses,repairs,-262.9,-27775.82
buyer_7,María,Valdec,1968-12-31,02529745K,maría.valdec@hyperdev.site,875013,ES22209506301220461003,7234.17,2023-08-18T13:29:11,Portugalete,expenses,transport,-45.51,-27821.33
buyer_7,María,Valdec,1968-12-31,02529745K,maría.valdec@hyperdev.site,875013,ES22209506301220461003,7234.17,2023-08-19T13:21:30,Portugalete,expenses,transport,-83.27,-27904.6
buyer_7,María,Valdec,1968-12-31,02529745K,maría.valdec@hyperdev.site,875013,ES22209506301220461003,7234.17,2023-08-19T12:40:55,Portugalete,expenses,cash,-100.0,-28004.6
buyer_7,María,Valdec,1968-12-31,02529745K,maría.valdec@hyperdev.site,875013,ES22209506301220461003,7234.17,2023-08-20T19:08:37,Portugalete,expenses,appliances,-157.96,-28162.56
buyer_7,María,Valdec,1968-12-31,02529745K,maría.valdec@hyperdev.site,875013,ES22209506301220461003,7234.17,2023-08-21T00:39:05,Portugalete,expenses,food,-120.37,-28282.93
buyer_7,María,Valdec,1968-12-31,02529745K,maría.valdec@hyperdev.site,875013,ES22209506301220461003,7234.17,2023-08-22T10:49:39,Portugalete,expenses,healthcare,-55.7,-28338.63
buyer_7,María,Valdec,1968-12-31,02529745K,maría.valdec@hyperdev.site,875013,ES22209506301220461003,7234.17,2023-08-22T20:55:30,Portugalete,expenses,repairs,-156.69,-28495.32
buyer_7,María,Valdec,1968-12-31,02529745K,maría.valdec@hyperdev.site,875013,ES22209506301220461003,7234.17,2023-08-24T16:02:03,Portugalete,expenses,leisure,-50.69,-28546.01
buyer_7,María,Valdec,1968-12-31,02529745K,maría.valdec@hyperdev.site,875013,ES22209506301220461003,7234.17,2023-08-26T09:48:49,Portugalete,expenses,clothing,-61.92,-28607.93
buyer_7,María,Valdec,1968-12-31,02529745K,maría.valdec@hyperdev.site,875013,ES22209506301220461003,7234.17,2023-08-27T10:37:12,Portugalete,expenses,food,-101.06,-28708.99
buyer_7,María,Valdec,1968-12-31,02529745K,maría.valdec@hyperdev.site,875013,ES22209506301220461003,7234.17,2023-08-28T14:37:35,Portugalete,expenses,clothing,-64.19,-28773.18
buyer_7,María,Valdec,1968-12-31,02529745K,maría.valdec@hyperdev.site,875013,ES22209506301220461003,7234.17,2023-08-30T17:21:49,Portugalete,expenses,children,-344.97,-29118.15
buyer_7,María,Valdec,1968-12-31,02529745K,maría.valdec@hyperdev.site,875013,ES22209506301220461003,7234.17,2023-08-31T20:07:46,Portugalete,expenses,education,-42.19,-29160.34
buyer_7,María,Valdec,1968-12-31,02529745K,maría.valdec@hyperdev.site,875013,ES22209506301220461003,7234.17,2023-09-01T15:56:24,Portugalete,incomes,salary,1587.01,-27573.33
buyer_7,María,Valdec,1968-12-31,02529745K,maría.valdec@hyperdev.site,875013,ES22209506301220461003,7234.17,2023-09-01T15:56:24,Portugalete,incomes,extra_income,208.35,-27364.98
buyer_7,María,Valdec,1968-12-31,02529745K,maría.valdec@hyperdev.site,875013,ES22209506301220461003,7234.17,2023-09-01T23:00:12,Portugalete,expenses,transport,-48.22,-27413.2
buyer_7,María,Valdec,1968-12-31,02529745K,maría.valdec@hyperdev.site,875013,ES22209506301220461003,7234.17,2023-09-01T10:13:14,Portugalete,expenses,children,-118.25,-27531.45
buyer_7,María,Valdec,1968-12-31,02529745K,maría.valdec@hyperdev.site,875013,ES22209506301220461003,7234.17,2023-09-02T13:00:55,Portugalete,expenses,food,-85.27,-27616.72
buyer_7,María,Valdec,1968-12-31,02529745K,maría.valdec@hyperdev.site,875013,ES22209506301220461003,7234.17,2023-09-04T15:20:20,Portugalete,expenses,mortgage,-595.89,-28212.61
buyer_7,María,Valdec,1968-12-31,02529745K,maría.valdec@hyperdev.site,875013,ES22209506301220461003,7234.17,2023-09-04T09:37:55,Portugalete,expenses,cash,-100.0,-28312.61
buyer_7,María,Valdec,1968-12-31,02529745K,maría.valdec@hyperdev.site,875013,ES22209506301220461003,7234.17,2023-09-04T16:17:10,Portugalete,expenses,repairs,-300.37,-28612.98
buyer_7,María,Valdec,1968-12-31,02529745K,maría.valdec@hyperdev.site,875013,ES22209506301220461003,7234.17,2023-09-05T21:43:29,Portugalete,expenses,phone,-27.19,-28640.17
buyer_7,María,Valdec,1968-12-31,02529745K,maría.valdec@hyperdev.site,875013,ES22209506301220461003,7234.17,2023-09-05T16:38:51,Portugalete,expenses,food,-80.43,-28720.6
buyer_7,María,Valdec,1968-12-31,02529745K,maría.valdec@hyperdev.site,875013,ES22209506301220461003,7234.17,2023-09-05T20:10:07,Portugalete,expenses,travel,-280.7,-29001.3
buyer_7,María,Valdec,1968-12-31,02529745K,maría.valdec@hyperdev.site,875013,ES22209506301220461003,7234.17,2023-09-05T13:29:52,Portugalete,expenses,gifts,-67.91,-29069.21
buyer_7,María,Valdec,1968-12-31,02529745K,maría.valdec@hyperdev.site,875013,ES22209506301220461003,7234.17,2023-09-06T08:10:45,Portugalete,expenses,cash,-100.0,-29169.21
buyer_7,María,Valdec,1968-12-31,02529745K,maría.valdec@hyperdev.site,875013,ES22209506301220461003,7234.17,2023-09-07T11:10:22,Portugalete,expenses,gas,-59.77,-29228.98
buyer_7,María,Valdec,1968-12-31,02529745K,maría.valdec@hyperdev.site,875013,ES22209506301220461003,7234.17,2023-09-08T18:57:11,Portugalete,expenses,water,-21.31,-29250.29
buyer_7,María,Valdec,1968-12-31,02529745K,maría.valdec@hyperdev.site,875013,ES22209506301220461003,7234.17,2023-09-08T22:18:03,Portugalete,expenses,electricity,-68.38,-29318.67
buyer_7,María,Valdec,1968-12-31,02529745K,maría.valdec@hyperdev.site,875013,ES22209506301220461003,7234.17,2023-09-08T12:41:27,Portugalete,expenses,internet,-33.33,-29352.0
buyer_7,María,Valdec,1968-12-31,02529745K,maría.valdec@hyperdev.site,875013,ES22209506301220461003,7234.17,2023-09-08T11:28:21,Portugalete,expenses,leisure,-43.69,-29395.69
buyer_7,María,Valdec,1968-12-31,02529745K,maría.valdec@hyperdev.site,875013,ES22209506301220461003,7234.17,2023-09-10T03:05:48,Portugalete,expenses,repairs,-287.86,-29683.55
buyer_7,María,Valdec,1968-12-31,02529745K,maría.valdec@hyperdev.site,875013,ES22209506301220461003,7234.17,2023-09-11T18:57:50,Portugalete,expenses,food,-99.59,-29783.14
buyer_7,María,Valdec,1968-12-31,02529745K,maría.valdec@hyperdev.site,875013,ES22209506301220461003,7234.17,2023-09-13T11:47:53,Portugalete,expenses,transport,-40.11,-29823.25
buyer_7,María,Valdec,1968-12-31,02529745K,maría.valdec@hyperdev.site,875013,ES22209506301220461003,7234.17,2023-09-14T13:26:24,Portugalete,expenses,leisure,-79.93,-29903.18
buyer_7,María,Valdec,1968-12-31,02529745K,maría.valdec@hyperdev.site,875013,ES22209506301220461003,7234.17,2023-09-14T12:23:37,Portugalete,expenses,children,-259.56,-30162.74
buyer_7,María,Valdec,1968-12-31,02529745K,maría.valdec@hyperdev.site,875013,ES22209506301220461003,7234.17,2023-09-15T13:28:14,Portugalete,expenses,children,-251.52,-30414.26
buyer_7,María,Valdec,1968-12-31,02529745K,maría.valdec@hyperdev.site,875013,ES22209506301220461003,7234.17,2023-09-16T20:40:46,Portugalete,expenses,appliances,-166.96,-30581.22
buyer_7,María,Valdec,1968-12-31,02529745K,maría.valdec@hyperdev.site,875013,ES22209506301220461003,7234.17,2023-09-17T20:49:24,Portugalete,expenses,cash,-100.0,-30681.22
buyer_7,María,Valdec,1968-12-31,02529745K,maría.valdec@hyperdev.site,875013,ES22209506301220461003,7234.17,2023-09-18T21:17:27,Portugalete,expenses,clothing,-57.77,-30738.99
buyer_7,María,Valdec,1968-12-31,02529745K,maría.valdec@hyperdev.site,875013,ES22209506301220461003,7234.17,2023-09-18T16:27:54,Portugalete,expenses,cash,-100.0,-30838.99
buyer_7,María,Valdec,1968-12-31,02529745K,maría.valdec@hyperdev.site,875013,ES22209506301220461003,7234.17,2023-09-18T20:56:27,Portugalete,expenses,gifts,-154.72,-30993.71
buyer_7,María,Valdec,1968-12-31,02529745K,maría.valdec@hyperdev.site,875013,ES22209506301220461003,7234.17,2023-09-19T13:58:48,Portugalete,expenses,healthcare,-153.87,-31147.58
buyer_7,María,Valdec,1968-12-31,02529745K,maría.valdec@hyperdev.site,875013,ES22209506301220461003,7234.17,2023-09-20T09:34:02,Portugalete,expenses,leisure,-44.98,-31192.56
buyer_7,María,Valdec,1968-12-31,02529745K,maría.valdec@hyperdev.site,875013,ES22209506301220461003,7234.17,2023-09-21T13:49:28,Portugalete,expenses,children,-94.09,-31286.65
buyer_7,María,Valdec,1968-12-31,02529745K,maría.valdec@hyperdev.site,875013,ES22209506301220461003,7234.17,2023-09-22T13:13:44,Portugalete,expenses,cash,-100.0,-31386.65
buyer_7,María,Valdec,1968-12-31,02529745K,maría.valdec@hyperdev.site,875013,ES22209506301220461003,7234.17,2023-09-22T16:33:10,Portugalete,expenses,gifts,-137.7,-31524.35
buyer_7,María,Valdec,1968-12-31,02529745K,maría.valdec@hyperdev.site,875013,ES22209506301220461003,7234.17,2023-09-23T19:18:34,Portugalete,expenses,leisure,-60.87,-31585.22
buyer_7,María,Valdec,1968-12-31,02529745K,maría.valdec@hyperdev.site,875013,ES22209506301220461003,7234.17,2023-09-28T15:27:05,Portugalete,expenses,repairs,-302.16,-31887.38
buyer_7,María,Valdec,1968-12-31,02529745K,maría.valdec@hyperdev.site,875013,ES22209506301220461003,7234.17,2023-09-29T12:55:02,Portugalete,expenses,food,-112.75,-32000.13
buyer_7,María,Valdec,1968-12-31,02529745K,maría.valdec@hyperdev.site,875013,ES22209506301220461003,7234.17,2023-09-30T12:40:29,Portugalete,expenses,cash,-100.0,-32100.13
buyer_7,María,Valdec,1968-12-31,02529745K,maría.valdec@hyperdev.site,875013,ES22209506301220461003,7234.17,2023-10-01T20:45:33,Portugalete,incomes,salary,1587.01,-30513.12
buyer_7,María,Valdec,1968-12-31,02529745K,maría.valdec@hyperdev.site,875013,ES22209506301220461003,7234.17,2023-10-02T14:26:25,Portugalete,expenses,gifts,-67.61,-30580.73
buyer_7,María,Valdec,1968-12-31,02529745K,maría.valdec@hyperdev.site,875013,ES22209506301220461003,7234.17,2023-10-02T10:32:17,Portugalete,expenses,children,-381.2801666666665,-30962.01
buyer_7,María,Valdec,1968-12-31,02529745K,maría.valdec@hyperdev.site,875013,ES22209506301220461003,7234.17,2023-10-03T00:50:36,Portugalete,expenses,children,-296.09,-31258.1
buyer_7,María,Valdec,1968-12-31,02529745K,maría.valdec@hyperdev.site,875013,ES22209506301220461003,7234.17,2023-10-04T12:33:49,Portugalete,expenses,mortgage,-595.89,-31853.99
buyer_7,María,Valdec,1968-12-31,02529745K,maría.valdec@hyperdev.site,875013,ES22209506301220461003,7234.17,2023-10-05T10:37:36,Portugalete,expenses,food,-105.49,-31959.48
buyer_7,María,Valdec,1968-12-31,02529745K,maría.valdec@hyperdev.site,875013,ES22209506301220461003,7234.17,2023-10-05T13:12:15,Portugalete,expenses,cash,-100.0,-32059.48
buyer_7,María,Valdec,1968-12-31,02529745K,maría.valdec@hyperdev.site,875013,ES22209506301220461003,7234.17,2023-10-06T17:54:57,Portugalete,expenses,internet,-33.33,-32092.81
buyer_7,María,Valdec,1968-12-31,02529745K,maría.valdec@hyperdev.site,875013,ES22209506301220461003,7234.17,2023-10-06T19:11:57,Portugalete,expenses,phone,-33.54,-32126.35
buyer_7,María,Valdec,1968-12-31,02529745K,maría.valdec@hyperdev.site,875013,ES22209506301220461003,7234.17,2023-10-06T07:23:49,Portugalete,expenses,leisure,-59.37,-32185.72
buyer_7,María,Valdec,1968-12-31,02529745K,maría.valdec@hyperdev.site,875013,ES22209506301220461003,7234.17,2023-10-06T12:28:37,Portugalete,expenses,cash,-100.0,-32285.72
buyer_7,María,Valdec,1968-12-31,02529745K,maría.valdec@hyperdev.site,875013,ES22209506301220461003,7234.17,2023-10-06T17:45:54,Portugalete,expenses,children,-239.72,-32525.44
buyer_7,María,Valdec,1968-12-31,02529745K,maría.valdec@hyperdev.site,875013,ES22209506301220461003,7234.17,2023-10-08T18:06:42,Portugalete,expenses,water,-26.06,-32551.5
buyer_7,María,Valdec,1968-12-31,02529745K,maría.valdec@hyperdev.site,875013,ES22209506301220461003,7234.17,2023-10-08T11:18:28,Portugalete,expenses,electricity,-47.1,-32598.6
buyer_7,María,Valdec,1968-12-31,02529745K,maría.valdec@hyperdev.site,875013,ES22209506301220461003,7234.17,2023-10-08T19:28:18,Portugalete,expenses,gas,-41.45,-32640.05
buyer_7,María,Valdec,1968-12-31,02529745K,maría.valdec@hyperdev.site,875013,ES22209506301220461003,7234.17,2023-10-08T10:32:31,Portugalete,expenses,cash,-100.0,-32740.05
buyer_7,María,Valdec,1968-12-31,02529745K,maría.valdec@hyperdev.site,875013,ES22209506301220461003,7234.17,2023-10-08T19:00:40,Portugalete,expenses,gifts,-197.32,-32937.37
buyer_7,María,Valdec,1968-12-31,02529745K,maría.valdec@hyperdev.site,875013,ES22209506301220461003,7234.17,2023-10-09T00:20:35,Portugalete,expenses,food,-64.1,-33001.47
buyer_7,María,Valdec,1968-12-31,02529745K,maría.valdec@hyperdev.site,875013,ES22209506301220461003,7234.17,2023-10-10T20:58:37,Portugalete,expenses,food,-82.43,-33083.9
buyer_7,María,Valdec,1968-12-31,02529745K,maría.valdec@hyperdev.site,875013,ES22209506301220461003,7234.17,2023-10-11T21:13:53,Portugalete,expenses,children,-168.87,-33252.77
buyer_7,María,Valdec,1968-12-31,02529745K,maría.valdec@hyperdev.site,875013,ES22209506301220461003,7234.17,2023-10-12T14:18:54,Portugalete,expenses,repairs,-95.74,-33348.51
buyer_7,María,Valdec,1968-12-31,02529745K,maría.valdec@hyperdev.site,875013,ES22209506301220461003,7234.17,2023-10-13T16:50:01,Portugalete,expenses,repairs,-103.38,-33451.89
buyer_7,María,Valdec,1968-12-31,02529745K,maría.valdec@hyperdev.site,875013,ES22209506301220461003,7234.17,2023-10-14T10:44:47,Portugalete,expenses,transport,-57.21,-33509.1
buyer_7,María,Valdec,1968-12-31,02529745K,maría.valdec@hyperdev.site,875013,ES22209506301220461003,7234.17,2023-10-15T08:47:28,Portugalete,expenses,appliances,-181.46,-33690.56
buyer_7,María,Valdec,1968-12-31,02529745K,maría.valdec@hyperdev.site,875013,ES22209506301220461003,7234.17,2023-10-17T20:31:56,Portugalete,expenses,transport,-80.5,-33771.06
buyer_7,María,Valdec,1968-12-31,02529745K,maría.valdec@hyperdev.site,875013,ES22209506301220461003,7234.17,2023-10-17T13:30:41,Portugalete,expenses,cash,-100.0,-33871.06
buyer_7,María,Valdec,1968-12-31,02529745K,maría.valdec@hyperdev.site,875013,ES22209506301220461003,7234.17,2023-10-18T15:48:22,Portugalete,expenses,clothing,-111.53,-33982.59
buyer_7,María,Valdec,1968-12-31,02529745K,maría.valdec@hyperdev.site,875013,ES22209506301220461003,7234.17,2023-10-18T23:51:45,Portugalete,expenses,appliances,-277.37,-34259.96
buyer_7,María,Valdec,1968-12-31,02529745K,maría.valdec@hyperdev.site,875013,ES22209506301220461003,7234.17,2023-10-19T15:22:20,Portugalete,expenses,leisure,-71.92,-34331.88
buyer_7,María,Valdec,1968-12-31,02529745K,maría.valdec@hyperdev.site,875013,ES22209506301220461003,7234.17,2023-10-21T00:03:49,Portugalete,expenses,transport,-43.17,-34375.05
buyer_7,María,Valdec,1968-12-31,02529745K,maría.valdec@hyperdev.site,875013,ES22209506301220461003,7234.17,2023-10-22T09:11:49,Portugalete,expenses,gifts,-228.36,-34603.41
buyer_7,María,Valdec,1968-12-31,02529745K,maría.valdec@hyperdev.site,875013,ES22209506301220461003,7234.17,2023-10-26T23:16:06,Portugalete,expenses,cash,-100.0,-34703.41
buyer_7,María,Valdec,1968-12-31,02529745K,maría.valdec@hyperdev.site,875013,ES22209506301220461003,7234.17,2023-10-26T15:44:54,Portugalete,expenses,children,-340.42,-35043.83
buyer_7,María,Valdec,1968-12-31,02529745K,maría.valdec@hyperdev.site,875013,ES22209506301220461003,7234.17,2023-10-27T14:51:48,Portugalete,expenses,leisure,-28.29,-35072.12
buyer_7,María,Valdec,1968-12-31,02529745K,maría.valdec@hyperdev.site,875013,ES22209506301220461003,7234.17,2023-10-29T18:09:53,Portugalete,expenses,gifts,-187.92,-35260.04
buyer_7,María,Valdec,1968-12-31,02529745K,maría.valdec@hyperdev.site,875013,ES22209506301220461003,7234.17,2023-10-31T19:10:48,Portugalete,expenses,transport,-44.03,-35304.07
buyer_7,María,Valdec,1968-12-31,02529745K,maría.valdec@hyperdev.site,875013,ES22209506301220461003,7234.17,2023-11-01T16:04:38,Portugalete,incomes,salary,1587.01,-33717.06
buyer_7,María,Valdec,1968-12-31,02529745K,maría.valdec@hyperdev.site,875013,ES22209506301220461003,7234.17,2023-11-01T13:06:51,Portugalete,expenses,cash,-100.0,-33817.06
buyer_7,María,Valdec,1968-12-31,02529745K,maría.valdec@hyperdev.site,875013,ES22209506301220461003,7234.17,2023-11-02T20:43:26,Portugalete,expenses,food,-81.37,-33898.43
buyer_7,María,Valdec,1968-12-31,02529745K,maría.valdec@hyperdev.site,875013,ES22209506301220461003,7234.17,2023-11-02T08:36:26,Portugalete,expenses,cash,-100.0,-33998.43
buyer_7,María,Valdec,1968-12-31,02529745K,maría.valdec@hyperdev.site,875013,ES22209506301220461003,7234.17,2023-11-02T10:15:44,Portugalete,expenses,gifts,-179.82,-34178.25
buyer_7,María,Valdec,1968-12-31,02529745K,maría.valdec@hyperdev.site,875013,ES22209506301220461003,7234.17,2023-11-03T21:56:15,Portugalete,expenses,cash,-100.0,-34278.25
buyer_7,María,Valdec,1968-12-31,02529745K,maría.valdec@hyperdev.site,875013,ES22209506301220461003,7234.17,2023-11-04T11:21:03,Portugalete,expenses,mortgage,-595.89,-34874.14
buyer_7,María,Valdec,1968-12-31,02529745K,maría.valdec@hyperdev.site,875013,ES22209506301220461003,7234.17,2023-11-05T23:41:34,Portugalete,expenses,internet,-33.33,-34907.47
buyer_7,María,Valdec,1968-12-31,02529745K,maría.valdec@hyperdev.site,875013,ES22209506301220461003,7234.17,2023-11-05T15:29:46,Portugalete,expenses,food,-75.54,-34983.01
buyer_7,María,Valdec,1968-12-31,02529745K,maría.valdec@hyperdev.site,875013,ES22209506301220461003,7234.17,2023-11-06T17:09:22,Portugalete,expenses,water,-15.99,-34999.0
buyer_7,María,Valdec,1968-12-31,02529745K,maría.valdec@hyperdev.site,875013,ES22209506301220461003,7234.17,2023-11-06T14:33:37,Portugalete,expenses,children,-331.24,-35330.24
buyer_7,María,Valdec,1968-12-31,02529745K,maría.valdec@hyperdev.site,875013,ES22209506301220461003,7234.17,2023-11-07T16:52:21,Portugalete,expenses,electricity,-35.12,-35365.36
buyer_7,María,Valdec,1968-12-31,02529745K,maría.valdec@hyperdev.site,875013,ES22209506301220461003,7234.17,2023-11-07T19:23:16,Portugalete,expenses,gas,-29.91,-35395.27
buyer_7,María,Valdec,1968-12-31,02529745K,maría.valdec@hyperdev.site,875013,ES22209506301220461003,7234.17,2023-11-07T16:23:37,Portugalete,expenses,phone,-31.35,-35426.62
buyer_7,María,Valdec,1968-12-31,02529745K,maría.valdec@hyperdev.site,875013,ES22209506301220461003,7234.17,2023-11-07T11:55:45,Portugalete,expenses,cash,-100.0,-35526.62
buyer_7,María,Valdec,1968-12-31,02529745K,maría.valdec@hyperdev.site,875013,ES22209506301220461003,7234.17,2023-11-08T21:20:29,Portugalete,expenses,education,-53.46,-35580.08
buyer_7,María,Valdec,1968-12-31,02529745K,maría.valdec@hyperdev.site,875013,ES22209506301220461003,7234.17,2023-11-09T15:38:41,Portugalete,expenses,repairs,-60.34,-35640.42
buyer_7,María,Valdec,1968-12-31,02529745K,maría.valdec@hyperdev.site,875013,ES22209506301220461003,7234.17,2023-11-10T15:02:52,Portugalete,expenses,cash,-100.0,-35740.42
buyer_7,María,Valdec,1968-12-31,02529745K,maría.valdec@hyperdev.site,875013,ES22209506301220461003,7234.17,2023-11-11T08:49:40,Portugalete,expenses,food,-116.06,-35856.48
buyer_7,María,Valdec,1968-12-31,02529745K,maría.valdec@hyperdev.site,875013,ES22209506301220461003,7234.17,2023-11-13T18:39:07,Portugalete,expenses,cash,-100.0,-35956.48
buyer_7,María,Valdec,1968-12-31,02529745K,maría.valdec@hyperdev.site,875013,ES22209506301220461003,7234.17,2023-11-16T14:09:00,Portugalete,expenses,leisure,-22.1,-35978.58
buyer_7,María,Valdec,1968-12-31,02529745K,maría.valdec@hyperdev.site,875013,ES22209506301220461003,7234.17,2023-11-17T13:07:39,Portugalete,expenses,education,-55.79,-36034.37
buyer_7,María,Valdec,1968-12-31,02529745K,maría.valdec@hyperdev.site,875013,ES22209506301220461003,7234.17,2023-11-19T18:07:46,Portugalete,expenses,gifts,-148.86,-36183.23
buyer_7,María,Valdec,1968-12-31,02529745K,maría.valdec@hyperdev.site,875013,ES22209506301220461003,7234.17,2023-11-20T13:45:11,Portugalete,expenses,leisure,-76.01,-36259.24
buyer_7,María,Valdec,1968-12-31,02529745K,maría.valdec@hyperdev.site,875013,ES22209506301220461003,7234.17,2023-11-20T08:19:23,Portugalete,expenses,education,-48.97,-36308.21
buyer_7,María,Valdec,1968-12-31,02529745K,maría.valdec@hyperdev.site,875013,ES22209506301220461003,7234.17,2023-11-20T19:27:45,Portugalete,expenses,children,-271.75,-36579.96
buyer_7,María,Valdec,1968-12-31,02529745K,maría.valdec@hyperdev.site,875013,ES22209506301220461003,7234.17,2023-11-23T23:23:37,Portugalete,expenses,cash,-100.0,-36679.96
buyer_7,María,Valdec,1968-12-31,02529745K,maría.valdec@hyperdev.site,875013,ES22209506301220461003,7234.17,2023-11-24T16:33:21,Portugalete,expenses,education,-50.71,-36730.67
buyer_7,María,Valdec,1968-12-31,02529745K,maría.valdec@hyperdev.site,875013,ES22209506301220461003,7234.17,2023-11-24T11:08:30,Portugalete,expenses,gifts,-111.96,-36842.63
buyer_7,María,Valdec,1968-12-31,02529745K,maría.valdec@hyperdev.site,875013,ES22209506301220461003,7234.17,2023-11-25T18:25:55,Portugalete,expenses,cash,-100.0,-36942.63
buyer_7,María,Valdec,1968-12-31,02529745K,maría.valdec@hyperdev.site,875013,ES22209506301220461003,7234.17,2023-11-26T15:37:20,Portugalete,expenses,food,-80.55,-37023.18
buyer_7,María,Valdec,1968-12-31,02529745K,maría.valdec@hyperdev.site,875013,ES22209506301220461003,7234.17,2023-11-27T17:59:01,Portugalete,expenses,healthcare,-56.82,-37080.0
buyer_7,María,Valdec,1968-12-31,02529745K,maría.valdec@hyperdev.site,875013,ES22209506301220461003,7234.17,2023-11-27T12:04:45,Portugalete,expenses,cash,-100.0,-37180.0
buyer_7,María,Valdec,1968-12-31,02529745K,maría.valdec@hyperdev.site,875013,ES22209506301220461003,7234.17,2023-11-29T12:27:04,Portugalete,expenses,food,-82.46,-37262.46
buyer_7,María,Valdec,1968-12-31,02529745K,maría.valdec@hyperdev.site,875013,ES22209506301220461003,7234.17,2023-12-01T12:19:11,Portugalete,incomes,salary,1587.01,-35675.45
buyer_7,María,Valdec,1968-12-31,02529745K,maría.valdec@hyperdev.site,875013,ES22209506301220461003,7234.17,2023-12-01T12:19:11,Portugalete,incomes,extra_income,208.35,-35467.1
buyer_7,María,Valdec,1968-12-31,02529745K,maría.valdec@hyperdev.site,875013,ES22209506301220461003,7234.17,2023-12-01T12:19:11,Portugalete,incomes,salary_bonus,1122.96,-34344.14
buyer_7,María,Valdec,1968-12-31,02529745K,maría.valdec@hyperdev.site,875013,ES22209506301220461003,7234.17,2023-12-01T19:15:33,Portugalete,expenses,transport,-82.87,-34427.01
buyer_7,María,Valdec,1968-12-31,02529745K,maría.valdec@hyperdev.site,875013,ES22209506301220461003,7234.17,2023-12-02T12:02:25,Portugalete,expenses,healthcare,-101.17,-34528.18
buyer_7,María,Valdec,1968-12-31,02529745K,maría.valdec@hyperdev.site,875013,ES22209506301220461003,7234.17,2023-12-04T13:17:35,Portugalete,expenses,mortgage,-595.89,-35124.07
buyer_7,María,Valdec,1968-12-31,02529745K,maría.valdec@hyperdev.site,875013,ES22209506301220461003,7234.17,2023-12-04T08:26:04,Portugalete,expenses,healthcare,-91.35,-35215.42
buyer_7,María,Valdec,1968-12-31,02529745K,maría.valdec@hyperdev.site,875013,ES22209506301220461003,7234.17,2023-12-04T14:37:03,Portugalete,expenses,cash,-100.0,-35315.42
buyer_7,María,Valdec,1968-12-31,02529745K,maría.valdec@hyperdev.site,875013,ES22209506301220461003,7234.17,2023-12-05T17:34:45,Portugalete,expenses,electricity,-41.37,-35356.79
buyer_7,María,Valdec,1968-12-31,02529745K,maría.valdec@hyperdev.site,875013,ES22209506301220461003,7234.17,2023-12-05T15:12:25,Portugalete,expenses,gas,-43.96,-35400.75
buyer_7,María,Valdec,1968-12-31,02529745K,maría.valdec@hyperdev.site,875013,ES22209506301220461003,7234.17,2023-12-05T17:11:56,Portugalete,expenses,leisure,-45.16,-35445.91
buyer_7,María,Valdec,1968-12-31,02529745K,maría.valdec@hyperdev.site,875013,ES22209506301220461003,7234.17,2023-12-06T15:59:11,Portugalete,expenses,phone,-35.31,-35481.22
buyer_7,María,Valdec,1968-12-31,02529745K,maría.valdec@hyperdev.site,875013,ES22209506301220461003,7234.17,2023-12-07T07:06:03,Portugalete,expenses,internet,-33.33,-35514.55
buyer_7,María,Valdec,1968-12-31,02529745K,maría.valdec@hyperdev.site,875013,ES22209506301220461003,7234.17,2023-12-07T23:47:08,Portugalete,expenses,clothing,-102.41,-35616.96
buyer_7,María,Valdec,1968-12-31,02529745K,maría.valdec@hyperdev.site,875013,ES22209506301220461003,7234.17,2023-12-07T13:49:11,Portugalete,expenses,cash,-100.0,-35716.96
buyer_7,María,Valdec,1968-12-31,02529745K,maría.valdec@hyperdev.site,875013,ES22209506301220461003,7234.17,2023-12-08T08:14:18,Portugalete,expenses,water,-18.42,-35735.38
buyer_7,María,Valdec,1968-12-31,02529745K,maría.valdec@hyperdev.site,875013,ES22209506301220461003,7234.17,2023-12-08T12:25:06,Portugalete,expenses,food,-84.47,-35819.85
buyer_7,María,Valdec,1968-12-31,02529745K,maría.valdec@hyperdev.site,875013,ES22209506301220461003,7234.17,2023-12-08T20:53:19,Portugalete,expenses,transport,-68.72,-35888.57
buyer_7,María,Valdec,1968-12-31,02529745K,maría.valdec@hyperdev.site,875013,ES22209506301220461003,7234.17,2023-12-11T18:28:13,Portugalete,expenses,food,-80.25,-35968.82
buyer_7,María,Valdec,1968-12-31,02529745K,maría.valdec@hyperdev.site,875013,ES22209506301220461003,7234.17,2023-12-13T13:29:10,Portugalete,expenses,food,-85.79,-36054.61
buyer_7,María,Valdec,1968-12-31,02529745K,maría.valdec@hyperdev.site,875013,ES22209506301220461003,7234.17,2023-12-13T11:20:55,Portugalete,expenses,travel,-281.98,-36336.59
buyer_7,María,Valdec,1968-12-31,02529745K,maría.valdec@hyperdev.site,875013,ES22209506301220461003,7234.17,2023-12-16T23:28:23,Portugalete,expenses,travel,-382.69,-36719.28
buyer_7,María,Valdec,1968-12-31,02529745K,maría.valdec@hyperdev.site,875013,ES22209506301220461003,7234.17,2023-12-17T14:53:20,Portugalete,expenses,leisure,-78.01,-36797.29
buyer_7,María,Valdec,1968-12-31,02529745K,maría.valdec@hyperdev.site,875013,ES22209506301220461003,7234.17,2023-12-18T10:13:14,Portugalete,expenses,food,-90.3,-36887.59
buyer_7,María,Valdec,1968-12-31,02529745K,maría.valdec@hyperdev.site,875013,ES22209506301220461003,7234.17,2023-12-18T13:14:26,Portugalete,expenses,cash,-100.0,-36987.59
buyer_7,María,Valdec,1968-12-31,02529745K,maría.valdec@hyperdev.site,875013,ES22209506301220461003,7234.17,2023-12-18T06:38:20,Portugalete,expenses,car,-108.46,-37096.05
buyer_7,María,Valdec,1968-12-31,02529745K,maría.valdec@hyperdev.site,875013,ES22209506301220461003,7234.17,2023-12-21T20:27:05,Portugalete,expenses,gifts,-130.28,-37226.33
buyer_7,María,Valdec,1968-12-31,02529745K,maría.valdec@hyperdev.site,875013,ES22209506301220461003,7234.17,2023-12-25T21:26:09,Portugalete,expenses,transport,-57.64,-37283.97
buyer_7,María,Valdec,1968-12-31,02529745K,maría.valdec@hyperdev.site,875013,ES22209506301220461003,7234.17,2023-12-25T02:25:34,Portugalete,expenses,cash,-100.0,-37383.97
buyer_7,María,Valdec,1968-12-31,02529745K,maría.valdec@hyperdev.site,875013,ES22209506301220461003,7234.17,2023-12-26T19:32:16,Portugalete,expenses,cash,-100.0,-37483.97
buyer_7,María,Valdec,1968-12-31,02529745K,maría.valdec@hyperdev.site,875013,ES22209506301220461003,7234.17,2023-12-26T17:57:35,Portugalete,expenses,travel,-347.15,-37831.12
buyer_7,María,Valdec,1968-12-31,02529745K,maría.valdec@hyperdev.site,875013,ES22209506301220461003,7234.17,2023-12-27T14:50:22,Portugalete,expenses,gifts,-84.81,-37915.93
buyer_7,María,Valdec,1968-12-31,02529745K,maría.valdec@hyperdev.site,875013,ES22209506301220461003,7234.17,2023-12-28T10:52:55,Portugalete,expenses,food,-74.01,-37989.94
buyer_7,María,Valdec,1968-12-31,02529745K,maría.valdec@hyperdev.site,875013,ES22209506301220461003,7234.17,2023-12-28T14:40:13,Portugalete,expenses,leisure,-31.19,-38021.13
buyer_7,María,Valdec,1968-12-31,02529745K,maría.valdec@hyperdev.site,875013,ES22209506301220461003,7234.17,2023-12-30T09:56:26,Portugalete,expenses,food,-83.47,-38104.6
buyer_7,María,Valdec,1968-12-31,02529745K,maría.valdec@hyperdev.site,875013,ES22209506301220461003,7234.17,2023-12-31T18:08:39,Portugalete,expenses,leisure,-79.32,-38183.92
buyer_7,María,Valdec,1968-12-31,02529745K,maría.valdec@hyperdev.site,875013,ES22209506301220461003,7234.17,2024-01-01T16:18:21,Portugalete,incomes,salary,1634.83,-36549.09
buyer_7,María,Valdec,1968-12-31,02529745K,maría.valdec@hyperdev.site,875013,ES22209506301220461003,7234.17,2024-01-02T16:04:54,Portugalete,expenses,food,-88.96,-36638.05
buyer_7,María,Valdec,1968-12-31,02529745K,maría.valdec@hyperdev.site,875013,ES22209506301220461003,7234.17,2024-01-02T18:17:24,Portugalete,expenses,travel,-278.58,-36916.63
buyer_7,María,Valdec,1968-12-31,02529745K,maría.valdec@hyperdev.site,875013,ES22209506301220461003,7234.17,2024-01-04T07:51:07,Portugalete,expenses,mortgage,-879.12,-37795.75
buyer_7,María,Valdec,1968-12-31,02529745K,maría.valdec@hyperdev.site,875013,ES22209506301220461003,7234.17,2024-01-04T11:16:34,Portugalete,expenses,transport,-85.58,-37881.33
buyer_7,María,Valdec,1968-12-31,02529745K,maría.valdec@hyperdev.site,875013,ES22209506301220461003,7234.17,2024-01-04T13:56:58,Portugalete,expenses,cash,-100.0,-37981.33
buyer_7,María,Valdec,1968-12-31,02529745K,maría.valdec@hyperdev.site,875013,ES22209506301220461003,7234.17,2024-01-06T17:49:46,Portugalete,expenses,water,-33.8,-38015.13
buyer_7,María,Valdec,1968-12-31,02529745K,maría.valdec@hyperdev.site,875013,ES22209506301220461003,7234.17,2024-01-06T19:42:10,Portugalete,expenses,phone,-24.89,-38040.02
buyer_7,María,Valdec,1968-12-31,02529745K,maría.valdec@hyperdev.site,875013,ES22209506301220461003,7234.17,2024-01-07T20:39:40,Portugalete,expenses,gas,-28.71,-38068.73
buyer_7,María,Valdec,1968-12-31,02529745K,maría.valdec@hyperdev.site,875013,ES22209506301220461003,7234.17,2024-01-07T20:24:10,Portugalete,expenses,food,-72.81,-38141.54
buyer_7,María,Valdec,1968-12-31,02529745K,maría.valdec@hyperdev.site,875013,ES22209506301220461003,7234.17,2024-01-07T17:55:39,Portugalete,expenses,clothing,-92.05,-38233.59
buyer_7,María,Valdec,1968-12-31,02529745K,maría.valdec@hyperdev.site,875013,ES22209506301220461003,7234.17,2024-01-08T13:28:38,Portugalete,expenses,electricity,-53.31,-38286.9
buyer_7,María,Valdec,1968-12-31,02529745K,maría.valdec@hyperdev.site,875013,ES22209506301220461003,7234.17,2024-01-08T06:54:01,Portugalete,expenses,internet,-34.33,-38321.23
buyer_7,María,Valdec,1968-12-31,02529745K,maría.valdec@hyperdev.site,875013,ES22209506301220461003,7234.17,2024-01-08T15:25:05,Portugalete,expenses,transport,-56.42,-38377.65
buyer_7,María,Valdec,1968-12-31,02529745K,maría.valdec@hyperdev.site,875013,ES22209506301220461003,7234.17,2024-01-08T14:50:53,Portugalete,expenses,education,-55.78,-38433.43
buyer_7,María,Valdec,1968-12-31,02529745K,maría.valdec@hyperdev.site,875013,ES22209506301220461003,7234.17,2024-01-09T15:27:51,Portugalete,expenses,gifts,-76.94,-38510.37
buyer_7,María,Valdec,1968-12-31,02529745K,maría.valdec@hyperdev.site,875013,ES22209506301220461003,7234.17,2024-01-11T19:36:35,Portugalete,expenses,transport,-53.54,-38563.91
buyer_7,María,Valdec,1968-12-31,02529745K,maría.valdec@hyperdev.site,875013,ES22209506301220461003,7234.17,2024-01-12T03:00:27,Portugalete,expenses,transport,-44.46,-38608.37
buyer_7,María,Valdec,1968-12-31,02529745K,maría.valdec@hyperdev.site,875013,ES22209506301220461003,7234.17,2024-01-13T14:05:54,Portugalete,expenses,education,-77.82,-38686.19
buyer_7,María,Valdec,1968-12-31,02529745K,maría.valdec@hyperdev.site,875013,ES22209506301220461003,7234.17,2024-01-15T13:14:29,Portugalete,expenses,cash,-100.0,-38786.19
buyer_7,María,Valdec,1968-12-31,02529745K,maría.valdec@hyperdev.site,875013,ES22209506301220461003,7234.17,2024-01-16T10:20:22,Portugalete,expenses,leisure,-69.83,-38856.02
buyer_7,María,Valdec,1968-12-31,02529745K,maría.valdec@hyperdev.site,875013,ES22209506301220461003,7234.17,2024-01-16T20:41:26,Portugalete,expenses,cash,-100.0,-38956.02
buyer_7,María,Valdec,1968-12-31,02529745K,maría.valdec@hyperdev.site,875013,ES22209506301220461003,7234.17,2024-01-17T15:25:01,Portugalete,expenses,children,-305.6625833333333,-39261.68
buyer_7,María,Valdec,1968-12-31,02529745K,maría.valdec@hyperdev.site,875013,ES22209506301220461003,7234.17,2024-01-18T11:58:00,Portugalete,expenses,cash,-100.0,-39361.68
buyer_7,María,Valdec,1968-12-31,02529745K,maría.valdec@hyperdev.site,875013,ES22209506301220461003,7234.17,2024-01-21T21:09:50,Portugalete,expenses,cash,-100.0,-39461.68
buyer_7,María,Valdec,1968-12-31,02529745K,maría.valdec@hyperdev.site,875013,ES22209506301220461003,7234.17,2024-01-22T08:00:50,Portugalete,expenses,healthcare,-139.49,-39601.17
buyer_7,María,Valdec,1968-12-31,02529745K,maría.valdec@hyperdev.site,875013,ES22209506301220461003,7234.17,2024-01-23T10:34:11,Portugalete,expenses,cash,-100.0,-39701.17
buyer_7,María,Valdec,1968-12-31,02529745K,maría.valdec@hyperdev.site,875013,ES22209506301220461003,7234.17,2024-01-24T23:00:19,Portugalete,expenses,food,-71.49,-39772.66
buyer_7,María,Valdec,1968-12-31,02529745K,maría.valdec@hyperdev.site,875013,ES22209506301220461003,7234.17,2024-01-24T20:56:42,Portugalete,expenses,children,-234.1725833333333,-40006.83
buyer_7,María,Valdec,1968-12-31,02529745K,maría.valdec@hyperdev.site,875013,ES22209506301220461003,7234.17,2024-01-26T20:08:58,Portugalete,expenses,leisure,-69.87,-40076.7
buyer_7,María,Valdec,1968-12-31,02529745K,maría.valdec@hyperdev.site,875013,ES22209506301220461003,7234.17,2024-01-28T11:25:51,Portugalete,expenses,cash,-100.0,-40176.7
buyer_7,María,Valdec,1968-12-31,02529745K,maría.valdec@hyperdev.site,875013,ES22209506301220461003,7234.17,2024-01-29T09:21:28,Portugalete,expenses,food,-92.07,-40268.77
buyer_7,María,Valdec,1968-12-31,02529745K,maría.valdec@hyperdev.site,875013,ES22209506301220461003,7234.17,2024-01-29T19:36:21,Portugalete,expenses,appliances,-196.99,-40465.76
buyer_7,María,Valdec,1968-12-31,02529745K,maría.valdec@hyperdev.site,875013,ES22209506301220461003,7234.17,2024-01-30T20:45:58,Portugalete,expenses,cash,-100.0,-40565.76
buyer_7,María,Valdec,1968-12-31,02529745K,maría.valdec@hyperdev.site,875013,ES22209506301220461003,7234.17,2024-02-01T05:27:30,Portugalete,incomes,salary,1634.83,-38930.93
buyer_7,María,Valdec,1968-12-31,02529745K,maría.valdec@hyperdev.site,875013,ES22209506301220461003,7234.17,2024-02-01T09:00:47,Portugalete,expenses,food,-85.28,-39016.21
buyer_7,María,Valdec,1968-12-31,02529745K,maría.valdec@hyperdev.site,875013,ES22209506301220461003,7234.17,2024-02-01T16:15:17,Portugalete,expenses,cash,-100.0,-39116.21
buyer_7,María,Valdec,1968-12-31,02529745K,maría.valdec@hyperdev.site,875013,ES22209506301220461003,7234.17,2024-02-03T11:16:21,Portugalete,expenses,education,-63.0,-39179.21
buyer_7,María,Valdec,1968-12-31,02529745K,maría.valdec@hyperdev.site,875013,ES22209506301220461003,7234.17,2024-02-04T08:00:17,Portugalete,expenses,mortgage,-879.12,-40058.33
buyer_7,María,Valdec,1968-12-31,02529745K,maría.valdec@hyperdev.site,875013,ES22209506301220461003,7234.17,2024-02-04T15:05:08,Portugalete,expenses,cash,-100.0,-40158.33
buyer_7,María,Valdec,1968-12-31,02529745K,maría.valdec@hyperdev.site,875013,ES22209506301220461003,7234.17,2024-02-05T10:22:56,Portugalete,expenses,food,-81.12,-40239.45
buyer_7,María,Valdec,1968-12-31,02529745K,maría.valdec@hyperdev.site,875013,ES22209506301220461003,7234.17,2024-02-05T20:37:28,Portugalete,expenses,cash,-100.0,-40339.45
buyer_7,María,Valdec,1968-12-31,02529745K,maría.valdec@hyperdev.site,875013,ES22209506301220461003,7234.17,2024-02-06T15:42:02,Portugalete,expenses,water,-30.59,-40370.04
buyer_7,María,Valdec,1968-12-31,02529745K,maría.valdec@hyperdev.site,875013,ES22209506301220461003,7234.17,2024-02-06T22:43:04,Portugalete,expenses,food,-98.74,-40468.78
buyer_7,María,Valdec,1968-12-31,02529745K,maría.valdec@hyperdev.site,875013,ES22209506301220461003,7234.17,2024-02-07T19:01:55,Portugalete,expenses,electricity,-24.66,-40493.44
buyer_7,María,Valdec,1968-12-31,02529745K,maría.valdec@hyperdev.site,875013,ES22209506301220461003,7234.17,2024-02-07T18:31:39,Portugalete,expenses,internet,-34.33,-40527.77
buyer_7,María,Valdec,1968-12-31,02529745K,maría.valdec@hyperdev.site,875013,ES22209506301220461003,7234.17,2024-02-07T08:07:42,Portugalete,expenses,repairs,-294.24,-40822.01
buyer_7,María,Valdec,1968-12-31,02529745K,maría.valdec@hyperdev.site,875013,ES22209506301220461003,7234.17,2024-02-08T19:56:28,Portugalete,expenses,gas,-75.77,-40897.78
buyer_7,María,Valdec,1968-12-31,02529745K,maría.valdec@hyperdev.site,875013,ES22209506301220461003,7234.17,2024-02-08T14:52:06,Portugalete,expenses,phone,-34.71,-40932.49
buyer_7,María,Valdec,1968-12-31,02529745K,maría.valdec@hyperdev.site,875013,ES22209506301220461003,7234.17,2024-02-08T00:30:58,Portugalete,expenses,food,-93.49,-41025.98
buyer_7,María,Valdec,1968-12-31,02529745K,maría.valdec@hyperdev.site,875013,ES22209506301220461003,7234.17,2024-02-08T15:25:02,Portugalete,expenses,transport,-68.49,-41094.47
buyer_7,María,Valdec,1968-12-31,02529745K,maría.valdec@hyperdev.site,875013,ES22209506301220461003,7234.17,2024-02-08T17:40:29,Portugalete,expenses,leisure,-27.6,-41122.07
buyer_7,María,Valdec,1968-12-31,02529745K,maría.valdec@hyperdev.site,875013,ES22209506301220461003,7234.17,2024-02-08T08:03:31,Portugalete,expenses,children,-116.08258333333333,-41238.15
buyer_7,María,Valdec,1968-12-31,02529745K,maría.valdec@hyperdev.site,875013,ES22209506301220461003,7234.17,2024-02-09T23:44:34,Portugalete,expenses,education,-70.21,-41308.36
buyer_7,María,Valdec,1968-12-31,02529745K,maría.valdec@hyperdev.site,875013,ES22209506301220461003,7234.17,2024-02-10T10:53:47,Portugalete,expenses,food,-101.91,-41410.27
buyer_7,María,Valdec,1968-12-31,02529745K,maría.valdec@hyperdev.site,875013,ES22209506301220461003,7234.17,2024-02-10T19:59:41,Portugalete,expenses,education,-67.03,-41477.3
buyer_7,María,Valdec,1968-12-31,02529745K,maría.valdec@hyperdev.site,875013,ES22209506301220461003,7234.17,2024-02-11T21:56:06,Portugalete,expenses,food,-97.82,-41575.12
buyer_7,María,Valdec,1968-12-31,02529745K,maría.valdec@hyperdev.site,875013,ES22209506301220461003,7234.17,2024-02-13T14:18:45,Portugalete,expenses,food,-79.79,-41654.91
buyer_7,María,Valdec,1968-12-31,02529745K,maría.valdec@hyperdev.site,875013,ES22209506301220461003,7234.17,2024-02-15T08:48:38,Portugalete,expenses,education,-70.61,-41725.52
buyer_7,María,Valdec,1968-12-31,02529745K,maría.valdec@hyperdev.site,875013,ES22209506301220461003,7234.17,2024-02-16T17:39:00,Portugalete,expenses,leisure,-58.06,-41783.58
buyer_7,María,Valdec,1968-12-31,02529745K,maría.valdec@hyperdev.site,875013,ES22209506301220461003,7234.17,2024-02-18T14:06:48,Portugalete,expenses,leisure,-18.18,-41801.76
buyer_7,María,Valdec,1968-12-31,02529745K,maría.valdec@hyperdev.site,875013,ES22209506301220461003,7234.17,2024-02-18T20:10:17,Portugalete,expenses,cash,-100.0,-41901.76
buyer_7,María,Valdec,1968-12-31,02529745K,maría.valdec@hyperdev.site,875013,ES22209506301220461003,7234.17,2024-02-19T15:21:50,Portugalete,expenses,appliances,-144.75,-42046.51
buyer_7,María,Valdec,1968-12-31,02529745K,maría.valdec@hyperdev.site,875013,ES22209506301220461003,7234.17,2024-02-20T12:06:08,Portugalete,expenses,food,-115.65,-42162.16
buyer_7,María,Valdec,1968-12-31,02529745K,maría.valdec@hyperdev.site,875013,ES22209506301220461003,7234.17,2024-02-20T13:55:08,Portugalete,expenses,repairs,-55.98,-42218.14
buyer_7,María,Valdec,1968-12-31,02529745K,maría.valdec@hyperdev.site,875013,ES22209506301220461003,7234.17,2024-02-22T14:44:39,Portugalete,expenses,transport,-78.68,-42296.82
buyer_7,María,Valdec,1968-12-31,02529745K,maría.valdec@hyperdev.site,875013,ES22209506301220461003,7234.17,2024-02-22T08:06:52,Portugalete,expenses,children,-226.9825833333333,-42523.8
buyer_7,María,Valdec,1968-12-31,02529745K,maría.valdec@hyperdev.site,875013,ES22209506301220461003,7234.17,2024-02-23T14:10:13,Portugalete,expenses,repairs,-61.54,-42585.34
buyer_7,María,Valdec,1968-12-31,02529745K,maría.valdec@hyperdev.site,875013,ES22209506301220461003,7234.17,2024-02-24T08:40:41,Portugalete,expenses,gifts,-140.17,-42725.51
buyer_7,María,Valdec,1968-12-31,02529745K,maría.valdec@hyperdev.site,875013,ES22209506301220461003,7234.17,2024-02-25T14:45:26,Portugalete,expenses,transport,-46.85,-42772.36
buyer_7,María,Valdec,1968-12-31,02529745K,maría.valdec@hyperdev.site,875013,ES22209506301220461003,7234.17,2024-02-26T18:39:19,Portugalete,expenses,food,-81.93,-42854.29
buyer_7,María,Valdec,1968-12-31,02529745K,maría.valdec@hyperdev.site,875013,ES22209506301220461003,7234.17,2024-02-26T16:08:22,Portugalete,expenses,leisure,-24.79,-42879.08
buyer_7,María,Valdec,1968-12-31,02529745K,maría.valdec@hyperdev.site,875013,ES22209506301220461003,7234.17,2024-02-27T02:24:27,Portugalete,expenses,transport,-79.78,-42958.86
buyer_7,María,Valdec,1968-12-31,02529745K,maría.valdec@hyperdev.site,875013,ES22209506301220461003,7234.17,2024-02-28T14:36:35,Portugalete,expenses,travel,-282.63,-43241.49
buyer_7,María,Valdec,1968-12-31,02529745K,maría.valdec@hyperdev.site,875013,ES22209506301220461003,7234.17,2024-03-01T08:44:12,Portugalete,incomes,salary,1634.83,-41606.66
buyer_7,María,Valdec,1968-12-31,02529745K,maría.valdec@hyperdev.site,875013,ES22209506301220461003,7234.17,2024-03-01T08:44:12,Portugalete,incomes,extra_income,208.35,-41398.31
buyer_7,María,Valdec,1968-12-31,02529745K,maría.valdec@hyperdev.site,875013,ES22209506301220461003,7234.17,2024-03-01T16:51:54,Portugalete,expenses,food,-80.78,-41479.09
buyer_7,María,Valdec,1968-12-31,02529745K,maría.valdec@hyperdev.site,875013,ES22209506301220461003,7234.17,2024-03-02T18:19:07,Portugalete,expenses,food,-100.16,-41579.25
buyer_7,María,Valdec,1968-12-31,02529745K,maría.valdec@hyperdev.site,875013,ES22209506301220461003,7234.17,2024-03-04T18:29:11,Portugalete,expenses,mortgage,-879.12,-42458.37
buyer_7,María,Valdec,1968-12-31,02529745K,maría.valdec@hyperdev.site,875013,ES22209506301220461003,7234.17,2024-03-05T18:35:23,Portugalete,expenses,water,-35.51,-42493.88
buyer_7,María,Valdec,1968-12-31,02529745K,maría.valdec@hyperdev.site,875013,ES22209506301220461003,7234.17,2024-03-05T21:21:07,Portugalete,expenses,healthcare,-71.9,-42565.78
buyer_7,María,Valdec,1968-12-31,02529745K,maría.valdec@hyperdev.site,875013,ES22209506301220461003,7234.17,2024-03-05T10:08:08,Portugalete,expenses,cash,-100.0,-42665.78
buyer_7,María,Valdec,1968-12-31,02529745K,maría.valdec@hyperdev.site,875013,ES22209506301220461003,7234.17,2024-03-06T08:50:12,Portugalete,expenses,internet,-34.33,-42700.11
buyer_7,María,Valdec,1968-12-31,02529745K,maría.valdec@hyperdev.site,875013,ES22209506301220461003,7234.17,2024-03-06T14:17:21,Portugalete,expenses,phone,-29.79,-42729.9
buyer_7,María,Valdec,1968-12-31,02529745K,maría.valdec@hyperdev.site,875013,ES22209506301220461003,7234.17,2024-03-06T08:16:50,Portugalete,expenses,leisure,-57.55,-42787.45
buyer_7,María,Valdec,1968-12-31,02529745K,maría.valdec@hyperdev.site,875013,ES22209506301220461003,7234.17,2024-03-07T07:22:26,Portugalete,expenses,cash,-100.0,-42887.45
buyer_7,María,Valdec,1968-12-31,02529745K,maría.valdec@hyperdev.site,875013,ES22209506301220461003,7234.17,2024-03-08T22:01:15,Portugalete,expenses,gas,-74.84,-42962.29
buyer_7,María,Valdec,1968-12-31,02529745K,maría.valdec@hyperdev.site,875013,ES22209506301220461003,7234.17,2024-03-08T08:06:18,Portugalete,expenses,electricity,-40.71,-43003.0
buyer_7,María,Valdec,1968-12-31,02529745K,maría.valdec@hyperdev.site,875013,ES22209506301220461003,7234.17,2024-03-08T11:44:42,Portugalete,expenses,leisure,-83.62,-43086.62
buyer_7,María,Valdec,1968-12-31,02529745K,maría.valdec@hyperdev.site,875013,ES22209506301220461003,7234.17,2024-03-08T17:29:33,Portugalete,expenses,clothing,-73.12,-43159.74
buyer_7,María,Valdec,1968-12-31,02529745K,maría.valdec@hyperdev.site,875013,ES22209506301220461003,7234.17,2024-03-08T22:07:09,Portugalete,expenses,children,-148.9225833333333,-43308.66
buyer_7,María,Valdec,1968-12-31,02529745K,maría.valdec@hyperdev.site,875013,ES22209506301220461003,7234.17,2024-03-09T14:47:41,Portugalete,expenses,food,-84.33,-43392.99
buyer_7,María,Valdec,1968-12-31,02529745K,maría.valdec@hyperdev.site,875013,ES22209506301220461003,7234.17,2024-03-10T12:31:47,Portugalete,expenses,transport,-50.89,-43443.88
buyer_7,María,Valdec,1968-12-31,02529745K,maría.valdec@hyperdev.site,875013,ES22209506301220461003,7234.17,2024-03-10T12:15:12,Portugalete,expenses,cash,-100.0,-43543.88
buyer_7,María,Valdec,1968-12-31,02529745K,maría.valdec@hyperdev.site,875013,ES22209506301220461003,7234.17,2024-03-13T21:41:06,Portugalete,expenses,cash,-100.0,-43643.88
buyer_7,María,Valdec,1968-12-31,02529745K,maría.valdec@hyperdev.site,875013,ES22209506301220461003,7234.17,2024-03-14T13:46:59,Portugalete,expenses,food,-102.13,-43746.01
buyer_7,María,Valdec,1968-12-31,02529745K,maría.valdec@hyperdev.site,875013,ES22209506301220461003,7234.17,2024-03-14T11:14:07,Portugalete,expenses,healthcare,-138.2,-43884.21
buyer_7,María,Valdec,1968-12-31,02529745K,maría.valdec@hyperdev.site,875013,ES22209506301220461003,7234.17,2024-03-16T14:37:35,Portugalete,expenses,food,-98.07,-43982.28
buyer_7,María,Valdec,1968-12-31,02529745K,maría.valdec@hyperdev.site,875013,ES22209506301220461003,7234.17,2024-03-16T20:30:41,Portugalete,expenses,repairs,-28.71,-44010.99
buyer_7,María,Valdec,1968-12-31,02529745K,maría.valdec@hyperdev.site,875013,ES22209506301220461003,7234.17,2024-03-18T19:48:29,Portugalete,expenses,transport,-40.14,-44051.13
buyer_7,María,Valdec,1968-12-31,02529745K,maría.valdec@hyperdev.site,875013,ES22209506301220461003,7234.17,2024-03-18T18:37:37,Portugalete,expenses,repairs,-91.6,-44142.73
buyer_7,María,Valdec,1968-12-31,02529745K,maría.valdec@hyperdev.site,875013,ES22209506301220461003,7234.17,2024-03-19T12:48:40,Portugalete,expenses,transport,-58.4,-44201.13
buyer_7,María,Valdec,1968-12-31,02529745K,maría.valdec@hyperdev.site,875013,ES22209506301220461003,7234.17,2024-03-20T04:17:11,Portugalete,expenses,clothing,-75.59,-44276.72
buyer_7,María,Valdec,1968-12-31,02529745K,maría.valdec@hyperdev.site,875013,ES22209506301220461003,7234.17,2024-03-20T15:07:52,Portugalete,expenses,cash,-100.0,-44376.72
buyer_7,María,Valdec,1968-12-31,02529745K,maría.valdec@hyperdev.site,875013,ES22209506301220461003,7234.17,2024-03-22T09:11:44,Portugalete,expenses,healthcare,-60.13,-44436.85
buyer_7,María,Valdec,1968-12-31,02529745K,maría.valdec@hyperdev.site,875013,ES22209506301220461003,7234.17,2024-03-24T08:44:44,Portugalete,expenses,leisure,-34.06,-44470.91
buyer_7,María,Valdec,1968-12-31,02529745K,maría.valdec@hyperdev.site,875013,ES22209506301220461003,7234.17,2024-03-26T00:37:19,Portugalete,expenses,repairs,-159.25,-44630.16
buyer_7,María,Valdec,1968-12-31,02529745K,maría.valdec@hyperdev.site,875013,ES22209506301220461003,7234.17,2024-03-28T13:41:07,Portugalete,expenses,food,-80.21,-44710.37
buyer_7,María,Valdec,1968-12-31,02529745K,maría.valdec@hyperdev.site,875013,ES22209506301220461003,7234.17,2024-03-28T10:56:52,Portugalete,expenses,children,-225.45258333333334,-44935.82
buyer_7,María,Valdec,1968-12-31,02529745K,maría.valdec@hyperdev.site,875013,ES22209506301220461003,7234.17,2024-03-29T12:18:22,Portugalete,expenses,cash,-100.0,-45035.82
buyer_7,María,Valdec,1968-12-31,02529745K,maría.valdec@hyperdev.site,875013,ES22209506301220461003,7234.17,2024-03-30T08:51:22,Portugalete,expenses,transport,-63.98,-45099.8
buyer_7,María,Valdec,1968-12-31,02529745K,maría.valdec@hyperdev.site,875013,ES22209506301220461003,7234.17,2024-03-30T11:07:16,Portugalete,expenses,leisure,-73.38,-45173.18
buyer_7,María,Valdec,1968-12-31,02529745K,maría.valdec@hyperdev.site,875013,ES22209506301220461003,7234.17,2024-03-30T14:26:07,Portugalete,expenses,appliances,-158.31,-45331.49
buyer_7,María,Valdec,1968-12-31,02529745K,maría.valdec@hyperdev.site,875013,ES22209506301220461003,7234.17,2024-03-31T10:43:20,Portugalete,expenses,food,-98.07,-45429.56
buyer_7,María,Valdec,1968-12-31,02529745K,maría.valdec@hyperdev.site,875013,ES22209506301220461003,7234.17,2024-04-01T12:23:16,Portugalete,incomes,salary,1634.83,-43794.73
buyer_7,María,Valdec,1968-12-31,02529745K,maría.valdec@hyperdev.site,875013,ES22209506301220461003,7234.17,2024-04-01T08:32:24,Portugalete,expenses,food,-91.5,-43886.23
buyer_7,María,Valdec,1968-12-31,02529745K,maría.valdec@hyperdev.site,875013,ES22209506301220461003,7234.17,2024-04-01T19:01:58,Portugalete,expenses,transport,-86.04,-43972.27
buyer_7,María,Valdec,1968-12-31,02529745K,maría.valdec@hyperdev.site,875013,ES22209506301220461003,7234.17,2024-04-01T16:23:41,Portugalete,expenses,leisure,-40.79,-44013.06
buyer_7,María,Valdec,1968-12-31,02529745K,maría.valdec@hyperdev.site,875013,ES22209506301220461003,7234.17,2024-04-02T08:30:02,Portugalete,expenses,cash,-100.0,-44113.06
buyer_7,María,Valdec,1968-12-31,02529745K,maría.valdec@hyperdev.site,875013,ES22209506301220461003,7234.17,2024-04-03T17:10:01,Portugalete,expenses,cash,-100.0,-44213.06
buyer_7,María,Valdec,1968-12-31,02529745K,maría.valdec@hyperdev.site,875013,ES22209506301220461003,7234.17,2024-04-04T08:52:13,Portugalete,expenses,mortgage,-879.12,-45092.18
buyer_7,María,Valdec,1968-12-31,02529745K,maría.valdec@hyperdev.site,875013,ES22209506301220461003,7234.17,2024-04-04T11:30:15,Portugalete,expenses,repairs,-38.78,-45130.96
buyer_7,María,Valdec,1968-12-31,02529745K,maría.valdec@hyperdev.site,875013,ES22209506301220461003,7234.17,2024-04-06T14:12:27,Portugalete,expenses,water,-30.02,-45160.98
buyer_7,María,Valdec,1968-12-31,02529745K,maría.valdec@hyperdev.site,875013,ES22209506301220461003,7234.17,2024-04-06T19:52:47,Portugalete,expenses,leisure,-43.08,-45204.06
buyer_7,María,Valdec,1968-12-31,02529745K,maría.valdec@hyperdev.site,875013,ES22209506301220461003,7234.17,2024-04-07T19:10:37,Portugalete,expenses,gas,-61.46,-45265.52
buyer_7,María,Valdec,1968-12-31,02529745K,maría.valdec@hyperdev.site,875013,ES22209506301220461003,7234.17,2024-04-07T17:55:41,Portugalete,expenses,repairs,-144.94,-45410.46
buyer_7,María,Valdec,1968-12-31,02529745K,maría.valdec@hyperdev.site,875013,ES22209506301220461003,7234.17,2024-04-07T10:18:37,Portugalete,expenses,gifts,-87.62,-45498.08
buyer_7,María,Valdec,1968-12-31,02529745K,maría.valdec@hyperdev.site,875013,ES22209506301220461003,7234.17,2024-04-07T11:03:47,Portugalete,expenses,children,-73.10258333333331,-45571.18
buyer_7,María,Valdec,1968-12-31,02529745K,maría.valdec@hyperdev.site,875013,ES22209506301220461003,7234.17,2024-04-08T15:57:17,Portugalete,expenses,internet,-34.33,-45605.51
buyer_7,María,Valdec,1968-12-31,02529745K,maría.valdec@hyperdev.site,875013,ES22209506301220461003,7234.17,2024-04-08T18:12:51,Portugalete,expenses,phone,-27.19,-45632.7
buyer_7,María,Valdec,1968-12-31,02529745K,maría.valdec@hyperdev.site,875013,ES22209506301220461003,7234.17,2024-04-08T12:29:43,Portugalete,expenses,electricity,-49.63,-45682.33
buyer_7,María,Valdec,1968-12-31,02529745K,maría.valdec@hyperdev.site,875013,ES22209506301220461003,7234.17,2024-04-08T10:08:46,Portugalete,expenses,gifts,-231.17,-45913.5
buyer_7,María,Valdec,1968-12-31,02529745K,maría.valdec@hyperdev.site,875013,ES22209506301220461003,7234.17,2024-04-09T13:24:45,Portugalete,expenses,leisure,-38.4,-45951.9
buyer_7,María,Valdec,1968-12-31,02529745K,maría.valdec@hyperdev.site,875013,ES22209506301220461003,7234.17,2024-04-09T05:28:44,Portugalete,expenses,cash,-100.0,-46051.9
buyer_7,María,Valdec,1968-12-31,02529745K,maría.valdec@hyperdev.site,875013,ES22209506301220461003,7234.17,2024-04-10T12:07:14,Portugalete,expenses,repairs,-219.31,-46271.21
buyer_7,María,Valdec,1968-12-31,02529745K,maría.valdec@hyperdev.site,875013,ES22209506301220461003,7234.17,2024-04-11T06:23:56,Portugalete,expenses,food,-89.52,-46360.73
buyer_7,María,Valdec,1968-12-31,02529745K,maría.valdec@hyperdev.site,875013,ES22209506301220461003,7234.17,2024-04-11T23:11:46,Portugalete,expenses,cash,-100.0,-46460.73
buyer_7,María,Valdec,1968-12-31,02529745K,maría.valdec@hyperdev.site,875013,ES22209506301220461003,7234.17,2024-04-12T14:43:29,Portugalete,expenses,food,-93.81,-46554.54
buyer_7,María,Valdec,1968-12-31,02529745K,maría.valdec@hyperdev.site,875013,ES22209506301220461003,7234.17,2024-04-12T15:20:20,Portugalete,expenses,cash,-100.0,-46654.54
buyer_7,María,Valdec,1968-12-31,02529745K,maría.valdec@hyperdev.site,875013,ES22209506301220461003,7234.17,2024-04-14T06:51:05,Portugalete,expenses,cash,-100.0,-46754.54
buyer_7,María,Valdec,1968-12-31,02529745K,maría.valdec@hyperdev.site,875013,ES22209506301220461003,7234.17,2024-04-17T20:55:42,Portugalete,expenses,food,-102.35,-46856.89
buyer_7,María,Valdec,1968-12-31,02529745K,maría.valdec@hyperdev.site,875013,ES22209506301220461003,7234.17,2024-04-21T09:35:37,Portugalete,expenses,cash,-100.0,-46956.89
buyer_7,María,Valdec,1968-12-31,02529745K,maría.valdec@hyperdev.site,875013,ES22209506301220461003,7234.17,2024-04-21T06:21:47,Portugalete,expenses,gifts,-162.65,-47119.54
buyer_7,María,Valdec,1968-12-31,02529745K,maría.valdec@hyperdev.site,875013,ES22209506301220461003,7234.17,2024-04-24T15:23:07,Portugalete,expenses,transport,-86.18,-47205.72
buyer_7,María,Valdec,1968-12-31,02529745K,maría.valdec@hyperdev.site,875013,ES22209506301220461003,7234.17,2024-04-24T13:17:57,Portugalete,expenses,cash,-100.0,-47305.72
buyer_7,María,Valdec,1968-12-31,02529745K,maría.valdec@hyperdev.site,875013,ES22209506301220461003,7234.17,2024-04-26T09:14:43,Portugalete,expenses,gifts,-224.66,-47530.38
buyer_7,María,Valdec,1968-12-31,02529745K,maría.valdec@hyperdev.site,875013,ES22209506301220461003,7234.17,2024-04-27T09:23:11,Portugalete,expenses,food,-87.85,-47618.23
buyer_7,María,Valdec,1968-12-31,02529745K,maría.valdec@hyperdev.site,875013,ES22209506301220461003,7234.17,2024-04-30T10:24:39,Portugalete,expenses,repairs,-215.47,-47833.7
buyer_7,María,Valdec,1968-12-31,02529745K,maría.valdec@hyperdev.site,875013,ES22209506301220461003,7234.17,2024-04-30T17:02:18,Portugalete,expenses,gifts,-77.11,-47910.81
buyer_7,María,Valdec,1968-12-31,02529745K,maría.valdec@hyperdev.site,875013,ES22209506301220461003,7234.17,2024-05-01T23:40:18,Portugalete,incomes,salary,1634.83,-46275.98
buyer_7,María,Valdec,1968-12-31,02529745K,maría.valdec@hyperdev.site,875013,ES22209506301220461003,7234.17,2024-05-01T19:56:28,Portugalete,expenses,cash,-100.0,-46375.98
buyer_7,María,Valdec,1968-12-31,02529745K,maría.valdec@hyperdev.site,875013,ES22209506301220461003,7234.17,2024-05-02T19:25:44,Portugalete,expenses,repairs,-303.47,-46679.45
buyer_7,María,Valdec,1968-12-31,02529745K,maría.valdec@hyperdev.site,875013,ES22209506301220461003,7234.17,2024-05-03T04:11:31,Portugalete,expenses,food,-94.16,-46773.61
buyer_7,María,Valdec,1968-12-31,02529745K,maría.valdec@hyperdev.site,875013,ES22209506301220461003,7234.17,2024-05-04T17:03:40,Portugalete,expenses,mortgage,-879.12,-47652.73
buyer_7,María,Valdec,1968-12-31,02529745K,maría.valdec@hyperdev.site,875013,ES22209506301220461003,7234.17,2024-05-05T20:07:18,Portugalete,expenses,electricity,-57.62,-47710.35
buyer_7,María,Valdec,1968-12-31,02529745K,maría.valdec@hyperdev.site,875013,ES22209506301220461003,7234.17,2024-05-05T08:13:35,Portugalete,expenses,food,-67.18,-47777.53
buyer_7,María,Valdec,1968-12-31,02529745K,maría.valdec@hyperdev.site,875013,ES22209506301220461003,7234.17,2024-05-06T09:47:51,Portugalete,expenses,gas,-59.04,-47836.57
buyer_7,María,Valdec,1968-12-31,02529745K,maría.valdec@hyperdev.site,875013,ES22209506301220461003,7234.17,2024-05-06T14:19:33,Portugalete,expenses,internet,-34.33,-47870.9
buyer_7,María,Valdec,1968-12-31,02529745K,maría.valdec@hyperdev.site,875013,ES22209506301220461003,7234.17,2024-05-06T17:59:08,Portugalete,expenses,cash,-100.0,-47970.9
buyer_7,María,Valdec,1968-12-31,02529745K,maría.valdec@hyperdev.site,875013,ES22209506301220461003,7234.17,2024-05-08T13:19:53,Portugalete,expenses,water,-24.82,-47995.72
buyer_7,María,Valdec,1968-12-31,02529745K,maría.valdec@hyperdev.site,875013,ES22209506301220461003,7234.17,2024-05-08T11:51:51,Portugalete,expenses,phone,-29.88,-48025.6
buyer_7,María,Valdec,1968-12-31,02529745K,maría.valdec@hyperdev.site,875013,ES22209506301220461003,7234.17,2024-05-09T09:25:24,Portugalete,expenses,food,-86.14,-48111.74
buyer_7,María,Valdec,1968-12-31,02529745K,maría.valdec@hyperdev.site,875013,ES22209506301220461003,7234.17,2024-05-09T19:22:59,Portugalete,expenses,cash,-100.0,-48211.74
buyer_7,María,Valdec,1968-12-31,02529745K,maría.valdec@hyperdev.site,875013,ES22209506301220461003,7234.17,2024-05-10T09:24:55,Portugalete,expenses,repairs,-165.84,-48377.58
buyer_7,María,Valdec,1968-12-31,02529745K,maría.valdec@hyperdev.site,875013,ES22209506301220461003,7234.17,2024-05-11T11:53:53,Portugalete,expenses,food,-70.36,-48447.94
buyer_7,María,Valdec,1968-12-31,02529745K,maría.valdec@hyperdev.site,875013,ES22209506301220461003,7234.17,2024-05-12T23:03:12,Portugalete,expenses,leisure,-63.23,-48511.17
buyer_7,María,Valdec,1968-12-31,02529745K,maría.valdec@hyperdev.site,875013,ES22209506301220461003,7234.17,2024-05-15T06:28:42,Portugalete,expenses,cash,-100.0,-48611.17
buyer_7,María,Valdec,1968-12-31,02529745K,maría.valdec@hyperdev.site,875013,ES22209506301220461003,7234.17,2024-05-16T12:34:23,Portugalete,expenses,clothing,-81.5,-48692.67
buyer_7,María,Valdec,1968-12-31,02529745K,maría.valdec@hyperdev.site,875013,ES22209506301220461003,7234.17,2024-05-17T23:46:03,Portugalete,expenses,leisure,-18.88,-48711.55
buyer_7,María,Valdec,1968-12-31,02529745K,maría.valdec@hyperdev.site,875013,ES22209506301220461003,7234.17,2024-05-19T22:13:34,Portugalete,expenses,cash,-100.0,-48811.55
buyer_7,María,Valdec,1968-12-31,02529745K,maría.valdec@hyperdev.site,875013,ES22209506301220461003,7234.17,2024-05-21T20:07:43,Portugalete,expenses,transport,-50.29,-48861.84
buyer_7,María,Valdec,1968-12-31,02529745K,maría.valdec@hyperdev.site,875013,ES22209506301220461003,7234.17,2024-05-23T19:48:55,Portugalete,expenses,food,-122.99,-48984.83
buyer_7,María,Valdec,1968-12-31,02529745K,maría.valdec@hyperdev.site,875013,ES22209506301220461003,7234.17,2024-05-26T16:58:25,Portugalete,expenses,transport,-53.31,-49038.14
buyer_7,María,Valdec,1968-12-31,02529745K,maría.valdec@hyperdev.site,875013,ES22209506301220461003,7234.17,2024-05-26T13:58:56,Portugalete,expenses,leisure,-69.22,-49107.36
buyer_7,María,Valdec,1968-12-31,02529745K,maría.valdec@hyperdev.site,875013,ES22209506301220461003,7234.17,2024-05-28T08:57:09,Portugalete,expenses,food,-66.5,-49173.86
buyer_7,María,Valdec,1968-12-31,02529745K,maría.valdec@hyperdev.site,875013,ES22209506301220461003,7234.17,2024-05-29T14:52:44,Portugalete,expenses,cash,-100.0,-49273.86
buyer_7,María,Valdec,1968-12-31,02529745K,maría.valdec@hyperdev.site,875013,ES22209506301220461003,7234.17,2024-05-31T08:37:27,Portugalete,expenses,leisure,-66.06,-49339.92
buyer_7,María,Valdec,1968-12-31,02529745K,maría.valdec@hyperdev.site,875013,ES22209506301220461003,7234.17,2024-06-01T18:50:43,Portugalete,incomes,salary,1634.83,-47705.09
buyer_7,María,Valdec,1968-12-31,02529745K,maría.valdec@hyperdev.site,875013,ES22209506301220461003,7234.17,2024-06-01T18:50:43,Portugalete,incomes,salary_bonus,1158.62,-46546.47
buyer_7,María,Valdec,1968-12-31,02529745K,maría.valdec@hyperdev.site,875013,ES22209506301220461003,7234.17,2024-06-01T18:10:22,Portugalete,expenses,leisure,-54.7,-46601.17
buyer_7,María,Valdec,1968-12-31,02529745K,maría.valdec@hyperdev.site,875013,ES22209506301220461003,7234.17,2024-06-01T03:36:39,Portugalete,expenses,cash,-100.0,-46701.17
buyer_7,María,Valdec,1968-12-31,02529745K,maría.valdec@hyperdev.site,875013,ES22209506301220461003,7234.17,2024-06-03T20:01:57,Portugalete,expenses,children,-184.96,-46886.13
buyer_7,María,Valdec,1968-12-31,02529745K,maría.valdec@hyperdev.site,875013,ES22209506301220461003,7234.17,2024-06-04T10:11:31,Portugalete,expenses,mortgage,-879.12,-47765.25
buyer_7,María,Valdec,1968-12-31,02529745K,maría.valdec@hyperdev.site,875013,ES22209506301220461003,7234.17,2024-06-04T15:05:28,Portugalete,expenses,transport,-62.94,-47828.19
buyer_7,María,Valdec,1968-12-31,02529745K,maría.valdec@hyperdev.site,875013,ES22209506301220461003,7234.17,2024-06-04T09:46:50,Portugalete,expenses,repairs,-216.07,-48044.26
buyer_7,María,Valdec,1968-12-31,02529745K,maría.valdec@hyperdev.site,875013,ES22209506301220461003,7234.17,2024-06-05T11:20:33,Portugalete,expenses,electricity,-23.8,-48068.06
buyer_7,María,Valdec,1968-12-31,02529745K,maría.valdec@hyperdev.site,875013,ES22209506301220461003,7234.17,2024-06-05T23:14:04,Portugalete,expenses,leisure,-79.23,-48147.29
buyer_7,María,Valdec,1968-12-31,02529745K,maría.valdec@hyperdev.site,875013,ES22209506301220461003,7234.17,2024-06-05T09:29:36,Portugalete,expenses,repairs,-54.34,-48201.63
buyer_7,María,Valdec,1968-12-31,02529745K,maría.valdec@hyperdev.site,875013,ES22209506301220461003,7234.17,2024-06-06T08:45:14,Portugalete,expenses,water,-36.7,-48238.33
buyer_7,María,Valdec,1968-12-31,02529745K,maría.valdec@hyperdev.site,875013,ES22209506301220461003,7234.17,2024-06-07T12:43:31,Portugalete,expenses,internet,-34.33,-48272.66
buyer_7,María,Valdec,1968-12-31,02529745K,maría.valdec@hyperdev.site,875013,ES22209506301220461003,7234.17,2024-06-07T21:26:57,Portugalete,expenses,phone,-34.73,-48307.39
buyer_7,María,Valdec,1968-12-31,02529745K,maría.valdec@hyperdev.site,875013,ES22209506301220461003,7234.17,2024-06-08T11:32:48,Portugalete,expenses,gas,-66.48,-48373.87
buyer_7,María,Valdec,1968-12-31,02529745K,maría.valdec@hyperdev.site,875013,ES22209506301220461003,7234.17,2024-06-09T13:25:05,Portugalete,expenses,gifts,-33.88,-48407.75
buyer_7,María,Valdec,1968-12-31,02529745K,maría.valdec@hyperdev.site,875013,ES22209506301220461003,7234.17,2024-06-14T14:05:01,Portugalete,expenses,children,-252.33,-48660.08
buyer_7,María,Valdec,1968-12-31,02529745K,maría.valdec@hyperdev.site,875013,ES22209506301220461003,7234.17,2024-06-16T04:45:11,Portugalete,expenses,cash,-100.0,-48760.08
buyer_7,María,Valdec,1968-12-31,02529745K,maría.valdec@hyperdev.site,875013,ES22209506301220461003,7234.17,2024-06-17T09:32:05,Portugalete,expenses,transport,-62.21,-48822.29
buyer_7,María,Valdec,1968-12-31,02529745K,maría.valdec@hyperdev.site,875013,ES22209506301220461003,7234.17,2024-06-17T10:53:01,Portugalete,expenses,leisure,-49.29,-48871.58
buyer_7,María,Valdec,1968-12-31,02529745K,maría.valdec@hyperdev.site,875013,ES22209506301220461003,7234.17,2024-06-17T08:59:33,Portugalete,expenses,gifts,-40.38,-48911.96
buyer_7,María,Valdec,1968-12-31,02529745K,maría.valdec@hyperdev.site,875013,ES22209506301220461003,7234.17,2024-06-18T12:24:42,Portugalete,expenses,gifts,-155.28,-49067.24
buyer_7,María,Valdec,1968-12-31,02529745K,maría.valdec@hyperdev.site,875013,ES22209506301220461003,7234.17,2024-06-20T14:10:09,Portugalete,expenses,repairs,-44.23,-49111.47
buyer_7,María,Valdec,1968-12-31,02529745K,maría.valdec@hyperdev.site,875013,ES22209506301220461003,7234.17,2024-06-21T15:13:35,Portugalete,expenses,transport,-80.88,-49192.35
buyer_7,María,Valdec,1968-12-31,02529745K,maría.valdec@hyperdev.site,875013,ES22209506301220461003,7234.17,2024-06-24T12:00:10,Portugalete,expenses,clothing,-147.77,-49340.12
buyer_7,María,Valdec,1968-12-31,02529745K,maría.valdec@hyperdev.site,875013,ES22209506301220461003,7234.17,2024-06-26T15:23:42,Portugalete,expenses,food,-65.99,-49406.11
buyer_7,María,Valdec,1968-12-31,02529745K,maría.valdec@hyperdev.site,875013,ES22209506301220461003,7234.17,2024-06-27T09:26:54,Portugalete,expenses,food,-112.99,-49519.1
buyer_7,María,Valdec,1968-12-31,02529745K,maría.valdec@hyperdev.site,875013,ES22209506301220461003,7234.17,2024-06-27T15:42:54,Portugalete,expenses,healthcare,-172.91,-49692.01
buyer_7,María,Valdec,1968-12-31,02529745K,maría.valdec@hyperdev.site,875013,ES22209506301220461003,7234.17,2024-06-27T17:28:31,Portugalete,expenses,cash,-56.12,-49748.13
buyer_7,María,Valdec,1968-12-31,02529745K,maría.valdec@hyperdev.site,875013,ES22209506301220461003,7234.17,2024-06-28T21:33:17,Portugalete,expenses,transport,-47.92,-49796.05
buyer_7,María,Valdec,1968-12-31,02529745K,maría.valdec@hyperdev.site,875013,ES22209506301220461003,7234.17,2024-06-29T19:55:49,Portugalete,expenses,clothing,-95.65,-49891.7
buyer_7,María,Valdec,1968-12-31,02529745K,maría.valdec@hyperdev.site,875013,ES22209506301220461003,7234.17,2024-06-30T21:41:29,Portugalete,expenses,education,-59.41,-49951.11
buyer_7,María,Valdec,1968-12-31,02529745K,maría.valdec@hyperdev.site,875013,ES22209506301220461003,7234.17,2024-07-01T05:01:50,Portugalete,incomes,salary,1634.83,-48316.28
buyer_7,María,Valdec,1968-12-31,02529745K,maría.valdec@hyperdev.site,875013,ES22209506301220461003,7234.17,2024-07-01T05:01:50,Portugalete,incomes,extra_income,208.35,-48107.93
buyer_7,María,Valdec,1968-12-31,02529745K,maría.valdec@hyperdev.site,875013,ES22209506301220461003,7234.17,2024-07-03T08:32:31,Portugalete,expenses,food,-65.97,-48173.9
buyer_7,María,Valdec,1968-12-31,02529745K,maría.valdec@hyperdev.site,875013,ES22209506301220461003,7234.17,2024-07-03T13:43:37,Portugalete,expenses,transport,-86.08,-48259.98
buyer_7,María,Valdec,1968-12-31,02529745K,maría.valdec@hyperdev.site,875013,ES22209506301220461003,7234.17,2024-07-04T11:34:19,Portugalete,expenses,mortgage,-879.12,-49139.1
buyer_7,María,Valdec,1968-12-31,02529745K,maría.valdec@hyperdev.site,875013,ES22209506301220461003,7234.17,2024-07-04T17:19:36,Portugalete,expenses,healthcare,-120.33,-49259.43
buyer_7,María,Valdec,1968-12-31,02529745K,maría.valdec@hyperdev.site,875013,ES22209506301220461003,7234.17,2024-07-05T23:38:10,Portugalete,expenses,transport,-84.82,-49344.25
buyer_7,María,Valdec,1968-12-31,02529745K,maría.valdec@hyperdev.site,875013,ES22209506301220461003,7234.17,2024-07-06T00:08:29,Portugalete,expenses,electricity,-37.83,-49382.08
buyer_7,María,Valdec,1968-12-31,02529745K,maría.valdec@hyperdev.site,875013,ES22209506301220461003,7234.17,2024-07-06T11:17:42,Portugalete,expenses,phone,-25.61,-49407.69
buyer_7,María,Valdec,1968-12-31,02529745K,maría.valdec@hyperdev.site,875013,ES22209506301220461003,7234.17,2024-07-06T16:04:40,Portugalete,expenses,transport,-69.93,-49477.62
buyer_7,María,Valdec,1968-12-31,02529745K,maría.valdec@hyperdev.site,875013,ES22209506301220461003,7234.17,2024-07-07T14:26:35,Portugalete,expenses,repairs,-89.15,-49566.77
buyer_7,María,Valdec,1968-12-31,02529745K,maría.valdec@hyperdev.site,875013,ES22209506301220461003,7234.17,2024-07-08T15:01:41,Portugalete,expenses,water,-22.01,-49588.78
buyer_7,María,Valdec,1968-12-31,02529745K,maría.valdec@hyperdev.site,875013,ES22209506301220461003,7234.17,2024-07-08T10:39:23,Portugalete,expenses,gas,-79.35,-49668.13
buyer_7,María,Valdec,1968-12-31,02529745K,maría.valdec@hyperdev.site,875013,ES22209506301220461003,7234.17,2024-07-08T09:11:59,Portugalete,expenses,internet,-34.33,-49702.46
buyer_7,María,Valdec,1968-12-31,02529745K,maría.valdec@hyperdev.site,875013,ES22209506301220461003,7234.17,2024-07-11T16:53:35,Portugalete,expenses,education,-48.06,-49750.52
buyer_7,María,Valdec,1968-12-31,02529745K,maría.valdec@hyperdev.site,875013,ES22209506301220461003,7234.17,2024-07-11T10:25:20,Portugalete,expenses,cash,-100.0,-49850.52
buyer_7,María,Valdec,1968-12-31,02529745K,maría.valdec@hyperdev.site,875013,ES22209506301220461003,7234.17,2024-07-11T21:24:49,Portugalete,expenses,travel,-253.62,-50104.14
buyer_7,María,Valdec,1968-12-31,02529745K,maría.valdec@hyperdev.site,875013,ES22209506301220461003,7234.17,2024-07-14T14:20:06,Portugalete,expenses,appliances,-146.88,-50251.02
buyer_7,María,Valdec,1968-12-31,02529745K,maría.valdec@hyperdev.site,875013,ES22209506301220461003,7234.17,2024-07-15T03:14:04,Portugalete,expenses,repairs,-246.63,-50497.65
buyer_7,María,Valdec,1968-12-31,02529745K,maría.valdec@hyperdev.site,875013,ES22209506301220461003,7234.17,2024-07-17T15:22:26,Portugalete,expenses,repairs,-125.81,-50623.46
buyer_7,María,Valdec,1968-12-31,02529745K,maría.valdec@hyperdev.site,875013,ES22209506301220461003,7234.17,2024-07-19T04:25:42,Portugalete,expenses,repairs,-125.97,-50749.43
buyer_7,María,Valdec,1968-12-31,02529745K,maría.valdec@hyperdev.site,875013,ES22209506301220461003,7234.17,2024-07-23T19:09:29,Portugalete,expenses,cash,-100.0,-50849.43
buyer_7,María,Valdec,1968-12-31,02529745K,maría.valdec@hyperdev.site,875013,ES22209506301220461003,7234.17,2024-07-23T01:54:02,Portugalete,expenses,gifts,-164.65,-51014.08
buyer_7,María,Valdec,1968-12-31,02529745K,maría.valdec@hyperdev.site,875013,ES22209506301220461003,7234.17,2024-07-24T20:32:00,Portugalete,expenses,transport,-40.02,-51054.1
buyer_7,María,Valdec,1968-12-31,02529745K,maría.valdec@hyperdev.site,875013,ES22209506301220461003,7234.17,2024-07-24T23:03:00,Portugalete,expenses,leisure,-43.56,-51097.66
buyer_7,María,Valdec,1968-12-31,02529745K,maría.valdec@hyperdev.site,875013,ES22209506301220461003,7234.17,2024-07-25T18:56:18,Portugalete,expenses,food,-63.99,-51161.65
buyer_7,María,Valdec,1968-12-31,02529745K,maría.valdec@hyperdev.site,875013,ES22209506301220461003,7234.17,2024-07-25T15:29:28,Portugalete,expenses,cash,-100.0,-51261.65
buyer_7,María,Valdec,1968-12-31,02529745K,maría.valdec@hyperdev.site,875013,ES22209506301220461003,7234.17,2024-07-26T08:31:56,Portugalete,expenses,food,-96.61,-51358.26
buyer_7,María,Valdec,1968-12-31,02529745K,maría.valdec@hyperdev.site,875013,ES22209506301220461003,7234.17,2024-07-26T11:16:04,Portugalete,expenses,cash,-100.0,-51458.26
buyer_7,María,Valdec,1968-12-31,02529745K,maría.valdec@hyperdev.site,875013,ES22209506301220461003,7234.17,2024-07-28T19:58:36,Portugalete,expenses,transport,-64.43,-51522.69
buyer_7,María,Valdec,1968-12-31,02529745K,maría.valdec@hyperdev.site,875013,ES22209506301220461003,7234.17,2024-07-29T09:19:05,Portugalete,expenses,food,-110.04,-51632.73
buyer_7,María,Valdec,1968-12-31,02529745K,maría.valdec@hyperdev.site,875013,ES22209506301220461003,7234.17,2024-07-29T12:56:39,Portugalete,expenses,cash,-100.0,-51732.73
buyer_7,María,Valdec,1968-12-31,02529745K,maría.valdec@hyperdev.site,875013,ES22209506301220461003,7234.17,2024-07-29T15:13:49,Portugalete,expenses,gifts,-72.7,-51805.43
buyer_7,María,Valdec,1968-12-31,02529745K,maría.valdec@hyperdev.site,875013,ES22209506301220461003,7234.17,2024-07-30T19:24:27,Portugalete,expenses,leisure,-83.38,-51888.81
buyer_7,María,Valdec,1968-12-31,02529745K,maría.valdec@hyperdev.site,875013,ES22209506301220461003,7234.17,2024-08-01T19:12:58,Portugalete,incomes,salary,1634.83,-50253.98
buyer_7,María,Valdec,1968-12-31,02529745K,maría.valdec@hyperdev.site,875013,ES22209506301220461003,7234.17,2024-08-04T16:24:42,Portugalete,expenses,mortgage,-879.12,-51133.1
buyer_7,María,Valdec,1968-12-31,02529745K,maría.valdec@hyperdev.site,875013,ES22209506301220461003,7234.17,2024-08-05T10:01:27,Portugalete,expenses,water,-18.95,-51152.05
buyer_7,María,Valdec,1968-12-31,02529745K,maría.valdec@hyperdev.site,875013,ES22209506301220461003,7234.17,2024-08-05T04:59:21,Portugalete,expenses,electricity,-54.53,-51206.58
buyer_7,María,Valdec,1968-12-31,02529745K,maría.valdec@hyperdev.site,875013,ES22209506301220461003,7234.17,2024-08-05T18:53:55,Portugalete,expenses,internet,-34.33,-51240.91
buyer_7,María,Valdec,1968-12-31,02529745K,maría.valdec@hyperdev.site,875013,ES22209506301220461003,7234.17,2024-08-05T16:58:52,Portugalete,expenses,cash,-100.0,-51340.91
buyer_7,María,Valdec,1968-12-31,02529745K,maría.valdec@hyperdev.site,875013,ES22209506301220461003,7234.17,2024-08-06T18:02:08,Portugalete,expenses,gas,-46.46,-51387.37
buyer_7,María,Valdec,1968-12-31,02529745K,maría.valdec@hyperdev.site,875013,ES22209506301220461003,7234.17,2024-08-06T12:38:01,Portugalete,expenses,transport,-54.23,-51441.6
buyer_7,María,Valdec,1968-12-31,02529745K,maría.valdec@hyperdev.site,875013,ES22209506301220461003,7234.17,2024-08-06T10:43:05,Portugalete,expenses,cash,-100.0,-51541.6
buyer_7,María,Valdec,1968-12-31,02529745K,maría.valdec@hyperdev.site,875013,ES22209506301220461003,7234.17,2024-08-07T09:19:37,Portugalete,expenses,phone,-25.48,-51567.08
buyer_7,María,Valdec,1968-12-31,02529745K,maría.valdec@hyperdev.site,875013,ES22209506301220461003,7234.17,2024-08-07T13:29:36,Portugalete,expenses,food,-90.04,-51657.12
buyer_7,María,Valdec,1968-12-31,02529745K,maría.valdec@hyperdev.site,875013,ES22209506301220461003,7234.17,2024-08-08T11:42:01,Portugalete,expenses,cash,-100.0,-51757.12
buyer_7,María,Valdec,1968-12-31,02529745K,maría.valdec@hyperdev.site,875013,ES22209506301220461003,7234.17,2024-08-09T18:46:03,Portugalete,expenses,education,-63.57,-51820.69
buyer_7,María,Valdec,1968-12-31,02529745K,maría.valdec@hyperdev.site,875013,ES22209506301220461003,7234.17,2024-08-10T16:27:26,Portugalete,expenses,cash,-100.0,-51920.69
buyer_7,María,Valdec,1968-12-31,02529745K,maría.valdec@hyperdev.site,875013,ES22209506301220461003,7234.17,2024-08-13T09:23:39,Portugalete,expenses,cash,-100.0,-52020.69
buyer_7,María,Valdec,1968-12-31,02529745K,maría.valdec@hyperdev.site,875013,ES22209506301220461003,7234.17,2024-08-14T17:16:13,Portugalete,expenses,food,-121.62,-52142.31
buyer_7,María,Valdec,1968-12-31,02529745K,maría.valdec@hyperdev.site,875013,ES22209506301220461003,7234.17,2024-08-16T10:59:38,Portugalete,expenses,food,-85.25,-52227.56
buyer_7,María,Valdec,1968-12-31,02529745K,maría.valdec@hyperdev.site,875013,ES22209506301220461003,7234.17,2024-08-16T14:25:29,Portugalete,expenses,transport,-56.79,-52284.35
buyer_7,María,Valdec,1968-12-31,02529745K,maría.valdec@hyperdev.site,875013,ES22209506301220461003,7234.17,2024-08-16T17:23:20,Portugalete,expenses,leisure,-60.49,-52344.84
buyer_7,María,Valdec,1968-12-31,02529745K,maría.valdec@hyperdev.site,875013,ES22209506301220461003,7234.17,2024-08-20T21:06:32,Portugalete,expenses,transport,-44.92,-52389.76
buyer_7,María,Valdec,1968-12-31,02529745K,maría.valdec@hyperdev.site,875013,ES22209506301220461003,7234.17,2024-08-20T20:50:04,Portugalete,expenses,cash,-100.0,-52489.76
buyer_7,María,Valdec,1968-12-31,02529745K,maría.valdec@hyperdev.site,875013,ES22209506301220461003,7234.17,2024-08-21T15:47:06,Portugalete,expenses,food,-84.21,-52573.97
buyer_7,María,Valdec,1968-12-31,02529745K,maría.valdec@hyperdev.site,875013,ES22209506301220461003,7234.17,2024-08-22T13:06:42,Portugalete,expenses,leisure,-59.19,-52633.16
buyer_7,María,Valdec,1968-12-31,02529745K,maría.valdec@hyperdev.site,875013,ES22209506301220461003,7234.17,2024-08-22T10:11:25,Portugalete,expenses,cash,-100.0,-52733.16
buyer_7,María,Valdec,1968-12-31,02529745K,maría.valdec@hyperdev.site,875013,ES22209506301220461003,7234.17,2024-08-24T08:40:13,Portugalete,expenses,food,-81.47,-52814.63
buyer_7,María,Valdec,1968-12-31,02529745K,maría.valdec@hyperdev.site,875013,ES22209506301220461003,7234.17,2024-08-26T00:29:43,Portugalete,expenses,food,-79.11,-52893.74
buyer_7,María,Valdec,1968-12-31,02529745K,maría.valdec@hyperdev.site,875013,ES22209506301220461003,7234.17,2024-08-27T08:57:39,Portugalete,expenses,food,-62.28,-52956.02
buyer_7,María,Valdec,1968-12-31,02529745K,maría.valdec@hyperdev.site,875013,ES22209506301220461003,7234.17,2024-08-29T16:05:09,Portugalete,expenses,cash,-100.0,-53056.02
buyer_7,María,Valdec,1968-12-31,02529745K,maría.valdec@hyperdev.site,875013,ES22209506301220461003,7234.17,2024-08-31T19:27:22,Portugalete,expenses,food,-84.26,-53140.28
buyer_7,María,Valdec,1968-12-31,02529745K,maría.valdec@hyperdev.site,875013,ES22209506301220461003,7234.17,2024-08-31T02:53:29,Portugalete,expenses,clothing,-83.93,-53224.21
buyer_7,María,Valdec,1968-12-31,02529745K,maría.valdec@hyperdev.site,875013,ES22209506301220461003,7234.17,2024-08-31T20:17:10,Portugalete,expenses,cash,-100.0,-53324.21
buyer_7,María,Valdec,1968-12-31,02529745K,maría.valdec@hyperdev.site,875013,ES22209506301220461003,7234.17,2024-09-01T18:32:22,Portugalete,incomes,salary,1634.83,-51689.38
buyer_7,María,Valdec,1968-12-31,02529745K,maría.valdec@hyperdev.site,875013,ES22209506301220461003,7234.17,2024-09-01T03:56:59,Portugalete,expenses,gifts,-148.67,-51838.05
buyer_7,María,Valdec,1968-12-31,02529745K,maría.valdec@hyperdev.site,875013,ES22209506301220461003,7234.17,2024-09-02T23:37:44,Portugalete,expenses,cash,-100.0,-51938.05
buyer_7,María,Valdec,1968-12-31,02529745K,maría.valdec@hyperdev.site,875013,ES22209506301220461003,7234.17,2024-09-03T18:59:38,Portugalete,expenses,education,-57.56,-51995.61
buyer_7,María,Valdec,1968-12-31,02529745K,maría.valdec@hyperdev.site,875013,ES22209506301220461003,7234.17,2024-09-04T11:47:29,Portugalete,expenses,mortgage,-879.12,-52874.73
buyer_7,María,Valdec,1968-12-31,02529745K,maría.valdec@hyperdev.site,875013,ES22209506301220461003,7234.17,2024-09-04T10:48:30,Portugalete,expenses,transport,-50.58,-52925.31
buyer_7,María,Valdec,1968-12-31,02529745K,maría.valdec@hyperdev.site,875013,ES22209506301220461003,7234.17,2024-09-04T09:19:02,Portugalete,expenses,appliances,-209.66,-53134.97
buyer_7,María,Valdec,1968-12-31,02529745K,maría.valdec@hyperdev.site,875013,ES22209506301220461003,7234.17,2024-09-05T02:24:15,Portugalete,expenses,gas,-68.05,-53203.02
buyer_7,María,Valdec,1968-12-31,02529745K,maría.valdec@hyperdev.site,875013,ES22209506301220461003,7234.17,2024-09-05T19:11:18,Portugalete,expenses,phone,-30.79,-53233.81
buyer_7,María,Valdec,1968-12-31,02529745K,maría.valdec@hyperdev.site,875013,ES22209506301220461003,7234.17,2024-09-06T20:49:12,Portugalete,expenses,food,-88.26,-53322.07
buyer_7,María,Valdec,1968-12-31,02529745K,maría.valdec@hyperdev.site,875013,ES22209506301220461003,7234.17,2024-09-07T13:10:02,Portugalete,expenses,transport,-50.67,-53372.74
buyer_7,María,Valdec,1968-12-31,02529745K,maría.valdec@hyperdev.site,875013,ES22209506301220461003,7234.17,2024-09-07T23:44:26,Portugalete,expenses,cash,-100.0,-53472.74
buyer_7,María,Valdec,1968-12-31,02529745K,maría.valdec@hyperdev.site,875013,ES22209506301220461003,7234.17,2024-09-08T10:24:50,Portugalete,expenses,water,-18.19,-53490.93
buyer_7,María,Valdec,1968-12-31,02529745K,maría.valdec@hyperdev.site,875013,ES22209506301220461003,7234.17,2024-09-08T14:21:09,Portugalete,expenses,electricity,-52.8,-53543.73
buyer_7,María,Valdec,1968-12-31,02529745K,maría.valdec@hyperdev.site,875013,ES22209506301220461003,7234.17,2024-09-08T16:46:42,Portugalete,expenses,internet,-34.33,-53578.06
buyer_7,María,Valdec,1968-12-31,02529745K,maría.valdec@hyperdev.site,875013,ES22209506301220461003,7234.17,2024-09-08T05:46:47,Portugalete,expenses,transport,-62.54,-53640.6
buyer_7,María,Valdec,1968-12-31,02529745K,maría.valdec@hyperdev.site,875013,ES22209506301220461003,7234.17,2024-09-08T12:38:03,Portugalete,expenses,repairs,-147.54,-53788.14
buyer_7,María,Valdec,1968-12-31,02529745K,maría.valdec@hyperdev.site,875013,ES22209506301220461003,7234.17,2024-09-10T19:24:42,Portugalete,expenses,food,-123.83,-53911.97
buyer_7,María,Valdec,1968-12-31,02529745K,maría.valdec@hyperdev.site,875013,ES22209506301220461003,7234.17,2024-09-10T15:12:00,Portugalete,expenses,transport,-72.74,-53984.71
buyer_7,María,Valdec,1968-12-31,02529745K,maría.valdec@hyperdev.site,875013,ES22209506301220461003,7234.17,2024-09-10T10:50:42,Portugalete,expenses,education,-72.42,-54057.13
buyer_7,María,Valdec,1968-12-31,02529745K,maría.valdec@hyperdev.site,875013,ES22209506301220461003,7234.17,2024-09-12T15:18:34,Portugalete,expenses,food,-63.55,-54120.68
buyer_7,María,Valdec,1968-12-31,02529745K,maría.valdec@hyperdev.site,875013,ES22209506301220461003,7234.17,2024-09-12T10:31:57,Portugalete,expenses,transport,-65.35,-54186.03
buyer_7,María,Valdec,1968-12-31,02529745K,maría.valdec@hyperdev.site,875013,ES22209506301220461003,7234.17,2024-09-14T08:27:46,Portugalete,expenses,clothing,-101.59,-54287.62
buyer_7,María,Valdec,1968-12-31,02529745K,maría.valdec@hyperdev.site,875013,ES22209506301220461003,7234.17,2024-09-14T18:49:10,Portugalete,expenses,car,-137.96,-54425.58
buyer_7,María,Valdec,1968-12-31,02529745K,maría.valdec@hyperdev.site,875013,ES22209506301220461003,7234.17,2024-09-15T12:04:01,Portugalete,expenses,repairs,-90.23,-54515.81
buyer_7,María,Valdec,1968-12-31,02529745K,maría.valdec@hyperdev.site,875013,ES22209506301220461003,7234.17,2024-09-17T18:19:23,Portugalete,expenses,gifts,-109.25,-54625.06
buyer_7,María,Valdec,1968-12-31,02529745K,maría.valdec@hyperdev.site,875013,ES22209506301220461003,7234.17,2024-09-19T12:42:36,Portugalete,expenses,repairs,-250.59,-54875.65
buyer_7,María,Valdec,1968-12-31,02529745K,maría.valdec@hyperdev.site,875013,ES22209506301220461003,7234.17,2024-09-20T11:53:51,Portugalete,expenses,clothing,-101.95,-54977.6
buyer_7,María,Valdec,1968-12-31,02529745K,maría.valdec@hyperdev.site,875013,ES22209506301220461003,7234.17,2024-09-21T08:22:45,Portugalete,expenses,repairs,-283.55,-55261.15
buyer_7,María,Valdec,1968-12-31,02529745K,maría.valdec@hyperdev.site,875013,ES22209506301220461003,7234.17,2024-09-22T14:28:17,Portugalete,expenses,repairs,-115.22,-55376.37
buyer_7,María,Valdec,1968-12-31,02529745K,maría.valdec@hyperdev.site,875013,ES22209506301220461003,7234.17,2024-09-24T22:05:31,Portugalete,expenses,appliances,-223.85,-55600.22
buyer_7,María,Valdec,1968-12-31,02529745K,maría.valdec@hyperdev.site,875013,ES22209506301220461003,7234.17,2024-09-25T00:53:42,Portugalete,expenses,transport,-84.07,-55684.29
buyer_7,María,Valdec,1968-12-31,02529745K,maría.valdec@hyperdev.site,875013,ES22209506301220461003,7234.17,2024-09-25T12:48:11,Portugalete,expenses,children,-221.59258333333332,-55905.88
buyer_7,María,Valdec,1968-12-31,02529745K,maría.valdec@hyperdev.site,875013,ES22209506301220461003,7234.17,2024-09-26T10:11:34,Portugalete,expenses,cash,-100.0,-56005.88
buyer_7,María,Valdec,1968-12-31,02529745K,maría.valdec@hyperdev.site,875013,ES22209506301220461003,7234.17,2024-09-26T17:14:52,Portugalete,expenses,repairs,-50.76,-56056.64
buyer_7,María,Valdec,1968-12-31,02529745K,maría.valdec@hyperdev.site,875013,ES22209506301220461003,7234.17,2024-09-28T11:17:04,Portugalete,expenses,cash,-100.0,-56156.64
buyer_7,María,Valdec,1968-12-31,02529745K,maría.valdec@hyperdev.site,875013,ES22209506301220461003,7234.17,2024-09-29T14:05:12,Portugalete,expenses,cash,-100.0,-56256.64
buyer_7,María,Valdec,1968-12-31,02529745K,maría.valdec@hyperdev.site,875013,ES22209506301220461003,7234.17,2024-10-01T13:46:19,Portugalete,incomes,salary,1634.83,-54621.81
buyer_7,María,Valdec,1968-12-31,02529745K,maría.valdec@hyperdev.site,875013,ES22209506301220461003,7234.17,2024-10-01T13:46:19,Portugalete,incomes,extra_income,208.35,-54413.46
buyer_7,María,Valdec,1968-12-31,02529745K,maría.valdec@hyperdev.site,875013,ES22209506301220461003,7234.17,2024-10-01T03:59:23,Portugalete,expenses,cash,-100.0,-54513.46
buyer_7,María,Valdec,1968-12-31,02529745K,maría.valdec@hyperdev.site,875013,ES22209506301220461003,7234.17,2024-10-02T02:45:10,Portugalete,expenses,transport,-84.59,-54598.05
buyer_7,María,Valdec,1968-12-31,02529745K,maría.valdec@hyperdev.site,875013,ES22209506301220461003,7234.17,2024-10-03T22:36:42,Portugalete,expenses,clothing,-136.29,-54734.34
buyer_7,María,Valdec,1968-12-31,02529745K,maría.valdec@hyperdev.site,875013,ES22209506301220461003,7234.17,2024-10-04T09:29:05,Portugalete,expenses,mortgage,-879.12,-55613.46
buyer_7,María,Valdec,1968-12-31,02529745K,maría.valdec@hyperdev.site,875013,ES22209506301220461003,7234.17,2024-10-06T16:31:07,Portugalete,expenses,internet,-34.33,-55647.79
buyer_7,María,Valdec,1968-12-31,02529745K,maría.valdec@hyperdev.site,875013,ES22209506301220461003,7234.17,2024-10-06T14:53:20,Portugalete,expenses,phone,-34.54,-55682.33
buyer_7,María,Valdec,1968-12-31,02529745K,maría.valdec@hyperdev.site,875013,ES22209506301220461003,7234.17,2024-10-08T20:03:24,Portugalete,expenses,electricity,-23.95,-55706.28
buyer_7,María,Valdec,1968-12-31,02529745K,maría.valdec@hyperdev.site,875013,ES22209506301220461003,7234.17,2024-10-08T20:53:16,Portugalete,expenses,gas,-74.16,-55780.44
buyer_7,María,Valdec,1968-12-31,02529745K,maría.valdec@hyperdev.site,875013,ES22209506301220461003,7234.17,2024-10-08T20:37:52,Portugalete,expenses,water,-28.48,-55808.92
buyer_7,María,Valdec,1968-12-31,02529745K,maría.valdec@hyperdev.site,875013,ES22209506301220461003,7234.17,2024-10-08T15:46:33,Portugalete,expenses,food,-88.47,-55897.39
buyer_7,María,Valdec,1968-12-31,02529745K,maría.valdec@hyperdev.site,875013,ES22209506301220461003,7234.17,2024-10-08T09:20:32,Portugalete,expenses,cash,-100.0,-55997.39
buyer_7,María,Valdec,1968-12-31,02529745K,maría.valdec@hyperdev.site,875013,ES22209506301220461003,7234.17,2024-10-09T12:52:02,Portugalete,expenses,gifts,-191.37,-56188.76
buyer_7,María,Valdec,1968-12-31,02529745K,maría.valdec@hyperdev.site,875013,ES22209506301220461003,7234.17,2024-10-10T12:18:24,Portugalete,expenses,cash,-100.0,-56288.76
buyer_7,María,Valdec,1968-12-31,02529745K,maría.valdec@hyperdev.site,875013,ES22209506301220461003,7234.17,2024-10-10T19:31:01,Portugalete,expenses,gifts,-58.76,-56347.52
buyer_8,Antonio,Miranda,1979-04-04,59224729M,antonio.miranda@supernet.net,427273,ES27209560243563162155,1664.64,2022-01-01T20:52:59,Labastida,incomes,salary,3588.11,5252.75
buyer_8,Antonio,Miranda,1979-04-04,59224729M,antonio.miranda@supernet.net,427273,ES27209560243563162155,1664.64,2022-01-03T16:23:23,Labastida,expenses,healthcare,-76.95,5175.8
buyer_8,Antonio,Miranda,1979-04-04,59224729M,antonio.miranda@supernet.net,427273,ES27209560243563162155,1664.64,2022-01-04T15:25:46,Labastida,expenses,mortgage,-1323.93,3851.87
buyer_8,Antonio,Miranda,1979-04-04,59224729M,antonio.miranda@supernet.net,427273,ES27209560243563162155,1664.64,2022-01-05T13:24:42,Labastida,expenses,cash,-100.0,3751.87
buyer_8,Antonio,Miranda,1979-04-04,59224729M,antonio.miranda@supernet.net,427273,ES27209560243563162155,1664.64,2022-01-07T09:29:26,Labastida,expenses,electricity,-54.27,3697.6
buyer_8,Antonio,Miranda,1979-04-04,59224729M,antonio.miranda@supernet.net,427273,ES27209560243563162155,1664.64,2022-01-07T08:26:03,Labastida,expenses,gas,-160.11,3537.49
buyer_8,Antonio,Miranda,1979-04-04,59224729M,antonio.miranda@supernet.net,427273,ES27209560243563162155,1664.64,2022-01-07T16:13:46,Labastida,expenses,food,-106.75,3430.74
buyer_8,Antonio,Miranda,1979-04-04,59224729M,antonio.miranda@supernet.net,427273,ES27209560243563162155,1664.64,2022-01-07T18:34:43,Labastida,expenses,cash,-100.0,3330.74
buyer_8,Antonio,Miranda,1979-04-04,59224729M,antonio.miranda@supernet.net,427273,ES27209560243563162155,1664.64,2022-01-07T09:08:00,Labastida,expenses,gifts,-693.85,2636.89
buyer_8,Antonio,Miranda,1979-04-04,59224729M,antonio.miranda@supernet.net,427273,ES27209560243563162155,1664.64,2022-01-08T08:06:22,Labastida,expenses,water,-40.58,2596.31
buyer_8,Antonio,Miranda,1979-04-04,59224729M,antonio.miranda@supernet.net,427273,ES27209560243563162155,1664.64,2022-01-08T14:25:08,Labastida,expenses,internet,-75.35,2520.96
buyer_8,Antonio,Miranda,1979-04-04,59224729M,antonio.miranda@supernet.net,427273,ES27209560243563162155,1664.64,2022-01-08T09:11:33,Labastida,expenses,phone,-58.22,2462.74
buyer_8,Antonio,Miranda,1979-04-04,59224729M,antonio.miranda@supernet.net,427273,ES27209560243563162155,1664.64,2022-01-09T09:06:01,Labastida,expenses,food,-77.58,2385.16
buyer_8,Antonio,Miranda,1979-04-04,59224729M,antonio.miranda@supernet.net,427273,ES27209560243563162155,1664.64,2022-01-09T00:41:26,Labastida,expenses,leisure,-20.56,2364.6
buyer_8,Antonio,Miranda,1979-04-04,59224729M,antonio.miranda@supernet.net,427273,ES27209560243563162155,1664.64,2022-01-09T08:40:17,Labastida,expenses,cash,-100.0,2264.6
buyer_8,Antonio,Miranda,1979-04-04,59224729M,antonio.miranda@supernet.net,427273,ES27209560243563162155,1664.64,2022-01-10T08:25:47,Labastida,expenses,food,-75.37,2189.23
buyer_8,Antonio,Miranda,1979-04-04,59224729M,antonio.miranda@supernet.net,427273,ES27209560243563162155,1664.64,2022-01-13T13:50:40,Labastida,expenses,cash,-100.0,2089.23
buyer_8,Antonio,Miranda,1979-04-04,59224729M,antonio.miranda@supernet.net,427273,ES27209560243563162155,1664.64,2022-01-15T17:20:17,Labastida,expenses,repairs,-254.82,1834.41
buyer_8,Antonio,Miranda,1979-04-04,59224729M,antonio.miranda@supernet.net,427273,ES27209560243563162155,1664.64,2022-01-16T19:52:17,Labastida,expenses,leisure,-84.82,1749.59
buyer_8,Antonio,Miranda,1979-04-04,59224729M,antonio.miranda@supernet.net,427273,ES27209560243563162155,1664.64,2022-01-17T10:47:26,Labastida,expenses,education,-48.03,1701.56
buyer_8,Antonio,Miranda,1979-04-04,59224729M,antonio.miranda@supernet.net,427273,ES27209560243563162155,1664.64,2022-01-18T14:19:13,Labastida,expenses,food,-72.8,1628.76
buyer_8,Antonio,Miranda,1979-04-04,59224729M,antonio.miranda@supernet.net,427273,ES27209560243563162155,1664.64,2022-01-19T12:27:58,Labastida,expenses,leisure,-20.06,1608.7
buyer_8,Antonio,Miranda,1979-04-04,59224729M,antonio.miranda@supernet.net,427273,ES27209560243563162155,1664.64,2022-01-19T20:17:00,Labastida,expenses,cash,-100.0,1508.7
buyer_8,Antonio,Miranda,1979-04-04,59224729M,antonio.miranda@supernet.net,427273,ES27209560243563162155,1664.64,2022-01-19T22:44:35,Labastida,expenses,appliances,-223.94,1284.76
buyer_8,Antonio,Miranda,1979-04-04,59224729M,antonio.miranda@supernet.net,427273,ES27209560243563162155,1664.64,2022-01-22T06:38:05,Labastida,expenses,leisure,-43.68,1241.08
buyer_8,Antonio,Miranda,1979-04-04,59224729M,antonio.miranda@supernet.net,427273,ES27209560243563162155,1664.64,2022-01-23T10:46:42,Labastida,expenses,cash,-100.0,1141.08
buyer_8,Antonio,Miranda,1979-04-04,59224729M,antonio.miranda@supernet.net,427273,ES27209560243563162155,1664.64,2022-01-24T21:09:24,Labastida,expenses,transport,-85.76,1055.32
buyer_8,Antonio,Miranda,1979-04-04,59224729M,antonio.miranda@supernet.net,427273,ES27209560243563162155,1664.64,2022-01-25T09:16:54,Labastida,expenses,cash,-100.0,955.32
buyer_8,Antonio,Miranda,1979-04-04,59224729M,antonio.miranda@supernet.net,427273,ES27209560243563162155,1664.64,2022-01-26T14:24:21,Labastida,expenses,gifts,-620.94,334.38
buyer_8,Antonio,Miranda,1979-04-04,59224729M,antonio.miranda@supernet.net,427273,ES27209560243563162155,1664.64,2022-01-30T18:13:27,Labastida,expenses,cash,-100.0,234.38
buyer_8,Antonio,Miranda,1979-04-04,59224729M,antonio.miranda@supernet.net,427273,ES27209560243563162155,1664.64,2022-02-01T10:19:51,Labastida,incomes,salary,3588.11,3822.49
buyer_8,Antonio,Miranda,1979-04-04,59224729M,antonio.miranda@supernet.net,427273,ES27209560243563162155,1664.64,2022-02-01T12:05:05,Labastida,expenses,repairs,-312.59,3509.9
buyer_8,Antonio,Miranda,1979-04-04,59224729M,antonio.miranda@supernet.net,427273,ES27209560243563162155,1664.64,2022-02-04T13:52:32,Labastida,expenses,mortgage,-1323.93,2185.97
buyer_8,Antonio,Miranda,1979-04-04,59224729M,antonio.miranda@supernet.net,427273,ES27209560243563162155,1664.64,2022-02-05T16:08:47,Labastida,expenses,electricity,-149.33,2036.64
buyer_8,Antonio,Miranda,1979-04-04,59224729M,antonio.miranda@supernet.net,427273,ES27209560243563162155,1664.64,2022-02-05T15:29:59,Labastida,expenses,transport,-49.05,1987.59
buyer_8,Antonio,Miranda,1979-04-04,59224729M,antonio.miranda@supernet.net,427273,ES27209560243563162155,1664.64,2022-02-05T16:24:04,Labastida,expenses,leisure,-42.49,1945.1
buyer_8,Antonio,Miranda,1979-04-04,59224729M,antonio.miranda@supernet.net,427273,ES27209560243563162155,1664.64,2022-02-06T11:19:09,Labastida,expenses,food,-63.83,1881.27
buyer_8,Antonio,Miranda,1979-04-04,59224729M,antonio.miranda@supernet.net,427273,ES27209560243563162155,1664.64,2022-02-06T19:51:52,Labastida,expenses,transport,-52.42,1828.85
buyer_8,Antonio,Miranda,1979-04-04,59224729M,antonio.miranda@supernet.net,427273,ES27209560243563162155,1664.64,2022-02-06T16:33:28,Labastida,expenses,education,-65.25,1763.6
buyer_8,Antonio,Miranda,1979-04-04,59224729M,antonio.miranda@supernet.net,427273,ES27209560243563162155,1664.64,2022-02-07T23:55:46,Labastida,expenses,gas,-180.62,1582.98
buyer_8,Antonio,Miranda,1979-04-04,59224729M,antonio.miranda@supernet.net,427273,ES27209560243563162155,1664.64,2022-02-07T10:57:34,Labastida,expenses,leisure,-74.55,1508.43
buyer_8,Antonio,Miranda,1979-04-04,59224729M,antonio.miranda@supernet.net,427273,ES27209560243563162155,1664.64,2022-02-07T01:26:06,Labastida,expenses,gifts,-227.0,1281.43
buyer_8,Antonio,Miranda,1979-04-04,59224729M,antonio.miranda@supernet.net,427273,ES27209560243563162155,1664.64,2022-02-08T19:09:38,Labastida,expenses,water,-49.76,1231.67
buyer_8,Antonio,Miranda,1979-04-04,59224729M,antonio.miranda@supernet.net,427273,ES27209560243563162155,1664.64,2022-02-08T21:58:24,Labastida,expenses,phone,-58.21,1173.46
buyer_8,Antonio,Miranda,1979-04-04,59224729M,antonio.miranda@supernet.net,427273,ES27209560243563162155,1664.64,2022-02-08T16:17:22,Labastida,expenses,internet,-75.35,1098.11
buyer_8,Antonio,Miranda,1979-04-04,59224729M,antonio.miranda@supernet.net,427273,ES27209560243563162155,1664.64,2022-02-08T11:15:11,Labastida,expenses,food,-117.16,980.95
buyer_8,Antonio,Miranda,1979-04-04,59224729M,antonio.miranda@supernet.net,427273,ES27209560243563162155,1664.64,2022-02-08T08:10:44,Labastida,expenses,cash,-100.0,880.95
buyer_8,Antonio,Miranda,1979-04-04,59224729M,antonio.miranda@supernet.net,427273,ES27209560243563162155,1664.64,2022-02-12T08:07:19,Labastida,expenses,food,-102.52,778.43
buyer_8,Antonio,Miranda,1979-04-04,59224729M,antonio.miranda@supernet.net,427273,ES27209560243563162155,1664.64,2022-02-18T14:00:44,Labastida,expenses,gifts,-826.79,-48.36
buyer_8,Antonio,Miranda,1979-04-04,59224729M,antonio.miranda@supernet.net,427273,ES27209560243563162155,1664.64,2022-02-20T15:57:27,Labastida,expenses,appliances,-190.14,-238.5
buyer_8,Antonio,Miranda,1979-04-04,59224729M,antonio.miranda@supernet.net,427273,ES27209560243563162155,1664.64,2022-02-20T14:32:11,Labastida,expenses,gifts,-747.87,-986.37
buyer_8,Antonio,Miranda,1979-04-04,59224729M,antonio.miranda@supernet.net,427273,ES27209560243563162155,1664.64,2022-02-22T13:40:38,Labastida,expenses,repairs,-163.75,-1150.12
buyer_8,Antonio,Miranda,1979-04-04,59224729M,antonio.miranda@supernet.net,427273,ES27209560243563162155,1664.64,2022-02-23T22:05:03,Labastida,expenses,repairs,-260.57,-1410.69
buyer_8,Antonio,Miranda,1979-04-04,59224729M,antonio.miranda@supernet.net,427273,ES27209560243563162155,1664.64,2022-02-24T15:14:25,Labastida,expenses,food,-74.85,-1485.54
buyer_8,Antonio,Miranda,1979-04-04,59224729M,antonio.miranda@supernet.net,427273,ES27209560243563162155,1664.64,2022-02-24T23:32:37,Labastida,expenses,car,-279.07,-1764.61
buyer_8,Antonio,Miranda,1979-04-04,59224729M,antonio.miranda@supernet.net,427273,ES27209560243563162155,1664.64,2022-02-25T17:32:18,Labastida,expenses,food,-68.01,-1832.62
buyer_8,Antonio,Miranda,1979-04-04,59224729M,antonio.miranda@supernet.net,427273,ES27209560243563162155,1664.64,2022-02-25T10:24:43,Labastida,expenses,travel,-1057.41,-2890.03
buyer_8,Antonio,Miranda,1979-04-04,59224729M,antonio.miranda@supernet.net,427273,ES27209560243563162155,1664.64,2022-02-25T11:55:56,Labastida,expenses,repairs,-155.04,-3045.07
buyer_8,Antonio,Miranda,1979-04-04,59224729M,antonio.miranda@supernet.net,427273,ES27209560243563162155,1664.64,2022-02-26T12:23:08,Labastida,expenses,cash,-100.0,-3145.07
buyer_8,Antonio,Miranda,1979-04-04,59224729M,antonio.miranda@supernet.net,427273,ES27209560243563162155,1664.64,2022-02-26T20:28:20,Labastida,expenses,repairs,-39.62,-3184.69
buyer_8,Antonio,Miranda,1979-04-04,59224729M,antonio.miranda@supernet.net,427273,ES27209560243563162155,1664.64,2022-02-28T16:58:07,Labastida,expenses,leisure,-83.76,-3268.45
buyer_8,Antonio,Miranda,1979-04-04,59224729M,antonio.miranda@supernet.net,427273,ES27209560243563162155,1664.64,2022-02-28T13:21:56,Labastida,expenses,appliances,-204.0,-3472.45
buyer_8,Antonio,Miranda,1979-04-04,59224729M,antonio.miranda@supernet.net,427273,ES27209560243563162155,1664.64,2022-03-01T12:59:30,Labastida,incomes,salary,3588.11,115.66
buyer_8,Antonio,Miranda,1979-04-04,59224729M,antonio.miranda@supernet.net,427273,ES27209560243563162155,1664.64,2022-03-03T18:02:46,Labastida,expenses,cash,-100.0,15.66
buyer_8,Antonio,Miranda,1979-04-04,59224729M,antonio.miranda@supernet.net,427273,ES27209560243563162155,1664.64,2022-03-04T09:23:52,Labastida,expenses,mortgage,-1323.93,-1308.27
buyer_8,Antonio,Miranda,1979-04-04,59224729M,antonio.miranda@supernet.net,427273,ES27209560243563162155,1664.64,2022-03-04T12:27:22,Labastida,expenses,clothing,-52.16,-1360.43
buyer_8,Antonio,Miranda,1979-04-04,59224729M,antonio.miranda@supernet.net,427273,ES27209560243563162155,1664.64,2022-03-06T11:41:13,Labastida,expenses,water,-46.16,-1406.59
buyer_8,Antonio,Miranda,1979-04-04,59224729M,antonio.miranda@supernet.net,427273,ES27209560243563162155,1664.64,2022-03-06T20:29:51,Labastida,expenses,internet,-75.35,-1481.94
buyer_8,Antonio,Miranda,1979-04-04,59224729M,antonio.miranda@supernet.net,427273,ES27209560243563162155,1664.64,2022-03-06T15:04:14,Labastida,expenses,phone,-68.52,-1550.46
buyer_8,Antonio,Miranda,1979-04-04,59224729M,antonio.miranda@supernet.net,427273,ES27209560243563162155,1664.64,2022-03-06T09:15:58,Labastida,expenses,food,-112.15,-1662.61
buyer_8,Antonio,Miranda,1979-04-04,59224729M,antonio.miranda@supernet.net,427273,ES27209560243563162155,1664.64,2022-03-07T08:54:22,Labastida,expenses,healthcare,-88.61,-1751.22
buyer_8,Antonio,Miranda,1979-04-04,59224729M,antonio.miranda@supernet.net,427273,ES27209560243563162155,1664.64,2022-03-08T11:09:21,Labastida,expenses,electricity,-48.05,-1799.27
buyer_8,Antonio,Miranda,1979-04-04,59224729M,antonio.miranda@supernet.net,427273,ES27209560243563162155,1664.64,2022-03-08T09:04:15,Labastida,expenses,gas,-125.39,-1924.66
buyer_8,Antonio,Miranda,1979-04-04,59224729M,antonio.miranda@supernet.net,427273,ES27209560243563162155,1664.64,2022-03-08T12:15:00,Labastida,expenses,food,-64.23,-1988.89
buyer_8,Antonio,Miranda,1979-04-04,59224729M,antonio.miranda@supernet.net,427273,ES27209560243563162155,1664.64,2022-03-11T17:40:56,Labastida,expenses,gifts,-840.58,-2829.47
buyer_8,Antonio,Miranda,1979-04-04,59224729M,antonio.miranda@supernet.net,427273,ES27209560243563162155,1664.64,2022-03-13T11:04:29,Labastida,expenses,gifts,-740.28,-3569.75
buyer_8,Antonio,Miranda,1979-04-04,59224729M,antonio.miranda@supernet.net,427273,ES27209560243563162155,1664.64,2022-03-14T04:04:09,Labastida,expenses,cash,-100.0,-3669.75
buyer_8,Antonio,Miranda,1979-04-04,59224729M,antonio.miranda@supernet.net,427273,ES27209560243563162155,1664.64,2022-03-15T21:44:28,Labastida,expenses,education,-72.36,-3742.11
buyer_8,Antonio,Miranda,1979-04-04,59224729M,antonio.miranda@supernet.net,427273,ES27209560243563162155,1664.64,2022-03-16T12:32:34,Labastida,expenses,gifts,-637.0,-4379.11
buyer_8,Antonio,Miranda,1979-04-04,59224729M,antonio.miranda@supernet.net,427273,ES27209560243563162155,1664.64,2022-03-17T01:23:18,Labastida,expenses,food,-74.54,-4453.65
buyer_8,Antonio,Miranda,1979-04-04,59224729M,antonio.miranda@supernet.net,427273,ES27209560243563162155,1664.64,2022-03-17T16:52:06,Labastida,expenses,appliances,-257.4,-4711.05
buyer_8,Antonio,Miranda,1979-04-04,59224729M,antonio.miranda@supernet.net,427273,ES27209560243563162155,1664.64,2022-03-18T15:17:27,Labastida,expenses,food,-85.21,-4796.26
buyer_8,Antonio,Miranda,1979-04-04,59224729M,antonio.miranda@supernet.net,427273,ES27209560243563162155,1664.64,2022-03-20T14:46:04,Labastida,expenses,food,-62.73,-4858.99
buyer_8,Antonio,Miranda,1979-04-04,59224729M,antonio.miranda@supernet.net,427273,ES27209560243563162155,1664.64,2022-03-20T19:24:43,Labastida,expenses,leisure,-58.61,-4917.6
buyer_8,Antonio,Miranda,1979-04-04,59224729M,antonio.miranda@supernet.net,427273,ES27209560243563162155,1664.64,2022-03-24T19:46:53,Labastida,expenses,leisure,-51.56,-4969.16
buyer_8,Antonio,Miranda,1979-04-04,59224729M,antonio.miranda@supernet.net,427273,ES27209560243563162155,1664.64,2022-03-24T18:44:35,Labastida,expenses,appliances,-281.68,-5250.84
buyer_8,Antonio,Miranda,1979-04-04,59224729M,antonio.miranda@supernet.net,427273,ES27209560243563162155,1664.64,2022-03-25T09:41:34,Labastida,expenses,food,-80.39,-5331.23
buyer_8,Antonio,Miranda,1979-04-04,59224729M,antonio.miranda@supernet.net,427273,ES27209560243563162155,1664.64,2022-03-26T11:30:41,Labastida,expenses,food,-75.71,-5406.94
buyer_8,Antonio,Miranda,1979-04-04,59224729M,antonio.miranda@supernet.net,427273,ES27209560243563162155,1664.64,2022-03-28T21:42:41,Labastida,expenses,transport,-77.3,-5484.24
buyer_8,Antonio,Miranda,1979-04-04,59224729M,antonio.miranda@supernet.net,427273,ES27209560243563162155,1664.64,2022-03-30T06:26:34,Labastida,expenses,leisure,-37.29,-5521.53
buyer_8,Antonio,Miranda,1979-04-04,59224729M,antonio.miranda@supernet.net,427273,ES27209560243563162155,1664.64,2022-04-01T11:31:50,Labastida,incomes,salary,3588.11,-1933.42
buyer_8,Antonio,Miranda,1979-04-04,59224729M,antonio.miranda@supernet.net,427273,ES27209560243563162155,1664.64,2022-04-01T11:31:50,Labastida,incomes,extra_income,484.35,-1449.07
buyer_8,Antonio,Miranda,1979-04-04,59224729M,antonio.miranda@supernet.net,427273,ES27209560243563162155,1664.64,2022-04-01T13:20:59,Labastida,expenses,food,-67.66,-1516.73
buyer_8,Antonio,Miranda,1979-04-04,59224729M,antonio.miranda@supernet.net,427273,ES27209560243563162155,1664.64,2022-04-02T15:43:46,Labastida,expenses,education,-46.11,-1562.84
buyer_8,Antonio,Miranda,1979-04-04,59224729M,antonio.miranda@supernet.net,427273,ES27209560243563162155,1664.64,2022-04-02T14:25:49,Labastida,expenses,cash,-100.0,-1662.84
buyer_8,Antonio,Miranda,1979-04-04,59224729M,antonio.miranda@supernet.net,427273,ES27209560243563162155,1664.64,2022-04-02T15:20:45,Labastida,expenses,appliances,-155.22,-1818.06
buyer_8,Antonio,Miranda,1979-04-04,59224729M,antonio.miranda@supernet.net,427273,ES27209560243563162155,1664.64,2022-04-04T20:17:14,Labastida,expenses,mortgage,-1323.93,-3141.99
buyer_8,Antonio,Miranda,1979-04-04,59224729M,antonio.miranda@supernet.net,427273,ES27209560243563162155,1664.64,2022-04-04T21:23:11,Labastida,expenses,leisure,-72.47,-3214.46
buyer_8,Antonio,Miranda,1979-04-04,59224729M,antonio.miranda@supernet.net,427273,ES27209560243563162155,1664.64,2022-04-04T20:19:59,Labastida,expenses,cash,-100.0,-3314.46
buyer_8,Antonio,Miranda,1979-04-04,59224729M,antonio.miranda@supernet.net,427273,ES27209560243563162155,1664.64,2022-04-04T10:19:44,Labastida,expenses,repairs,-283.22,-3597.68
buyer_8,Antonio,Miranda,1979-04-04,59224729M,antonio.miranda@supernet.net,427273,ES27209560243563162155,1664.64,2022-04-05T13:17:17,Labastida,expenses,electricity,-149.12,-3746.8
buyer_8,Antonio,Miranda,1979-04-04,59224729M,antonio.miranda@supernet.net,427273,ES27209560243563162155,1664.64,2022-04-05T08:09:13,Labastida,expenses,clothing,-95.47,-3842.27
buyer_8,Antonio,Miranda,1979-04-04,59224729M,antonio.miranda@supernet.net,427273,ES27209560243563162155,1664.64,2022-04-05T15:58:36,Labastida,expenses,cash,-100.0,-3942.27
buyer_8,Antonio,Miranda,1979-04-04,59224729M,antonio.miranda@supernet.net,427273,ES27209560243563162155,1664.64,2022-04-06T12:19:18,Labastida,expenses,internet,-75.35,-4017.62
buyer_8,Antonio,Miranda,1979-04-04,59224729M,antonio.miranda@supernet.net,427273,ES27209560243563162155,1664.64,2022-04-07T16:28:37,Labastida,expenses,leisure,-42.86,-4060.48
buyer_8,Antonio,Miranda,1979-04-04,59224729M,antonio.miranda@supernet.net,427273,ES27209560243563162155,1664.64,2022-04-07T09:47:47,Labastida,expenses,education,-51.62,-4112.1
buyer_8,Antonio,Miranda,1979-04-04,59224729M,antonio.miranda@supernet.net,427273,ES27209560243563162155,1664.64,2022-04-08T14:09:49,Labastida,expenses,gas,-66.25,-4178.35
buyer_8,Antonio,Miranda,1979-04-04,59224729M,antonio.miranda@supernet.net,427273,ES27209560243563162155,1664.64,2022-04-08T08:09:51,Labastida,expenses,water,-48.09,-4226.44
buyer_8,Antonio,Miranda,1979-04-04,59224729M,antonio.miranda@supernet.net,427273,ES27209560243563162155,1664.64,2022-04-08T12:35:00,Labastida,expenses,phone,-73.9,-4300.34
buyer_8,Antonio,Miranda,1979-04-04,59224729M,antonio.miranda@supernet.net,427273,ES27209560243563162155,1664.64,2022-04-08T12:00:38,Labastida,expenses,leisure,-75.15,-4375.49
buyer_8,Antonio,Miranda,1979-04-04,59224729M,antonio.miranda@supernet.net,427273,ES27209560243563162155,1664.64,2022-04-15T08:21:22,Labastida,expenses,food,-72.78,-4448.27
buyer_8,Antonio,Miranda,1979-04-04,59224729M,antonio.miranda@supernet.net,427273,ES27209560243563162155,1664.64,2022-04-15T18:35:16,Labastida,expenses,travel,-1703.13,-6151.4
buyer_8,Antonio,Miranda,1979-04-04,59224729M,antonio.miranda@supernet.net,427273,ES27209560243563162155,1664.64,2022-04-17T09:03:34,Labastida,expenses,healthcare,-172.19,-6323.59
buyer_8,Antonio,Miranda,1979-04-04,59224729M,antonio.miranda@supernet.net,427273,ES27209560243563162155,1664.64,2022-04-17T19:56:13,Labastida,expenses,cash,-100.0,-6423.59
buyer_8,Antonio,Miranda,1979-04-04,59224729M,antonio.miranda@supernet.net,427273,ES27209560243563162155,1664.64,2022-04-17T17:03:43,Labastida,expenses,appliances,-375.64,-6799.23
buyer_8,Antonio,Miranda,1979-04-04,59224729M,antonio.miranda@supernet.net,427273,ES27209560243563162155,1664.64,2022-04-20T16:41:08,Labastida,expenses,food,-104.98,-6904.21
buyer_8,Antonio,Miranda,1979-04-04,59224729M,antonio.miranda@supernet.net,427273,ES27209560243563162155,1664.64,2022-04-20T21:10:54,Labastida,expenses,cash,-100.0,-7004.21
buyer_8,Antonio,Miranda,1979-04-04,59224729M,antonio.miranda@supernet.net,427273,ES27209560243563162155,1664.64,2022-04-20T11:43:39,Labastida,expenses,gifts,-314.4,-7318.61
buyer_8,Antonio,Miranda,1979-04-04,59224729M,antonio.miranda@supernet.net,427273,ES27209560243563162155,1664.64,2022-04-21T08:36:00,Labastida,expenses,healthcare,-99.89,-7418.5
buyer_8,Antonio,Miranda,1979-04-04,59224729M,antonio.miranda@supernet.net,427273,ES27209560243563162155,1664.64,2022-04-23T16:47:07,Labastida,expenses,food,-89.79,-7508.29
buyer_8,Antonio,Miranda,1979-04-04,59224729M,antonio.miranda@supernet.net,427273,ES27209560243563162155,1664.64,2022-04-23T18:07:05,Labastida,expenses,transport,-82.13,-7590.42
buyer_8,Antonio,Miranda,1979-04-04,59224729M,antonio.miranda@supernet.net,427273,ES27209560243563162155,1664.64,2022-04-25T09:27:23,Labastida,expenses,education,-50.91,-7641.33
buyer_8,Antonio,Miranda,1979-04-04,59224729M,antonio.miranda@supernet.net,427273,ES27209560243563162155,1664.64,2022-04-26T19:25:42,Labastida,expenses,leisure,-22.33,-7663.66
buyer_8,Antonio,Miranda,1979-04-04,59224729M,antonio.miranda@supernet.net,427273,ES27209560243563162155,1664.64,2022-04-27T13:59:52,Labastida,expenses,transport,-69.74,-7733.4
buyer_8,Antonio,Miranda,1979-04-04,59224729M,antonio.miranda@supernet.net,427273,ES27209560243563162155,1664.64,2022-04-27T15:15:59,Labastida,expenses,cash,-100.0,-7833.4
buyer_8,Antonio,Miranda,1979-04-04,59224729M,antonio.miranda@supernet.net,427273,ES27209560243563162155,1664.64,2022-04-27T12:35:51,Labastida,expenses,appliances,-417.36,-8250.76
buyer_8,Antonio,Miranda,1979-04-04,59224729M,antonio.miranda@supernet.net,427273,ES27209560243563162155,1664.64,2022-04-28T16:48:44,Labastida,expenses,travel,-631.87,-8882.63
buyer_8,Antonio,Miranda,1979-04-04,59224729M,antonio.miranda@supernet.net,427273,ES27209560243563162155,1664.64,2022-04-29T03:52:10,Labastida,expenses,clothing,-73.83,-8956.46
buyer_8,Antonio,Miranda,1979-04-04,59224729M,antonio.miranda@supernet.net,427273,ES27209560243563162155,1664.64,2022-04-29T08:16:17,Labastida,expenses,cash,-100.0,-9056.46
buyer_8,Antonio,Miranda,1979-04-04,59224729M,antonio.miranda@supernet.net,427273,ES27209560243563162155,1664.64,2022-04-30T11:21:49,Labastida,expenses,cash,-100.0,-9156.46
buyer_8,Antonio,Miranda,1979-04-04,59224729M,antonio.miranda@supernet.net,427273,ES27209560243563162155,1664.64,2022-05-01T19:17:19,Labastida,incomes,salary,3588.11,-5568.35
buyer_8,Antonio,Miranda,1979-04-04,59224729M,antonio.miranda@supernet.net,427273,ES27209560243563162155,1664.64,2022-05-01T13:23:36,Labastida,expenses,transport,-69.41,-5637.76
buyer_8,Antonio,Miranda,1979-04-04,59224729M,antonio.miranda@supernet.net,427273,ES27209560243563162155,1664.64,2022-05-04T01:22:31,Labastida,expenses,mortgage,-1323.93,-6961.69
buyer_8,Antonio,Miranda,1979-04-04,59224729M,antonio.miranda@supernet.net,427273,ES27209560243563162155,1664.64,2022-05-04T08:12:23,Labastida,expenses,repairs,-153.19,-7114.88
buyer_8,Antonio,Miranda,1979-04-04,59224729M,antonio.miranda@supernet.net,427273,ES27209560243563162155,1664.64,2022-05-05T23:23:15,Labastida,expenses,phone,-72.54,-7187.42
buyer_8,Antonio,Miranda,1979-04-04,59224729M,antonio.miranda@supernet.net,427273,ES27209560243563162155,1664.64,2022-05-05T15:12:42,Labastida,expenses,food,-108.07,-7295.49
buyer_8,Antonio,Miranda,1979-04-04,59224729M,antonio.miranda@supernet.net,427273,ES27209560243563162155,1664.64,2022-05-07T03:16:05,Labastida,expenses,water,-78.41,-7373.9
buyer_8,Antonio,Miranda,1979-04-04,59224729M,antonio.miranda@supernet.net,427273,ES27209560243563162155,1664.64,2022-05-08T20:47:48,Labastida,expenses,gas,-112.76,-7486.66
buyer_8,Antonio,Miranda,1979-04-04,59224729M,antonio.miranda@supernet.net,427273,ES27209560243563162155,1664.64,2022-05-08T22:17:38,Labastida,expenses,internet,-75.35,-7562.01
buyer_8,Antonio,Miranda,1979-04-04,59224729M,antonio.miranda@supernet.net,427273,ES27209560243563162155,1664.64,2022-05-08T10:11:56,Labastida,expenses,electricity,-101.4,-7663.41
buyer_8,Antonio,Miranda,1979-04-04,59224729M,antonio.miranda@supernet.net,427273,ES27209560243563162155,1664.64,2022-05-08T11:15:41,Labastida,expenses,leisure,-69.51,-7732.92
buyer_8,Antonio,Miranda,1979-04-04,59224729M,antonio.miranda@supernet.net,427273,ES27209560243563162155,1664.64,2022-05-08T04:52:19,Labastida,expenses,education,-44.99,-7777.91
buyer_8,Antonio,Miranda,1979-04-04,59224729M,antonio.miranda@supernet.net,427273,ES27209560243563162155,1664.64,2022-05-08T12:57:20,Labastida,expenses,cash,-100.0,-7877.91
buyer_8,Antonio,Miranda,1979-04-04,59224729M,antonio.miranda@supernet.net,427273,ES27209560243563162155,1664.64,2022-05-09T09:04:11,Labastida,expenses,cash,-100.0,-7977.91
buyer_8,Antonio,Miranda,1979-04-04,59224729M,antonio.miranda@supernet.net,427273,ES27209560243563162155,1664.64,2022-05-11T16:20:44,Labastida,expenses,transport,-78.1,-8056.01
buyer_8,Antonio,Miranda,1979-04-04,59224729M,antonio.miranda@supernet.net,427273,ES27209560243563162155,1664.64,2022-05-13T20:38:44,Labastida,expenses,education,-71.95,-8127.96
buyer_8,Antonio,Miranda,1979-04-04,59224729M,antonio.miranda@supernet.net,427273,ES27209560243563162155,1664.64,2022-05-15T08:55:19,Labastida,expenses,cash,-100.0,-8227.96
buyer_8,Antonio,Miranda,1979-04-04,59224729M,antonio.miranda@supernet.net,427273,ES27209560243563162155,1664.64,2022-05-15T12:56:47,Labastida,expenses,repairs,-234.09,-8462.05
buyer_8,Antonio,Miranda,1979-04-04,59224729M,antonio.miranda@supernet.net,427273,ES27209560243563162155,1664.64,2022-05-19T19:01:51,Labastida,expenses,food,-61.88,-8523.93
buyer_8,Antonio,Miranda,1979-04-04,59224729M,antonio.miranda@supernet.net,427273,ES27209560243563162155,1664.64,2022-05-20T17:49:55,Labastida,expenses,transport,-75.95,-8599.88
buyer_8,Antonio,Miranda,1979-04-04,59224729M,antonio.miranda@supernet.net,427273,ES27209560243563162155,1664.64,2022-05-20T15:18:07,Labastida,expenses,education,-61.37,-8661.25
buyer_8,Antonio,Miranda,1979-04-04,59224729M,antonio.miranda@supernet.net,427273,ES27209560243563162155,1664.64,2022-05-21T06:45:54,Labastida,expenses,cash,-100.0,-8761.25
buyer_8,Antonio,Miranda,1979-04-04,59224729M,antonio.miranda@supernet.net,427273,ES27209560243563162155,1664.64,2022-05-22T09:14:10,Labastida,expenses,food,-107.15,-8868.4
buyer_8,Antonio,Miranda,1979-04-04,59224729M,antonio.miranda@supernet.net,427273,ES27209560243563162155,1664.64,2022-05-25T23:51:57,Labastida,expenses,appliances,-99.5,-8967.9
buyer_8,Antonio,Miranda,1979-04-04,59224729M,antonio.miranda@supernet.net,427273,ES27209560243563162155,1664.64,2022-05-28T02:55:14,Labastida,expenses,education,-49.83,-9017.73
buyer_8,Antonio,Miranda,1979-04-04,59224729M,antonio.miranda@supernet.net,427273,ES27209560243563162155,1664.64,2022-05-30T12:14:54,Labastida,expenses,cash,-100.0,-9117.73
buyer_8,Antonio,Miranda,1979-04-04,59224729M,antonio.miranda@supernet.net,427273,ES27209560243563162155,1664.64,2022-05-31T10:08:14,Labastida,expenses,car,-524.66,-9642.39
buyer_8,Antonio,Miranda,1979-04-04,59224729M,antonio.miranda@supernet.net,427273,ES27209560243563162155,1664.64,2022-06-01T20:47:27,Labastida,incomes,salary,3588.11,-6054.28
buyer_8,Antonio,Miranda,1979-04-04,59224729M,antonio.miranda@supernet.net,427273,ES27209560243563162155,1664.64,2022-06-01T20:47:27,Labastida,incomes,salary_bonus,2573.69,-3480.59
buyer_8,Antonio,Miranda,1979-04-04,59224729M,antonio.miranda@supernet.net,427273,ES27209560243563162155,1664.64,2022-06-01T19:43:30,Labastida,expenses,food,-102.58,-3583.17
buyer_8,Antonio,Miranda,1979-04-04,59224729M,antonio.miranda@supernet.net,427273,ES27209560243563162155,1664.64,2022-06-01T13:40:52,Labastida,expenses,cash,-100.0,-3683.17
buyer_8,Antonio,Miranda,1979-04-04,59224729M,antonio.miranda@supernet.net,427273,ES27209560243563162155,1664.64,2022-06-01T19:07:39,Labastida,expenses,repairs,-300.49,-3983.66
buyer_8,Antonio,Miranda,1979-04-04,59224729M,antonio.miranda@supernet.net,427273,ES27209560243563162155,1664.64,2022-06-03T14:52:35,Labastida,expenses,cash,-100.0,-4083.66
buyer_8,Antonio,Miranda,1979-04-04,59224729M,antonio.miranda@supernet.net,427273,ES27209560243563162155,1664.64,2022-06-04T11:26:53,Labastida,expenses,mortgage,-1323.93,-5407.59
buyer_8,Antonio,Miranda,1979-04-04,59224729M,antonio.miranda@supernet.net,427273,ES27209560243563162155,1664.64,2022-06-05T16:20:51,Labastida,expenses,water,-40.75,-5448.34
buyer_8,Antonio,Miranda,1979-04-04,59224729M,antonio.miranda@supernet.net,427273,ES27209560243563162155,1664.64,2022-06-05T17:15:19,Labastida,expenses,electricity,-154.27,-5602.61
buyer_8,Antonio,Miranda,1979-04-04,59224729M,antonio.miranda@supernet.net,427273,ES27209560243563162155,1664.64,2022-06-05T18:43:03,Labastida,expenses,gifts,-774.41,-6377.02
buyer_8,Antonio,Miranda,1979-04-04,59224729M,antonio.miranda@supernet.net,427273,ES27209560243563162155,1664.64,2022-06-06T13:28:53,Labastida,expenses,internet,-75.35,-6452.37
buyer_8,Antonio,Miranda,1979-04-04,59224729M,antonio.miranda@supernet.net,427273,ES27209560243563162155,1664.64,2022-06-07T17:26:30,Labastida,expenses,gas,-66.86,-6519.23
buyer_8,Antonio,Miranda,1979-04-04,59224729M,antonio.miranda@supernet.net,427273,ES27209560243563162155,1664.64,2022-06-08T05:18:17,Labastida,expenses,phone,-75.79,-6595.02
buyer_8,Antonio,Miranda,1979-04-04,59224729M,antonio.miranda@supernet.net,427273,ES27209560243563162155,1664.64,2022-06-08T01:15:28,Labastida,expenses,food,-120.66,-6715.68
buyer_8,Antonio,Miranda,1979-04-04,59224729M,antonio.miranda@supernet.net,427273,ES27209560243563162155,1664.64,2022-06-09T11:46:40,Labastida,expenses,cash,-100.0,-6815.68
buyer_8,Antonio,Miranda,1979-04-04,59224729M,antonio.miranda@supernet.net,427273,ES27209560243563162155,1664.64,2022-06-11T07:11:44,Labastida,expenses,food,-75.99,-6891.67
buyer_8,Antonio,Miranda,1979-04-04,59224729M,antonio.miranda@supernet.net,427273,ES27209560243563162155,1664.64,2022-06-13T21:04:04,Labastida,expenses,cash,-100.0,-6991.67
buyer_8,Antonio,Miranda,1979-04-04,59224729M,antonio.miranda@supernet.net,427273,ES27209560243563162155,1664.64,2022-06-14T09:13:02,Labastida,expenses,transport,-64.71,-7056.38
buyer_8,Antonio,Miranda,1979-04-04,59224729M,antonio.miranda@supernet.net,427273,ES27209560243563162155,1664.64,2022-06-16T16:00:10,Labastida,expenses,food,-107.71,-7164.09
buyer_8,Antonio,Miranda,1979-04-04,59224729M,antonio.miranda@supernet.net,427273,ES27209560243563162155,1664.64,2022-06-17T16:35:22,Labastida,expenses,transport,-53.47,-7217.56
buyer_8,Antonio,Miranda,1979-04-04,59224729M,antonio.miranda@supernet.net,427273,ES27209560243563162155,1664.64,2022-06-17T13:03:56,Labastida,expenses,cash,-100.0,-7317.56
buyer_8,Antonio,Miranda,1979-04-04,59224729M,antonio.miranda@supernet.net,427273,ES27209560243563162155,1664.64,2022-06-19T18:36:01,Labastida,expenses,cash,-100.0,-7417.56
buyer_8,Antonio,Miranda,1979-04-04,59224729M,antonio.miranda@supernet.net,427273,ES27209560243563162155,1664.64,2022-06-19T18:43:10,Labastida,expenses,repairs,-34.56,-7452.12
buyer_8,Antonio,Miranda,1979-04-04,59224729M,antonio.miranda@supernet.net,427273,ES27209560243563162155,1664.64,2022-06-20T15:47:08,Labastida,expenses,transport,-58.07,-7510.19
buyer_8,Antonio,Miranda,1979-04-04,59224729M,antonio.miranda@supernet.net,427273,ES27209560243563162155,1664.64,2022-06-20T17:57:29,Labastida,expenses,leisure,-82.74,-7592.93
buyer_8,Antonio,Miranda,1979-04-04,59224729M,antonio.miranda@supernet.net,427273,ES27209560243563162155,1664.64,2022-06-21T13:17:13,Labastida,expenses,cash,-100.0,-7692.93
buyer_8,Antonio,Miranda,1979-04-04,59224729M,antonio.miranda@supernet.net,427273,ES27209560243563162155,1664.64,2022-06-27T15:26:19,Labastida,expenses,transport,-62.15,-7755.08
buyer_8,Antonio,Miranda,1979-04-04,59224729M,antonio.miranda@supernet.net,427273,ES27209560243563162155,1664.64,2022-06-30T13:45:44,Labastida,expenses,cash,-100.0,-7855.08
buyer_8,Antonio,Miranda,1979-04-04,59224729M,antonio.miranda@supernet.net,427273,ES27209560243563162155,1664.64,2022-07-01T03:49:56,Labastida,incomes,salary,3588.11,-4266.97
buyer_8,Antonio,Miranda,1979-04-04,59224729M,antonio.miranda@supernet.net,427273,ES27209560243563162155,1664.64,2022-07-04T17:53:14,Labastida,expenses,mortgage,-1323.93,-5590.9
buyer_8,Antonio,Miranda,1979-04-04,59224729M,antonio.miranda@supernet.net,427273,ES27209560243563162155,1664.64,2022-07-04T08:22:54,Labastida,expenses,cash,-100.0,-5690.9
buyer_8,Antonio,Miranda,1979-04-04,59224729M,antonio.miranda@supernet.net,427273,ES27209560243563162155,1664.64,2022-07-05T16:47:56,Labastida,expenses,water,-40.89,-5731.79
buyer_8,Antonio,Miranda,1979-04-04,59224729M,antonio.miranda@supernet.net,427273,ES27209560243563162155,1664.64,2022-07-05T21:05:46,Labastida,expenses,gas,-166.96,-5898.75
buyer_8,Antonio,Miranda,1979-04-04,59224729M,antonio.miranda@supernet.net,427273,ES27209560243563162155,1664.64,2022-07-05T12:45:50,Labastida,expenses,food,-122.2,-6020.95
buyer_8,Antonio,Miranda,1979-04-04,59224729M,antonio.miranda@supernet.net,427273,ES27209560243563162155,1664.64,2022-07-06T13:22:17,Labastida,expenses,phone,-62.85,-6083.8
buyer_8,Antonio,Miranda,1979-04-04,59224729M,antonio.miranda@supernet.net,427273,ES27209560243563162155,1664.64,2022-07-06T23:00:29,Labastida,expenses,food,-86.53,-6170.33
buyer_8,Antonio,Miranda,1979-04-04,59224729M,antonio.miranda@supernet.net,427273,ES27209560243563162155,1664.64,2022-07-06T17:26:22,Labastida,expenses,transport,-71.36,-6241.69
buyer_8,Antonio,Miranda,1979-04-04,59224729M,antonio.miranda@supernet.net,427273,ES27209560243563162155,1664.64,2022-07-06T15:35:19,Labastida,expenses,appliances,-233.13,-6474.82
buyer_8,Antonio,Miranda,1979-04-04,59224729M,antonio.miranda@supernet.net,427273,ES27209560243563162155,1664.64,2022-07-08T10:22:00,Labastida,expenses,electricity,-133.61,-6608.43
buyer_8,Antonio,Miranda,1979-04-04,59224729M,antonio.miranda@supernet.net,427273,ES27209560243563162155,1664.64,2022-07-08T20:26:18,Labastida,expenses,internet,-75.35,-6683.78
buyer_8,Antonio,Miranda,1979-04-04,59224729M,antonio.miranda@supernet.net,427273,ES27209560243563162155,1664.64,2022-07-11T18:10:00,Labastida,expenses,food,-111.3,-6795.08
buyer_8,Antonio,Miranda,1979-04-04,59224729M,antonio.miranda@supernet.net,427273,ES27209560243563162155,1664.64,2022-07-11T09:35:12,Labastida,expenses,cash,-100.0,-6895.08
buyer_8,Antonio,Miranda,1979-04-04,59224729M,antonio.miranda@supernet.net,427273,ES27209560243563162155,1664.64,2022-07-12T08:44:20,Labastida,expenses,travel,-794.83,-7689.91
buyer_8,Antonio,Miranda,1979-04-04,59224729M,antonio.miranda@supernet.net,427273,ES27209560243563162155,1664.64,2022-07-13T10:53:54,Labastida,expenses,food,-124.76,-7814.67
buyer_8,Antonio,Miranda,1979-04-04,59224729M,antonio.miranda@supernet.net,427273,ES27209560243563162155,1664.64,2022-07-16T12:52:06,Labastida,expenses,appliances,-252.31,-8066.98
buyer_8,Antonio,Miranda,1979-04-04,59224729M,antonio.miranda@supernet.net,427273,ES27209560243563162155,1664.64,2022-07-20T20:01:22,Labastida,expenses,leisure,-46.35,-8113.33
buyer_8,Antonio,Miranda,1979-04-04,59224729M,antonio.miranda@supernet.net,427273,ES27209560243563162155,1664.64,2022-07-21T19:25:03,Labastida,expenses,gifts,-66.08,-8179.41
buyer_8,Antonio,Miranda,1979-04-04,59224729M,antonio.miranda@supernet.net,427273,ES27209560243563162155,1664.64,2022-07-21T16:21:56,Labastida,expenses,car,-261.27,-8440.68
buyer_8,Antonio,Miranda,1979-04-04,59224729M,antonio.miranda@supernet.net,427273,ES27209560243563162155,1664.64,2022-07-22T08:27:07,Labastida,expenses,food,-101.49,-8542.17
buyer_8,Antonio,Miranda,1979-04-04,59224729M,antonio.miranda@supernet.net,427273,ES27209560243563162155,1664.64,2022-07-23T08:39:00,Labastida,expenses,appliances,-103.87,-8646.04
buyer_8,Antonio,Miranda,1979-04-04,59224729M,antonio.miranda@supernet.net,427273,ES27209560243563162155,1664.64,2022-07-24T15:18:32,Labastida,expenses,education,-52.48,-8698.52
buyer_8,Antonio,Miranda,1979-04-04,59224729M,antonio.miranda@supernet.net,427273,ES27209560243563162155,1664.64,2022-07-24T03:02:25,Labastida,expenses,cash,-100.0,-8798.52
buyer_8,Antonio,Miranda,1979-04-04,59224729M,antonio.miranda@supernet.net,427273,ES27209560243563162155,1664.64,2022-07-25T22:42:47,Labastida,expenses,cash,-100.0,-8898.52
buyer_8,Antonio,Miranda,1979-04-04,59224729M,antonio.miranda@supernet.net,427273,ES27209560243563162155,1664.64,2022-07-28T21:55:54,Labastida,expenses,transport,-53.42,-8951.94
buyer_8,Antonio,Miranda,1979-04-04,59224729M,antonio.miranda@supernet.net,427273,ES27209560243563162155,1664.64,2022-07-31T12:31:11,Labastida,expenses,cash,-100.0,-9051.94
buyer_8,Antonio,Miranda,1979-04-04,59224729M,antonio.miranda@supernet.net,427273,ES27209560243563162155,1664.64,2022-08-01T09:53:26,Labastida,incomes,salary,3588.11,-5463.83
buyer_8,Antonio,Miranda,1979-04-04,59224729M,antonio.miranda@supernet.net,427273,ES27209560243563162155,1664.64,2022-08-01T09:53:26,Labastida,incomes,extra_income,484.35,-4979.48
buyer_8,Antonio,Miranda,1979-04-04,59224729M,antonio.miranda@supernet.net,427273,ES27209560243563162155,1664.64,2022-08-03T14:48:47,Labastida,expenses,food,-105.88,-5085.36
buyer_8,Antonio,Miranda,1979-04-04,59224729M,antonio.miranda@supernet.net,427273,ES27209560243563162155,1664.64,2022-08-03T23:59:35,Labastida,expenses,transport,-61.72,-5147.08
buyer_8,Antonio,Miranda,1979-04-04,59224729M,antonio.miranda@supernet.net,427273,ES27209560243563162155,1664.64,2022-08-03T21:59:09,Labastida,expenses,clothing,-109.55,-5256.63
buyer_8,Antonio,Miranda,1979-04-04,59224729M,antonio.miranda@supernet.net,427273,ES27209560243563162155,1664.64,2022-08-03T23:40:39,Labastida,expenses,appliances,-351.18,-5607.81
buyer_8,Antonio,Miranda,1979-04-04,59224729M,antonio.miranda@supernet.net,427273,ES27209560243563162155,1664.64,2022-08-04T10:10:35,Labastida,expenses,mortgage,-1323.93,-6931.74
buyer_8,Antonio,Miranda,1979-04-04,59224729M,antonio.miranda@supernet.net,427273,ES27209560243563162155,1664.64,2022-08-04T11:04:47,Labastida,expenses,cash,-100.0,-7031.74
buyer_8,Antonio,Miranda,1979-04-04,59224729M,antonio.miranda@supernet.net,427273,ES27209560243563162155,1664.64,2022-08-05T11:05:26,Labastida,expenses,water,-72.53,-7104.27
buyer_8,Antonio,Miranda,1979-04-04,59224729M,antonio.miranda@supernet.net,427273,ES27209560243563162155,1664.64,2022-08-05T15:14:13,Labastida,expenses,gas,-138.84,-7243.11
buyer_8,Antonio,Miranda,1979-04-04,59224729M,antonio.miranda@supernet.net,427273,ES27209560243563162155,1664.64,2022-08-05T19:17:01,Labastida,expenses,phone,-64.49,-7307.6
buyer_8,Antonio,Miranda,1979-04-04,59224729M,antonio.miranda@supernet.net,427273,ES27209560243563162155,1664.64,2022-08-05T15:48:00,Labastida,expenses,food,-110.45,-7418.05
buyer_8,Antonio,Miranda,1979-04-04,59224729M,antonio.miranda@supernet.net,427273,ES27209560243563162155,1664.64,2022-08-07T10:08:24,Labastida,expenses,gifts,-47.73,-7465.78
buyer_8,Antonio,Miranda,1979-04-04,59224729M,antonio.miranda@supernet.net,427273,ES27209560243563162155,1664.64,2022-08-08T19:17:26,Labastida,expenses,electricity,-132.62,-7598.4
buyer_8,Antonio,Miranda,1979-04-04,59224729M,antonio.miranda@supernet.net,427273,ES27209560243563162155,1664.64,2022-08-08T13:09:08,Labastida,expenses,internet,-75.35,-7673.75
buyer_8,Antonio,Miranda,1979-04-04,59224729M,antonio.miranda@supernet.net,427273,ES27209560243563162155,1664.64,2022-08-09T19:44:17,Labastida,expenses,cash,-100.0,-7773.75
buyer_8,Antonio,Miranda,1979-04-04,59224729M,antonio.miranda@supernet.net,427273,ES27209560243563162155,1664.64,2022-08-11T16:59:44,Labastida,expenses,food,-97.79,-7871.54
buyer_8,Antonio,Miranda,1979-04-04,59224729M,antonio.miranda@supernet.net,427273,ES27209560243563162155,1664.64,2022-08-13T04:58:28,Labastida,expenses,food,-80.82,-7952.36
buyer_8,Antonio,Miranda,1979-04-04,59224729M,antonio.miranda@supernet.net,427273,ES27209560243563162155,1664.64,2022-08-14T10:38:32,Labastida,expenses,transport,-80.21,-8032.57
buyer_8,Antonio,Miranda,1979-04-04,59224729M,antonio.miranda@supernet.net,427273,ES27209560243563162155,1664.64,2022-08-14T13:12:27,Labastida,expenses,cash,-100.0,-8132.57
buyer_8,Antonio,Miranda,1979-04-04,59224729M,antonio.miranda@supernet.net,427273,ES27209560243563162155,1664.64,2022-08-16T17:45:22,Labastida,expenses,transport,-68.89,-8201.46
buyer_8,Antonio,Miranda,1979-04-04,59224729M,antonio.miranda@supernet.net,427273,ES27209560243563162155,1664.64,2022-08-16T13:43:08,Labastida,expenses,leisure,-40.73,-8242.19
buyer_8,Antonio,Miranda,1979-04-04,59224729M,antonio.miranda@supernet.net,427273,ES27209560243563162155,1664.64,2022-08-16T19:30:08,Labastida,expenses,gifts,-514.16,-8756.35
buyer_8,Antonio,Miranda,1979-04-04,59224729M,antonio.miranda@supernet.net,427273,ES27209560243563162155,1664.64,2022-08-17T17:06:52,Labastida,expenses,food,-87.87,-8844.22
buyer_8,Antonio,Miranda,1979-04-04,59224729M,antonio.miranda@supernet.net,427273,ES27209560243563162155,1664.64,2022-08-17T19:41:20,Labastida,expenses,cash,-100.0,-8944.22
buyer_8,Antonio,Miranda,1979-04-04,59224729M,antonio.miranda@supernet.net,427273,ES27209560243563162155,1664.64,2022-08-19T19:06:06,Labastida,expenses,cash,-100.0,-9044.22
buyer_8,Antonio,Miranda,1979-04-04,59224729M,antonio.miranda@supernet.net,427273,ES27209560243563162155,1664.64,2022-08-22T12:14:57,Labastida,expenses,clothing,-59.31,-9103.53
buyer_8,Antonio,Miranda,1979-04-04,59224729M,antonio.miranda@supernet.net,427273,ES27209560243563162155,1664.64,2022-08-22T18:54:23,Labastida,expenses,appliances,-406.28,-9509.81
buyer_8,Antonio,Miranda,1979-04-04,59224729M,antonio.miranda@supernet.net,427273,ES27209560243563162155,1664.64,2022-08-23T21:22:55,Labastida,expenses,food,-100.89,-9610.7
buyer_8,Antonio,Miranda,1979-04-04,59224729M,antonio.miranda@supernet.net,427273,ES27209560243563162155,1664.64,2022-08-23T10:08:53,Labastida,expenses,transport,-74.1,-9684.8
buyer_8,Antonio,Miranda,1979-04-04,59224729M,antonio.miranda@supernet.net,427273,ES27209560243563162155,1664.64,2022-08-24T14:49:30,Labastida,expenses,cash,-100.0,-9784.8
buyer_8,Antonio,Miranda,1979-04-04,59224729M,antonio.miranda@supernet.net,427273,ES27209560243563162155,1664.64,2022-08-25T13:17:10,Labastida,expenses,food,-118.2,-9903.0
buyer_8,Antonio,Miranda,1979-04-04,59224729M,antonio.miranda@supernet.net,427273,ES27209560243563162155,1664.64,2022-08-26T11:49:13,Labastida,expenses,food,-69.03,-9972.03
buyer_8,Antonio,Miranda,1979-04-04,59224729M,antonio.miranda@supernet.net,427273,ES27209560243563162155,1664.64,2022-08-28T18:50:15,Labastida,expenses,gifts,-817.81,-10789.84
buyer_8,Antonio,Miranda,1979-04-04,59224729M,antonio.miranda@supernet.net,427273,ES27209560243563162155,1664.64,2022-08-30T09:42:05,Labastida,expenses,cash,-100.0,-10889.84
buyer_8,Antonio,Miranda,1979-04-04,59224729M,antonio.miranda@supernet.net,427273,ES27209560243563162155,1664.64,2022-09-01T18:55:39,Labastida,incomes,salary,3588.11,-7301.73
buyer_8,Antonio,Miranda,1979-04-04,59224729M,antonio.miranda@supernet.net,427273,ES27209560243563162155,1664.64,2022-09-02T15:28:03,Labastida,expenses,leisure,-53.89,-7355.62
buyer_8,Antonio,Miranda,1979-04-04,59224729M,antonio.miranda@supernet.net,427273,ES27209560243563162155,1664.64,2022-09-02T17:12:47,Labastida,expenses,gifts,-488.0,-7843.62
buyer_8,Antonio,Miranda,1979-04-04,59224729M,antonio.miranda@supernet.net,427273,ES27209560243563162155,1664.64,2022-09-04T17:31:42,Labastida,expenses,mortgage,-1323.93,-9167.55
buyer_8,Antonio,Miranda,1979-04-04,59224729M,antonio.miranda@supernet.net,427273,ES27209560243563162155,1664.64,2022-09-04T19:47:42,Labastida,expenses,food,-87.44,-9254.99
buyer_8,Antonio,Miranda,1979-04-04,59224729M,antonio.miranda@supernet.net,427273,ES27209560243563162155,1664.64,2022-09-04T14:14:57,Labastida,expenses,cash,-100.0,-9354.99
buyer_8,Antonio,Miranda,1979-04-04,59224729M,antonio.miranda@supernet.net,427273,ES27209560243563162155,1664.64,2022-09-05T08:31:27,Labastida,expenses,gas,-69.46,-9424.45
buyer_8,Antonio,Miranda,1979-04-04,59224729M,antonio.miranda@supernet.net,427273,ES27209560243563162155,1664.64,2022-09-05T16:53:58,Labastida,expenses,food,-80.46,-9504.91
buyer_8,Antonio,Miranda,1979-04-04,59224729M,antonio.miranda@supernet.net,427273,ES27209560243563162155,1664.64,2022-09-06T10:41:20,Labastida,expenses,water,-44.64,-9549.55
buyer_8,Antonio,Miranda,1979-04-04,59224729M,antonio.miranda@supernet.net,427273,ES27209560243563162155,1664.64,2022-09-06T15:49:38,Labastida,expenses,electricity,-76.35,-9625.9
buyer_8,Antonio,Miranda,1979-04-04,59224729M,antonio.miranda@supernet.net,427273,ES27209560243563162155,1664.64,2022-09-07T19:08:58,Labastida,expenses,clothing,-94.41,-9720.31
buyer_8,Antonio,Miranda,1979-04-04,59224729M,antonio.miranda@supernet.net,427273,ES27209560243563162155,1664.64,2022-09-08T15:06:25,Labastida,expenses,phone,-74.92,-9795.23
buyer_8,Antonio,Miranda,1979-04-04,59224729M,antonio.miranda@supernet.net,427273,ES27209560243563162155,1664.64,2022-09-08T17:51:22,Labastida,expenses,internet,-75.35,-9870.58
buyer_8,Antonio,Miranda,1979-04-04,59224729M,antonio.miranda@supernet.net,427273,ES27209560243563162155,1664.64,2022-09-09T21:27:01,Labastida,expenses,cash,-100.0,-9970.58
buyer_8,Antonio,Miranda,1979-04-04,59224729M,antonio.miranda@supernet.net,427273,ES27209560243563162155,1664.64,2022-09-14T08:30:19,Labastida,expenses,transport,-69.58,-10040.16
buyer_8,Antonio,Miranda,1979-04-04,59224729M,antonio.miranda@supernet.net,427273,ES27209560243563162155,1664.64,2022-09-14T15:52:28,Labastida,expenses,gifts,-849.6,-10889.76
buyer_8,Antonio,Miranda,1979-04-04,59224729M,antonio.miranda@supernet.net,427273,ES27209560243563162155,1664.64,2022-09-16T08:02:24,Labastida,expenses,repairs,-261.61,-11151.37
buyer_8,Antonio,Miranda,1979-04-04,59224729M,antonio.miranda@supernet.net,427273,ES27209560243563162155,1664.64,2022-09-17T14:56:23,Labastida,expenses,leisure,-55.13,-11206.5
buyer_8,Antonio,Miranda,1979-04-04,59224729M,antonio.miranda@supernet.net,427273,ES27209560243563162155,1664.64,2022-09-17T18:08:52,Labastida,expenses,gifts,-631.78,-11838.28
buyer_8,Antonio,Miranda,1979-04-04,59224729M,antonio.miranda@supernet.net,427273,ES27209560243563162155,1664.64,2022-09-18T13:26:56,Labastida,expenses,leisure,-19.21,-11857.49
buyer_8,Antonio,Miranda,1979-04-04,59224729M,antonio.miranda@supernet.net,427273,ES27209560243563162155,1664.64,2022-09-18T20:08:56,Labastida,expenses,repairs,-64.67,-11922.16
buyer_8,Antonio,Miranda,1979-04-04,59224729M,antonio.miranda@supernet.net,427273,ES27209560243563162155,1664.64,2022-09-19T02:32:38,Labastida,expenses,clothing,-129.59,-12051.75
buyer_8,Antonio,Miranda,1979-04-04,59224729M,antonio.miranda@supernet.net,427273,ES27209560243563162155,1664.64,2022-09-20T15:19:08,Labastida,expenses,healthcare,-56.85,-12108.6
buyer_8,Antonio,Miranda,1979-04-04,59224729M,antonio.miranda@supernet.net,427273,ES27209560243563162155,1664.64,2022-09-21T12:40:35,Labastida,expenses,leisure,-37.77,-12146.37
buyer_8,Antonio,Miranda,1979-04-04,59224729M,antonio.miranda@supernet.net,427273,ES27209560243563162155,1664.64,2022-09-21T20:23:50,Labastida,expenses,clothing,-86.88,-12233.25
buyer_8,Antonio,Miranda,1979-04-04,59224729M,antonio.miranda@supernet.net,427273,ES27209560243563162155,1664.64,2022-09-23T14:42:18,Labastida,expenses,healthcare,-92.71,-12325.96
buyer_8,Antonio,Miranda,1979-04-04,59224729M,antonio.miranda@supernet.net,427273,ES27209560243563162155,1664.64,2022-09-23T11:21:43,Labastida,expenses,cash,-100.0,-12425.96
buyer_8,Antonio,Miranda,1979-04-04,59224729M,antonio.miranda@supernet.net,427273,ES27209560243563162155,1664.64,2022-09-23T13:34:38,Labastida,expenses,gifts,-817.12,-13243.08
buyer_8,Antonio,Miranda,1979-04-04,59224729M,antonio.miranda@supernet.net,427273,ES27209560243563162155,1664.64,2022-09-24T11:48:06,Labastida,expenses,healthcare,-69.39,-13312.47
buyer_8,Antonio,Miranda,1979-04-04,59224729M,antonio.miranda@supernet.net,427273,ES27209560243563162155,1664.64,2022-09-24T07:29:41,Labastida,expenses,cash,-100.0,-13412.47
buyer_8,Antonio,Miranda,1979-04-04,59224729M,antonio.miranda@supernet.net,427273,ES27209560243563162155,1664.64,2022-09-26T14:57:06,Labastida,expenses,education,-47.62,-13460.09
buyer_8,Antonio,Miranda,1979-04-04,59224729M,antonio.miranda@supernet.net,427273,ES27209560243563162155,1664.64,2022-09-27T20:42:47,Labastida,expenses,food,-92.71,-13552.8
buyer_8,Antonio,Miranda,1979-04-04,59224729M,antonio.miranda@supernet.net,427273,ES27209560243563162155,1664.64,2022-09-28T13:49:43,Labastida,expenses,transport,-63.31,-13616.11
buyer_8,Antonio,Miranda,1979-04-04,59224729M,antonio.miranda@supernet.net,427273,ES27209560243563162155,1664.64,2022-09-28T10:08:36,Labastida,expenses,gifts,-493.96,-14110.07
buyer_8,Antonio,Miranda,1979-04-04,59224729M,antonio.miranda@supernet.net,427273,ES27209560243563162155,1664.64,2022-09-29T19:04:10,Labastida,expenses,leisure,-44.02,-14154.09
buyer_8,Antonio,Miranda,1979-04-04,59224729M,antonio.miranda@supernet.net,427273,ES27209560243563162155,1664.64,2022-09-30T14:29:19,Labastida,expenses,food,-60.15,-14214.24
buyer_8,Antonio,Miranda,1979-04-04,59224729M,antonio.miranda@supernet.net,427273,ES27209560243563162155,1664.64,2022-09-30T10:25:52,Labastida,expenses,cash,-100.0,-14314.24
buyer_8,Antonio,Miranda,1979-04-04,59224729M,antonio.miranda@supernet.net,427273,ES27209560243563162155,1664.64,2022-10-01T10:02:10,Labastida,incomes,salary,3588.11,-10726.13
buyer_8,Antonio,Miranda,1979-04-04,59224729M,antonio.miranda@supernet.net,427273,ES27209560243563162155,1664.64,2022-10-01T19:38:47,Labastida,expenses,leisure,-21.6,-10747.73
buyer_8,Antonio,Miranda,1979-04-04,59224729M,antonio.miranda@supernet.net,427273,ES27209560243563162155,1664.64,2022-10-01T09:38:56,Labastida,expenses,healthcare,-141.9,-10889.63
buyer_8,Antonio,Miranda,1979-04-04,59224729M,antonio.miranda@supernet.net,427273,ES27209560243563162155,1664.64,2022-10-03T12:42:06,Labastida,expenses,food,-63.22,-10952.85
buyer_8,Antonio,Miranda,1979-04-04,59224729M,antonio.miranda@supernet.net,427273,ES27209560243563162155,1664.64,2022-10-04T14:06:48,Labastida,expenses,mortgage,-1323.93,-12276.78
buyer_8,Antonio,Miranda,1979-04-04,59224729M,antonio.miranda@supernet.net,427273,ES27209560243563162155,1664.64,2022-10-04T15:46:07,Labastida,expenses,food,-98.13,-12374.91
buyer_8,Antonio,Miranda,1979-04-04,59224729M,antonio.miranda@supernet.net,427273,ES27209560243563162155,1664.64,2022-10-06T15:05:28,Labastida,expenses,electricity,-92.7,-12467.61
buyer_8,Antonio,Miranda,1979-04-04,59224729M,antonio.miranda@supernet.net,427273,ES27209560243563162155,1664.64,2022-10-06T16:49:42,Labastida,expenses,transport,-86.03,-12553.64
buyer_8,Antonio,Miranda,1979-04-04,59224729M,antonio.miranda@supernet.net,427273,ES27209560243563162155,1664.64,2022-10-06T23:42:19,Labastida,expenses,leisure,-18.61,-12572.25
buyer_8,Antonio,Miranda,1979-04-04,59224729M,antonio.miranda@supernet.net,427273,ES27209560243563162155,1664.64,2022-10-07T18:13:16,Labastida,expenses,gas,-143.87,-12716.12
buyer_8,Antonio,Miranda,1979-04-04,59224729M,antonio.miranda@supernet.net,427273,ES27209560243563162155,1664.64,2022-10-07T18:39:02,Labastida,expenses,transport,-52.92,-12769.04
buyer_8,Antonio,Miranda,1979-04-04,59224729M,antonio.miranda@supernet.net,427273,ES27209560243563162155,1664.64,2022-10-07T11:29:16,Labastida,expenses,gifts,-397.78,-13166.82
buyer_8,Antonio,Miranda,1979-04-04,59224729M,antonio.miranda@supernet.net,427273,ES27209560243563162155,1664.64,2022-10-08T07:31:25,Labastida,expenses,water,-46.46,-13213.28
buyer_8,Antonio,Miranda,1979-04-04,59224729M,antonio.miranda@supernet.net,427273,ES27209560243563162155,1664.64,2022-10-08T19:03:42,Labastida,expenses,internet,-75.35,-13288.63
buyer_8,Antonio,Miranda,1979-04-04,59224729M,antonio.miranda@supernet.net,427273,ES27209560243563162155,1664.64,2022-10-08T10:52:29,Labastida,expenses,phone,-55.06,-13343.69
buyer_8,Antonio,Miranda,1979-04-04,59224729M,antonio.miranda@supernet.net,427273,ES27209560243563162155,1664.64,2022-10-09T17:41:17,Labastida,expenses,food,-111.69,-13455.38
buyer_8,Antonio,Miranda,1979-04-04,59224729M,antonio.miranda@supernet.net,427273,ES27209560243563162155,1664.64,2022-10-10T20:42:53,Labastida,expenses,leisure,-65.64,-13521.02
buyer_8,Antonio,Miranda,1979-04-04,59224729M,antonio.miranda@supernet.net,427273,ES27209560243563162155,1664.64,2022-10-15T08:43:30,Labastida,expenses,leisure,-50.4,-13571.42
buyer_8,Antonio,Miranda,1979-04-04,59224729M,antonio.miranda@supernet.net,427273,ES27209560243563162155,1664.64,2022-10-17T19:55:20,Labastida,expenses,cash,-100.0,-13671.42
buyer_8,Antonio,Miranda,1979-04-04,59224729M,antonio.miranda@supernet.net,427273,ES27209560243563162155,1664.64,2022-10-18T14:09:59,Labastida,expenses,leisure,-70.79,-13742.21
buyer_8,Antonio,Miranda,1979-04-04,59224729M,antonio.miranda@supernet.net,427273,ES27209560243563162155,1664.64,2022-10-18T11:19:02,Labastida,expenses,cash,-100.0,-13842.21
buyer_8,Antonio,Miranda,1979-04-04,59224729M,antonio.miranda@supernet.net,427273,ES27209560243563162155,1664.64,2022-10-20T12:00:33,Labastida,expenses,food,-92.58,-13934.79
buyer_8,Antonio,Miranda,1979-04-04,59224729M,antonio.miranda@supernet.net,427273,ES27209560243563162155,1664.64,2022-10-20T16:48:50,Labastida,expenses,clothing,-119.21,-14054.0
buyer_8,Antonio,Miranda,1979-04-04,59224729M,antonio.miranda@supernet.net,427273,ES27209560243563162155,1664.64,2022-10-21T08:08:56,Labastida,expenses,cash,-100.0,-14154.0
buyer_8,Antonio,Miranda,1979-04-04,59224729M,antonio.miranda@supernet.net,427273,ES27209560243563162155,1664.64,2022-10-23T11:39:50,Labastida,expenses,food,-108.28,-14262.28
buyer_8,Antonio,Miranda,1979-04-04,59224729M,antonio.miranda@supernet.net,427273,ES27209560243563162155,1664.64,2022-10-23T19:54:04,Labastida,expenses,cash,-100.0,-14362.28
buyer_8,Antonio,Miranda,1979-04-04,59224729M,antonio.miranda@supernet.net,427273,ES27209560243563162155,1664.64,2022-10-26T06:35:26,Labastida,expenses,food,-83.11,-14445.39
buyer_8,Antonio,Miranda,1979-04-04,59224729M,antonio.miranda@supernet.net,427273,ES27209560243563162155,1664.64,2022-10-26T10:11:44,Labastida,expenses,cash,-100.0,-14545.39
buyer_8,Antonio,Miranda,1979-04-04,59224729M,antonio.miranda@supernet.net,427273,ES27209560243563162155,1664.64,2022-10-26T08:15:10,Labastida,expenses,appliances,-221.79,-14767.18
buyer_8,Antonio,Miranda,1979-04-04,59224729M,antonio.miranda@supernet.net,427273,ES27209560243563162155,1664.64,2022-10-27T19:14:38,Labastida,expenses,healthcare,-132.3,-14899.48
buyer_8,Antonio,Miranda,1979-04-04,59224729M,antonio.miranda@supernet.net,427273,ES27209560243563162155,1664.64,2022-10-28T17:49:16,Labastida,expenses,leisure,-50.86,-14950.34
buyer_8,Antonio,Miranda,1979-04-04,59224729M,antonio.miranda@supernet.net,427273,ES27209560243563162155,1664.64,2022-10-28T09:27:09,Labastida,expenses,healthcare,-121.78,-15072.12
buyer_8,Antonio,Miranda,1979-04-04,59224729M,antonio.miranda@supernet.net,427273,ES27209560243563162155,1664.64,2022-10-29T21:20:43,Labastida,expenses,food,-107.27,-15179.39
buyer_8,Antonio,Miranda,1979-04-04,59224729M,antonio.miranda@supernet.net,427273,ES27209560243563162155,1664.64,2022-11-01T21:20:47,Labastida,incomes,salary,3588.11,-11591.28
buyer_8,Antonio,Miranda,1979-04-04,59224729M,antonio.miranda@supernet.net,427273,ES27209560243563162155,1664.64,2022-11-01T21:20:47,Labastida,incomes,extra_income,484.35,-11106.93
buyer_8,Antonio,Miranda,1979-04-04,59224729M,antonio.miranda@supernet.net,427273,ES27209560243563162155,1664.64,2022-11-01T12:11:01,Labastida,expenses,leisure,-82.41,-11189.34
buyer_8,Antonio,Miranda,1979-04-04,59224729M,antonio.miranda@supernet.net,427273,ES27209560243563162155,1664.64,2022-11-01T15:36:16,Labastida,expenses,cash,-100.0,-11289.34
buyer_8,Antonio,Miranda,1979-04-04,59224729M,antonio.miranda@supernet.net,427273,ES27209560243563162155,1664.64,2022-11-04T13:34:03,Labastida,expenses,mortgage,-1323.93,-12613.27
buyer_8,Antonio,Miranda,1979-04-04,59224729M,antonio.miranda@supernet.net,427273,ES27209560243563162155,1664.64,2022-11-04T16:12:59,Labastida,expenses,healthcare,-67.32,-12680.59
buyer_8,Antonio,Miranda,1979-04-04,59224729M,antonio.miranda@supernet.net,427273,ES27209560243563162155,1664.64,2022-11-05T17:49:40,Labastida,expenses,water,-37.77,-12718.36
buyer_8,Antonio,Miranda,1979-04-04,59224729M,antonio.miranda@supernet.net,427273,ES27209560243563162155,1664.64,2022-11-05T10:05:21,Labastida,expenses,electricity,-112.6,-12830.96
buyer_8,Antonio,Miranda,1979-04-04,59224729M,antonio.miranda@supernet.net,427273,ES27209560243563162155,1664.64,2022-11-05T02:26:49,Labastida,expenses,gas,-72.56,-12903.52
buyer_8,Antonio,Miranda,1979-04-04,59224729M,antonio.miranda@supernet.net,427273,ES27209560243563162155,1664.64,2022-11-06T15:25:06,Labastida,expenses,internet,-75.35,-12978.87
buyer_8,Antonio,Miranda,1979-04-04,59224729M,antonio.miranda@supernet.net,427273,ES27209560243563162155,1664.64,2022-11-06T20:36:14,Labastida,expenses,phone,-60.77,-13039.64
buyer_8,Antonio,Miranda,1979-04-04,59224729M,antonio.miranda@supernet.net,427273,ES27209560243563162155,1664.64,2022-11-06T09:56:29,Labastida,expenses,transport,-41.4,-13081.04
buyer_8,Antonio,Miranda,1979-04-04,59224729M,antonio.miranda@supernet.net,427273,ES27209560243563162155,1664.64,2022-11-07T10:41:59,Labastida,expenses,leisure,-28.08,-13109.12
buyer_8,Antonio,Miranda,1979-04-04,59224729M,antonio.miranda@supernet.net,427273,ES27209560243563162155,1664.64,2022-11-09T13:06:43,Labastida,expenses,cash,-100.0,-13209.12
buyer_8,Antonio,Miranda,1979-04-04,59224729M,antonio.miranda@supernet.net,427273,ES27209560243563162155,1664.64,2022-11-10T12:32:04,Labastida,expenses,cash,-100.0,-13309.12
buyer_8,Antonio,Miranda,1979-04-04,59224729M,antonio.miranda@supernet.net,427273,ES27209560243563162155,1664.64,2022-11-15T16:21:03,Labastida,expenses,transport,-47.13,-13356.25
buyer_8,Antonio,Miranda,1979-04-04,59224729M,antonio.miranda@supernet.net,427273,ES27209560243563162155,1664.64,2022-11-17T08:45:26,Labastida,expenses,cash,-100.0,-13456.25
buyer_8,Antonio,Miranda,1979-04-04,59224729M,antonio.miranda@supernet.net,427273,ES27209560243563162155,1664.64,2022-11-18T11:11:40,Labastida,expenses,gifts,-824.78,-14281.03
buyer_8,Antonio,Miranda,1979-04-04,59224729M,antonio.miranda@supernet.net,427273,ES27209560243563162155,1664.64,2022-11-19T14:27:48,Labastida,expenses,education,-61.91,-14342.94
buyer_8,Antonio,Miranda,1979-04-04,59224729M,antonio.miranda@supernet.net,427273,ES27209560243563162155,1664.64,2022-11-21T13:32:27,Labastida,expenses,education,-56.14,-14399.08
buyer_8,Antonio,Miranda,1979-04-04,59224729M,antonio.miranda@supernet.net,427273,ES27209560243563162155,1664.64,2022-11-22T16:01:05,Labastida,expenses,healthcare,-114.51,-14513.59
buyer_8,Antonio,Miranda,1979-04-04,59224729M,antonio.miranda@supernet.net,427273,ES27209560243563162155,1664.64,2022-11-22T14:04:26,Labastida,expenses,cash,-100.0,-14613.59
buyer_8,Antonio,Miranda,1979-04-04,59224729M,antonio.miranda@supernet.net,427273,ES27209560243563162155,1664.64,2022-11-25T09:54:15,Labastida,expenses,leisure,-47.75,-14661.34
buyer_8,Antonio,Miranda,1979-04-04,59224729M,antonio.miranda@supernet.net,427273,ES27209560243563162155,1664.64,2022-11-25T17:15:31,Labastida,expenses,appliances,-137.93,-14799.27
buyer_8,Antonio,Miranda,1979-04-04,59224729M,antonio.miranda@supernet.net,427273,ES27209560243563162155,1664.64,2022-11-27T11:13:35,Labastida,expenses,education,-55.31,-14854.58
buyer_8,Antonio,Miranda,1979-04-04,59224729M,antonio.miranda@supernet.net,427273,ES27209560243563162155,1664.64,2022-11-29T05:07:24,Labastida,expenses,gifts,-316.37,-15170.95
buyer_8,Antonio,Miranda,1979-04-04,59224729M,antonio.miranda@supernet.net,427273,ES27209560243563162155,1664.64,2022-11-30T17:10:59,Labastida,expenses,healthcare,-133.52,-15304.47
buyer_8,Antonio,Miranda,1979-04-04,59224729M,antonio.miranda@supernet.net,427273,ES27209560243563162155,1664.64,2022-11-30T09:43:41,Labastida,expenses,cash,-100.0,-15404.47
buyer_8,Antonio,Miranda,1979-04-04,59224729M,antonio.miranda@supernet.net,427273,ES27209560243563162155,1664.64,2022-12-01T05:56:54,Labastida,incomes,salary,3588.11,-11816.36
buyer_8,Antonio,Miranda,1979-04-04,59224729M,antonio.miranda@supernet.net,427273,ES27209560243563162155,1664.64,2022-12-01T05:56:54,Labastida,incomes,salary_bonus,2640.49,-9175.87
buyer_8,Antonio,Miranda,1979-04-04,59224729M,antonio.miranda@supernet.net,427273,ES27209560243563162155,1664.64,2022-12-01T14:10:24,Labastida,expenses,cash,-100.0,-9275.87
buyer_8,Antonio,Miranda,1979-04-04,59224729M,antonio.miranda@supernet.net,427273,ES27209560243563162155,1664.64,2022-12-04T19:02:48,Labastida,expenses,mortgage,-1323.93,-10599.8
buyer_8,Antonio,Miranda,1979-04-04,59224729M,antonio.miranda@supernet.net,427273,ES27209560243563162155,1664.64,2022-12-04T14:23:22,Labastida,expenses,food,-85.81,-10685.61
buyer_8,Antonio,Miranda,1979-04-04,59224729M,antonio.miranda@supernet.net,427273,ES27209560243563162155,1664.64,2022-12-04T13:05:20,Labastida,expenses,leisure,-52.11,-10737.72
buyer_8,Antonio,Miranda,1979-04-04,59224729M,antonio.miranda@supernet.net,427273,ES27209560243563162155,1664.64,2022-12-05T10:38:45,Labastida,expenses,water,-43.4,-10781.12
buyer_8,Antonio,Miranda,1979-04-04,59224729M,antonio.miranda@supernet.net,427273,ES27209560243563162155,1664.64,2022-12-05T17:38:50,Labastida,expenses,electricity,-75.78,-10856.9
buyer_8,Antonio,Miranda,1979-04-04,59224729M,antonio.miranda@supernet.net,427273,ES27209560243563162155,1664.64,2022-12-05T08:40:49,Labastida,expenses,phone,-74.02,-10930.92
buyer_8,Antonio,Miranda,1979-04-04,59224729M,antonio.miranda@supernet.net,427273,ES27209560243563162155,1664.64,2022-12-06T20:45:28,Labastida,expenses,gas,-176.36,-11107.28
buyer_8,Antonio,Miranda,1979-04-04,59224729M,antonio.miranda@supernet.net,427273,ES27209560243563162155,1664.64,2022-12-06T09:36:22,Labastida,expenses,internet,-75.35,-11182.63
buyer_8,Antonio,Miranda,1979-04-04,59224729M,antonio.miranda@supernet.net,427273,ES27209560243563162155,1664.64,2022-12-06T12:40:25,Labastida,expenses,food,-73.7,-11256.33
buyer_8,Antonio,Miranda,1979-04-04,59224729M,antonio.miranda@supernet.net,427273,ES27209560243563162155,1664.64,2022-12-08T09:50:27,Labastida,expenses,clothing,-140.29,-11396.62
buyer_8,Antonio,Miranda,1979-04-04,59224729M,antonio.miranda@supernet.net,427273,ES27209560243563162155,1664.64,2022-12-09T11:16:31,Labastida,expenses,food,-110.72,-11507.34
buyer_8,Antonio,Miranda,1979-04-04,59224729M,antonio.miranda@supernet.net,427273,ES27209560243563162155,1664.64,2022-12-09T15:03:26,Labastida,expenses,leisure,-46.73,-11554.07
buyer_8,Antonio,Miranda,1979-04-04,59224729M,antonio.miranda@supernet.net,427273,ES27209560243563162155,1664.64,2022-12-11T18:26:32,Labastida,expenses,food,-100.41,-11654.48
buyer_8,Antonio,Miranda,1979-04-04,59224729M,antonio.miranda@supernet.net,427273,ES27209560243563162155,1664.64,2022-12-12T14:13:43,Labastida,expenses,clothing,-56.97,-11711.45
buyer_8,Antonio,Miranda,1979-04-04,59224729M,antonio.miranda@supernet.net,427273,ES27209560243563162155,1664.64,2022-12-13T08:50:18,Labastida,expenses,food,-88.71,-11800.16
buyer_8,Antonio,Miranda,1979-04-04,59224729M,antonio.miranda@supernet.net,427273,ES27209560243563162155,1664.64,2022-12-14T11:25:22,Labastida,expenses,education,-58.33,-11858.49
buyer_8,Antonio,Miranda,1979-04-04,59224729M,antonio.miranda@supernet.net,427273,ES27209560243563162155,1664.64,2022-12-14T11:41:52,Labastida,expenses,cash,-100.0,-11958.49
buyer_8,Antonio,Miranda,1979-04-04,59224729M,antonio.miranda@supernet.net,427273,ES27209560243563162155,1664.64,2022-12-15T10:55:28,Labastida,expenses,leisure,-73.16,-12031.65
buyer_8,Antonio,Miranda,1979-04-04,59224729M,antonio.miranda@supernet.net,427273,ES27209560243563162155,1664.64,2022-12-16T11:30:30,Labastida,expenses,cash,-100.0,-12131.65
buyer_8,Antonio,Miranda,1979-04-04,59224729M,antonio.miranda@supernet.net,427273,ES27209560243563162155,1664.64,2022-12-17T08:54:37,Labastida,expenses,food,-64.27,-12195.92
buyer_8,Antonio,Miranda,1979-04-04,59224729M,antonio.miranda@supernet.net,427273,ES27209560243563162155,1664.64,2022-12-19T17:00:52,Labastida,expenses,food,-64.05,-12259.97
buyer_8,Antonio,Miranda,1979-04-04,59224729M,antonio.miranda@supernet.net,427273,ES27209560243563162155,1664.64,2022-12-19T20:14:55,Labastida,expenses,clothing,-53.88,-12313.85
buyer_8,Antonio,Miranda,1979-04-04,59224729M,antonio.miranda@supernet.net,427273,ES27209560243563162155,1664.64,2022-12-20T18:25:25,Labastida,expenses,food,-115.96,-12429.81
buyer_8,Antonio,Miranda,1979-04-04,59224729M,antonio.miranda@supernet.net,427273,ES27209560243563162155,1664.64,2022-12-21T13:07:01,Labastida,expenses,repairs,-242.13,-12671.94
buyer_8,Antonio,Miranda,1979-04-04,59224729M,antonio.miranda@supernet.net,427273,ES27209560243563162155,1664.64,2022-12-22T09:29:17,Labastida,expenses,transport,-74.09,-12746.03
buyer_8,Antonio,Miranda,1979-04-04,59224729M,antonio.miranda@supernet.net,427273,ES27209560243563162155,1664.64,2022-12-23T23:28:25,Labastida,expenses,leisure,-31.4,-12777.43
buyer_8,Antonio,Miranda,1979-04-04,59224729M,antonio.miranda@supernet.net,427273,ES27209560243563162155,1664.64,2022-12-24T09:51:21,Labastida,expenses,transport,-66.82,-12844.25
buyer_8,Antonio,Miranda,1979-04-04,59224729M,antonio.miranda@supernet.net,427273,ES27209560243563162155,1664.64,2022-12-24T07:11:27,Labastida,expenses,repairs,-147.82,-12992.07
buyer_8,Antonio,Miranda,1979-04-04,59224729M,antonio.miranda@supernet.net,427273,ES27209560243563162155,1664.64,2022-12-29T20:49:24,Labastida,expenses,cash,-100.0,-13092.07
buyer_8,Antonio,Miranda,1979-04-04,59224729M,antonio.miranda@supernet.net,427273,ES27209560243563162155,1664.64,2022-12-31T19:14:08,Labastida,expenses,food,-116.06,-13208.13
buyer_8,Antonio,Miranda,1979-04-04,59224729M,antonio.miranda@supernet.net,427273,ES27209560243563162155,1664.64,2022-12-31T08:33:41,Labastida,expenses,gifts,-556.83,-13764.96
buyer_8,Antonio,Miranda,1979-04-04,59224729M,antonio.miranda@supernet.net,427273,ES27209560243563162155,1664.64,2023-01-01T14:56:59,Labastida,incomes,salary,3703.89,-10061.07
buyer_8,Antonio,Miranda,1979-04-04,59224729M,antonio.miranda@supernet.net,427273,ES27209560243563162155,1664.64,2023-01-03T21:19:07,Labastida,expenses,healthcare,-78.81,-10139.88
buyer_8,Antonio,Miranda,1979-04-04,59224729M,antonio.miranda@supernet.net,427273,ES27209560243563162155,1664.64,2023-01-04T20:40:35,Labastida,expenses,mortgage,-1976.33,-12116.21
buyer_8,Antonio,Miranda,1979-04-04,59224729M,antonio.miranda@supernet.net,427273,ES27209560243563162155,1664.64,2023-01-04T20:18:39,Labastida,expenses,leisure,-66.56,-12182.77
buyer_8,Antonio,Miranda,1979-04-04,59224729M,antonio.miranda@supernet.net,427273,ES27209560243563162155,1664.64,2023-01-05T18:47:07,Labastida,expenses,water,-56.83,-12239.6
buyer_8,Antonio,Miranda,1979-04-04,59224729M,antonio.miranda@supernet.net,427273,ES27209560243563162155,1664.64,2023-01-05T08:39:56,Labastida,expenses,gas,-183.89,-12423.49
buyer_8,Antonio,Miranda,1979-04-04,59224729M,antonio.miranda@supernet.net,427273,ES27209560243563162155,1664.64,2023-01-05T09:34:13,Labastida,expenses,internet,-77.78,-12501.27
buyer_8,Antonio,Miranda,1979-04-04,59224729M,antonio.miranda@supernet.net,427273,ES27209560243563162155,1664.64,2023-01-05T15:45:47,Labastida,expenses,repairs,-146.84,-12648.11
buyer_8,Antonio,Miranda,1979-04-04,59224729M,antonio.miranda@supernet.net,427273,ES27209560243563162155,1664.64,2023-01-06T16:06:32,Labastida,expenses,electricity,-140.53,-12788.64
buyer_8,Antonio,Miranda,1979-04-04,59224729M,antonio.miranda@supernet.net,427273,ES27209560243563162155,1664.64,2023-01-07T18:21:45,Labastida,expenses,phone,-70.48,-12859.12
buyer_8,Antonio,Miranda,1979-04-04,59224729M,antonio.miranda@supernet.net,427273,ES27209560243563162155,1664.64,2023-01-07T00:18:08,Labastida,expenses,transport,-78.18,-12937.3
buyer_8,Antonio,Miranda,1979-04-04,59224729M,antonio.miranda@supernet.net,427273,ES27209560243563162155,1664.64,2023-01-07T19:11:35,Labastida,expenses,cash,-100.0,-13037.3
buyer_8,Antonio,Miranda,1979-04-04,59224729M,antonio.miranda@supernet.net,427273,ES27209560243563162155,1664.64,2023-01-08T18:06:45,Labastida,expenses,repairs,-309.54,-13346.84
buyer_8,Antonio,Miranda,1979-04-04,59224729M,antonio.miranda@supernet.net,427273,ES27209560243563162155,1664.64,2023-01-10T12:53:16,Labastida,expenses,cash,-100.0,-13446.84
buyer_8,Antonio,Miranda,1979-04-04,59224729M,antonio.miranda@supernet.net,427273,ES27209560243563162155,1664.64,2023-01-17T18:01:25,Labastida,expenses,transport,-56.86,-13503.7
buyer_8,Antonio,Miranda,1979-04-04,59224729M,antonio.miranda@supernet.net,427273,ES27209560243563162155,1664.64,2023-01-19T21:56:04,Labastida,expenses,repairs,-113.59,-13617.29
buyer_8,Antonio,Miranda,1979-04-04,59224729M,antonio.miranda@supernet.net,427273,ES27209560243563162155,1664.64,2023-01-21T18:49:26,Labastida,expenses,food,-83.27,-13700.56
buyer_8,Antonio,Miranda,1979-04-04,59224729M,antonio.miranda@supernet.net,427273,ES27209560243563162155,1664.64,2023-01-25T17:38:12,Labastida,expenses,cash,-100.0,-13800.56
buyer_8,Antonio,Miranda,1979-04-04,59224729M,antonio.miranda@supernet.net,427273,ES27209560243563162155,1664.64,2023-01-30T15:01:40,Labastida,expenses,gifts,-589.73,-14390.29
buyer_8,Antonio,Miranda,1979-04-04,59224729M,antonio.miranda@supernet.net,427273,ES27209560243563162155,1664.64,2023-02-01T17:33:04,Labastida,incomes,salary,3703.89,-10686.4
buyer_8,Antonio,Miranda,1979-04-04,59224729M,antonio.miranda@supernet.net,427273,ES27209560243563162155,1664.64,2023-02-01T17:33:04,Labastida,incomes,extra_income,484.35,-10202.05
buyer_8,Antonio,Miranda,1979-04-04,59224729M,antonio.miranda@supernet.net,427273,ES27209560243563162155,1664.64,2023-02-02T20:23:38,Labastida,expenses,food,-65.68,-10267.73
buyer_8,Antonio,Miranda,1979-04-04,59224729M,antonio.miranda@supernet.net,427273,ES27209560243563162155,1664.64,2023-02-03T05:37:36,Labastida,expenses,food,-71.95,-10339.68
buyer_8,Antonio,Miranda,1979-04-04,59224729M,antonio.miranda@supernet.net,427273,ES27209560243563162155,1664.64,2023-02-03T16:09:24,Labastida,expenses,transport,-78.12,-10417.8
buyer_8,Antonio,Miranda,1979-04-04,59224729M,antonio.miranda@supernet.net,427273,ES27209560243563162155,1664.64,2023-02-04T17:13:54,Labastida,expenses,mortgage,-1976.33,-12394.13
buyer_8,Antonio,Miranda,1979-04-04,59224729M,antonio.miranda@supernet.net,427273,ES27209560243563162155,1664.64,2023-02-04T08:43:49,Labastida,expenses,food,-64.03,-12458.16
buyer_8,Antonio,Miranda,1979-04-04,59224729M,antonio.miranda@supernet.net,427273,ES27209560243563162155,1664.64,2023-02-04T11:33:14,Labastida,expenses,transport,-69.86,-12528.02
buyer_8,Antonio,Miranda,1979-04-04,59224729M,antonio.miranda@supernet.net,427273,ES27209560243563162155,1664.64,2023-02-05T18:10:57,Labastida,expenses,water,-49.41,-12577.43
buyer_8,Antonio,Miranda,1979-04-04,59224729M,antonio.miranda@supernet.net,427273,ES27209560243563162155,1664.64,2023-02-05T20:52:18,Labastida,expenses,internet,-77.78,-12655.21
buyer_8,Antonio,Miranda,1979-04-04,59224729M,antonio.miranda@supernet.net,427273,ES27209560243563162155,1664.64,2023-02-05T11:40:00,Labastida,expenses,transport,-72.95,-12728.16
buyer_8,Antonio,Miranda,1979-04-04,59224729M,antonio.miranda@supernet.net,427273,ES27209560243563162155,1664.64,2023-02-06T19:48:20,Labastida,expenses,gas,-200.02,-12928.18
buyer_8,Antonio,Miranda,1979-04-04,59224729M,antonio.miranda@supernet.net,427273,ES27209560243563162155,1664.64,2023-02-07T18:26:19,Labastida,expenses,clothing,-98.63,-13026.81
buyer_8,Antonio,Miranda,1979-04-04,59224729M,antonio.miranda@supernet.net,427273,ES27209560243563162155,1664.64,2023-02-08T16:51:36,Labastida,expenses,electricity,-112.82,-13139.63
buyer_8,Antonio,Miranda,1979-04-04,59224729M,antonio.miranda@supernet.net,427273,ES27209560243563162155,1664.64,2023-02-08T11:55:31,Labastida,expenses,phone,-82.59,-13222.22
buyer_8,Antonio,Miranda,1979-04-04,59224729M,antonio.miranda@supernet.net,427273,ES27209560243563162155,1664.64,2023-02-08T16:34:03,Labastida,expenses,food,-87.87,-13310.09
buyer_8,Antonio,Miranda,1979-04-04,59224729M,antonio.miranda@supernet.net,427273,ES27209560243563162155,1664.64,2023-02-09T08:43:11,Labastida,expenses,food,-62.6,-13372.69
buyer_8,Antonio,Miranda,1979-04-04,59224729M,antonio.miranda@supernet.net,427273,ES27209560243563162155,1664.64,2023-02-09T12:53:21,Labastida,expenses,leisure,-64.82,-13437.51
buyer_8,Antonio,Miranda,1979-04-04,59224729M,antonio.miranda@supernet.net,427273,ES27209560243563162155,1664.64,2023-02-11T16:15:22,Labastida,expenses,food,-82.04,-13519.55
buyer_8,Antonio,Miranda,1979-04-04,59224729M,antonio.miranda@supernet.net,427273,ES27209560243563162155,1664.64,2023-02-12T08:05:57,Labastida,expenses,food,-124.25,-13643.8
buyer_8,Antonio,Miranda,1979-04-04,59224729M,antonio.miranda@supernet.net,427273,ES27209560243563162155,1664.64,2023-02-12T15:46:25,Labastida,expenses,leisure,-42.08,-13685.88
buyer_8,Antonio,Miranda,1979-04-04,59224729M,antonio.miranda@supernet.net,427273,ES27209560243563162155,1664.64,2023-02-13T20:42:25,Labastida,expenses,food,-64.2,-13750.08
buyer_8,Antonio,Miranda,1979-04-04,59224729M,antonio.miranda@supernet.net,427273,ES27209560243563162155,1664.64,2023-02-15T16:52:54,Labastida,expenses,transport,-66.7,-13816.78
buyer_8,Antonio,Miranda,1979-04-04,59224729M,antonio.miranda@supernet.net,427273,ES27209560243563162155,1664.64,2023-02-16T12:33:38,Labastida,expenses,food,-117.78,-13934.56
buyer_8,Antonio,Miranda,1979-04-04,59224729M,antonio.miranda@supernet.net,427273,ES27209560243563162155,1664.64,2023-02-16T23:12:03,Labastida,expenses,education,-64.47,-13999.03
buyer_8,Antonio,Miranda,1979-04-04,59224729M,antonio.miranda@supernet.net,427273,ES27209560243563162155,1664.64,2023-02-16T11:01:17,Labastida,expenses,cash,-100.0,-14099.03
buyer_8,Antonio,Miranda,1979-04-04,59224729M,antonio.miranda@supernet.net,427273,ES27209560243563162155,1664.64,2023-02-16T15:25:22,Labastida,expenses,appliances,-126.38,-14225.41
buyer_8,Antonio,Miranda,1979-04-04,59224729M,antonio.miranda@supernet.net,427273,ES27209560243563162155,1664.64,2023-02-18T17:19:10,Labastida,expenses,food,-98.53,-14323.94
buyer_8,Antonio,Miranda,1979-04-04,59224729M,antonio.miranda@supernet.net,427273,ES27209560243563162155,1664.64,2023-02-19T19:51:04,Labastida,expenses,leisure,-50.16,-14374.1
buyer_8,Antonio,Miranda,1979-04-04,59224729M,antonio.miranda@supernet.net,427273,ES27209560243563162155,1664.64,2023-02-20T23:59:46,Labastida,expenses,cash,-100.0,-14474.1
buyer_8,Antonio,Miranda,1979-04-04,59224729M,antonio.miranda@supernet.net,427273,ES27209560243563162155,1664.64,2023-02-21T22:54:07,Labastida,expenses,healthcare,-60.49,-14534.59
buyer_8,Antonio,Miranda,1979-04-04,59224729M,antonio.miranda@supernet.net,427273,ES27209560243563162155,1664.64,2023-02-21T13:44:31,Labastida,expenses,cash,-100.0,-14634.59
buyer_8,Antonio,Miranda,1979-04-04,59224729M,antonio.miranda@supernet.net,427273,ES27209560243563162155,1664.64,2023-02-22T13:35:08,Labastida,expenses,leisure,-36.72,-14671.31
buyer_8,Antonio,Miranda,1979-04-04,59224729M,antonio.miranda@supernet.net,427273,ES27209560243563162155,1664.64,2023-02-25T16:20:35,Labastida,expenses,food,-91.85,-14763.16
buyer_8,Antonio,Miranda,1979-04-04,59224729M,antonio.miranda@supernet.net,427273,ES27209560243563162155,1664.64,2023-03-01T20:17:23,Labastida,incomes,salary,3703.89,-11059.27
buyer_8,Antonio,Miranda,1979-04-04,59224729M,antonio.miranda@supernet.net,427273,ES27209560243563162155,1664.64,2023-03-01T17:51:25,Labastida,expenses,repairs,-321.86,-11381.13
buyer_8,Antonio,Miranda,1979-04-04,59224729M,antonio.miranda@supernet.net,427273,ES27209560243563162155,1664.64,2023-03-02T14:04:12,Labastida,expenses,cash,-100.0,-11481.13
buyer_8,Antonio,Miranda,1979-04-04,59224729M,antonio.miranda@supernet.net,427273,ES27209560243563162155,1664.64,2023-03-04T18:34:18,Labastida,expenses,mortgage,-1976.33,-13457.46
buyer_8,Antonio,Miranda,1979-04-04,59224729M,antonio.miranda@supernet.net,427273,ES27209560243563162155,1664.64,2023-03-04T15:43:19,Labastida,expenses,leisure,-75.1,-13532.56
buyer_8,Antonio,Miranda,1979-04-04,59224729M,antonio.miranda@supernet.net,427273,ES27209560243563162155,1664.64,2023-03-05T06:53:39,Labastida,expenses,leisure,-62.05,-13594.61
buyer_8,Antonio,Miranda,1979-04-04,59224729M,antonio.miranda@supernet.net,427273,ES27209560243563162155,1664.64,2023-03-07T20:54:47,Labastida,expenses,water,-72.26,-13666.87
buyer_8,Antonio,Miranda,1979-04-04,59224729M,antonio.miranda@supernet.net,427273,ES27209560243563162155,1664.64,2023-03-07T04:14:07,Labastida,expenses,phone,-57.5,-13724.37
buyer_8,Antonio,Miranda,1979-04-04,59224729M,antonio.miranda@supernet.net,427273,ES27209560243563162155,1664.64,2023-03-08T18:38:17,Labastida,expenses,internet,-77.78,-13802.15
buyer_8,Antonio,Miranda,1979-04-04,59224729M,antonio.miranda@supernet.net,427273,ES27209560243563162155,1664.64,2023-03-08T09:54:04,Labastida,expenses,electricity,-129.73,-13931.88
buyer_8,Antonio,Miranda,1979-04-04,59224729M,antonio.miranda@supernet.net,427273,ES27209560243563162155,1664.64,2023-03-08T14:45:42,Labastida,expenses,gas,-132.55,-14064.43
buyer_8,Antonio,Miranda,1979-04-04,59224729M,antonio.miranda@supernet.net,427273,ES27209560243563162155,1664.64,2023-03-08T19:31:59,Labastida,expenses,food,-98.34,-14162.77
buyer_8,Antonio,Miranda,1979-04-04,59224729M,antonio.miranda@supernet.net,427273,ES27209560243563162155,1664.64,2023-03-12T19:18:12,Labastida,expenses,food,-64.91,-14227.68
buyer_8,Antonio,Miranda,1979-04-04,59224729M,antonio.miranda@supernet.net,427273,ES27209560243563162155,1664.64,2023-03-13T20:30:48,Labastida,expenses,transport,-79.79,-14307.47
buyer_8,Antonio,Miranda,1979-04-04,59224729M,antonio.miranda@supernet.net,427273,ES27209560243563162155,1664.64,2023-03-13T22:08:15,Labastida,expenses,gifts,-283.93,-14591.4
buyer_8,Antonio,Miranda,1979-04-04,59224729M,antonio.miranda@supernet.net,427273,ES27209560243563162155,1664.64,2023-03-14T15:53:04,Labastida,expenses,education,-75.82,-14667.22
buyer_8,Antonio,Miranda,1979-04-04,59224729M,antonio.miranda@supernet.net,427273,ES27209560243563162155,1664.64,2023-03-14T13:42:55,Labastida,expenses,repairs,-142.36,-14809.58
buyer_8,Antonio,Miranda,1979-04-04,59224729M,antonio.miranda@supernet.net,427273,ES27209560243563162155,1664.64,2023-03-16T11:41:52,Labastida,expenses,food,-82.74,-14892.32
buyer_8,Antonio,Miranda,1979-04-04,59224729M,antonio.miranda@supernet.net,427273,ES27209560243563162155,1664.64,2023-03-17T23:31:05,Labastida,expenses,food,-107.62,-14999.94
buyer_8,Antonio,Miranda,1979-04-04,59224729M,antonio.miranda@supernet.net,427273,ES27209560243563162155,1664.64,2023-03-18T15:00:39,Labastida,expenses,leisure,-22.43,-15022.37
buyer_8,Antonio,Miranda,1979-04-04,59224729M,antonio.miranda@supernet.net,427273,ES27209560243563162155,1664.64,2023-03-20T14:19:11,Labastida,expenses,food,-95.24,-15117.61
buyer_8,Antonio,Miranda,1979-04-04,59224729M,antonio.miranda@supernet.net,427273,ES27209560243563162155,1664.64,2023-03-21T09:06:29,Labastida,expenses,cash,-100.0,-15217.61
buyer_8,Antonio,Miranda,1979-04-04,59224729M,antonio.miranda@supernet.net,427273,ES27209560243563162155,1664.64,2023-03-23T19:57:23,Labastida,expenses,cash,-100.0,-15317.61
buyer_8,Antonio,Miranda,1979-04-04,59224729M,antonio.miranda@supernet.net,427273,ES27209560243563162155,1664.64,2023-03-25T16:46:09,Labastida,expenses,food,-76.58,-15394.19
buyer_8,Antonio,Miranda,1979-04-04,59224729M,antonio.miranda@supernet.net,427273,ES27209560243563162155,1664.64,2023-03-26T13:14:19,Labastida,expenses,education,-59.6,-15453.79
buyer_8,Antonio,Miranda,1979-04-04,59224729M,antonio.miranda@supernet.net,427273,ES27209560243563162155,1664.64,2023-03-29T15:21:20,Labastida,expenses,food,-123.47,-15577.26
buyer_8,Antonio,Miranda,1979-04-04,59224729M,antonio.miranda@supernet.net,427273,ES27209560243563162155,1664.64,2023-03-31T20:39:30,Labastida,expenses,food,-88.43,-15665.69
buyer_8,Antonio,Miranda,1979-04-04,59224729M,antonio.miranda@supernet.net,427273,ES27209560243563162155,1664.64,2023-03-31T10:50:38,Labastida,expenses,repairs,-66.83,-15732.52
buyer_8,Antonio,Miranda,1979-04-04,59224729M,antonio.miranda@supernet.net,427273,ES27209560243563162155,1664.64,2023-04-01T19:33:28,Labastida,incomes,salary,3703.89,-12028.63
buyer_8,Antonio,Miranda,1979-04-04,59224729M,antonio.miranda@supernet.net,427273,ES27209560243563162155,1664.64,2023-04-01T18:43:21,Labastida,expenses,leisure,-84.36,-12112.99
buyer_8,Antonio,Miranda,1979-04-04,59224729M,antonio.miranda@supernet.net,427273,ES27209560243563162155,1664.64,2023-04-03T11:25:44,Labastida,expenses,transport,-63.25,-12176.24
buyer_8,Antonio,Miranda,1979-04-04,59224729M,antonio.miranda@supernet.net,427273,ES27209560243563162155,1664.64,2023-04-03T01:24:13,Labastida,expenses,cash,-100.0,-12276.24
buyer_8,Antonio,Miranda,1979-04-04,59224729M,antonio.miranda@supernet.net,427273,ES27209560243563162155,1664.64,2023-04-04T20:09:44,Labastida,expenses,mortgage,-1976.33,-14252.57
buyer_8,Antonio,Miranda,1979-04-04,59224729M,antonio.miranda@supernet.net,427273,ES27209560243563162155,1664.64,2023-04-04T14:17:32,Labastida,expenses,transport,-45.24,-14297.81
buyer_8,Antonio,Miranda,1979-04-04,59224729M,antonio.miranda@supernet.net,427273,ES27209560243563162155,1664.64,2023-04-05T14:38:35,Labastida,expenses,internet,-77.78,-14375.59
buyer_8,Antonio,Miranda,1979-04-04,59224729M,antonio.miranda@supernet.net,427273,ES27209560243563162155,1664.64,2023-04-06T20:39:12,Labastida,expenses,gas,-183.97,-14559.56
buyer_8,Antonio,Miranda,1979-04-04,59224729M,antonio.miranda@supernet.net,427273,ES27209560243563162155,1664.64,2023-04-06T12:10:08,Labastida,expenses,phone,-62.68,-14622.24
buyer_8,Antonio,Miranda,1979-04-04,59224729M,antonio.miranda@supernet.net,427273,ES27209560243563162155,1664.64,2023-04-06T06:56:44,Labastida,expenses,healthcare,-154.21,-14776.45
buyer_8,Antonio,Miranda,1979-04-04,59224729M,antonio.miranda@supernet.net,427273,ES27209560243563162155,1664.64,2023-04-06T13:40:00,Labastida,expenses,cash,-100.0,-14876.45
buyer_8,Antonio,Miranda,1979-04-04,59224729M,antonio.miranda@supernet.net,427273,ES27209560243563162155,1664.64,2023-04-08T21:48:22,Labastida,expenses,water,-44.29,-14920.74
buyer_8,Antonio,Miranda,1979-04-04,59224729M,antonio.miranda@supernet.net,427273,ES27209560243563162155,1664.64,2023-04-08T08:56:29,Labastida,expenses,electricity,-50.35,-14971.09
buyer_8,Antonio,Miranda,1979-04-04,59224729M,antonio.miranda@supernet.net,427273,ES27209560243563162155,1664.64,2023-04-09T12:14:39,Labastida,expenses,food,-99.35,-15070.44
buyer_8,Antonio,Miranda,1979-04-04,59224729M,antonio.miranda@supernet.net,427273,ES27209560243563162155,1664.64,2023-04-10T06:54:25,Labastida,expenses,leisure,-75.81,-15146.25
buyer_8,Antonio,Miranda,1979-04-04,59224729M,antonio.miranda@supernet.net,427273,ES27209560243563162155,1664.64,2023-04-10T14:40:03,Labastida,expenses,appliances,-243.47,-15389.72
buyer_8,Antonio,Miranda,1979-04-04,59224729M,antonio.miranda@supernet.net,427273,ES27209560243563162155,1664.64,2023-04-11T20:20:13,Labastida,expenses,cash,-100.0,-15489.72
buyer_8,Antonio,Miranda,1979-04-04,59224729M,antonio.miranda@supernet.net,427273,ES27209560243563162155,1664.64,2023-04-13T13:30:35,Labastida,expenses,healthcare,-50.81,-15540.53
buyer_8,Antonio,Miranda,1979-04-04,59224729M,antonio.miranda@supernet.net,427273,ES27209560243563162155,1664.64,2023-04-13T11:55:37,Labastida,expenses,education,-48.49,-15589.02
buyer_8,Antonio,Miranda,1979-04-04,59224729M,antonio.miranda@supernet.net,427273,ES27209560243563162155,1664.64,2023-04-13T14:10:11,Labastida,expenses,repairs,-76.7,-15665.72
buyer_8,Antonio,Miranda,1979-04-04,59224729M,antonio.miranda@supernet.net,427273,ES27209560243563162155,1664.64,2023-04-14T19:22:25,Labastida,expenses,transport,-40.23,-15705.95
buyer_8,Antonio,Miranda,1979-04-04,59224729M,antonio.miranda@supernet.net,427273,ES27209560243563162155,1664.64,2023-04-14T13:47:47,Labastida,expenses,gifts,-809.6,-16515.55
buyer_8,Antonio,Miranda,1979-04-04,59224729M,antonio.miranda@supernet.net,427273,ES27209560243563162155,1664.64,2023-04-16T23:29:23,Labastida,expenses,food,-108.59,-16624.14
buyer_8,Antonio,Miranda,1979-04-04,59224729M,antonio.miranda@supernet.net,427273,ES27209560243563162155,1664.64,2023-04-17T20:25:02,Labastida,expenses,healthcare,-151.19,-16775.33
buyer_8,Antonio,Miranda,1979-04-04,59224729M,antonio.miranda@supernet.net,427273,ES27209560243563162155,1664.64,2023-04-19T16:01:49,Labastida,expenses,food,-69.09,-16844.42
buyer_8,Antonio,Miranda,1979-04-04,59224729M,antonio.miranda@supernet.net,427273,ES27209560243563162155,1664.64,2023-04-19T15:04:54,Labastida,expenses,repairs,-318.19,-17162.61
buyer_8,Antonio,Miranda,1979-04-04,59224729M,antonio.miranda@supernet.net,427273,ES27209560243563162155,1664.64,2023-04-19T15:55:21,Labastida,expenses,gifts,-756.47,-17919.08
buyer_8,Antonio,Miranda,1979-04-04,59224729M,antonio.miranda@supernet.net,427273,ES27209560243563162155,1664.64,2023-04-20T21:28:53,Labastida,expenses,cash,-100.0,-18019.08
buyer_8,Antonio,Miranda,1979-04-04,59224729M,antonio.miranda@supernet.net,427273,ES27209560243563162155,1664.64,2023-04-21T13:56:40,Labastida,expenses,healthcare,-179.09,-18198.17
buyer_8,Antonio,Miranda,1979-04-04,59224729M,antonio.miranda@supernet.net,427273,ES27209560243563162155,1664.64,2023-04-22T19:56:18,Labastida,expenses,transport,-44.01,-18242.18
buyer_8,Antonio,Miranda,1979-04-04,59224729M,antonio.miranda@supernet.net,427273,ES27209560243563162155,1664.64,2023-04-23T16:36:34,Labastida,expenses,cash,-100.0,-18342.18
buyer_8,Antonio,Miranda,1979-04-04,59224729M,antonio.miranda@supernet.net,427273,ES27209560243563162155,1664.64,2023-04-24T08:32:34,Labastida,expenses,leisure,-63.2,-18405.38
buyer_8,Antonio,Miranda,1979-04-04,59224729M,antonio.miranda@supernet.net,427273,ES27209560243563162155,1664.64,2023-04-27T08:26:12,Labastida,expenses,cash,-100.0,-18505.38
buyer_8,Antonio,Miranda,1979-04-04,59224729M,antonio.miranda@supernet.net,427273,ES27209560243563162155,1664.64,2023-04-29T07:51:39,Labastida,expenses,transport,-57.99,-18563.37
buyer_8,Antonio,Miranda,1979-04-04,59224729M,antonio.miranda@supernet.net,427273,ES27209560243563162155,1664.64,2023-04-29T12:57:00,Labastida,expenses,appliances,-298.63,-18862.0
buyer_8,Antonio,Miranda,1979-04-04,59224729M,antonio.miranda@supernet.net,427273,ES27209560243563162155,1664.64,2023-05-01T19:17:47,Labastida,incomes,salary,3703.89,-15158.11
buyer_8,Antonio,Miranda,1979-04-04,59224729M,antonio.miranda@supernet.net,427273,ES27209560243563162155,1664.64,2023-05-01T19:17:47,Labastida,incomes,extra_income,484.35,-14673.76
buyer_8,Antonio,Miranda,1979-04-04,59224729M,antonio.miranda@supernet.net,427273,ES27209560243563162155,1664.64,2023-05-01T10:58:30,Labastida,expenses,food,-122.09,-14795.85
buyer_8,Antonio,Miranda,1979-04-04,59224729M,antonio.miranda@supernet.net,427273,ES27209560243563162155,1664.64,2023-05-01T13:35:45,Labastida,expenses,repairs,-77.92,-14873.77
buyer_8,Antonio,Miranda,1979-04-04,59224729M,antonio.miranda@supernet.net,427273,ES27209560243563162155,1664.64,2023-05-02T12:09:16,Labastida,expenses,leisure,-75.04,-14948.81
buyer_8,Antonio,Miranda,1979-04-04,59224729M,antonio.miranda@supernet.net,427273,ES27209560243563162155,1664.64,2023-05-04T15:40:12,Labastida,expenses,mortgage,-1976.33,-16925.14
buyer_8,Antonio,Miranda,1979-04-04,59224729M,antonio.miranda@supernet.net,427273,ES27209560243563162155,1664.64,2023-05-04T01:36:39,Labastida,expenses,leisure,-70.06,-16995.2
buyer_8,Antonio,Miranda,1979-04-04,59224729M,antonio.miranda@supernet.net,427273,ES27209560243563162155,1664.64,2023-05-05T12:22:59,Labastida,expenses,water,-79.61,-17074.81
buyer_8,Antonio,Miranda,1979-04-04,59224729M,antonio.miranda@supernet.net,427273,ES27209560243563162155,1664.64,2023-05-05T20:42:40,Labastida,expenses,electricity,-40.18,-17114.99
buyer_8,Antonio,Miranda,1979-04-04,59224729M,antonio.miranda@supernet.net,427273,ES27209560243563162155,1664.64,2023-05-05T17:52:44,Labastida,expenses,gifts,-768.22,-17883.21
buyer_8,Antonio,Miranda,1979-04-04,59224729M,antonio.miranda@supernet.net,427273,ES27209560243563162155,1664.64,2023-05-06T17:25:56,Labastida,expenses,gas,-106.74,-17989.95
buyer_8,Antonio,Miranda,1979-04-04,59224729M,antonio.miranda@supernet.net,427273,ES27209560243563162155,1664.64,2023-05-06T10:29:38,Labastida,expenses,internet,-77.78,-18067.73
buyer_8,Antonio,Miranda,1979-04-04,59224729M,antonio.miranda@supernet.net,427273,ES27209560243563162155,1664.64,2023-05-06T10:10:45,Labastida,expenses,phone,-64.16,-18131.89
buyer_8,Antonio,Miranda,1979-04-04,59224729M,antonio.miranda@supernet.net,427273,ES27209560243563162155,1664.64,2023-05-06T22:55:54,Labastida,expenses,cash,-100.0,-18231.89
buyer_8,Antonio,Miranda,1979-04-04,59224729M,antonio.miranda@supernet.net,427273,ES27209560243563162155,1664.64,2023-05-07T17:00:49,Labastida,expenses,leisure,-82.96,-18314.85
buyer_8,Antonio,Miranda,1979-04-04,59224729M,antonio.miranda@supernet.net,427273,ES27209560243563162155,1664.64,2023-05-07T14:16:32,Labastida,expenses,cash,-100.0,-18414.85
buyer_8,Antonio,Miranda,1979-04-04,59224729M,antonio.miranda@supernet.net,427273,ES27209560243563162155,1664.64,2023-05-08T20:13:17,Labastida,expenses,food,-90.54,-18505.39
buyer_8,Antonio,Miranda,1979-04-04,59224729M,antonio.miranda@supernet.net,427273,ES27209560243563162155,1664.64,2023-05-08T11:06:30,Labastida,expenses,transport,-65.32,-18570.71
buyer_8,Antonio,Miranda,1979-04-04,59224729M,antonio.miranda@supernet.net,427273,ES27209560243563162155,1664.64,2023-05-10T07:18:05,Labastida,expenses,leisure,-43.58,-18614.29
buyer_8,Antonio,Miranda,1979-04-04,59224729M,antonio.miranda@supernet.net,427273,ES27209560243563162155,1664.64,2023-05-10T10:31:06,Labastida,expenses,cash,-100.0,-18714.29
buyer_8,Antonio,Miranda,1979-04-04,59224729M,antonio.miranda@supernet.net,427273,ES27209560243563162155,1664.64,2023-05-11T10:45:33,Labastida,expenses,food,-110.0,-18824.29
buyer_8,Antonio,Miranda,1979-04-04,59224729M,antonio.miranda@supernet.net,427273,ES27209560243563162155,1664.64,2023-05-11T11:26:30,Labastida,expenses,leisure,-36.98,-18861.27
buyer_8,Antonio,Miranda,1979-04-04,59224729M,antonio.miranda@supernet.net,427273,ES27209560243563162155,1664.64,2023-05-16T10:54:53,Labastida,expenses,repairs,-32.82,-18894.09
buyer_8,Antonio,Miranda,1979-04-04,59224729M,antonio.miranda@supernet.net,427273,ES27209560243563162155,1664.64,2023-05-18T10:10:39,Labastida,expenses,food,-106.59,-19000.68
buyer_8,Antonio,Miranda,1979-04-04,59224729M,antonio.miranda@supernet.net,427273,ES27209560243563162155,1664.64,2023-05-21T17:24:19,Labastida,expenses,cash,-100.0,-19100.68
buyer_8,Antonio,Miranda,1979-04-04,59224729M,antonio.miranda@supernet.net,427273,ES27209560243563162155,1664.64,2023-05-22T13:12:43,Labastida,expenses,repairs,-214.2,-19314.88
buyer_8,Antonio,Miranda,1979-04-04,59224729M,antonio.miranda@supernet.net,427273,ES27209560243563162155,1664.64,2023-05-23T09:10:12,Labastida,expenses,healthcare,-106.56,-19421.44
buyer_8,Antonio,Miranda,1979-04-04,59224729M,antonio.miranda@supernet.net,427273,ES27209560243563162155,1664.64,2023-05-24T10:23:59,Labastida,expenses,cash,-100.0,-19521.44
buyer_8,Antonio,Miranda,1979-04-04,59224729M,antonio.miranda@supernet.net,427273,ES27209560243563162155,1664.64,2023-05-25T11:13:14,Labastida,expenses,food,-79.35,-19600.79
buyer_8,Antonio,Miranda,1979-04-04,59224729M,antonio.miranda@supernet.net,427273,ES27209560243563162155,1664.64,2023-05-25T12:05:03,Labastida,expenses,leisure,-39.85,-19640.64
buyer_8,Antonio,Miranda,1979-04-04,59224729M,antonio.miranda@supernet.net,427273,ES27209560243563162155,1664.64,2023-05-25T03:01:08,Labastida,expenses,cash,-100.0,-19740.64
buyer_8,Antonio,Miranda,1979-04-04,59224729M,antonio.miranda@supernet.net,427273,ES27209560243563162155,1664.64,2023-05-26T13:04:41,Labastida,expenses,food,-107.41,-19848.05
buyer_8,Antonio,Miranda,1979-04-04,59224729M,antonio.miranda@supernet.net,427273,ES27209560243563162155,1664.64,2023-05-26T19:57:01,Labastida,expenses,clothing,-88.93,-19936.98
buyer_8,Antonio,Miranda,1979-04-04,59224729M,antonio.miranda@supernet.net,427273,ES27209560243563162155,1664.64,2023-05-26T09:34:31,Labastida,expenses,appliances,-404.86,-20341.84
buyer_8,Antonio,Miranda,1979-04-04,59224729M,antonio.miranda@supernet.net,427273,ES27209560243563162155,1664.64,2023-05-27T12:02:30,Labastida,expenses,food,-95.44,-20437.28
buyer_8,Antonio,Miranda,1979-04-04,59224729M,antonio.miranda@supernet.net,427273,ES27209560243563162155,1664.64,2023-05-28T08:21:10,Labastida,expenses,clothing,-74.88,-20512.16
buyer_8,Antonio,Miranda,1979-04-04,59224729M,antonio.miranda@supernet.net,427273,ES27209560243563162155,1664.64,2023-05-28T21:17:04,Labastida,expenses,repairs,-47.55,-20559.71
buyer_8,Antonio,Miranda,1979-04-04,59224729M,antonio.miranda@supernet.net,427273,ES27209560243563162155,1664.64,2023-05-29T18:35:02,Labastida,expenses,leisure,-66.82,-20626.53
buyer_8,Antonio,Miranda,1979-04-04,59224729M,antonio.miranda@supernet.net,427273,ES27209560243563162155,1664.64,2023-05-31T08:41:51,Labastida,expenses,food,-119.65,-20746.18
buyer_8,Antonio,Miranda,1979-04-04,59224729M,antonio.miranda@supernet.net,427273,ES27209560243563162155,1664.64,2023-05-31T13:33:00,Labastida,expenses,clothing,-111.25,-20857.43
buyer_8,Antonio,Miranda,1979-04-04,59224729M,antonio.miranda@supernet.net,427273,ES27209560243563162155,1664.64,2023-05-31T16:19:26,Labastida,expenses,cash,-100.0,-20957.43
buyer_8,Antonio,Miranda,1979-04-04,59224729M,antonio.miranda@supernet.net,427273,ES27209560243563162155,1664.64,2023-06-01T18:08:10,Labastida,incomes,salary,3703.89,-17253.54
buyer_8,Antonio,Miranda,1979-04-04,59224729M,antonio.miranda@supernet.net,427273,ES27209560243563162155,1664.64,2023-06-01T18:08:10,Labastida,incomes,salary_bonus,2818.57,-14434.97
buyer_8,Antonio,Miranda,1979-04-04,59224729M,antonio.miranda@supernet.net,427273,ES27209560243563162155,1664.64,2023-06-01T18:47:40,Labastida,expenses,transport,-53.36,-14488.33
buyer_8,Antonio,Miranda,1979-04-04,59224729M,antonio.miranda@supernet.net,427273,ES27209560243563162155,1664.64,2023-06-01T11:56:17,Labastida,expenses,cash,-100.0,-14588.33
buyer_8,Antonio,Miranda,1979-04-04,59224729M,antonio.miranda@supernet.net,427273,ES27209560243563162155,1664.64,2023-06-02T09:16:11,Labastida,expenses,repairs,-218.6,-14806.93
buyer_8,Antonio,Miranda,1979-04-04,59224729M,antonio.miranda@supernet.net,427273,ES27209560243563162155,1664.64,2023-06-03T08:01:12,Labastida,expenses,cash,-100.0,-14906.93
buyer_8,Antonio,Miranda,1979-04-04,59224729M,antonio.miranda@supernet.net,427273,ES27209560243563162155,1664.64,2023-06-04T23:49:21,Labastida,expenses,mortgage,-1976.33,-16883.26
buyer_8,Antonio,Miranda,1979-04-04,59224729M,antonio.miranda@supernet.net,427273,ES27209560243563162155,1664.64,2023-06-04T17:56:44,Labastida,expenses,transport,-61.19,-16944.45
buyer_8,Antonio,Miranda,1979-04-04,59224729M,antonio.miranda@supernet.net,427273,ES27209560243563162155,1664.64,2023-06-04T18:22:24,Labastida,expenses,leisure,-42.99,-16987.44
buyer_8,Antonio,Miranda,1979-04-04,59224729M,antonio.miranda@supernet.net,427273,ES27209560243563162155,1664.64,2023-06-04T09:50:07,Labastida,expenses,gifts,-843.04,-17830.48
buyer_8,Antonio,Miranda,1979-04-04,59224729M,antonio.miranda@supernet.net,427273,ES27209560243563162155,1664.64,2023-06-05T09:16:39,Labastida,expenses,water,-79.25,-17909.73
buyer_8,Antonio,Miranda,1979-04-04,59224729M,antonio.miranda@supernet.net,427273,ES27209560243563162155,1664.64,2023-06-05T12:12:48,Labastida,expenses,electricity,-80.72,-17990.45
buyer_8,Antonio,Miranda,1979-04-04,59224729M,antonio.miranda@supernet.net,427273,ES27209560243563162155,1664.64,2023-06-05T10:05:21,Labastida,expenses,internet,-77.78,-18068.23
buyer_8,Antonio,Miranda,1979-04-04,59224729M,antonio.miranda@supernet.net,427273,ES27209560243563162155,1664.64,2023-06-05T21:24:04,Labastida,expenses,phone,-76.49,-18144.72
buyer_8,Antonio,Miranda,1979-04-04,59224729M,antonio.miranda@supernet.net,427273,ES27209560243563162155,1664.64,2023-06-05T12:47:09,Labastida,expenses,healthcare,-51.04,-18195.76
buyer_8,Antonio,Miranda,1979-04-04,59224729M,antonio.miranda@supernet.net,427273,ES27209560243563162155,1664.64,2023-06-06T14:55:59,Labastida,expenses,gas,-72.77,-18268.53
buyer_8,Antonio,Miranda,1979-04-04,59224729M,antonio.miranda@supernet.net,427273,ES27209560243563162155,1664.64,2023-06-11T20:29:36,Labastida,expenses,cash,-100.0,-18368.53
buyer_8,Antonio,Miranda,1979-04-04,59224729M,antonio.miranda@supernet.net,427273,ES27209560243563162155,1664.64,2023-06-12T11:28:42,Labastida,expenses,gifts,-396.98,-18765.51
buyer_8,Antonio,Miranda,1979-04-04,59224729M,antonio.miranda@supernet.net,427273,ES27209560243563162155,1664.64,2023-06-13T11:17:41,Labastida,expenses,cash,-100.0,-18865.51
buyer_8,Antonio,Miranda,1979-04-04,59224729M,antonio.miranda@supernet.net,427273,ES27209560243563162155,1664.64,2023-06-15T14:02:00,Labastida,expenses,cash,-100.0,-18965.51
buyer_8,Antonio,Miranda,1979-04-04,59224729M,antonio.miranda@supernet.net,427273,ES27209560243563162155,1664.64,2023-06-16T19:33:06,Labastida,expenses,gifts,-641.61,-19607.12
buyer_8,Antonio,Miranda,1979-04-04,59224729M,antonio.miranda@supernet.net,427273,ES27209560243563162155,1664.64,2023-06-20T06:43:21,Labastida,expenses,cash,-100.0,-19707.12
buyer_8,Antonio,Miranda,1979-04-04,59224729M,antonio.miranda@supernet.net,427273,ES27209560243563162155,1664.64,2023-06-21T17:49:00,Labastida,expenses,leisure,-58.76,-19765.88
buyer_8,Antonio,Miranda,1979-04-04,59224729M,antonio.miranda@supernet.net,427273,ES27209560243563162155,1664.64,2023-06-21T12:41:36,Labastida,expenses,cash,-100.0,-19865.88
buyer_8,Antonio,Miranda,1979-04-04,59224729M,antonio.miranda@supernet.net,427273,ES27209560243563162155,1664.64,2023-06-23T14:06:03,Labastida,expenses,healthcare,-98.09,-19963.97
buyer_8,Antonio,Miranda,1979-04-04,59224729M,antonio.miranda@supernet.net,427273,ES27209560243563162155,1664.64,2023-06-24T08:02:03,Labastida,expenses,food,-104.56,-20068.53
buyer_8,Antonio,Miranda,1979-04-04,59224729M,antonio.miranda@supernet.net,427273,ES27209560243563162155,1664.64,2023-06-26T17:03:44,Labastida,expenses,cash,-100.0,-20168.53
buyer_8,Antonio,Miranda,1979-04-04,59224729M,antonio.miranda@supernet.net,427273,ES27209560243563162155,1664.64,2023-06-28T10:55:09,Labastida,expenses,leisure,-49.23,-20217.76
buyer_8,Antonio,Miranda,1979-04-04,59224729M,antonio.miranda@supernet.net,427273,ES27209560243563162155,1664.64,2023-06-28T16:55:33,Labastida,expenses,clothing,-95.67,-20313.43
buyer_8,Antonio,Miranda,1979-04-04,59224729M,antonio.miranda@supernet.net,427273,ES27209560243563162155,1664.64,2023-06-29T10:10:05,Labastida,expenses,leisure,-69.41,-20382.84
buyer_8,Antonio,Miranda,1979-04-04,59224729M,antonio.miranda@supernet.net,427273,ES27209560243563162155,1664.64,2023-07-01T15:58:26,Labastida,incomes,salary,3703.89,-16678.95
buyer_8,Antonio,Miranda,1979-04-04,59224729M,antonio.miranda@supernet.net,427273,ES27209560243563162155,1664.64,2023-07-01T23:17:38,Labastida,expenses,food,-123.1,-16802.05
buyer_8,Antonio,Miranda,1979-04-04,59224729M,antonio.miranda@supernet.net,427273,ES27209560243563162155,1664.64,2023-07-01T17:13:53,Labastida,expenses,leisure,-22.28,-16824.33
buyer_8,Antonio,Miranda,1979-04-04,59224729M,antonio.miranda@supernet.net,427273,ES27209560243563162155,1664.64,2023-07-01T07:48:21,Labastida,expenses,repairs,-47.26,-16871.59
buyer_8,Antonio,Miranda,1979-04-04,59224729M,antonio.miranda@supernet.net,427273,ES27209560243563162155,1664.64,2023-07-02T00:14:00,Labastida,expenses,cash,-100.0,-16971.59
buyer_8,Antonio,Miranda,1979-04-04,59224729M,antonio.miranda@supernet.net,427273,ES27209560243563162155,1664.64,2023-07-03T12:58:32,Labastida,expenses,transport,-49.84,-17021.43
buyer_8,Antonio,Miranda,1979-04-04,59224729M,antonio.miranda@supernet.net,427273,ES27209560243563162155,1664.64,2023-07-03T12:55:16,Labastida,expenses,cash,-100.0,-17121.43
buyer_8,Antonio,Miranda,1979-04-04,59224729M,antonio.miranda@supernet.net,427273,ES27209560243563162155,1664.64,2023-07-04T19:43:42,Labastida,expenses,mortgage,-1976.33,-19097.76
buyer_8,Antonio,Miranda,1979-04-04,59224729M,antonio.miranda@supernet.net,427273,ES27209560243563162155,1664.64,2023-07-07T22:23:58,Labastida,expenses,water,-69.32,-19167.08
buyer_8,Antonio,Miranda,1979-04-04,59224729M,antonio.miranda@supernet.net,427273,ES27209560243563162155,1664.64,2023-07-07T11:55:57,Labastida,expenses,electricity,-70.19,-19237.27
buyer_8,Antonio,Miranda,1979-04-04,59224729M,antonio.miranda@supernet.net,427273,ES27209560243563162155,1664.64,2023-07-07T06:33:52,Labastida,expenses,cash,-100.0,-19337.27
buyer_8,Antonio,Miranda,1979-04-04,59224729M,antonio.miranda@supernet.net,427273,ES27209560243563162155,1664.64,2023-07-08T19:44:09,Labastida,expenses,phone,-66.92,-19404.19
buyer_8,Antonio,Miranda,1979-04-04,59224729M,antonio.miranda@supernet.net,427273,ES27209560243563162155,1664.64,2023-07-08T08:33:42,Labastida,expenses,gas,-118.43,-19522.62
buyer_8,Antonio,Miranda,1979-04-04,59224729M,antonio.miranda@supernet.net,427273,ES27209560243563162155,1664.64,2023-07-08T02:14:26,Labastida,expenses,internet,-77.78,-19600.4
buyer_8,Antonio,Miranda,1979-04-04,59224729M,antonio.miranda@supernet.net,427273,ES27209560243563162155,1664.64,2023-07-08T16:15:59,Labastida,expenses,repairs,-288.31,-19888.71
buyer_8,Antonio,Miranda,1979-04-04,59224729M,antonio.miranda@supernet.net,427273,ES27209560243563162155,1664.64,2023-07-09T14:30:51,Labastida,expenses,cash,-100.0,-19988.71
buyer_8,Antonio,Miranda,1979-04-04,59224729M,antonio.miranda@supernet.net,427273,ES27209560243563162155,1664.64,2023-07-10T20:12:34,Labastida,expenses,food,-105.83,-20094.54
buyer_8,Antonio,Miranda,1979-04-04,59224729M,antonio.miranda@supernet.net,427273,ES27209560243563162155,1664.64,2023-07-12T02:54:14,Labastida,expenses,food,-95.93,-20190.47
buyer_8,Antonio,Miranda,1979-04-04,59224729M,antonio.miranda@supernet.net,427273,ES27209560243563162155,1664.64,2023-07-15T13:30:29,Labastida,expenses,cash,-100.0,-20290.47
buyer_8,Antonio,Miranda,1979-04-04,59224729M,antonio.miranda@supernet.net,427273,ES27209560243563162155,1664.64,2023-07-16T17:22:22,Labastida,expenses,food,-68.07,-20358.54
buyer_8,Antonio,Miranda,1979-04-04,59224729M,antonio.miranda@supernet.net,427273,ES27209560243563162155,1664.64,2023-07-19T06:41:08,Labastida,expenses,gifts,-205.61,-20564.15
buyer_8,Antonio,Miranda,1979-04-04,59224729M,antonio.miranda@supernet.net,427273,ES27209560243563162155,1664.64,2023-07-20T13:46:46,Labastida,expenses,transport,-42.58,-20606.73
buyer_8,Antonio,Miranda,1979-04-04,59224729M,antonio.miranda@supernet.net,427273,ES27209560243563162155,1664.64,2023-07-21T12:24:45,Labastida,expenses,transport,-53.29,-20660.02
buyer_8,Antonio,Miranda,1979-04-04,59224729M,antonio.miranda@supernet.net,427273,ES27209560243563162155,1664.64,2023-07-22T22:32:45,Labastida,expenses,food,-76.09,-20736.11
buyer_8,Antonio,Miranda,1979-04-04,59224729M,antonio.miranda@supernet.net,427273,ES27209560243563162155,1664.64,2023-07-23T17:46:39,Labastida,expenses,food,-121.45,-20857.56
buyer_8,Antonio,Miranda,1979-04-04,59224729M,antonio.miranda@supernet.net,427273,ES27209560243563162155,1664.64,2023-07-23T13:33:30,Labastida,expenses,cash,-100.0,-20957.56
buyer_8,Antonio,Miranda,1979-04-04,59224729M,antonio.miranda@supernet.net,427273,ES27209560243563162155,1664.64,2023-07-24T16:05:57,Labastida,expenses,clothing,-92.77,-21050.33
buyer_8,Antonio,Miranda,1979-04-04,59224729M,antonio.miranda@supernet.net,427273,ES27209560243563162155,1664.64,2023-07-26T08:23:05,Labastida,expenses,clothing,-147.08,-21197.41
buyer_8,Antonio,Miranda,1979-04-04,59224729M,antonio.miranda@supernet.net,427273,ES27209560243563162155,1664.64,2023-07-31T16:14:17,Labastida,expenses,cash,-100.0,-21297.41
buyer_8,Antonio,Miranda,1979-04-04,59224729M,antonio.miranda@supernet.net,427273,ES27209560243563162155,1664.64,2023-08-01T09:32:25,Labastida,incomes,salary,3703.89,-17593.52
buyer_8,Antonio,Miranda,1979-04-04,59224729M,antonio.miranda@supernet.net,427273,ES27209560243563162155,1664.64,2023-08-01T09:32:25,Labastida,incomes,extra_income,484.35,-17109.17
buyer_8,Antonio,Miranda,1979-04-04,59224729M,antonio.miranda@supernet.net,427273,ES27209560243563162155,1664.64,2023-08-01T16:40:04,Labastida,expenses,transport,-87.27,-17196.44
buyer_8,Antonio,Miranda,1979-04-04,59224729M,antonio.miranda@supernet.net,427273,ES27209560243563162155,1664.64,2023-08-02T13:30:55,Labastida,expenses,food,-88.04,-17284.48
buyer_8,Antonio,Miranda,1979-04-04,59224729M,antonio.miranda@supernet.net,427273,ES27209560243563162155,1664.64,2023-08-02T17:31:48,Labastida,expenses,transport,-63.98,-17348.46
buyer_8,Antonio,Miranda,1979-04-04,59224729M,antonio.miranda@supernet.net,427273,ES27209560243563162155,1664.64,2023-08-03T14:49:47,Labastida,expenses,food,-121.41,-17469.87
buyer_8,Antonio,Miranda,1979-04-04,59224729M,antonio.miranda@supernet.net,427273,ES27209560243563162155,1664.64,2023-08-04T16:37:31,Labastida,expenses,mortgage,-1976.33,-19446.2
buyer_8,Antonio,Miranda,1979-04-04,59224729M,antonio.miranda@supernet.net,427273,ES27209560243563162155,1664.64,2023-08-05T10:20:21,Labastida,expenses,water,-49.94,-19496.14
buyer_8,Antonio,Miranda,1979-04-04,59224729M,antonio.miranda@supernet.net,427273,ES27209560243563162155,1664.64,2023-08-06T10:11:26,Labastida,expenses,internet,-77.78,-19573.92
buyer_8,Antonio,Miranda,1979-04-04,59224729M,antonio.miranda@supernet.net,427273,ES27209560243563162155,1664.64,2023-08-06T01:12:07,Labastida,expenses,gifts,-378.43,-19952.35
buyer_8,Antonio,Miranda,1979-04-04,59224729M,antonio.miranda@supernet.net,427273,ES27209560243563162155,1664.64,2023-08-08T08:46:38,Labastida,expenses,electricity,-165.0,-20117.35
buyer_8,Antonio,Miranda,1979-04-04,59224729M,antonio.miranda@supernet.net,427273,ES27209560243563162155,1664.64,2023-08-08T09:11:16,Labastida,expenses,gas,-123.6,-20240.95
buyer_8,Antonio,Miranda,1979-04-04,59224729M,antonio.miranda@supernet.net,427273,ES27209560243563162155,1664.64,2023-08-08T15:41:20,Labastida,expenses,phone,-63.63,-20304.58
buyer_8,Antonio,Miranda,1979-04-04,59224729M,antonio.miranda@supernet.net,427273,ES27209560243563162155,1664.64,2023-08-08T19:11:49,Labastida,expenses,food,-66.57,-20371.15
buyer_8,Antonio,Miranda,1979-04-04,59224729M,antonio.miranda@supernet.net,427273,ES27209560243563162155,1664.64,2023-08-11T12:10:07,Labastida,expenses,leisure,-28.49,-20399.64
buyer_8,Antonio,Miranda,1979-04-04,59224729M,antonio.miranda@supernet.net,427273,ES27209560243563162155,1664.64,2023-08-12T11:23:42,Labastida,expenses,healthcare,-81.24,-20480.88
buyer_8,Antonio,Miranda,1979-04-04,59224729M,antonio.miranda@supernet.net,427273,ES27209560243563162155,1664.64,2023-08-14T16:44:45,Labastida,expenses,leisure,-35.99,-20516.87
buyer_8,Antonio,Miranda,1979-04-04,59224729M,antonio.miranda@supernet.net,427273,ES27209560243563162155,1664.64,2023-08-15T10:44:37,Labastida,expenses,transport,-68.46,-20585.33
buyer_8,Antonio,Miranda,1979-04-04,59224729M,antonio.miranda@supernet.net,427273,ES27209560243563162155,1664.64,2023-08-16T15:46:30,Labastida,expenses,transport,-85.34,-20670.67
buyer_8,Antonio,Miranda,1979-04-04,59224729M,antonio.miranda@supernet.net,427273,ES27209560243563162155,1664.64,2023-08-16T17:58:18,Labastida,expenses,leisure,-63.9,-20734.57
buyer_8,Antonio,Miranda,1979-04-04,59224729M,antonio.miranda@supernet.net,427273,ES27209560243563162155,1664.64,2023-08-18T19:16:15,Labastida,expenses,food,-115.77,-20850.34
buyer_8,Antonio,Miranda,1979-04-04,59224729M,antonio.miranda@supernet.net,427273,ES27209560243563162155,1664.64,2023-08-19T18:41:30,Labastida,expenses,food,-79.49,-20929.83
buyer_8,Antonio,Miranda,1979-04-04,59224729M,antonio.miranda@supernet.net,427273,ES27209560243563162155,1664.64,2023-08-19T09:57:43,Labastida,expenses,transport,-69.16,-20998.99
buyer_8,Antonio,Miranda,1979-04-04,59224729M,antonio.miranda@supernet.net,427273,ES27209560243563162155,1664.64,2023-08-19T03:31:26,Labastida,expenses,appliances,-371.22,-21370.21
buyer_8,Antonio,Miranda,1979-04-04,59224729M,antonio.miranda@supernet.net,427273,ES27209560243563162155,1664.64,2023-08-20T15:32:06,Labastida,expenses,food,-75.57,-21445.78
buyer_8,Antonio,Miranda,1979-04-04,59224729M,antonio.miranda@supernet.net,427273,ES27209560243563162155,1664.64,2023-08-22T14:17:13,Labastida,expenses,food,-88.94,-21534.72
buyer_8,Antonio,Miranda,1979-04-04,59224729M,antonio.miranda@supernet.net,427273,ES27209560243563162155,1664.64,2023-08-22T12:34:35,Labastida,expenses,cash,-100.0,-21634.72
buyer_8,Antonio,Miranda,1979-04-04,59224729M,antonio.miranda@supernet.net,427273,ES27209560243563162155,1664.64,2023-08-24T16:19:28,Labastida,expenses,repairs,-231.65,-21866.37
buyer_8,Antonio,Miranda,1979-04-04,59224729M,antonio.miranda@supernet.net,427273,ES27209560243563162155,1664.64,2023-08-25T11:53:41,Labastida,expenses,cash,-100.0,-21966.37
buyer_8,Antonio,Miranda,1979-04-04,59224729M,antonio.miranda@supernet.net,427273,ES27209560243563162155,1664.64,2023-08-26T19:20:21,Labastida,expenses,leisure,-29.09,-21995.46
buyer_8,Antonio,Miranda,1979-04-04,59224729M,antonio.miranda@supernet.net,427273,ES27209560243563162155,1664.64,2023-08-27T09:23:28,Labastida,expenses,cash,-100.0,-22095.46
buyer_8,Antonio,Miranda,1979-04-04,59224729M,antonio.miranda@supernet.net,427273,ES27209560243563162155,1664.64,2023-08-28T11:52:41,Labastida,expenses,gifts,-632.25,-22727.71
buyer_8,Antonio,Miranda,1979-04-04,59224729M,antonio.miranda@supernet.net,427273,ES27209560243563162155,1664.64,2023-08-30T11:47:44,Labastida,expenses,leisure,-33.85,-22761.56
buyer_8,Antonio,Miranda,1979-04-04,59224729M,antonio.miranda@supernet.net,427273,ES27209560243563162155,1664.64,2023-08-31T14:27:40,Labastida,expenses,food,-104.76,-22866.32
buyer_8,Antonio,Miranda,1979-04-04,59224729M,antonio.miranda@supernet.net,427273,ES27209560243563162155,1664.64,2023-08-31T17:00:03,Labastida,expenses,leisure,-48.74,-22915.06
buyer_8,Antonio,Miranda,1979-04-04,59224729M,antonio.miranda@supernet.net,427273,ES27209560243563162155,1664.64,2023-09-01T07:50:19,Labastida,incomes,salary,3703.89,-19211.17
buyer_8,Antonio,Miranda,1979-04-04,59224729M,antonio.miranda@supernet.net,427273,ES27209560243563162155,1664.64,2023-09-01T09:07:29,Labastida,expenses,leisure,-32.48,-19243.65
buyer_8,Antonio,Miranda,1979-04-04,59224729M,antonio.miranda@supernet.net,427273,ES27209560243563162155,1664.64,2023-09-02T14:15:12,Labastida,expenses,healthcare,-41.73,-19285.38
buyer_8,Antonio,Miranda,1979-04-04,59224729M,antonio.miranda@supernet.net,427273,ES27209560243563162155,1664.64,2023-09-03T13:33:15,Labastida,expenses,cash,-100.0,-19385.38
buyer_8,Antonio,Miranda,1979-04-04,59224729M,antonio.miranda@supernet.net,427273,ES27209560243563162155,1664.64,2023-09-04T09:10:06,Labastida,expenses,mortgage,-1976.33,-21361.71
buyer_8,Antonio,Miranda,1979-04-04,59224729M,antonio.miranda@supernet.net,427273,ES27209560243563162155,1664.64,2023-09-05T21:10:37,Labastida,expenses,water,-51.07,-21412.78
buyer_8,Antonio,Miranda,1979-04-04,59224729M,antonio.miranda@supernet.net,427273,ES27209560243563162155,1664.64,2023-09-05T09:38:23,Labastida,expenses,electricity,-53.98,-21466.76
buyer_8,Antonio,Miranda,1979-04-04,59224729M,antonio.miranda@supernet.net,427273,ES27209560243563162155,1664.64,2023-09-06T10:38:45,Labastida,expenses,cash,-100.0,-21566.76
buyer_8,Antonio,Miranda,1979-04-04,59224729M,antonio.miranda@supernet.net,427273,ES27209560243563162155,1664.64,2023-09-08T14:17:39,Labastida,expenses,internet,-77.78,-21644.54
buyer_8,Antonio,Miranda,1979-04-04,59224729M,antonio.miranda@supernet.net,427273,ES27209560243563162155,1664.64,2023-09-08T16:50:46,Labastida,expenses,gas,-95.49,-21740.03
buyer_8,Antonio,Miranda,1979-04-04,59224729M,antonio.miranda@supernet.net,427273,ES27209560243563162155,1664.64,2023-09-08T19:52:45,Labastida,expenses,phone,-81.4,-21821.43
buyer_8,Antonio,Miranda,1979-04-04,59224729M,antonio.miranda@supernet.net,427273,ES27209560243563162155,1664.64,2023-09-08T20:17:22,Labastida,expenses,transport,-54.42,-21875.85
buyer_8,Antonio,Miranda,1979-04-04,59224729M,antonio.miranda@supernet.net,427273,ES27209560243563162155,1664.64,2023-09-13T19:36:02,Labastida,expenses,leisure,-34.07,-21909.92
buyer_8,Antonio,Miranda,1979-04-04,59224729M,antonio.miranda@supernet.net,427273,ES27209560243563162155,1664.64,2023-09-14T22:29:18,Labastida,expenses,leisure,-84.18,-21994.1
buyer_8,Antonio,Miranda,1979-04-04,59224729M,antonio.miranda@supernet.net,427273,ES27209560243563162155,1664.64,2023-09-14T09:05:05,Labastida,expenses,clothing,-117.62,-22111.72
buyer_8,Antonio,Miranda,1979-04-04,59224729M,antonio.miranda@supernet.net,427273,ES27209560243563162155,1664.64,2023-09-14T12:15:17,Labastida,expenses,appliances,-350.7,-22462.42
buyer_8,Antonio,Miranda,1979-04-04,59224729M,antonio.miranda@supernet.net,427273,ES27209560243563162155,1664.64,2023-09-18T17:46:27,Labastida,expenses,transport,-84.05,-22546.47
buyer_8,Antonio,Miranda,1979-04-04,59224729M,antonio.miranda@supernet.net,427273,ES27209560243563162155,1664.64,2023-09-18T18:09:28,Labastida,expenses,healthcare,-104.98,-22651.45
buyer_8,Antonio,Miranda,1979-04-04,59224729M,antonio.miranda@supernet.net,427273,ES27209560243563162155,1664.64,2023-09-19T19:56:27,Labastida,expenses,food,-121.88,-22773.33
buyer_8,Antonio,Miranda,1979-04-04,59224729M,antonio.miranda@supernet.net,427273,ES27209560243563162155,1664.64,2023-09-19T12:43:42,Labastida,expenses,clothing,-141.65,-22914.98
buyer_8,Antonio,Miranda,1979-04-04,59224729M,antonio.miranda@supernet.net,427273,ES27209560243563162155,1664.64,2023-09-19T10:42:51,Labastida,expenses,cash,-100.0,-23014.98
buyer_8,Antonio,Miranda,1979-04-04,59224729M,antonio.miranda@supernet.net,427273,ES27209560243563162155,1664.64,2023-09-20T19:12:59,Labastida,expenses,appliances,-111.31,-23126.29
buyer_8,Antonio,Miranda,1979-04-04,59224729M,antonio.miranda@supernet.net,427273,ES27209560243563162155,1664.64,2023-09-23T15:31:53,Labastida,expenses,food,-111.8,-23238.09
buyer_8,Antonio,Miranda,1979-04-04,59224729M,antonio.miranda@supernet.net,427273,ES27209560243563162155,1664.64,2023-09-23T10:30:48,Labastida,expenses,clothing,-83.87,-23321.96
buyer_8,Antonio,Miranda,1979-04-04,59224729M,antonio.miranda@supernet.net,427273,ES27209560243563162155,1664.64,2023-09-24T02:59:01,Labastida,expenses,clothing,-101.72,-23423.68
buyer_8,Antonio,Miranda,1979-04-04,59224729M,antonio.miranda@supernet.net,427273,ES27209560243563162155,1664.64,2023-09-25T19:58:29,Labastida,expenses,leisure,-66.43,-23490.11
buyer_8,Antonio,Miranda,1979-04-04,59224729M,antonio.miranda@supernet.net,427273,ES27209560243563162155,1664.64,2023-09-25T12:34:41,Labastida,expenses,cash,-100.0,-23590.11
buyer_8,Antonio,Miranda,1979-04-04,59224729M,antonio.miranda@supernet.net,427273,ES27209560243563162155,1664.64,2023-09-26T11:45:29,Labastida,expenses,leisure,-75.38,-23665.49
buyer_8,Antonio,Miranda,1979-04-04,59224729M,antonio.miranda@supernet.net,427273,ES27209560243563162155,1664.64,2023-09-26T15:40:16,Labastida,expenses,clothing,-73.4,-23738.89
buyer_8,Antonio,Miranda,1979-04-04,59224729M,antonio.miranda@supernet.net,427273,ES27209560243563162155,1664.64,2023-09-27T17:45:36,Labastida,expenses,gifts,-92.0,-23830.89
buyer_8,Antonio,Miranda,1979-04-04,59224729M,antonio.miranda@supernet.net,427273,ES27209560243563162155,1664.64,2023-09-28T10:22:27,Labastida,expenses,transport,-70.16,-23901.05
buyer_8,Antonio,Miranda,1979-04-04,59224729M,antonio.miranda@supernet.net,427273,ES27209560243563162155,1664.64,2023-09-29T10:39:14,Labastida,expenses,cash,-100.0,-24001.05
buyer_8,Antonio,Miranda,1979-04-04,59224729M,antonio.miranda@supernet.net,427273,ES27209560243563162155,1664.64,2023-10-01T08:53:04,Labastida,incomes,salary,3703.89,-20297.16
buyer_8,Antonio,Miranda,1979-04-04,59224729M,antonio.miranda@supernet.net,427273,ES27209560243563162155,1664.64,2023-10-04T13:27:11,Labastida,expenses,mortgage,-1976.33,-22273.49
buyer_8,Antonio,Miranda,1979-04-04,59224729M,antonio.miranda@supernet.net,427273,ES27209560243563162155,1664.64,2023-10-05T12:53:29,Labastida,expenses,phone,-58.14,-22331.63
buyer_8,Antonio,Miranda,1979-04-04,59224729M,antonio.miranda@supernet.net,427273,ES27209560243563162155,1664.64,2023-10-05T20:31:23,Labastida,expenses,education,-70.56,-22402.19
buyer_8,Antonio,Miranda,1979-04-04,59224729M,antonio.miranda@supernet.net,427273,ES27209560243563162155,1664.64,2023-10-06T12:49:45,Labastida,expenses,internet,-77.78,-22479.97
buyer_8,Antonio,Miranda,1979-04-04,59224729M,antonio.miranda@supernet.net,427273,ES27209560243563162155,1664.64,2023-10-06T16:24:22,Labastida,expenses,clothing,-83.68,-22563.65
buyer_8,Antonio,Miranda,1979-04-04,59224729M,antonio.miranda@supernet.net,427273,ES27209560243563162155,1664.64,2023-10-06T10:15:01,Labastida,expenses,cash,-100.0,-22663.65
buyer_8,Antonio,Miranda,1979-04-04,59224729M,antonio.miranda@supernet.net,427273,ES27209560243563162155,1664.64,2023-10-08T07:39:59,Labastida,expenses,water,-74.19,-22737.84
buyer_8,Antonio,Miranda,1979-04-04,59224729M,antonio.miranda@supernet.net,427273,ES27209560243563162155,1664.64,2023-10-08T17:41:53,Labastida,expenses,electricity,-98.98,-22836.82
buyer_8,Antonio,Miranda,1979-04-04,59224729M,antonio.miranda@supernet.net,427273,ES27209560243563162155,1664.64,2023-10-08T23:30:27,Labastida,expenses,gas,-120.18,-22957.0
buyer_8,Antonio,Miranda,1979-04-04,59224729M,antonio.miranda@supernet.net,427273,ES27209560243563162155,1664.64,2023-10-08T20:20:05,Labastida,expenses,leisure,-62.92,-23019.92
buyer_8,Antonio,Miranda,1979-04-04,59224729M,antonio.miranda@supernet.net,427273,ES27209560243563162155,1664.64,2023-10-09T11:29:19,Labastida,expenses,cash,-100.0,-23119.92
buyer_8,Antonio,Miranda,1979-04-04,59224729M,antonio.miranda@supernet.net,427273,ES27209560243563162155,1664.64,2023-10-09T15:56:58,Labastida,expenses,gifts,-294.99,-23414.91
buyer_8,Antonio,Miranda,1979-04-04,59224729M,antonio.miranda@supernet.net,427273,ES27209560243563162155,1664.64,2023-10-10T19:33:13,Labastida,expenses,leisure,-63.82,-23478.73
buyer_8,Antonio,Miranda,1979-04-04,59224729M,antonio.miranda@supernet.net,427273,ES27209560243563162155,1664.64,2023-10-11T08:16:55,Labastida,expenses,cash,-100.0,-23578.73
buyer_8,Antonio,Miranda,1979-04-04,59224729M,antonio.miranda@supernet.net,427273,ES27209560243563162155,1664.64,2023-10-12T21:49:44,Labastida,expenses,food,-112.31,-23691.04
buyer_8,Antonio,Miranda,1979-04-04,59224729M,antonio.miranda@supernet.net,427273,ES27209560243563162155,1664.64,2023-10-13T20:36:54,Labastida,expenses,transport,-49.17,-23740.21
buyer_8,Antonio,Miranda,1979-04-04,59224729M,antonio.miranda@supernet.net,427273,ES27209560243563162155,1664.64,2023-10-13T18:22:15,Labastida,expenses,repairs,-195.55,-23935.76
buyer_8,Antonio,Miranda,1979-04-04,59224729M,antonio.miranda@supernet.net,427273,ES27209560243563162155,1664.64,2023-10-14T20:46:22,Labastida,expenses,clothing,-95.65,-24031.41
buyer_8,Antonio,Miranda,1979-04-04,59224729M,antonio.miranda@supernet.net,427273,ES27209560243563162155,1664.64,2023-10-14T08:34:30,Labastida,expenses,cash,-100.0,-24131.41
buyer_8,Antonio,Miranda,1979-04-04,59224729M,antonio.miranda@supernet.net,427273,ES27209560243563162155,1664.64,2023-10-15T12:29:16,Labastida,expenses,clothing,-158.76,-24290.17
buyer_8,Antonio,Miranda,1979-04-04,59224729M,antonio.miranda@supernet.net,427273,ES27209560243563162155,1664.64,2023-10-15T20:35:56,Labastida,expenses,appliances,-287.36,-24577.53
buyer_8,Antonio,Miranda,1979-04-04,59224729M,antonio.miranda@supernet.net,427273,ES27209560243563162155,1664.64,2023-10-17T08:33:04,Labastida,expenses,food,-117.53,-24695.06
buyer_8,Antonio,Miranda,1979-04-04,59224729M,antonio.miranda@supernet.net,427273,ES27209560243563162155,1664.64,2023-10-21T19:24:55,Labastida,expenses,transport,-66.57,-24761.63
buyer_8,Antonio,Miranda,1979-04-04,59224729M,antonio.miranda@supernet.net,427273,ES27209560243563162155,1664.64,2023-10-23T05:43:47,Labastida,expenses,food,-64.6,-24826.23
buyer_8,Antonio,Miranda,1979-04-04,59224729M,antonio.miranda@supernet.net,427273,ES27209560243563162155,1664.64,2023-10-23T11:06:37,Labastida,expenses,transport,-50.79,-24877.02
buyer_8,Antonio,Miranda,1979-04-04,59224729M,antonio.miranda@supernet.net,427273,ES27209560243563162155,1664.64,2023-10-23T17:10:21,Labastida,expenses,leisure,-64.5,-24941.52
buyer_8,Antonio,Miranda,1979-04-04,59224729M,antonio.miranda@supernet.net,427273,ES27209560243563162155,1664.64,2023-10-23T19:12:04,Labastida,expenses,repairs,-290.69,-25232.21
buyer_8,Antonio,Miranda,1979-04-04,59224729M,antonio.miranda@supernet.net,427273,ES27209560243563162155,1664.64,2023-10-24T09:55:43,Labastida,expenses,transport,-47.42,-25279.63
buyer_8,Antonio,Miranda,1979-04-04,59224729M,antonio.miranda@supernet.net,427273,ES27209560243563162155,1664.64,2023-10-25T09:35:40,Labastida,expenses,clothing,-55.31,-25334.94
buyer_8,Antonio,Miranda,1979-04-04,59224729M,antonio.miranda@supernet.net,427273,ES27209560243563162155,1664.64,2023-10-26T11:00:42,Labastida,expenses,clothing,-107.29,-25442.23
buyer_8,Antonio,Miranda,1979-04-04,59224729M,antonio.miranda@supernet.net,427273,ES27209560243563162155,1664.64,2023-10-27T10:10:11,Labastida,expenses,cash,-100.0,-25542.23
buyer_8,Antonio,Miranda,1979-04-04,59224729M,antonio.miranda@supernet.net,427273,ES27209560243563162155,1664.64,2023-10-28T22:32:58,Labastida,expenses,cash,-100.0,-25642.23
buyer_8,Antonio,Miranda,1979-04-04,59224729M,antonio.miranda@supernet.net,427273,ES27209560243563162155,1664.64,2023-10-31T08:09:04,Labastida,expenses,repairs,-230.08,-25872.31
buyer_8,Antonio,Miranda,1979-04-04,59224729M,antonio.miranda@supernet.net,427273,ES27209560243563162155,1664.64,2023-11-01T07:47:04,Labastida,incomes,salary,3703.89,-22168.42
buyer_8,Antonio,Miranda,1979-04-04,59224729M,antonio.miranda@supernet.net,427273,ES27209560243563162155,1664.64,2023-11-02T17:30:17,Labastida,expenses,clothing,-130.84,-22299.26
buyer_8,Antonio,Miranda,1979-04-04,59224729M,antonio.miranda@supernet.net,427273,ES27209560243563162155,1664.64,2023-11-02T16:12:03,Labastida,expenses,cash,-100.0,-22399.26
buyer_8,Antonio,Miranda,1979-04-04,59224729M,antonio.miranda@supernet.net,427273,ES27209560243563162155,1664.64,2023-11-03T21:23:30,Labastida,expenses,leisure,-75.56,-22474.82
buyer_8,Antonio,Miranda,1979-04-04,59224729M,antonio.miranda@supernet.net,427273,ES27209560243563162155,1664.64,2023-11-04T11:46:40,Labastida,expenses,mortgage,-1976.33,-24451.15
buyer_8,Antonio,Miranda,1979-04-04,59224729M,antonio.miranda@supernet.net,427273,ES27209560243563162155,1664.64,2023-11-05T08:46:35,Labastida,expenses,water,-66.43,-24517.58
buyer_8,Antonio,Miranda,1979-04-04,59224729M,antonio.miranda@supernet.net,427273,ES27209560243563162155,1664.64,2023-11-05T11:00:20,Labastida,expenses,electricity,-114.3,-24631.88
buyer_8,Antonio,Miranda,1979-04-04,59224729M,antonio.miranda@supernet.net,427273,ES27209560243563162155,1664.64,2023-11-05T17:19:02,Labastida,expenses,phone,-75.69,-24707.57
buyer_8,Antonio,Miranda,1979-04-04,59224729M,antonio.miranda@supernet.net,427273,ES27209560243563162155,1664.64,2023-11-06T03:34:28,Labastida,expenses,internet,-77.78,-24785.35
buyer_8,Antonio,Miranda,1979-04-04,59224729M,antonio.miranda@supernet.net,427273,ES27209560243563162155,1664.64,2023-11-06T18:37:03,Labastida,expenses,transport,-64.15,-24849.5
buyer_8,Antonio,Miranda,1979-04-04,59224729M,antonio.miranda@supernet.net,427273,ES27209560243563162155,1664.64,2023-11-06T19:35:13,Labastida,expenses,education,-64.87,-24914.37
buyer_8,Antonio,Miranda,1979-04-04,59224729M,antonio.miranda@supernet.net,427273,ES27209560243563162155,1664.64,2023-11-06T09:44:31,Labastida,expenses,repairs,-165.05,-25079.42
buyer_8,Antonio,Miranda,1979-04-04,59224729M,antonio.miranda@supernet.net,427273,ES27209560243563162155,1664.64,2023-11-06T12:21:28,Labastida,expenses,gifts,-235.81,-25315.23
buyer_8,Antonio,Miranda,1979-04-04,59224729M,antonio.miranda@supernet.net,427273,ES27209560243563162155,1664.64,2023-11-07T16:46:25,Labastida,expenses,healthcare,-160.96,-25476.19
buyer_8,Antonio,Miranda,1979-04-04,59224729M,antonio.miranda@supernet.net,427273,ES27209560243563162155,1664.64,2023-11-07T14:30:18,Labastida,expenses,cash,-100.0,-25576.19
buyer_8,Antonio,Miranda,1979-04-04,59224729M,antonio.miranda@supernet.net,427273,ES27209560243563162155,1664.64,2023-11-08T17:51:49,Labastida,expenses,gas,-68.65,-25644.84
buyer_8,Antonio,Miranda,1979-04-04,59224729M,antonio.miranda@supernet.net,427273,ES27209560243563162155,1664.64,2023-11-08T18:43:34,Labastida,expenses,clothing,-108.57,-25753.41
buyer_8,Antonio,Miranda,1979-04-04,59224729M,antonio.miranda@supernet.net,427273,ES27209560243563162155,1664.64,2023-11-10T05:39:29,Labastida,expenses,leisure,-65.68,-25819.09
buyer_8,Antonio,Miranda,1979-04-04,59224729M,antonio.miranda@supernet.net,427273,ES27209560243563162155,1664.64,2023-11-12T08:10:43,Labastida,expenses,cash,-100.0,-25919.09
buyer_8,Antonio,Miranda,1979-04-04,59224729M,antonio.miranda@supernet.net,427273,ES27209560243563162155,1664.64,2023-11-14T16:43:42,Labastida,expenses,food,-99.38,-26018.47
buyer_8,Antonio,Miranda,1979-04-04,59224729M,antonio.miranda@supernet.net,427273,ES27209560243563162155,1664.64,2023-11-15T15:23:23,Labastida,expenses,leisure,-63.65,-26082.12
buyer_8,Antonio,Miranda,1979-04-04,59224729M,antonio.miranda@supernet.net,427273,ES27209560243563162155,1664.64,2023-11-15T17:29:45,Labastida,expenses,cash,-100.0,-26182.12
buyer_8,Antonio,Miranda,1979-04-04,59224729M,antonio.miranda@supernet.net,427273,ES27209560243563162155,1664.64,2023-11-16T14:58:33,Labastida,expenses,food,-95.69,-26277.81
buyer_8,Antonio,Miranda,1979-04-04,59224729M,antonio.miranda@supernet.net,427273,ES27209560243563162155,1664.64,2023-11-18T14:34:26,Labastida,expenses,cash,-100.0,-26377.81
buyer_8,Antonio,Miranda,1979-04-04,59224729M,antonio.miranda@supernet.net,427273,ES27209560243563162155,1664.64,2023-11-20T12:19:14,Labastida,expenses,food,-84.17,-26461.98
buyer_8,Antonio,Miranda,1979-04-04,59224729M,antonio.miranda@supernet.net,427273,ES27209560243563162155,1664.64,2023-11-20T08:20:02,Labastida,expenses,repairs,-76.15,-26538.13
buyer_8,Antonio,Miranda,1979-04-04,59224729M,antonio.miranda@supernet.net,427273,ES27209560243563162155,1664.64,2023-11-22T09:37:41,Labastida,expenses,food,-122.02,-26660.15
buyer_8,Antonio,Miranda,1979-04-04,59224729M,antonio.miranda@supernet.net,427273,ES27209560243563162155,1664.64,2023-11-23T21:26:59,Labastida,expenses,education,-52.58,-26712.73
buyer_8,Antonio,Miranda,1979-04-04,59224729M,antonio.miranda@supernet.net,427273,ES27209560243563162155,1664.64,2023-11-23T09:58:55,Labastida,expenses,repairs,-229.13,-26941.86
buyer_8,Antonio,Miranda,1979-04-04,59224729M,antonio.miranda@supernet.net,427273,ES27209560243563162155,1664.64,2023-11-24T08:28:50,Labastida,expenses,repairs,-318.05,-27259.91
buyer_8,Antonio,Miranda,1979-04-04,59224729M,antonio.miranda@supernet.net,427273,ES27209560243563162155,1664.64,2023-11-27T18:08:27,Labastida,expenses,leisure,-36.66,-27296.57
buyer_8,Antonio,Miranda,1979-04-04,59224729M,antonio.miranda@supernet.net,427273,ES27209560243563162155,1664.64,2023-11-27T20:26:49,Labastida,expenses,cash,-100.0,-27396.57
buyer_8,Antonio,Miranda,1979-04-04,59224729M,antonio.miranda@supernet.net,427273,ES27209560243563162155,1664.64,2023-11-27T17:53:01,Labastida,expenses,gifts,-45.66,-27442.23
buyer_8,Antonio,Miranda,1979-04-04,59224729M,antonio.miranda@supernet.net,427273,ES27209560243563162155,1664.64,2023-11-28T09:43:56,Labastida,expenses,clothing,-69.98,-27512.21
buyer_8,Antonio,Miranda,1979-04-04,59224729M,antonio.miranda@supernet.net,427273,ES27209560243563162155,1664.64,2023-12-01T17:20:03,Labastida,incomes,salary,3703.89,-23808.32
buyer_8,Antonio,Miranda,1979-04-04,59224729M,antonio.miranda@supernet.net,427273,ES27209560243563162155,1664.64,2023-12-01T17:20:03,Labastida,incomes,extra_income,484.35,-23323.97
buyer_8,Antonio,Miranda,1979-04-04,59224729M,antonio.miranda@supernet.net,427273,ES27209560243563162155,1664.64,2023-12-01T17:20:03,Labastida,incomes,salary_bonus,2886.68,-20437.29
buyer_8,Antonio,Miranda,1979-04-04,59224729M,antonio.miranda@supernet.net,427273,ES27209560243563162155,1664.64,2023-12-01T20:08:05,Labastida,expenses,transport,-66.34,-20503.63
buyer_8,Antonio,Miranda,1979-04-04,59224729M,antonio.miranda@supernet.net,427273,ES27209560243563162155,1664.64,2023-12-01T14:29:50,Labastida,expenses,leisure,-50.09,-20553.72
buyer_8,Antonio,Miranda,1979-04-04,59224729M,antonio.miranda@supernet.net,427273,ES27209560243563162155,1664.64,2023-12-01T17:45:05,Labastida,expenses,clothing,-144.51,-20698.23
buyer_8,Antonio,Miranda,1979-04-04,59224729M,antonio.miranda@supernet.net,427273,ES27209560243563162155,1664.64,2023-12-02T12:48:51,Labastida,expenses,travel,-1083.41,-21781.64
buyer_8,Antonio,Miranda,1979-04-04,59224729M,antonio.miranda@supernet.net,427273,ES27209560243563162155,1664.64,2023-12-02T08:24:26,Labastida,expenses,repairs,-94.93,-21876.57
buyer_8,Antonio,Miranda,1979-04-04,59224729M,antonio.miranda@supernet.net,427273,ES27209560243563162155,1664.64,2023-12-03T22:01:24,Labastida,expenses,transport,-89.44,-21966.01
buyer_8,Antonio,Miranda,1979-04-04,59224729M,antonio.miranda@supernet.net,427273,ES27209560243563162155,1664.64,2023-12-04T23:08:11,Labastida,expenses,mortgage,-1976.33,-23942.34
buyer_8,Antonio,Miranda,1979-04-04,59224729M,antonio.miranda@supernet.net,427273,ES27209560243563162155,1664.64,2023-12-04T13:55:23,Labastida,expenses,repairs,-74.68,-24017.02
buyer_8,Antonio,Miranda,1979-04-04,59224729M,antonio.miranda@supernet.net,427273,ES27209560243563162155,1664.64,2023-12-05T14:41:53,Labastida,expenses,gas,-114.24,-24131.26
buyer_8,Antonio,Miranda,1979-04-04,59224729M,antonio.miranda@supernet.net,427273,ES27209560243563162155,1664.64,2023-12-05T10:43:39,Labastida,expenses,food,-99.8,-24231.06
buyer_8,Antonio,Miranda,1979-04-04,59224729M,antonio.miranda@supernet.net,427273,ES27209560243563162155,1664.64,2023-12-05T08:17:47,Labastida,expenses,clothing,-65.57,-24296.63
buyer_8,Antonio,Miranda,1979-04-04,59224729M,antonio.miranda@supernet.net,427273,ES27209560243563162155,1664.64,2023-12-06T16:33:14,Labastida,expenses,water,-73.56,-24370.19
buyer_8,Antonio,Miranda,1979-04-04,59224729M,antonio.miranda@supernet.net,427273,ES27209560243563162155,1664.64,2023-12-06T12:03:05,Labastida,expenses,phone,-73.4,-24443.59
buyer_8,Antonio,Miranda,1979-04-04,59224729M,antonio.miranda@supernet.net,427273,ES27209560243563162155,1664.64,2023-12-08T23:05:27,Labastida,expenses,electricity,-62.8,-24506.39
buyer_8,Antonio,Miranda,1979-04-04,59224729M,antonio.miranda@supernet.net,427273,ES27209560243563162155,1664.64,2023-12-08T18:06:10,Labastida,expenses,internet,-77.78,-24584.17
buyer_8,Antonio,Miranda,1979-04-04,59224729M,antonio.miranda@supernet.net,427273,ES27209560243563162155,1664.64,2023-12-08T21:23:14,Labastida,expenses,transport,-75.54,-24659.71
buyer_8,Antonio,Miranda,1979-04-04,59224729M,antonio.miranda@supernet.net,427273,ES27209560243563162155,1664.64,2023-12-10T15:14:36,Labastida,expenses,gifts,-656.84,-25316.55
buyer_8,Antonio,Miranda,1979-04-04,59224729M,antonio.miranda@supernet.net,427273,ES27209560243563162155,1664.64,2023-12-11T18:59:51,Labastida,expenses,leisure,-53.89,-25370.44
buyer_8,Antonio,Miranda,1979-04-04,59224729M,antonio.miranda@supernet.net,427273,ES27209560243563162155,1664.64,2023-12-12T19:46:35,Labastida,expenses,transport,-82.67,-25453.11
buyer_8,Antonio,Miranda,1979-04-04,59224729M,antonio.miranda@supernet.net,427273,ES27209560243563162155,1664.64,2023-12-15T10:22:00,Labastida,expenses,cash,-100.0,-25553.11
buyer_8,Antonio,Miranda,1979-04-04,59224729M,antonio.miranda@supernet.net,427273,ES27209560243563162155,1664.64,2023-12-16T16:59:48,Labastida,expenses,gifts,-697.85,-26250.96
buyer_8,Antonio,Miranda,1979-04-04,59224729M,antonio.miranda@supernet.net,427273,ES27209560243563162155,1664.64,2023-12-17T08:28:48,Labastida,expenses,food,-121.11,-26372.07
buyer_8,Antonio,Miranda,1979-04-04,59224729M,antonio.miranda@supernet.net,427273,ES27209560243563162155,1664.64,2023-12-18T10:18:26,Labastida,expenses,cash,-100.0,-26472.07
buyer_8,Antonio,Miranda,1979-04-04,59224729M,antonio.miranda@supernet.net,427273,ES27209560243563162155,1664.64,2023-12-19T18:20:02,Labastida,expenses,clothing,-116.26,-26588.33
buyer_8,Antonio,Miranda,1979-04-04,59224729M,antonio.miranda@supernet.net,427273,ES27209560243563162155,1664.64,2023-12-20T08:48:22,Labastida,expenses,leisure,-66.62,-26654.95
buyer_8,Antonio,Miranda,1979-04-04,59224729M,antonio.miranda@supernet.net,427273,ES27209560243563162155,1664.64,2023-12-20T17:25:57,Labastida,expenses,repairs,-324.35,-26979.3
buyer_8,Antonio,Miranda,1979-04-04,59224729M,antonio.miranda@supernet.net,427273,ES27209560243563162155,1664.64,2023-12-21T17:28:59,Labastida,expenses,leisure,-29.34,-27008.64
buyer_8,Antonio,Miranda,1979-04-04,59224729M,antonio.miranda@supernet.net,427273,ES27209560243563162155,1664.64,2023-12-21T14:51:41,Labastida,expenses,cash,-100.0,-27108.64
buyer_8,Antonio,Miranda,1979-04-04,59224729M,antonio.miranda@supernet.net,427273,ES27209560243563162155,1664.64,2023-12-22T04:00:13,Labastida,expenses,leisure,-74.83,-27183.47
buyer_8,Antonio,Miranda,1979-04-04,59224729M,antonio.miranda@supernet.net,427273,ES27209560243563162155,1664.64,2023-12-23T23:21:13,Labastida,expenses,transport,-60.22,-27243.69
buyer_8,Antonio,Miranda,1979-04-04,59224729M,antonio.miranda@supernet.net,427273,ES27209560243563162155,1664.64,2023-12-23T08:30:10,Labastida,expenses,cash,-100.0,-27343.69
buyer_8,Antonio,Miranda,1979-04-04,59224729M,antonio.miranda@supernet.net,427273,ES27209560243563162155,1664.64,2023-12-23T19:37:32,Labastida,expenses,gifts,-477.44,-27821.13
buyer_8,Antonio,Miranda,1979-04-04,59224729M,antonio.miranda@supernet.net,427273,ES27209560243563162155,1664.64,2023-12-25T14:38:05,Labastida,expenses,leisure,-23.18,-27844.31
buyer_8,Antonio,Miranda,1979-04-04,59224729M,antonio.miranda@supernet.net,427273,ES27209560243563162155,1664.64,2023-12-25T16:06:16,Labastida,expenses,cash,-100.0,-27944.31
buyer_8,Antonio,Miranda,1979-04-04,59224729M,antonio.miranda@supernet.net,427273,ES27209560243563162155,1664.64,2023-12-29T20:57:47,Labastida,expenses,cash,-100.0,-28044.31
buyer_8,Antonio,Miranda,1979-04-04,59224729M,antonio.miranda@supernet.net,427273,ES27209560243563162155,1664.64,2023-12-29T17:23:15,Labastida,expenses,repairs,-180.46,-28224.77
buyer_8,Antonio,Miranda,1979-04-04,59224729M,antonio.miranda@supernet.net,427273,ES27209560243563162155,1664.64,2023-12-30T09:26:41,Labastida,expenses,transport,-77.55,-28302.32
buyer_8,Antonio,Miranda,1979-04-04,59224729M,antonio.miranda@supernet.net,427273,ES27209560243563162155,1664.64,2024-01-01T19:49:50,Labastida,incomes,salary,3793.02,-24509.3
buyer_8,Antonio,Miranda,1979-04-04,59224729M,antonio.miranda@supernet.net,427273,ES27209560243563162155,1664.64,2024-01-02T16:11:40,Labastida,expenses,leisure,-59.84,-24569.14
buyer_8,Antonio,Miranda,1979-04-04,59224729M,antonio.miranda@supernet.net,427273,ES27209560243563162155,1664.64,2024-01-03T19:51:32,Labastida,expenses,repairs,-209.44,-24778.58
buyer_8,Antonio,Miranda,1979-04-04,59224729M,antonio.miranda@supernet.net,427273,ES27209560243563162155,1664.64,2024-01-04T08:57:06,Labastida,expenses,mortgage,-1579.16,-26357.74
buyer_8,Antonio,Miranda,1979-04-04,59224729M,antonio.miranda@supernet.net,427273,ES27209560243563162155,1664.64,2024-01-04T21:14:15,Labastida,expenses,food,-80.77,-26438.51
buyer_8,Antonio,Miranda,1979-04-04,59224729M,antonio.miranda@supernet.net,427273,ES27209560243563162155,1664.64,2024-01-05T15:11:55,Labastida,expenses,internet,-79.65,-26518.16
buyer_8,Antonio,Miranda,1979-04-04,59224729M,antonio.miranda@supernet.net,427273,ES27209560243563162155,1664.64,2024-01-05T19:10:47,Labastida,expenses,phone,-73.18,-26591.34
buyer_8,Antonio,Miranda,1979-04-04,59224729M,antonio.miranda@supernet.net,427273,ES27209560243563162155,1664.64,2024-01-05T12:25:36,Labastida,expenses,cash,-100.0,-26691.34
buyer_8,Antonio,Miranda,1979-04-04,59224729M,antonio.miranda@supernet.net,427273,ES27209560243563162155,1664.64,2024-01-05T19:10:03,Labastida,expenses,repairs,-38.4,-26729.74
buyer_8,Antonio,Miranda,1979-04-04,59224729M,antonio.miranda@supernet.net,427273,ES27209560243563162155,1664.64,2024-01-06T15:03:18,Labastida,expenses,cash,-100.0,-26829.74
buyer_8,Antonio,Miranda,1979-04-04,59224729M,antonio.miranda@supernet.net,427273,ES27209560243563162155,1664.64,2024-01-08T08:24:12,Labastida,expenses,water,-76.92,-26906.66
buyer_8,Antonio,Miranda,1979-04-04,59224729M,antonio.miranda@supernet.net,427273,ES27209560243563162155,1664.64,2024-01-08T10:13:31,Labastida,expenses,electricity,-134.74,-27041.4
buyer_8,Antonio,Miranda,1979-04-04,59224729M,antonio.miranda@supernet.net,427273,ES27209560243563162155,1664.64,2024-01-08T14:38:37,Labastida,expenses,gas,-134.1,-27175.5
buyer_8,Antonio,Miranda,1979-04-04,59224729M,antonio.miranda@supernet.net,427273,ES27209560243563162155,1664.64,2024-01-09T12:47:34,Labastida,expenses,food,-89.81,-27265.31
buyer_8,Antonio,Miranda,1979-04-04,59224729M,antonio.miranda@supernet.net,427273,ES27209560243563162155,1664.64,2024-01-11T18:48:38,Labastida,expenses,clothing,-49.11,-27314.42
buyer_8,Antonio,Miranda,1979-04-04,59224729M,antonio.miranda@supernet.net,427273,ES27209560243563162155,1664.64,2024-01-12T02:27:37,Labastida,expenses,cash,-100.0,-27414.42
buyer_8,Antonio,Miranda,1979-04-04,59224729M,antonio.miranda@supernet.net,427273,ES27209560243563162155,1664.64,2024-01-12T13:20:26,Labastida,expenses,gifts,-124.16,-27538.58
buyer_8,Antonio,Miranda,1979-04-04,59224729M,antonio.miranda@supernet.net,427273,ES27209560243563162155,1664.64,2024-01-13T15:07:12,Labastida,expenses,leisure,-74.64,-27613.22
buyer_8,Antonio,Miranda,1979-04-04,59224729M,antonio.miranda@supernet.net,427273,ES27209560243563162155,1664.64,2024-01-13T09:11:58,Labastida,expenses,appliances,-364.51,-27977.73
buyer_8,Antonio,Miranda,1979-04-04,59224729M,antonio.miranda@supernet.net,427273,ES27209560243563162155,1664.64,2024-01-15T03:45:14,Labastida,expenses,leisure,-53.57,-28031.3
buyer_8,Antonio,Miranda,1979-04-04,59224729M,antonio.miranda@supernet.net,427273,ES27209560243563162155,1664.64,2024-01-15T15:26:39,Labastida,expenses,healthcare,-179.58,-28210.88
buyer_8,Antonio,Miranda,1979-04-04,59224729M,antonio.miranda@supernet.net,427273,ES27209560243563162155,1664.64,2024-01-15T18:33:46,Labastida,expenses,cash,-100.0,-28310.88
buyer_8,Antonio,Miranda,1979-04-04,59224729M,antonio.miranda@supernet.net,427273,ES27209560243563162155,1664.64,2024-01-18T18:08:07,Labastida,expenses,food,-93.17,-28404.05
buyer_8,Antonio,Miranda,1979-04-04,59224729M,antonio.miranda@supernet.net,427273,ES27209560243563162155,1664.64,2024-01-19T16:39:54,Labastida,expenses,leisure,-18.6,-28422.65
buyer_8,Antonio,Miranda,1979-04-04,59224729M,antonio.miranda@supernet.net,427273,ES27209560243563162155,1664.64,2024-01-21T09:59:48,Labastida,expenses,transport,-83.28,-28505.93
buyer_8,Antonio,Miranda,1979-04-04,59224729M,antonio.miranda@supernet.net,427273,ES27209560243563162155,1664.64,2024-01-23T19:40:54,Labastida,expenses,food,-91.63,-28597.56
buyer_8,Antonio,Miranda,1979-04-04,59224729M,antonio.miranda@supernet.net,427273,ES27209560243563162155,1664.64,2024-01-26T19:40:51,Labastida,expenses,education,-65.75,-28663.31
buyer_8,Antonio,Miranda,1979-04-04,59224729M,antonio.miranda@supernet.net,427273,ES27209560243563162155,1664.64,2024-01-27T18:13:53,Labastida,expenses,transport,-44.87,-28708.18
buyer_8,Antonio,Miranda,1979-04-04,59224729M,antonio.miranda@supernet.net,427273,ES27209560243563162155,1664.64,2024-01-27T16:32:27,Labastida,expenses,cash,-100.0,-28808.18
buyer_8,Antonio,Miranda,1979-04-04,59224729M,antonio.miranda@supernet.net,427273,ES27209560243563162155,1664.64,2024-01-28T18:07:50,Labastida,expenses,food,-64.14,-28872.32
buyer_8,Antonio,Miranda,1979-04-04,59224729M,antonio.miranda@supernet.net,427273,ES27209560243563162155,1664.64,2024-01-29T19:35:51,Labastida,expenses,food,-60.02,-28932.34
buyer_8,Antonio,Miranda,1979-04-04,59224729M,antonio.miranda@supernet.net,427273,ES27209560243563162155,1664.64,2024-01-29T12:14:42,Labastida,expenses,leisure,-21.82,-28954.16
buyer_8,Antonio,Miranda,1979-04-04,59224729M,antonio.miranda@supernet.net,427273,ES27209560243563162155,1664.64,2024-01-29T04:00:50,Labastida,expenses,cash,-100.0,-29054.16
buyer_8,Antonio,Miranda,1979-04-04,59224729M,antonio.miranda@supernet.net,427273,ES27209560243563162155,1664.64,2024-01-29T17:26:22,Labastida,expenses,appliances,-391.89,-29446.05
buyer_8,Antonio,Miranda,1979-04-04,59224729M,antonio.miranda@supernet.net,427273,ES27209560243563162155,1664.64,2024-01-31T20:57:07,Labastida,expenses,leisure,-71.21,-29517.26
buyer_8,Antonio,Miranda,1979-04-04,59224729M,antonio.miranda@supernet.net,427273,ES27209560243563162155,1664.64,2024-02-01T21:00:11,Labastida,incomes,salary,3793.02,-25724.24
buyer_8,Antonio,Miranda,1979-04-04,59224729M,antonio.miranda@supernet.net,427273,ES27209560243563162155,1664.64,2024-02-03T09:28:54,Labastida,expenses,cash,-100.0,-25824.24
buyer_8,Antonio,Miranda,1979-04-04,59224729M,antonio.miranda@supernet.net,427273,ES27209560243563162155,1664.64,2024-02-04T09:36:19,Labastida,expenses,mortgage,-1579.16,-27403.4
buyer_8,Antonio,Miranda,1979-04-04,59224729M,antonio.miranda@supernet.net,427273,ES27209560243563162155,1664.64,2024-02-04T12:42:31,Labastida,expenses,food,-111.42,-27514.82
buyer_8,Antonio,Miranda,1979-04-04,59224729M,antonio.miranda@supernet.net,427273,ES27209560243563162155,1664.64,2024-02-05T18:02:01,Labastida,expenses,electricity,-149.22,-27664.04
buyer_8,Antonio,Miranda,1979-04-04,59224729M,antonio.miranda@supernet.net,427273,ES27209560243563162155,1664.64,2024-02-05T09:24:49,Labastida,expenses,gas,-207.2,-27871.24
buyer_8,Antonio,Miranda,1979-04-04,59224729M,antonio.miranda@supernet.net,427273,ES27209560243563162155,1664.64,2024-02-05T15:23:38,Labastida,expenses,phone,-71.47,-27942.71
buyer_8,Antonio,Miranda,1979-04-04,59224729M,antonio.miranda@supernet.net,427273,ES27209560243563162155,1664.64,2024-02-05T09:13:28,Labastida,expenses,repairs,-152.84,-28095.55
buyer_8,Antonio,Miranda,1979-04-04,59224729M,antonio.miranda@supernet.net,427273,ES27209560243563162155,1664.64,2024-02-06T18:09:27,Labastida,expenses,internet,-79.65,-28175.2
buyer_8,Antonio,Miranda,1979-04-04,59224729M,antonio.miranda@supernet.net,427273,ES27209560243563162155,1664.64,2024-02-08T18:44:36,Labastida,expenses,water,-80.46,-28255.66
buyer_8,Antonio,Miranda,1979-04-04,59224729M,antonio.miranda@supernet.net,427273,ES27209560243563162155,1664.64,2024-02-08T13:15:19,Labastida,expenses,food,-105.36,-28361.02
buyer_8,Antonio,Miranda,1979-04-04,59224729M,antonio.miranda@supernet.net,427273,ES27209560243563162155,1664.64,2024-02-09T22:38:59,Labastida,expenses,transport,-48.74,-28409.76
buyer_8,Antonio,Miranda,1979-04-04,59224729M,antonio.miranda@supernet.net,427273,ES27209560243563162155,1664.64,2024-02-10T11:50:38,Labastida,expenses,cash,-100.0,-28509.76
buyer_8,Antonio,Miranda,1979-04-04,59224729M,antonio.miranda@supernet.net,427273,ES27209560243563162155,1664.64,2024-02-11T18:40:43,Labastida,expenses,cash,-100.0,-28609.76
buyer_8,Antonio,Miranda,1979-04-04,59224729M,antonio.miranda@supernet.net,427273,ES27209560243563162155,1664.64,2024-02-12T01:22:21,Labastida,expenses,repairs,-206.91,-28816.67
buyer_8,Antonio,Miranda,1979-04-04,59224729M,antonio.miranda@supernet.net,427273,ES27209560243563162155,1664.64,2024-02-13T00:19:45,Labastida,expenses,leisure,-63.04,-28879.71
buyer_8,Antonio,Miranda,1979-04-04,59224729M,antonio.miranda@supernet.net,427273,ES27209560243563162155,1664.64,2024-02-15T20:57:45,Labastida,expenses,education,-45.53,-28925.24
buyer_8,Antonio,Miranda,1979-04-04,59224729M,antonio.miranda@supernet.net,427273,ES27209560243563162155,1664.64,2024-02-15T10:37:28,Labastida,expenses,cash,-100.0,-29025.24
buyer_8,Antonio,Miranda,1979-04-04,59224729M,antonio.miranda@supernet.net,427273,ES27209560243563162155,1664.64,2024-02-16T21:55:54,Labastida,expenses,cash,-100.0,-29125.24
buyer_8,Antonio,Miranda,1979-04-04,59224729M,antonio.miranda@supernet.net,427273,ES27209560243563162155,1664.64,2024-02-20T10:37:46,Labastida,expenses,cash,-100.0,-29225.24
buyer_8,Antonio,Miranda,1979-04-04,59224729M,antonio.miranda@supernet.net,427273,ES27209560243563162155,1664.64,2024-02-21T12:34:16,Labastida,expenses,healthcare,-82.05,-29307.29
buyer_8,Antonio,Miranda,1979-04-04,59224729M,antonio.miranda@supernet.net,427273,ES27209560243563162155,1664.64,2024-02-21T11:18:43,Labastida,expenses,travel,-1223.69,-30530.98
buyer_8,Antonio,Miranda,1979-04-04,59224729M,antonio.miranda@supernet.net,427273,ES27209560243563162155,1664.64,2024-02-24T09:09:35,Labastida,expenses,repairs,-257.47,-30788.45
buyer_8,Antonio,Miranda,1979-04-04,59224729M,antonio.miranda@supernet.net,427273,ES27209560243563162155,1664.64,2024-02-25T14:01:22,Labastida,expenses,food,-122.5,-30910.95
buyer_8,Antonio,Miranda,1979-04-04,59224729M,antonio.miranda@supernet.net,427273,ES27209560243563162155,1664.64,2024-02-25T03:53:35,Labastida,expenses,transport,-42.56,-30953.51
buyer_8,Antonio,Miranda,1979-04-04,59224729M,antonio.miranda@supernet.net,427273,ES27209560243563162155,1664.64,2024-02-26T09:53:02,Labastida,expenses,food,-61.07,-31014.58
buyer_8,Antonio,Miranda,1979-04-04,59224729M,antonio.miranda@supernet.net,427273,ES27209560243563162155,1664.64,2024-02-26T09:53:44,Labastida,expenses,cash,-100.0,-31114.58
buyer_8,Antonio,Miranda,1979-04-04,59224729M,antonio.miranda@supernet.net,427273,ES27209560243563162155,1664.64,2024-02-27T17:23:26,Labastida,expenses,transport,-61.72,-31176.3
buyer_8,Antonio,Miranda,1979-04-04,59224729M,antonio.miranda@supernet.net,427273,ES27209560243563162155,1664.64,2024-02-28T10:14:49,Labastida,expenses,clothing,-141.63,-31317.93
buyer_8,Antonio,Miranda,1979-04-04,59224729M,antonio.miranda@supernet.net,427273,ES27209560243563162155,1664.64,2024-02-28T17:27:04,Labastida,expenses,cash,-100.0,-31417.93
buyer_8,Antonio,Miranda,1979-04-04,59224729M,antonio.miranda@supernet.net,427273,ES27209560243563162155,1664.64,2024-03-01T13:40:24,Labastida,incomes,salary,3793.02,-27624.91
buyer_8,Antonio,Miranda,1979-04-04,59224729M,antonio.miranda@supernet.net,427273,ES27209560243563162155,1664.64,2024-03-01T13:46:36,Labastida,expenses,healthcare,-188.95,-27813.86
buyer_8,Antonio,Miranda,1979-04-04,59224729M,antonio.miranda@supernet.net,427273,ES27209560243563162155,1664.64,2024-03-01T11:34:51,Labastida,expenses,education,-49.15,-27863.01
buyer_8,Antonio,Miranda,1979-04-04,59224729M,antonio.miranda@supernet.net,427273,ES27209560243563162155,1664.64,2024-03-02T21:22:14,Labastida,expenses,leisure,-35.23,-27898.24
buyer_8,Antonio,Miranda,1979-04-04,59224729M,antonio.miranda@supernet.net,427273,ES27209560243563162155,1664.64,2024-03-03T13:22:05,Labastida,expenses,cash,-100.0,-27998.24
buyer_8,Antonio,Miranda,1979-04-04,59224729M,antonio.miranda@supernet.net,427273,ES27209560243563162155,1664.64,2024-03-04T10:57:34,Labastida,expenses,mortgage,-1579.16,-29577.4
buyer_8,Antonio,Miranda,1979-04-04,59224729M,antonio.miranda@supernet.net,427273,ES27209560243563162155,1664.64,2024-03-05T01:09:04,Labastida,expenses,gas,-142.75,-29720.15
buyer_8,Antonio,Miranda,1979-04-04,59224729M,antonio.miranda@supernet.net,427273,ES27209560243563162155,1664.64,2024-03-06T15:24:14,Labastida,expenses,cash,-100.0,-29820.15
buyer_8,Antonio,Miranda,1979-04-04,59224729M,antonio.miranda@supernet.net,427273,ES27209560243563162155,1664.64,2024-03-07T18:24:38,Labastida,expenses,water,-49.52,-29869.67
buyer_8,Antonio,Miranda,1979-04-04,59224729M,antonio.miranda@supernet.net,427273,ES27209560243563162155,1664.64,2024-03-07T20:49:46,Labastida,expenses,phone,-59.02,-29928.69
buyer_8,Antonio,Miranda,1979-04-04,59224729M,antonio.miranda@supernet.net,427273,ES27209560243563162155,1664.64,2024-03-08T15:59:42,Labastida,expenses,electricity,-91.96,-30020.65
buyer_8,Antonio,Miranda,1979-04-04,59224729M,antonio.miranda@supernet.net,427273,ES27209560243563162155,1664.64,2024-03-08T16:25:11,Labastida,expenses,internet,-79.65,-30100.3
buyer_8,Antonio,Miranda,1979-04-04,59224729M,antonio.miranda@supernet.net,427273,ES27209560243563162155,1664.64,2024-03-09T13:18:20,Labastida,expenses,food,-93.28,-30193.58
buyer_8,Antonio,Miranda,1979-04-04,59224729M,antonio.miranda@supernet.net,427273,ES27209560243563162155,1664.64,2024-03-09T04:18:46,Labastida,expenses,transport,-41.45,-30235.03
buyer_8,Antonio,Miranda,1979-04-04,59224729M,antonio.miranda@supernet.net,427273,ES27209560243563162155,1664.64,2024-03-09T15:22:02,Labastida,expenses,leisure,-41.2,-30276.23
buyer_8,Antonio,Miranda,1979-04-04,59224729M,antonio.miranda@supernet.net,427273,ES27209560243563162155,1664.64,2024-03-09T18:56:20,Labastida,expenses,gifts,-83.3,-30359.53
buyer_8,Antonio,Miranda,1979-04-04,59224729M,antonio.miranda@supernet.net,427273,ES27209560243563162155,1664.64,2024-03-13T14:34:37,Labastida,expenses,food,-74.21,-30433.74
buyer_8,Antonio,Miranda,1979-04-04,59224729M,antonio.miranda@supernet.net,427273,ES27209560243563162155,1664.64,2024-03-13T17:23:15,Labastida,expenses,cash,-100.0,-30533.74
buyer_8,Antonio,Miranda,1979-04-04,59224729M,antonio.miranda@supernet.net,427273,ES27209560243563162155,1664.64,2024-03-14T09:56:22,Labastida,expenses,food,-66.48,-30600.22
buyer_8,Antonio,Miranda,1979-04-04,59224729M,antonio.miranda@supernet.net,427273,ES27209560243563162155,1664.64,2024-03-14T20:31:11,Labastida,expenses,cash,-100.0,-30700.22
buyer_8,Antonio,Miranda,1979-04-04,59224729M,antonio.miranda@supernet.net,427273,ES27209560243563162155,1664.64,2024-03-17T15:10:42,Labastida,expenses,transport,-87.59,-30787.81
buyer_8,Antonio,Miranda,1979-04-04,59224729M,antonio.miranda@supernet.net,427273,ES27209560243563162155,1664.64,2024-03-17T11:14:04,Labastida,expenses,gifts,-139.59,-30927.4
buyer_8,Antonio,Miranda,1979-04-04,59224729M,antonio.miranda@supernet.net,427273,ES27209560243563162155,1664.64,2024-03-19T13:23:15,Labastida,expenses,food,-112.1,-31039.5
buyer_8,Antonio,Miranda,1979-04-04,59224729M,antonio.miranda@supernet.net,427273,ES27209560243563162155,1664.64,2024-03-21T22:49:20,Labastida,expenses,cash,-100.0,-31139.5
buyer_8,Antonio,Miranda,1979-04-04,59224729M,antonio.miranda@supernet.net,427273,ES27209560243563162155,1664.64,2024-03-21T22:29:51,Labastida,expenses,gifts,-771.07,-31910.57
buyer_8,Antonio,Miranda,1979-04-04,59224729M,antonio.miranda@supernet.net,427273,ES27209560243563162155,1664.64,2024-03-22T10:24:34,Labastida,expenses,education,-52.6,-31963.17
buyer_8,Antonio,Miranda,1979-04-04,59224729M,antonio.miranda@supernet.net,427273,ES27209560243563162155,1664.64,2024-03-23T11:46:52,Labastida,expenses,food,-92.58,-32055.75
buyer_8,Antonio,Miranda,1979-04-04,59224729M,antonio.miranda@supernet.net,427273,ES27209560243563162155,1664.64,2024-03-24T13:42:01,Labastida,expenses,transport,-52.4,-32108.15
buyer_8,Antonio,Miranda,1979-04-04,59224729M,antonio.miranda@supernet.net,427273,ES27209560243563162155,1664.64,2024-03-24T18:55:08,Labastida,expenses,education,-66.32,-32174.47
buyer_8,Antonio,Miranda,1979-04-04,59224729M,antonio.miranda@supernet.net,427273,ES27209560243563162155,1664.64,2024-03-25T20:44:35,Labastida,expenses,food,-114.5,-32288.97
buyer_8,Antonio,Miranda,1979-04-04,59224729M,antonio.miranda@supernet.net,427273,ES27209560243563162155,1664.64,2024-03-25T11:56:55,Labastida,expenses,cash,-100.0,-32388.97
buyer_8,Antonio,Miranda,1979-04-04,59224729M,antonio.miranda@supernet.net,427273,ES27209560243563162155,1664.64,2024-03-29T08:51:10,Labastida,expenses,food,-108.73,-32497.7
buyer_8,Antonio,Miranda,1979-04-04,59224729M,antonio.miranda@supernet.net,427273,ES27209560243563162155,1664.64,2024-03-29T19:29:15,Labastida,expenses,leisure,-77.96,-32575.66
buyer_8,Antonio,Miranda,1979-04-04,59224729M,antonio.miranda@supernet.net,427273,ES27209560243563162155,1664.64,2024-03-30T16:46:11,Labastida,expenses,transport,-61.25,-32636.91
buyer_8,Antonio,Miranda,1979-04-04,59224729M,antonio.miranda@supernet.net,427273,ES27209560243563162155,1664.64,2024-03-30T09:23:06,Labastida,expenses,gifts,-120.54,-32757.45
buyer_8,Antonio,Miranda,1979-04-04,59224729M,antonio.miranda@supernet.net,427273,ES27209560243563162155,1664.64,2024-03-31T10:59:42,Labastida,expenses,transport,-67.39,-32824.84
buyer_8,Antonio,Miranda,1979-04-04,59224729M,antonio.miranda@supernet.net,427273,ES27209560243563162155,1664.64,2024-04-01T08:31:27,Labastida,incomes,salary,3793.02,-29031.82
buyer_8,Antonio,Miranda,1979-04-04,59224729M,antonio.miranda@supernet.net,427273,ES27209560243563162155,1664.64,2024-04-01T08:31:27,Labastida,incomes,extra_income,484.35,-28547.47
buyer_8,Antonio,Miranda,1979-04-04,59224729M,antonio.miranda@supernet.net,427273,ES27209560243563162155,1664.64,2024-04-01T13:42:41,Labastida,expenses,cash,-100.0,-28647.47
buyer_8,Antonio,Miranda,1979-04-04,59224729M,antonio.miranda@supernet.net,427273,ES27209560243563162155,1664.64,2024-04-02T21:46:18,Labastida,expenses,healthcare,-77.24,-28724.71
buyer_8,Antonio,Miranda,1979-04-04,59224729M,antonio.miranda@supernet.net,427273,ES27209560243563162155,1664.64,2024-04-02T10:49:22,Labastida,expenses,cash,-100.0,-28824.71
buyer_8,Antonio,Miranda,1979-04-04,59224729M,antonio.miranda@supernet.net,427273,ES27209560243563162155,1664.64,2024-04-02T10:10:24,Labastida,expenses,repairs,-172.08,-28996.79
buyer_8,Antonio,Miranda,1979-04-04,59224729M,antonio.miranda@supernet.net,427273,ES27209560243563162155,1664.64,2024-04-04T13:07:31,Labastida,expenses,mortgage,-1579.16,-30575.95
buyer_8,Antonio,Miranda,1979-04-04,59224729M,antonio.miranda@supernet.net,427273,ES27209560243563162155,1664.64,2024-04-05T11:31:04,Labastida,expenses,gas,-149.49,-30725.44
buyer_8,Antonio,Miranda,1979-04-04,59224729M,antonio.miranda@supernet.net,427273,ES27209560243563162155,1664.64,2024-04-05T09:50:08,Labastida,expenses,phone,-62.55,-30787.99
buyer_8,Antonio,Miranda,1979-04-04,59224729M,antonio.miranda@supernet.net,427273,ES27209560243563162155,1664.64,2024-04-06T02:14:46,Labastida,expenses,water,-59.09,-30847.08
buyer_8,Antonio,Miranda,1979-04-04,59224729M,antonio.miranda@supernet.net,427273,ES27209560243563162155,1664.64,2024-04-06T20:20:56,Labastida,expenses,gifts,-782.66,-31629.74
buyer_8,Antonio,Miranda,1979-04-04,59224729M,antonio.miranda@supernet.net,427273,ES27209560243563162155,1664.64,2024-04-07T11:46:19,Labastida,expenses,electricity,-155.29,-31785.03
buyer_8,Antonio,Miranda,1979-04-04,59224729M,antonio.miranda@supernet.net,427273,ES27209560243563162155,1664.64,2024-04-07T17:42:28,Labastida,expenses,transport,-88.17,-31873.2
buyer_8,Antonio,Miranda,1979-04-04,59224729M,antonio.miranda@supernet.net,427273,ES27209560243563162155,1664.64,2024-04-08T10:33:56,Labastida,expenses,internet,-79.65,-31952.85
buyer_8,Antonio,Miranda,1979-04-04,59224729M,antonio.miranda@supernet.net,427273,ES27209560243563162155,1664.64,2024-04-08T16:01:43,Labastida,expenses,transport,-40.52,-31993.37
buyer_8,Antonio,Miranda,1979-04-04,59224729M,antonio.miranda@supernet.net,427273,ES27209560243563162155,1664.64,2024-04-09T12:29:00,Labastida,expenses,cash,-100.0,-32093.37
buyer_8,Antonio,Miranda,1979-04-04,59224729M,antonio.miranda@supernet.net,427273,ES27209560243563162155,1664.64,2024-04-10T08:49:25,Labastida,expenses,repairs,-289.98,-32383.35
buyer_8,Antonio,Miranda,1979-04-04,59224729M,antonio.miranda@supernet.net,427273,ES27209560243563162155,1664.64,2024-04-11T14:45:17,Labastida,expenses,leisure,-44.73,-32428.08
buyer_8,Antonio,Miranda,1979-04-04,59224729M,antonio.miranda@supernet.net,427273,ES27209560243563162155,1664.64,2024-04-12T08:37:46,Labastida,expenses,food,-104.66,-32532.74
buyer_8,Antonio,Miranda,1979-04-04,59224729M,antonio.miranda@supernet.net,427273,ES27209560243563162155,1664.64,2024-04-12T07:18:53,Labastida,expenses,cash,-100.0,-32632.74
buyer_8,Antonio,Miranda,1979-04-04,59224729M,antonio.miranda@supernet.net,427273,ES27209560243563162155,1664.64,2024-04-12T09:29:26,Labastida,expenses,travel,-307.8,-32940.54
buyer_8,Antonio,Miranda,1979-04-04,59224729M,antonio.miranda@supernet.net,427273,ES27209560243563162155,1664.64,2024-04-13T23:54:52,Labastida,expenses,food,-120.75,-33061.29
buyer_8,Antonio,Miranda,1979-04-04,59224729M,antonio.miranda@supernet.net,427273,ES27209560243563162155,1664.64,2024-04-13T13:44:51,Labastida,expenses,transport,-53.64,-33114.93
buyer_8,Antonio,Miranda,1979-04-04,59224729M,antonio.miranda@supernet.net,427273,ES27209560243563162155,1664.64,2024-04-13T10:31:56,Labastida,expenses,leisure,-55.82,-33170.75
buyer_8,Antonio,Miranda,1979-04-04,59224729M,antonio.miranda@supernet.net,427273,ES27209560243563162155,1664.64,2024-04-16T15:53:16,Labastida,expenses,transport,-40.94,-33211.69
buyer_8,Antonio,Miranda,1979-04-04,59224729M,antonio.miranda@supernet.net,427273,ES27209560243563162155,1664.64,2024-04-16T12:32:16,Labastida,expenses,leisure,-57.83,-33269.52
buyer_8,Antonio,Miranda,1979-04-04,59224729M,antonio.miranda@supernet.net,427273,ES27209560243563162155,1664.64,2024-04-23T14:49:20,Labastida,expenses,repairs,-254.19,-33523.71
buyer_8,Antonio,Miranda,1979-04-04,59224729M,antonio.miranda@supernet.net,427273,ES27209560243563162155,1664.64,2024-04-24T10:09:53,Labastida,expenses,leisure,-30.3,-33554.01
buyer_8,Antonio,Miranda,1979-04-04,59224729M,antonio.miranda@supernet.net,427273,ES27209560243563162155,1664.64,2024-04-24T09:08:37,Labastida,expenses,cash,-100.0,-33654.01
buyer_8,Antonio,Miranda,1979-04-04,59224729M,antonio.miranda@supernet.net,427273,ES27209560243563162155,1664.64,2024-04-25T08:33:44,Labastida,expenses,cash,-100.0,-33754.01
buyer_8,Antonio,Miranda,1979-04-04,59224729M,antonio.miranda@supernet.net,427273,ES27209560243563162155,1664.64,2024-04-26T17:16:53,Labastida,expenses,food,-113.35,-33867.36
buyer_8,Antonio,Miranda,1979-04-04,59224729M,antonio.miranda@supernet.net,427273,ES27209560243563162155,1664.64,2024-04-26T20:05:36,Labastida,expenses,leisure,-82.86,-33950.22
buyer_8,Antonio,Miranda,1979-04-04,59224729M,antonio.miranda@supernet.net,427273,ES27209560243563162155,1664.64,2024-04-27T23:29:23,Labastida,expenses,cash,-100.0,-34050.22
buyer_8,Antonio,Miranda,1979-04-04,59224729M,antonio.miranda@supernet.net,427273,ES27209560243563162155,1664.64,2024-04-29T11:03:14,Labastida,expenses,transport,-48.98,-34099.2
buyer_8,Antonio,Miranda,1979-04-04,59224729M,antonio.miranda@supernet.net,427273,ES27209560243563162155,1664.64,2024-04-30T12:55:34,Labastida,expenses,education,-78.57,-34177.77
buyer_8,Antonio,Miranda,1979-04-04,59224729M,antonio.miranda@supernet.net,427273,ES27209560243563162155,1664.64,2024-04-30T09:08:39,Labastida,expenses,cash,-100.0,-34277.77
buyer_8,Antonio,Miranda,1979-04-04,59224729M,antonio.miranda@supernet.net,427273,ES27209560243563162155,1664.64,2024-05-01T16:58:32,Labastida,incomes,salary,3793.02,-30484.75
buyer_8,Antonio,Miranda,1979-04-04,59224729M,antonio.miranda@supernet.net,427273,ES27209560243563162155,1664.64,2024-05-01T20:47:52,Labastida,expenses,food,-100.61,-30585.36
buyer_8,Antonio,Miranda,1979-04-04,59224729M,antonio.miranda@supernet.net,427273,ES27209560243563162155,1664.64,2024-05-04T11:54:03,Labastida,expenses,mortgage,-1579.16,-32164.52
buyer_8,Antonio,Miranda,1979-04-04,59224729M,antonio.miranda@supernet.net,427273,ES27209560243563162155,1664.64,2024-05-04T16:56:33,Labastida,expenses,transport,-80.64,-32245.16
buyer_8,Antonio,Miranda,1979-04-04,59224729M,antonio.miranda@supernet.net,427273,ES27209560243563162155,1664.64,2024-05-04T11:38:40,Labastida,expenses,leisure,-49.46,-32294.62
buyer_8,Antonio,Miranda,1979-04-04,59224729M,antonio.miranda@supernet.net,427273,ES27209560243563162155,1664.64,2024-05-05T08:22:38,Labastida,expenses,clothing,-63.71,-32358.33
buyer_8,Antonio,Miranda,1979-04-04,59224729M,antonio.miranda@supernet.net,427273,ES27209560243563162155,1664.64,2024-05-07T08:14:38,Labastida,expenses,electricity,-58.92,-32417.25
buyer_8,Antonio,Miranda,1979-04-04,59224729M,antonio.miranda@supernet.net,427273,ES27209560243563162155,1664.64,2024-05-07T19:05:00,Labastida,expenses,transport,-86.27,-32503.52
buyer_8,Antonio,Miranda,1979-04-04,59224729M,antonio.miranda@supernet.net,427273,ES27209560243563162155,1664.64,2024-05-07T17:19:01,Labastida,expenses,leisure,-68.4,-32571.92
buyer_8,Antonio,Miranda,1979-04-04,59224729M,antonio.miranda@supernet.net,427273,ES27209560243563162155,1664.64,2024-05-07T00:33:02,Labastida,expenses,education,-65.06,-32636.98
buyer_8,Antonio,Miranda,1979-04-04,59224729M,antonio.miranda@supernet.net,427273,ES27209560243563162155,1664.64,2024-05-08T20:19:44,Labastida,expenses,water,-48.16,-32685.14
buyer_8,Antonio,Miranda,1979-04-04,59224729M,antonio.miranda@supernet.net,427273,ES27209560243563162155,1664.64,2024-05-08T11:30:57,Labastida,expenses,gas,-73.67,-32758.81
buyer_8,Antonio,Miranda,1979-04-04,59224729M,antonio.miranda@supernet.net,427273,ES27209560243563162155,1664.64,2024-05-08T11:56:57,Labastida,expenses,internet,-79.65,-32838.46
buyer_8,Antonio,Miranda,1979-04-04,59224729M,antonio.miranda@supernet.net,427273,ES27209560243563162155,1664.64,2024-05-08T23:25:49,Labastida,expenses,phone,-83.13,-32921.59
buyer_8,Antonio,Miranda,1979-04-04,59224729M,antonio.miranda@supernet.net,427273,ES27209560243563162155,1664.64,2024-05-10T15:36:03,Labastida,expenses,cash,-100.0,-33021.59
buyer_8,Antonio,Miranda,1979-04-04,59224729M,antonio.miranda@supernet.net,427273,ES27209560243563162155,1664.64,2024-05-11T23:00:33,Labastida,expenses,food,-113.02,-33134.61
buyer_8,Antonio,Miranda,1979-04-04,59224729M,antonio.miranda@supernet.net,427273,ES27209560243563162155,1664.64,2024-05-11T11:11:41,Labastida,expenses,transport,-82.47,-33217.08
buyer_8,Antonio,Miranda,1979-04-04,59224729M,antonio.miranda@supernet.net,427273,ES27209560243563162155,1664.64,2024-05-12T20:21:59,Labastida,expenses,education,-48.65,-33265.73
buyer_8,Antonio,Miranda,1979-04-04,59224729M,antonio.miranda@supernet.net,427273,ES27209560243563162155,1664.64,2024-05-15T18:40:39,Labastida,expenses,transport,-71.66,-33337.39
buyer_8,Antonio,Miranda,1979-04-04,59224729M,antonio.miranda@supernet.net,427273,ES27209560243563162155,1664.64,2024-05-16T14:07:15,Labastida,expenses,gifts,-655.31,-33992.7
buyer_8,Antonio,Miranda,1979-04-04,59224729M,antonio.miranda@supernet.net,427273,ES27209560243563162155,1664.64,2024-05-18T14:08:53,Labastida,expenses,gifts,-86.23,-34078.93
buyer_8,Antonio,Miranda,1979-04-04,59224729M,antonio.miranda@supernet.net,427273,ES27209560243563162155,1664.64,2024-05-19T12:37:51,Labastida,expenses,clothing,-61.54,-34140.47
buyer_8,Antonio,Miranda,1979-04-04,59224729M,antonio.miranda@supernet.net,427273,ES27209560243563162155,1664.64,2024-05-21T05:11:52,Labastida,expenses,healthcare,-172.33,-34312.8
buyer_8,Antonio,Miranda,1979-04-04,59224729M,antonio.miranda@supernet.net,427273,ES27209560243563162155,1664.64,2024-05-22T17:49:29,Labastida,expenses,food,-101.37,-34414.17
buyer_8,Antonio,Miranda,1979-04-04,59224729M,antonio.miranda@supernet.net,427273,ES27209560243563162155,1664.64,2024-05-22T23:32:19,Labastida,expenses,leisure,-28.07,-34442.24
buyer_8,Antonio,Miranda,1979-04-04,59224729M,antonio.miranda@supernet.net,427273,ES27209560243563162155,1664.64,2024-05-22T18:12:08,Labastida,expenses,cash,-100.0,-34542.24
buyer_8,Antonio,Miranda,1979-04-04,59224729M,antonio.miranda@supernet.net,427273,ES27209560243563162155,1664.64,2024-05-22T09:00:13,Labastida,expenses,repairs,-154.48,-34696.72
buyer_8,Antonio,Miranda,1979-04-04,59224729M,antonio.miranda@supernet.net,427273,ES27209560243563162155,1664.64,2024-05-23T08:16:10,Labastida,expenses,food,-83.51,-34780.23
buyer_8,Antonio,Miranda,1979-04-04,59224729M,antonio.miranda@supernet.net,427273,ES27209560243563162155,1664.64,2024-05-24T17:33:24,Labastida,expenses,repairs,-46.38,-34826.61
buyer_8,Antonio,Miranda,1979-04-04,59224729M,antonio.miranda@supernet.net,427273,ES27209560243563162155,1664.64,2024-05-26T13:13:51,Labastida,expenses,leisure,-31.69,-34858.3
buyer_8,Antonio,Miranda,1979-04-04,59224729M,antonio.miranda@supernet.net,427273,ES27209560243563162155,1664.64,2024-05-26T17:48:43,Labastida,expenses,healthcare,-75.17,-34933.47
buyer_8,Antonio,Miranda,1979-04-04,59224729M,antonio.miranda@supernet.net,427273,ES27209560243563162155,1664.64,2024-05-27T13:41:40,Labastida,expenses,food,-72.91,-35006.38
buyer_8,Antonio,Miranda,1979-04-04,59224729M,antonio.miranda@supernet.net,427273,ES27209560243563162155,1664.64,2024-05-27T17:25:35,Labastida,expenses,clothing,-67.26,-35073.64
buyer_8,Antonio,Miranda,1979-04-04,59224729M,antonio.miranda@supernet.net,427273,ES27209560243563162155,1664.64,2024-05-28T08:11:47,Labastida,expenses,appliances,-195.28,-35268.92
buyer_8,Antonio,Miranda,1979-04-04,59224729M,antonio.miranda@supernet.net,427273,ES27209560243563162155,1664.64,2024-05-30T10:54:28,Labastida,expenses,cash,-100.0,-35368.92
buyer_8,Antonio,Miranda,1979-04-04,59224729M,antonio.miranda@supernet.net,427273,ES27209560243563162155,1664.64,2024-05-30T08:49:57,Labastida,expenses,appliances,-294.07,-35662.99
buyer_8,Antonio,Miranda,1979-04-04,59224729M,antonio.miranda@supernet.net,427273,ES27209560243563162155,1664.64,2024-06-01T20:49:09,Labastida,incomes,salary,3793.02,-31869.97
buyer_8,Antonio,Miranda,1979-04-04,59224729M,antonio.miranda@supernet.net,427273,ES27209560243563162155,1664.64,2024-06-01T20:49:09,Labastida,incomes,salary_bonus,3006.84,-28863.13
buyer_8,Antonio,Miranda,1979-04-04,59224729M,antonio.miranda@supernet.net,427273,ES27209560243563162155,1664.64,2024-06-01T08:44:41,Labastida,expenses,clothing,-61.8,-28924.93
buyer_8,Antonio,Miranda,1979-04-04,59224729M,antonio.miranda@supernet.net,427273,ES27209560243563162155,1664.64,2024-06-03T00:45:03,Labastida,expenses,cash,-100.0,-29024.93
buyer_8,Antonio,Miranda,1979-04-04,59224729M,antonio.miranda@supernet.net,427273,ES27209560243563162155,1664.64,2024-06-03T02:03:41,Labastida,expenses,gifts,-703.24,-29728.17
buyer_8,Antonio,Miranda,1979-04-04,59224729M,antonio.miranda@supernet.net,427273,ES27209560243563162155,1664.64,2024-06-04T07:00:49,Labastida,expenses,mortgage,-1579.16,-31307.33
buyer_8,Antonio,Miranda,1979-04-04,59224729M,antonio.miranda@supernet.net,427273,ES27209560243563162155,1664.64,2024-06-04T13:16:08,Labastida,expenses,food,-85.23,-31392.56
buyer_8,Antonio,Miranda,1979-04-04,59224729M,antonio.miranda@supernet.net,427273,ES27209560243563162155,1664.64,2024-06-05T20:29:42,Labastida,expenses,electricity,-170.68,-31563.24
buyer_8,Antonio,Miranda,1979-04-04,59224729M,antonio.miranda@supernet.net,427273,ES27209560243563162155,1664.64,2024-06-05T22:01:33,Labastida,expenses,gas,-214.36,-31777.6
buyer_8,Antonio,Miranda,1979-04-04,59224729M,antonio.miranda@supernet.net,427273,ES27209560243563162155,1664.64,2024-06-05T09:05:21,Labastida,expenses,food,-92.33,-31869.93
buyer_8,Antonio,Miranda,1979-04-04,59224729M,antonio.miranda@supernet.net,427273,ES27209560243563162155,1664.64,2024-06-05T04:24:53,Labastida,expenses,leisure,-58.98,-31928.91
buyer_8,Antonio,Miranda,1979-04-04,59224729M,antonio.miranda@supernet.net,427273,ES27209560243563162155,1664.64,2024-06-06T22:25:00,Labastida,expenses,water,-80.52,-32009.43
buyer_8,Antonio,Miranda,1979-04-04,59224729M,antonio.miranda@supernet.net,427273,ES27209560243563162155,1664.64,2024-06-06T11:40:15,Labastida,expenses,clothing,-61.05,-32070.48
buyer_8,Antonio,Miranda,1979-04-04,59224729M,antonio.miranda@supernet.net,427273,ES27209560243563162155,1664.64,2024-06-07T10:38:40,Labastida,expenses,internet,-79.65,-32150.13
buyer_8,Antonio,Miranda,1979-04-04,59224729M,antonio.miranda@supernet.net,427273,ES27209560243563162155,1664.64,2024-06-07T16:40:28,Labastida,expenses,phone,-69.83,-32219.96
buyer_8,Antonio,Miranda,1979-04-04,59224729M,antonio.miranda@supernet.net,427273,ES27209560243563162155,1664.64,2024-06-07T18:54:35,Labastida,expenses,repairs,-115.3,-32335.26
buyer_8,Antonio,Miranda,1979-04-04,59224729M,antonio.miranda@supernet.net,427273,ES27209560243563162155,1664.64,2024-06-11T18:28:04,Labastida,expenses,cash,-100.0,-32435.26
buyer_8,Antonio,Miranda,1979-04-04,59224729M,antonio.miranda@supernet.net,427273,ES27209560243563162155,1664.64,2024-06-13T12:54:28,Labastida,expenses,cash,-100.0,-32535.26
buyer_8,Antonio,Miranda,1979-04-04,59224729M,antonio.miranda@supernet.net,427273,ES27209560243563162155,1664.64,2024-06-14T19:28:31,Labastida,expenses,appliances,-127.16,-32662.42
buyer_8,Antonio,Miranda,1979-04-04,59224729M,antonio.miranda@supernet.net,427273,ES27209560243563162155,1664.64,2024-06-15T11:22:01,Labastida,expenses,leisure,-48.48,-32710.9
buyer_8,Antonio,Miranda,1979-04-04,59224729M,antonio.miranda@supernet.net,427273,ES27209560243563162155,1664.64,2024-06-19T19:45:36,Labastida,expenses,transport,-64.07,-32774.97
buyer_8,Antonio,Miranda,1979-04-04,59224729M,antonio.miranda@supernet.net,427273,ES27209560243563162155,1664.64,2024-06-23T10:19:40,Labastida,expenses,cash,-100.0,-32874.97
buyer_8,Antonio,Miranda,1979-04-04,59224729M,antonio.miranda@supernet.net,427273,ES27209560243563162155,1664.64,2024-06-23T20:02:05,Labastida,expenses,repairs,-64.5,-32939.47
buyer_8,Antonio,Miranda,1979-04-04,59224729M,antonio.miranda@supernet.net,427273,ES27209560243563162155,1664.64,2024-06-24T10:18:09,Labastida,expenses,repairs,-236.45,-33175.92
buyer_8,Antonio,Miranda,1979-04-04,59224729M,antonio.miranda@supernet.net,427273,ES27209560243563162155,1664.64,2024-06-25T12:19:42,Labastida,expenses,food,-83.56,-33259.48
buyer_8,Antonio,Miranda,1979-04-04,59224729M,antonio.miranda@supernet.net,427273,ES27209560243563162155,1664.64,2024-06-26T15:41:38,Labastida,expenses,transport,-71.83,-33331.31
buyer_8,Antonio,Miranda,1979-04-04,59224729M,antonio.miranda@supernet.net,427273,ES27209560243563162155,1664.64,2024-06-26T10:00:53,Labastida,expenses,gifts,-281.1,-33612.41
buyer_8,Antonio,Miranda,1979-04-04,59224729M,antonio.miranda@supernet.net,427273,ES27209560243563162155,1664.64,2024-06-28T11:37:20,Labastida,expenses,cash,-100.0,-33712.41
buyer_8,Antonio,Miranda,1979-04-04,59224729M,antonio.miranda@supernet.net,427273,ES27209560243563162155,1664.64,2024-07-01T05:10:25,Labastida,incomes,salary,3793.02,-29919.39
buyer_8,Antonio,Miranda,1979-04-04,59224729M,antonio.miranda@supernet.net,427273,ES27209560243563162155,1664.64,2024-07-01T05:10:25,Labastida,incomes,extra_income,484.35,-29435.04
buyer_8,Antonio,Miranda,1979-04-04,59224729M,antonio.miranda@supernet.net,427273,ES27209560243563162155,1664.64,2024-07-01T09:04:53,Labastida,expenses,cash,-100.0,-29535.04
buyer_8,Antonio,Miranda,1979-04-04,59224729M,antonio.miranda@supernet.net,427273,ES27209560243563162155,1664.64,2024-07-02T15:40:40,Labastida,expenses,education,-73.82,-29608.86
buyer_8,Antonio,Miranda,1979-04-04,59224729M,antonio.miranda@supernet.net,427273,ES27209560243563162155,1664.64,2024-07-02T16:12:13,Labastida,expenses,gifts,-539.12,-30147.98
buyer_8,Antonio,Miranda,1979-04-04,59224729M,antonio.miranda@supernet.net,427273,ES27209560243563162155,1664.64,2024-07-04T13:02:33,Labastida,expenses,mortgage,-1579.16,-31727.14
buyer_8,Antonio,Miranda,1979-04-04,59224729M,antonio.miranda@supernet.net,427273,ES27209560243563162155,1664.64,2024-07-04T01:41:19,Labastida,expenses,transport,-54.82,-31781.96
buyer_8,Antonio,Miranda,1979-04-04,59224729M,antonio.miranda@supernet.net,427273,ES27209560243563162155,1664.64,2024-07-04T08:13:48,Labastida,expenses,travel,-1378.85,-33160.81
buyer_8,Antonio,Miranda,1979-04-04,59224729M,antonio.miranda@supernet.net,427273,ES27209560243563162155,1664.64,2024-07-05T17:47:36,Labastida,expenses,gas,-198.91,-33359.72
buyer_8,Antonio,Miranda,1979-04-04,59224729M,antonio.miranda@supernet.net,427273,ES27209560243563162155,1664.64,2024-07-05T18:29:52,Labastida,expenses,phone,-78.76,-33438.48
buyer_8,Antonio,Miranda,1979-04-04,59224729M,antonio.miranda@supernet.net,427273,ES27209560243563162155,1664.64,2024-07-06T14:28:52,Labastida,expenses,internet,-79.65,-33518.13
buyer_8,Antonio,Miranda,1979-04-04,59224729M,antonio.miranda@supernet.net,427273,ES27209560243563162155,1664.64,2024-07-06T10:39:29,Labastida,expenses,transport,-83.05,-33601.18
buyer_8,Antonio,Miranda,1979-04-04,59224729M,antonio.miranda@supernet.net,427273,ES27209560243563162155,1664.64,2024-07-06T17:07:03,Labastida,expenses,healthcare,-145.73,-33746.91
buyer_8,Antonio,Miranda,1979-04-04,59224729M,antonio.miranda@supernet.net,427273,ES27209560243563162155,1664.64,2024-07-07T19:13:56,Labastida,expenses,cash,-100.0,-33846.91
buyer_8,Antonio,Miranda,1979-04-04,59224729M,antonio.miranda@supernet.net,427273,ES27209560243563162155,1664.64,2024-07-08T11:23:47,Labastida,expenses,water,-55.69,-33902.6
buyer_8,Antonio,Miranda,1979-04-04,59224729M,antonio.miranda@supernet.net,427273,ES27209560243563162155,1664.64,2024-07-08T19:16:28,Labastida,expenses,electricity,-120.36,-34022.96
buyer_8,Antonio,Miranda,1979-04-04,59224729M,antonio.miranda@supernet.net,427273,ES27209560243563162155,1664.64,2024-07-08T09:32:21,Labastida,expenses,leisure,-61.03,-34083.99
buyer_8,Antonio,Miranda,1979-04-04,59224729M,antonio.miranda@supernet.net,427273,ES27209560243563162155,1664.64,2024-07-09T12:38:32,Labastida,expenses,food,-76.52,-34160.51
buyer_8,Antonio,Miranda,1979-04-04,59224729M,antonio.miranda@supernet.net,427273,ES27209560243563162155,1664.64,2024-07-09T17:31:37,Labastida,expenses,clothing,-61.65,-34222.16
buyer_8,Antonio,Miranda,1979-04-04,59224729M,antonio.miranda@supernet.net,427273,ES27209560243563162155,1664.64,2024-07-10T14:06:38,Labastida,expenses,transport,-78.34,-34300.5
buyer_8,Antonio,Miranda,1979-04-04,59224729M,antonio.miranda@supernet.net,427273,ES27209560243563162155,1664.64,2024-07-10T08:31:44,Labastida,expenses,repairs,-258.51,-34559.01
buyer_8,Antonio,Miranda,1979-04-04,59224729M,antonio.miranda@supernet.net,427273,ES27209560243563162155,1664.64,2024-07-12T20:01:26,Labastida,expenses,education,-42.6,-34601.61
buyer_8,Antonio,Miranda,1979-04-04,59224729M,antonio.miranda@supernet.net,427273,ES27209560243563162155,1664.64,2024-07-13T13:07:26,Labastida,expenses,leisure,-25.86,-34627.47
buyer_8,Antonio,Miranda,1979-04-04,59224729M,antonio.miranda@supernet.net,427273,ES27209560243563162155,1664.64,2024-07-15T18:58:12,Labastida,expenses,food,-86.04,-34713.51
buyer_8,Antonio,Miranda,1979-04-04,59224729M,antonio.miranda@supernet.net,427273,ES27209560243563162155,1664.64,2024-07-15T19:17:19,Labastida,expenses,transport,-57.69,-34771.2
buyer_8,Antonio,Miranda,1979-04-04,59224729M,antonio.miranda@supernet.net,427273,ES27209560243563162155,1664.64,2024-07-15T22:29:54,Labastida,expenses,healthcare,-77.82,-34849.02
buyer_8,Antonio,Miranda,1979-04-04,59224729M,antonio.miranda@supernet.net,427273,ES27209560243563162155,1664.64,2024-07-15T08:09:40,Labastida,expenses,cash,-100.0,-34949.02
buyer_8,Antonio,Miranda,1979-04-04,59224729M,antonio.miranda@supernet.net,427273,ES27209560243563162155,1664.64,2024-07-16T09:19:38,Labastida,expenses,cash,-100.0,-35049.02
buyer_8,Antonio,Miranda,1979-04-04,59224729M,antonio.miranda@supernet.net,427273,ES27209560243563162155,1664.64,2024-07-18T11:19:45,Labastida,expenses,repairs,-105.41,-35154.43
buyer_8,Antonio,Miranda,1979-04-04,59224729M,antonio.miranda@supernet.net,427273,ES27209560243563162155,1664.64,2024-07-18T11:50:03,Labastida,expenses,gifts,-769.43,-35923.86
buyer_8,Antonio,Miranda,1979-04-04,59224729M,antonio.miranda@supernet.net,427273,ES27209560243563162155,1664.64,2024-07-21T17:23:48,Labastida,expenses,leisure,-47.06,-35970.92
buyer_8,Antonio,Miranda,1979-04-04,59224729M,antonio.miranda@supernet.net,427273,ES27209560243563162155,1664.64,2024-07-23T10:19:41,Labastida,expenses,leisure,-31.37,-36002.29
buyer_8,Antonio,Miranda,1979-04-04,59224729M,antonio.miranda@supernet.net,427273,ES27209560243563162155,1664.64,2024-07-23T08:24:42,Labastida,expenses,gifts,-349.5,-36351.79
buyer_8,Antonio,Miranda,1979-04-04,59224729M,antonio.miranda@supernet.net,427273,ES27209560243563162155,1664.64,2024-07-24T10:59:24,Labastida,expenses,leisure,-80.78,-36432.57
buyer_8,Antonio,Miranda,1979-04-04,59224729M,antonio.miranda@supernet.net,427273,ES27209560243563162155,1664.64,2024-07-24T08:11:13,Labastida,expenses,healthcare,-140.29,-36572.86
buyer_8,Antonio,Miranda,1979-04-04,59224729M,antonio.miranda@supernet.net,427273,ES27209560243563162155,1664.64,2024-07-24T11:21:44,Labastida,expenses,repairs,-94.03,-36666.89
buyer_8,Antonio,Miranda,1979-04-04,59224729M,antonio.miranda@supernet.net,427273,ES27209560243563162155,1664.64,2024-07-25T16:07:56,Labastida,expenses,transport,-55.61,-36722.5
buyer_8,Antonio,Miranda,1979-04-04,59224729M,antonio.miranda@supernet.net,427273,ES27209560243563162155,1664.64,2024-07-25T16:18:17,Labastida,expenses,leisure,-79.76,-36802.26
buyer_8,Antonio,Miranda,1979-04-04,59224729M,antonio.miranda@supernet.net,427273,ES27209560243563162155,1664.64,2024-07-26T17:22:23,Labastida,expenses,food,-121.51,-36923.77
buyer_8,Antonio,Miranda,1979-04-04,59224729M,antonio.miranda@supernet.net,427273,ES27209560243563162155,1664.64,2024-07-27T19:07:17,Labastida,expenses,gifts,-788.44,-37712.21
buyer_8,Antonio,Miranda,1979-04-04,59224729M,antonio.miranda@supernet.net,427273,ES27209560243563162155,1664.64,2024-07-28T15:49:10,Labastida,expenses,gifts,-715.94,-38428.15
buyer_8,Antonio,Miranda,1979-04-04,59224729M,antonio.miranda@supernet.net,427273,ES27209560243563162155,1664.64,2024-07-29T20:44:33,Labastida,expenses,food,-117.66,-38545.81
buyer_8,Antonio,Miranda,1979-04-04,59224729M,antonio.miranda@supernet.net,427273,ES27209560243563162155,1664.64,2024-07-30T12:11:57,Labastida,expenses,gifts,-210.56,-38756.37
buyer_8,Antonio,Miranda,1979-04-04,59224729M,antonio.miranda@supernet.net,427273,ES27209560243563162155,1664.64,2024-07-31T11:36:56,Labastida,expenses,cash,-100.0,-38856.37
buyer_8,Antonio,Miranda,1979-04-04,59224729M,antonio.miranda@supernet.net,427273,ES27209560243563162155,1664.64,2024-08-01T09:50:40,Labastida,incomes,salary,3793.02,-35063.35
buyer_8,Antonio,Miranda,1979-04-04,59224729M,antonio.miranda@supernet.net,427273,ES27209560243563162155,1664.64,2024-08-01T18:22:33,Labastida,expenses,food,-111.27,-35174.62
buyer_8,Antonio,Miranda,1979-04-04,59224729M,antonio.miranda@supernet.net,427273,ES27209560243563162155,1664.64,2024-08-01T04:05:27,Labastida,expenses,repairs,-219.56,-35394.18
buyer_8,Antonio,Miranda,1979-04-04,59224729M,antonio.miranda@supernet.net,427273,ES27209560243563162155,1664.64,2024-08-03T17:31:36,Labastida,expenses,leisure,-77.91,-35472.09
buyer_8,Antonio,Miranda,1979-04-04,59224729M,antonio.miranda@supernet.net,427273,ES27209560243563162155,1664.64,2024-08-04T12:12:19,Labastida,expenses,mortgage,-1579.16,-37051.25
buyer_8,Antonio,Miranda,1979-04-04,59224729M,antonio.miranda@supernet.net,427273,ES27209560243563162155,1664.64,2024-08-04T17:24:01,Labastida,expenses,food,-73.89,-37125.14
buyer_8,Antonio,Miranda,1979-04-04,59224729M,antonio.miranda@supernet.net,427273,ES27209560243563162155,1664.64,2024-08-05T09:35:07,Labastida,expenses,electricity,-71.76,-37196.9
buyer_8,Antonio,Miranda,1979-04-04,59224729M,antonio.miranda@supernet.net,427273,ES27209560243563162155,1664.64,2024-08-05T12:20:32,Labastida,expenses,clothing,-111.37,-37308.27
buyer_8,Antonio,Miranda,1979-04-04,59224729M,antonio.miranda@supernet.net,427273,ES27209560243563162155,1664.64,2024-08-06T10:35:53,Labastida,expenses,water,-69.61,-37377.88
buyer_8,Antonio,Miranda,1979-04-04,59224729M,antonio.miranda@supernet.net,427273,ES27209560243563162155,1664.64,2024-08-08T16:08:52,Labastida,expenses,gas,-68.28,-37446.16
buyer_8,Antonio,Miranda,1979-04-04,59224729M,antonio.miranda@supernet.net,427273,ES27209560243563162155,1664.64,2024-08-08T21:50:40,Labastida,expenses,internet,-79.65,-37525.81
buyer_8,Antonio,Miranda,1979-04-04,59224729M,antonio.miranda@supernet.net,427273,ES27209560243563162155,1664.64,2024-08-08T17:56:08,Labastida,expenses,phone,-69.48,-37595.29
buyer_8,Antonio,Miranda,1979-04-04,59224729M,antonio.miranda@supernet.net,427273,ES27209560243563162155,1664.64,2024-08-08T13:52:17,Labastida,expenses,cash,-100.0,-37695.29
buyer_8,Antonio,Miranda,1979-04-04,59224729M,antonio.miranda@supernet.net,427273,ES27209560243563162155,1664.64,2024-08-14T17:07:17,Labastida,expenses,gifts,-387.0,-38082.29
buyer_8,Antonio,Miranda,1979-04-04,59224729M,antonio.miranda@supernet.net,427273,ES27209560243563162155,1664.64,2024-08-16T01:40:17,Labastida,expenses,clothing,-121.13,-38203.42
buyer_8,Antonio,Miranda,1979-04-04,59224729M,antonio.miranda@supernet.net,427273,ES27209560243563162155,1664.64,2024-08-16T11:49:05,Labastida,expenses,cash,-100.0,-38303.42
buyer_8,Antonio,Miranda,1979-04-04,59224729M,antonio.miranda@supernet.net,427273,ES27209560243563162155,1664.64,2024-08-20T04:46:39,Labastida,expenses,leisure,-47.04,-38350.46
buyer_8,Antonio,Miranda,1979-04-04,59224729M,antonio.miranda@supernet.net,427273,ES27209560243563162155,1664.64,2024-08-21T21:13:01,Labastida,expenses,cash,-100.0,-38450.46
buyer_8,Antonio,Miranda,1979-04-04,59224729M,antonio.miranda@supernet.net,427273,ES27209560243563162155,1664.64,2024-08-22T09:57:14,Labastida,expenses,leisure,-37.32,-38487.78
buyer_8,Antonio,Miranda,1979-04-04,59224729M,antonio.miranda@supernet.net,427273,ES27209560243563162155,1664.64,2024-08-23T11:18:30,Labastida,expenses,food,-121.85,-38609.63
buyer_8,Antonio,Miranda,1979-04-04,59224729M,antonio.miranda@supernet.net,427273,ES27209560243563162155,1664.64,2024-08-24T18:06:33,Labastida,expenses,food,-71.08,-38680.71
buyer_8,Antonio,Miranda,1979-04-04,59224729M,antonio.miranda@supernet.net,427273,ES27209560243563162155,1664.64,2024-08-25T18:17:50,Labastida,expenses,travel,-1131.21,-39811.92
buyer_8,Antonio,Miranda,1979-04-04,59224729M,antonio.miranda@supernet.net,427273,ES27209560243563162155,1664.64,2024-08-27T15:59:51,Labastida,expenses,food,-63.56,-39875.48
buyer_8,Antonio,Miranda,1979-04-04,59224729M,antonio.miranda@supernet.net,427273,ES27209560243563162155,1664.64,2024-08-28T13:33:12,Labastida,expenses,gifts,-332.1,-40207.58
buyer_8,Antonio,Miranda,1979-04-04,59224729M,antonio.miranda@supernet.net,427273,ES27209560243563162155,1664.64,2024-08-29T00:26:37,Labastida,expenses,food,-104.81,-40312.39
buyer_8,Antonio,Miranda,1979-04-04,59224729M,antonio.miranda@supernet.net,427273,ES27209560243563162155,1664.64,2024-08-29T16:24:15,Labastida,expenses,clothing,-119.43,-40431.82
buyer_8,Antonio,Miranda,1979-04-04,59224729M,antonio.miranda@supernet.net,427273,ES27209560243563162155,1664.64,2024-09-01T12:52:26,Labastida,incomes,salary,3793.02,-36638.8
buyer_8,Antonio,Miranda,1979-04-04,59224729M,antonio.miranda@supernet.net,427273,ES27209560243563162155,1664.64,2024-09-01T00:04:28,Labastida,expenses,food,-109.12,-36747.92
buyer_8,Antonio,Miranda,1979-04-04,59224729M,antonio.miranda@supernet.net,427273,ES27209560243563162155,1664.64,2024-09-01T11:23:13,Labastida,expenses,repairs,-63.74,-36811.66
buyer_8,Antonio,Miranda,1979-04-04,59224729M,antonio.miranda@supernet.net,427273,ES27209560243563162155,1664.64,2024-09-04T13:55:44,Labastida,expenses,mortgage,-1579.16,-38390.82
buyer_8,Antonio,Miranda,1979-04-04,59224729M,antonio.miranda@supernet.net,427273,ES27209560243563162155,1664.64,2024-09-05T18:07:16,Labastida,expenses,water,-41.67,-38432.49
buyer_8,Antonio,Miranda,1979-04-04,59224729M,antonio.miranda@supernet.net,427273,ES27209560243563162155,1664.64,2024-09-05T09:25:44,Labastida,expenses,gas,-127.46,-38559.95
buyer_8,Antonio,Miranda,1979-04-04,59224729M,antonio.miranda@supernet.net,427273,ES27209560243563162155,1664.64,2024-09-05T18:28:06,Labastida,expenses,cash,-100.0,-38659.95
buyer_8,Antonio,Miranda,1979-04-04,59224729M,antonio.miranda@supernet.net,427273,ES27209560243563162155,1664.64,2024-09-06T13:21:40,Labastida,expenses,phone,-81.38,-38741.33
buyer_8,Antonio,Miranda,1979-04-04,59224729M,antonio.miranda@supernet.net,427273,ES27209560243563162155,1664.64,2024-09-06T21:08:21,Labastida,expenses,repairs,-140.99,-38882.32
buyer_8,Antonio,Miranda,1979-04-04,59224729M,antonio.miranda@supernet.net,427273,ES27209560243563162155,1664.64,2024-09-07T08:04:11,Labastida,expenses,food,-97.42,-38979.74
buyer_8,Antonio,Miranda,1979-04-04,59224729M,antonio.miranda@supernet.net,427273,ES27209560243563162155,1664.64,2024-09-08T09:35:51,Labastida,expenses,electricity,-120.41,-39100.15
buyer_8,Antonio,Miranda,1979-04-04,59224729M,antonio.miranda@supernet.net,427273,ES27209560243563162155,1664.64,2024-09-08T10:28:25,Labastida,expenses,internet,-79.65,-39179.8
buyer_8,Antonio,Miranda,1979-04-04,59224729M,antonio.miranda@supernet.net,427273,ES27209560243563162155,1664.64,2024-09-08T12:50:28,Labastida,expenses,education,-50.49,-39230.29
buyer_8,Antonio,Miranda,1979-04-04,59224729M,antonio.miranda@supernet.net,427273,ES27209560243563162155,1664.64,2024-09-09T09:25:55,Labastida,expenses,cash,-100.0,-39330.29
buyer_8,Antonio,Miranda,1979-04-04,59224729M,antonio.miranda@supernet.net,427273,ES27209560243563162155,1664.64,2024-09-09T11:29:29,Labastida,expenses,repairs,-153.89,-39484.18
buyer_8,Antonio,Miranda,1979-04-04,59224729M,antonio.miranda@supernet.net,427273,ES27209560243563162155,1664.64,2024-09-14T15:52:20,Labastida,expenses,transport,-89.05,-39573.23
buyer_8,Antonio,Miranda,1979-04-04,59224729M,antonio.miranda@supernet.net,427273,ES27209560243563162155,1664.64,2024-09-14T11:41:33,Labastida,expenses,cash,-100.0,-39673.23
buyer_8,Antonio,Miranda,1979-04-04,59224729M,antonio.miranda@supernet.net,427273,ES27209560243563162155,1664.64,2024-09-16T09:38:43,Labastida,expenses,leisure,-59.44,-39732.67
buyer_8,Antonio,Miranda,1979-04-04,59224729M,antonio.miranda@supernet.net,427273,ES27209560243563162155,1664.64,2024-09-17T12:13:40,Labastida,expenses,transport,-46.1,-39778.77
buyer_8,Antonio,Miranda,1979-04-04,59224729M,antonio.miranda@supernet.net,427273,ES27209560243563162155,1664.64,2024-09-18T22:19:54,Labastida,expenses,gifts,-225.37,-40004.14
buyer_8,Antonio,Miranda,1979-04-04,59224729M,antonio.miranda@supernet.net,427273,ES27209560243563162155,1664.64,2024-09-23T00:41:00,Labastida,expenses,transport,-66.23,-40070.37
buyer_8,Antonio,Miranda,1979-04-04,59224729M,antonio.miranda@supernet.net,427273,ES27209560243563162155,1664.64,2024-09-23T13:37:44,Labastida,expenses,leisure,-58.76,-40129.13
buyer_8,Antonio,Miranda,1979-04-04,59224729M,antonio.miranda@supernet.net,427273,ES27209560243563162155,1664.64,2024-09-24T20:00:45,Labastida,expenses,leisure,-76.71,-40205.84
buyer_8,Antonio,Miranda,1979-04-04,59224729M,antonio.miranda@supernet.net,427273,ES27209560243563162155,1664.64,2024-09-24T10:39:02,Labastida,expenses,cash,-100.0,-40305.84
buyer_8,Antonio,Miranda,1979-04-04,59224729M,antonio.miranda@supernet.net,427273,ES27209560243563162155,1664.64,2024-09-25T10:27:54,Labastida,expenses,food,-66.01,-40371.85
buyer_8,Antonio,Miranda,1979-04-04,59224729M,antonio.miranda@supernet.net,427273,ES27209560243563162155,1664.64,2024-09-26T20:07:02,Labastida,expenses,food,-105.16,-40477.01
buyer_8,Antonio,Miranda,1979-04-04,59224729M,antonio.miranda@supernet.net,427273,ES27209560243563162155,1664.64,2024-09-27T09:12:15,Labastida,expenses,transport,-61.58,-40538.59
buyer_8,Antonio,Miranda,1979-04-04,59224729M,antonio.miranda@supernet.net,427273,ES27209560243563162155,1664.64,2024-09-28T16:08:45,Labastida,expenses,leisure,-42.92,-40581.51
buyer_8,Antonio,Miranda,1979-04-04,59224729M,antonio.miranda@supernet.net,427273,ES27209560243563162155,1664.64,2024-09-29T17:01:16,Labastida,expenses,food,-81.59,-40663.1
buyer_8,Antonio,Miranda,1979-04-04,59224729M,antonio.miranda@supernet.net,427273,ES27209560243563162155,1664.64,2024-10-01T22:54:37,Labastida,incomes,salary,3793.02,-36870.08
buyer_8,Antonio,Miranda,1979-04-04,59224729M,antonio.miranda@supernet.net,427273,ES27209560243563162155,1664.64,2024-10-01T22:54:37,Labastida,incomes,extra_income,484.35,-36385.73
buyer_8,Antonio,Miranda,1979-04-04,59224729M,antonio.miranda@supernet.net,427273,ES27209560243563162155,1664.64,2024-10-02T09:27:42,Labastida,expenses,food,-113.48,-36499.21
buyer_8,Antonio,Miranda,1979-04-04,59224729M,antonio.miranda@supernet.net,427273,ES27209560243563162155,1664.64,2024-10-04T13:06:46,Labastida,expenses,mortgage,-1579.16,-38078.37
buyer_8,Antonio,Miranda,1979-04-04,59224729M,antonio.miranda@supernet.net,427273,ES27209560243563162155,1664.64,2024-10-04T09:00:32,Labastida,expenses,leisure,-59.06,-38137.43
buyer_8,Antonio,Miranda,1979-04-04,59224729M,antonio.miranda@supernet.net,427273,ES27209560243563162155,1664.64,2024-10-05T23:15:46,Labastida,expenses,water,-55.41,-38192.84
buyer_8,Antonio,Miranda,1979-04-04,59224729M,antonio.miranda@supernet.net,427273,ES27209560243563162155,1664.64,2024-10-05T15:53:56,Labastida,expenses,electricity,-101.06,-38293.9
buyer_8,Antonio,Miranda,1979-04-04,59224729M,antonio.miranda@supernet.net,427273,ES27209560243563162155,1664.64,2024-10-05T21:21:09,Labastida,expenses,leisure,-55.21,-38349.11
buyer_8,Antonio,Miranda,1979-04-04,59224729M,antonio.miranda@supernet.net,427273,ES27209560243563162155,1664.64,2024-10-07T14:07:59,Labastida,expenses,gas,-209.0,-38558.11
buyer_8,Antonio,Miranda,1979-04-04,59224729M,antonio.miranda@supernet.net,427273,ES27209560243563162155,1664.64,2024-10-07T21:21:12,Labastida,expenses,food,-98.67,-38656.78
buyer_8,Antonio,Miranda,1979-04-04,59224729M,antonio.miranda@supernet.net,427273,ES27209560243563162155,1664.64,2024-10-07T21:01:02,Labastida,expenses,cash,-100.0,-38756.78
buyer_8,Antonio,Miranda,1979-04-04,59224729M,antonio.miranda@supernet.net,427273,ES27209560243563162155,1664.64,2024-10-08T14:06:15,Labastida,expenses,phone,-67.95,-38824.73
buyer_8,Antonio,Miranda,1979-04-04,59224729M,antonio.miranda@supernet.net,427273,ES27209560243563162155,1664.64,2024-10-08T15:52:43,Labastida,expenses,internet,-79.65,-38904.38
buyer_8,Antonio,Miranda,1979-04-04,59224729M,antonio.miranda@supernet.net,427273,ES27209560243563162155,1664.64,2024-10-08T21:51:50,Labastida,expenses,transport,-76.86,-38981.24
buyer_8,Antonio,Miranda,1979-04-04,59224729M,antonio.miranda@supernet.net,427273,ES27209560243563162155,1664.64,2024-10-09T14:29:36,Labastida,expenses,food,-91.27,-39072.51
buyer_8,Antonio,Miranda,1979-04-04,59224729M,antonio.miranda@supernet.net,427273,ES27209560243563162155,1664.64,2024-10-09T14:38:26,Labastida,expenses,leisure,-75.78,-39148.29
buyer_8,Antonio,Miranda,1979-04-04,59224729M,antonio.miranda@supernet.net,427273,ES27209560243563162155,1664.64,2024-10-09T08:11:07,Labastida,expenses,cash,-100.0,-39248.29
