profile,name,surname,birth_date,iban,trx_id,timestamp,city,trx_type,trx_cat,amount_eur,balance
buyer_1,Luis,,1996-08-10,ES05209515179869230980,TRX_N-00001-94138371,2022-01-01T14:02:45,Bilbao,incomes,salary,1589.41,5381.87
buyer_1,Luis,,1996-08-10,ES05209515179869230980,TRX_N-00002-97083583,2022-01-03T23:52:38,Bilbao,expenses,cash,-100.0,5281.87
buyer_1,Luis,,1996-08-10,ES05209515179869230980,TRX_N-00003-12350550,2022-01-04T08:15:24,Bilbao,expenses,rent,-601.82,4680.05
buyer_1,Luis,,1996-08-10,ES05209515179869230980,TRX_N-00004-14591024,2022-01-05T15:39:19,Bilbao,expenses,water,-42.98,4637.07
buyer_1,Luis,,1996-08-10,ES05209515179869230980,TRX_N-00005-84835414,2022-01-05T14:21:01,Bilbao,expenses,electricity,-37.56,4599.51
buyer_1,Luis,,1996-08-10,ES05209515179869230980,TRX_N-00006-94532334,2022-01-05T10:28:43,Bilbao,expenses,food,-79.87,4519.64
buyer_1,Luis,,1996-08-10,ES05209515179869230980,TRX_N-00007-00453081,2022-01-05T23:23:30,Bilbao,expenses,cash,-100.0,4419.64
buyer_1,Luis,,1996-08-10,ES05209515179869230980,TRX_N-00008-06437746,2022-01-06T08:11:33,Bilbao,expenses,appliances,-127.81,4291.83
buyer_1,Luis,,1996-08-10,ES05209515179869230980,TRX_N-00009-25206575,2022-01-07T20:12:22,Bilbao,expenses,internet,-42.0,4249.83
buyer_1,Luis,,1996-08-10,ES05209515179869230980,TRX_N-00010-28031594,2022-01-07T12:26:24,Bilbao,expenses,phone,-36.23,4213.6
buyer_1,Luis,,1996-08-10,ES05209515179869230980,TRX_N-00011-19660728,2022-01-08T20:44:03,Bilbao,expenses,gas,-93.21,4120.39
buyer_1,Luis,,1996-08-10,ES05209515179869230980,TRX_N-00012-60686747,2022-01-08T19:04:39,Bilbao,expenses,transport,-64.73,4055.66
buyer_1,Luis,,1996-08-10,ES05209515179869230980,TRX_N-00013-01260833,2022-01-10T18:34:03,Bilbao,expenses,education,-66.63,3989.03
buyer_1,Luis,,1996-08-10,ES05209515179869230980,TRX_N-00014-34312823,2022-01-12T20:01:01,Bilbao,expenses,repairs,-56.28,3932.75
buyer_1,Luis,,1996-08-10,ES05209515179869230980,TRX_N-00015-19319710,2022-01-16T10:25:38,Salvatierra/Agurain,expenses,transport,-54.24,3878.51
buyer_1,Luis,,1996-08-10,ES05209515179869230980,TRX_N-00016-61149771,2022-01-17T19:31:10,Basauri,expenses,transport,-46.43,3832.08
buyer_1,Luis,,1996-08-10,ES05209515179869230980,TRX_N-00017-17717849,2022-01-20T11:55:04,Bilbao,expenses,leisure,-21.72,3810.36
buyer_1,Luis,,1996-08-10,ES05209515179869230980,TRX_N-00018-02705078,2022-01-20T10:06:13,Bilbao,expenses,cash,-100.0,3710.36
buyer_1,Luis,,1996-08-10,ES05209515179869230980,TRX_N-00019-95169565,2022-01-25T19:47:44,Bilbao,expenses,food,-67.1,3643.26
buyer_1,Luis,,1996-08-10,ES05209515179869230980,TRX_N-00020-20152771,2022-01-25T16:45:58,Bilbao,expenses,cash,-100.0,3543.26
buyer_1,Luis,,1996-08-10,ES05209515179869230980,TRX_N-00021-08753022,2022-01-25T13:22:14,Bilbao,expenses,travel,-680.46,2862.8
buyer_1,Luis,,1996-08-10,ES05209515179869230980,TRX_N-00022-60710784,2022-01-26T15:35:26,Bilbao,expenses,education,-48.08,2814.72
buyer_1,Luis,,1996-08-10,ES05209515179869230980,TRX_N-00023-22811254,2022-01-26T14:19:30,Bermeo,expenses,cash,-100.0,2714.72
buyer_1,Luis,,1996-08-10,ES05209515179869230980,TRX_N-00024-52484204,2022-01-27T15:32:34,Bilbao,expenses,transport,-87.32,2627.4
buyer_1,Luis,,1996-08-10,ES05209515179869230980,TRX_N-00025-96320955,2022-01-27T16:29:32,Bilbao,expenses,repairs,-130.73,2496.67
buyer_1,Luis,,1996-08-10,ES05209515179869230980,TRX_N-00026-51997899,2022-01-29T08:20:29,Bilbao,expenses,food,-79.07,2417.6
buyer_1,Luis,,1996-08-10,ES05209515179869230980,TRX_N-00027-46230425,2022-01-30T09:33:17,Bilbao,expenses,appliances,-198.94,2218.66
buyer_1,Luis,,1996-08-10,ES05209515179869230980,TRX_N-00028-62704840,2022-01-31T08:13:49,Irun,expenses,leisure,-73.81,2144.85
buyer_1,Luis,,1996-08-10,ES05209515179869230980,TRX_N-00029-02881336,2022-02-01T17:30:31,Bilbao,incomes,salary,1589.41,3734.26
buyer_1,Luis,,1996-08-10,ES05209515179869230980,TRX_N-00030-21671202,2022-02-02T19:00:27,Bilbao,expenses,transport,-84.45,3649.81
buyer_1,Luis,,1996-08-10,ES05209515179869230980,TRX_N-00031-31451826,2022-02-03T13:34:06,Bilbao,expenses,food,-91.74,3558.07
buyer_1,Luis,,1996-08-10,ES05209515179869230980,TRX_N-00032-93573135,2022-02-04T13:19:23,Bilbao,expenses,rent,-601.82,2956.25
buyer_1,Luis,,1996-08-10,ES05209515179869230980,TRX_N-00033-86646001,2022-02-05T15:03:55,Bilbao,expenses,water,-44.33,2911.92
buyer_1,Luis,,1996-08-10,ES05209515179869230980,TRX_N-00034-75642703,2022-02-06T12:12:29,Durango,expenses,leisure,-84.57,2827.35
buyer_1,Luis,,1996-08-10,ES05209515179869230980,TRX_N-00035-92482986,2022-02-06T22:32:06,Bilbao,expenses,clothing,-105.08,2722.27
buyer_1,Luis,,1996-08-10,ES05209515179869230980,TRX_N-00036-32023915,2022-02-07T16:07:46,Bilbao,expenses,electricity,-66.43,2655.84
buyer_1,Luis,,1996-08-10,ES05209515179869230980,TRX_N-00037-90720324,2022-02-07T00:21:42,Bilbao,expenses,gas,-47.84,2608.0
buyer_1,Luis,,1996-08-10,ES05209515179869230980,TRX_N-00038-07375285,2022-02-07T14:13:27,Bilbao,expenses,internet,-42.0,2566.0
buyer_1,Luis,,1996-08-10,ES05209515179869230980,TRX_N-00039-47177251,2022-02-07T12:29:36,Bilbao,expenses,phone,-40.23,2525.77
buyer_1,Luis,,1996-08-10,ES05209515179869230980,TRX_N-00040-72337650,2022-02-07T14:27:04,Bilbao,expenses,leisure,-63.41,2462.36
buyer_1,Luis,,1996-08-10,ES05209515179869230980,TRX_N-00041-26130650,2022-02-08T11:32:55,Bilbao,expenses,transport,-48.12,2414.24
buyer_1,Luis,,1996-08-10,ES05209515179869230980,TRX_N-00042-77660813,2022-02-08T18:44:29,Bilbao,expenses,repairs,-211.89,2202.35
buyer_1,Luis,,1996-08-10,ES05209515179869230980,TRX_N-00043-27856315,2022-02-10T02:16:32,Bilbao,expenses,gifts,-288.64,1913.71
buyer_1,Luis,,1996-08-10,ES05209515179869230980,TRX_N-00044-04178738,2022-02-11T10:20:20,Bilbao,expenses,cash,-100.0,1813.71
buyer_1,Luis,,1996-08-10,ES05209515179869230980,TRX_N-00045-14035561,2022-02-13T20:45:17,Bilbao,expenses,leisure,-41.36,1772.35
buyer_1,Luis,,1996-08-10,ES05209515179869230980,TRX_N-00046-65539936,2022-02-15T11:21:44,Hernani,expenses,cash,-100.0,1672.35
buyer_1,Luis,,1996-08-10,ES05209515179869230980,TRX_N-00047-12985003,2022-02-18T17:19:24,Bilbao,expenses,leisure,-83.34,1589.01
buyer_1,Luis,,1996-08-10,ES05209515179869230980,TRX_N-00048-33374632,2022-02-19T19:39:07,Bilbao,expenses,cash,-100.0,1489.01
buyer_1,Luis,,1996-08-10,ES05209515179869230980,TRX_N-00049-22995635,2022-02-20T20:17:03,Bilbao,expenses,gifts,-255.93,1233.08
buyer_1,Luis,,1996-08-10,ES05209515179869230980,TRX_N-00050-68134623,2022-02-22T05:16:12,Bilbao,expenses,cash,-100.0,1133.08
buyer_1,Luis,,1996-08-10,ES05209515179869230980,TRX_N-00051-97522547,2022-02-22T17:37:37,Bilbao,expenses,gifts,-130.02,1003.06
buyer_1,Luis,,1996-08-10,ES05209515179869230980,TRX_N-00052-26882035,2022-02-23T15:26:55,Bilbao,expenses,transport,-64.05,939.01
buyer_1,Luis,,1996-08-10,ES05209515179869230980,TRX_N-00053-88971414,2022-02-24T11:11:47,Bilbao,expenses,cash,-100.0,839.01
buyer_1,Luis,,1996-08-10,ES05209515179869230980,TRX_N-00054-60945028,2022-02-25T12:22:35,Bilbao,expenses,education,-47.04,791.97
buyer_1,Luis,,1996-08-10,ES05209515179869230980,TRX_N-00055-00445650,2022-02-25T16:00:25,Bilbao,expenses,cash,-100.0,691.97
buyer_1,Luis,,1996-08-10,ES05209515179869230980,TRX_N-00056-01139244,2022-02-26T14:16:32,Bilbao,expenses,transport,-78.45,613.52
buyer_1,Luis,,1996-08-10,ES05209515179869230980,TRX_N-00057-54124845,2022-02-26T15:13:04,Barakaldo,expenses,education,-53.19,560.33
buyer_1,Luis,,1996-08-10,ES05209515179869230980,TRX_N-00058-75812292,2022-03-01T02:08:22,Bilbao,incomes,salary,1589.41,2149.74
buyer_1,Luis,,1996-08-10,ES05209515179869230980,TRX_N-00059-97547418,2022-03-04T19:43:30,Bilbao,expenses,rent,-601.82,1547.92
buyer_1,Luis,,1996-08-10,ES05209515179869230980,TRX_N-00060-89082969,2022-03-05T23:04:16,Bilbao,expenses,gas,-32.66,1515.26
buyer_1,Luis,,1996-08-10,ES05209515179869230980,TRX_N-00061-99713581,2022-03-05T09:30:53,Bilbao,expenses,internet,-42.0,1473.26
buyer_1,Luis,,1996-08-10,ES05209515179869230980,TRX_N-00062-28972193,2022-03-06T09:29:51,Bilbao,expenses,cash,-100.0,1373.26
buyer_1,Luis,,1996-08-10,ES05209515179869230980,TRX_N-00063-65157622,2022-03-06T18:01:22,Bilbao,expenses,appliances,-372.11,1001.15
buyer_1,Luis,,1996-08-10,ES05209515179869230980,TRX_N-00064-02638677,2022-03-07T09:45:48,Bilbao,expenses,water,-23.34,977.81
buyer_1,Luis,,1996-08-10,ES05209515179869230980,TRX_N-00065-86746179,2022-03-08T20:49:46,Bilbao,expenses,electricity,-69.65,908.16
buyer_1,Luis,,1996-08-10,ES05209515179869230980,TRX_N-00066-90826267,2022-03-08T21:23:04,Bilbao,expenses,phone,-35.12,873.04
buyer_1,Luis,,1996-08-10,ES05209515179869230980,TRX_N-00067-33280273,2022-03-09T11:53:01,Bilbao,expenses,food,-61.78,811.26
buyer_1,Luis,,1996-08-10,ES05209515179869230980,TRX_N-00068-24138556,2022-03-10T12:03:36,Iru√±a de Oca,expenses,transport,-46.39,764.87
buyer_1,Luis,,1996-08-10,ES05209515179869230980,TRX_N-00069-52470175,2022-03-10T15:09:46,Bilbao,expenses,gifts,-310.37,454.5
buyer_1,Luis,,1996-08-10,ES05209515179869230980,TRX_N-00070-99007449,2022-03-11T15:47:25,Bilbao,expenses,cash,-100.0,354.5
buyer_1,Luis,,1996-08-10,ES05209515179869230980,TRX_N-00071-72128601,2022-03-13T18:52:32,Bilbao,expenses,food,-73.12,281.38
buyer_1,Luis,,1996-08-10,ES05209515179869230980,TRX_N-00072-48340066,2022-03-17T11:33:39,Eibar,expenses,food,-103.77,177.61
buyer_1,Luis,,1996-08-10,ES05209515179869230980,TRX_N-00073-70302916,2022-03-17T15:18:22,Bilbao,expenses,gifts,-235.6,-57.99
buyer_1,Luis,,1996-08-10,ES05209515179869230980,TRX_N-00074-14608918,2022-03-18T08:11:32,Bilbao,expenses,repairs,-144.49,-202.48
buyer_1,Luis,,1996-08-10,ES05209515179869230980,TRX_N-00075-54302749,2022-03-19T22:00:47,Bilbao,expenses,education,-66.26,-268.74
buyer_1,Luis,,1996-08-10,ES05209515179869230980,TRX_N-00076-26582038,2022-03-19T08:47:28,Bilbao,expenses,cash,-100.0,-368.74
buyer_1,Luis,,1996-08-10,ES05209515179869230980,TRX_N-00077-17422303,2022-03-21T11:10:43,Bilbao,expenses,clothing,-55.82,-424.56
buyer_1,Luis,,1996-08-10,ES05209515179869230980,TRX_N-00078-43415287,2022-03-22T20:14:19,Bilbao,expenses,repairs,-259.62,-684.18
buyer_1,Luis,,1996-08-10,ES05209515179869230980,TRX_N-00079-10931906,2022-03-28T15:46:08,Bilbao,expenses,transport,-45.38,-729.56
buyer_1,Luis,,1996-08-10,ES05209515179869230980,TRX_N-00080-67780618,2022-03-29T10:19:00,Bilbao,expenses,cash,-100.0,-829.56
buyer_1,Luis,,1996-08-10,ES05209515179869230980,TRX_N-00081-55630183,2022-03-31T09:59:34,Erandio,expenses,transport,-67.08,-896.64
buyer_1,Luis,,1996-08-10,ES05209515179869230980,TRX_N-00082-63912999,2022-04-01T08:51:48,Bilbao,incomes,salary,1589.41,692.77
buyer_1,Luis,,1996-08-10,ES05209515179869230980,TRX_N-00083-05852871,2022-04-01T08:51:48,Bilbao,incomes,extra_income,260.51,953.28
buyer_1,Luis,,1996-08-10,ES05209515179869230980,TRX_N-00084-99132417,2022-04-01T10:02:33,Bilbao,expenses,food,-110.45,842.83
buyer_1,Luis,,1996-08-10,ES05209515179869230980,TRX_N-00085-94975148,2022-04-01T10:17:57,Amurrio,expenses,cash,-100.0,742.83
buyer_1,Luis,,1996-08-10,ES05209515179869230980,TRX_N-00086-44364887,2022-04-02T14:20:19,Bilbao,expenses,cash,-100.0,642.83
buyer_1,Luis,,1996-08-10,ES05209515179869230980,TRX_N-00087-45976374,2022-04-04T19:31:09,Bilbao,expenses,rent,-601.82,41.01
buyer_1,Luis,,1996-08-10,ES05209515179869230980,TRX_N-00088-17904409,2022-04-05T09:10:17,Bilbao,expenses,gas,-31.46,9.55
buyer_1,Luis,,1996-08-10,ES05209515179869230980,TRX_N-00089-75643781,2022-04-05T19:06:13,Bilbao,expenses,leisure,-44.19,-34.64
buyer_1,Luis,,1996-08-10,ES05209515179869230980,TRX_N-00090-31183669,2022-04-07T20:29:56,Bilbao,expenses,water,-35.86,-70.5
buyer_1,Luis,,1996-08-10,ES05209515179869230980,TRX_N-00091-70624454,2022-04-07T15:55:19,Bilbao,expenses,transport,-89.42,-159.92
buyer_1,Luis,,1996-08-10,ES05209515179869230980,TRX_N-00092-61885286,2022-04-07T15:20:44,Bilbao,expenses,cash,-100.0,-259.92
buyer_1,Luis,,1996-08-10,ES05209515179869230980,TRX_N-00093-05194418,2022-04-08T08:13:13,Bilbao,expenses,electricity,-53.45,-313.37
buyer_1,Luis,,1996-08-10,ES05209515179869230980,TRX_N-00094-93643140,2022-04-08T20:10:18,Bilbao,expenses,internet,-42.0,-355.37
buyer_1,Luis,,1996-08-10,ES05209515179869230980,TRX_N-00095-21661229,2022-04-08T18:03:41,Bilbao,expenses,phone,-37.09,-392.46
buyer_1,Luis,,1996-08-10,ES05209515179869230980,TRX_N-00096-26219136,2022-04-09T17:24:24,Barakaldo,expenses,cash,-100.0,-492.46
buyer_1,Luis,,1996-08-10,ES05209515179869230980,TRX_N-00097-76249086,2022-04-10T10:54:07,Bilbao,expenses,food,-74.75,-567.21
buyer_1,Luis,,1996-08-10,ES05209515179869230980,TRX_N-00098-93562405,2022-04-12T12:13:14,Bilbao,expenses,food,-124.88,-692.09
buyer_1,Luis,,1996-08-10,ES05209515179869230980,TRX_N-00099-51388877,2022-04-12T14:42:30,Bilbao,expenses,leisure,-26.27,-718.36
buyer_1,Luis,,1996-08-10,ES05209515179869230980,TRX_N-00100-04485795,2022-04-12T17:59:43,Mungia,expenses,healthcare,-40.54,-758.9
buyer_1,Luis,,1996-08-10,ES05209515179869230980,TRX_N-00101-35512656,2022-04-13T01:03:26,Bilbao,expenses,leisure,-39.24,-798.14
buyer_1,Luis,,1996-08-10,ES05209515179869230980,TRX_N-00102-26789337,2022-04-15T16:42:27,Bilbao,expenses,food,-63.63,-861.77
buyer_1,Luis,,1996-08-10,ES05209515179869230980,TRX_N-00103-43229944,2022-04-15T10:21:01,Bilbao,expenses,transport,-77.44,-939.21
buyer_1,Luis,,1996-08-10,ES05209515179869230980,TRX_N-00104-07758008,2022-04-16T11:26:32,Bilbao,expenses,food,-67.38,-1006.59
buyer_1,Luis,,1996-08-10,ES05209515179869230980,TRX_N-00105-41686356,2022-04-16T14:34:58,Bilbao,expenses,gifts,-499.87,-1506.46
buyer_1,Luis,,1996-08-10,ES05209515179869230980,TRX_N-00106-00410509,2022-04-18T14:28:34,Bilbao,expenses,cash,-100.0,-1606.46
buyer_1,Luis,,1996-08-10,ES05209515179869230980,TRX_N-00107-54852520,2022-04-19T10:58:35,Bilbao,expenses,transport,-49.0,-1655.46
buyer_1,Luis,,1996-08-10,ES05209515179869230980,TRX_N-00108-78294538,2022-04-19T18:54:00,Bilbao,expenses,gifts,-727.86,-2383.32
buyer_1,Luis,,1996-08-10,ES05209515179869230980,TRX_N-00109-78544882,2022-04-21T09:49:43,Bilbao,expenses,repairs,-120.64,-2503.96
buyer_1,Luis,,1996-08-10,ES05209515179869230980,TRX_N-00110-01770892,2022-04-22T05:33:09,Bilbao,expenses,transport,-85.32,-2589.28
buyer_1,Luis,,1996-08-10,ES05209515179869230980,TRX_N-00111-38553352,2022-04-22T10:12:45,Bilbao,expenses,healthcare,-171.65,-2760.93
buyer_1,Luis,,1996-08-10,ES05209515179869230980,TRX_N-00112-71013834,2022-04-22T22:01:07,Hondarribia,expenses,cash,-100.0,-2860.93
buyer_1,Luis,,1996-08-10,ES05209515179869230980,TRX_N-00113-19071787,2022-04-23T11:10:13,Bilbao,expenses,leisure,-84.12,-2945.05
buyer_1,Luis,,1996-08-10,ES05209515179869230980,TRX_N-00114-76185993,2022-04-24T10:49:21,Bilbao,expenses,leisure,-38.8,-2983.85
buyer_1,Luis,,1996-08-10,ES05209515179869230980,TRX_N-00115-73293883,2022-04-25T12:20:33,Bilbao,expenses,food,-122.6,-3106.45
buyer_1,Luis,,1996-08-10,ES05209515179869230980,TRX_N-00116-42966091,2022-04-27T09:43:38,Bilbao,expenses,clothing,-118.92,-3225.37
buyer_1,Luis,,1996-08-10,ES05209515179869230980,TRX_N-00117-84862819,2022-04-28T15:05:53,Bilbao,expenses,repairs,-183.1,-3408.47
buyer_1,Luis,,1996-08-10,ES05209515179869230980,TRX_N-00118-74127796,2022-04-29T11:51:33,Bilbao,expenses,healthcare,-60.24,-3468.71
buyer_1,Luis,,1996-08-10,ES05209515179869230980,TRX_N-00119-66334522,2022-04-30T08:46:32,Bilbao,expenses,food,-72.79,-3541.5
buyer_1,Luis,,1996-08-10,ES05209515179869230980,TRX_N-00120-26140344,2022-05-01T19:03:12,Bilbao,incomes,salary,1589.41,-1952.09
buyer_1,Luis,,1996-08-10,ES05209515179869230980,TRX_N-00121-25923549,2022-05-01T19:21:24,Bilbao,expenses,car,-216.34,-2168.43
buyer_1,Luis,,1996-08-10,ES05209515179869230980,TRX_N-00122-57684164,2022-05-03T15:25:58,Bilbao,expenses,food,-104.03,-2272.46
buyer_1,Luis,,1996-08-10,ES05209515179869230980,TRX_N-00123-13376868,2022-05-03T01:05:23,Bilbao,expenses,cash,-100.0,-2372.46
buyer_1,Luis,,1996-08-10,ES05209515179869230980,TRX_N-00124-97357751,2022-05-04T15:19:38,Bilbao,expenses,rent,-601.82,-2974.28
buyer_1,Luis,,1996-08-10,ES05209515179869230980,TRX_N-00125-85597254,2022-05-05T08:58:51,Bilbao,expenses,electricity,-32.08,-3006.36
buyer_1,Luis,,1996-08-10,ES05209515179869230980,TRX_N-00126-27782117,2022-05-05T11:53:09,Bilbao,expenses,food,-95.23,-3101.59
buyer_1,Luis,,1996-08-10,ES05209515179869230980,TRX_N-00127-18347903,2022-05-06T13:53:23,Bilbao,expenses,phone,-43.3,-3144.89
buyer_1,Luis,,1996-08-10,ES05209515179869230980,TRX_N-00128-60603748,2022-05-07T14:23:05,Bilbao,expenses,gas,-94.7,-3239.59
buyer_1,Luis,,1996-08-10,ES05209515179869230980,TRX_N-00129-29392237,2022-05-07T16:37:52,Bilbao,expenses,appliances,-130.85,-3370.44
buyer_1,Luis,,1996-08-10,ES05209515179869230980,TRX_N-00130-76617857,2022-05-08T20:17:46,Bilbao,expenses,water,-29.39,-3399.83
buyer_1,Luis,,1996-08-10,ES05209515179869230980,TRX_N-00131-27470393,2022-05-08T15:17:08,Bilbao,expenses,internet,-42.0,-3441.83
buyer_1,Luis,,1996-08-10,ES05209515179869230980,TRX_N-00132-13598994,2022-05-08T21:17:49,Bilbao,expenses,food,-92.02,-3533.85
buyer_1,Luis,,1996-08-10,ES05209515179869230980,TRX_N-00133-61048617,2022-05-09T16:07:14,Salvatierra/Agurain,expenses,travel,-1099.0,-4632.85
buyer_1,Luis,,1996-08-10,ES05209515179869230980,TRX_N-00134-77232337,2022-05-10T15:16:11,Zarautz,expenses,transport,-54.3,-4687.15
buyer_1,Luis,,1996-08-10,ES05209515179869230980,TRX_N-00135-07365475,2022-05-11T14:29:18,Bilbao,expenses,food,-124.38,-4811.53
buyer_1,Luis,,1996-08-10,ES05209515179869230980,TRX_N-00136-55433096,2022-05-12T15:18:27,Bilbao,expenses,healthcare,-39.57,-4851.1
buyer_1,Luis,,1996-08-10,ES05209515179869230980,TRX_N-00137-26547940,2022-05-12T11:26:30,Bilbao,expenses,cash,-100.0,-4951.1
buyer_1,Luis,,1996-08-10,ES05209515179869230980,TRX_N-00138-96390325,2022-05-13T18:25:31,Bilbao,expenses,food,-79.12,-5030.22
buyer_1,Luis,,1996-08-10,ES05209515179869230980,TRX_N-00139-66465266,2022-05-13T14:58:48,Bilbao,expenses,transport,-62.37,-5092.59
buyer_1,Luis,,1996-08-10,ES05209515179869230980,TRX_N-00140-47839680,2022-05-15T21:47:59,Bilbao,expenses,food,-103.27,-5195.86
buyer_1,Luis,,1996-08-10,ES05209515179869230980,TRX_N-00141-19557450,2022-05-17T17:34:41,Bilbao,expenses,cash,-100.0,-5295.86
buyer_1,Luis,,1996-08-10,ES05209515179869230980,TRX_N-00142-94731678,2022-05-25T12:57:05,Bilbao,expenses,cash,-100.0,-5395.86
buyer_1,Luis,,1996-08-10,ES05209515179869230980,TRX_N-00143-38002259,2022-05-28T12:52:50,Bilbao,expenses,food,-83.49,-5479.35
buyer_1,Luis,,1996-08-10,ES05209515179869230980,TRX_N-00144-27904886,2022-05-28T13:29:11,Bilbao,expenses,appliances,-133.36,-5612.71
buyer_1,Luis,,1996-08-10,ES05209515179869230980,TRX_N-00145-92430610,2022-05-30T08:17:37,Bilbao,expenses,cash,-100.0,-5712.71
buyer_1,Luis,,1996-08-10,ES05209515179869230980,TRX_N-00146-27572720,2022-05-30T21:21:43,Bilbao,expenses,gifts,-392.31,-6105.02
buyer_1,Luis,,1996-08-10,ES05209515179869230980,TRX_N-00147-74549923,2022-06-01T15:39:53,Bilbao,incomes,salary,1589.41,-4515.61
buyer_1,Luis,,1996-08-10,ES05209515179869230980,TRX_N-00148-04493910,2022-06-01T15:39:53,Bilbao,incomes,salary_bonus,1169.12,-3346.49
buyer_1,Luis,,1996-08-10,ES05209515179869230980,TRX_N-00149-39213463,2022-06-01T15:37:16,Bilbao,expenses,taxes,-1558.76,-4905.25
buyer_1,Luis,,1996-08-10,ES05209515179869230980,TRX_N-00150-33502460,2022-06-01T18:51:18,Bilbao,expenses,insurance,-342.59,-5247.84
buyer_1,Luis,,1996-08-10,ES05209515179869230980,TRX_N-00151-69903014,2022-06-01T17:33:27,Bilbao,expenses,leisure,-44.14,-5291.98
buyer_1,Luis,,1996-08-10,ES05209515179869230980,TRX_N-00152-30130482,2022-06-01T12:27:04,Bilbao,expenses,cash,-100.0,-5391.98
buyer_1,Luis,,1996-08-10,ES05209515179869230980,TRX_N-00153-86407721,2022-06-02T13:46:31,Bilbao,expenses,transport,-58.52,-5450.5
buyer_1,Luis,,1996-08-10,ES05209515179869230980,TRX_N-00154-46307475,2022-06-04T11:45:12,Bilbao,expenses,rent,-601.82,-6052.32
buyer_1,Luis,,1996-08-10,ES05209515179869230980,TRX_N-00155-76335733,2022-06-04T19:18:45,Bilbao,expenses,food,-83.36,-6135.68
buyer_1,Luis,,1996-08-10,ES05209515179869230980,TRX_N-00156-04235625,2022-06-05T16:53:33,Bilbao,expenses,internet,-42.0,-6177.68
buyer_1,Luis,,1996-08-10,ES05209515179869230980,TRX_N-00157-82013452,2022-06-06T10:30:33,Bilbao,expenses,gas,-62.82,-6240.5
buyer_1,Luis,,1996-08-10,ES05209515179869230980,TRX_N-00158-30795437,2022-06-06T16:04:56,Bilbao,expenses,phone,-36.94,-6277.44
buyer_1,Luis,,1996-08-10,ES05209515179869230980,TRX_N-00159-82234795,2022-06-08T14:03:41,Bilbao,expenses,water,-40.89,-6318.33
buyer_1,Luis,,1996-08-10,ES05209515179869230980,TRX_N-00160-49097778,2022-06-08T20:03:19,Bilbao,expenses,electricity,-30.9,-6349.23
buyer_1,Luis,,1996-08-10,ES05209515179869230980,TRX_N-00161-26040820,2022-06-08T20:49:29,Bilbao,expenses,cash,-100.0,-6449.23
buyer_1,Luis,,1996-08-10,ES05209515179869230980,TRX_N-00162-37687472,2022-06-08T14:20:15,Bilbao,expenses,gifts,-362.41,-6811.64
buyer_1,Luis,,1996-08-10,ES05209515179869230980,TRX_N-00163-19731149,2022-06-09T18:19:55,Leioa,expenses,transport,-78.48,-6890.12
buyer_1,Luis,,1996-08-10,ES05209515179869230980,TRX_N-00164-75632681,2022-06-09T08:44:26,Bilbao,expenses,healthcare,-176.04,-7066.16
buyer_1,Luis,,1996-08-10,ES05209515179869230980,TRX_N-00165-48620217,2022-06-09T11:32:38,Bilbao,expenses,repairs,-31.51,-7097.67
buyer_1,Luis,,1996-08-10,ES05209515179869230980,TRX_N-00166-86879168,2022-06-10T10:22:05,Bilbao,expenses,cash,-100.0,-7197.67
buyer_1,Luis,,1996-08-10,ES05209515179869230980,TRX_N-00167-78384647,2022-06-12T18:19:45,Bilbao,expenses,food,-107.52,-7305.19
buyer_1,Luis,,1996-08-10,ES05209515179869230980,TRX_N-00168-45553962,2022-06-12T13:06:28,Bilbao,expenses,leisure,-72.96,-7378.15
buyer_1,Luis,,1996-08-10,ES05209515179869230980,TRX_N-00169-77242211,2022-06-16T19:28:38,Bilbao,expenses,cash,-100.0,-7478.15
buyer_1,Luis,,1996-08-10,ES05209515179869230980,TRX_N-00170-90891273,2022-06-17T06:42:30,Zarautz,expenses,transport,-77.49,-7555.64
buyer_1,Luis,,1996-08-10,ES05209515179869230980,TRX_N-00171-86697513,2022-06-17T12:48:41,Eibar,expenses,leisure,-56.31,-7611.95
buyer_1,Luis,,1996-08-10,ES05209515179869230980,TRX_N-00172-80593797,2022-06-17T10:46:35,Bilbao,expenses,car,-241.07,-7853.02
buyer_1,Luis,,1996-08-10,ES05209515179869230980,TRX_N-00173-89851690,2022-06-19T07:46:13,Bilbao,expenses,leisure,-59.89,-7912.91
buyer_1,Luis,,1996-08-10,ES05209515179869230980,TRX_N-00174-00057784,2022-06-20T20:38:06,Bilbao,expenses,transport,-72.69,-7985.6
buyer_1,Luis,,1996-08-10,ES05209515179869230980,TRX_N-00175-26377539,2022-06-20T11:39:58,Bilbao,expenses,healthcare,-134.3,-8119.9
buyer_1,Luis,,1996-08-10,ES05209515179869230980,TRX_N-00176-30282311,2022-06-20T16:23:34,Bilbao,expenses,repairs,-145.41,-8265.31
buyer_1,Luis,,1996-08-10,ES05209515179869230980,TRX_N-00177-19464263,2022-06-21T12:31:21,Bilbao,expenses,appliances,-307.92,-8573.23
buyer_1,Luis,,1996-08-10,ES05209515179869230980,TRX_N-00178-63311402,2022-06-22T16:08:34,Bilbao,expenses,repairs,-92.72,-8665.95
buyer_1,Luis,,1996-08-10,ES05209515179869230980,TRX_N-00179-43653668,2022-06-23T11:10:34,Bilbao,expenses,cash,-100.0,-8765.95
buyer_1,Luis,,1996-08-10,ES05209515179869230980,TRX_N-00180-18494667,2022-06-24T08:09:59,Bilbao,expenses,food,-90.48,-8856.43
buyer_1,Luis,,1996-08-10,ES05209515179869230980,TRX_N-00181-17566256,2022-06-24T20:43:33,Bilbao,expenses,leisure,-65.44,-8921.87
buyer_1,Luis,,1996-08-10,ES05209515179869230980,TRX_N-00182-31823013,2022-06-24T12:21:02,Bilbao,expenses,cash,-100.0,-9021.87
buyer_1,Luis,,1996-08-10,ES05209515179869230980,TRX_N-00183-12954539,2022-06-25T06:12:53,Bilbao,expenses,leisure,-24.61,-9046.48
buyer_1,Luis,,1996-08-10,ES05209515179869230980,TRX_N-00184-53941544,2022-06-27T10:25:43,Labastida,expenses,food,-91.73,-9138.21
buyer_1,Luis,,1996-08-10,ES05209515179869230980,TRX_N-00185-02746727,2022-06-28T09:00:37,Bilbao,expenses,repairs,-326.35,-9464.56
buyer_1,Luis,,1996-08-10,ES05209515179869230980,TRX_N-00186-34663114,2022-06-29T18:48:52,Bilbao,expenses,repairs,-237.5,-9702.06
buyer_1,Luis,,1996-08-10,ES05209515179869230980,TRX_N-00187-51360250,2022-06-30T19:43:32,Bilbao,expenses,appliances,-355.7,-10057.76
buyer_1,Luis,,1996-08-10,ES05209515179869230980,TRX_N-00188-19427086,2022-07-01T19:44:15,Bilbao,incomes,salary,1589.41,-8468.35
buyer_1,Luis,,1996-08-10,ES05209515179869230980,TRX_N-00189-54808785,2022-07-02T12:26:21,Bilbao,expenses,healthcare,-149.28,-8617.63
buyer_1,Luis,,1996-08-10,ES05209515179869230980,TRX_N-00190-31085416,2022-07-04T12:43:15,Bilbao,expenses,rent,-601.82,-9219.45
buyer_1,Luis,,1996-08-10,ES05209515179869230980,TRX_N-00191-33849901,2022-07-05T16:08:10,Bilbao,expenses,gas,-81.6,-9301.05
buyer_1,Luis,,1996-08-10,ES05209515179869230980,TRX_N-00192-60436272,2022-07-05T09:21:05,Bilbao,expenses,food,-97.98,-9399.03
buyer_1,Luis,,1996-08-10,ES05209515179869230980,TRX_N-00193-48773730,2022-07-06T19:24:12,Bilbao,expenses,gifts,-632.4,-10031.43
buyer_1,Luis,,1996-08-10,ES05209515179869230980,TRX_N-00194-26040495,2022-07-07T08:25:06,Bilbao,expenses,electricity,-58.54,-10089.97
buyer_1,Luis,,1996-08-10,ES05209515179869230980,TRX_N-00195-70793046,2022-07-07T20:50:48,Bilbao,expenses,internet,-42.0,-10131.97
buyer_1,Luis,,1996-08-10,ES05209515179869230980,TRX_N-00196-89961722,2022-07-08T10:28:01,Bilbao,expenses,water,-30.99,-10162.96
buyer_1,Luis,,1996-08-10,ES05209515179869230980,TRX_N-00197-72943312,2022-07-08T11:39:19,Bilbao,expenses,phone,-32.39,-10195.35
buyer_1,Luis,,1996-08-10,ES05209515179869230980,TRX_N-00198-83962113,2022-07-08T06:48:34,Bilbao,expenses,transport,-67.43,-10262.78
buyer_1,Luis,,1996-08-10,ES05209515179869230980,TRX_N-00199-62827321,2022-07-08T16:14:48,Bilbao,expenses,leisure,-29.77,-10292.55
buyer_1,Luis,,1996-08-10,ES05209515179869230980,TRX_N-00200-53423319,2022-07-08T13:45:31,Erandio,expenses,cash,-100.0,-10392.55
buyer_1,Luis,,1996-08-10,ES05209515179869230980,TRX_N-00201-49527358,2022-07-09T08:56:13,Bilbao,expenses,leisure,-55.25,-10447.8
buyer_1,Luis,,1996-08-10,ES05209515179869230980,TRX_N-00202-66943152,2022-07-09T08:04:17,Bilbao,expenses,gifts,-577.03,-11024.83
buyer_1,Luis,,1996-08-10,ES05209515179869230980,TRX_N-00203-51211305,2022-07-10T09:40:47,Bilbao,expenses,cash,-100.0,-11124.83
buyer_1,Luis,,1996-08-10,ES05209515179869230980,TRX_N-00204-83366038,2022-07-12T16:04:14,Bilbao,expenses,clothing,-150.84,-11275.67
buyer_1,Luis,,1996-08-10,ES05209515179869230980,TRX_N-00205-60234879,2022-07-13T11:23:56,Bilbao,expenses,clothing,-102.39,-11378.06
buyer_1,Luis,,1996-08-10,ES05209515179869230980,TRX_N-00206-77331454,2022-07-14T06:35:02,Bilbao,expenses,cash,-100.0,-11478.06
buyer_1,Luis,,1996-08-10,ES05209515179869230980,TRX_N-00207-77682545,2022-07-17T07:05:36,Bilbao,expenses,food,-96.76,-11574.82
buyer_1,Luis,,1996-08-10,ES05209515179869230980,TRX_N-00208-68089206,2022-07-17T11:00:30,Bilbao,expenses,cash,-100.0,-11674.82
buyer_1,Luis,,1996-08-10,ES05209515179869230980,TRX_N-00209-75858285,2022-07-18T10:15:14,Bilbao,expenses,food,-85.18,-11760.0
buyer_1,Luis,,1996-08-10,ES05209515179869230980,TRX_N-00210-87603520,2022-07-18T17:12:38,Bilbao,expenses,cash,-100.0,-11860.0
buyer_1,Luis,,1996-08-10,ES05209515179869230980,TRX_N-00211-85501379,2022-07-20T13:50:36,Bilbao,expenses,cash,-100.0,-11960.0
buyer_1,Luis,,1996-08-10,ES05209515179869230980,TRX_N-00212-78733762,2022-07-21T22:00:32,Bilbao,expenses,cash,-100.0,-12060.0
buyer_1,Luis,,1996-08-10,ES05209515179869230980,TRX_N-00213-99731116,2022-07-23T09:15:13,Bilbao,expenses,food,-85.77,-12145.77
buyer_1,Luis,,1996-08-10,ES05209515179869230980,TRX_N-00214-11466054,2022-07-26T08:01:04,Bilbao,expenses,cash,-100.0,-12245.77
buyer_1,Luis,,1996-08-10,ES05209515179869230980,TRX_N-00215-57276321,2022-07-27T09:56:01,Bilbao,expenses,leisure,-71.74,-12317.51
buyer_1,Luis,,1996-08-10,ES05209515179869230980,TRX_N-00216-32923260,2022-07-27T18:30:37,Arrasate,expenses,gifts,-687.01,-13004.52
buyer_1,Luis,,1996-08-10,ES05209515179869230980,TRX_N-00217-54011492,2022-07-29T09:58:20,Bilbao,expenses,leisure,-27.59,-13032.11
buyer_1,Luis,,1996-08-10,ES05209515179869230980,TRX_N-00218-04583514,2022-07-30T21:17:31,Bilbao,expenses,food,-96.35,-13128.46
buyer_1,Luis,,1996-08-10,ES05209515179869230980,TRX_N-00219-66228987,2022-07-30T13:18:28,Bilbao,expenses,cash,-100.0,-13228.46
buyer_1,Luis,,1996-08-10,ES05209515179869230980,TRX_N-00220-95784446,2022-07-30T14:26:51,Bilbao,expenses,gifts,-774.44,-14002.9
buyer_1,Luis,,1996-08-10,ES05209515179869230980,TRX_N-00221-77911876,2022-08-01T16:25:32,Bilbao,incomes,salary,1589.41,-12413.49
buyer_1,Luis,,1996-08-10,ES05209515179869230980,TRX_N-00222-26427899,2022-08-01T16:25:32,Bilbao,incomes,extra_income,260.51,-12152.98
buyer_1,Luis,,1996-08-10,ES05209515179869230980,TRX_N-00223-59854638,2022-08-01T15:54:28,Bilbao,expenses,gifts,-138.82,-12291.8
buyer_1,Luis,,1996-08-10,ES05209515179869230980,TRX_N-00224-49312124,2022-08-02T10:33:52,Zuia,expenses,repairs,-75.31,-12367.11
buyer_1,Luis,,1996-08-10,ES05209515179869230980,TRX_N-00225-95947690,2022-08-04T16:09:36,Bilbao,expenses,rent,-601.82,-12968.93
buyer_1,Luis,,1996-08-10,ES05209515179869230980,TRX_N-00226-20901842,2022-08-05T12:53:09,Bilbao,expenses,leisure,-48.85,-13017.78
buyer_1,Luis,,1996-08-10,ES05209515179869230980,TRX_N-00227-66190941,2022-08-06T13:06:35,Bilbao,expenses,electricity,-21.21,-13038.99
buyer_1,Luis,,1996-08-10,ES05209515179869230980,TRX_N-00228-13140084,2022-08-06T18:33:03,Bilbao,expenses,repairs,-219.17,-13258.16
buyer_1,Luis,,1996-08-10,ES05209515179869230980,TRX_N-00229-61642692,2022-08-07T12:49:16,Bilbao,expenses,gas,-100.11,-13358.27
buyer_1,Luis,,1996-08-10,ES05209515179869230980,TRX_N-00230-09331247,2022-08-07T08:58:07,Bilbao,expenses,internet,-42.0,-13400.27
buyer_1,Luis,,1996-08-10,ES05209515179869230980,TRX_N-00231-29536623,2022-08-07T08:26:05,Bilbao,expenses,food,-111.15,-13511.42
buyer_1,Luis,,1996-08-10,ES05209515179869230980,TRX_N-00232-56138952,2022-08-07T22:29:32,Bilbao,expenses,appliances,-284.48,-13795.9
buyer_1,Luis,,1996-08-10,ES05209515179869230980,TRX_N-00233-22721150,2022-08-08T11:10:58,Bilbao,expenses,water,-38.55,-13834.45
buyer_1,Luis,,1996-08-10,ES05209515179869230980,TRX_N-00234-57368339,2022-08-08T12:28:12,Bilbao,expenses,phone,-33.83,-13868.28
buyer_1,Luis,,1996-08-10,ES05209515179869230980,TRX_N-00235-57715167,2022-08-08T08:18:39,Bilbao,expenses,education,-48.11,-13916.39
buyer_1,Luis,,1996-08-10,ES05209515179869230980,TRX_N-00236-84571725,2022-08-09T11:21:09,Bilbao,expenses,food,-67.56,-13983.95
buyer_1,Luis,,1996-08-10,ES05209515179869230980,TRX_N-00237-42041816,2022-08-10T13:10:24,Bilbao,expenses,cash,-100.0,-14083.95
buyer_1,Luis,,1996-08-10,ES05209515179869230980,TRX_N-00238-66034677,2022-08-10T10:12:39,Bilbao,expenses,travel,-1316.47,-15400.42
buyer_1,Luis,,1996-08-10,ES05209515179869230980,TRX_N-00239-12374824,2022-08-11T15:17:26,Santurtzi,expenses,transport,-59.12,-15459.54
buyer_1,Luis,,1996-08-10,ES05209515179869230980,TRX_N-00240-96418286,2022-08-12T23:06:26,Bilbao,expenses,cash,-100.0,-15559.54
buyer_1,Luis,,1996-08-10,ES05209515179869230980,TRX_N-00241-59823881,2022-08-13T18:49:12,Zarautz,expenses,leisure,-32.12,-15591.66
buyer_1,Luis,,1996-08-10,ES05209515179869230980,TRX_N-00242-32388478,2022-08-13T20:41:16,Bilbao,expenses,cash,-100.0,-15691.66
buyer_1,Luis,,1996-08-10,ES05209515179869230980,TRX_N-00243-02685214,2022-08-15T18:02:36,Bilbao,expenses,leisure,-71.0,-15762.66
buyer_1,Luis,,1996-08-10,ES05209515179869230980,TRX_N-00244-83142511,2022-08-15T11:24:32,Bilbao,expenses,cash,-100.0,-15862.66
buyer_1,Luis,,1996-08-10,ES05209515179869230980,TRX_N-00245-05323464,2022-08-16T17:15:58,Bilbao,expenses,transport,-82.2,-15944.86
buyer_1,Luis,,1996-08-10,ES05209515179869230980,TRX_N-00246-51768618,2022-08-18T18:18:33,Bilbao,expenses,education,-44.41,-15989.27
buyer_1,Luis,,1996-08-10,ES05209515179869230980,TRX_N-00247-30432372,2022-08-18T09:08:03,Bilbao,expenses,cash,-100.0,-16089.27
buyer_1,Luis,,1996-08-10,ES05209515179869230980,TRX_N-00248-59313211,2022-08-18T12:08:58,Getxo,expenses,gifts,-276.64,-16365.91
buyer_1,Luis,,1996-08-10,ES05209515179869230980,TRX_N-00249-59392919,2022-08-21T08:13:16,Bilbao,expenses,transport,-58.74,-16424.65
buyer_1,Luis,,1996-08-10,ES05209515179869230980,TRX_N-00250-68212668,2022-08-24T00:41:55,Bilbao,expenses,cash,-100.0,-16524.65
buyer_1,Luis,,1996-08-10,ES05209515179869230980,TRX_N-00251-92281063,2022-08-26T20:53:53,Bilbao,expenses,food,-80.83,-16605.48
buyer_1,Luis,,1996-08-10,ES05209515179869230980,TRX_N-00252-66923010,2022-08-27T13:46:57,Bilbao,expenses,repairs,-70.63,-16676.11
buyer_1,Luis,,1996-08-10,ES05209515179869230980,TRX_N-00253-73821468,2022-08-31T15:40:02,Bilbao,expenses,cash,-100.0,-16776.11
buyer_1,Luis,,1996-08-10,ES05209515179869230980,TRX_N-00254-97354939,2022-09-01T17:35:59,Bilbao,incomes,salary,1589.41,-15186.7
buyer_1,Luis,,1996-08-10,ES05209515179869230980,TRX_N-00255-54282625,2022-09-02T00:59:55,Bilbao,expenses,transport,-40.34,-15227.04
buyer_1,Luis,,1996-08-10,ES05209515179869230980,TRX_N-00256-15393243,2022-09-02T18:57:04,Bilbao,expenses,clothing,-134.78,-15361.82
buyer_1,Luis,,1996-08-10,ES05209515179869230980,TRX_N-00257-08688741,2022-09-02T20:58:02,Bilbao,expenses,healthcare,-129.27,-15491.09
buyer_1,Luis,,1996-08-10,ES05209515179869230980,TRX_N-00258-89692134,2022-09-02T22:12:58,Bilbao,expenses,repairs,-229.67,-15720.76
buyer_1,Luis,,1996-08-10,ES05209515179869230980,TRX_N-00259-14699786,2022-09-03T00:33:40,Bilbao,expenses,clothing,-82.95,-15803.71
buyer_1,Luis,,1996-08-10,ES05209515179869230980,TRX_N-00260-02322167,2022-09-03T20:27:16,Bilbao,expenses,healthcare,-160.53,-15964.24
buyer_1,Luis,,1996-08-10,ES05209515179869230980,TRX_N-00261-61263632,2022-09-04T11:14:48,Bilbao,expenses,rent,-601.82,-16566.06
buyer_1,Luis,,1996-08-10,ES05209515179869230980,TRX_N-00262-40149934,2022-09-04T15:43:38,Bilbao,expenses,transport,-68.54,-16634.6
buyer_1,Luis,,1996-08-10,ES05209515179869230980,TRX_N-00263-70986324,2022-09-04T16:01:07,Bilbao,expenses,leisure,-26.56,-16661.16
buyer_1,Luis,,1996-08-10,ES05209515179869230980,TRX_N-00264-70820922,2022-09-06T12:56:28,Bilbao,expenses,electricity,-36.47,-16697.63
buyer_1,Luis,,1996-08-10,ES05209515179869230980,TRX_N-00265-57785861,2022-09-06T23:11:10,Bilbao,expenses,gas,-103.7,-16801.33
buyer_1,Luis,,1996-08-10,ES05209515179869230980,TRX_N-00266-13572487,2022-09-06T14:24:56,Bilbao,expenses,phone,-43.04,-16844.37
buyer_1,Luis,,1996-08-10,ES05209515179869230980,TRX_N-00267-38055487,2022-09-06T21:31:30,Bilbao,expenses,cash,-100.0,-16944.37
buyer_1,Luis,,1996-08-10,ES05209515179869230980,TRX_N-00268-71158560,2022-09-07T20:52:18,Bilbao,expenses,water,-44.22,-16988.59
buyer_1,Luis,,1996-08-10,ES05209515179869230980,TRX_N-00269-69836315,2022-09-07T19:49:37,Bilbao,expenses,internet,-42.0,-17030.59
buyer_1,Luis,,1996-08-10,ES05209515179869230980,TRX_N-00270-08108310,2022-09-08T14:52:33,Bilbao,expenses,transport,-80.18,-17110.77
buyer_1,Luis,,1996-08-10,ES05209515179869230980,TRX_N-00271-41266108,2022-09-09T09:02:20,Bilbao,expenses,transport,-77.04,-17187.81
buyer_1,Luis,,1996-08-10,ES05209515179869230980,TRX_N-00272-27441472,2022-09-10T10:01:30,Bilbao,expenses,leisure,-44.64,-17232.45
buyer_1,Luis,,1996-08-10,ES05209515179869230980,TRX_N-00273-65410041,2022-09-11T02:17:55,Bilbao,expenses,food,-124.3,-17356.75
buyer_1,Luis,,1996-08-10,ES05209515179869230980,TRX_N-00274-76372646,2022-09-13T18:58:45,Bilbao,expenses,appliances,-352.16,-17708.91
buyer_1,Luis,,1996-08-10,ES05209515179869230980,TRX_N-00275-35723533,2022-09-15T14:53:14,Bilbao,expenses,transport,-44.65,-17753.56
buyer_1,Luis,,1996-08-10,ES05209515179869230980,TRX_N-00276-75269227,2022-09-15T15:58:03,Bilbao,expenses,cash,-100.0,-17853.56
buyer_1,Luis,,1996-08-10,ES05209515179869230980,TRX_N-00277-31257816,2022-09-15T05:57:34,Bilbao,expenses,repairs,-267.5,-18121.06
buyer_1,Luis,,1996-08-10,ES05209515179869230980,TRX_N-00278-94658815,2022-09-16T22:54:23,Erandio,expenses,cash,-100.0,-18221.06
buyer_1,Luis,,1996-08-10,ES05209515179869230980,TRX_N-00279-50444549,2022-09-19T13:50:21,Bilbao,expenses,gifts,-188.22,-18409.28
buyer_1,Luis,,1996-08-10,ES05209515179869230980,TRX_N-00280-62626724,2022-09-20T20:39:02,Bilbao,expenses,leisure,-39.42,-18448.7
buyer_1,Luis,,1996-08-10,ES05209515179869230980,TRX_N-00281-85289480,2022-09-21T12:09:07,Bilbao,expenses,cash,-100.0,-18548.7
buyer_1,Luis,,1996-08-10,ES05209515179869230980,TRX_N-00282-74347449,2022-09-21T22:19:00,Bilbao,expenses,repairs,-293.95,-18842.65
buyer_1,Luis,,1996-08-10,ES05209515179869230980,TRX_N-00283-74096609,2022-09-23T15:39:18,Bilbao,expenses,cash,-100.0,-18942.65
buyer_1,Luis,,1996-08-10,ES05209515179869230980,TRX_N-00284-61687174,2022-09-27T09:39:47,Bilbao,expenses,cash,-100.0,-19042.65
buyer_1,Luis,,1996-08-10,ES05209515179869230980,TRX_N-00285-71809503,2022-09-28T17:41:11,Pasaia,expenses,food,-85.76,-19128.41
buyer_1,Luis,,1996-08-10,ES05209515179869230980,TRX_N-00286-96518176,2022-09-28T12:00:53,Irun,expenses,appliances,-356.63,-19485.04
buyer_1,Luis,,1996-08-10,ES05209515179869230980,TRX_N-00287-28830692,2022-09-29T05:59:07,Bilbao,expenses,cash,-100.0,-19585.04
buyer_1,Luis,,1996-08-10,ES05209515179869230980,TRX_N-00288-74738037,2022-09-30T22:41:35,Mungia,expenses,repairs,-308.87,-19893.91
buyer_1,Luis,,1996-08-10,ES05209515179869230980,TRX_N-00289-58281241,2022-10-01T14:52:49,Bilbao,incomes,salary,1589.41,-18304.5
buyer_1,Luis,,1996-08-10,ES05209515179869230980,TRX_N-00290-12751990,2022-10-01T19:59:03,Bilbao,expenses,transport,-77.44,-18381.94
buyer_1,Luis,,1996-08-10,ES05209515179869230980,TRX_N-00291-05819654,2022-10-01T14:41:24,Bilbao,expenses,appliances,-186.62,-18568.56
buyer_1,Luis,,1996-08-10,ES05209515179869230980,TRX_N-00292-85132196,2022-10-01T22:59:17,Bilbao,expenses,repairs,-182.65,-18751.21
buyer_1,Luis,,1996-08-10,ES05209515179869230980,TRX_N-00293-22321544,2022-10-02T11:56:53,Bilbao,expenses,education,-78.32,-18829.53
buyer_1,Luis,,1996-08-10,ES05209515179869230980,TRX_N-00294-12074013,2022-10-02T02:31:16,Bilbao,expenses,repairs,-186.96,-19016.49
buyer_1,Luis,,1996-08-10,ES05209515179869230980,TRX_N-00295-17996416,2022-10-03T11:55:52,Bilbao,expenses,appliances,-203.03,-19219.52
buyer_1,Luis,,1996-08-10,ES05209515179869230980,TRX_N-00296-04668544,2022-10-04T18:56:47,Bilbao,expenses,rent,-601.82,-19821.34
buyer_1,Luis,,1996-08-10,ES05209515179869230980,TRX_N-00297-31451805,2022-10-04T12:05:21,Bilbao,expenses,cash,-100.0,-19921.34
buyer_1,Luis,,1996-08-10,ES05209515179869230980,TRX_N-00298-67115135,2022-10-05T18:45:41,Bilbao,expenses,electricity,-58.14,-19979.48
buyer_1,Luis,,1996-08-10,ES05209515179869230980,TRX_N-00299-32877809,2022-10-05T20:32:49,Bilbao,expenses,gas,-48.26,-20027.74
buyer_1,Luis,,1996-08-10,ES05209515179869230980,TRX_N-00300-51689129,2022-10-07T08:40:52,Bilbao,expenses,water,-28.82,-20056.56
buyer_1,Luis,,1996-08-10,ES05209515179869230980,TRX_N-00301-55578193,2022-10-07T09:48:18,Bilbao,expenses,food,-75.51,-20132.07
buyer_1,Luis,,1996-08-10,ES05209515179869230980,TRX_N-00302-91217682,2022-10-07T15:46:39,Bilbao,expenses,leisure,-55.16,-20187.23
buyer_1,Luis,,1996-08-10,ES05209515179869230980,TRX_N-00303-71755910,2022-10-08T08:35:55,Bilbao,expenses,internet,-42.0,-20229.23
buyer_1,Luis,,1996-08-10,ES05209515179869230980,TRX_N-00304-29123726,2022-10-08T13:11:14,Bilbao,expenses,phone,-35.27,-20264.5
buyer_1,Luis,,1996-08-10,ES05209515179869230980,TRX_N-00305-06446490,2022-10-08T17:57:53,Bilbao,expenses,gifts,-468.49,-20732.99
buyer_1,Luis,,1996-08-10,ES05209515179869230980,TRX_N-00306-42751443,2022-10-09T18:02:36,Bilbao,expenses,cash,-100.0,-20832.99
buyer_1,Luis,,1996-08-10,ES05209515179869230980,TRX_N-00307-12522568,2022-10-10T02:34:47,Bilbao,expenses,transport,-75.4,-20908.39
buyer_1,Luis,,1996-08-10,ES05209515179869230980,TRX_N-00308-93777792,2022-10-10T13:25:41,Bilbao,expenses,education,-69.08,-20977.47
buyer_1,Luis,,1996-08-10,ES05209515179869230980,TRX_N-00309-46608732,2022-10-11T13:02:22,Amurrio,expenses,food,-63.41,-21040.88
buyer_1,Luis,,1996-08-10,ES05209515179869230980,TRX_N-00310-70065454,2022-10-11T12:10:36,Bilbao,expenses,gifts,-781.53,-21822.41
buyer_1,Luis,,1996-08-10,ES05209515179869230980,TRX_N-00311-53271239,2022-10-12T08:45:06,Galdakao,expenses,transport,-62.58,-21884.99
buyer_1,Luis,,1996-08-10,ES05209515179869230980,TRX_N-00312-57076329,2022-10-12T12:43:20,Bilbao,expenses,leisure,-20.53,-21905.52
buyer_1,Luis,,1996-08-10,ES05209515179869230980,TRX_N-00313-21309598,2022-10-12T13:26:52,Bilbao,expenses,travel,-1254.58,-23160.1
buyer_1,Luis,,1996-08-10,ES05209515179869230980,TRX_N-00314-67803003,2022-10-13T08:19:32,Donostia,expenses,repairs,-277.86,-23437.96
buyer_1,Luis,,1996-08-10,ES05209515179869230980,TRX_N-00315-07496680,2022-10-15T20:38:19,Irun,expenses,leisure,-45.55,-23483.51
buyer_1,Luis,,1996-08-10,ES05209515179869230980,TRX_N-00316-92844348,2022-10-17T13:00:25,Bilbao,expenses,food,-94.03,-23577.54
buyer_1,Luis,,1996-08-10,ES05209515179869230980,TRX_N-00317-00972666,2022-10-20T13:44:18,Bilbao,expenses,food,-112.73,-23690.27
buyer_1,Luis,,1996-08-10,ES05209515179869230980,TRX_N-00318-09369764,2022-10-20T01:14:06,Bilbao,expenses,leisure,-68.83,-23759.1
buyer_1,Luis,,1996-08-10,ES05209515179869230980,TRX_N-00319-88994346,2022-10-21T13:46:23,Irun,expenses,leisure,-56.36,-23815.46
buyer_1,Luis,,1996-08-10,ES05209515179869230980,TRX_N-00320-86446194,2022-10-21T07:03:25,Hondarribia,expenses,education,-53.39,-23868.85
buyer_1,Luis,,1996-08-10,ES05209515179869230980,TRX_N-00321-83816945,2022-10-21T13:05:18,Bilbao,expenses,repairs,-74.43,-23943.28
buyer_1,Luis,,1996-08-10,ES05209515179869230980,TRX_N-00322-70781578,2022-10-22T15:13:16,Bilbao,expenses,leisure,-22.2,-23965.48
buyer_1,Luis,,1996-08-10,ES05209515179869230980,TRX_N-00323-69020593,2022-10-23T22:03:33,Bilbao,expenses,food,-115.94,-24081.42
buyer_1,Luis,,1996-08-10,ES05209515179869230980,TRX_N-00324-88614073,2022-10-25T13:12:54,Bilbao,expenses,food,-100.86,-24182.28
buyer_1,Luis,,1996-08-10,ES05209515179869230980,TRX_N-00325-10208608,2022-10-25T06:47:00,Bilbao,expenses,leisure,-44.9,-24227.18
buyer_1,Luis,,1996-08-10,ES05209515179869230980,TRX_N-00326-40883868,2022-10-25T13:26:13,Bilbao,expenses,travel,-1200.78,-25427.96
buyer_1,Luis,,1996-08-10,ES05209515179869230980,TRX_N-00327-16754278,2022-10-25T22:59:59,Bilbao,expenses,repairs,-201.5,-25629.46
buyer_1,Luis,,1996-08-10,ES05209515179869230980,TRX_N-00328-40845992,2022-10-26T21:58:37,Bilbao,expenses,food,-85.06,-25714.52
buyer_1,Luis,,1996-08-10,ES05209515179869230980,TRX_N-00329-24471991,2022-10-27T22:29:28,Pasaia,expenses,appliances,-261.02,-25975.54
buyer_1,Luis,,1996-08-10,ES05209515179869230980,TRX_N-00330-00007286,2022-10-28T14:32:08,Bilbao,expenses,appliances,-206.79,-26182.33
buyer_1,Luis,,1996-08-10,ES05209515179869230980,TRX_N-00331-95431237,2022-10-29T21:31:55,Bilbao,expenses,cash,-100.0,-26282.33
buyer_1,Luis,,1996-08-10,ES05209515179869230980,TRX_N-00332-22152892,2022-10-29T08:27:24,Bilbao,expenses,gifts,-310.95,-26593.28
buyer_1,Luis,,1996-08-10,ES05209515179869230980,TRX_N-00333-14823110,2022-10-30T12:12:10,Alegr√≠a-Dulantzi,expenses,cash,-100.0,-26693.28
buyer_1,Luis,,1996-08-10,ES05209515179869230980,TRX_N-00334-03362123,2022-10-31T15:33:08,Arrasate,expenses,transport,-49.88,-26743.16
buyer_1,Luis,,1996-08-10,ES05209515179869230980,TRX_N-00335-52823721,2022-11-01T21:22:05,Bilbao,incomes,salary,1589.41,-25153.75
buyer_1,Luis,,1996-08-10,ES05209515179869230980,TRX_N-00336-94918113,2022-11-01T21:22:05,Bilbao,incomes,extra_income,260.51,-24893.24
buyer_1,Luis,,1996-08-10,ES05209515179869230980,TRX_N-00337-23998423,2022-11-01T18:25:00,Iru√±a de Oca,expenses,leisure,-82.11,-24975.35
buyer_1,Luis,,1996-08-10,ES05209515179869230980,TRX_N-00338-64360772,2022-11-01T13:07:52,Bilbao,expenses,clothing,-150.18,-25125.53
buyer_1,Luis,,1996-08-10,ES05209515179869230980,TRX_N-00339-35134508,2022-11-01T20:38:35,Bilbao,expenses,repairs,-64.19,-25189.72
buyer_1,Luis,,1996-08-10,ES05209515179869230980,TRX_N-00340-82468540,2022-11-02T21:10:06,Bilbao,expenses,food,-80.35,-25270.07
buyer_1,Luis,,1996-08-10,ES05209515179869230980,TRX_N-00341-63813724,2022-11-04T17:06:33,Bilbao,expenses,rent,-601.82,-25871.89
buyer_1,Luis,,1996-08-10,ES05209515179869230980,TRX_N-00342-80934386,2022-11-05T08:29:28,Bilbao,expenses,water,-24.32,-25896.21
buyer_1,Luis,,1996-08-10,ES05209515179869230980,TRX_N-00343-86774630,2022-11-05T12:04:29,Bilbao,expenses,electricity,-20.83,-25917.04
buyer_1,Luis,,1996-08-10,ES05209515179869230980,TRX_N-00344-18996449,2022-11-05T21:07:54,Bilbao,expenses,gas,-95.98,-26013.02
buyer_1,Luis,,1996-08-10,ES05209515179869230980,TRX_N-00345-87480004,2022-11-05T16:11:41,Bilbao,expenses,leisure,-82.27,-26095.29
buyer_1,Luis,,1996-08-10,ES05209515179869230980,TRX_N-00346-33291752,2022-11-05T18:13:21,Bilbao,expenses,cash,-100.0,-26195.29
buyer_1,Luis,,1996-08-10,ES05209515179869230980,TRX_N-00347-54347222,2022-11-07T13:20:24,Bilbao,expenses,transport,-55.17,-26250.46
buyer_1,Luis,,1996-08-10,ES05209515179869230980,TRX_N-00348-97543899,2022-11-08T16:56:17,Bilbao,expenses,internet,-42.0,-26292.46
buyer_1,Luis,,1996-08-10,ES05209515179869230980,TRX_N-00349-92184821,2022-11-08T09:53:31,Bilbao,expenses,phone,-41.35,-26333.81
buyer_1,Luis,,1996-08-10,ES05209515179869230980,TRX_N-00350-63464273,2022-11-08T22:56:57,Bilbao,expenses,education,-59.69,-26393.5
buyer_1,Luis,,1996-08-10,ES05209515179869230980,TRX_N-00351-83026083,2022-11-10T16:16:36,Bilbao,expenses,healthcare,-153.19,-26546.69
buyer_1,Luis,,1996-08-10,ES05209515179869230980,TRX_N-00352-58381006,2022-11-11T09:37:18,Bilbao,expenses,leisure,-21.7,-26568.39
buyer_1,Luis,,1996-08-10,ES05209515179869230980,TRX_N-00353-49468518,2022-11-12T09:09:36,Bilbao,expenses,gifts,-664.69,-27233.08
buyer_1,Luis,,1996-08-10,ES05209515179869230980,TRX_N-00354-36491506,2022-11-16T08:52:54,Bilbao,expenses,food,-88.45,-27321.53
buyer_1,Luis,,1996-08-10,ES05209515179869230980,TRX_N-00355-42685620,2022-11-17T08:29:24,Bilbao,expenses,appliances,-286.33,-27607.86
buyer_1,Luis,,1996-08-10,ES05209515179869230980,TRX_N-00356-51439897,2022-11-18T19:54:44,Andoain,expenses,food,-98.36,-27706.22
buyer_1,Luis,,1996-08-10,ES05209515179869230980,TRX_N-00357-91082176,2022-11-18T18:42:39,Bilbao,expenses,appliances,-186.77,-27892.99
buyer_1,Luis,,1996-08-10,ES05209515179869230980,TRX_N-00358-78856344,2022-11-22T18:58:27,Bilbao,expenses,food,-98.55,-27991.54
buyer_1,Luis,,1996-08-10,ES05209515179869230980,TRX_N-00359-25047114,2022-11-22T18:02:41,Bilbao,expenses,leisure,-32.44,-28023.98
buyer_1,Luis,,1996-08-10,ES05209515179869230980,TRX_N-00360-77476868,2022-11-23T09:40:03,Bilbao,expenses,gifts,-816.34,-28840.32
buyer_1,Luis,,1996-08-10,ES05209515179869230980,TRX_N-00361-86817514,2022-11-26T19:24:36,Bilbao,expenses,cash,-100.0,-28940.32
buyer_1,Luis,,1996-08-10,ES05209515179869230980,TRX_N-00362-53776273,2022-11-28T17:03:59,Bilbao,expenses,food,-67.69,-29008.01
buyer_1,Luis,,1996-08-10,ES05209515179869230980,TRX_N-00363-06891401,2022-11-30T15:34:15,Bilbao,expenses,leisure,-79.25,-29087.26
buyer_1,Luis,,1996-08-10,ES05209515179869230980,TRX_N-00364-05025731,2022-11-30T21:13:54,Bilbao,expenses,repairs,-327.55,-29414.81
buyer_1,Luis,,1996-08-10,ES05209515179869230980,TRX_N-00365-86817855,2022-12-01T11:22:59,Bilbao,incomes,salary,1589.41,-27825.4
buyer_1,Luis,,1996-08-10,ES05209515179869230980,TRX_N-00366-79311953,2022-12-01T11:22:59,Bilbao,incomes,salary_bonus,1114.95,-26710.45
buyer_1,Luis,,1996-08-10,ES05209515179869230980,TRX_N-00367-13653240,2022-12-02T17:08:22,Bilbao,expenses,food,-85.44,-26795.89
buyer_1,Luis,,1996-08-10,ES05209515179869230980,TRX_N-00368-18622495,2022-12-03T13:27:55,Bilbao,expenses,transport,-42.45,-26838.34
buyer_1,Luis,,1996-08-10,ES05209515179869230980,TRX_N-00369-04321544,2022-12-04T18:03:37,Bilbao,expenses,rent,-601.82,-27440.16
buyer_1,Luis,,1996-08-10,ES05209515179869230980,TRX_N-00370-71028125,2022-12-04T23:23:16,Bilbao,expenses,healthcare,-181.17,-27621.33
buyer_1,Luis,,1996-08-10,ES05209515179869230980,TRX_N-00371-12884638,2022-12-05T12:41:06,Bilbao,expenses,water,-21.61,-27642.94
buyer_1,Luis,,1996-08-10,ES05209515179869230980,TRX_N-00372-43326103,2022-12-05T16:14:37,Bilbao,expenses,leisure,-53.23,-27696.17
buyer_1,Luis,,1996-08-10,ES05209515179869230980,TRX_N-00373-25138805,2022-12-06T15:17:30,Bilbao,expenses,electricity,-78.98,-27775.15
buyer_1,Luis,,1996-08-10,ES05209515179869230980,TRX_N-00374-92875793,2022-12-06T17:19:22,Bilbao,expenses,gas,-76.88,-27852.03
buyer_1,Luis,,1996-08-10,ES05209515179869230980,TRX_N-00375-13702875,2022-12-06T20:37:15,Salvatierra/Agurain,expenses,food,-87.66,-27939.69
buyer_1,Luis,,1996-08-10,ES05209515179869230980,TRX_N-00376-95798380,2022-12-07T06:27:51,Bilbao,expenses,internet,-42.0,-27981.69
buyer_1,Luis,,1996-08-10,ES05209515179869230980,TRX_N-00377-25235784,2022-12-08T09:56:17,Bilbao,expenses,phone,-43.78,-28025.47
buyer_1,Luis,,1996-08-10,ES05209515179869230980,TRX_N-00378-48839488,2022-12-09T15:29:21,Bilbao,expenses,transport,-73.69,-28099.16
buyer_1,Luis,,1996-08-10,ES05209515179869230980,TRX_N-00379-90377629,2022-12-10T09:16:21,Bilbao,expenses,cash,-100.0,-28199.16
buyer_1,Luis,,1996-08-10,ES05209515179869230980,TRX_N-00380-63814550,2022-12-11T11:28:24,Bilbao,expenses,cash,-100.0,-28299.16
buyer_1,Luis,,1996-08-10,ES05209515179869230980,TRX_N-00381-92449118,2022-12-13T08:29:59,Iru√±a de Oca,expenses,leisure,-29.38,-28328.54
buyer_1,Luis,,1996-08-10,ES05209515179869230980,TRX_N-00382-80419329,2022-12-16T14:55:07,Bilbao,expenses,transport,-50.79,-28379.33
buyer_1,Luis,,1996-08-10,ES05209515179869230980,TRX_N-00383-81137830,2022-12-17T11:36:57,Bilbao,expenses,transport,-66.18,-28445.51
buyer_1,Luis,,1996-08-10,ES05209515179869230980,TRX_N-00384-73419780,2022-12-18T18:38:37,Bilbao,expenses,food,-79.68,-28525.19
buyer_1,Luis,,1996-08-10,ES05209515179869230980,TRX_N-00385-08220056,2022-12-18T09:17:42,Bilbao,expenses,repairs,-174.91,-28700.1
buyer_1,Luis,,1996-08-10,ES05209515179869230980,TRX_N-00386-19973508,2022-12-19T16:08:59,Bilbao,expenses,education,-46.21,-28746.31
buyer_1,Luis,,1996-08-10,ES05209515179869230980,TRX_N-00387-17292578,2022-12-19T19:44:44,Getxo,expenses,gifts,-780.74,-29527.05
buyer_1,Luis,,1996-08-10,ES05209515179869230980,TRX_N-00388-22378996,2022-12-20T20:04:23,Bilbao,expenses,healthcare,-169.91,-29696.96
buyer_1,Luis,,1996-08-10,ES05209515179869230980,TRX_N-00389-89966814,2022-12-20T11:18:42,Bilbao,expenses,education,-42.3,-29739.26
buyer_1,Luis,,1996-08-10,ES05209515179869230980,TRX_N-00390-99500048,2022-12-21T11:39:35,Bilbao,expenses,cash,-100.0,-29839.26
buyer_1,Luis,,1996-08-10,ES05209515179869230980,TRX_N-00391-52814294,2022-12-21T11:38:41,Bilbao,expenses,gifts,-243.22,-30082.48
buyer_1,Luis,,1996-08-10,ES05209515179869230980,TRX_N-00392-63989086,2022-12-22T09:58:05,Bilbao,expenses,cash,-100.0,-30182.48
buyer_1,Luis,,1996-08-10,ES05209515179869230980,TRX_N-00393-92104646,2022-12-24T15:06:13,Bilbao,expenses,cash,-100.0,-30282.48
buyer_1,Luis,,1996-08-10,ES05209515179869230980,TRX_N-00394-53884410,2022-12-25T11:07:30,Bilbao,expenses,food,-102.31,-30384.79
buyer_1,Luis,,1996-08-10,ES05209515179869230980,TRX_N-00395-00833984,2022-12-26T11:21:41,Bilbao,expenses,repairs,-227.64,-30612.43
buyer_1,Luis,,1996-08-10,ES05209515179869230980,TRX_N-00396-73954989,2022-12-27T19:18:11,Amurrio,expenses,food,-109.5,-30721.93
buyer_1,Luis,,1996-08-10,ES05209515179869230980,TRX_N-00397-29507753,2022-12-27T00:02:26,Bilbao,expenses,cash,-100.0,-30821.93
buyer_1,Luis,,1996-08-10,ES05209515179869230980,TRX_N-00398-98180765,2022-12-29T08:59:01,Bermeo,expenses,cash,-100.0,-30921.93
buyer_1,Luis,,1996-08-10,ES05209515179869230980,TRX_N-00399-78543879,2023-01-01T13:44:17,Bilbao,incomes,salary,1650.0,-29271.93
buyer_1,Luis,,1996-08-10,ES05209515179869230980,TRX_N-00400-30301369,2023-01-01T20:38:22,Bilbao,expenses,gifts,-282.3,-29554.23
buyer_1,Luis,,1996-08-10,ES05209515179869230980,TRX_N-00401-27291453,2023-01-02T23:31:12,Zuia,expenses,food,-109.35,-29663.58
buyer_1,Luis,,1996-08-10,ES05209515179869230980,TRX_N-00402-70981314,2023-01-02T10:45:45,Bilbao,expenses,healthcare,-157.27,-29820.85
buyer_1,Luis,,1996-08-10,ES05209515179869230980,TRX_N-00403-30209262,2023-01-02T10:32:52,Barakaldo,expenses,repairs,-184.49,-30005.34
buyer_1,Luis,,1996-08-10,ES05209515179869230980,TRX_N-00404-78140982,2023-01-03T09:09:19,Labastida,expenses,transport,-66.68,-30072.02
buyer_1,Luis,,1996-08-10,ES05209515179869230980,TRX_N-00405-64192102,2023-01-04T11:03:37,Bilbao,expenses,rent,-601.82,-30673.84
buyer_1,Luis,,1996-08-10,ES05209515179869230980,TRX_N-00406-95131034,2023-01-05T15:16:05,Bilbao,expenses,water,-31.22,-30705.06
buyer_1,Luis,,1996-08-10,ES05209515179869230980,TRX_N-00407-76484987,2023-01-05T11:32:24,Bilbao,expenses,electricity,-86.56,-30791.62
buyer_1,Luis,,1996-08-10,ES05209515179869230980,TRX_N-00408-47186531,2023-01-05T17:09:47,Bilbao,expenses,phone,-34.07,-30825.69
buyer_1,Luis,,1996-08-10,ES05209515179869230980,TRX_N-00409-24098854,2023-01-05T15:20:49,Bilbao,expenses,repairs,-132.04,-30957.73
buyer_1,Luis,,1996-08-10,ES05209515179869230980,TRX_N-00410-45211675,2023-01-06T23:37:44,Bilbao,expenses,food,-74.39,-31032.12
buyer_1,Luis,,1996-08-10,ES05209515179869230980,TRX_N-00411-77341448,2023-01-06T13:44:42,Bilbao,expenses,leisure,-47.76,-31079.88
buyer_1,Luis,,1996-08-10,ES05209515179869230980,TRX_N-00412-63902925,2023-01-07T13:20:41,Bilbao,expenses,gas,-42.69,-31122.57
buyer_1,Luis,,1996-08-10,ES05209515179869230980,TRX_N-00413-02187950,2023-01-07T16:47:30,Bilbao,expenses,internet,-42.0,-31164.57
buyer_1,Luis,,1996-08-10,ES05209515179869230980,TRX_N-00414-63097667,2023-01-14T14:48:55,Bilbao,expenses,repairs,-232.69,-31397.26
buyer_1,Luis,,1996-08-10,ES05209515179869230980,TRX_N-00415-70813934,2023-01-16T20:24:48,Bilbao,expenses,cash,-100.0,-31497.26
buyer_1,Luis,,1996-08-10,ES05209515179869230980,TRX_N-00416-19205072,2023-01-17T15:24:53,Bilbao,expenses,leisure,-53.29,-31550.55
buyer_1,Luis,,1996-08-10,ES05209515179869230980,TRX_N-00417-23327456,2023-01-17T14:48:32,Bilbao,expenses,cash,-100.0,-31650.55
buyer_1,Luis,,1996-08-10,ES05209515179869230980,TRX_N-00418-68363462,2023-01-21T17:26:55,Bilbao,expenses,transport,-74.19,-31724.74
buyer_1,Luis,,1996-08-10,ES05209515179869230980,TRX_N-00419-71990227,2023-01-21T12:15:39,Bilbao,expenses,gifts,-118.65,-31843.39
buyer_1,Luis,,1996-08-10,ES05209515179869230980,TRX_N-00420-11114940,2023-01-22T17:14:32,Bilbao,expenses,cash,-100.0,-31943.39
buyer_1,Luis,,1996-08-10,ES05209515179869230980,TRX_N-00421-57896580,2023-01-23T17:05:28,Bilbao,expenses,food,-67.5,-32010.89
buyer_1,Luis,,1996-08-10,ES05209515179869230980,TRX_N-00422-94493291,2023-01-24T11:38:02,Bilbao,expenses,education,-61.98,-32072.87
buyer_1,Luis,,1996-08-10,ES05209515179869230980,TRX_N-00423-10239781,2023-01-24T16:47:17,Bilbao,expenses,cash,-100.0,-32172.87
buyer_1,Luis,,1996-08-10,ES05209515179869230980,TRX_N-00424-17135946,2023-01-27T11:16:06,Bilbao,expenses,transport,-60.9,-32233.77
buyer_1,Luis,,1996-08-10,ES05209515179869230980,TRX_N-00425-24336679,2023-01-28T08:26:34,Bilbao,expenses,transport,-46.96,-32280.73
buyer_1,Luis,,1996-08-10,ES05209515179869230980,TRX_N-00426-63323694,2023-01-28T16:30:05,Bilbao,expenses,healthcare,-141.78,-32422.51
buyer_1,Luis,,1996-08-10,ES05209515179869230980,TRX_N-00427-57745023,2023-01-29T02:31:46,Bilbao,expenses,food,-66.48,-32488.99
buyer_1,Luis,,1996-08-10,ES05209515179869230980,TRX_N-00428-17026956,2023-02-01T15:53:14,Bilbao,incomes,salary,1650.0,-30838.99
buyer_1,Luis,,1996-08-10,ES05209515179869230980,TRX_N-00429-67202074,2023-02-01T15:53:14,Bilbao,incomes,extra_income,260.51,-30578.48
buyer_1,Luis,,1996-08-10,ES05209515179869230980,TRX_N-00430-17784189,2023-02-01T15:08:09,Bilbao,expenses,food,-107.06,-30685.54
buyer_1,Luis,,1996-08-10,ES05209515179869230980,TRX_N-00431-31833489,2023-02-01T18:06:15,Bilbao,expenses,healthcare,-80.16,-30765.7
buyer_1,Luis,,1996-08-10,ES05209515179869230980,TRX_N-00432-11587683,2023-02-02T12:15:43,Bilbao,expenses,transport,-47.28,-30812.98
buyer_1,Luis,,1996-08-10,ES05209515179869230980,TRX_N-00433-69437577,2023-02-03T15:53:47,Bilbao,expenses,food,-122.52,-30935.5
buyer_1,Luis,,1996-08-10,ES05209515179869230980,TRX_N-00434-85345753,2023-02-04T09:12:45,Bilbao,expenses,rent,-601.82,-31537.32
buyer_1,Luis,,1996-08-10,ES05209515179869230980,TRX_N-00435-57866669,2023-02-04T20:43:19,Bilbao,expenses,leisure,-79.95,-31617.27
buyer_1,Luis,,1996-08-10,ES05209515179869230980,TRX_N-00436-91382692,2023-02-05T16:45:59,Bilbao,expenses,food,-92.15,-31709.42
buyer_1,Luis,,1996-08-10,ES05209515179869230980,TRX_N-00437-58161132,2023-02-05T08:46:34,Bilbao,expenses,clothing,-96.67,-31806.09
buyer_1,Luis,,1996-08-10,ES05209515179869230980,TRX_N-00438-19422741,2023-02-05T20:51:21,Bermeo,expenses,gifts,-807.86,-32613.95
buyer_1,Luis,,1996-08-10,ES05209515179869230980,TRX_N-00439-14741888,2023-02-06T16:10:45,Bilbao,expenses,water,-44.23,-32658.18
buyer_1,Luis,,1996-08-10,ES05209515179869230980,TRX_N-00440-60357556,2023-02-06T17:11:46,Bilbao,expenses,electricity,-24.92,-32683.1
buyer_1,Luis,,1996-08-10,ES05209515179869230980,TRX_N-00441-46720463,2023-02-06T22:17:00,Bilbao,expenses,phone,-31.29,-32714.39
buyer_1,Luis,,1996-08-10,ES05209515179869230980,TRX_N-00442-22086104,2023-02-06T13:33:32,Salvatierra/Agurain,expenses,cash,-100.0,-32814.39
buyer_1,Luis,,1996-08-10,ES05209515179869230980,TRX_N-00443-99132997,2023-02-06T13:46:53,Bilbao,expenses,repairs,-135.13,-32949.52
buyer_1,Luis,,1996-08-10,ES05209515179869230980,TRX_N-00444-37253121,2023-02-07T10:25:47,Bilbao,expenses,gas,-85.42,-33034.94
buyer_1,Luis,,1996-08-10,ES05209515179869230980,TRX_N-00445-08322451,2023-02-07T13:07:52,Bilbao,expenses,leisure,-33.75,-33068.69
buyer_1,Luis,,1996-08-10,ES05209515179869230980,TRX_N-00446-47495645,2023-02-08T22:03:03,Bilbao,expenses,internet,-42.0,-33110.69
buyer_1,Luis,,1996-08-10,ES05209515179869230980,TRX_N-00447-43078254,2023-02-08T16:39:15,Bilbao,expenses,food,-116.31,-33227.0
buyer_1,Luis,,1996-08-10,ES05209515179869230980,TRX_N-00448-36943593,2023-02-08T17:14:35,Bilbao,expenses,leisure,-34.4,-33261.4
buyer_1,Luis,,1996-08-10,ES05209515179869230980,TRX_N-00449-98712718,2023-02-09T19:20:39,Oy√≥n-Oion,expenses,leisure,-33.68,-33295.08
buyer_1,Luis,,1996-08-10,ES05209515179869230980,TRX_N-00450-07438429,2023-02-10T12:11:51,Bilbao,expenses,leisure,-65.25,-33360.33
buyer_1,Luis,,1996-08-10,ES05209515179869230980,TRX_N-00451-91153409,2023-02-11T18:00:55,Bilbao,expenses,car,-237.02,-33597.35
buyer_1,Luis,,1996-08-10,ES05209515179869230980,TRX_N-00452-66280049,2023-02-12T12:43:34,Bilbao,expenses,gifts,-245.16,-33842.51
buyer_1,Luis,,1996-08-10,ES05209515179869230980,TRX_N-00453-45241628,2023-02-13T19:48:58,Bilbao,expenses,food,-101.52,-33944.03
buyer_1,Luis,,1996-08-10,ES05209515179869230980,TRX_N-00454-02261067,2023-02-13T16:48:03,Bilbao,expenses,repairs,-175.34,-34119.37
buyer_1,Luis,,1996-08-10,ES05209515179869230980,TRX_N-00455-04534862,2023-02-14T20:40:50,Bilbao,expenses,healthcare,-115.62,-34234.99
buyer_1,Luis,,1996-08-10,ES05209515179869230980,TRX_N-00456-66654039,2023-02-17T10:13:06,Bilbao,expenses,gifts,-598.26,-34833.25
buyer_1,Luis,,1996-08-10,ES05209515179869230980,TRX_N-00457-20784534,2023-02-19T11:20:22,Bilbao,expenses,healthcare,-151.56,-34984.81
buyer_1,Luis,,1996-08-10,ES05209515179869230980,TRX_N-00458-86823633,2023-02-20T10:59:25,Irun,expenses,cash,-100.0,-35084.81
buyer_1,Luis,,1996-08-10,ES05209515179869230980,TRX_N-00459-01234967,2023-02-21T14:04:19,Bilbao,expenses,food,-81.33,-35166.14
buyer_1,Luis,,1996-08-10,ES05209515179869230980,TRX_N-00460-11821935,2023-02-21T17:13:25,Bilbao,expenses,cash,-100.0,-35266.14
buyer_1,Luis,,1996-08-10,ES05209515179869230980,TRX_N-00461-60273807,2023-02-23T21:43:27,Bilbao,expenses,leisure,-36.24,-35302.38
buyer_1,Luis,,1996-08-10,ES05209515179869230980,TRX_N-00462-82111720,2023-02-25T12:14:04,Bilbao,expenses,leisure,-44.7,-35347.08
buyer_1,Luis,,1996-08-10,ES05209515179869230980,TRX_N-00463-32372748,2023-02-26T16:31:37,Bermeo,expenses,gifts,-184.59,-35531.67
buyer_1,Luis,,1996-08-10,ES05209515179869230980,TRX_N-00464-11657147,2023-02-27T16:59:53,Bilbao,expenses,food,-122.62,-35654.29
buyer_1,Luis,,1996-08-10,ES05209515179869230980,TRX_N-00465-98384981,2023-02-28T03:50:40,Bilbao,expenses,food,-80.21,-35734.5
buyer_1,Luis,,1996-08-10,ES05209515179869230980,TRX_N-00466-49335883,2023-03-01T19:59:07,Bilbao,incomes,salary,1650.0,-34084.5
buyer_1,Luis,,1996-08-10,ES05209515179869230980,TRX_N-00467-09037105,2023-03-01T08:38:55,Bilbao,expenses,transport,-59.07,-34143.57
buyer_1,Luis,,1996-08-10,ES05209515179869230980,TRX_N-00468-11417232,2023-03-01T23:17:07,Bilbao,expenses,appliances,-199.2,-34342.77
buyer_1,Luis,,1996-08-10,ES05209515179869230980,TRX_N-00469-71384919,2023-03-03T17:10:28,Alegr√≠a-Dulantzi,expenses,education,-49.09,-34391.86
buyer_1,Luis,,1996-08-10,ES05209515179869230980,TRX_N-00470-97715650,2023-03-04T15:32:23,Bilbao,expenses,rent,-601.82,-34993.68
buyer_1,Luis,,1996-08-10,ES05209515179869230980,TRX_N-00471-72370923,2023-03-04T10:29:30,Bilbao,expenses,leisure,-18.93,-35012.61
buyer_1,Luis,,1996-08-10,ES05209515179869230980,TRX_N-00472-78039569,2023-03-04T08:44:12,Bilbao,expenses,repairs,-290.09,-35302.7
buyer_1,Luis,,1996-08-10,ES05209515179869230980,TRX_N-00473-64985397,2023-03-05T14:21:10,Bilbao,expenses,gas,-102.03,-35404.73
buyer_1,Luis,,1996-08-10,ES05209515179869230980,TRX_N-00474-12315240,2023-03-06T17:37:39,Bilbao,expenses,water,-31.05,-35435.78
buyer_1,Luis,,1996-08-10,ES05209515179869230980,TRX_N-00475-03435825,2023-03-06T11:51:11,Bilbao,expenses,internet,-42.0,-35477.78
buyer_1,Luis,,1996-08-10,ES05209515179869230980,TRX_N-00476-06553321,2023-03-06T20:17:55,Bilbao,expenses,food,-113.24,-35591.02
buyer_1,Luis,,1996-08-10,ES05209515179869230980,TRX_N-00477-81813156,2023-03-06T09:52:28,Bilbao,expenses,cash,-100.0,-35691.02
buyer_1,Luis,,1996-08-10,ES05209515179869230980,TRX_N-00478-81246535,2023-03-07T16:43:31,Bilbao,expenses,electricity,-57.82,-35748.84
buyer_1,Luis,,1996-08-10,ES05209515179869230980,TRX_N-00479-58849820,2023-03-08T14:02:17,Bilbao,expenses,phone,-33.11,-35781.95
buyer_1,Luis,,1996-08-10,ES05209515179869230980,TRX_N-00480-18035723,2023-03-08T12:49:21,Bilbao,expenses,transport,-79.43,-35861.38
buyer_1,Luis,,1996-08-10,ES05209515179869230980,TRX_N-00481-78546820,2023-03-09T15:25:05,Bilbao,expenses,food,-62.09,-35923.47
buyer_1,Luis,,1996-08-10,ES05209515179869230980,TRX_N-00482-44818841,2023-03-11T15:31:33,Bilbao,expenses,food,-68.0,-35991.47
buyer_1,Luis,,1996-08-10,ES05209515179869230980,TRX_N-00483-98157675,2023-03-15T19:57:49,Bilbao,expenses,leisure,-82.69,-36074.16
buyer_1,Luis,,1996-08-10,ES05209515179869230980,TRX_N-00484-80697788,2023-03-15T15:04:46,Bilbao,expenses,healthcare,-63.24,-36137.4
buyer_1,Luis,,1996-08-10,ES05209515179869230980,TRX_N-00485-37547854,2023-03-15T16:11:02,Bilbao,expenses,cash,-100.0,-36237.4
buyer_1,Luis,,1996-08-10,ES05209515179869230980,TRX_N-00486-45990628,2023-03-16T13:25:51,Leioa,expenses,gifts,-481.9,-36719.3
buyer_1,Luis,,1996-08-10,ES05209515179869230980,TRX_N-00487-37860487,2023-03-18T21:54:06,Bilbao,expenses,cash,-100.0,-36819.3
buyer_1,Luis,,1996-08-10,ES05209515179869230980,TRX_N-00488-58786268,2023-03-18T10:42:03,Bilbao,expenses,gifts,-86.9,-36906.2
buyer_1,Luis,,1996-08-10,ES05209515179869230980,TRX_N-00489-36280377,2023-03-19T23:57:37,Bilbao,expenses,repairs,-69.97,-36976.17
buyer_1,Luis,,1996-08-10,ES05209515179869230980,TRX_N-00490-91067810,2023-03-20T16:12:27,Bilbao,expenses,clothing,-116.24,-37092.41
buyer_1,Luis,,1996-08-10,ES05209515179869230980,TRX_N-00491-64734797,2023-03-21T15:41:46,Bilbao,expenses,cash,-100.0,-37192.41
buyer_1,Luis,,1996-08-10,ES05209515179869230980,TRX_N-00492-30475562,2023-03-23T08:12:22,Bilbao,expenses,transport,-45.62,-37238.03
buyer_1,Luis,,1996-08-10,ES05209515179869230980,TRX_N-00493-33196984,2023-03-23T10:52:08,Llodio,expenses,repairs,-165.72,-37403.75
buyer_1,Luis,,1996-08-10,ES05209515179869230980,TRX_N-00494-92926949,2023-03-25T14:02:43,Bilbao,expenses,food,-120.0,-37523.75
buyer_1,Luis,,1996-08-10,ES05209515179869230980,TRX_N-00495-74936168,2023-03-25T22:09:03,Bilbao,expenses,cash,-100.0,-37623.75
buyer_1,Luis,,1996-08-10,ES05209515179869230980,TRX_N-00496-33675093,2023-03-26T21:30:41,Donostia,expenses,leisure,-82.98,-37706.73
buyer_1,Luis,,1996-08-10,ES05209515179869230980,TRX_N-00497-18313640,2023-03-27T11:02:47,Bilbao,expenses,leisure,-53.8,-37760.53
buyer_1,Luis,,1996-08-10,ES05209515179869230980,TRX_N-00498-62154231,2023-03-28T00:52:06,Bilbao,expenses,leisure,-80.35,-37840.88
buyer_1,Luis,,1996-08-10,ES05209515179869230980,TRX_N-00499-28319395,2023-03-30T04:11:54,Erandio,expenses,cash,-100.0,-37940.88
buyer_1,Luis,,1996-08-10,ES05209515179869230980,TRX_N-00500-87098277,2023-04-01T16:02:20,Bilbao,incomes,salary,1650.0,-36290.88
buyer_1,Luis,,1996-08-10,ES05209515179869230980,TRX_N-00501-80238723,2023-04-04T11:57:43,Bilbao,expenses,rent,-601.82,-36892.7
buyer_1,Luis,,1996-08-10,ES05209515179869230980,TRX_N-00502-77655238,2023-04-04T10:54:17,Bilbao,expenses,transport,-85.1,-36977.8
buyer_1,Luis,,1996-08-10,ES05209515179869230980,TRX_N-00503-24652369,2023-04-05T17:47:13,Bilbao,expenses,water,-26.86,-37004.66
buyer_1,Luis,,1996-08-10,ES05209515179869230980,TRX_N-00504-16099586,2023-04-05T09:35:30,Bilbao,expenses,gas,-107.66,-37112.32
buyer_1,Luis,,1996-08-10,ES05209515179869230980,TRX_N-00505-41052701,2023-04-08T08:46:31,Bilbao,expenses,internet,-42.0,-37154.32
buyer_1,Luis,,1996-08-10,ES05209515179869230980,TRX_N-00506-19229504,2023-04-08T19:00:14,Bilbao,expenses,electricity,-75.83,-37230.15
buyer_1,Luis,,1996-08-10,ES05209515179869230980,TRX_N-00507-18943529,2023-04-08T02:29:08,Bilbao,expenses,phone,-42.11,-37272.26
buyer_1,Luis,,1996-08-10,ES05209515179869230980,TRX_N-00508-03463815,2023-04-08T09:56:19,Bilbao,expenses,leisure,-79.17,-37351.43
buyer_1,Luis,,1996-08-10,ES05209515179869230980,TRX_N-00509-08189495,2023-04-08T19:59:59,Bilbao,expenses,travel,-1293.76,-38645.19
buyer_1,Luis,,1996-08-10,ES05209515179869230980,TRX_N-00510-21104848,2023-04-12T21:14:53,Bilbao,expenses,transport,-42.72,-38687.91
buyer_1,Luis,,1996-08-10,ES05209515179869230980,TRX_N-00511-17959550,2023-04-13T18:39:46,Erandio,expenses,transport,-47.84,-38735.75
buyer_1,Luis,,1996-08-10,ES05209515179869230980,TRX_N-00512-60036493,2023-04-15T09:40:04,Bilbao,expenses,leisure,-36.34,-38772.09
buyer_1,Luis,,1996-08-10,ES05209515179869230980,TRX_N-00513-74225295,2023-04-15T04:24:23,Bilbao,expenses,gifts,-358.19,-39130.28
buyer_1,Luis,,1996-08-10,ES05209515179869230980,TRX_N-00514-70731492,2023-04-18T12:28:34,Bilbao,expenses,cash,-100.0,-39230.28
buyer_1,Luis,,1996-08-10,ES05209515179869230980,TRX_N-00515-84440433,2023-04-18T09:27:00,Bilbao,expenses,gifts,-845.02,-40075.3
buyer_1,Luis,,1996-08-10,ES05209515179869230980,TRX_N-00516-50046470,2023-04-19T19:36:20,Bilbao,expenses,healthcare,-38.12,-40113.42
buyer_1,Luis,,1996-08-10,ES05209515179869230980,TRX_N-00517-50117165,2023-04-20T14:35:43,Bilbao,expenses,food,-66.93,-40180.35
buyer_1,Luis,,1996-08-10,ES05209515179869230980,TRX_N-00518-86771524,2023-04-21T09:29:28,Bilbao,expenses,clothing,-85.53,-40265.88
buyer_1,Luis,,1996-08-10,ES05209515179869230980,TRX_N-00519-79073153,2023-04-23T15:18:23,Hernani,expenses,education,-67.34,-40333.22
buyer_1,Luis,,1996-08-10,ES05209515179869230980,TRX_N-00520-52477045,2023-04-24T22:47:11,Bilbao,expenses,food,-98.69,-40431.91
buyer_1,Luis,,1996-08-10,ES05209515179869230980,TRX_N-00521-94739426,2023-04-25T13:12:02,Bilbao,expenses,food,-100.43,-40532.34
buyer_1,Luis,,1996-08-10,ES05209515179869230980,TRX_N-00522-04817512,2023-04-26T13:38:02,Bilbao,expenses,food,-95.47,-40627.81
buyer_1,Luis,,1996-08-10,ES05209515179869230980,TRX_N-00523-85715627,2023-04-27T08:40:31,Bilbao,expenses,cash,-100.0,-40727.81
buyer_1,Luis,,1996-08-10,ES05209515179869230980,TRX_N-00524-86784405,2023-04-29T13:54:47,Hondarribia,expenses,food,-105.73,-40833.54
buyer_1,Luis,,1996-08-10,ES05209515179869230980,TRX_N-00525-14261445,2023-04-29T14:58:25,Bilbao,expenses,gifts,-532.04,-41365.58
buyer_1,Luis,,1996-08-10,ES05209515179869230980,TRX_N-00526-99211234,2023-05-01T23:20:02,Bilbao,incomes,salary,1650.0,-39715.58
buyer_1,Luis,,1996-08-10,ES05209515179869230980,TRX_N-00527-36543289,2023-05-01T17:40:33,Sopela,expenses,food,-61.57,-39777.15
buyer_1,Luis,,1996-08-10,ES05209515179869230980,TRX_N-00528-46063328,2023-05-02T16:14:37,Bilbao,expenses,leisure,-36.3,-39813.45
buyer_1,Luis,,1996-08-10,ES05209515179869230980,TRX_N-00529-66156054,2023-05-04T18:35:56,Bilbao,expenses,rent,-601.82,-40415.27
buyer_1,Luis,,1996-08-10,ES05209515179869230980,TRX_N-00530-82379364,2023-05-04T17:03:12,Bilbao,expenses,food,-62.65,-40477.92
buyer_1,Luis,,1996-08-10,ES05209515179869230980,TRX_N-00531-74321135,2023-05-04T10:11:17,Bilbao,expenses,gifts,-794.17,-41272.09
buyer_1,Luis,,1996-08-10,ES05209515179869230980,TRX_N-00532-25964411,2023-05-05T09:05:38,Bilbao,expenses,electricity,-85.12,-41357.21
buyer_1,Luis,,1996-08-10,ES05209515179869230980,TRX_N-00533-93059037,2023-05-05T15:06:48,Bilbao,expenses,gas,-95.11,-41452.32
buyer_1,Luis,,1996-08-10,ES05209515179869230980,TRX_N-00534-23185319,2023-05-06T08:04:18,Bilbao,expenses,food,-74.89,-41527.21
buyer_1,Luis,,1996-08-10,ES05209515179869230980,TRX_N-00535-91823912,2023-05-06T21:28:58,Bilbao,expenses,transport,-66.13,-41593.34
buyer_1,Luis,,1996-08-10,ES05209515179869230980,TRX_N-00536-71820513,2023-05-08T22:11:54,Bilbao,expenses,water,-20.3,-41613.64
buyer_1,Luis,,1996-08-10,ES05209515179869230980,TRX_N-00537-85976812,2023-05-08T20:13:02,Bilbao,expenses,internet,-42.0,-41655.64
buyer_1,Luis,,1996-08-10,ES05209515179869230980,TRX_N-00538-16176321,2023-05-08T21:37:25,Bilbao,expenses,phone,-32.65,-41688.29
buyer_1,Luis,,1996-08-10,ES05209515179869230980,TRX_N-00539-62305815,2023-05-08T13:45:01,Bilbao,expenses,leisure,-82.61,-41770.9
buyer_1,Luis,,1996-08-10,ES05209515179869230980,TRX_N-00540-06049344,2023-05-09T09:59:36,Bilbao,expenses,food,-78.25,-41849.15
buyer_1,Luis,,1996-08-10,ES05209515179869230980,TRX_N-00541-82852916,2023-05-17T06:52:34,Bilbao,expenses,education,-44.0,-41893.15
buyer_1,Luis,,1996-08-10,ES05209515179869230980,TRX_N-00542-07341314,2023-05-20T08:08:43,Bilbao,expenses,transport,-55.94,-41949.09
buyer_1,Luis,,1996-08-10,ES05209515179869230980,TRX_N-00543-85808516,2023-05-20T20:16:23,Bilbao,expenses,leisure,-41.02,-41990.11
buyer_1,Luis,,1996-08-10,ES05209515179869230980,TRX_N-00544-69397780,2023-05-20T02:00:00,Bilbao,expenses,healthcare,-81.38,-42071.49
buyer_1,Luis,,1996-08-10,ES05209515179869230980,TRX_N-00545-43016189,2023-05-22T16:40:47,Bilbao,expenses,food,-73.65,-42145.14
buyer_1,Luis,,1996-08-10,ES05209515179869230980,TRX_N-00546-97603404,2023-05-24T12:00:54,Bilbao,expenses,repairs,-122.81,-42267.95
buyer_1,Luis,,1996-08-10,ES05209515179869230980,TRX_N-00547-73774597,2023-05-25T14:09:40,Bilbao,expenses,repairs,-42.21,-42310.16
buyer_1,Luis,,1996-08-10,ES05209515179869230980,TRX_N-00548-18080489,2023-05-25T06:04:30,Bilbao,expenses,gifts,-652.73,-42962.89
buyer_1,Luis,,1996-08-10,ES05209515179869230980,TRX_N-00549-95454498,2023-05-26T22:30:32,Arrasate,expenses,cash,-100.0,-43062.89
buyer_1,Luis,,1996-08-10,ES05209515179869230980,TRX_N-00550-72614677,2023-05-27T09:37:52,Bilbao,expenses,food,-110.55,-43173.44
buyer_1,Luis,,1996-08-10,ES05209515179869230980,TRX_N-00551-14086783,2023-05-31T17:27:22,Mungia,expenses,healthcare,-154.22,-43327.66
buyer_1,Luis,,1996-08-10,ES05209515179869230980,TRX_N-00552-55946023,2023-06-01T08:26:20,Bilbao,incomes,salary,1650.0,-41677.66
buyer_1,Luis,,1996-08-10,ES05209515179869230980,TRX_N-00553-12771412,2023-06-01T08:26:20,Bilbao,incomes,extra_income,260.51,-41417.15
buyer_1,Luis,,1996-08-10,ES05209515179869230980,TRX_N-00554-03594368,2023-06-01T08:26:20,Bilbao,incomes,salary_bonus,1173.22,-40243.93
buyer_1,Luis,,1996-08-10,ES05209515179869230980,TRX_N-00555-75146708,2023-06-02T10:37:49,Bilbao,expenses,food,-96.37,-40340.3
buyer_1,Luis,,1996-08-10,ES05209515179869230980,TRX_N-00556-12692337,2023-06-02T14:06:16,Bilbao,expenses,education,-63.54,-40403.84
buyer_1,Luis,,1996-08-10,ES05209515179869230980,TRX_N-00557-41958749,2023-06-02T00:57:56,Bilbao,expenses,cash,-100.0,-40503.84
buyer_1,Luis,,1996-08-10,ES05209515179869230980,TRX_N-00558-82038200,2023-06-03T13:36:22,Bilbao,expenses,education,-59.17,-40563.01
buyer_1,Luis,,1996-08-10,ES05209515179869230980,TRX_N-00559-62216006,2023-06-04T01:57:22,Bilbao,expenses,rent,-601.82,-41164.83
buyer_1,Luis,,1996-08-10,ES05209515179869230980,TRX_N-00560-41567886,2023-06-04T18:58:33,Bilbao,expenses,clothing,-118.73,-41283.56
buyer_1,Luis,,1996-08-10,ES05209515179869230980,TRX_N-00561-28137355,2023-06-05T20:17:05,Bilbao,expenses,gas,-80.88,-41364.44
buyer_1,Luis,,1996-08-10,ES05209515179869230980,TRX_N-00562-06529342,2023-06-05T19:21:57,Bilbao,expenses,phone,-42.31,-41406.75
buyer_1,Luis,,1996-08-10,ES05209515179869230980,TRX_N-00563-61146492,2023-06-07T16:18:44,Bilbao,expenses,taxes,-1432.59,-42839.34
buyer_1,Luis,,1996-08-10,ES05209515179869230980,TRX_N-00564-13884767,2023-06-07T23:22:25,Bilbao,expenses,insurance,-489.38,-43328.72
buyer_1,Luis,,1996-08-10,ES05209515179869230980,TRX_N-00565-97146411,2023-06-07T13:06:25,Bilbao,expenses,electricity,-62.16,-43390.88
buyer_1,Luis,,1996-08-10,ES05209515179869230980,TRX_N-00566-75214734,2023-06-07T22:43:09,Bilbao,expenses,internet,-42.0,-43432.88
buyer_1,Luis,,1996-08-10,ES05209515179869230980,TRX_N-00567-70273851,2023-06-07T17:07:38,Bilbao,expenses,food,-65.9,-43498.78
buyer_1,Luis,,1996-08-10,ES05209515179869230980,TRX_N-00568-40906241,2023-06-08T20:14:16,Bilbao,expenses,water,-37.97,-43536.75
buyer_1,Luis,,1996-08-10,ES05209515179869230980,TRX_N-00569-88144159,2023-06-10T14:40:03,Bilbao,expenses,cash,-100.0,-43636.75
buyer_1,Luis,,1996-08-10,ES05209515179869230980,TRX_N-00570-99113160,2023-06-11T19:00:36,Bilbao,expenses,leisure,-82.92,-43719.67
buyer_1,Luis,,1996-08-10,ES05209515179869230980,TRX_N-00571-44326316,2023-06-11T14:05:06,Bilbao,expenses,clothing,-109.95,-43829.62
buyer_1,Luis,,1996-08-10,ES05209515179869230980,TRX_N-00572-03851690,2023-06-13T05:05:16,Bilbao,expenses,gifts,-193.2,-44022.82
buyer_1,Luis,,1996-08-10,ES05209515179869230980,TRX_N-00573-35405234,2023-06-15T20:35:05,Bilbao,expenses,repairs,-273.5,-44296.32
buyer_1,Luis,,1996-08-10,ES05209515179869230980,TRX_N-00574-01637120,2023-06-18T17:09:27,Pasaia,expenses,food,-86.47,-44382.79
buyer_1,Luis,,1996-08-10,ES05209515179869230980,TRX_N-00575-83995566,2023-06-18T15:10:20,Bilbao,expenses,cash,-100.0,-44482.79
buyer_1,Luis,,1996-08-10,ES05209515179869230980,TRX_N-00576-37398620,2023-06-19T00:16:32,Bilbao,expenses,cash,-100.0,-44582.79
buyer_1,Luis,,1996-08-10,ES05209515179869230980,TRX_N-00577-49542067,2023-06-19T09:46:31,Sopela,expenses,appliances,-316.73,-44899.52
buyer_1,Luis,,1996-08-10,ES05209515179869230980,TRX_N-00578-07491448,2023-06-19T19:03:31,Bilbao,expenses,repairs,-331.32,-45230.84
buyer_1,Luis,,1996-08-10,ES05209515179869230980,TRX_N-00579-04307312,2023-06-20T19:50:13,Bilbao,expenses,transport,-80.35,-45311.19
buyer_1,Luis,,1996-08-10,ES05209515179869230980,TRX_N-00580-68154292,2023-06-21T11:17:07,Bilbao,expenses,food,-91.17,-45402.36
buyer_1,Luis,,1996-08-10,ES05209515179869230980,TRX_N-00581-61401642,2023-06-21T19:38:30,Bilbao,expenses,leisure,-49.2,-45451.56
buyer_1,Luis,,1996-08-10,ES05209515179869230980,TRX_N-00582-16225765,2023-06-22T18:04:11,Bilbao,expenses,repairs,-152.36,-45603.92
buyer_1,Luis,,1996-08-10,ES05209515179869230980,TRX_N-00583-40480190,2023-06-23T15:51:25,Bilbao,expenses,food,-62.86,-45666.78
buyer_1,Luis,,1996-08-10,ES05209515179869230980,TRX_N-00584-79844457,2023-06-24T20:48:42,Bilbao,expenses,food,-84.37,-45751.15
buyer_1,Luis,,1996-08-10,ES05209515179869230980,TRX_N-00585-28709298,2023-06-24T16:18:19,Bilbao,expenses,cash,-100.0,-45851.15
buyer_1,Luis,,1996-08-10,ES05209515179869230980,TRX_N-00586-27382160,2023-06-26T17:52:34,Bilbao,expenses,cash,-100.0,-45951.15
buyer_1,Luis,,1996-08-10,ES05209515179869230980,TRX_N-00587-86527781,2023-06-27T13:14:20,Bilbao,expenses,leisure,-71.54,-46022.69
buyer_1,Luis,,1996-08-10,ES05209515179869230980,TRX_N-00588-29228849,2023-06-30T15:59:00,Bilbao,expenses,transport,-63.2,-46085.89
buyer_1,Luis,,1996-08-10,ES05209515179869230980,TRX_N-00589-48263326,2023-07-01T16:04:32,Bilbao,incomes,salary,1650.0,-44435.89
buyer_1,Luis,,1996-08-10,ES05209515179869230980,TRX_N-00590-67565925,2023-07-01T02:34:34,Bilbao,expenses,cash,-100.0,-44535.89
buyer_1,Luis,,1996-08-10,ES05209515179869230980,TRX_N-00591-53824145,2023-07-01T12:26:05,Bilbao,expenses,repairs,-43.24,-44579.13
buyer_1,Luis,,1996-08-10,ES05209515179869230980,TRX_N-00592-83901189,2023-07-02T10:35:16,Bilbao,expenses,food,-77.24,-44656.37
buyer_1,Luis,,1996-08-10,ES05209515179869230980,TRX_N-00593-06368314,2023-07-02T09:39:52,Bilbao,expenses,repairs,-90.66,-44747.03
buyer_1,Luis,,1996-08-10,ES05209515179869230980,TRX_N-00594-18611770,2023-07-03T18:06:24,Bilbao,expenses,food,-103.9,-44850.93
buyer_1,Luis,,1996-08-10,ES05209515179869230980,TRX_N-00595-43795720,2023-07-03T20:05:59,Bilbao,expenses,repairs,-195.09,-45046.02
buyer_1,Luis,,1996-08-10,ES05209515179869230980,TRX_N-00596-77332247,2023-07-04T09:30:12,Bilbao,expenses,rent,-601.82,-45647.84
buyer_1,Luis,,1996-08-10,ES05209515179869230980,TRX_N-00597-38854533,2023-07-04T20:41:42,Bilbao,expenses,cash,-100.0,-45747.84
buyer_1,Luis,,1996-08-10,ES05209515179869230980,TRX_N-00598-06802856,2023-07-05T21:15:41,Bilbao,expenses,electricity,-79.49,-45827.33
buyer_1,Luis,,1996-08-10,ES05209515179869230980,TRX_N-00599-56219054,2023-07-05T04:49:48,Bilbao,expenses,cash,-100.0,-45927.33
buyer_1,Luis,,1996-08-10,ES05209515179869230980,TRX_N-00600-64687258,2023-07-06T17:24:30,Bilbao,expenses,phone,-38.61,-45965.94
buyer_1,Luis,,1996-08-10,ES05209515179869230980,TRX_N-00601-52945082,2023-07-07T12:35:34,Bilbao,expenses,water,-29.98,-45995.92
buyer_1,Luis,,1996-08-10,ES05209515179869230980,TRX_N-00602-90804187,2023-07-07T15:02:03,Bilbao,expenses,gas,-102.06,-46097.98
buyer_1,Luis,,1996-08-10,ES05209515179869230980,TRX_N-00603-27656947,2023-07-07T17:31:12,Bilbao,expenses,transport,-72.17,-46170.15
buyer_1,Luis,,1996-08-10,ES05209515179869230980,TRX_N-00604-20854208,2023-07-08T09:39:39,Bilbao,expenses,internet,-42.0,-46212.15
buyer_1,Luis,,1996-08-10,ES05209515179869230980,TRX_N-00605-71402064,2023-07-08T09:45:51,Bilbao,expenses,food,-75.59,-46287.74
buyer_1,Luis,,1996-08-10,ES05209515179869230980,TRX_N-00606-91516334,2023-07-09T10:09:39,Bilbao,expenses,cash,-100.0,-46387.74
buyer_1,Luis,,1996-08-10,ES05209515179869230980,TRX_N-00607-08703448,2023-07-10T18:49:27,Bilbao,expenses,food,-80.45,-46468.19
buyer_1,Luis,,1996-08-10,ES05209515179869230980,TRX_N-00608-68108930,2023-07-10T14:22:00,Bilbao,expenses,education,-76.25,-46544.44
buyer_1,Luis,,1996-08-10,ES05209515179869230980,TRX_N-00609-18729469,2023-07-10T19:00:24,Bilbao,expenses,cash,-100.0,-46644.44
buyer_1,Luis,,1996-08-10,ES05209515179869230980,TRX_N-00610-58674249,2023-07-12T12:12:11,Bilbao,expenses,food,-65.69,-46710.13
buyer_1,Luis,,1996-08-10,ES05209515179869230980,TRX_N-00611-66121486,2023-07-13T15:32:02,Bilbao,expenses,food,-80.51,-46790.64
buyer_1,Luis,,1996-08-10,ES05209515179869230980,TRX_N-00612-87232958,2023-07-15T08:20:10,Bilbao,expenses,cash,-100.0,-46890.64
buyer_1,Luis,,1996-08-10,ES05209515179869230980,TRX_N-00613-34973904,2023-07-16T01:41:22,Bilbao,expenses,leisure,-38.92,-46929.56
buyer_1,Luis,,1996-08-10,ES05209515179869230980,TRX_N-00614-05471298,2023-07-19T14:22:00,Bilbao,expenses,cash,-100.0,-47029.56
buyer_1,Luis,,1996-08-10,ES05209515179869230980,TRX_N-00615-03631328,2023-07-21T16:55:52,Bilbao,expenses,leisure,-53.7,-47083.26
buyer_1,Luis,,1996-08-10,ES05209515179869230980,TRX_N-00616-80135522,2023-07-21T01:56:34,Bilbao,expenses,repairs,-211.44,-47294.7
buyer_1,Luis,,1996-08-10,ES05209515179869230980,TRX_N-00617-21904344,2023-07-23T14:23:33,Bilbao,expenses,food,-70.95,-47365.65
buyer_1,Luis,,1996-08-10,ES05209515179869230980,TRX_N-00618-08406209,2023-07-26T11:25:50,Bilbao,expenses,cash,-100.0,-47465.65
buyer_1,Luis,,1996-08-10,ES05209515179869230980,TRX_N-00619-11780203,2023-07-28T11:27:57,Bilbao,expenses,transport,-70.24,-47535.89
buyer_1,Luis,,1996-08-10,ES05209515179869230980,TRX_N-00620-67627959,2023-07-28T13:12:20,Bilbao,expenses,gifts,-393.88,-47929.77
buyer_1,Luis,,1996-08-10,ES05209515179869230980,TRX_N-00621-71404600,2023-07-30T10:23:39,Bilbao,expenses,repairs,-264.03,-48193.8
buyer_1,Luis,,1996-08-10,ES05209515179869230980,TRX_N-00622-52243353,2023-07-31T12:50:52,Bilbao,expenses,repairs,-324.06,-48517.86
buyer_1,Luis,,1996-08-10,ES05209515179869230980,TRX_N-00623-89609105,2023-08-01T10:04:08,Bilbao,incomes,salary,1650.0,-46867.86
buyer_1,Luis,,1996-08-10,ES05209515179869230980,TRX_N-00624-81838079,2023-08-02T08:17:16,Bilbao,expenses,transport,-61.43,-46929.29
buyer_1,Luis,,1996-08-10,ES05209515179869230980,TRX_N-00625-15786707,2023-08-03T12:50:31,Bilbao,expenses,clothing,-154.86,-47084.15
buyer_1,Luis,,1996-08-10,ES05209515179869230980,TRX_N-00626-93300212,2023-08-04T20:23:00,Bilbao,expenses,rent,-601.82,-47685.97
buyer_1,Luis,,1996-08-10,ES05209515179869230980,TRX_N-00627-87023421,2023-08-04T14:50:39,Bilbao,expenses,transport,-47.65,-47733.62
buyer_1,Luis,,1996-08-10,ES05209515179869230980,TRX_N-00628-62416159,2023-08-05T16:34:00,Bilbao,expenses,water,-34.83,-47768.45
buyer_1,Luis,,1996-08-10,ES05209515179869230980,TRX_N-00629-57896784,2023-08-05T05:28:27,Bilbao,expenses,food,-111.94,-47880.39
buyer_1,Luis,,1996-08-10,ES05209515179869230980,TRX_N-00630-32489406,2023-08-05T13:37:21,Bilbao,expenses,transport,-60.13,-47940.52
buyer_1,Luis,,1996-08-10,ES05209515179869230980,TRX_N-00631-28090718,2023-08-06T14:52:23,Bilbao,expenses,internet,-42.0,-47982.52
buyer_1,Luis,,1996-08-10,ES05209515179869230980,TRX_N-00632-96221132,2023-08-06T09:00:54,Bilbao,expenses,phone,-38.05,-48020.57
buyer_1,Luis,,1996-08-10,ES05209515179869230980,TRX_N-00633-45606946,2023-08-07T11:46:15,Bilbao,expenses,cash,-100.0,-48120.57
buyer_1,Luis,,1996-08-10,ES05209515179869230980,TRX_N-00634-46480618,2023-08-08T06:56:46,Bilbao,expenses,electricity,-65.94,-48186.51
buyer_1,Luis,,1996-08-10,ES05209515179869230980,TRX_N-00635-50271008,2023-08-08T18:33:59,Bilbao,expenses,gas,-77.38,-48263.89
buyer_1,Luis,,1996-08-10,ES05209515179869230980,TRX_N-00636-90626983,2023-08-08T17:42:26,Bilbao,expenses,healthcare,-152.26,-48416.15
buyer_1,Luis,,1996-08-10,ES05209515179869230980,TRX_N-00637-06457489,2023-08-10T13:44:12,Bilbao,expenses,healthcare,-43.64,-48459.79
buyer_1,Luis,,1996-08-10,ES05209515179869230980,TRX_N-00638-89440659,2023-08-11T19:57:18,Bilbao,expenses,appliances,-309.47,-48769.26
buyer_1,Luis,,1996-08-10,ES05209515179869230980,TRX_N-00639-85277238,2023-08-12T22:48:24,Bilbao,expenses,food,-117.73,-48886.99
buyer_1,Luis,,1996-08-10,ES05209515179869230980,TRX_N-00640-10477915,2023-08-12T10:29:23,Berango,expenses,leisure,-83.59,-48970.58
buyer_1,Luis,,1996-08-10,ES05209515179869230980,TRX_N-00641-84658571,2023-08-13T21:23:16,Bilbao,expenses,leisure,-62.68,-49033.26
buyer_1,Luis,,1996-08-10,ES05209515179869230980,TRX_N-00642-45229133,2023-08-14T13:42:36,Bilbao,expenses,cash,-100.0,-49133.26
buyer_1,Luis,,1996-08-10,ES05209515179869230980,TRX_N-00643-62801820,2023-08-16T17:03:01,Bilbao,expenses,repairs,-219.02,-49352.28
buyer_1,Luis,,1996-08-10,ES05209515179869230980,TRX_N-00644-01360691,2023-08-16T23:39:30,Pasaia,expenses,gifts,-83.78,-49436.06
buyer_1,Luis,,1996-08-10,ES05209515179869230980,TRX_N-00645-09194767,2023-08-17T17:28:13,Bilbao,expenses,leisure,-56.13,-49492.19
buyer_1,Luis,,1996-08-10,ES05209515179869230980,TRX_N-00646-40416518,2023-08-17T11:47:47,Bilbao,expenses,cash,-100.0,-49592.19
buyer_1,Luis,,1996-08-10,ES05209515179869230980,TRX_N-00647-81434872,2023-08-18T20:00:03,Berango,expenses,cash,-100.0,-49692.19
buyer_1,Luis,,1996-08-10,ES05209515179869230980,TRX_N-00648-19739256,2023-08-18T16:31:02,Bilbao,expenses,gifts,-305.06,-49997.25
buyer_1,Luis,,1996-08-10,ES05209515179869230980,TRX_N-00649-05530379,2023-08-19T12:53:40,Bilbao,expenses,transport,-49.46,-50046.71
buyer_1,Luis,,1996-08-10,ES05209515179869230980,TRX_N-00650-88160496,2023-08-20T21:57:25,Bilbao,expenses,leisure,-21.61,-50068.32
buyer_1,Luis,,1996-08-10,ES05209515179869230980,TRX_N-00651-01627678,2023-08-22T15:04:37,Bilbao,expenses,clothing,-83.46,-50151.78
buyer_1,Luis,,1996-08-10,ES05209515179869230980,TRX_N-00652-83537407,2023-08-23T13:53:56,Bilbao,expenses,cash,-100.0,-50251.78
buyer_1,Luis,,1996-08-10,ES05209515179869230980,TRX_N-00653-92243241,2023-08-24T08:10:24,Bilbao,expenses,clothing,-115.63,-50367.41
buyer_1,Luis,,1996-08-10,ES05209515179869230980,TRX_N-00654-33663449,2023-08-24T09:15:55,Bilbao,expenses,cash,-100.0,-50467.41
buyer_1,Luis,,1996-08-10,ES05209515179869230980,TRX_N-00655-39384208,2023-08-24T11:55:58,Bilbao,expenses,gifts,-359.78,-50827.19
buyer_1,Luis,,1996-08-10,ES05209515179869230980,TRX_N-00656-71602442,2023-08-26T10:01:59,Bilbao,expenses,clothing,-122.65,-50949.84
buyer_1,Luis,,1996-08-10,ES05209515179869230980,TRX_N-00657-52746135,2023-08-29T09:00:28,Bilbao,expenses,repairs,-140.64,-51090.48
buyer_1,Luis,,1996-08-10,ES05209515179869230980,TRX_N-00658-47789651,2023-08-29T04:45:02,Bilbao,expenses,gifts,-89.33,-51179.81
buyer_1,Luis,,1996-08-10,ES05209515179869230980,TRX_N-00659-70610088,2023-08-30T17:01:36,Bilbao,expenses,food,-116.68,-51296.49
buyer_1,Luis,,1996-08-10,ES05209515179869230980,TRX_N-00660-35778241,2023-08-30T09:24:47,Bilbao,expenses,healthcare,-75.62,-51372.11
buyer_1,Luis,,1996-08-10,ES05209515179869230980,TRX_N-00661-16039588,2023-08-30T10:37:06,Bilbao,expenses,repairs,-151.37,-51523.48
buyer_1,Luis,,1996-08-10,ES05209515179869230980,TRX_N-00662-91603800,2023-08-31T07:14:46,Bilbao,expenses,transport,-72.77,-51596.25
buyer_1,Luis,,1996-08-10,ES05209515179869230980,TRX_N-00663-86373385,2023-09-01T23:07:08,Bilbao,incomes,salary,1650.0,-49946.25
buyer_1,Luis,,1996-08-10,ES05209515179869230980,TRX_N-00664-10406560,2023-09-01T23:07:08,Bilbao,incomes,extra_income,260.51,-49685.74
buyer_1,Luis,,1996-08-10,ES05209515179869230980,TRX_N-00665-02580380,2023-09-02T15:25:32,Bilbao,expenses,repairs,-108.26,-49794.0
buyer_1,Luis,,1996-08-10,ES05209515179869230980,TRX_N-00666-79783882,2023-09-03T13:46:28,Bilbao,expenses,food,-72.07,-49866.07
buyer_1,Luis,,1996-08-10,ES05209515179869230980,TRX_N-00667-85728633,2023-09-04T17:25:29,Bilbao,expenses,rent,-601.82,-50467.89
buyer_1,Luis,,1996-08-10,ES05209515179869230980,TRX_N-00668-46666562,2023-09-05T16:04:31,Bilbao,expenses,electricity,-88.18,-50556.07
buyer_1,Luis,,1996-08-10,ES05209515179869230980,TRX_N-00669-11865234,2023-09-06T09:05:14,Bilbao,expenses,water,-33.88,-50589.95
buyer_1,Luis,,1996-08-10,ES05209515179869230980,TRX_N-00670-83097737,2023-09-06T14:38:15,Bilbao,expenses,internet,-42.0,-50631.95
buyer_1,Luis,,1996-08-10,ES05209515179869230980,TRX_N-00671-44808445,2023-09-06T17:25:19,Bilbao,expenses,transport,-56.24,-50688.19
buyer_1,Luis,,1996-08-10,ES05209515179869230980,TRX_N-00672-59735253,2023-09-07T20:17:01,Bilbao,expenses,phone,-32.47,-50720.66
buyer_1,Luis,,1996-08-10,ES05209515179869230980,TRX_N-00673-00589047,2023-09-07T20:21:30,Getxo,expenses,leisure,-49.1,-50769.76
buyer_1,Luis,,1996-08-10,ES05209515179869230980,TRX_N-00674-73510628,2023-09-07T19:27:32,Bilbao,expenses,cash,-100.0,-50869.76
buyer_1,Luis,,1996-08-10,ES05209515179869230980,TRX_N-00675-30223514,2023-09-08T13:47:24,Bilbao,expenses,gas,-48.67,-50918.43
buyer_1,Luis,,1996-08-10,ES05209515179869230980,TRX_N-00676-84036081,2023-09-08T14:22:59,Bilbao,expenses,food,-91.23,-51009.66
buyer_1,Luis,,1996-08-10,ES05209515179869230980,TRX_N-00677-87649277,2023-09-08T11:54:47,Bilbao,expenses,leisure,-30.98,-51040.64
buyer_1,Luis,,1996-08-10,ES05209515179869230980,TRX_N-00678-78802599,2023-09-08T16:36:20,Bilbao,expenses,education,-46.42,-51087.06
buyer_1,Luis,,1996-08-10,ES05209515179869230980,TRX_N-00679-04457389,2023-09-08T08:29:10,Bilbao,expenses,repairs,-316.45,-51403.51
buyer_1,Luis,,1996-08-10,ES05209515179869230980,TRX_N-00680-24649519,2023-09-09T11:37:45,Bilbao,expenses,food,-98.59,-51502.1
buyer_1,Luis,,1996-08-10,ES05209515179869230980,TRX_N-00681-09377234,2023-09-09T00:24:42,Bilbao,expenses,cash,-100.0,-51602.1
buyer_1,Luis,,1996-08-10,ES05209515179869230980,TRX_N-00682-93054269,2023-09-10T18:33:19,Oy√≥n-Oion,expenses,cash,-100.0,-51702.1
buyer_1,Luis,,1996-08-10,ES05209515179869230980,TRX_N-00683-25622827,2023-09-11T14:14:58,Pasaia,expenses,healthcare,-112.51,-51814.61
buyer_1,Luis,,1996-08-10,ES05209515179869230980,TRX_N-00684-33310034,2023-09-12T10:14:35,Bilbao,expenses,healthcare,-189.16,-52003.77
buyer_1,Luis,,1996-08-10,ES05209515179869230980,TRX_N-00685-39783737,2023-09-17T04:29:08,Bilbao,expenses,transport,-63.47,-52067.24
buyer_1,Luis,,1996-08-10,ES05209515179869230980,TRX_N-00686-80163216,2023-09-17T00:23:57,Bilbao,expenses,cash,-100.0,-52167.24
buyer_1,Luis,,1996-08-10,ES05209515179869230980,TRX_N-00687-86392828,2023-09-19T16:40:50,Bilbao,expenses,leisure,-77.15,-52244.39
buyer_1,Luis,,1996-08-10,ES05209515179869230980,TRX_N-00688-78835330,2023-09-19T13:01:00,Bilbao,expenses,appliances,-375.89,-52620.28
buyer_1,Luis,,1996-08-10,ES05209515179869230980,TRX_N-00689-24047796,2023-09-20T15:19:13,Bilbao,expenses,food,-80.61,-52700.89
buyer_1,Luis,,1996-08-10,ES05209515179869230980,TRX_N-00690-09389589,2023-09-22T10:17:02,Bilbao,expenses,food,-86.59,-52787.48
buyer_1,Luis,,1996-08-10,ES05209515179869230980,TRX_N-00691-95452386,2023-09-22T18:32:20,Bilbao,expenses,education,-70.54,-52858.02
buyer_1,Luis,,1996-08-10,ES05209515179869230980,TRX_N-00692-93859800,2023-09-23T12:47:47,Bilbao,expenses,cash,-100.0,-52958.02
buyer_1,Luis,,1996-08-10,ES05209515179869230980,TRX_N-00693-37809422,2023-09-24T15:33:12,Labastida,expenses,food,-85.71,-53043.73
buyer_1,Luis,,1996-08-10,ES05209515179869230980,TRX_N-00694-88283019,2023-09-24T12:35:35,Bilbao,expenses,transport,-56.89,-53100.62
buyer_1,Luis,,1996-08-10,ES05209515179869230980,TRX_N-00695-59479228,2023-09-24T21:25:38,Bilbao,expenses,leisure,-66.36,-53166.98
buyer_1,Luis,,1996-08-10,ES05209515179869230980,TRX_N-00696-17982272,2023-09-24T20:27:49,Bilbao,expenses,repairs,-281.28,-53448.26
buyer_1,Luis,,1996-08-10,ES05209515179869230980,TRX_N-00697-90351455,2023-09-28T13:58:52,Bilbao,expenses,leisure,-19.83,-53468.09
buyer_1,Luis,,1996-08-10,ES05209515179869230980,TRX_N-00698-72269080,2023-09-28T16:49:11,Bilbao,expenses,repairs,-36.81,-53504.9
buyer_1,Luis,,1996-08-10,ES05209515179869230980,TRX_N-00699-05498856,2023-09-29T16:49:51,Bilbao,expenses,cash,-100.0,-53604.9
buyer_1,Luis,,1996-08-10,ES05209515179869230980,TRX_N-00700-82131351,2023-09-30T08:21:03,Bilbao,expenses,repairs,-288.4,-53893.3
buyer_1,Luis,,1996-08-10,ES05209515179869230980,TRX_N-00701-87373650,2023-10-01T12:03:02,Bilbao,incomes,salary,1650.0,-52243.3
buyer_1,Luis,,1996-08-10,ES05209515179869230980,TRX_N-00702-94171713,2023-10-04T21:51:37,Bilbao,expenses,rent,-601.82,-52845.12
buyer_1,Luis,,1996-08-10,ES05209515179869230980,TRX_N-00703-81757957,2023-10-04T16:02:12,Bilbao,expenses,education,-48.34,-52893.46
buyer_1,Luis,,1996-08-10,ES05209515179869230980,TRX_N-00704-54634994,2023-10-05T21:35:28,Bilbao,expenses,water,-44.57,-52938.03
buyer_1,Luis,,1996-08-10,ES05209515179869230980,TRX_N-00705-78373979,2023-10-05T13:18:44,Bilbao,expenses,electricity,-55.78,-52993.81
buyer_1,Luis,,1996-08-10,ES05209515179869230980,TRX_N-00706-02477204,2023-10-05T09:29:14,Bilbao,expenses,phone,-41.79,-53035.6
buyer_1,Luis,,1996-08-10,ES05209515179869230980,TRX_N-00707-37008568,2023-10-05T10:05:07,Amurrio,expenses,leisure,-38.26,-53073.86
buyer_1,Luis,,1996-08-10,ES05209515179869230980,TRX_N-00708-30881049,2023-10-05T10:24:51,Bilbao,expenses,gifts,-372.29,-53446.15
buyer_1,Luis,,1996-08-10,ES05209515179869230980,TRX_N-00709-56755195,2023-10-06T16:54:48,Bilbao,expenses,repairs,-265.17,-53711.32
buyer_1,Luis,,1996-08-10,ES05209515179869230980,TRX_N-00710-59130696,2023-10-07T15:39:28,Bilbao,expenses,transport,-63.14,-53774.46
buyer_1,Luis,,1996-08-10,ES05209515179869230980,TRX_N-00711-34154442,2023-10-07T10:20:25,Bilbao,expenses,clothing,-48.26,-53822.72
buyer_1,Luis,,1996-08-10,ES05209515179869230980,TRX_N-00712-27698541,2023-10-07T11:24:28,Bilbao,expenses,repairs,-280.18,-54102.9
buyer_1,Luis,,1996-08-10,ES05209515179869230980,TRX_N-00713-04025657,2023-10-07T15:01:58,Bilbao,expenses,gifts,-490.28,-54593.18
buyer_1,Luis,,1996-08-10,ES05209515179869230980,TRX_N-00714-89110571,2023-10-07T13:49:44,Bilbao,expenses,car,-241.42,-54834.6
buyer_1,Luis,,1996-08-10,ES05209515179869230980,TRX_N-00715-54844447,2023-10-08T22:45:15,Bilbao,expenses,gas,-31.19,-54865.79
buyer_1,Luis,,1996-08-10,ES05209515179869230980,TRX_N-00716-33571162,2023-10-08T08:02:17,Bilbao,expenses,internet,-42.0,-54907.79
buyer_1,Luis,,1996-08-10,ES05209515179869230980,TRX_N-00717-54556722,2023-10-08T13:51:23,Bilbao,expenses,food,-96.82,-55004.61
buyer_1,Luis,,1996-08-10,ES05209515179869230980,TRX_N-00718-13268289,2023-10-08T14:16:29,Elciego,expenses,leisure,-58.37,-55062.98
buyer_1,Luis,,1996-08-10,ES05209515179869230980,TRX_N-00719-39602373,2023-10-08T22:02:36,Sopela,expenses,cash,-100.0,-55162.98
buyer_1,Luis,,1996-08-10,ES05209515179869230980,TRX_N-00720-78710661,2023-10-09T02:17:40,Bilbao,expenses,repairs,-120.48,-55283.46
buyer_1,Luis,,1996-08-10,ES05209515179869230980,TRX_N-00721-02481581,2023-10-11T17:50:53,Bilbao,expenses,cash,-100.0,-55383.46
buyer_1,Luis,,1996-08-10,ES05209515179869230980,TRX_N-00722-48034570,2023-10-14T09:38:06,Bilbao,expenses,gifts,-156.36,-55539.82
buyer_1,Luis,,1996-08-10,ES05209515179869230980,TRX_N-00723-80299836,2023-10-17T17:25:57,Bilbao,expenses,clothing,-74.87,-55614.69
buyer_1,Luis,,1996-08-10,ES05209515179869230980,TRX_N-00724-91154385,2023-10-17T19:19:21,Bilbao,expenses,cash,-100.0,-55714.69
buyer_1,Luis,,1996-08-10,ES05209515179869230980,TRX_N-00725-49230241,2023-10-18T14:20:00,Bilbao,expenses,food,-62.8,-55777.49
buyer_1,Luis,,1996-08-10,ES05209515179869230980,TRX_N-00726-55873850,2023-10-18T14:35:40,Arrasate,expenses,cash,-100.0,-55877.49
buyer_1,Luis,,1996-08-10,ES05209515179869230980,TRX_N-00727-83031938,2023-10-21T08:44:37,Bilbao,expenses,leisure,-37.41,-55914.9
buyer_1,Luis,,1996-08-10,ES05209515179869230980,TRX_N-00728-85173437,2023-10-22T11:03:07,Bilbao,expenses,cash,-100.0,-56014.9
buyer_1,Luis,,1996-08-10,ES05209515179869230980,TRX_N-00729-89144293,2023-10-23T13:14:52,Bilbao,expenses,clothing,-106.62,-56121.52
buyer_1,Luis,,1996-08-10,ES05209515179869230980,TRX_N-00730-75959070,2023-10-24T17:51:37,Bilbao,expenses,food,-75.35,-56196.87
buyer_1,Luis,,1996-08-10,ES05209515179869230980,TRX_N-00731-59267111,2023-10-24T18:56:58,Bilbao,expenses,leisure,-68.04,-56264.91
buyer_1,Luis,,1996-08-10,ES05209515179869230980,TRX_N-00732-86898599,2023-10-26T16:43:11,Bilbao,expenses,transport,-54.64,-56319.55
buyer_1,Luis,,1996-08-10,ES05209515179869230980,TRX_N-00733-94409445,2023-10-29T15:22:43,Bilbao,expenses,healthcare,-117.03,-56436.58
buyer_1,Luis,,1996-08-10,ES05209515179869230980,TRX_N-00734-03487975,2023-10-30T08:19:11,Bilbao,expenses,leisure,-82.81,-56519.39
buyer_1,Luis,,1996-08-10,ES05209515179869230980,TRX_N-00735-34009728,2023-11-01T12:11:58,Bilbao,incomes,salary,1650.0,-54869.39
buyer_1,Luis,,1996-08-10,ES05209515179869230980,TRX_N-00736-14090409,2023-11-01T06:59:57,Zarautz,expenses,transport,-53.66,-54923.05
buyer_1,Luis,,1996-08-10,ES05209515179869230980,TRX_N-00737-23308470,2023-11-01T20:46:19,Bilbao,expenses,cash,-100.0,-55023.05
buyer_1,Luis,,1996-08-10,ES05209515179869230980,TRX_N-00738-72384933,2023-11-01T13:09:22,Bilbao,expenses,travel,-1352.85,-56375.9
buyer_1,Luis,,1996-08-10,ES05209515179869230980,TRX_N-00739-58900315,2023-11-01T17:51:59,Bilbao,expenses,repairs,-157.71,-56533.61
buyer_1,Luis,,1996-08-10,ES05209515179869230980,TRX_N-00740-12072411,2023-11-03T16:30:21,Bermeo,expenses,cash,-100.0,-56633.61
buyer_1,Luis,,1996-08-10,ES05209515179869230980,TRX_N-00741-39331330,2023-11-03T20:55:28,Bilbao,expenses,repairs,-305.06,-56938.67
buyer_1,Luis,,1996-08-10,ES05209515179869230980,TRX_N-00742-26473256,2023-11-04T18:22:10,Bilbao,expenses,rent,-601.82,-57540.49
buyer_1,Luis,,1996-08-10,ES05209515179869230980,TRX_N-00743-83600187,2023-11-05T19:00:36,Bilbao,expenses,water,-29.77,-57570.26
buyer_1,Luis,,1996-08-10,ES05209515179869230980,TRX_N-00744-32321128,2023-11-05T16:42:51,Bilbao,expenses,electricity,-52.3,-57622.56
buyer_1,Luis,,1996-08-10,ES05209515179869230980,TRX_N-00745-47680681,2023-11-05T18:30:01,Bilbao,expenses,repairs,-231.37,-57853.93
buyer_1,Luis,,1996-08-10,ES05209515179869230980,TRX_N-00746-59507514,2023-11-06T12:57:04,Bilbao,expenses,internet,-42.0,-57895.93
buyer_1,Luis,,1996-08-10,ES05209515179869230980,TRX_N-00747-15335741,2023-11-06T12:52:05,Bilbao,expenses,phone,-34.9,-57930.83
buyer_1,Luis,,1996-08-10,ES05209515179869230980,TRX_N-00748-72659161,2023-11-06T08:06:12,Bilbao,expenses,cash,-100.0,-58030.83
buyer_1,Luis,,1996-08-10,ES05209515179869230980,TRX_N-00749-58950082,2023-11-07T02:42:40,Bilbao,expenses,gas,-55.2,-58086.03
buyer_1,Luis,,1996-08-10,ES05209515179869230980,TRX_N-00750-91720027,2023-11-08T09:06:10,Bilbao,expenses,food,-104.87,-58190.9
buyer_1,Luis,,1996-08-10,ES05209515179869230980,TRX_N-00751-29733774,2023-11-08T20:26:22,Bilbao,expenses,cash,-100.0,-58290.9
buyer_1,Luis,,1996-08-10,ES05209515179869230980,TRX_N-00752-93314366,2023-11-09T19:01:41,Bilbao,expenses,food,-62.79,-58353.69
buyer_1,Luis,,1996-08-10,ES05209515179869230980,TRX_N-00753-72046181,2023-11-10T13:08:28,Bilbao,expenses,food,-111.21,-58464.9
buyer_1,Luis,,1996-08-10,ES05209515179869230980,TRX_N-00754-65586774,2023-11-10T18:56:13,Bilbao,expenses,transport,-70.7,-58535.6
buyer_1,Luis,,1996-08-10,ES05209515179869230980,TRX_N-00755-62215471,2023-11-13T08:42:14,Bilbao,expenses,food,-121.23,-58656.83
buyer_1,Luis,,1996-08-10,ES05209515179869230980,TRX_N-00756-36802813,2023-11-14T21:32:09,Bilbao,expenses,transport,-72.08,-58728.91
buyer_1,Luis,,1996-08-10,ES05209515179869230980,TRX_N-00757-97245364,2023-11-15T23:33:47,Santurtzi,expenses,leisure,-51.44,-58780.35
buyer_1,Luis,,1996-08-10,ES05209515179869230980,TRX_N-00758-00714772,2023-11-15T15:13:24,Bilbao,expenses,cash,-100.0,-58880.35
buyer_1,Luis,,1996-08-10,ES05209515179869230980,TRX_N-00759-65381529,2023-11-16T08:21:54,Bilbao,expenses,food,-104.33,-58984.68
buyer_1,Luis,,1996-08-10,ES05209515179869230980,TRX_N-00760-73698749,2023-11-16T18:15:46,Llodio,expenses,gifts,-597.06,-59581.74
buyer_1,Luis,,1996-08-10,ES05209515179869230980,TRX_N-00761-86260687,2023-11-21T09:25:32,Irun,expenses,food,-117.09,-59698.83
buyer_1,Luis,,1996-08-10,ES05209515179869230980,TRX_N-00762-38067114,2023-11-21T19:10:44,Bilbao,expenses,transport,-77.26,-59776.09
buyer_1,Luis,,1996-08-10,ES05209515179869230980,TRX_N-00763-46256590,2023-11-21T19:38:17,Portugalete,expenses,leisure,-41.71,-59817.8
buyer_1,Luis,,1996-08-10,ES05209515179869230980,TRX_N-00764-56186592,2023-11-24T17:34:10,Bilbao,expenses,food,-82.0,-59899.8
buyer_1,Luis,,1996-08-10,ES05209515179869230980,TRX_N-00765-36158688,2023-11-24T18:28:04,Arrasate,expenses,gifts,-827.94,-60727.74
buyer_1,Luis,,1996-08-10,ES05209515179869230980,TRX_N-00766-84248818,2023-11-25T18:29:54,Irun,expenses,food,-88.5,-60816.24
buyer_1,Luis,,1996-08-10,ES05209515179869230980,TRX_N-00767-11963333,2023-11-26T18:44:51,Bilbao,expenses,transport,-85.56,-60901.8
buyer_1,Luis,,1996-08-10,ES05209515179869230980,TRX_N-00768-34328411,2023-11-27T18:54:49,Bilbao,expenses,food,-71.2,-60973.0
buyer_1,Luis,,1996-08-10,ES05209515179869230980,TRX_N-00769-97782013,2023-11-28T14:40:23,Bilbao,expenses,leisure,-48.44,-61021.44
buyer_1,Luis,,1996-08-10,ES05209515179869230980,TRX_N-00770-04753114,2023-11-29T19:00:22,Bilbao,expenses,healthcare,-175.36,-61196.8
buyer_1,Luis,,1996-08-10,ES05209515179869230980,TRX_N-00771-70195313,2023-11-30T14:20:06,Bilbao,expenses,food,-97.27,-61294.07
buyer_1,Luis,,1996-08-10,ES05209515179869230980,TRX_N-00772-22217951,2023-12-01T09:20:47,Bilbao,incomes,salary,1650.0,-59644.07
buyer_1,Luis,,1996-08-10,ES05209515179869230980,TRX_N-00773-49688241,2023-12-01T09:20:47,Bilbao,incomes,extra_income,260.51,-59383.56
buyer_1,Luis,,1996-08-10,ES05209515179869230980,TRX_N-00774-84048640,2023-12-01T09:20:47,Bilbao,incomes,salary_bonus,1204.11,-58179.45
buyer_1,Luis,,1996-08-10,ES05209515179869230980,TRX_N-00775-70990199,2023-12-02T12:32:38,Bilbao,expenses,cash,-100.0,-58279.45
buyer_1,Luis,,1996-08-10,ES05209515179869230980,TRX_N-00776-18132250,2023-12-04T12:17:24,Bilbao,expenses,rent,-601.82,-58881.27
buyer_1,Luis,,1996-08-10,ES05209515179869230980,TRX_N-00777-80563206,2023-12-05T20:14:15,Bilbao,expenses,water,-33.83,-58915.1
buyer_1,Luis,,1996-08-10,ES05209515179869230980,TRX_N-00778-12151454,2023-12-06T03:19:42,Bilbao,expenses,gas,-50.37,-58965.47
buyer_1,Luis,,1996-08-10,ES05209515179869230980,TRX_N-00779-35275555,2023-12-06T05:12:35,Bilbao,expenses,internet,-42.0,-59007.47
buyer_1,Luis,,1996-08-10,ES05209515179869230980,TRX_N-00780-35651201,2023-12-06T18:46:12,Bilbao,expenses,education,-57.34,-59064.81
buyer_1,Luis,,1996-08-10,ES05209515179869230980,TRX_N-00781-34397099,2023-12-07T08:37:46,Bilbao,expenses,electricity,-63.11,-59127.92
buyer_1,Luis,,1996-08-10,ES05209515179869230980,TRX_N-00782-59339025,2023-12-07T04:44:04,Bilbao,expenses,phone,-42.59,-59170.51
buyer_1,Luis,,1996-08-10,ES05209515179869230980,TRX_N-00783-07162077,2023-12-09T13:40:01,Bilbao,expenses,transport,-86.31,-59256.82
buyer_1,Luis,,1996-08-10,ES05209515179869230980,TRX_N-00784-08577714,2023-12-10T09:19:51,Bilbao,expenses,food,-102.57,-59359.39
buyer_1,Luis,,1996-08-10,ES05209515179869230980,TRX_N-00785-67116267,2023-12-10T17:44:59,Bilbao,expenses,clothing,-126.84,-59486.23
buyer_1,Luis,,1996-08-10,ES05209515179869230980,TRX_N-00786-36597077,2023-12-10T18:39:33,Bilbao,expenses,education,-71.46,-59557.69
buyer_1,Luis,,1996-08-10,ES05209515179869230980,TRX_N-00787-38539484,2023-12-11T18:32:13,Bilbao,expenses,clothing,-102.8,-59660.49
buyer_1,Luis,,1996-08-10,ES05209515179869230980,TRX_N-00788-04932104,2023-12-12T16:46:59,Bilbao,expenses,education,-48.28,-59708.77
buyer_1,Luis,,1996-08-10,ES05209515179869230980,TRX_N-00789-91589760,2023-12-16T13:32:21,Bilbao,expenses,food,-81.06,-59789.83
buyer_1,Luis,,1996-08-10,ES05209515179869230980,TRX_N-00790-87847938,2023-12-18T11:55:05,Bilbao,expenses,healthcare,-127.59,-59917.42
buyer_1,Luis,,1996-08-10,ES05209515179869230980,TRX_N-00791-80854501,2023-12-19T08:28:28,Bilbao,expenses,transport,-40.64,-59958.06
buyer_1,Luis,,1996-08-10,ES05209515179869230980,TRX_N-00792-64714492,2023-12-19T12:35:32,Bilbao,expenses,repairs,-271.19,-60229.25
buyer_1,Luis,,1996-08-10,ES05209515179869230980,TRX_N-00793-71305487,2023-12-20T21:02:15,Andoain,expenses,leisure,-33.81,-60263.06
buyer_1,Luis,,1996-08-10,ES05209515179869230980,TRX_N-00794-17309523,2023-12-20T20:21:45,Bilbao,expenses,cash,-100.0,-60363.06
buyer_1,Luis,,1996-08-10,ES05209515179869230980,TRX_N-00795-57484224,2023-12-21T11:17:33,Bilbao,expenses,transport,-46.56,-60409.62
buyer_1,Luis,,1996-08-10,ES05209515179869230980,TRX_N-00796-73834473,2023-12-23T22:33:40,Bilbao,expenses,leisure,-58.86,-60468.48
buyer_1,Luis,,1996-08-10,ES05209515179869230980,TRX_N-00797-57036748,2023-12-23T13:43:56,Bilbao,expenses,cash,-100.0,-60568.48
buyer_1,Luis,,1996-08-10,ES05209515179869230980,TRX_N-00798-39041010,2023-12-24T08:20:55,Bilbao,expenses,food,-97.74,-60666.22
buyer_1,Luis,,1996-08-10,ES05209515179869230980,TRX_N-00799-51327856,2023-12-26T09:07:08,Bilbao,expenses,leisure,-20.22,-60686.44
buyer_1,Luis,,1996-08-10,ES05209515179869230980,TRX_N-00800-27896873,2023-12-27T18:06:53,Bilbao,expenses,cash,-100.0,-60786.44
buyer_1,Luis,,1996-08-10,ES05209515179869230980,TRX_N-00801-96369321,2023-12-29T15:11:36,Bilbao,expenses,transport,-80.7,-60867.14
buyer_1,Luis,,1996-08-10,ES05209515179869230980,TRX_N-00802-23717792,2023-12-29T19:49:44,Bilbao,expenses,cash,-100.0,-60967.14
buyer_1,Luis,,1996-08-10,ES05209515179869230980,TRX_N-00803-81375885,2023-12-31T08:35:45,Pasaia,expenses,transport,-87.9,-61055.04
buyer_1,Luis,,1996-08-10,ES05209515179869230980,TRX_N-00804-44326752,2024-01-01T14:27:57,Bilbao,incomes,salary,1693.78,-59361.26
buyer_1,Luis,,1996-08-10,ES05209515179869230980,TRX_N-00805-51477568,2024-01-01T10:33:27,Bilbao,expenses,cash,-100.0,-59461.26
buyer_1,Luis,,1996-08-10,ES05209515179869230980,TRX_N-00806-87458629,2024-01-04T18:22:40,Bilbao,expenses,rent,-601.82,-60063.08
buyer_1,Luis,,1996-08-10,ES05209515179869230980,TRX_N-00807-54259583,2024-01-04T04:31:45,Bilbao,expenses,leisure,-80.14,-60143.22
buyer_1,Luis,,1996-08-10,ES05209515179869230980,TRX_N-00808-36293577,2024-01-05T13:59:08,Bilbao,expenses,food,-104.54,-60247.76
buyer_1,Luis,,1996-08-10,ES05209515179869230980,TRX_N-00809-97690316,2024-01-05T04:30:11,Bilbao,expenses,leisure,-48.2,-60295.96
buyer_1,Luis,,1996-08-10,ES05209515179869230980,TRX_N-00810-74406736,2024-01-05T11:35:37,Bilbao,expenses,repairs,-206.47,-60502.43
buyer_1,Luis,,1996-08-10,ES05209515179869230980,TRX_N-00811-94502665,2024-01-06T15:18:22,Bilbao,expenses,internet,-42.0,-60544.43
buyer_1,Luis,,1996-08-10,ES05209515179869230980,TRX_N-00812-98641906,2024-01-06T19:17:18,Amurrio,expenses,leisure,-49.55,-60593.98
buyer_1,Luis,,1996-08-10,ES05209515179869230980,TRX_N-00813-51115072,2024-01-07T20:55:44,Bilbao,expenses,electricity,-46.59,-60640.57
buyer_1,Luis,,1996-08-10,ES05209515179869230980,TRX_N-00814-41161941,2024-01-07T10:04:20,Bilbao,expenses,gas,-82.64,-60723.21
buyer_1,Luis,,1996-08-10,ES05209515179869230980,TRX_N-00815-70999105,2024-01-07T20:05:08,Bilbao,expenses,leisure,-80.15,-60803.36
buyer_1,Luis,,1996-08-10,ES05209515179869230980,TRX_N-00816-69552343,2024-01-08T21:47:19,Bilbao,expenses,water,-38.69,-60842.05
buyer_1,Luis,,1996-08-10,ES05209515179869230980,TRX_N-00817-42943865,2024-01-08T16:04:29,Bilbao,expenses,phone,-33.68,-60875.73
buyer_1,Luis,,1996-08-10,ES05209515179869230980,TRX_N-00818-00371629,2024-01-08T20:13:02,Bilbao,expenses,food,-96.76,-60972.49
buyer_1,Luis,,1996-08-10,ES05209515179869230980,TRX_N-00819-82364908,2024-01-10T16:15:44,Bilbao,expenses,transport,-87.42,-61059.91
buyer_1,Luis,,1996-08-10,ES05209515179869230980,TRX_N-00820-37226548,2024-01-11T13:10:44,Bilbao,expenses,transport,-79.44,-61139.35
buyer_1,Luis,,1996-08-10,ES05209515179869230980,TRX_N-00821-65432283,2024-01-11T19:29:04,Bilbao,expenses,leisure,-62.28,-61201.63
buyer_1,Luis,,1996-08-10,ES05209515179869230980,TRX_N-00822-38193822,2024-01-11T04:22:17,Bilbao,expenses,education,-47.59,-61249.22
buyer_1,Luis,,1996-08-10,ES05209515179869230980,TRX_N-00823-61064207,2024-01-12T04:49:16,Bilbao,expenses,cash,-100.0,-61349.22
buyer_1,Luis,,1996-08-10,ES05209515179869230980,TRX_N-00824-97299015,2024-01-14T14:56:33,Bilbao,expenses,food,-116.77,-61465.99
buyer_1,Luis,,1996-08-10,ES05209515179869230980,TRX_N-00825-88147826,2024-01-14T09:05:11,Santurtzi,expenses,leisure,-71.86,-61537.85
buyer_1,Luis,,1996-08-10,ES05209515179869230980,TRX_N-00826-26065175,2024-01-14T13:02:50,Bilbao,expenses,repairs,-59.42,-61597.27
buyer_1,Luis,,1996-08-10,ES05209515179869230980,TRX_N-00827-54335591,2024-01-17T06:14:13,Bilbao,expenses,cash,-100.0,-61697.27
buyer_1,Luis,,1996-08-10,ES05209515179869230980,TRX_N-00828-94692409,2024-01-18T09:48:29,Bilbao,expenses,gifts,-649.27,-62346.54
buyer_1,Luis,,1996-08-10,ES05209515179869230980,TRX_N-00829-70961581,2024-01-19T17:32:00,Bilbao,expenses,cash,-100.0,-62446.54
buyer_1,Luis,,1996-08-10,ES05209515179869230980,TRX_N-00830-01404364,2024-01-20T00:38:43,Bilbao,expenses,food,-64.15,-62510.69
buyer_1,Luis,,1996-08-10,ES05209515179869230980,TRX_N-00831-49201889,2024-01-20T10:21:21,Bilbao,expenses,transport,-76.39,-62587.08
buyer_1,Luis,,1996-08-10,ES05209515179869230980,TRX_N-00832-35274516,2024-01-21T12:02:37,Bilbao,expenses,cash,-100.0,-62687.08
buyer_1,Luis,,1996-08-10,ES05209515179869230980,TRX_N-00833-30965889,2024-01-22T19:59:23,Barakaldo,expenses,transport,-74.55,-62761.63
buyer_1,Luis,,1996-08-10,ES05209515179869230980,TRX_N-00834-48961395,2024-01-22T09:14:38,Bilbao,expenses,clothing,-46.61,-62808.24
buyer_1,Luis,,1996-08-10,ES05209515179869230980,TRX_N-00835-65422702,2024-01-23T14:55:36,Bilbao,expenses,repairs,-311.44,-63119.68
buyer_1,Luis,,1996-08-10,ES05209515179869230980,TRX_N-00836-64481257,2024-01-24T15:24:59,Bilbao,expenses,travel,-1389.83,-64509.51
buyer_1,Luis,,1996-08-10,ES05209515179869230980,TRX_N-00837-39420797,2024-01-26T11:16:46,Bilbao,expenses,cash,-100.0,-64609.51
buyer_1,Luis,,1996-08-10,ES05209515179869230980,TRX_N-00838-76484129,2024-01-27T13:12:30,Bilbao,expenses,food,-73.04,-64682.55
buyer_1,Luis,,1996-08-10,ES05209515179869230980,TRX_N-00839-68244180,2024-01-27T10:43:35,Arrasate,expenses,leisure,-51.58,-64734.13
buyer_1,Luis,,1996-08-10,ES05209515179869230980,TRX_N-00840-94975510,2024-01-27T11:14:30,Bilbao,expenses,clothing,-87.35,-64821.48
buyer_1,Luis,,1996-08-10,ES05209515179869230980,TRX_N-00841-81125453,2024-01-27T17:11:57,Bilbao,expenses,gifts,-663.69,-65485.17
buyer_1,Luis,,1996-08-10,ES05209515179869230980,TRX_N-00842-50124122,2024-01-28T06:52:25,Bilbao,expenses,clothing,-128.79,-65613.96
buyer_1,Luis,,1996-08-10,ES05209515179869230980,TRX_N-00843-59325084,2024-01-30T15:26:20,Andoain,expenses,education,-54.59,-65668.55
buyer_1,Luis,,1996-08-10,ES05209515179869230980,TRX_N-00844-31670884,2024-01-31T10:32:27,Bilbao,expenses,cash,-100.0,-65768.55
buyer_1,Luis,,1996-08-10,ES05209515179869230980,TRX_N-00845-41327139,2024-01-31T16:54:58,Bilbao,expenses,gifts,-787.47,-66556.02
buyer_1,Luis,,1996-08-10,ES05209515179869230980,TRX_N-00846-88670178,2024-02-01T19:05:17,Bilbao,incomes,salary,1693.78,-64862.24
buyer_1,Luis,,1996-08-10,ES05209515179869230980,TRX_N-00847-69908644,2024-02-01T10:46:49,Bilbao,expenses,clothing,-133.8,-64996.04
buyer_1,Luis,,1996-08-10,ES05209515179869230980,TRX_N-00848-46944902,2024-02-03T03:31:51,Vitoria-Gasteiz,expenses,food,-110.35,-65106.39
buyer_1,Luis,,1996-08-10,ES05209515179869230980,TRX_N-00849-96610163,2024-02-03T12:20:59,Bilbao,expenses,cash,-100.0,-65206.39
buyer_1,Luis,,1996-08-10,ES05209515179869230980,TRX_N-00850-95430941,2024-02-04T18:32:17,Bilbao,expenses,rent,-601.82,-65808.21
buyer_1,Luis,,1996-08-10,ES05209515179869230980,TRX_N-00851-99670471,2024-02-05T23:05:05,Bilbao,expenses,phone,-37.28,-65845.49
buyer_1,Luis,,1996-08-10,ES05209515179869230980,TRX_N-00852-25840872,2024-02-06T18:17:59,Barakaldo,expenses,food,-73.26,-65918.75
buyer_1,Luis,,1996-08-10,ES05209515179869230980,TRX_N-00853-26175504,2024-02-07T09:48:03,Bilbao,expenses,electricity,-73.4,-65992.15
buyer_1,Luis,,1996-08-10,ES05209515179869230980,TRX_N-00854-46667556,2024-02-07T08:50:59,Bilbao,expenses,internet,-42.0,-66034.15
buyer_1,Luis,,1996-08-10,ES05209515179869230980,TRX_N-00855-11980115,2024-02-07T19:18:52,Bilbao,expenses,food,-120.79,-66154.94
buyer_1,Luis,,1996-08-10,ES05209515179869230980,TRX_N-00856-01993958,2024-02-07T20:15:55,Bilbao,expenses,leisure,-84.84,-66239.78
buyer_1,Luis,,1996-08-10,ES05209515179869230980,TRX_N-00857-16811599,2024-02-07T08:43:44,Bilbao,expenses,education,-61.19,-66300.97
buyer_1,Luis,,1996-08-10,ES05209515179869230980,TRX_N-00858-21632324,2024-02-08T17:44:52,Bilbao,expenses,water,-37.26,-66338.23
buyer_1,Luis,,1996-08-10,ES05209515179869230980,TRX_N-00859-53339840,2024-02-08T02:10:49,Bilbao,expenses,gas,-79.62,-66417.85
buyer_1,Luis,,1996-08-10,ES05209515179869230980,TRX_N-00860-07808348,2024-02-09T12:21:17,Bilbao,expenses,food,-82.85,-66500.7
buyer_1,Luis,,1996-08-10,ES05209515179869230980,TRX_N-00861-70300560,2024-02-09T22:07:50,Bilbao,expenses,cash,-100.0,-66600.7
buyer_1,Luis,,1996-08-10,ES05209515179869230980,TRX_N-00862-63143338,2024-02-12T08:55:53,Bilbao,expenses,leisure,-46.75,-66647.45
buyer_1,Luis,,1996-08-10,ES05209515179869230980,TRX_N-00863-48400873,2024-02-15T09:43:12,Bilbao,expenses,cash,-100.0,-66747.45
buyer_1,Luis,,1996-08-10,ES05209515179869230980,TRX_N-00864-50650373,2024-02-16T15:53:54,Bilbao,expenses,food,-71.68,-66819.13
buyer_1,Luis,,1996-08-10,ES05209515179869230980,TRX_N-00865-87102981,2024-02-16T19:51:30,Bilbao,expenses,cash,-100.0,-66919.13
buyer_1,Luis,,1996-08-10,ES05209515179869230980,TRX_N-00866-59599291,2024-02-18T18:38:03,Durango,expenses,leisure,-49.04,-66968.17
buyer_1,Luis,,1996-08-10,ES05209515179869230980,TRX_N-00867-86451292,2024-02-21T23:11:32,Bilbao,expenses,food,-73.88,-67042.05
buyer_1,Luis,,1996-08-10,ES05209515179869230980,TRX_N-00868-97691907,2024-02-21T19:40:01,Bilbao,expenses,transport,-82.97,-67125.02
buyer_1,Luis,,1996-08-10,ES05209515179869230980,TRX_N-00869-61837279,2024-02-21T09:39:40,Arrasate,expenses,gifts,-446.69,-67571.71
buyer_1,Luis,,1996-08-10,ES05209515179869230980,TRX_N-00870-65618659,2024-02-23T20:37:56,Bilbao,expenses,food,-96.23,-67667.94
buyer_1,Luis,,1996-08-10,ES05209515179869230980,TRX_N-00871-87594881,2024-02-24T12:27:48,Bilbao,expenses,cash,-100.0,-67767.94
buyer_1,Luis,,1996-08-10,ES05209515179869230980,TRX_N-00872-63764508,2024-02-25T19:29:14,Bilbao,expenses,healthcare,-168.14,-67936.08
buyer_1,Luis,,1996-08-10,ES05209515179869230980,TRX_N-00873-25794013,2024-02-25T13:51:09,Iru√±a de Oca,expenses,gifts,-788.27,-68724.35
buyer_1,Luis,,1996-08-10,ES05209515179869230980,TRX_N-00874-43932519,2024-02-26T08:47:14,Mungia,expenses,transport,-70.84,-68795.19
buyer_1,Luis,,1996-08-10,ES05209515179869230980,TRX_N-00875-72064226,2024-02-28T17:09:49,Bilbao,expenses,food,-93.84,-68889.03
buyer_1,Luis,,1996-08-10,ES05209515179869230980,TRX_N-00876-30444722,2024-03-01T05:27:55,Bilbao,incomes,salary,1693.78,-67195.25
buyer_1,Luis,,1996-08-10,ES05209515179869230980,TRX_N-00877-39562390,2024-03-01T21:37:31,Bilbao,expenses,leisure,-62.33,-67257.58
buyer_1,Luis,,1996-08-10,ES05209515179869230980,TRX_N-00878-55579914,2024-03-02T06:51:49,Bilbao,expenses,food,-85.52,-67343.1
buyer_1,Luis,,1996-08-10,ES05209515179869230980,TRX_N-00879-27393963,2024-03-02T20:13:57,Bilbao,expenses,transport,-68.6,-67411.7
buyer_1,Luis,,1996-08-10,ES05209515179869230980,TRX_N-00880-22267657,2024-03-02T16:29:01,Bilbao,expenses,travel,-514.92,-67926.62
buyer_1,Luis,,1996-08-10,ES05209515179869230980,TRX_N-00881-51873566,2024-03-03T09:57:02,Bilbao,expenses,leisure,-26.66,-67953.28
buyer_1,Luis,,1996-08-10,ES05209515179869230980,TRX_N-00882-57924427,2024-03-04T13:22:36,Bilbao,expenses,rent,-601.82,-68555.1
buyer_1,Luis,,1996-08-10,ES05209515179869230980,TRX_N-00883-31290482,2024-03-04T16:40:16,Bilbao,expenses,transport,-59.9,-68615.0
buyer_1,Luis,,1996-08-10,ES05209515179869230980,TRX_N-00884-25018548,2024-03-04T12:16:18,Bilbao,expenses,cash,-100.0,-68715.0
buyer_1,Luis,,1996-08-10,ES05209515179869230980,TRX_N-00885-29531676,2024-03-05T08:36:19,Bilbao,expenses,phone,-38.3,-68753.3
buyer_1,Luis,,1996-08-10,ES05209515179869230980,TRX_N-00886-87065227,2024-03-05T19:32:39,Bilbao,expenses,transport,-63.17,-68816.47
buyer_1,Luis,,1996-08-10,ES05209515179869230980,TRX_N-00887-59207215,2024-03-05T14:23:26,Bilbao,expenses,cash,-100.0,-68916.47
buyer_1,Luis,,1996-08-10,ES05209515179869230980,TRX_N-00888-24012932,2024-03-06T15:16:23,Bilbao,expenses,electricity,-33.98,-68950.45
buyer_1,Luis,,1996-08-10,ES05209515179869230980,TRX_N-00889-43655592,2024-03-06T10:55:10,Bilbao,expenses,gas,-73.71,-69024.16
buyer_1,Luis,,1996-08-10,ES05209515179869230980,TRX_N-00890-27834566,2024-03-06T17:23:21,Bilbao,expenses,food,-71.59,-69095.75
buyer_1,Luis,,1996-08-10,ES05209515179869230980,TRX_N-00891-16186614,2024-03-06T20:18:38,Bilbao,expenses,transport,-70.82,-69166.57
buyer_1,Luis,,1996-08-10,ES05209515179869230980,TRX_N-00892-86838482,2024-03-07T16:13:01,Bilbao,expenses,internet,-42.0,-69208.57
buyer_1,Luis,,1996-08-10,ES05209515179869230980,TRX_N-00893-85070381,2024-03-07T06:22:47,Bilbao,expenses,cash,-100.0,-69308.57
buyer_1,Luis,,1996-08-10,ES05209515179869230980,TRX_N-00894-50175139,2024-03-08T16:56:09,Bilbao,expenses,water,-31.86,-69340.43
buyer_1,Luis,,1996-08-10,ES05209515179869230980,TRX_N-00895-54816255,2024-03-09T19:42:30,Bilbao,expenses,food,-60.17,-69400.6
buyer_1,Luis,,1996-08-10,ES05209515179869230980,TRX_N-00896-99983694,2024-03-09T13:48:36,Amurrio,expenses,travel,-902.02,-70302.62
buyer_1,Luis,,1996-08-10,ES05209515179869230980,TRX_N-00897-48312592,2024-03-09T20:31:10,Bilbao,expenses,repairs,-257.2,-70559.82
buyer_1,Luis,,1996-08-10,ES05209515179869230980,TRX_N-00898-08534567,2024-03-10T13:08:44,Bilbao,expenses,food,-96.4,-70656.22
buyer_1,Luis,,1996-08-10,ES05209515179869230980,TRX_N-00899-80653351,2024-03-10T09:17:47,Bilbao,expenses,transport,-74.47,-70730.69
buyer_1,Luis,,1996-08-10,ES05209515179869230980,TRX_N-00900-69807580,2024-03-11T14:13:57,Bilbao,expenses,food,-91.95,-70822.64
buyer_1,Luis,,1996-08-10,ES05209515179869230980,TRX_N-00901-46001426,2024-03-14T15:41:55,Bilbao,expenses,food,-62.67,-70885.31
buyer_1,Luis,,1996-08-10,ES05209515179869230980,TRX_N-00902-52673627,2024-03-14T10:30:36,Bilbao,expenses,cash,-100.0,-70985.31
buyer_1,Luis,,1996-08-10,ES05209515179869230980,TRX_N-00903-59363675,2024-03-18T10:30:24,Bilbao,expenses,clothing,-111.35,-71096.66
buyer_1,Luis,,1996-08-10,ES05209515179869230980,TRX_N-00904-34050797,2024-03-19T16:59:41,Bilbao,expenses,clothing,-150.13,-71246.79
buyer_1,Luis,,1996-08-10,ES05209515179869230980,TRX_N-00905-31074475,2024-03-19T18:14:33,Bilbao,expenses,cash,-100.0,-71346.79
buyer_1,Luis,,1996-08-10,ES05209515179869230980,TRX_N-00906-78238837,2024-03-19T14:25:21,Bilbao,expenses,gifts,-78.42,-71425.21
buyer_1,Luis,,1996-08-10,ES05209515179869230980,TRX_N-00907-81581232,2024-03-23T23:57:42,Llodio,expenses,clothing,-67.54,-71492.75
buyer_1,Luis,,1996-08-10,ES05209515179869230980,TRX_N-00908-58977035,2024-03-24T07:19:28,Bilbao,expenses,food,-124.13,-71616.88
buyer_1,Luis,,1996-08-10,ES05209515179869230980,TRX_N-00909-16215834,2024-03-24T17:58:36,Arrasate,expenses,leisure,-67.08,-71683.96
buyer_1,Luis,,1996-08-10,ES05209515179869230980,TRX_N-00910-60551043,2024-03-24T08:47:00,Eibar,expenses,healthcare,-55.98,-71739.94
buyer_1,Luis,,1996-08-10,ES05209515179869230980,TRX_N-00911-45615941,2024-03-25T12:23:13,Bilbao,expenses,clothing,-49.13,-71789.07
buyer_1,Luis,,1996-08-10,ES05209515179869230980,TRX_N-00912-35264056,2024-03-27T16:36:59,Bilbao,expenses,leisure,-79.06,-71868.13
buyer_1,Luis,,1996-08-10,ES05209515179869230980,TRX_N-00913-33939361,2024-03-27T10:16:29,Bilbao,expenses,repairs,-310.78,-72178.91
buyer_1,Luis,,1996-08-10,ES05209515179869230980,TRX_N-00914-94060721,2024-03-29T13:07:10,Arrasate,expenses,repairs,-243.3,-72422.21
buyer_1,Luis,,1996-08-10,ES05209515179869230980,TRX_N-00915-20762968,2024-03-31T18:41:21,Bilbao,expenses,transport,-41.0,-72463.21
buyer_1,Luis,,1996-08-10,ES05209515179869230980,TRX_N-00916-39992572,2024-03-31T19:03:52,Bilbao,expenses,appliances,-179.07,-72642.28
buyer_1,Luis,,1996-08-10,ES05209515179869230980,TRX_N-00917-13796113,2024-04-01T17:49:47,Bilbao,incomes,salary,1693.78,-70948.5
buyer_1,Luis,,1996-08-10,ES05209515179869230980,TRX_N-00918-83187962,2024-04-01T17:49:47,Bilbao,incomes,extra_income,260.51,-70687.99
buyer_1,Luis,,1996-08-10,ES05209515179869230980,TRX_N-00919-52115416,2024-04-02T09:14:53,Llodio,expenses,transport,-40.95,-70728.94
buyer_1,Luis,,1996-08-10,ES05209515179869230980,TRX_N-00920-53883521,2024-04-04T13:47:36,Bilbao,expenses,rent,-601.82,-71330.76
buyer_1,Luis,,1996-08-10,ES05209515179869230980,TRX_N-00921-31300750,2024-04-05T19:07:18,Bilbao,expenses,gas,-67.75,-71398.51
buyer_1,Luis,,1996-08-10,ES05209515179869230980,TRX_N-00922-90681657,2024-04-05T08:22:47,Bilbao,expenses,internet,-42.0,-71440.51
buyer_1,Luis,,1996-08-10,ES05209515179869230980,TRX_N-00923-28157757,2024-04-05T12:44:14,Pasaia,expenses,cash,-100.0,-71540.51
buyer_1,Luis,,1996-08-10,ES05209515179869230980,TRX_N-00924-63921493,2024-04-07T11:29:01,Bilbao,expenses,electricity,-57.08,-71597.59
buyer_1,Luis,,1996-08-10,ES05209515179869230980,TRX_N-00925-11873391,2024-04-07T09:38:07,Bilbao,expenses,food,-123.92,-71721.51
buyer_1,Luis,,1996-08-10,ES05209515179869230980,TRX_N-00926-84782390,2024-04-07T15:06:33,Bilbao,expenses,leisure,-30.28,-71751.79
buyer_1,Luis,,1996-08-10,ES05209515179869230980,TRX_N-00927-24017103,2024-04-08T19:34:04,Bilbao,expenses,water,-29.91,-71781.7
buyer_1,Luis,,1996-08-10,ES05209515179869230980,TRX_N-00928-24154127,2024-04-08T14:46:15,Bilbao,expenses,phone,-34.29,-71815.99
buyer_1,Luis,,1996-08-10,ES05209515179869230980,TRX_N-00929-03280801,2024-04-09T19:04:57,Lasarte-Oria,expenses,appliances,-250.63,-72066.62
buyer_1,Luis,,1996-08-10,ES05209515179869230980,TRX_N-00930-62690416,2024-04-09T13:21:01,Bilbao,expenses,gifts,-419.33,-72485.95
buyer_1,Luis,,1996-08-10,ES05209515179869230980,TRX_N-00931-73995526,2024-04-10T15:59:23,Bilbao,expenses,transport,-81.99,-72567.94
buyer_1,Luis,,1996-08-10,ES05209515179869230980,TRX_N-00932-41706927,2024-04-12T15:19:25,Bilbao,expenses,transport,-70.95,-72638.89
buyer_1,Luis,,1996-08-10,ES05209515179869230980,TRX_N-00933-59324592,2024-04-15T17:23:01,Bilbao,expenses,leisure,-37.92,-72676.81
buyer_1,Luis,,1996-08-10,ES05209515179869230980,TRX_N-00934-18808949,2024-04-17T20:38:19,Bilbao,expenses,food,-76.83,-72753.64
buyer_1,Luis,,1996-08-10,ES05209515179869230980,TRX_N-00935-80632053,2024-04-17T17:17:21,Bilbao,expenses,transport,-76.76,-72830.4
buyer_1,Luis,,1996-08-10,ES05209515179869230980,TRX_N-00936-88160053,2024-04-18T10:46:16,Bilbao,expenses,transport,-45.9,-72876.3
buyer_1,Luis,,1996-08-10,ES05209515179869230980,TRX_N-00937-25765592,2024-04-18T16:54:18,Bilbao,expenses,repairs,-93.02,-72969.32
buyer_1,Luis,,1996-08-10,ES05209515179869230980,TRX_N-00938-08204584,2024-04-20T12:48:16,Bilbao,expenses,food,-71.07,-73040.39
buyer_1,Luis,,1996-08-10,ES05209515179869230980,TRX_N-00939-10840481,2024-04-20T15:09:57,Bilbao,expenses,cash,-100.0,-73140.39
buyer_1,Luis,,1996-08-10,ES05209515179869230980,TRX_N-00940-72974714,2024-04-21T14:00:57,Bilbao,expenses,education,-43.31,-73183.7
buyer_1,Luis,,1996-08-10,ES05209515179869230980,TRX_N-00941-81601881,2024-04-24T18:51:33,Bilbao,expenses,cash,-100.0,-73283.7
buyer_1,Luis,,1996-08-10,ES05209515179869230980,TRX_N-00942-17130135,2024-04-25T10:08:35,Bilbao,expenses,repairs,-290.05,-73573.75
buyer_1,Luis,,1996-08-10,ES05209515179869230980,TRX_N-00943-26805544,2024-04-26T19:47:48,Bilbao,expenses,transport,-42.74,-73616.49
buyer_1,Luis,,1996-08-10,ES05209515179869230980,TRX_N-00944-98523839,2024-04-30T14:51:21,Bilbao,expenses,transport,-63.06,-73679.55
buyer_1,Luis,,1996-08-10,ES05209515179869230980,TRX_N-00945-43089239,2024-05-01T09:48:28,Bilbao,incomes,salary,1693.78,-71985.77
buyer_1,Luis,,1996-08-10,ES05209515179869230980,TRX_N-00946-29857094,2024-05-01T11:37:44,Bilbao,expenses,cash,-100.0,-72085.77
buyer_1,Luis,,1996-08-10,ES05209515179869230980,TRX_N-00947-34196668,2024-05-02T14:41:05,Bilbao,expenses,leisure,-29.75,-72115.52
buyer_1,Luis,,1996-08-10,ES05209515179869230980,TRX_N-00948-72706988,2024-05-03T11:16:05,Bilbao,expenses,food,-60.77,-72176.29
buyer_1,Luis,,1996-08-10,ES05209515179869230980,TRX_N-00949-14373790,2024-05-04T13:32:45,Bilbao,expenses,rent,-601.82,-72778.11
buyer_1,Luis,,1996-08-10,ES05209515179869230980,TRX_N-00950-68748771,2024-05-05T22:26:43,Bilbao,expenses,internet,-42.0,-72820.11
buyer_1,Luis,,1996-08-10,ES05209515179869230980,TRX_N-00951-21815490,2024-05-06T11:51:19,Bilbao,expenses,electricity,-61.92,-72882.03
buyer_1,Luis,,1996-08-10,ES05209515179869230980,TRX_N-00952-47472912,2024-05-06T18:38:06,Bilbao,expenses,phone,-41.45,-72923.48
buyer_1,Luis,,1996-08-10,ES05209515179869230980,TRX_N-00953-66739166,2024-05-07T20:56:48,Bilbao,expenses,water,-24.17,-72947.65
buyer_1,Luis,,1996-08-10,ES05209515179869230980,TRX_N-00954-35476077,2024-05-07T11:46:58,Bilbao,expenses,clothing,-116.53,-73064.18
buyer_1,Luis,,1996-08-10,ES05209515179869230980,TRX_N-00955-01821122,2024-05-07T12:59:05,Bilbao,expenses,appliances,-131.4,-73195.58
buyer_1,Luis,,1996-08-10,ES05209515179869230980,TRX_N-00956-69700272,2024-05-08T08:22:45,Bilbao,expenses,gas,-90.79,-73286.37
buyer_1,Luis,,1996-08-10,ES05209515179869230980,TRX_N-00957-68709578,2024-05-08T15:17:58,Bilbao,expenses,cash,-100.0,-73386.37
buyer_1,Luis,,1996-08-10,ES05209515179869230980,TRX_N-00958-44094087,2024-05-08T08:51:41,Bilbao,expenses,repairs,-213.45,-73599.82
buyer_1,Luis,,1996-08-10,ES05209515179869230980,TRX_N-00959-11089980,2024-05-09T11:43:53,Bilbao,expenses,transport,-46.83,-73646.65
buyer_1,Luis,,1996-08-10,ES05209515179869230980,TRX_N-00960-79563413,2024-05-09T14:03:46,Bilbao,expenses,cash,-100.0,-73746.65
buyer_1,Luis,,1996-08-10,ES05209515179869230980,TRX_N-00961-22351830,2024-05-12T13:37:55,Bilbao,expenses,leisure,-80.63,-73827.28
buyer_1,Luis,,1996-08-10,ES05209515179869230980,TRX_N-00962-26639330,2024-05-13T11:40:04,Bilbao,expenses,food,-87.82,-73915.1
buyer_1,Luis,,1996-08-10,ES05209515179869230980,TRX_N-00963-79296986,2024-05-14T17:27:42,Bilbao,expenses,repairs,-285.29,-74200.39
buyer_1,Luis,,1996-08-10,ES05209515179869230980,TRX_N-00964-26155220,2024-05-16T15:24:53,Bilbao,expenses,transport,-43.13,-74243.52
buyer_1,Luis,,1996-08-10,ES05209515179869230980,TRX_N-00965-11090012,2024-05-19T10:00:59,Pasaia,expenses,transport,-68.62,-74312.14
buyer_1,Luis,,1996-08-10,ES05209515179869230980,TRX_N-00966-95207190,2024-05-20T11:01:50,Bilbao,expenses,gifts,-562.7,-74874.84
buyer_1,Luis,,1996-08-10,ES05209515179869230980,TRX_N-00967-23512980,2024-05-21T14:44:21,Bilbao,expenses,healthcare,-142.99,-75017.83
buyer_1,Luis,,1996-08-10,ES05209515179869230980,TRX_N-00968-15090743,2024-05-22T12:22:29,Bilbao,expenses,leisure,-64.18,-75082.01
buyer_1,Luis,,1996-08-10,ES05209515179869230980,TRX_N-00969-03526647,2024-05-22T09:12:29,Bilbao,expenses,repairs,-196.75,-75278.76
buyer_1,Luis,,1996-08-10,ES05209515179869230980,TRX_N-00970-90161959,2024-05-23T12:32:23,Bilbao,expenses,leisure,-49.18,-75327.94
buyer_1,Luis,,1996-08-10,ES05209515179869230980,TRX_N-00971-21183299,2024-05-23T14:13:24,Bilbao,expenses,education,-52.46,-75380.4
buyer_1,Luis,,1996-08-10,ES05209515179869230980,TRX_N-00972-03193597,2024-05-25T14:58:07,Bilbao,expenses,repairs,-153.18,-75533.58
buyer_1,Luis,,1996-08-10,ES05209515179869230980,TRX_N-00973-16488779,2024-05-27T08:32:50,Bilbao,expenses,leisure,-63.93,-75597.51
buyer_1,Luis,,1996-08-10,ES05209515179869230980,TRX_N-00974-15707268,2024-05-29T11:28:10,Bilbao,expenses,leisure,-38.08,-75635.59
buyer_1,Luis,,1996-08-10,ES05209515179869230980,TRX_N-00975-64524627,2024-05-29T17:11:52,Mungia,expenses,gifts,-540.66,-76176.25
buyer_1,Luis,,1996-08-10,ES05209515179869230980,TRX_N-00976-36016394,2024-05-30T14:29:47,Bilbao,expenses,gifts,-346.35,-76522.6
buyer_1,Luis,,1996-08-10,ES05209515179869230980,TRX_N-00977-12683241,2024-05-31T15:35:49,Bilbao,expenses,travel,-696.07,-77218.67
buyer_1,Luis,,1996-08-10,ES05209515179869230980,TRX_N-00978-85605681,2024-06-01T18:01:55,Bilbao,incomes,salary,1693.78,-75524.89
buyer_1,Luis,,1996-08-10,ES05209515179869230980,TRX_N-00979-32139368,2024-06-01T18:01:55,Bilbao,incomes,salary_bonus,1324.6,-74200.29
buyer_1,Luis,,1996-08-10,ES05209515179869230980,TRX_N-00980-34268336,2024-06-01T20:16:13,Errenteria,expenses,food,-97.22,-74297.51
buyer_1,Luis,,1996-08-10,ES05209515179869230980,TRX_N-00981-33884638,2024-06-02T20:24:48,Bilbao,expenses,cash,-100.0,-74397.51
buyer_1,Luis,,1996-08-10,ES05209515179869230980,TRX_N-00982-80050374,2024-06-03T13:11:32,Bilbao,expenses,taxes,-1719.25,-76116.76
buyer_1,Luis,,1996-08-10,ES05209515179869230980,TRX_N-00983-04703855,2024-06-03T17:56:12,Bilbao,expenses,insurance,-402.23,-76518.99
buyer_1,Luis,,1996-08-10,ES05209515179869230980,TRX_N-00984-46430400,2024-06-03T15:41:45,Bilbao,expenses,leisure,-31.57,-76550.56
buyer_1,Luis,,1996-08-10,ES05209515179869230980,TRX_N-00985-17701422,2024-06-04T07:32:01,Bilbao,expenses,rent,-601.82,-77152.38
buyer_1,Luis,,1996-08-10,ES05209515179869230980,TRX_N-00986-23490387,2024-06-04T09:43:03,Bilbao,expenses,gifts,-676.8,-77829.18
buyer_1,Luis,,1996-08-10,ES05209515179869230980,TRX_N-00987-22897653,2024-06-05T20:30:54,Bilbao,expenses,electricity,-37.89,-77867.07
buyer_1,Luis,,1996-08-10,ES05209515179869230980,TRX_N-00988-31385349,2024-06-05T09:20:20,Bilbao,expenses,internet,-42.0,-77909.07
buyer_1,Luis,,1996-08-10,ES05209515179869230980,TRX_N-00989-85471308,2024-06-05T17:25:42,Bilbao,expenses,phone,-43.64,-77952.71
buyer_1,Luis,,1996-08-10,ES05209515179869230980,TRX_N-00990-43698425,2024-06-05T09:38:20,Bilbao,expenses,food,-84.67,-78037.38
buyer_1,Luis,,1996-08-10,ES05209515179869230980,TRX_N-00991-86399387,2024-06-05T17:56:34,Sopela,expenses,leisure,-52.86,-78090.24
buyer_1,Luis,,1996-08-10,ES05209515179869230980,TRX_N-00992-04096028,2024-06-05T15:33:56,Bilbao,expenses,healthcare,-188.17,-78278.41
buyer_1,Luis,,1996-08-10,ES05209515179869230980,TRX_N-00993-04975983,2024-06-07T08:40:18,Bilbao,expenses,water,-34.91,-78313.32
buyer_1,Luis,,1996-08-10,ES05209515179869230980,TRX_N-00994-62756113,2024-06-07T08:17:03,Bilbao,expenses,gas,-114.56,-78427.88
buyer_1,Luis,,1996-08-10,ES05209515179869230980,TRX_N-00995-00816334,2024-06-08T17:41:16,Bilbao,expenses,transport,-42.45,-78470.33
buyer_1,Luis,,1996-08-10,ES05209515179869230980,TRX_N-00996-88001441,2024-06-09T18:50:57,Bilbao,expenses,food,-97.06,-78567.39
buyer_1,Luis,,1996-08-10,ES05209515179869230980,TRX_N-00997-39080017,2024-06-09T20:00:33,Bilbao,expenses,leisure,-78.65,-78646.04
buyer_1,Luis,,1996-08-10,ES05209515179869230980,TRX_N-00998-62793558,2024-06-12T20:17:48,Bilbao,expenses,leisure,-46.45,-78692.49
buyer_1,Luis,,1996-08-10,ES05209515179869230980,TRX_N-00999-40041770,2024-06-15T10:13:50,Bilbao,expenses,food,-65.53,-78758.02
buyer_1,Luis,,1996-08-10,ES05209515179869230980,TRX_N-01000-38645452,2024-06-18T20:28:37,Santurtzi,expenses,leisure,-80.09,-78838.11
buyer_1,Luis,,1996-08-10,ES05209515179869230980,TRX_N-01001-12232933,2024-06-18T09:15:25,Bilbao,expenses,education,-68.53,-78906.64
buyer_1,Luis,,1996-08-10,ES05209515179869230980,TRX_N-01002-46016413,2024-06-19T01:15:42,Bilbao,expenses,food,-117.19,-79023.83
buyer_1,Luis,,1996-08-10,ES05209515179869230980,TRX_N-01003-46152440,2024-06-20T16:33:17,Bilbao,expenses,healthcare,-109.64,-79133.47
buyer_1,Luis,,1996-08-10,ES05209515179869230980,TRX_N-01004-30898999,2024-06-21T10:58:18,Bilbao,expenses,gifts,-232.93,-79366.4
buyer_1,Luis,,1996-08-10,ES05209515179869230980,TRX_N-01005-08479150,2024-06-23T13:08:12,Bilbao,expenses,food,-98.96,-79465.36
buyer_1,Luis,,1996-08-10,ES05209515179869230980,TRX_N-01006-29780416,2024-06-24T09:11:27,Bilbao,expenses,transport,-64.72,-79530.08
buyer_1,Luis,,1996-08-10,ES05209515179869230980,TRX_N-01007-86096434,2024-06-25T12:38:52,Bilbao,expenses,food,-76.03,-79606.11
buyer_1,Luis,,1996-08-10,ES05209515179869230980,TRX_N-01008-18415231,2024-06-25T11:38:47,Bilbao,expenses,leisure,-48.83,-79654.94
buyer_1,Luis,,1996-08-10,ES05209515179869230980,TRX_N-01009-64940300,2024-06-27T05:48:28,Bilbao,expenses,food,-111.39,-79766.33
buyer_1,Luis,,1996-08-10,ES05209515179869230980,TRX_N-01010-20334023,2024-06-27T11:50:31,Bilbao,expenses,cash,-100.0,-79866.33
buyer_1,Luis,,1996-08-10,ES05209515179869230980,TRX_N-01011-49080731,2024-06-28T08:32:25,Bilbao,expenses,repairs,-55.14,-79921.47
buyer_1,Luis,,1996-08-10,ES05209515179869230980,TRX_N-01012-18644679,2024-06-29T16:46:44,Santurtzi,expenses,appliances,-186.23,-80107.7
buyer_1,Luis,,1996-08-10,ES05209515179869230980,TRX_N-01013-87465583,2024-06-30T10:47:24,Andoain,expenses,repairs,-173.59,-80281.29
buyer_1,Luis,,1996-08-10,ES05209515179869230980,TRX_N-01014-95995953,2024-07-01T23:11:17,Bilbao,incomes,salary,1693.78,-78587.51
buyer_1,Luis,,1996-08-10,ES05209515179869230980,TRX_N-01015-21406692,2024-07-01T23:11:17,Bilbao,incomes,extra_income,260.51,-78327.0
buyer_1,Luis,,1996-08-10,ES05209515179869230980,TRX_N-01016-28514703,2024-07-01T17:30:00,Bilbao,expenses,cash,-100.0,-78427.0
buyer_1,Luis,,1996-08-10,ES05209515179869230980,TRX_N-01017-41460375,2024-07-01T18:34:03,Bilbao,expenses,appliances,-339.5,-78766.5
buyer_1,Luis,,1996-08-10,ES05209515179869230980,TRX_N-01018-39038415,2024-07-02T19:18:04,Eibar,expenses,clothing,-147.45,-78913.95
buyer_1,Luis,,1996-08-10,ES05209515179869230980,TRX_N-01019-13821818,2024-07-03T00:49:00,Bilbao,expenses,food,-114.13,-79028.08
buyer_1,Luis,,1996-08-10,ES05209515179869230980,TRX_N-01020-08070902,2024-07-04T11:21:05,Bilbao,expenses,rent,-601.82,-79629.9
buyer_1,Luis,,1996-08-10,ES05209515179869230980,TRX_N-01021-72717067,2024-07-05T06:21:37,Bilbao,expenses,gas,-52.41,-79682.31
buyer_1,Luis,,1996-08-10,ES05209515179869230980,TRX_N-01022-65284746,2024-07-05T10:29:16,Bilbao,expenses,phone,-39.23,-79721.54
buyer_1,Luis,,1996-08-10,ES05209515179869230980,TRX_N-01023-39983338,2024-07-05T20:22:49,Bilbao,expenses,education,-62.84,-79784.38
buyer_1,Luis,,1996-08-10,ES05209515179869230980,TRX_N-01024-66230368,2024-07-07T09:53:14,Bilbao,expenses,electricity,-51.05,-79835.43
buyer_1,Luis,,1996-08-10,ES05209515179869230980,TRX_N-01025-42497865,2024-07-07T20:11:14,Bilbao,expenses,internet,-42.0,-79877.43
buyer_1,Luis,,1996-08-10,ES05209515179869230980,TRX_N-01026-25094955,2024-07-07T19:42:16,Bilbao,expenses,food,-116.59,-79994.02
buyer_1,Luis,,1996-08-10,ES05209515179869230980,TRX_N-01027-09442422,2024-07-07T16:07:44,Bilbao,expenses,cash,-100.0,-80094.02
buyer_1,Luis,,1996-08-10,ES05209515179869230980,TRX_N-01028-95667841,2024-07-08T22:10:58,Bilbao,expenses,water,-36.14,-80130.16
buyer_1,Luis,,1996-08-10,ES05209515179869230980,TRX_N-01029-42482466,2024-07-08T09:16:25,Oy√≥n-Oion,expenses,food,-66.61,-80196.77
buyer_1,Luis,,1996-08-10,ES05209515179869230980,TRX_N-01030-46913442,2024-07-08T20:06:03,Barakaldo,expenses,repairs,-87.24,-80284.01
buyer_1,Luis,,1996-08-10,ES05209515179869230980,TRX_N-01031-05331214,2024-07-09T17:44:52,Bilbao,expenses,food,-90.13,-80374.14
buyer_1,Luis,,1996-08-10,ES05209515179869230980,TRX_N-01032-02278961,2024-07-09T19:25:55,Bilbao,expenses,transport,-75.07,-80449.21
buyer_1,Luis,,1996-08-10,ES05209515179869230980,TRX_N-01033-30747032,2024-07-11T09:05:39,Bilbao,expenses,food,-68.27,-80517.48
buyer_1,Luis,,1996-08-10,ES05209515179869230980,TRX_N-01034-85050462,2024-07-13T14:25:56,Bilbao,expenses,leisure,-55.79,-80573.27
buyer_1,Luis,,1996-08-10,ES05209515179869230980,TRX_N-01035-55376960,2024-07-13T08:58:28,Bilbao,expenses,education,-53.1,-80626.37
buyer_1,Luis,,1996-08-10,ES05209515179869230980,TRX_N-01036-41238289,2024-07-14T22:45:32,Bilbao,expenses,food,-88.48,-80714.85
buyer_1,Luis,,1996-08-10,ES05209515179869230980,TRX_N-01037-87333213,2024-07-14T04:16:19,Bilbao,expenses,transport,-69.46,-80784.31
buyer_1,Luis,,1996-08-10,ES05209515179869230980,TRX_N-01038-61196757,2024-07-17T10:39:35,Bilbao,expenses,leisure,-22.36,-80806.67
buyer_1,Luis,,1996-08-10,ES05209515179869230980,TRX_N-01039-97759842,2024-07-19T16:20:56,Bilbao,expenses,gifts,-294.46,-81101.13
buyer_1,Luis,,1996-08-10,ES05209515179869230980,TRX_N-01040-88169487,2024-07-21T15:07:22,Hondarribia,expenses,cash,-100.0,-81201.13
buyer_1,Luis,,1996-08-10,ES05209515179869230980,TRX_N-01041-34419261,2024-07-22T20:10:18,Bilbao,expenses,travel,-1342.0,-82543.13
buyer_1,Luis,,1996-08-10,ES05209515179869230980,TRX_N-01042-39776776,2024-07-25T08:39:20,Bilbao,expenses,food,-107.45,-82650.58
buyer_1,Luis,,1996-08-10,ES05209515179869230980,TRX_N-01043-19024716,2024-07-30T14:28:37,Bilbao,expenses,leisure,-64.83,-82715.41
buyer_1,Luis,,1996-08-10,ES05209515179869230980,TRX_N-01044-27234230,2024-07-31T13:25:46,Bilbao,expenses,transport,-82.48,-82797.89
buyer_1,Luis,,1996-08-10,ES05209515179869230980,TRX_N-01045-73548308,2024-08-01T16:57:43,Bilbao,incomes,salary,1693.78,-81104.11
buyer_1,Luis,,1996-08-10,ES05209515179869230980,TRX_N-01046-93809953,2024-08-01T17:17:44,Bilbao,expenses,transport,-52.03,-81156.14
buyer_1,Luis,,1996-08-10,ES05209515179869230980,TRX_N-01047-83687167,2024-08-01T18:15:34,Santurtzi,expenses,gifts,-736.42,-81892.56
buyer_1,Luis,,1996-08-10,ES05209515179869230980,TRX_N-01048-47177036,2024-08-04T13:53:56,Bilbao,expenses,rent,-601.82,-82494.38
buyer_1,Luis,,1996-08-10,ES05209515179869230980,TRX_N-01049-43221159,2024-08-04T12:30:01,Bilbao,expenses,food,-80.06,-82574.44
buyer_1,Luis,,1996-08-10,ES05209515179869230980,TRX_N-01050-10550703,2024-08-04T17:26:18,Bilbao,expenses,transport,-76.95,-82651.39
buyer_1,Luis,,1996-08-10,ES05209515179869230980,TRX_N-01051-96652797,2024-08-04T18:52:31,Bilbao,expenses,cash,-100.0,-82751.39
buyer_1,Luis,,1996-08-10,ES05209515179869230980,TRX_N-01052-47355880,2024-08-05T14:56:45,Bilbao,expenses,gas,-100.2,-82851.59
buyer_1,Luis,,1996-08-10,ES05209515179869230980,TRX_N-01053-25362560,2024-08-05T14:35:54,Bilbao,expenses,internet,-42.0,-82893.59
buyer_1,Luis,,1996-08-10,ES05209515179869230980,TRX_N-01054-31041015,2024-08-06T19:28:31,Bilbao,expenses,food,-113.41,-83007.0
buyer_1,Luis,,1996-08-10,ES05209515179869230980,TRX_N-01055-33603426,2024-08-06T12:17:26,Bilbao,expenses,leisure,-38.21,-83045.21
buyer_1,Luis,,1996-08-10,ES05209515179869230980,TRX_N-01056-71029203,2024-08-07T09:50:33,Sestao,expenses,transport,-74.0,-83119.21
buyer_1,Luis,,1996-08-10,ES05209515179869230980,TRX_N-01057-67913033,2024-08-08T10:03:01,Bilbao,expenses,water,-23.45,-83142.66
buyer_1,Luis,,1996-08-10,ES05209515179869230980,TRX_N-01058-71273688,2024-08-08T19:58:42,Bilbao,expenses,electricity,-68.38,-83211.04
buyer_1,Luis,,1996-08-10,ES05209515179869230980,TRX_N-01059-10355936,2024-08-08T11:19:52,Bilbao,expenses,phone,-33.81,-83244.85
buyer_1,Luis,,1996-08-10,ES05209515179869230980,TRX_N-01060-49656893,2024-08-08T18:08:10,Bilbao,expenses,food,-106.3,-83351.15
buyer_1,Luis,,1996-08-10,ES05209515179869230980,TRX_N-01061-29368906,2024-08-10T12:41:30,Bilbao,expenses,leisure,-72.56,-83423.71
buyer_1,Luis,,1996-08-10,ES05209515179869230980,TRX_N-01062-52212742,2024-08-10T12:34:27,Berango,expenses,cash,-100.0,-83523.71
buyer_1,Luis,,1996-08-10,ES05209515179869230980,TRX_N-01063-08399761,2024-08-12T12:40:54,Bilbao,expenses,cash,-100.0,-83623.71
buyer_1,Luis,,1996-08-10,ES05209515179869230980,TRX_N-01064-34436963,2024-08-15T13:53:41,Bilbao,expenses,food,-75.14,-83698.85
buyer_1,Luis,,1996-08-10,ES05209515179869230980,TRX_N-01065-86409612,2024-08-15T20:03:11,Lasarte-Oria,expenses,cash,-100.0,-83798.85
buyer_1,Luis,,1996-08-10,ES05209515179869230980,TRX_N-01066-45166126,2024-08-17T12:13:00,Bilbao,expenses,food,-117.96,-83916.81
buyer_1,Luis,,1996-08-10,ES05209515179869230980,TRX_N-01067-74629909,2024-08-20T18:48:34,Bilbao,expenses,food,-96.23,-84013.04
buyer_1,Luis,,1996-08-10,ES05209515179869230980,TRX_N-01068-07388094,2024-08-20T08:02:28,Bilbao,expenses,cash,-100.0,-84113.04
buyer_1,Luis,,1996-08-10,ES05209515179869230980,TRX_N-01069-81558209,2024-08-21T14:19:36,Bermeo,expenses,leisure,-53.64,-84166.68
buyer_1,Luis,,1996-08-10,ES05209515179869230980,TRX_N-01070-84643916,2024-08-21T15:58:09,Bilbao,expenses,cash,-100.0,-84266.68
buyer_1,Luis,,1996-08-10,ES05209515179869230980,TRX_N-01071-74560097,2024-08-23T08:26:05,Berango,expenses,food,-84.47,-84351.15
buyer_1,Luis,,1996-08-10,ES05209515179869230980,TRX_N-01072-68078182,2024-08-23T05:03:30,Bilbao,expenses,leisure,-48.52,-84399.67
buyer_1,Luis,,1996-08-10,ES05209515179869230980,TRX_N-01073-39851390,2024-08-23T17:36:06,Bilbao,expenses,cash,-100.0,-84499.67
buyer_1,Luis,,1996-08-10,ES05209515179869230980,TRX_N-01074-01045459,2024-08-26T00:17:59,Sestao,expenses,appliances,-402.78,-84902.45
buyer_1,Luis,,1996-08-10,ES05209515179869230980,TRX_N-01075-30886039,2024-08-27T16:24:28,Bilbao,expenses,transport,-62.51,-84964.96
buyer_1,Luis,,1996-08-10,ES05209515179869230980,TRX_N-01076-65296719,2024-08-28T11:19:49,Bilbao,expenses,leisure,-29.87,-84994.83
buyer_1,Luis,,1996-08-10,ES05209515179869230980,TRX_N-01077-61863626,2024-08-28T20:45:14,Bilbao,expenses,healthcare,-88.14,-85082.97
buyer_1,Luis,,1996-08-10,ES05209515179869230980,TRX_N-01078-03216337,2024-08-28T08:20:15,Andoain,expenses,appliances,-244.39,-85327.36
buyer_1,Luis,,1996-08-10,ES05209515179869230980,TRX_N-01079-35253177,2024-08-30T09:33:39,Bilbao,expenses,healthcare,-169.4,-85496.76
buyer_1,Luis,,1996-08-10,ES05209515179869230980,TRX_N-01080-65554451,2024-08-31T14:05:43,Bilbao,expenses,leisure,-57.05,-85553.81
buyer_1,Luis,,1996-08-10,ES05209515179869230980,TRX_N-01081-13766116,2024-09-01T23:27:16,Bilbao,incomes,salary,1693.78,-83860.03
buyer_1,Luis,,1996-08-10,ES05209515179869230980,TRX_N-01082-24790202,2024-09-01T10:17:25,Bilbao,expenses,cash,-100.0,-83960.03
buyer_1,Luis,,1996-08-10,ES05209515179869230980,TRX_N-01083-32314406,2024-09-02T06:37:11,Barakaldo,expenses,transport,-42.55,-84002.58
buyer_1,Luis,,1996-08-10,ES05209515179869230980,TRX_N-01084-29605958,2024-09-02T10:57:11,Bilbao,expenses,cash,-100.0,-84102.58
buyer_1,Luis,,1996-08-10,ES05209515179869230980,TRX_N-01085-44467576,2024-09-03T15:46:49,Bilbao,expenses,food,-120.29,-84222.87
buyer_1,Luis,,1996-08-10,ES05209515179869230980,TRX_N-01086-13193784,2024-09-04T08:20:34,Bilbao,expenses,rent,-601.82,-84824.69
buyer_1,Luis,,1996-08-10,ES05209515179869230980,TRX_N-01087-58296307,2024-09-04T20:27:34,Bilbao,expenses,leisure,-75.3,-84899.99
buyer_1,Luis,,1996-08-10,ES05209515179869230980,TRX_N-01088-55608882,2024-09-05T16:48:57,Bilbao,expenses,electricity,-78.4,-84978.39
buyer_1,Luis,,1996-08-10,ES05209515179869230980,TRX_N-01089-89715921,2024-09-05T19:43:47,Bilbao,expenses,internet,-42.0,-85020.39
buyer_1,Luis,,1996-08-10,ES05209515179869230980,TRX_N-01090-51649326,2024-09-05T04:59:33,Bilbao,expenses,food,-87.53,-85107.92
buyer_1,Luis,,1996-08-10,ES05209515179869230980,TRX_N-01091-85702135,2024-09-05T13:10:57,Bilbao,expenses,transport,-73.7,-85181.62
buyer_1,Luis,,1996-08-10,ES05209515179869230980,TRX_N-01092-19735277,2024-09-06T13:58:08,Bilbao,expenses,leisure,-27.01,-85208.63
buyer_1,Luis,,1996-08-10,ES05209515179869230980,TRX_N-01093-13789541,2024-09-06T16:05:38,Bilbao,expenses,cash,-100.0,-85308.63
buyer_1,Luis,,1996-08-10,ES05209515179869230980,TRX_N-01094-26039136,2024-09-07T20:19:31,Bilbao,expenses,water,-42.01,-85350.64
buyer_1,Luis,,1996-08-10,ES05209515179869230980,TRX_N-01095-03360461,2024-09-07T19:33:11,Bilbao,expenses,gas,-79.61,-85430.25
buyer_1,Luis,,1996-08-10,ES05209515179869230980,TRX_N-01096-75732034,2024-09-07T08:43:34,Bilbao,expenses,leisure,-37.09,-85467.34
buyer_1,Luis,,1996-08-10,ES05209515179869230980,TRX_N-01097-93010073,2024-09-07T14:10:01,Bilbao,expenses,healthcare,-104.95,-85572.29
buyer_1,Luis,,1996-08-10,ES05209515179869230980,TRX_N-01098-65162597,2024-09-08T13:06:36,Bilbao,expenses,phone,-35.4,-85607.69
buyer_1,Luis,,1996-08-10,ES05209515179869230980,TRX_N-01099-39339860,2024-09-10T09:51:26,Bilbao,expenses,cash,-100.0,-85707.69
buyer_1,Luis,,1996-08-10,ES05209515179869230980,TRX_N-01100-06987063,2024-09-11T13:44:40,Labastida,expenses,transport,-89.69,-85797.38
buyer_1,Luis,,1996-08-10,ES05209515179869230980,TRX_N-01101-10312976,2024-09-11T05:49:24,Bilbao,expenses,healthcare,-84.58,-85881.96
buyer_1,Luis,,1996-08-10,ES05209515179869230980,TRX_N-01102-46352035,2024-09-12T16:29:06,Bilbao,expenses,transport,-81.68,-85963.64
buyer_1,Luis,,1996-08-10,ES05209515179869230980,TRX_N-01103-91689146,2024-09-13T16:09:18,Bilbao,expenses,food,-84.37,-86048.01
buyer_1,Luis,,1996-08-10,ES05209515179869230980,TRX_N-01104-29739674,2024-09-15T10:53:30,Bilbao,expenses,cash,-100.0,-86148.01
buyer_1,Luis,,1996-08-10,ES05209515179869230980,TRX_N-01105-68208314,2024-09-17T12:00:16,Bilbao,expenses,gifts,-495.17,-86643.18
buyer_1,Luis,,1996-08-10,ES05209515179869230980,TRX_N-01106-32330606,2024-09-18T15:13:58,Bilbao,expenses,leisure,-59.94,-86703.12
buyer_1,Luis,,1996-08-10,ES05209515179869230980,TRX_N-01107-99078527,2024-09-18T13:26:05,Bilbao,expenses,clothing,-155.91,-86859.03
buyer_1,Luis,,1996-08-10,ES05209515179869230980,TRX_N-01108-51421138,2024-09-19T23:23:24,Bilbao,expenses,transport,-51.3,-86910.33
buyer_1,Luis,,1996-08-10,ES05209515179869230980,TRX_N-01109-28380907,2024-09-19T16:42:26,Amurrio,expenses,cash,-100.0,-87010.33
buyer_1,Luis,,1996-08-10,ES05209515179869230980,TRX_N-01110-78198239,2024-09-20T18:41:04,Bilbao,expenses,cash,-100.0,-87110.33
buyer_1,Luis,,1996-08-10,ES05209515179869230980,TRX_N-01111-83114671,2024-09-20T13:00:22,Bilbao,expenses,repairs,-173.17,-87283.5
buyer_1,Luis,,1996-08-10,ES05209515179869230980,TRX_N-01112-24233506,2024-09-24T11:18:07,Bilbao,expenses,food,-71.42,-87354.92
buyer_1,Luis,,1996-08-10,ES05209515179869230980,TRX_N-01113-27237508,2024-09-24T14:04:27,Bilbao,expenses,healthcare,-125.16,-87480.08
buyer_1,Luis,,1996-08-10,ES05209515179869230980,TRX_N-01114-45753983,2024-09-25T03:57:59,Pasaia,expenses,repairs,-62.19,-87542.27
buyer_1,Luis,,1996-08-10,ES05209515179869230980,TRX_N-01115-96876651,2024-09-27T08:50:54,Bilbao,expenses,food,-91.57,-87633.84
buyer_1,Luis,,1996-08-10,ES05209515179869230980,TRX_N-01116-16149476,2024-09-28T14:22:36,Bilbao,expenses,cash,-100.0,-87733.84
buyer_1,Luis,,1996-08-10,ES05209515179869230980,TRX_N-01117-99241684,2024-10-01T15:17:28,Bilbao,incomes,salary,1693.78,-86040.06
buyer_1,Luis,,1996-08-10,ES05209515179869230980,TRX_N-01118-44654806,2024-10-02T20:01:14,Elciego,expenses,cash,-100.0,-86140.06
buyer_1,Luis,,1996-08-10,ES05209515179869230980,TRX_N-01119-06443656,2024-10-04T14:11:46,Bilbao,expenses,rent,-601.82,-86741.88
buyer_1,Luis,,1996-08-10,ES05209515179869230980,TRX_N-01120-10929153,2024-10-05T09:40:35,Bilbao,expenses,water,-20.24,-86762.12
buyer_1,Luis,,1996-08-10,ES05209515179869230980,TRX_N-01121-05569979,2024-10-05T15:42:49,Bilbao,expenses,electricity,-67.11,-86829.23
buyer_1,Luis,,1996-08-10,ES05209515179869230980,TRX_N-01122-53928889,2024-10-05T14:10:50,Bilbao,expenses,gas,-102.21,-86931.44
buyer_1,Luis,,1996-08-10,ES05209515179869230980,TRX_N-01123-61959573,2024-10-06T10:26:48,Bilbao,expenses,phone,-37.52,-86968.96
buyer_1,Luis,,1996-08-10,ES05209515179869230980,TRX_N-01124-83589574,2024-10-07T08:13:14,Bilbao,expenses,cash,-100.0,-87068.96
buyer_1,Luis,,1996-08-10,ES05209515179869230980,TRX_N-01125-07163328,2024-10-08T16:24:39,Bilbao,expenses,internet,-42.0,-87110.96
buyer_1,Luis,,1996-08-10,ES05209515179869230980,TRX_N-01126-00138545,2024-10-08T13:06:56,Bilbao,expenses,cash,-100.0,-87210.96
buyer_1,Luis,,1996-08-10,ES05209515179869230980,TRX_N-01127-98734328,2024-10-09T17:38:56,Bilbao,expenses,cash,-100.0,-87310.96
buyer_2,Carmen,,1984-09-05,ES90209507870172975664,TRX_N-00001-47752555,2022-01-01T17:28:24,Zarautz,incomes,salary,1990.44,8327.76
buyer_2,Carmen,,1984-09-05,ES90209507870172975664,TRX_N-00002-84550426,2022-01-02T16:09:05,Zarautz,expenses,gifts,-541.66,7786.1
buyer_2,Carmen,,1984-09-05,ES90209507870172975664,TRX_N-00003-63569291,2022-01-03T16:31:26,Zarautz,expenses,food,-70.99,7715.11
buyer_2,Carmen,,1984-09-05,ES90209507870172975664,TRX_N-00004-15027587,2022-01-03T21:17:26,Zarautz,expenses,leisure,-74.78,7640.33
buyer_2,Carmen,,1984-09-05,ES90209507870172975664,TRX_N-00005-67343758,2022-01-04T23:02:08,Zarautz,expenses,mortgage,-703.19,6937.14
buyer_2,Carmen,,1984-09-05,ES90209507870172975664,TRX_N-00006-97617295,2022-01-04T20:15:24,Zarautz,expenses,transport,-73.34,6863.8
buyer_2,Carmen,,1984-09-05,ES90209507870172975664,TRX_N-00007-10425780,2022-01-05T20:21:53,Zarautz,expenses,internet,-42.0,6821.8
buyer_2,Carmen,,1984-09-05,ES90209507870172975664,TRX_N-00008-35038375,2022-01-06T10:45:22,Zarautz,expenses,gas,-66.57,6755.23
buyer_2,Carmen,,1984-09-05,ES90209507870172975664,TRX_N-00009-96736268,2022-01-06T21:35:17,Zarautz,expenses,leisure,-82.94,6672.29
buyer_2,Carmen,,1984-09-05,ES90209507870172975664,TRX_N-00010-11071519,2022-01-07T13:56:51,Zarautz,expenses,water,-38.16,6634.13
buyer_2,Carmen,,1984-09-05,ES90209507870172975664,TRX_N-00011-03312765,2022-01-07T14:22:12,Zarautz,expenses,food,-123.11,6511.02
buyer_2,Carmen,,1984-09-05,ES90209507870172975664,TRX_N-00012-62475433,2022-01-08T18:37:35,Zarautz,expenses,electricity,-51.27,6459.75
buyer_2,Carmen,,1984-09-05,ES90209507870172975664,TRX_N-00013-16856922,2022-01-08T17:51:44,Zarautz,expenses,phone,-39.17,6420.58
buyer_2,Carmen,,1984-09-05,ES90209507870172975664,TRX_N-00014-87014698,2022-01-08T16:37:36,Zarautz,expenses,children,-147.39,6273.19
buyer_2,Carmen,,1984-09-05,ES90209507870172975664,TRX_N-00015-34398404,2022-01-09T13:45:52,Zarautz,expenses,leisure,-76.77,6196.42
buyer_2,Carmen,,1984-09-05,ES90209507870172975664,TRX_N-00016-01399200,2022-01-09T14:02:07,Zarautz,expenses,clothing,-154.24,6042.18
buyer_2,Carmen,,1984-09-05,ES90209507870172975664,TRX_N-00017-15921821,2022-01-10T16:40:02,Oy√≥n-Oion,expenses,transport,-81.89,5960.29
buyer_2,Carmen,,1984-09-05,ES90209507870172975664,TRX_N-00018-64344743,2022-01-13T10:28:36,Zarautz,expenses,transport,-57.92,5902.37
buyer_2,Carmen,,1984-09-05,ES90209507870172975664,TRX_N-00019-57954485,2022-01-14T23:54:23,Zarautz,expenses,cash,-100.0,5802.37
buyer_2,Carmen,,1984-09-05,ES90209507870172975664,TRX_N-00020-67689284,2022-01-15T19:53:27,Zarautz,expenses,cash,-100.0,5702.37
buyer_2,Carmen,,1984-09-05,ES90209507870172975664,TRX_N-00021-26755064,2022-01-18T01:31:49,Zarautz,expenses,cash,-100.0,5602.37
buyer_2,Carmen,,1984-09-05,ES90209507870172975664,TRX_N-00022-57976582,2022-01-18T15:52:15,Zarautz,expenses,gifts,-296.46,5305.91
buyer_2,Carmen,,1984-09-05,ES90209507870172975664,TRX_N-00023-00349276,2022-01-20T16:02:16,Zarautz,expenses,leisure,-40.81,5265.1
buyer_2,Carmen,,1984-09-05,ES90209507870172975664,TRX_N-00024-84813954,2022-01-21T20:29:58,Zarautz,expenses,cash,-100.0,5165.1
buyer_2,Carmen,,1984-09-05,ES90209507870172975664,TRX_N-00025-96461916,2022-01-24T16:56:07,Zarautz,expenses,transport,-43.23,5121.87
buyer_2,Carmen,,1984-09-05,ES90209507870172975664,TRX_N-00026-07592958,2022-01-26T13:39:23,Zarautz,expenses,cash,-100.0,5021.87
buyer_2,Carmen,,1984-09-05,ES90209507870172975664,TRX_N-00027-30597993,2022-01-28T17:46:50,Sopela,expenses,transport,-76.51,4945.36
buyer_2,Carmen,,1984-09-05,ES90209507870172975664,TRX_N-00028-85656959,2022-01-29T06:46:41,Zarautz,expenses,food,-67.11,4878.25
buyer_2,Carmen,,1984-09-05,ES90209507870172975664,TRX_N-00029-19207357,2022-01-29T10:31:12,Amurrio,expenses,cash,-100.0,4778.25
buyer_2,Carmen,,1984-09-05,ES90209507870172975664,TRX_N-00030-39905724,2022-02-01T10:00:25,Zarautz,incomes,salary,1990.44,6768.69
buyer_2,Carmen,,1984-09-05,ES90209507870172975664,TRX_N-00031-22432797,2022-02-01T23:04:34,Zarautz,expenses,children,-249.0,6519.69
buyer_2,Carmen,,1984-09-05,ES90209507870172975664,TRX_N-00032-13394897,2022-02-02T20:38:20,Sestao,expenses,transport,-52.83,6466.86
buyer_2,Carmen,,1984-09-05,ES90209507870172975664,TRX_N-00033-01039332,2022-02-04T11:02:41,Zarautz,expenses,mortgage,-703.19,5763.67
buyer_2,Carmen,,1984-09-05,ES90209507870172975664,TRX_N-00034-09868503,2022-02-04T17:22:35,Zarautz,expenses,food,-109.61,5654.06
buyer_2,Carmen,,1984-09-05,ES90209507870172975664,TRX_N-00035-81623101,2022-02-04T20:20:55,Zarautz,expenses,children,-142.14,5511.92
buyer_2,Carmen,,1984-09-05,ES90209507870172975664,TRX_N-00036-28480043,2022-02-05T22:07:09,Zarautz,expenses,internet,-42.0,5469.92
buyer_2,Carmen,,1984-09-05,ES90209507870172975664,TRX_N-00037-01186401,2022-02-06T11:03:08,Zarautz,expenses,food,-117.55,5352.37
buyer_2,Carmen,,1984-09-05,ES90209507870172975664,TRX_N-00038-62600126,2022-02-06T18:30:54,Zarautz,expenses,leisure,-36.98,5315.39
buyer_2,Carmen,,1984-09-05,ES90209507870172975664,TRX_N-00039-46835794,2022-02-07T15:18:39,Zarautz,expenses,water,-22.19,5293.2
buyer_2,Carmen,,1984-09-05,ES90209507870172975664,TRX_N-00040-16372853,2022-02-07T19:41:17,Zarautz,expenses,children,-244.97,5048.23
buyer_2,Carmen,,1984-09-05,ES90209507870172975664,TRX_N-00041-21815123,2022-02-08T18:05:40,Zarautz,expenses,electricity,-75.07,4973.16
buyer_2,Carmen,,1984-09-05,ES90209507870172975664,TRX_N-00042-47571927,2022-02-08T01:05:17,Zarautz,expenses,gas,-49.78,4923.38
buyer_2,Carmen,,1984-09-05,ES90209507870172975664,TRX_N-00043-87087332,2022-02-08T09:26:36,Zarautz,expenses,phone,-40.89,4882.49
buyer_2,Carmen,,1984-09-05,ES90209507870172975664,TRX_N-00044-85678692,2022-02-08T09:19:15,Zarautz,expenses,clothing,-158.35,4724.14
buyer_2,Carmen,,1984-09-05,ES90209507870172975664,TRX_N-00045-32765584,2022-02-08T08:50:07,Labastida,expenses,repairs,-276.72,4447.42
buyer_2,Carmen,,1984-09-05,ES90209507870172975664,TRX_N-00046-81490774,2022-02-09T08:25:54,Zarautz,expenses,food,-72.49,4374.93
buyer_2,Carmen,,1984-09-05,ES90209507870172975664,TRX_N-00047-56831158,2022-02-09T09:26:21,Zarautz,expenses,children,-628.45,3746.48
buyer_2,Carmen,,1984-09-05,ES90209507870172975664,TRX_N-00048-06144969,2022-02-12T05:14:44,Zarautz,expenses,leisure,-33.62,3712.86
buyer_2,Carmen,,1984-09-05,ES90209507870172975664,TRX_N-00049-48123467,2022-02-14T18:36:16,Zarautz,expenses,food,-65.37,3647.49
buyer_2,Carmen,,1984-09-05,ES90209507870172975664,TRX_N-00050-63271720,2022-02-15T14:58:33,Labastida,expenses,gifts,-265.55,3381.94
buyer_2,Carmen,,1984-09-05,ES90209507870172975664,TRX_N-00051-59627987,2022-02-16T19:59:54,Zarautz,expenses,gifts,-844.37,2537.57
buyer_2,Carmen,,1984-09-05,ES90209507870172975664,TRX_N-00052-20488912,2022-02-17T08:04:48,Zarautz,expenses,food,-70.17,2467.4
buyer_2,Carmen,,1984-09-05,ES90209507870172975664,TRX_N-00053-55354733,2022-02-17T04:44:21,Zarautz,expenses,transport,-59.06,2408.34
buyer_2,Carmen,,1984-09-05,ES90209507870172975664,TRX_N-00054-47712390,2022-02-17T19:31:00,Zarautz,expenses,leisure,-32.68,2375.66
buyer_2,Carmen,,1984-09-05,ES90209507870172975664,TRX_N-00055-81119884,2022-02-17T15:44:24,Zarautz,expenses,cash,-100.0,2275.66
buyer_2,Carmen,,1984-09-05,ES90209507870172975664,TRX_N-00056-32607590,2022-02-17T18:02:29,Durango,expenses,gifts,-322.83,1952.83
buyer_2,Carmen,,1984-09-05,ES90209507870172975664,TRX_N-00057-01518917,2022-02-18T15:30:37,Zarautz,expenses,leisure,-19.29,1933.54
buyer_2,Carmen,,1984-09-05,ES90209507870172975664,TRX_N-00058-24445604,2022-02-19T16:49:38,Errenteria,expenses,gifts,-118.62,1814.92
buyer_2,Carmen,,1984-09-05,ES90209507870172975664,TRX_N-00059-94126291,2022-02-22T10:24:44,Zarautz,expenses,food,-63.29,1751.63
buyer_2,Carmen,,1984-09-05,ES90209507870172975664,TRX_N-00060-46570629,2022-03-01T08:13:29,Zarautz,incomes,salary,1990.44,3742.07
buyer_2,Carmen,,1984-09-05,ES90209507870172975664,TRX_N-00061-00258093,2022-03-01T16:51:27,Zarautz,expenses,leisure,-26.68,3715.39
buyer_2,Carmen,,1984-09-05,ES90209507870172975664,TRX_N-00062-31547715,2022-03-02T13:29:44,Lasarte-Oria,expenses,transport,-51.17,3664.22
buyer_2,Carmen,,1984-09-05,ES90209507870172975664,TRX_N-00063-95198223,2022-03-02T16:17:43,Zarautz,expenses,leisure,-22.88,3641.34
buyer_2,Carmen,,1984-09-05,ES90209507870172975664,TRX_N-00064-46699232,2022-03-02T13:05:25,Zarautz,expenses,gifts,-814.52,2826.82
buyer_2,Carmen,,1984-09-05,ES90209507870172975664,TRX_N-00065-26294494,2022-03-04T09:20:13,Zarautz,expenses,mortgage,-703.19,2123.63
buyer_2,Carmen,,1984-09-05,ES90209507870172975664,TRX_N-00066-40565349,2022-03-04T16:53:05,Zarautz,expenses,transport,-86.24,2037.39
buyer_2,Carmen,,1984-09-05,ES90209507870172975664,TRX_N-00067-58968277,2022-03-05T16:08:52,Zarautz,expenses,electricity,-39.27,1998.12
buyer_2,Carmen,,1984-09-05,ES90209507870172975664,TRX_N-00068-62508384,2022-03-05T15:26:15,Zarautz,expenses,phone,-31.38,1966.74
buyer_2,Carmen,,1984-09-05,ES90209507870172975664,TRX_N-00069-52751533,2022-03-05T15:45:11,Zarautz,expenses,healthcare,-161.08,1805.66
buyer_2,Carmen,,1984-09-05,ES90209507870172975664,TRX_N-00070-18960518,2022-03-05T17:53:07,Zarautz,expenses,repairs,-158.72,1646.94
buyer_2,Carmen,,1984-09-05,ES90209507870172975664,TRX_N-00071-38726831,2022-03-06T13:35:36,Zarautz,expenses,gas,-108.02,1538.92
buyer_2,Carmen,,1984-09-05,ES90209507870172975664,TRX_N-00072-38465306,2022-03-07T13:36:35,Galdakao,expenses,food,-80.78,1458.14
buyer_2,Carmen,,1984-09-05,ES90209507870172975664,TRX_N-00073-49894940,2022-03-07T13:42:46,Zarautz,expenses,leisure,-33.37,1424.77
buyer_2,Carmen,,1984-09-05,ES90209507870172975664,TRX_N-00074-66474877,2022-03-08T13:53:35,Zarautz,expenses,water,-36.47,1388.3
buyer_2,Carmen,,1984-09-05,ES90209507870172975664,TRX_N-00075-25377908,2022-03-08T22:31:42,Zarautz,expenses,internet,-42.0,1346.3
buyer_2,Carmen,,1984-09-05,ES90209507870172975664,TRX_N-00076-27807892,2022-03-13T16:20:25,Zarautz,expenses,leisure,-22.24,1324.06
buyer_2,Carmen,,1984-09-05,ES90209507870172975664,TRX_N-00077-65336694,2022-03-17T10:01:16,Zarautz,expenses,leisure,-77.57,1246.49
buyer_2,Carmen,,1984-09-05,ES90209507870172975664,TRX_N-00078-28242886,2022-03-17T16:55:48,Zarautz,expenses,clothing,-135.77,1110.72
buyer_2,Carmen,,1984-09-05,ES90209507870172975664,TRX_N-00079-68597021,2022-03-20T16:32:34,Zarautz,expenses,food,-111.02,999.7
buyer_2,Carmen,,1984-09-05,ES90209507870172975664,TRX_N-00080-50926362,2022-03-20T19:02:03,Zarautz,expenses,leisure,-31.9,967.8
buyer_2,Carmen,,1984-09-05,ES90209507870172975664,TRX_N-00081-53392010,2022-03-22T08:34:26,Zarautz,expenses,food,-116.55,851.25
buyer_2,Carmen,,1984-09-05,ES90209507870172975664,TRX_N-00082-47932756,2022-03-22T22:14:30,Zarautz,expenses,gifts,-755.44,95.81
buyer_2,Carmen,,1984-09-05,ES90209507870172975664,TRX_N-00083-51061514,2022-03-23T19:16:41,Zarautz,expenses,appliances,-101.19,-5.38
buyer_2,Carmen,,1984-09-05,ES90209507870172975664,TRX_N-00084-01193780,2022-03-25T15:28:12,Zarautz,expenses,food,-75.59,-80.97
buyer_2,Carmen,,1984-09-05,ES90209507870172975664,TRX_N-00085-87705712,2022-03-25T13:56:02,Zarautz,expenses,repairs,-197.44,-278.41
buyer_2,Carmen,,1984-09-05,ES90209507870172975664,TRX_N-00086-01579439,2022-03-26T14:18:55,Elciego,expenses,cash,-100.0,-378.41
buyer_2,Carmen,,1984-09-05,ES90209507870172975664,TRX_N-00087-60141950,2022-03-28T11:32:22,Zarautz,expenses,leisure,-59.95,-438.36
buyer_2,Carmen,,1984-09-05,ES90209507870172975664,TRX_N-00088-80357221,2022-03-28T13:56:13,Zarautz,expenses,appliances,-172.37,-610.73
buyer_2,Carmen,,1984-09-05,ES90209507870172975664,TRX_N-00089-56396221,2022-03-28T22:08:57,Zarautz,expenses,repairs,-309.68,-920.41
buyer_2,Carmen,,1984-09-05,ES90209507870172975664,TRX_N-00090-15537943,2022-03-29T20:19:46,Zarautz,expenses,children,-193.6,-1114.01
buyer_2,Carmen,,1984-09-05,ES90209507870172975664,TRX_N-00091-16710526,2022-03-31T11:19:11,Zarautz,expenses,gifts,-643.42,-1757.43
buyer_2,Carmen,,1984-09-05,ES90209507870172975664,TRX_N-00092-11025722,2022-04-01T16:03:52,Zarautz,incomes,salary,1990.44,233.01
buyer_2,Carmen,,1984-09-05,ES90209507870172975664,TRX_N-00093-33963414,2022-04-01T16:03:52,Zarautz,incomes,extra_income,364.42,597.43
buyer_2,Carmen,,1984-09-05,ES90209507870172975664,TRX_N-00094-29247419,2022-04-02T19:24:13,Zarautz,expenses,transport,-72.32,525.11
buyer_2,Carmen,,1984-09-05,ES90209507870172975664,TRX_N-00095-26682954,2022-04-02T08:55:17,Mungia,expenses,healthcare,-133.06,392.05
buyer_2,Carmen,,1984-09-05,ES90209507870172975664,TRX_N-00096-15929268,2022-04-02T07:11:39,Zarautz,expenses,cash,-100.0,292.05
buyer_2,Carmen,,1984-09-05,ES90209507870172975664,TRX_N-00097-88789035,2022-04-02T09:09:55,Zarautz,expenses,gifts,-572.45,-280.4
buyer_2,Carmen,,1984-09-05,ES90209507870172975664,TRX_N-00098-28473575,2022-04-03T14:18:06,Labastida,expenses,leisure,-79.56,-359.96
buyer_2,Carmen,,1984-09-05,ES90209507870172975664,TRX_N-00099-84580617,2022-04-04T17:22:42,Zarautz,expenses,mortgage,-703.19,-1063.15
buyer_2,Carmen,,1984-09-05,ES90209507870172975664,TRX_N-00100-45579880,2022-04-05T12:22:42,Zarautz,expenses,water,-41.08,-1104.23
buyer_2,Carmen,,1984-09-05,ES90209507870172975664,TRX_N-00101-80814199,2022-04-05T10:03:53,Zarautz,expenses,internet,-42.0,-1146.23
buyer_2,Carmen,,1984-09-05,ES90209507870172975664,TRX_N-00102-47484574,2022-04-05T11:51:01,Zarautz,expenses,phone,-43.37,-1189.6
buyer_2,Carmen,,1984-09-05,ES90209507870172975664,TRX_N-00103-45439591,2022-04-06T06:44:42,Zarautz,expenses,gas,-37.89,-1227.49
buyer_2,Carmen,,1984-09-05,ES90209507870172975664,TRX_N-00104-25325939,2022-04-06T08:16:30,Zarautz,expenses,leisure,-37.86,-1265.35
buyer_2,Carmen,,1984-09-05,ES90209507870172975664,TRX_N-00105-97566734,2022-04-06T16:59:45,Zarautz,expenses,cash,-100.0,-1365.35
buyer_2,Carmen,,1984-09-05,ES90209507870172975664,TRX_N-00106-47735534,2022-04-07T01:47:25,Zarautz,expenses,electricity,-23.38,-1388.73
buyer_2,Carmen,,1984-09-05,ES90209507870172975664,TRX_N-00107-64404838,2022-04-07T14:54:21,Zarautz,expenses,transport,-57.24,-1445.97
buyer_2,Carmen,,1984-09-05,ES90209507870172975664,TRX_N-00108-52721547,2022-04-08T17:58:39,Zarautz,expenses,cash,-100.0,-1545.97
buyer_2,Carmen,,1984-09-05,ES90209507870172975664,TRX_N-00109-18292633,2022-04-08T02:53:00,Zarautz,expenses,gifts,-202.73,-1748.7
buyer_2,Carmen,,1984-09-05,ES90209507870172975664,TRX_N-00110-94880779,2022-04-09T17:54:26,Zarautz,expenses,leisure,-43.01,-1791.71
buyer_2,Carmen,,1984-09-05,ES90209507870172975664,TRX_N-00111-20372445,2022-04-09T13:31:31,Zarautz,expenses,children,-530.22,-2321.93
buyer_2,Carmen,,1984-09-05,ES90209507870172975664,TRX_N-00112-66827796,2022-04-10T13:25:31,Zarautz,expenses,transport,-55.3,-2377.23
buyer_2,Carmen,,1984-09-05,ES90209507870172975664,TRX_N-00113-43630311,2022-04-10T13:39:14,Zarautz,expenses,leisure,-24.09,-2401.32
buyer_2,Carmen,,1984-09-05,ES90209507870172975664,TRX_N-00114-12841825,2022-04-10T08:30:26,Zarautz,expenses,cash,-100.0,-2501.32
buyer_2,Carmen,,1984-09-05,ES90209507870172975664,TRX_N-00115-45248874,2022-04-12T17:19:02,Zarautz,expenses,cash,-100.0,-2601.32
buyer_2,Carmen,,1984-09-05,ES90209507870172975664,TRX_N-00116-67210792,2022-04-13T13:14:38,Santurtzi,expenses,transport,-50.72,-2652.04
buyer_2,Carmen,,1984-09-05,ES90209507870172975664,TRX_N-00117-37395305,2022-04-13T20:22:28,Zarautz,expenses,children,-693.32,-3345.36
buyer_2,Carmen,,1984-09-05,ES90209507870172975664,TRX_N-00118-21837565,2022-04-14T18:44:28,Oy√≥n-Oion,expenses,food,-73.25,-3418.61
buyer_2,Carmen,,1984-09-05,ES90209507870172975664,TRX_N-00119-20757346,2022-04-15T17:02:29,Zarautz,expenses,gifts,-472.99,-3891.6
buyer_2,Carmen,,1984-09-05,ES90209507870172975664,TRX_N-00120-12303123,2022-04-15T09:29:31,Zarautz,expenses,children,-429.49,-4321.09
buyer_2,Carmen,,1984-09-05,ES90209507870172975664,TRX_N-00121-15059870,2022-04-16T13:53:02,Zarautz,expenses,leisure,-53.87,-4374.96
buyer_2,Carmen,,1984-09-05,ES90209507870172975664,TRX_N-00122-88339299,2022-04-16T20:31:05,Zarautz,expenses,children,-588.12,-4963.08
buyer_2,Carmen,,1984-09-05,ES90209507870172975664,TRX_N-00123-89044598,2022-04-17T16:44:56,Zarautz,expenses,leisure,-74.97,-5038.05
buyer_2,Carmen,,1984-09-05,ES90209507870172975664,TRX_N-00124-41419816,2022-04-18T12:39:22,Zarautz,expenses,food,-121.67,-5159.72
buyer_2,Carmen,,1984-09-05,ES90209507870172975664,TRX_N-00125-53291809,2022-04-18T14:16:12,Zarautz,expenses,transport,-81.53,-5241.25
buyer_2,Carmen,,1984-09-05,ES90209507870172975664,TRX_N-00126-91612559,2022-04-19T10:48:26,Donostia,expenses,food,-116.14,-5357.39
buyer_2,Carmen,,1984-09-05,ES90209507870172975664,TRX_N-00127-01230591,2022-04-19T22:55:22,Errenteria,expenses,clothing,-59.5,-5416.89
buyer_2,Carmen,,1984-09-05,ES90209507870172975664,TRX_N-00128-16987633,2022-04-20T04:53:01,Iru√±a de Oca,expenses,cash,-100.0,-5516.89
buyer_2,Carmen,,1984-09-05,ES90209507870172975664,TRX_N-00129-30914687,2022-04-23T17:25:21,Zarautz,expenses,appliances,-340.63,-5857.52
buyer_2,Carmen,,1984-09-05,ES90209507870172975664,TRX_N-00130-51476007,2022-04-25T14:24:34,Zarautz,expenses,cash,-100.0,-5957.52
buyer_2,Carmen,,1984-09-05,ES90209507870172975664,TRX_N-00131-58136712,2022-04-26T16:22:05,Zarautz,expenses,food,-60.92,-6018.44
buyer_2,Carmen,,1984-09-05,ES90209507870172975664,TRX_N-00132-74871420,2022-04-27T08:38:45,Zarautz,expenses,food,-71.8,-6090.24
buyer_2,Carmen,,1984-09-05,ES90209507870172975664,TRX_N-00133-40315701,2022-04-28T14:06:31,Santurtzi,expenses,leisure,-68.67,-6158.91
buyer_2,Carmen,,1984-09-05,ES90209507870172975664,TRX_N-00134-36839286,2022-05-01T12:07:13,Zarautz,incomes,salary,1990.44,-4168.47
buyer_2,Carmen,,1984-09-05,ES90209507870172975664,TRX_N-00135-26164491,2022-05-01T02:31:16,Leioa,expenses,food,-103.28,-4271.75
buyer_2,Carmen,,1984-09-05,ES90209507870172975664,TRX_N-00136-18881064,2022-05-01T18:25:30,Zarautz,expenses,transport,-64.12,-4335.87
buyer_2,Carmen,,1984-09-05,ES90209507870172975664,TRX_N-00137-08655470,2022-05-02T10:16:47,Zarautz,expenses,repairs,-166.03,-4501.9
buyer_2,Carmen,,1984-09-05,ES90209507870172975664,TRX_N-00138-27067241,2022-05-02T08:57:57,Zarautz,expenses,gifts,-319.71,-4821.61
buyer_2,Carmen,,1984-09-05,ES90209507870172975664,TRX_N-00139-34233179,2022-05-04T10:28:27,Zarautz,expenses,mortgage,-703.19,-5524.8
buyer_2,Carmen,,1984-09-05,ES90209507870172975664,TRX_N-00140-32437214,2022-05-04T05:58:50,Labastida,expenses,gifts,-629.39,-6154.19
buyer_2,Carmen,,1984-09-05,ES90209507870172975664,TRX_N-00141-30510979,2022-05-06T15:16:21,Zarautz,expenses,electricity,-42.99,-6197.18
buyer_2,Carmen,,1984-09-05,ES90209507870172975664,TRX_N-00142-45825771,2022-05-06T01:36:21,Zarautz,expenses,food,-122.73,-6319.91
buyer_2,Carmen,,1984-09-05,ES90209507870172975664,TRX_N-00143-53404682,2022-05-07T17:38:08,Zarautz,expenses,water,-33.04,-6352.95
buyer_2,Carmen,,1984-09-05,ES90209507870172975664,TRX_N-00144-62920482,2022-05-08T14:12:43,Zarautz,expenses,internet,-42.0,-6394.95
buyer_2,Carmen,,1984-09-05,ES90209507870172975664,TRX_N-00145-30637520,2022-05-08T16:32:48,Zarautz,expenses,gas,-101.27,-6496.22
buyer_2,Carmen,,1984-09-05,ES90209507870172975664,TRX_N-00146-66605879,2022-05-08T22:46:04,Zarautz,expenses,phone,-41.74,-6537.96
buyer_2,Carmen,,1984-09-05,ES90209507870172975664,TRX_N-00147-06724809,2022-05-08T19:59:52,Zarautz,expenses,food,-81.93,-6619.89
buyer_2,Carmen,,1984-09-05,ES90209507870172975664,TRX_N-00148-35993591,2022-05-08T10:03:21,Zarautz,expenses,leisure,-44.86,-6664.75
buyer_2,Carmen,,1984-09-05,ES90209507870172975664,TRX_N-00149-92370599,2022-05-11T19:07:20,Zarautz,expenses,transport,-84.83,-6749.58
buyer_2,Carmen,,1984-09-05,ES90209507870172975664,TRX_N-00150-25170878,2022-05-11T15:01:00,Eibar,expenses,cash,-100.0,-6849.58
buyer_2,Carmen,,1984-09-05,ES90209507870172975664,TRX_N-00151-86188327,2022-05-14T15:20:35,Berango,expenses,food,-96.61,-6946.19
buyer_2,Carmen,,1984-09-05,ES90209507870172975664,TRX_N-00152-74172888,2022-05-16T09:02:39,Labastida,expenses,food,-113.43,-7059.62
buyer_2,Carmen,,1984-09-05,ES90209507870172975664,TRX_N-00153-85905927,2022-05-21T23:12:20,Zarautz,expenses,food,-75.03,-7134.65
buyer_2,Carmen,,1984-09-05,ES90209507870172975664,TRX_N-00154-82785047,2022-05-21T02:57:47,Arrasate,expenses,cash,-100.0,-7234.65
buyer_2,Carmen,,1984-09-05,ES90209507870172975664,TRX_N-00155-79498726,2022-05-24T13:34:50,Zarautz,expenses,repairs,-247.27,-7481.92
buyer_2,Carmen,,1984-09-05,ES90209507870172975664,TRX_N-00156-22158882,2022-05-25T18:59:54,Zarautz,expenses,cash,-100.0,-7581.92
buyer_2,Carmen,,1984-09-05,ES90209507870172975664,TRX_N-00157-75596972,2022-05-29T21:47:55,Zarautz,expenses,leisure,-25.69,-7607.61
buyer_2,Carmen,,1984-09-05,ES90209507870172975664,TRX_N-00158-87135528,2022-05-29T14:53:59,Zarautz,expenses,cash,-100.0,-7707.61
buyer_2,Carmen,,1984-09-05,ES90209507870172975664,TRX_N-00159-78049791,2022-05-31T09:59:02,Zarautz,expenses,food,-87.48,-7795.09
buyer_2,Carmen,,1984-09-05,ES90209507870172975664,TRX_N-00160-33930340,2022-06-01T09:42:08,Zarautz,incomes,salary,1990.44,-5804.65
buyer_2,Carmen,,1984-09-05,ES90209507870172975664,TRX_N-00161-78767282,2022-06-01T09:42:08,Zarautz,incomes,salary_bonus,1563.24,-4241.41
buyer_2,Carmen,,1984-09-05,ES90209507870172975664,TRX_N-00162-16518116,2022-06-02T13:07:59,Zarautz,expenses,transport,-78.48,-4319.89
buyer_2,Carmen,,1984-09-05,ES90209507870172975664,TRX_N-00163-27790275,2022-06-03T17:36:41,Portugalete,expenses,food,-111.16,-4431.05
buyer_2,Carmen,,1984-09-05,ES90209507870172975664,TRX_N-00164-80844838,2022-06-04T19:08:19,Zarautz,expenses,mortgage,-703.19,-5134.24
buyer_2,Carmen,,1984-09-05,ES90209507870172975664,TRX_N-00165-74533003,2022-06-04T19:25:24,Portugalete,expenses,food,-87.72,-5221.96
buyer_2,Carmen,,1984-09-05,ES90209507870172975664,TRX_N-00166-15853464,2022-06-05T15:29:09,Zarautz,expenses,gas,-80.47,-5302.43
buyer_2,Carmen,,1984-09-05,ES90209507870172975664,TRX_N-00167-49612772,2022-06-06T11:53:03,Zarautz,expenses,water,-32.83,-5335.26
buyer_2,Carmen,,1984-09-05,ES90209507870172975664,TRX_N-00168-92097989,2022-06-06T13:10:58,Zarautz,expenses,internet,-42.0,-5377.26
buyer_2,Carmen,,1984-09-05,ES90209507870172975664,TRX_N-00169-45421352,2022-06-07T22:55:48,Zarautz,expenses,food,-72.77,-5450.03
buyer_2,Carmen,,1984-09-05,ES90209507870172975664,TRX_N-00170-87515065,2022-06-08T09:46:19,Zarautz,expenses,electricity,-69.9,-5519.93
buyer_2,Carmen,,1984-09-05,ES90209507870172975664,TRX_N-00171-52193419,2022-06-08T15:18:52,Zarautz,expenses,phone,-39.97,-5559.9
buyer_2,Carmen,,1984-09-05,ES90209507870172975664,TRX_N-00172-00502207,2022-06-08T08:18:17,Zarautz,expenses,cash,-100.0,-5659.9
buyer_2,Carmen,,1984-09-05,ES90209507870172975664,TRX_N-00173-68438250,2022-06-10T15:49:28,Zarautz,expenses,leisure,-55.89,-5715.79
buyer_2,Carmen,,1984-09-05,ES90209507870172975664,TRX_N-00174-56519496,2022-06-11T19:33:38,Leioa,expenses,food,-73.92,-5789.71
buyer_2,Carmen,,1984-09-05,ES90209507870172975664,TRX_N-00175-00540754,2022-06-14T23:11:02,Zarautz,expenses,cash,-100.0,-5889.71
buyer_2,Carmen,,1984-09-05,ES90209507870172975664,TRX_N-00176-40879132,2022-06-15T09:51:01,Zarautz,expenses,healthcare,-57.08,-5946.79
buyer_2,Carmen,,1984-09-05,ES90209507870172975664,TRX_N-00177-11111319,2022-06-17T10:11:38,Zarautz,expenses,leisure,-33.49,-5980.28
buyer_2,Carmen,,1984-09-05,ES90209507870172975664,TRX_N-00178-49095891,2022-06-18T20:57:56,Zarautz,expenses,cash,-100.0,-6080.28
buyer_2,Carmen,,1984-09-05,ES90209507870172975664,TRX_N-00179-61690662,2022-06-18T12:50:05,Zarautz,expenses,gifts,-25.37,-6105.65
buyer_2,Carmen,,1984-09-05,ES90209507870172975664,TRX_N-00180-26961147,2022-06-21T12:34:49,Berango,expenses,leisure,-38.02,-6143.67
buyer_2,Carmen,,1984-09-05,ES90209507870172975664,TRX_N-00181-16324351,2022-06-25T23:36:47,Zarautz,expenses,cash,-100.0,-6243.67
buyer_2,Carmen,,1984-09-05,ES90209507870172975664,TRX_N-00182-01777320,2022-06-25T08:13:03,Zarautz,expenses,children,-229.01,-6472.68
buyer_2,Carmen,,1984-09-05,ES90209507870172975664,TRX_N-00183-24276515,2022-06-26T11:49:43,Zarautz,expenses,food,-90.11,-6562.79
buyer_2,Carmen,,1984-09-05,ES90209507870172975664,TRX_N-00184-76633144,2022-06-26T11:12:46,Zarautz,expenses,cash,-100.0,-6662.79
buyer_2,Carmen,,1984-09-05,ES90209507870172975664,TRX_N-00185-10902761,2022-06-27T20:05:15,Iru√±a de Oca,expenses,transport,-58.15,-6720.94
buyer_2,Carmen,,1984-09-05,ES90209507870172975664,TRX_N-00186-53231579,2022-06-27T19:45:18,Zarautz,expenses,children,-665.16,-7386.1
buyer_2,Carmen,,1984-09-05,ES90209507870172975664,TRX_N-00187-53495550,2022-06-28T13:07:02,Zarautz,expenses,repairs,-290.36,-7676.46
buyer_2,Carmen,,1984-09-05,ES90209507870172975664,TRX_N-00188-95507101,2022-06-29T17:49:25,Zarautz,expenses,transport,-52.01,-7728.47
buyer_2,Carmen,,1984-09-05,ES90209507870172975664,TRX_N-00189-64792745,2022-06-29T08:00:01,Salvatierra/Agurain,expenses,cash,-100.0,-7828.47
buyer_2,Carmen,,1984-09-05,ES90209507870172975664,TRX_N-00190-62180347,2022-07-01T13:28:10,Zarautz,incomes,salary,1990.44,-5838.03
buyer_2,Carmen,,1984-09-05,ES90209507870172975664,TRX_N-00191-96641999,2022-07-01T15:53:26,Zarautz,expenses,transport,-61.75,-5899.78
buyer_2,Carmen,,1984-09-05,ES90209507870172975664,TRX_N-00192-34913786,2022-07-01T08:15:44,Zarautz,expenses,repairs,-129.39,-6029.17
buyer_2,Carmen,,1984-09-05,ES90209507870172975664,TRX_N-00193-11336274,2022-07-03T09:29:06,Oy√≥n-Oion,expenses,healthcare,-117.05,-6146.22
buyer_2,Carmen,,1984-09-05,ES90209507870172975664,TRX_N-00194-77550981,2022-07-04T15:25:39,Zarautz,expenses,mortgage,-703.19,-6849.41
buyer_2,Carmen,,1984-09-05,ES90209507870172975664,TRX_N-00195-49722863,2022-07-05T13:08:14,Zarautz,expenses,water,-22.64,-6872.05
buyer_2,Carmen,,1984-09-05,ES90209507870172975664,TRX_N-00196-16046395,2022-07-05T11:51:30,Zarautz,expenses,electricity,-69.39,-6941.44
buyer_2,Carmen,,1984-09-05,ES90209507870172975664,TRX_N-00197-78353942,2022-07-07T14:40:56,Zarautz,expenses,gas,-30.75,-6972.19
buyer_2,Carmen,,1984-09-05,ES90209507870172975664,TRX_N-00198-79527613,2022-07-07T12:24:02,Zarautz,expenses,travel,-1111.0,-8083.19
buyer_2,Carmen,,1984-09-05,ES90209507870172975664,TRX_N-00199-24902657,2022-07-07T13:33:51,Zarautz,expenses,repairs,-198.96,-8282.15
buyer_2,Carmen,,1984-09-05,ES90209507870172975664,TRX_N-00200-69048406,2022-07-08T13:32:52,Zarautz,expenses,internet,-42.0,-8324.15
buyer_2,Carmen,,1984-09-05,ES90209507870172975664,TRX_N-00201-96871406,2022-07-08T16:17:35,Zarautz,expenses,phone,-37.05,-8361.2
buyer_2,Carmen,,1984-09-05,ES90209507870172975664,TRX_N-00202-69575501,2022-07-08T15:06:57,Zarautz,expenses,leisure,-70.5,-8431.7
buyer_2,Carmen,,1984-09-05,ES90209507870172975664,TRX_N-00203-50737684,2022-07-09T13:05:26,Zarautz,expenses,education,-56.22,-8487.92
buyer_2,Carmen,,1984-09-05,ES90209507870172975664,TRX_N-00204-40110628,2022-07-10T13:01:11,Zarautz,expenses,food,-87.21,-8575.13
buyer_2,Carmen,,1984-09-05,ES90209507870172975664,TRX_N-00205-03389422,2022-07-10T19:11:11,Zarautz,expenses,leisure,-44.4,-8619.53
buyer_2,Carmen,,1984-09-05,ES90209507870172975664,TRX_N-00206-03773604,2022-07-13T08:54:31,Zarautz,expenses,children,-234.31,-8853.84
buyer_2,Carmen,,1984-09-05,ES90209507870172975664,TRX_N-00207-32220015,2022-07-14T15:39:32,Zarautz,expenses,leisure,-61.83,-8915.67
buyer_2,Carmen,,1984-09-05,ES90209507870172975664,TRX_N-00208-89514644,2022-07-15T09:25:58,Zarautz,expenses,travel,-1303.81,-10219.48
buyer_2,Carmen,,1984-09-05,ES90209507870172975664,TRX_N-00209-04758569,2022-07-17T18:57:36,Zarautz,expenses,gifts,-848.95,-11068.43
buyer_2,Carmen,,1984-09-05,ES90209507870172975664,TRX_N-00210-19453680,2022-07-19T10:32:50,Zarautz,expenses,food,-100.68,-11169.11
buyer_2,Carmen,,1984-09-05,ES90209507870172975664,TRX_N-00211-84909496,2022-07-19T12:52:12,Zarautz,expenses,children,-169.05,-11338.16
buyer_2,Carmen,,1984-09-05,ES90209507870172975664,TRX_N-00212-12235427,2022-07-21T08:16:39,Zarautz,expenses,repairs,-62.74,-11400.9
buyer_2,Carmen,,1984-09-05,ES90209507870172975664,TRX_N-00213-76526495,2022-07-22T20:25:43,Arrasate,expenses,transport,-87.6,-11488.5
buyer_2,Carmen,,1984-09-05,ES90209507870172975664,TRX_N-00214-41401965,2022-07-22T22:42:08,Labastida,expenses,education,-52.85,-11541.35
buyer_2,Carmen,,1984-09-05,ES90209507870172975664,TRX_N-00215-49473951,2022-07-23T22:39:29,Zarautz,expenses,cash,-100.0,-11641.35
buyer_2,Carmen,,1984-09-05,ES90209507870172975664,TRX_N-00216-51420281,2022-07-25T19:37:18,Zarautz,expenses,healthcare,-58.31,-11699.66
buyer_2,Carmen,,1984-09-05,ES90209507870172975664,TRX_N-00217-92380122,2022-07-27T12:18:22,Zarautz,expenses,transport,-71.29,-11770.95
buyer_2,Carmen,,1984-09-05,ES90209507870172975664,TRX_N-00218-36039677,2022-07-28T11:51:53,Zarautz,expenses,healthcare,-49.29,-11820.24
buyer_2,Carmen,,1984-09-05,ES90209507870172975664,TRX_N-00219-19316826,2022-07-30T19:03:05,Zarautz,expenses,leisure,-42.2,-11862.44
buyer_2,Carmen,,1984-09-05,ES90209507870172975664,TRX_N-00220-72272749,2022-07-30T14:07:14,Zarautz,expenses,cash,-100.0,-11962.44
buyer_2,Carmen,,1984-09-05,ES90209507870172975664,TRX_N-00221-30694375,2022-07-31T17:16:34,Zarautz,expenses,leisure,-64.69,-12027.13
buyer_2,Carmen,,1984-09-05,ES90209507870172975664,TRX_N-00222-42694045,2022-08-01T08:02:01,Zarautz,incomes,salary,1990.44,-10036.69
buyer_2,Carmen,,1984-09-05,ES90209507870172975664,TRX_N-00223-40812681,2022-08-01T08:02:01,Zarautz,incomes,extra_income,364.42,-9672.27
buyer_2,Carmen,,1984-09-05,ES90209507870172975664,TRX_N-00224-04831707,2022-08-01T14:01:48,Zarautz,expenses,food,-84.27,-9756.54
buyer_2,Carmen,,1984-09-05,ES90209507870172975664,TRX_N-00225-28824941,2022-08-01T13:48:31,Zarautz,expenses,transport,-88.75,-9845.29
buyer_2,Carmen,,1984-09-05,ES90209507870172975664,TRX_N-00226-75297453,2022-08-02T13:57:54,Zarautz,expenses,clothing,-55.59,-9900.88
buyer_2,Carmen,,1984-09-05,ES90209507870172975664,TRX_N-00227-00403584,2022-08-03T17:19:22,Iru√±a de Oca,expenses,cash,-100.0,-10000.88
buyer_2,Carmen,,1984-09-05,ES90209507870172975664,TRX_N-00228-71207984,2022-08-04T10:03:47,Zarautz,expenses,mortgage,-703.19,-10704.07
buyer_2,Carmen,,1984-09-05,ES90209507870172975664,TRX_N-00229-59753091,2022-08-04T09:58:37,Zarautz,expenses,cash,-100.0,-10804.07
buyer_2,Carmen,,1984-09-05,ES90209507870172975664,TRX_N-00230-67111433,2022-08-05T10:10:04,Zarautz,expenses,electricity,-25.33,-10829.4
buyer_2,Carmen,,1984-09-05,ES90209507870172975664,TRX_N-00231-30278206,2022-08-05T17:51:35,Zarautz,expenses,phone,-43.75,-10873.15
buyer_2,Carmen,,1984-09-05,ES90209507870172975664,TRX_N-00232-11554504,2022-08-06T08:30:15,Zarautz,expenses,water,-33.99,-10907.14
buyer_2,Carmen,,1984-09-05,ES90209507870172975664,TRX_N-00233-70218615,2022-08-06T18:27:37,Zarautz,expenses,internet,-42.0,-10949.14
buyer_2,Carmen,,1984-09-05,ES90209507870172975664,TRX_N-00234-60178302,2022-08-06T14:57:57,Zarautz,expenses,leisure,-73.77,-11022.91
buyer_2,Carmen,,1984-09-05,ES90209507870172975664,TRX_N-00235-90145598,2022-08-07T18:06:42,Zarautz,expenses,gas,-31.21,-11054.12
buyer_2,Carmen,,1984-09-05,ES90209507870172975664,TRX_N-00236-96250803,2022-08-11T08:35:13,Bermeo,expenses,leisure,-19.44,-11073.56
buyer_2,Carmen,,1984-09-05,ES90209507870172975664,TRX_N-00237-75035377,2022-08-13T17:26:40,Zarautz,expenses,transport,-61.87,-11135.43
buyer_2,Carmen,,1984-09-05,ES90209507870172975664,TRX_N-00238-62423762,2022-08-15T08:30:02,Zarautz,expenses,appliances,-147.86,-11283.29
buyer_2,Carmen,,1984-09-05,ES90209507870172975664,TRX_N-00239-40013470,2022-08-17T12:19:09,Zarautz,expenses,clothing,-139.18,-11422.47
buyer_2,Carmen,,1984-09-05,ES90209507870172975664,TRX_N-00240-64022390,2022-08-18T09:04:55,Zarautz,expenses,cash,-100.0,-11522.47
buyer_2,Carmen,,1984-09-05,ES90209507870172975664,TRX_N-00241-97139741,2022-08-20T10:30:42,Donostia,expenses,education,-59.07,-11581.54
buyer_2,Carmen,,1984-09-05,ES90209507870172975664,TRX_N-00242-79520100,2022-08-21T19:47:59,Zarautz,expenses,cash,-100.0,-11681.54
buyer_2,Carmen,,1984-09-05,ES90209507870172975664,TRX_N-00243-43509225,2022-08-24T12:02:11,Zarautz,expenses,cash,-100.0,-11781.54
buyer_2,Carmen,,1984-09-05,ES90209507870172975664,TRX_N-00244-68569033,2022-08-25T04:37:43,Zarautz,expenses,leisure,-25.83,-11807.37
buyer_2,Carmen,,1984-09-05,ES90209507870172975664,TRX_N-00245-67727779,2022-08-25T17:04:30,Zarautz,expenses,clothing,-142.24,-11949.61
buyer_2,Carmen,,1984-09-05,ES90209507870172975664,TRX_N-00246-47139572,2022-08-25T11:58:54,Zarautz,expenses,cash,-100.0,-12049.61
buyer_2,Carmen,,1984-09-05,ES90209507870172975664,TRX_N-00247-77400871,2022-08-26T17:30:47,Zarautz,expenses,appliances,-236.6,-12286.21
buyer_2,Carmen,,1984-09-05,ES90209507870172975664,TRX_N-00248-97271241,2022-08-26T18:24:20,Zarautz,expenses,repairs,-76.09,-12362.3
buyer_2,Carmen,,1984-09-05,ES90209507870172975664,TRX_N-00249-41766488,2022-08-29T15:45:22,Zarautz,expenses,leisure,-70.1,-12432.4
buyer_2,Carmen,,1984-09-05,ES90209507870172975664,TRX_N-00250-63903831,2022-08-29T13:08:59,Salvatierra/Agurain,expenses,education,-65.7,-12498.1
buyer_2,Carmen,,1984-09-05,ES90209507870172975664,TRX_N-00251-32954698,2022-09-01T02:02:25,Zarautz,incomes,salary,1990.44,-10507.66
buyer_2,Carmen,,1984-09-05,ES90209507870172975664,TRX_N-00252-98504511,2022-09-01T11:15:36,Zarautz,expenses,food,-113.47,-10621.13
buyer_2,Carmen,,1984-09-05,ES90209507870172975664,TRX_N-00253-96346078,2022-09-02T13:42:55,Zarautz,expenses,education,-57.92,-10679.05
buyer_2,Carmen,,1984-09-05,ES90209507870172975664,TRX_N-00254-48866931,2022-09-03T13:52:56,Zarautz,expenses,cash,-100.0,-10779.05
buyer_2,Carmen,,1984-09-05,ES90209507870172975664,TRX_N-00255-57618842,2022-09-04T08:57:21,Zarautz,expenses,mortgage,-703.19,-11482.24
buyer_2,Carmen,,1984-09-05,ES90209507870172975664,TRX_N-00256-84386529,2022-09-04T15:32:41,Zarautz,expenses,transport,-61.05,-11543.29
buyer_2,Carmen,,1984-09-05,ES90209507870172975664,TRX_N-00257-36713334,2022-09-05T13:18:48,Zarautz,expenses,electricity,-51.03,-11594.32
buyer_2,Carmen,,1984-09-05,ES90209507870172975664,TRX_N-00258-42938939,2022-09-05T09:30:53,Zarautz,expenses,internet,-42.0,-11636.32
buyer_2,Carmen,,1984-09-05,ES90209507870172975664,TRX_N-00259-24332378,2022-09-05T14:46:23,Zarautz,expenses,phone,-44.25,-11680.57
buyer_2,Carmen,,1984-09-05,ES90209507870172975664,TRX_N-00260-63292022,2022-09-06T15:48:53,Zarautz,expenses,gifts,-567.24,-12247.81
buyer_2,Carmen,,1984-09-05,ES90209507870172975664,TRX_N-00261-55616779,2022-09-07T11:07:44,Zarautz,expenses,gas,-75.38,-12323.19
buyer_2,Carmen,,1984-09-05,ES90209507870172975664,TRX_N-00262-38546014,2022-09-07T12:04:32,Zarautz,expenses,leisure,-83.26,-12406.45
buyer_2,Carmen,,1984-09-05,ES90209507870172975664,TRX_N-00263-30565173,2022-09-08T15:07:27,Zarautz,expenses,water,-42.93,-12449.38
buyer_2,Carmen,,1984-09-05,ES90209507870172975664,TRX_N-00264-62473381,2022-09-08T21:27:15,Zarautz,expenses,appliances,-233.23,-12682.61
buyer_2,Carmen,,1984-09-05,ES90209507870172975664,TRX_N-00265-27170397,2022-09-09T14:06:58,Zarautz,expenses,leisure,-69.41,-12752.02
buyer_2,Carmen,,1984-09-05,ES90209507870172975664,TRX_N-00266-63732992,2022-09-12T09:08:48,Barakaldo,expenses,cash,-100.0,-12852.02
buyer_2,Carmen,,1984-09-05,ES90209507870172975664,TRX_N-00267-71461221,2022-09-14T09:45:31,Zarautz,expenses,cash,-100.0,-12952.02
buyer_2,Carmen,,1984-09-05,ES90209507870172975664,TRX_N-00268-31818250,2022-09-15T09:22:57,Zarautz,expenses,children,-540.36,-13492.38
buyer_2,Carmen,,1984-09-05,ES90209507870172975664,TRX_N-00269-46094019,2022-09-16T12:48:30,Salvatierra/Agurain,expenses,leisure,-58.5,-13550.88
buyer_2,Carmen,,1984-09-05,ES90209507870172975664,TRX_N-00270-55175581,2022-09-16T17:08:23,Zarautz,expenses,healthcare,-161.63,-13712.51
buyer_2,Carmen,,1984-09-05,ES90209507870172975664,TRX_N-00271-17537254,2022-09-17T22:35:28,Zarautz,expenses,leisure,-24.24,-13736.75
buyer_2,Carmen,,1984-09-05,ES90209507870172975664,TRX_N-00272-99949021,2022-09-18T09:29:27,Zarautz,expenses,cash,-100.0,-13836.75
buyer_2,Carmen,,1984-09-05,ES90209507870172975664,TRX_N-00273-88885851,2022-09-20T14:08:27,Zarautz,expenses,cash,-100.0,-13936.75
buyer_2,Carmen,,1984-09-05,ES90209507870172975664,TRX_N-00274-02714631,2022-09-22T22:50:28,Zarautz,expenses,repairs,-210.36,-14147.11
buyer_2,Carmen,,1984-09-05,ES90209507870172975664,TRX_N-00275-58703410,2022-09-23T08:18:35,Zarautz,expenses,appliances,-226.4,-14373.51
buyer_2,Carmen,,1984-09-05,ES90209507870172975664,TRX_N-00276-42176268,2022-09-24T10:21:10,Zarautz,expenses,clothing,-137.38,-14510.89
buyer_2,Carmen,,1984-09-05,ES90209507870172975664,TRX_N-00277-66194247,2022-09-24T12:51:08,Sestao,expenses,cash,-100.0,-14610.89
buyer_2,Carmen,,1984-09-05,ES90209507870172975664,TRX_N-00278-42555084,2022-09-27T16:22:43,Iru√±a de Oca,expenses,cash,-100.0,-14710.89
buyer_2,Carmen,,1984-09-05,ES90209507870172975664,TRX_N-00279-47682612,2022-09-29T16:03:46,Zarautz,expenses,children,-578.29,-15289.18
buyer_2,Carmen,,1984-09-05,ES90209507870172975664,TRX_N-00280-80336078,2022-09-30T11:57:40,Portugalete,expenses,repairs,-183.27,-15472.45
buyer_2,Carmen,,1984-09-05,ES90209507870172975664,TRX_N-00281-81918246,2022-10-01T12:27:48,Zarautz,incomes,salary,1990.44,-13482.01
buyer_2,Carmen,,1984-09-05,ES90209507870172975664,TRX_N-00282-49817939,2022-10-02T13:54:20,Zarautz,expenses,food,-117.95,-13599.96
buyer_2,Carmen,,1984-09-05,ES90209507870172975664,TRX_N-00283-13856235,2022-10-02T12:32:14,Zarautz,expenses,clothing,-125.95,-13725.91
buyer_2,Carmen,,1984-09-05,ES90209507870172975664,TRX_N-00284-14679754,2022-10-02T17:51:02,Zarautz,expenses,cash,-100.0,-13825.91
buyer_2,Carmen,,1984-09-05,ES90209507870172975664,TRX_N-00285-30036477,2022-10-04T14:52:31,Zarautz,expenses,mortgage,-703.19,-14529.1
buyer_2,Carmen,,1984-09-05,ES90209507870172975664,TRX_N-00286-03416829,2022-10-04T13:50:42,Zarautz,expenses,cash,-100.0,-14629.1
buyer_2,Carmen,,1984-09-05,ES90209507870172975664,TRX_N-00287-77594119,2022-10-05T19:25:05,Zarautz,expenses,electricity,-89.74,-14718.84
buyer_2,Carmen,,1984-09-05,ES90209507870172975664,TRX_N-00288-66652256,2022-10-05T11:21:36,Zarautz,expenses,phone,-37.25,-14756.09
buyer_2,Carmen,,1984-09-05,ES90209507870172975664,TRX_N-00289-21496468,2022-10-05T16:47:23,Zarautz,expenses,clothing,-108.02,-14864.11
buyer_2,Carmen,,1984-09-05,ES90209507870172975664,TRX_N-00290-00473433,2022-10-06T16:57:35,Zarautz,expenses,food,-120.72,-14984.83
buyer_2,Carmen,,1984-09-05,ES90209507870172975664,TRX_N-00291-24703751,2022-10-06T09:09:40,Zarautz,expenses,leisure,-82.79,-15067.62
buyer_2,Carmen,,1984-09-05,ES90209507870172975664,TRX_N-00292-00831428,2022-10-07T16:07:23,Zarautz,expenses,water,-41.43,-15109.05
buyer_2,Carmen,,1984-09-05,ES90209507870172975664,TRX_N-00293-58994232,2022-10-07T09:11:32,Zarautz,expenses,food,-106.91,-15215.96
buyer_2,Carmen,,1984-09-05,ES90209507870172975664,TRX_N-00294-90123397,2022-10-08T02:41:32,Zarautz,expenses,gas,-32.54,-15248.5
buyer_2,Carmen,,1984-09-05,ES90209507870172975664,TRX_N-00295-38444735,2022-10-08T13:24:53,Zarautz,expenses,internet,-42.0,-15290.5
buyer_2,Carmen,,1984-09-05,ES90209507870172975664,TRX_N-00296-16526929,2022-10-08T11:13:02,Hondarribia,expenses,cash,-100.0,-15390.5
buyer_2,Carmen,,1984-09-05,ES90209507870172975664,TRX_N-00297-52503710,2022-10-09T20:18:13,Eibar,expenses,food,-61.28,-15451.78
buyer_2,Carmen,,1984-09-05,ES90209507870172975664,TRX_N-00298-14177195,2022-10-09T08:51:16,Zarautz,expenses,cash,-100.0,-15551.78
buyer_2,Carmen,,1984-09-05,ES90209507870172975664,TRX_N-00299-47003237,2022-10-10T17:37:51,Zarautz,expenses,leisure,-34.99,-15586.77
buyer_2,Carmen,,1984-09-05,ES90209507870172975664,TRX_N-00300-48610258,2022-10-11T16:43:22,Zarautz,expenses,transport,-61.41,-15648.18
buyer_2,Carmen,,1984-09-05,ES90209507870172975664,TRX_N-00301-80381110,2022-10-11T20:41:43,Zarautz,expenses,cash,-100.0,-15748.18
buyer_2,Carmen,,1984-09-05,ES90209507870172975664,TRX_N-00302-72391015,2022-10-12T11:34:25,Barakaldo,expenses,transport,-79.5,-15827.68
buyer_2,Carmen,,1984-09-05,ES90209507870172975664,TRX_N-00303-73921808,2022-10-13T20:52:51,Zarautz,expenses,clothing,-74.21,-15901.89
buyer_2,Carmen,,1984-09-05,ES90209507870172975664,TRX_N-00304-87049492,2022-10-13T09:56:12,Zarautz,expenses,gifts,-137.51,-16039.4
buyer_2,Carmen,,1984-09-05,ES90209507870172975664,TRX_N-00305-70536979,2022-10-15T23:32:42,Zarautz,expenses,leisure,-68.61,-16108.01
buyer_2,Carmen,,1984-09-05,ES90209507870172975664,TRX_N-00306-62720408,2022-10-15T09:15:45,Zarautz,expenses,cash,-100.0,-16208.01
buyer_2,Carmen,,1984-09-05,ES90209507870172975664,TRX_N-00307-23105895,2022-10-15T22:23:50,Zarautz,expenses,repairs,-299.2,-16507.21
buyer_2,Carmen,,1984-09-05,ES90209507870172975664,TRX_N-00308-47272314,2022-10-16T15:13:44,Zarautz,expenses,leisure,-33.44,-16540.65
buyer_2,Carmen,,1984-09-05,ES90209507870172975664,TRX_N-00309-87397118,2022-10-16T14:42:01,Zarautz,expenses,cash,-100.0,-16640.65
buyer_2,Carmen,,1984-09-05,ES90209507870172975664,TRX_N-00310-05884410,2022-10-19T08:04:20,Zarautz,expenses,food,-68.53,-16709.18
buyer_2,Carmen,,1984-09-05,ES90209507870172975664,TRX_N-00311-75971910,2022-10-20T17:02:14,Zarautz,expenses,leisure,-58.39,-16767.57
buyer_2,Carmen,,1984-09-05,ES90209507870172975664,TRX_N-00312-84637773,2022-10-20T08:44:03,Zarautz,expenses,healthcare,-90.02,-16857.59
buyer_2,Carmen,,1984-09-05,ES90209507870172975664,TRX_N-00313-32819286,2022-10-20T15:42:06,Zarautz,expenses,children,-588.72,-17446.31
buyer_2,Carmen,,1984-09-05,ES90209507870172975664,TRX_N-00314-88250931,2022-10-21T08:29:30,Zarautz,expenses,leisure,-44.44,-17490.75
buyer_2,Carmen,,1984-09-05,ES90209507870172975664,TRX_N-00315-33596549,2022-10-22T16:15:41,Zarautz,expenses,leisure,-76.82,-17567.57
buyer_2,Carmen,,1984-09-05,ES90209507870172975664,TRX_N-00316-10037575,2022-10-24T12:18:57,Zarautz,expenses,leisure,-45.09,-17612.66
buyer_2,Carmen,,1984-09-05,ES90209507870172975664,TRX_N-00317-17573425,2022-10-24T22:01:18,Zarautz,expenses,appliances,-114.94,-17727.6
buyer_2,Carmen,,1984-09-05,ES90209507870172975664,TRX_N-00318-70675741,2022-10-25T13:58:08,Zarautz,expenses,cash,-100.0,-17827.6
buyer_2,Carmen,,1984-09-05,ES90209507870172975664,TRX_N-00319-90138456,2022-10-26T15:10:07,Zarautz,expenses,food,-68.43,-17896.03
buyer_2,Carmen,,1984-09-05,ES90209507870172975664,TRX_N-00320-51331012,2022-10-27T18:26:26,Oy√≥n-Oion,expenses,leisure,-69.3,-17965.33
buyer_2,Carmen,,1984-09-05,ES90209507870172975664,TRX_N-00321-43223852,2022-10-30T19:36:21,Mungia,expenses,cash,-100.0,-18065.33
buyer_2,Carmen,,1984-09-05,ES90209507870172975664,TRX_N-00322-46956481,2022-11-01T12:01:16,Zarautz,incomes,salary,1990.44,-16074.89
buyer_2,Carmen,,1984-09-05,ES90209507870172975664,TRX_N-00323-06254250,2022-11-01T16:07:02,Zarautz,expenses,leisure,-51.1,-16125.99
buyer_2,Carmen,,1984-09-05,ES90209507870172975664,TRX_N-00324-91592892,2022-11-01T14:10:43,Zarautz,expenses,gifts,-444.32,-16570.31
buyer_2,Carmen,,1984-09-05,ES90209507870172975664,TRX_N-00325-66434397,2022-11-02T06:24:02,Bermeo,expenses,cash,-100.0,-16670.31
buyer_2,Carmen,,1984-09-05,ES90209507870172975664,TRX_N-00326-15287281,2022-11-04T21:27:08,Zarautz,expenses,mortgage,-703.19,-17373.5
buyer_2,Carmen,,1984-09-05,ES90209507870172975664,TRX_N-00327-22350027,2022-11-05T09:09:12,Zarautz,expenses,food,-75.83,-17449.33
buyer_2,Carmen,,1984-09-05,ES90209507870172975664,TRX_N-00328-07481974,2022-11-05T19:43:02,Zarautz,expenses,healthcare,-60.69,-17510.02
buyer_2,Carmen,,1984-09-05,ES90209507870172975664,TRX_N-00329-90829634,2022-11-06T17:47:21,Zarautz,expenses,phone,-38.62,-17548.64
buyer_2,Carmen,,1984-09-05,ES90209507870172975664,TRX_N-00330-76259289,2022-11-06T15:50:50,Zarautz,expenses,healthcare,-73.4,-17622.04
buyer_2,Carmen,,1984-09-05,ES90209507870172975664,TRX_N-00331-22382086,2022-11-07T14:13:35,Zarautz,expenses,water,-42.65,-17664.69
buyer_2,Carmen,,1984-09-05,ES90209507870172975664,TRX_N-00332-64324662,2022-11-07T17:39:43,Zarautz,expenses,electricity,-54.62,-17719.31
buyer_2,Carmen,,1984-09-05,ES90209507870172975664,TRX_N-00333-05730771,2022-11-07T22:24:33,Zarautz,expenses,cash,-100.0,-17819.31
buyer_2,Carmen,,1984-09-05,ES90209507870172975664,TRX_N-00334-56549476,2022-11-08T18:12:40,Zarautz,expenses,gas,-98.57,-17917.88
buyer_2,Carmen,,1984-09-05,ES90209507870172975664,TRX_N-00335-07533194,2022-11-08T12:21:33,Zarautz,expenses,internet,-42.0,-17959.88
buyer_2,Carmen,,1984-09-05,ES90209507870172975664,TRX_N-00336-39364026,2022-11-09T11:09:11,Zarautz,expenses,leisure,-31.28,-17991.16
buyer_2,Carmen,,1984-09-05,ES90209507870172975664,TRX_N-00337-24378989,2022-11-11T11:18:10,Zarautz,expenses,food,-110.78,-18101.94
buyer_2,Carmen,,1984-09-05,ES90209507870172975664,TRX_N-00338-60053256,2022-11-11T06:07:48,Zarautz,expenses,cash,-100.0,-18201.94
buyer_2,Carmen,,1984-09-05,ES90209507870172975664,TRX_N-00339-05791476,2022-11-11T20:27:59,Zarautz,expenses,gifts,-121.21,-18323.15
buyer_2,Carmen,,1984-09-05,ES90209507870172975664,TRX_N-00340-83117918,2022-11-12T11:40:48,Zarautz,expenses,appliances,-241.71,-18564.86
buyer_2,Carmen,,1984-09-05,ES90209507870172975664,TRX_N-00341-72837358,2022-11-15T20:11:14,Zarautz,expenses,cash,-100.0,-18664.86
buyer_2,Carmen,,1984-09-05,ES90209507870172975664,TRX_N-00342-89881753,2022-11-16T20:47:36,Zarautz,expenses,food,-108.17,-18773.03
buyer_2,Carmen,,1984-09-05,ES90209507870172975664,TRX_N-00343-75220307,2022-11-19T09:53:20,Zarautz,expenses,healthcare,-48.28,-18821.31
buyer_2,Carmen,,1984-09-05,ES90209507870172975664,TRX_N-00344-30001899,2022-11-21T17:26:56,Eibar,expenses,cash,-100.0,-18921.31
buyer_2,Carmen,,1984-09-05,ES90209507870172975664,TRX_N-00345-51422272,2022-11-24T16:37:11,Zarautz,expenses,food,-110.59,-19031.9
buyer_2,Carmen,,1984-09-05,ES90209507870172975664,TRX_N-00346-19207072,2022-11-24T12:46:31,Zarautz,expenses,transport,-62.85,-19094.75
buyer_2,Carmen,,1984-09-05,ES90209507870172975664,TRX_N-00347-52277362,2022-11-24T19:56:54,Zarautz,expenses,leisure,-33.1,-19127.85
buyer_2,Carmen,,1984-09-05,ES90209507870172975664,TRX_N-00348-27634918,2022-11-27T23:03:04,Zarautz,expenses,leisure,-24.5,-19152.35
buyer_2,Carmen,,1984-09-05,ES90209507870172975664,TRX_N-00349-47602620,2022-11-27T10:55:32,Zarautz,expenses,repairs,-321.68,-19474.03
buyer_2,Carmen,,1984-09-05,ES90209507870172975664,TRX_N-00350-26670574,2022-11-28T15:34:59,Zarautz,expenses,transport,-51.7,-19525.73
buyer_2,Carmen,,1984-09-05,ES90209507870172975664,TRX_N-00351-97929584,2022-11-28T20:33:46,Zarautz,expenses,gifts,-216.87,-19742.6
buyer_2,Carmen,,1984-09-05,ES90209507870172975664,TRX_N-00352-87927091,2022-11-29T12:19:42,Zarautz,expenses,cash,-100.0,-19842.6
buyer_2,Carmen,,1984-09-05,ES90209507870172975664,TRX_N-00353-27541572,2022-11-30T13:32:54,Zarautz,expenses,clothing,-118.04,-19960.64
buyer_2,Carmen,,1984-09-05,ES90209507870172975664,TRX_N-00354-46239543,2022-12-01T04:42:40,Zarautz,incomes,salary,1990.44,-17970.2
buyer_2,Carmen,,1984-09-05,ES90209507870172975664,TRX_N-00355-90069124,2022-12-01T04:42:40,Zarautz,incomes,extra_income,364.42,-17605.78
buyer_2,Carmen,,1984-09-05,ES90209507870172975664,TRX_N-00356-10159350,2022-12-01T04:42:40,Zarautz,incomes,salary_bonus,1453.83,-16151.95
buyer_2,Carmen,,1984-09-05,ES90209507870172975664,TRX_N-00357-93009044,2022-12-01T13:48:01,Zarautz,expenses,gifts,-454.73,-16606.68
buyer_2,Carmen,,1984-09-05,ES90209507870172975664,TRX_N-00358-30190406,2022-12-01T11:57:17,Zarautz,expenses,children,-696.23,-17302.91
buyer_2,Carmen,,1984-09-05,ES90209507870172975664,TRX_N-00359-46633610,2022-12-02T02:14:11,Zarautz,expenses,appliances,-99.5,-17402.41
buyer_2,Carmen,,1984-09-05,ES90209507870172975664,TRX_N-00360-14922298,2022-12-03T10:32:42,Portugalete,expenses,food,-99.85,-17502.26
buyer_2,Carmen,,1984-09-05,ES90209507870172975664,TRX_N-00361-48945139,2022-12-04T10:18:14,Zarautz,expenses,mortgage,-703.19,-18205.45
buyer_2,Carmen,,1984-09-05,ES90209507870172975664,TRX_N-00362-73700970,2022-12-04T08:27:20,Zarautz,expenses,food,-94.56,-18300.01
buyer_2,Carmen,,1984-09-05,ES90209507870172975664,TRX_N-00363-29304216,2022-12-05T10:17:48,Zarautz,expenses,water,-23.75,-18323.76
buyer_2,Carmen,,1984-09-05,ES90209507870172975664,TRX_N-00364-13448146,2022-12-05T15:05:35,Zarautz,expenses,internet,-42.0,-18365.76
buyer_2,Carmen,,1984-09-05,ES90209507870172975664,TRX_N-00365-00277158,2022-12-05T03:38:28,Zarautz,expenses,phone,-41.01,-18406.77
buyer_2,Carmen,,1984-09-05,ES90209507870172975664,TRX_N-00366-43219471,2022-12-06T19:34:01,Labastida,expenses,appliances,-242.99,-18649.76
buyer_2,Carmen,,1984-09-05,ES90209507870172975664,TRX_N-00367-94508679,2022-12-07T08:15:03,Oy√≥n-Oion,expenses,transport,-80.35,-18730.11
buyer_2,Carmen,,1984-09-05,ES90209507870172975664,TRX_N-00368-02020748,2022-12-07T09:33:01,Zarautz,expenses,leisure,-26.56,-18756.67
buyer_2,Carmen,,1984-09-05,ES90209507870172975664,TRX_N-00369-72225302,2022-12-07T21:48:19,Zarautz,expenses,cash,-100.0,-18856.67
buyer_2,Carmen,,1984-09-05,ES90209507870172975664,TRX_N-00370-20559431,2022-12-08T04:34:49,Zarautz,expenses,electricity,-43.07,-18899.74
buyer_2,Carmen,,1984-09-05,ES90209507870172975664,TRX_N-00371-85439965,2022-12-08T15:26:40,Zarautz,expenses,gas,-68.18,-18967.92
buyer_2,Carmen,,1984-09-05,ES90209507870172975664,TRX_N-00372-29865573,2022-12-08T21:55:38,Barakaldo,expenses,food,-121.67,-19089.59
buyer_2,Carmen,,1984-09-05,ES90209507870172975664,TRX_N-00373-05755693,2022-12-09T09:27:46,Zarautz,expenses,cash,-100.0,-19189.59
buyer_2,Carmen,,1984-09-05,ES90209507870172975664,TRX_N-00374-06805784,2022-12-10T07:44:25,Zarautz,expenses,food,-69.97,-19259.56
buyer_2,Carmen,,1984-09-05,ES90209507870172975664,TRX_N-00375-18810356,2022-12-11T01:41:25,Zarautz,expenses,gifts,-682.36,-19941.92
buyer_2,Carmen,,1984-09-05,ES90209507870172975664,TRX_N-00376-98018081,2022-12-12T17:47:40,Zarautz,expenses,food,-119.55,-20061.47
buyer_2,Carmen,,1984-09-05,ES90209507870172975664,TRX_N-00377-77411909,2022-12-12T13:53:40,Zarautz,expenses,gifts,-690.67,-20752.14
buyer_2,Carmen,,1984-09-05,ES90209507870172975664,TRX_N-00378-14400132,2022-12-12T19:35:54,Zarautz,expenses,children,-490.75,-21242.89
buyer_2,Carmen,,1984-09-05,ES90209507870172975664,TRX_N-00379-15559351,2022-12-13T08:40:46,Zuia,expenses,cash,-100.0,-21342.89
buyer_2,Carmen,,1984-09-05,ES90209507870172975664,TRX_N-00380-09023829,2022-12-13T12:26:49,Zarautz,expenses,gifts,-504.6,-21847.49
buyer_2,Carmen,,1984-09-05,ES90209507870172975664,TRX_N-00381-83207828,2022-12-14T19:46:41,Zarautz,expenses,transport,-56.43,-21903.92
buyer_2,Carmen,,1984-09-05,ES90209507870172975664,TRX_N-00382-42421467,2022-12-15T09:49:29,Zarautz,expenses,clothing,-114.29,-22018.21
buyer_2,Carmen,,1984-09-05,ES90209507870172975664,TRX_N-00383-13743389,2022-12-15T20:45:54,Hondarribia,expenses,cash,-100.0,-22118.21
buyer_2,Carmen,,1984-09-05,ES90209507870172975664,TRX_N-00384-12979045,2022-12-15T18:20:53,Durango,expenses,repairs,-81.72,-22199.93
buyer_2,Carmen,,1984-09-05,ES90209507870172975664,TRX_N-00385-80168120,2022-12-15T19:54:26,Zarautz,expenses,children,-284.65,-22484.58
buyer_2,Carmen,,1984-09-05,ES90209507870172975664,TRX_N-00386-88808053,2022-12-17T09:11:36,Zarautz,expenses,transport,-79.26,-22563.84
buyer_2,Carmen,,1984-09-05,ES90209507870172975664,TRX_N-00387-68040461,2022-12-17T15:17:08,Zarautz,expenses,cash,-100.0,-22663.84
buyer_2,Carmen,,1984-09-05,ES90209507870172975664,TRX_N-00388-98792061,2022-12-18T14:10:47,Zarautz,expenses,transport,-60.58,-22724.42
buyer_2,Carmen,,1984-09-05,ES90209507870172975664,TRX_N-00389-04956878,2022-12-18T20:29:05,Zarautz,expenses,repairs,-296.22,-23020.64
buyer_2,Carmen,,1984-09-05,ES90209507870172975664,TRX_N-00390-91169181,2022-12-18T12:07:09,Zarautz,expenses,children,-249.26,-23269.9
buyer_2,Carmen,,1984-09-05,ES90209507870172975664,TRX_N-00391-13375956,2022-12-19T05:00:26,Zarautz,expenses,leisure,-65.28,-23335.18
buyer_2,Carmen,,1984-09-05,ES90209507870172975664,TRX_N-00392-12278965,2022-12-21T14:29:58,Zarautz,expenses,leisure,-78.15,-23413.33
buyer_2,Carmen,,1984-09-05,ES90209507870172975664,TRX_N-00393-34606360,2022-12-23T23:00:58,Zarautz,expenses,leisure,-25.83,-23439.16
buyer_2,Carmen,,1984-09-05,ES90209507870172975664,TRX_N-00394-53616378,2022-12-23T20:47:13,Zarautz,expenses,repairs,-295.71,-23734.87
buyer_2,Carmen,,1984-09-05,ES90209507870172975664,TRX_N-00395-77443206,2022-12-26T11:08:59,Zarautz,expenses,food,-84.63,-23819.5
buyer_2,Carmen,,1984-09-05,ES90209507870172975664,TRX_N-00396-99986293,2022-12-27T22:07:26,Zarautz,expenses,transport,-87.34,-23906.84
buyer_2,Carmen,,1984-09-05,ES90209507870172975664,TRX_N-00397-81170812,2022-12-27T11:55:08,Zarautz,expenses,repairs,-51.87,-23958.71
buyer_2,Carmen,,1984-09-05,ES90209507870172975664,TRX_N-00398-70877665,2022-12-29T22:30:03,Zarautz,expenses,food,-94.83,-24053.54
buyer_2,Carmen,,1984-09-05,ES90209507870172975664,TRX_N-00399-61859733,2022-12-29T20:48:28,Zarautz,expenses,healthcare,-77.15,-24130.69
buyer_2,Carmen,,1984-09-05,ES90209507870172975664,TRX_N-00400-99515946,2022-12-29T11:23:17,Zarautz,expenses,gifts,-197.88,-24328.57
buyer_2,Carmen,,1984-09-05,ES90209507870172975664,TRX_N-00401-05710821,2022-12-30T08:07:34,Zarautz,expenses,education,-58.59,-24387.16
buyer_2,Carmen,,1984-09-05,ES90209507870172975664,TRX_N-00402-20584073,2022-12-31T16:45:09,Zarautz,expenses,food,-110.55,-24497.71
buyer_2,Carmen,,1984-09-05,ES90209507870172975664,TRX_N-00403-44017338,2023-01-01T13:45:04,Zarautz,incomes,salary,2035.83,-22461.88
buyer_2,Carmen,,1984-09-05,ES90209507870172975664,TRX_N-00404-46794465,2023-01-01T13:28:26,Irun,expenses,food,-98.64,-22560.52
buyer_2,Carmen,,1984-09-05,ES90209507870172975664,TRX_N-00405-62424945,2023-01-01T17:15:40,Zarautz,expenses,leisure,-44.81,-22605.33
buyer_2,Carmen,,1984-09-05,ES90209507870172975664,TRX_N-00406-11550407,2023-01-02T13:59:50,Zarautz,expenses,food,-119.64,-22724.97
buyer_2,Carmen,,1984-09-05,ES90209507870172975664,TRX_N-00407-34340179,2023-01-02T19:00:58,Zarautz,expenses,leisure,-67.37,-22792.34
buyer_2,Carmen,,1984-09-05,ES90209507870172975664,TRX_N-00408-12563431,2023-01-03T14:15:30,Zarautz,expenses,clothing,-62.78,-22855.12
buyer_2,Carmen,,1984-09-05,ES90209507870172975664,TRX_N-00409-58487300,2023-01-04T14:07:33,Zarautz,expenses,mortgage,-703.19,-23558.31
buyer_2,Carmen,,1984-09-05,ES90209507870172975664,TRX_N-00410-25839172,2023-01-06T11:33:55,Zarautz,expenses,internet,-42.0,-23600.31
buyer_2,Carmen,,1984-09-05,ES90209507870172975664,TRX_N-00411-88039951,2023-01-06T18:07:32,Zarautz,expenses,children,-423.02,-24023.33
buyer_2,Carmen,,1984-09-05,ES90209507870172975664,TRX_N-00412-64644940,2023-01-07T21:09:36,Zarautz,expenses,water,-37.83,-24061.16
buyer_2,Carmen,,1984-09-05,ES90209507870172975664,TRX_N-00413-86805983,2023-01-07T12:23:34,Zarautz,expenses,clothing,-105.93,-24167.09
buyer_2,Carmen,,1984-09-05,ES90209507870172975664,TRX_N-00414-44471920,2023-01-07T15:21:37,Zarautz,expenses,repairs,-229.49,-24396.58
buyer_2,Carmen,,1984-09-05,ES90209507870172975664,TRX_N-00415-90129972,2023-01-08T09:44:08,Zarautz,expenses,electricity,-69.41,-24465.99
buyer_2,Carmen,,1984-09-05,ES90209507870172975664,TRX_N-00416-69538114,2023-01-08T11:24:53,Zarautz,expenses,gas,-36.72,-24502.71
buyer_2,Carmen,,1984-09-05,ES90209507870172975664,TRX_N-00417-63002319,2023-01-08T14:01:27,Zarautz,expenses,phone,-36.29,-24539.0
buyer_2,Carmen,,1984-09-05,ES90209507870172975664,TRX_N-00418-50369705,2023-01-08T18:25:08,Zarautz,expenses,clothing,-155.29,-24694.29
buyer_2,Carmen,,1984-09-05,ES90209507870172975664,TRX_N-00419-43708625,2023-01-08T09:41:37,Zarautz,expenses,children,-350.74,-25045.03
buyer_2,Carmen,,1984-09-05,ES90209507870172975664,TRX_N-00420-89283916,2023-01-09T13:04:10,Zarautz,expenses,leisure,-26.24,-25071.27
buyer_2,Carmen,,1984-09-05,ES90209507870172975664,TRX_N-00421-20074519,2023-01-11T13:25:52,Zarautz,expenses,cash,-100.0,-25171.27
buyer_2,Carmen,,1984-09-05,ES90209507870172975664,TRX_N-00422-94892447,2023-01-12T13:45:51,Zarautz,expenses,transport,-44.35,-25215.62
buyer_2,Carmen,,1984-09-05,ES90209507870172975664,TRX_N-00423-28271007,2023-01-13T15:12:37,Zarautz,expenses,gifts,-209.28,-25424.9
buyer_2,Carmen,,1984-09-05,ES90209507870172975664,TRX_N-00424-21569690,2023-01-15T12:34:55,Zarautz,expenses,transport,-64.85,-25489.75
buyer_2,Carmen,,1984-09-05,ES90209507870172975664,TRX_N-00425-65132897,2023-01-16T05:21:26,Zarautz,expenses,cash,-100.0,-25589.75
buyer_2,Carmen,,1984-09-05,ES90209507870172975664,TRX_N-00426-29874387,2023-01-16T08:58:27,Zarautz,expenses,repairs,-161.87,-25751.62
buyer_2,Carmen,,1984-09-05,ES90209507870172975664,TRX_N-00427-75550060,2023-01-17T14:48:59,Zarautz,expenses,food,-93.45,-25845.07
buyer_2,Carmen,,1984-09-05,ES90209507870172975664,TRX_N-00428-61353653,2023-01-23T03:38:47,Zarautz,expenses,food,-65.82,-25910.89
buyer_2,Carmen,,1984-09-05,ES90209507870172975664,TRX_N-00429-90446054,2023-01-25T17:06:18,Zarautz,expenses,gifts,-622.85,-26533.74
buyer_2,Carmen,,1984-09-05,ES90209507870172975664,TRX_N-00430-68799149,2023-01-26T12:30:00,Zarautz,expenses,repairs,-207.76,-26741.5
buyer_2,Carmen,,1984-09-05,ES90209507870172975664,TRX_N-00431-40921986,2023-01-31T14:13:47,Hernani,expenses,leisure,-56.34,-26797.84
buyer_2,Carmen,,1984-09-05,ES90209507870172975664,TRX_N-00432-61213756,2023-01-31T18:41:04,Zarautz,expenses,gifts,-475.86,-27273.7
buyer_2,Carmen,,1984-09-05,ES90209507870172975664,TRX_N-00433-10537144,2023-02-01T18:06:19,Zarautz,incomes,salary,2035.83,-25237.87
buyer_2,Carmen,,1984-09-05,ES90209507870172975664,TRX_N-00434-10251337,2023-02-01T16:03:40,Donostia,expenses,food,-124.36,-25362.23
buyer_2,Carmen,,1984-09-05,ES90209507870172975664,TRX_N-00435-21664842,2023-02-04T21:21:39,Zarautz,expenses,mortgage,-703.19,-26065.42
buyer_2,Carmen,,1984-09-05,ES90209507870172975664,TRX_N-00436-12868498,2023-02-04T14:15:29,Zarautz,expenses,cash,-100.0,-26165.42
buyer_2,Carmen,,1984-09-05,ES90209507870172975664,TRX_N-00437-31331146,2023-02-05T15:33:05,Zarautz,expenses,water,-40.97,-26206.39
buyer_2,Carmen,,1984-09-05,ES90209507870172975664,TRX_N-00438-45316892,2023-02-05T09:05:39,Zarautz,expenses,phone,-37.56,-26243.95
buyer_2,Carmen,,1984-09-05,ES90209507870172975664,TRX_N-00439-45987738,2023-02-06T10:21:03,Zarautz,expenses,electricity,-31.04,-26274.99
buyer_2,Carmen,,1984-09-05,ES90209507870172975664,TRX_N-00440-54089646,2023-02-07T08:43:27,Zarautz,expenses,gas,-54.67,-26329.66
buyer_2,Carmen,,1984-09-05,ES90209507870172975664,TRX_N-00441-22950705,2023-02-07T14:57:36,Sestao,expenses,food,-115.68,-26445.34
buyer_2,Carmen,,1984-09-05,ES90209507870172975664,TRX_N-00442-52145586,2023-02-08T08:41:35,Zarautz,expenses,internet,-42.0,-26487.34
buyer_2,Carmen,,1984-09-05,ES90209507870172975664,TRX_N-00443-03807843,2023-02-08T16:56:04,Zarautz,expenses,cash,-100.0,-26587.34
buyer_2,Carmen,,1984-09-05,ES90209507870172975664,TRX_N-00444-79275373,2023-02-08T15:46:03,Zarautz,expenses,repairs,-152.88,-26740.22
buyer_2,Carmen,,1984-09-05,ES90209507870172975664,TRX_N-00445-78506341,2023-02-08T15:05:49,Zarautz,expenses,children,-209.59,-26949.81
buyer_2,Carmen,,1984-09-05,ES90209507870172975664,TRX_N-00446-84922408,2023-02-13T11:04:54,Sestao,expenses,clothing,-102.16,-27051.97
buyer_2,Carmen,,1984-09-05,ES90209507870172975664,TRX_N-00447-00767720,2023-02-13T17:54:26,Donostia,expenses,repairs,-253.32,-27305.29
buyer_2,Carmen,,1984-09-05,ES90209507870172975664,TRX_N-00448-64051727,2023-02-15T13:31:18,Zarautz,expenses,transport,-57.63,-27362.92
buyer_2,Carmen,,1984-09-05,ES90209507870172975664,TRX_N-00449-26041518,2023-02-15T12:51:23,Zarautz,expenses,gifts,-231.57,-27594.49
buyer_2,Carmen,,1984-09-05,ES90209507870172975664,TRX_N-00450-48913534,2023-02-18T18:58:40,Zarautz,expenses,leisure,-39.37,-27633.86
buyer_2,Carmen,,1984-09-05,ES90209507870172975664,TRX_N-00451-91964729,2023-02-21T13:16:49,Sestao,expenses,repairs,-37.96,-27671.82
buyer_2,Carmen,,1984-09-05,ES90209507870172975664,TRX_N-00452-75162698,2023-02-22T03:53:16,Getxo,expenses,food,-102.11,-27773.93
buyer_2,Carmen,,1984-09-05,ES90209507870172975664,TRX_N-00453-35145311,2023-02-24T11:56:16,Irun,expenses,appliances,-407.02,-28180.95
buyer_2,Carmen,,1984-09-05,ES90209507870172975664,TRX_N-00454-88146732,2023-02-25T23:24:17,Zarautz,expenses,food,-124.99,-28305.94
buyer_2,Carmen,,1984-09-05,ES90209507870172975664,TRX_N-00455-30652791,2023-02-27T23:44:33,Zarautz,expenses,cash,-100.0,-28405.94
buyer_2,Carmen,,1984-09-05,ES90209507870172975664,TRX_N-00456-67044504,2023-02-28T21:28:47,Zarautz,expenses,food,-96.58,-28502.52
buyer_2,Carmen,,1984-09-05,ES90209507870172975664,TRX_N-00457-83000600,2023-02-28T17:47:34,Zarautz,expenses,cash,-100.0,-28602.52
buyer_2,Carmen,,1984-09-05,ES90209507870172975664,TRX_N-00458-85416081,2023-03-01T17:41:40,Zarautz,incomes,salary,2035.83,-26566.69
buyer_2,Carmen,,1984-09-05,ES90209507870172975664,TRX_N-00459-42658682,2023-03-03T20:25:20,Zarautz,expenses,food,-84.66,-26651.35
buyer_2,Carmen,,1984-09-05,ES90209507870172975664,TRX_N-00460-56163500,2023-03-03T13:58:15,Getxo,expenses,leisure,-64.33,-26715.68
buyer_2,Carmen,,1984-09-05,ES90209507870172975664,TRX_N-00461-36536748,2023-03-03T16:24:05,Zarautz,expenses,children,-473.69,-27189.37
buyer_2,Carmen,,1984-09-05,ES90209507870172975664,TRX_N-00462-88835018,2023-03-04T09:07:56,Zarautz,expenses,mortgage,-703.19,-27892.56
buyer_2,Carmen,,1984-09-05,ES90209507870172975664,TRX_N-00463-64796440,2023-03-04T21:36:19,Mungia,expenses,transport,-75.25,-27967.81
buyer_2,Carmen,,1984-09-05,ES90209507870172975664,TRX_N-00464-48082427,2023-03-05T13:42:25,Zarautz,expenses,water,-39.89,-28007.7
buyer_2,Carmen,,1984-09-05,ES90209507870172975664,TRX_N-00465-91586156,2023-03-05T13:40:08,Zarautz,expenses,internet,-42.0,-28049.7
buyer_2,Carmen,,1984-09-05,ES90209507870172975664,TRX_N-00466-88530826,2023-03-05T10:35:07,Zarautz,expenses,children,-365.56,-28415.26
buyer_2,Carmen,,1984-09-05,ES90209507870172975664,TRX_N-00467-94497351,2023-03-06T17:43:54,Zarautz,expenses,electricity,-34.88,-28450.14
buyer_2,Carmen,,1984-09-05,ES90209507870172975664,TRX_N-00468-68678385,2023-03-06T17:44:33,Zarautz,expenses,gifts,-330.24,-28780.38
buyer_2,Carmen,,1984-09-05,ES90209507870172975664,TRX_N-00469-33925059,2023-03-07T17:26:30,Zarautz,expenses,phone,-38.73,-28819.11
buyer_2,Carmen,,1984-09-05,ES90209507870172975664,TRX_N-00470-38536490,2023-03-07T14:47:16,Zarautz,expenses,food,-104.94,-28924.05
buyer_2,Carmen,,1984-09-05,ES90209507870172975664,TRX_N-00471-12522889,2023-03-07T13:10:47,Zarautz,expenses,leisure,-41.72,-28965.77
buyer_2,Carmen,,1984-09-05,ES90209507870172975664,TRX_N-00472-24351895,2023-03-08T16:47:42,Zarautz,expenses,gas,-40.69,-29006.46
buyer_2,Carmen,,1984-09-05,ES90209507870172975664,TRX_N-00473-50718080,2023-03-09T22:54:55,Zarautz,expenses,clothing,-141.11,-29147.57
buyer_2,Carmen,,1984-09-05,ES90209507870172975664,TRX_N-00474-16244271,2023-03-10T04:36:03,Zarautz,expenses,children,-552.97,-29700.54
buyer_2,Carmen,,1984-09-05,ES90209507870172975664,TRX_N-00475-66327695,2023-03-12T17:32:53,Zarautz,expenses,children,-500.68,-30201.22
buyer_2,Carmen,,1984-09-05,ES90209507870172975664,TRX_N-00476-36675493,2023-03-13T14:57:53,Zarautz,expenses,gifts,-679.76,-30880.98
buyer_2,Carmen,,1984-09-05,ES90209507870172975664,TRX_N-00477-55759629,2023-03-14T18:19:14,Zarautz,expenses,food,-110.89,-30991.87
buyer_2,Carmen,,1984-09-05,ES90209507870172975664,TRX_N-00478-38038809,2023-03-15T10:34:15,Basauri,expenses,repairs,-82.87,-31074.74
buyer_2,Carmen,,1984-09-05,ES90209507870172975664,TRX_N-00479-20518749,2023-03-17T14:03:48,Zarautz,expenses,food,-101.3,-31176.04
buyer_2,Carmen,,1984-09-05,ES90209507870172975664,TRX_N-00480-26593126,2023-03-20T18:05:22,Zarautz,expenses,transport,-43.83,-31219.87
buyer_2,Carmen,,1984-09-05,ES90209507870172975664,TRX_N-00481-76511735,2023-03-26T16:56:18,Zarautz,expenses,transport,-66.13,-31286.0
buyer_2,Carmen,,1984-09-05,ES90209507870172975664,TRX_N-00482-11010473,2023-03-26T19:44:27,Zarautz,expenses,clothing,-87.12,-31373.12
buyer_2,Carmen,,1984-09-05,ES90209507870172975664,TRX_N-00483-20993572,2023-03-27T15:34:29,Zarautz,expenses,food,-102.01,-31475.13
buyer_2,Carmen,,1984-09-05,ES90209507870172975664,TRX_N-00484-31397063,2023-03-31T03:43:39,Zarautz,expenses,food,-88.74,-31563.87
buyer_2,Carmen,,1984-09-05,ES90209507870172975664,TRX_N-00485-30716423,2023-03-31T18:12:50,Zarautz,expenses,transport,-46.36,-31610.23
buyer_2,Carmen,,1984-09-05,ES90209507870172975664,TRX_N-00486-33327768,2023-03-31T09:16:34,Zarautz,expenses,gifts,-619.82,-32230.05
buyer_2,Carmen,,1984-09-05,ES90209507870172975664,TRX_N-00487-36221142,2023-04-01T16:35:46,Zarautz,incomes,salary,2035.83,-30194.22
buyer_2,Carmen,,1984-09-05,ES90209507870172975664,TRX_N-00488-81904990,2023-04-01T16:35:46,Zarautz,incomes,extra_income,364.42,-29829.8
buyer_2,Carmen,,1984-09-05,ES90209507870172975664,TRX_N-00489-03514484,2023-04-01T09:06:27,Zarautz,expenses,transport,-56.72,-29886.52
buyer_2,Carmen,,1984-09-05,ES90209507870172975664,TRX_N-00490-13391945,2023-04-01T20:22:37,Zarautz,expenses,children,-550.5,-30437.02
buyer_2,Carmen,,1984-09-05,ES90209507870172975664,TRX_N-00491-94955928,2023-04-02T10:54:00,Zarautz,expenses,food,-99.67,-30536.69
buyer_2,Carmen,,1984-09-05,ES90209507870172975664,TRX_N-00492-52911376,2023-04-03T20:07:51,Zarautz,expenses,transport,-55.68,-30592.37
buyer_2,Carmen,,1984-09-05,ES90209507870172975664,TRX_N-00493-31591240,2023-04-04T13:31:19,Zarautz,expenses,mortgage,-703.19,-31295.56
buyer_2,Carmen,,1984-09-05,ES90209507870172975664,TRX_N-00494-58170216,2023-04-04T10:52:41,Zarautz,expenses,food,-68.0,-31363.56
buyer_2,Carmen,,1984-09-05,ES90209507870172975664,TRX_N-00495-82655950,2023-04-05T05:51:51,Zarautz,expenses,internet,-42.0,-31405.56
buyer_2,Carmen,,1984-09-05,ES90209507870172975664,TRX_N-00496-44875807,2023-04-05T19:23:59,Zarautz,expenses,phone,-42.41,-31447.97
buyer_2,Carmen,,1984-09-05,ES90209507870172975664,TRX_N-00497-55308825,2023-04-05T18:16:55,Zuia,expenses,education,-49.98,-31497.95
buyer_2,Carmen,,1984-09-05,ES90209507870172975664,TRX_N-00498-65058822,2023-04-06T10:56:38,Zarautz,expenses,water,-30.55,-31528.5
buyer_2,Carmen,,1984-09-05,ES90209507870172975664,TRX_N-00499-82960643,2023-04-07T12:14:53,Zarautz,expenses,electricity,-81.47,-31609.97
buyer_2,Carmen,,1984-09-05,ES90209507870172975664,TRX_N-00500-82830152,2023-04-07T20:33:16,Zarautz,expenses,gas,-31.43,-31641.4
buyer_2,Carmen,,1984-09-05,ES90209507870172975664,TRX_N-00501-98267953,2023-04-07T09:29:16,Zarautz,expenses,cash,-100.0,-31741.4
buyer_2,Carmen,,1984-09-05,ES90209507870172975664,TRX_N-00502-54201550,2023-04-09T13:33:02,Zarautz,expenses,food,-65.73,-31807.13
buyer_2,Carmen,,1984-09-05,ES90209507870172975664,TRX_N-00503-47879824,2023-04-09T13:39:31,Zarautz,expenses,leisure,-68.65,-31875.78
buyer_2,Carmen,,1984-09-05,ES90209507870172975664,TRX_N-00504-84468188,2023-04-10T08:13:24,Zarautz,expenses,food,-93.69,-31969.47
buyer_2,Carmen,,1984-09-05,ES90209507870172975664,TRX_N-00505-59418834,2023-04-10T16:43:59,Zarautz,expenses,transport,-68.73,-32038.2
buyer_2,Carmen,,1984-09-05,ES90209507870172975664,TRX_N-00506-59663272,2023-04-11T13:17:41,Zuia,expenses,leisure,-39.75,-32077.95
buyer_2,Carmen,,1984-09-05,ES90209507870172975664,TRX_N-00507-79709164,2023-04-12T12:49:35,Zarautz,expenses,transport,-71.3,-32149.25
buyer_2,Carmen,,1984-09-05,ES90209507870172975664,TRX_N-00508-27989872,2023-04-12T17:50:52,Zarautz,expenses,cash,-100.0,-32249.25
buyer_2,Carmen,,1984-09-05,ES90209507870172975664,TRX_N-00509-96931281,2023-04-13T20:10:41,Zarautz,expenses,repairs,-292.08,-32541.33
buyer_2,Carmen,,1984-09-05,ES90209507870172975664,TRX_N-00510-17142703,2023-04-15T08:36:36,Zarautz,expenses,repairs,-297.58,-32838.91
buyer_2,Carmen,,1984-09-05,ES90209507870172975664,TRX_N-00511-36406426,2023-04-17T18:52:02,Zarautz,expenses,food,-61.2,-32900.11
buyer_2,Carmen,,1984-09-05,ES90209507870172975664,TRX_N-00512-56990455,2023-04-18T23:38:01,Zarautz,expenses,clothing,-105.19,-33005.3
buyer_2,Carmen,,1984-09-05,ES90209507870172975664,TRX_N-00513-44018489,2023-04-18T14:11:09,Zarautz,expenses,cash,-100.0,-33105.3
buyer_2,Carmen,,1984-09-05,ES90209507870172975664,TRX_N-00514-46853247,2023-04-20T11:31:50,Zarautz,expenses,food,-118.46,-33223.76
buyer_2,Carmen,,1984-09-05,ES90209507870172975664,TRX_N-00515-41461746,2023-04-20T09:19:32,Zarautz,expenses,gifts,-714.92,-33938.68
buyer_2,Carmen,,1984-09-05,ES90209507870172975664,TRX_N-00516-89621460,2023-04-21T15:53:17,Zarautz,expenses,food,-87.05,-34025.73
buyer_2,Carmen,,1984-09-05,ES90209507870172975664,TRX_N-00517-71114362,2023-04-22T00:44:20,Zarautz,expenses,food,-100.73,-34126.46
buyer_2,Carmen,,1984-09-05,ES90209507870172975664,TRX_N-00518-63360962,2023-04-22T11:44:49,Zarautz,expenses,cash,-100.0,-34226.46
buyer_2,Carmen,,1984-09-05,ES90209507870172975664,TRX_N-00519-51829812,2023-04-23T12:46:36,Zarautz,expenses,clothing,-124.87,-34351.33
buyer_2,Carmen,,1984-09-05,ES90209507870172975664,TRX_N-00520-75071175,2023-04-24T20:18:47,Zarautz,expenses,cash,-100.0,-34451.33
buyer_2,Carmen,,1984-09-05,ES90209507870172975664,TRX_N-00521-76922400,2023-04-25T19:20:50,Zarautz,expenses,healthcare,-114.92,-34566.25
buyer_2,Carmen,,1984-09-05,ES90209507870172975664,TRX_N-00522-70573220,2023-04-25T08:24:09,Getxo,expenses,cash,-100.0,-34666.25
buyer_2,Carmen,,1984-09-05,ES90209507870172975664,TRX_N-00523-31137959,2023-04-26T17:58:19,Zarautz,expenses,education,-54.82,-34721.07
buyer_2,Carmen,,1984-09-05,ES90209507870172975664,TRX_N-00524-37189688,2023-04-28T08:30:37,Zarautz,expenses,food,-117.91,-34838.98
buyer_2,Carmen,,1984-09-05,ES90209507870172975664,TRX_N-00525-63627070,2023-04-28T18:18:22,Elciego,expenses,leisure,-61.15,-34900.13
buyer_2,Carmen,,1984-09-05,ES90209507870172975664,TRX_N-00526-14099043,2023-04-28T17:31:45,Errenteria,expenses,repairs,-219.49,-35119.62
buyer_2,Carmen,,1984-09-05,ES90209507870172975664,TRX_N-00527-81054909,2023-05-01T13:26:28,Zarautz,incomes,salary,2035.83,-33083.79
buyer_2,Carmen,,1984-09-05,ES90209507870172975664,TRX_N-00528-85073844,2023-05-02T19:44:33,Zarautz,expenses,leisure,-21.85,-33105.64
buyer_2,Carmen,,1984-09-05,ES90209507870172975664,TRX_N-00529-16811951,2023-05-03T10:29:34,Zarautz,expenses,appliances,-90.1,-33195.74
buyer_2,Carmen,,1984-09-05,ES90209507870172975664,TRX_N-00530-35887306,2023-05-04T16:32:26,Zarautz,expenses,mortgage,-703.19,-33898.93
buyer_2,Carmen,,1984-09-05,ES90209507870172975664,TRX_N-00531-15127638,2023-05-05T15:27:53,Zarautz,expenses,cash,-100.0,-33998.93
buyer_2,Carmen,,1984-09-05,ES90209507870172975664,TRX_N-00532-75069854,2023-05-06T22:13:22,Zarautz,expenses,internet,-42.0,-34040.93
buyer_2,Carmen,,1984-09-05,ES90209507870172975664,TRX_N-00533-34802209,2023-05-07T11:25:24,Zarautz,expenses,phone,-42.57,-34083.5
buyer_2,Carmen,,1984-09-05,ES90209507870172975664,TRX_N-00534-21258498,2023-05-07T03:09:28,Zarautz,expenses,gifts,-406.94,-34490.44
buyer_2,Carmen,,1984-09-05,ES90209507870172975664,TRX_N-00535-24902296,2023-05-08T08:14:04,Zarautz,expenses,water,-32.04,-34522.48
buyer_2,Carmen,,1984-09-05,ES90209507870172975664,TRX_N-00536-65952330,2023-05-08T09:54:50,Zarautz,expenses,electricity,-46.36,-34568.84
buyer_2,Carmen,,1984-09-05,ES90209507870172975664,TRX_N-00537-35259457,2023-05-08T16:39:52,Zarautz,expenses,gas,-93.69,-34662.53
buyer_2,Carmen,,1984-09-05,ES90209507870172975664,TRX_N-00538-81216415,2023-05-08T20:23:37,Zarautz,expenses,food,-88.62,-34751.15
buyer_2,Carmen,,1984-09-05,ES90209507870172975664,TRX_N-00539-42608087,2023-05-09T16:55:55,Zarautz,expenses,cash,-100.0,-34851.15
buyer_2,Carmen,,1984-09-05,ES90209507870172975664,TRX_N-00540-19478619,2023-05-10T16:29:02,Zarautz,expenses,food,-94.42,-34945.57
buyer_2,Carmen,,1984-09-05,ES90209507870172975664,TRX_N-00541-35566880,2023-05-11T08:39:13,Barakaldo,expenses,food,-97.96,-35043.53
buyer_2,Carmen,,1984-09-05,ES90209507870172975664,TRX_N-00542-22885241,2023-05-11T18:03:58,Zarautz,expenses,clothing,-66.59,-35110.12
buyer_2,Carmen,,1984-09-05,ES90209507870172975664,TRX_N-00543-30970769,2023-05-12T11:28:21,Zarautz,expenses,food,-81.06,-35191.18
buyer_2,Carmen,,1984-09-05,ES90209507870172975664,TRX_N-00544-58645435,2023-05-12T12:48:06,Zarautz,expenses,gifts,-181.18,-35372.36
buyer_2,Carmen,,1984-09-05,ES90209507870172975664,TRX_N-00545-51447074,2023-05-14T19:42:58,Zarautz,expenses,food,-68.45,-35440.81
buyer_2,Carmen,,1984-09-05,ES90209507870172975664,TRX_N-00546-33982993,2023-05-15T13:02:12,Leioa,expenses,clothing,-72.47,-35513.28
buyer_2,Carmen,,1984-09-05,ES90209507870172975664,TRX_N-00547-78279575,2023-05-15T13:42:43,Zarautz,expenses,gifts,-723.06,-36236.34
buyer_2,Carmen,,1984-09-05,ES90209507870172975664,TRX_N-00548-98020282,2023-05-16T20:41:54,Zarautz,expenses,transport,-55.7,-36292.04
buyer_2,Carmen,,1984-09-05,ES90209507870172975664,TRX_N-00549-05180500,2023-05-16T14:48:43,Pasaia,expenses,gifts,-101.69,-36393.73
buyer_2,Carmen,,1984-09-05,ES90209507870172975664,TRX_N-00550-71287101,2023-05-19T11:28:51,Vitoria-Gasteiz,expenses,transport,-84.12,-36477.85
buyer_2,Carmen,,1984-09-05,ES90209507870172975664,TRX_N-00551-22677955,2023-05-19T22:40:46,Zarautz,expenses,repairs,-277.86,-36755.71
buyer_2,Carmen,,1984-09-05,ES90209507870172975664,TRX_N-00552-30384014,2023-05-20T19:57:59,Zarautz,expenses,leisure,-44.29,-36800.0
buyer_2,Carmen,,1984-09-05,ES90209507870172975664,TRX_N-00553-36676649,2023-05-21T14:40:39,Zarautz,expenses,repairs,-246.47,-37046.47
buyer_2,Carmen,,1984-09-05,ES90209507870172975664,TRX_N-00554-52220236,2023-05-22T23:26:49,Zarautz,expenses,repairs,-198.46,-37244.93
buyer_2,Carmen,,1984-09-05,ES90209507870172975664,TRX_N-00555-88892008,2023-05-23T08:16:37,Zarautz,expenses,cash,-100.0,-37344.93
buyer_2,Carmen,,1984-09-05,ES90209507870172975664,TRX_N-00556-13547798,2023-05-23T17:13:44,Oy√≥n-Oion,expenses,repairs,-167.72,-37512.65
buyer_2,Carmen,,1984-09-05,ES90209507870172975664,TRX_N-00557-40692738,2023-05-24T17:36:51,Zarautz,expenses,gifts,-125.09,-37637.74
buyer_2,Carmen,,1984-09-05,ES90209507870172975664,TRX_N-00558-79090737,2023-05-27T16:52:34,Zarautz,expenses,leisure,-49.04,-37686.78
buyer_2,Carmen,,1984-09-05,ES90209507870172975664,TRX_N-00559-63947196,2023-05-27T03:18:55,Zarautz,expenses,education,-51.36,-37738.14
buyer_2,Carmen,,1984-09-05,ES90209507870172975664,TRX_N-00560-88411559,2023-05-28T10:58:35,Zarautz,expenses,cash,-100.0,-37838.14
buyer_2,Carmen,,1984-09-05,ES90209507870172975664,TRX_N-00561-18928454,2023-05-28T09:31:14,Zarautz,expenses,repairs,-156.14,-37994.28
buyer_2,Carmen,,1984-09-05,ES90209507870172975664,TRX_N-00562-98347662,2023-05-31T23:49:47,Elciego,expenses,cash,-100.0,-38094.28
buyer_2,Carmen,,1984-09-05,ES90209507870172975664,TRX_N-00563-25048032,2023-06-01T08:46:59,Zarautz,incomes,salary,2035.83,-36058.45
buyer_2,Carmen,,1984-09-05,ES90209507870172975664,TRX_N-00564-95844918,2023-06-01T08:46:59,Zarautz,incomes,salary_bonus,1504.92,-34553.53
buyer_2,Carmen,,1984-09-05,ES90209507870172975664,TRX_N-00565-68572497,2023-06-01T15:04:26,Zarautz,expenses,cash,-100.0,-34653.53
buyer_2,Carmen,,1984-09-05,ES90209507870172975664,TRX_N-00566-89748893,2023-06-02T17:33:49,Zarautz,expenses,cash,-100.0,-34753.53
buyer_2,Carmen,,1984-09-05,ES90209507870172975664,TRX_N-00567-11094284,2023-06-02T11:03:28,Zarautz,expenses,repairs,-144.7,-34898.23
buyer_2,Carmen,,1984-09-05,ES90209507870172975664,TRX_N-00568-78596541,2023-06-03T21:02:44,Zarautz,expenses,transport,-56.88,-34955.11
buyer_2,Carmen,,1984-09-05,ES90209507870172975664,TRX_N-00569-84388412,2023-06-04T14:17:11,Zarautz,expenses,mortgage,-703.19,-35658.3
buyer_2,Carmen,,1984-09-05,ES90209507870172975664,TRX_N-00570-11401943,2023-06-04T23:22:08,Zarautz,expenses,transport,-85.47,-35743.77
buyer_2,Carmen,,1984-09-05,ES90209507870172975664,TRX_N-00571-90101417,2023-06-05T12:32:29,Zarautz,expenses,water,-22.5,-35766.27
buyer_2,Carmen,,1984-09-05,ES90209507870172975664,TRX_N-00572-86732808,2023-06-06T00:16:39,Zarautz,expenses,gas,-43.25,-35809.52
buyer_2,Carmen,,1984-09-05,ES90209507870172975664,TRX_N-00573-71694492,2023-06-06T03:44:40,Zarautz,expenses,internet,-42.0,-35851.52
buyer_2,Carmen,,1984-09-05,ES90209507870172975664,TRX_N-00574-32266286,2023-06-06T20:04:49,Zarautz,expenses,food,-98.0,-35949.52
buyer_2,Carmen,,1984-09-05,ES90209507870172975664,TRX_N-00575-17992289,2023-06-06T20:00:00,Zarautz,expenses,healthcare,-136.93,-36086.45
buyer_2,Carmen,,1984-09-05,ES90209507870172975664,TRX_N-00576-15433874,2023-06-06T17:20:46,Zarautz,expenses,gifts,-655.43,-36741.88
buyer_2,Carmen,,1984-09-05,ES90209507870172975664,TRX_N-00577-12655356,2023-06-07T10:13:10,Zarautz,expenses,electricity,-83.47,-36825.35
buyer_2,Carmen,,1984-09-05,ES90209507870172975664,TRX_N-00578-66704520,2023-06-07T18:50:20,Zarautz,expenses,repairs,-282.91,-37108.26
buyer_2,Carmen,,1984-09-05,ES90209507870172975664,TRX_N-00579-06571548,2023-06-08T13:49:06,Zarautz,expenses,phone,-38.26,-37146.52
buyer_2,Carmen,,1984-09-05,ES90209507870172975664,TRX_N-00580-82251356,2023-06-08T19:14:04,Durango,expenses,transport,-62.36,-37208.88
buyer_2,Carmen,,1984-09-05,ES90209507870172975664,TRX_N-00581-06400120,2023-06-08T13:31:28,Zarautz,expenses,gifts,-44.22,-37253.1
buyer_2,Carmen,,1984-09-05,ES90209507870172975664,TRX_N-00582-14441755,2023-06-09T10:03:56,Zarautz,expenses,gifts,-750.28,-38003.38
buyer_2,Carmen,,1984-09-05,ES90209507870172975664,TRX_N-00583-82149425,2023-06-11T15:24:51,Zarautz,expenses,transport,-42.63,-38046.01
buyer_2,Carmen,,1984-09-05,ES90209507870172975664,TRX_N-00584-90987269,2023-06-11T18:04:23,Zarautz,expenses,leisure,-47.76,-38093.77
buyer_2,Carmen,,1984-09-05,ES90209507870172975664,TRX_N-00585-76775309,2023-06-13T00:56:17,Zarautz,expenses,children,-558.77,-38652.54
buyer_2,Carmen,,1984-09-05,ES90209507870172975664,TRX_N-00586-85706611,2023-06-14T20:37:02,Zarautz,expenses,food,-109.5,-38762.04
buyer_2,Carmen,,1984-09-05,ES90209507870172975664,TRX_N-00587-94923708,2023-06-14T08:07:23,Oy√≥n-Oion,expenses,cash,-100.0,-38862.04
buyer_2,Carmen,,1984-09-05,ES90209507870172975664,TRX_N-00588-25388063,2023-06-15T09:13:20,Zarautz,expenses,leisure,-38.99,-38901.03
buyer_2,Carmen,,1984-09-05,ES90209507870172975664,TRX_N-00589-33766326,2023-06-16T10:24:18,Zarautz,expenses,food,-101.58,-39002.61
buyer_2,Carmen,,1984-09-05,ES90209507870172975664,TRX_N-00590-56562172,2023-06-16T17:15:42,Zarautz,expenses,leisure,-54.87,-39057.48
buyer_2,Carmen,,1984-09-05,ES90209507870172975664,TRX_N-00591-93443336,2023-06-16T09:21:36,Zarautz,expenses,clothing,-126.88,-39184.36
buyer_2,Carmen,,1984-09-05,ES90209507870172975664,TRX_N-00592-44084583,2023-06-16T08:27:30,Zarautz,expenses,cash,-100.0,-39284.36
buyer_2,Carmen,,1984-09-05,ES90209507870172975664,TRX_N-00593-89669688,2023-06-16T17:53:46,Zarautz,expenses,gifts,-823.26,-40107.62
buyer_2,Carmen,,1984-09-05,ES90209507870172975664,TRX_N-00594-12642863,2023-06-18T18:05:18,Zarautz,expenses,food,-96.07,-40203.69
buyer_2,Carmen,,1984-09-05,ES90209507870172975664,TRX_N-00595-74284807,2023-06-19T15:42:55,Zarautz,expenses,leisure,-36.16,-40239.85
buyer_2,Carmen,,1984-09-05,ES90209507870172975664,TRX_N-00596-04042324,2023-06-19T10:00:58,Zarautz,expenses,clothing,-84.84,-40324.69
buyer_2,Carmen,,1984-09-05,ES90209507870172975664,TRX_N-00597-59136160,2023-06-21T14:01:00,Zarautz,expenses,transport,-42.94,-40367.63
buyer_2,Carmen,,1984-09-05,ES90209507870172975664,TRX_N-00598-40802937,2023-06-23T17:27:42,Zarautz,expenses,children,-705.98,-41073.61
buyer_2,Carmen,,1984-09-05,ES90209507870172975664,TRX_N-00599-60902939,2023-06-27T08:00:44,Zarautz,expenses,children,-163.18,-41236.79
buyer_2,Carmen,,1984-09-05,ES90209507870172975664,TRX_N-00600-23119002,2023-06-28T11:16:38,Zarautz,expenses,food,-115.92,-41352.71
buyer_2,Carmen,,1984-09-05,ES90209507870172975664,TRX_N-00601-27322094,2023-06-29T12:50:57,Zarautz,expenses,food,-61.65,-41414.36
buyer_2,Carmen,,1984-09-05,ES90209507870172975664,TRX_N-00602-57092423,2023-06-29T09:39:10,Zarautz,expenses,education,-71.53,-41485.89
buyer_2,Carmen,,1984-09-05,ES90209507870172975664,TRX_N-00603-71100640,2023-06-30T15:35:15,Elciego,expenses,food,-109.55,-41595.44
buyer_2,Carmen,,1984-09-05,ES90209507870172975664,TRX_N-00604-50345077,2023-07-01T22:14:26,Zarautz,incomes,salary,2035.83,-39559.61
buyer_2,Carmen,,1984-09-05,ES90209507870172975664,TRX_N-00605-20759885,2023-07-01T22:14:26,Zarautz,incomes,extra_income,364.42,-39195.19
buyer_2,Carmen,,1984-09-05,ES90209507870172975664,TRX_N-00606-88759722,2023-07-01T11:41:06,Zarautz,expenses,leisure,-46.93,-39242.12
buyer_2,Carmen,,1984-09-05,ES90209507870172975664,TRX_N-00607-52497305,2023-07-02T02:27:34,Zarautz,expenses,cash,-100.0,-39342.12
buyer_2,Carmen,,1984-09-05,ES90209507870172975664,TRX_N-00608-45005038,2023-07-03T15:28:47,Zarautz,expenses,cash,-100.0,-39442.12
buyer_2,Carmen,,1984-09-05,ES90209507870172975664,TRX_N-00609-65337270,2023-07-04T13:16:35,Zarautz,expenses,mortgage,-703.19,-40145.31
buyer_2,Carmen,,1984-09-05,ES90209507870172975664,TRX_N-00610-53685518,2023-07-05T17:30:59,Zarautz,expenses,phone,-43.4,-40188.71
buyer_2,Carmen,,1984-09-05,ES90209507870172975664,TRX_N-00611-69106573,2023-07-05T22:35:03,Barakaldo,expenses,cash,-100.0,-40288.71
buyer_2,Carmen,,1984-09-05,ES90209507870172975664,TRX_N-00612-34773799,2023-07-05T12:36:09,Vitoria-Gasteiz,expenses,gifts,-733.19,-41021.9
buyer_2,Carmen,,1984-09-05,ES90209507870172975664,TRX_N-00613-74917713,2023-07-07T23:51:59,Zarautz,expenses,gas,-64.56,-41086.46
buyer_2,Carmen,,1984-09-05,ES90209507870172975664,TRX_N-00614-09741700,2023-07-07T14:46:45,Zarautz,expenses,internet,-42.0,-41128.46
buyer_2,Carmen,,1984-09-05,ES90209507870172975664,TRX_N-00615-76851680,2023-07-07T02:25:07,Zarautz,expenses,transport,-89.07,-41217.53
buyer_2,Carmen,,1984-09-05,ES90209507870172975664,TRX_N-00616-67900205,2023-07-08T14:48:39,Zarautz,expenses,water,-21.11,-41238.64
buyer_2,Carmen,,1984-09-05,ES90209507870172975664,TRX_N-00617-79047561,2023-07-08T09:00:53,Zarautz,expenses,electricity,-23.26,-41261.9
buyer_2,Carmen,,1984-09-05,ES90209507870172975664,TRX_N-00618-22704163,2023-07-08T08:39:18,Zarautz,expenses,food,-94.17,-41356.07
buyer_2,Carmen,,1984-09-05,ES90209507870172975664,TRX_N-00619-99140110,2023-07-08T18:32:17,Zarautz,expenses,cash,-100.0,-41456.07
buyer_2,Carmen,,1984-09-05,ES90209507870172975664,TRX_N-00620-65510280,2023-07-09T11:24:26,Zarautz,expenses,gifts,-264.8,-41720.87
buyer_2,Carmen,,1984-09-05,ES90209507870172975664,TRX_N-00621-55009156,2023-07-12T20:58:36,Zarautz,expenses,food,-123.7,-41844.57
buyer_2,Carmen,,1984-09-05,ES90209507870172975664,TRX_N-00622-04640168,2023-07-13T01:11:16,Zarautz,expenses,cash,-100.0,-41944.57
buyer_2,Carmen,,1984-09-05,ES90209507870172975664,TRX_N-00623-04734557,2023-07-18T18:22:06,Mungia,expenses,leisure,-44.22,-41988.79
buyer_2,Carmen,,1984-09-05,ES90209507870172975664,TRX_N-00624-23561676,2023-07-20T17:26:58,Zarautz,expenses,education,-77.53,-42066.32
buyer_2,Carmen,,1984-09-05,ES90209507870172975664,TRX_N-00625-04032267,2023-07-22T13:04:10,Zarautz,expenses,cash,-100.0,-42166.32
buyer_2,Carmen,,1984-09-05,ES90209507870172975664,TRX_N-00626-81388257,2023-07-22T19:26:10,Bermeo,expenses,repairs,-235.05,-42401.37
buyer_2,Carmen,,1984-09-05,ES90209507870172975664,TRX_N-00627-70870380,2023-07-24T17:09:34,Zarautz,expenses,leisure,-64.39,-42465.76
buyer_2,Carmen,,1984-09-05,ES90209507870172975664,TRX_N-00628-78488402,2023-07-26T08:39:53,Zarautz,expenses,food,-76.17,-42541.93
buyer_2,Carmen,,1984-09-05,ES90209507870172975664,TRX_N-00629-32313382,2023-07-26T18:24:27,Zarautz,expenses,travel,-1140.78,-43682.71
buyer_2,Carmen,,1984-09-05,ES90209507870172975664,TRX_N-00630-91416282,2023-07-27T19:22:28,Iru√±a de Oca,expenses,food,-102.73,-43785.44
buyer_2,Carmen,,1984-09-05,ES90209507870172975664,TRX_N-00631-70811300,2023-08-01T11:10:34,Zarautz,incomes,salary,2035.83,-41749.61
buyer_2,Carmen,,1984-09-05,ES90209507870172975664,TRX_N-00632-37108463,2023-08-01T11:26:59,Zuia,expenses,cash,-100.0,-41849.61
buyer_2,Carmen,,1984-09-05,ES90209507870172975664,TRX_N-00633-73173519,2023-08-02T14:53:33,Zarautz,expenses,leisure,-50.38,-41899.99
buyer_2,Carmen,,1984-09-05,ES90209507870172975664,TRX_N-00634-74695604,2023-08-04T04:48:40,Zarautz,expenses,mortgage,-703.19,-42603.18
buyer_2,Carmen,,1984-09-05,ES90209507870172975664,TRX_N-00635-34294356,2023-08-04T18:41:52,Zarautz,expenses,food,-123.97,-42727.15
buyer_2,Carmen,,1984-09-05,ES90209507870172975664,TRX_N-00636-43955142,2023-08-04T17:55:35,Sopela,expenses,cash,-100.0,-42827.15
buyer_2,Carmen,,1984-09-05,ES90209507870172975664,TRX_N-00637-65690863,2023-08-05T21:15:08,Zarautz,expenses,electricity,-50.05,-42877.2
buyer_2,Carmen,,1984-09-05,ES90209507870172975664,TRX_N-00638-79348873,2023-08-05T18:32:08,Zarautz,expenses,gas,-41.83,-42919.03
buyer_2,Carmen,,1984-09-05,ES90209507870172975664,TRX_N-00639-30585080,2023-08-06T18:06:54,Zarautz,expenses,gifts,-249.41,-43168.44
buyer_2,Carmen,,1984-09-05,ES90209507870172975664,TRX_N-00640-88053386,2023-08-07T19:49:19,Zarautz,expenses,phone,-44.1,-43212.54
buyer_2,Carmen,,1984-09-05,ES90209507870172975664,TRX_N-00641-80694194,2023-08-07T16:06:45,Zarautz,expenses,transport,-55.23,-43267.77
buyer_2,Carmen,,1984-09-05,ES90209507870172975664,TRX_N-00642-18345521,2023-08-07T15:11:17,Zarautz,expenses,cash,-100.0,-43367.77
buyer_2,Carmen,,1984-09-05,ES90209507870172975664,TRX_N-00643-55509077,2023-08-08T18:26:09,Zarautz,expenses,water,-29.33,-43397.1
buyer_2,Carmen,,1984-09-05,ES90209507870172975664,TRX_N-00644-54364346,2023-08-08T17:14:41,Zarautz,expenses,internet,-42.0,-43439.1
buyer_2,Carmen,,1984-09-05,ES90209507870172975664,TRX_N-00645-33358112,2023-08-09T16:58:55,Zarautz,expenses,leisure,-73.86,-43512.96
buyer_2,Carmen,,1984-09-05,ES90209507870172975664,TRX_N-00646-64792491,2023-08-13T10:47:16,Bilbao,expenses,food,-124.36,-43637.32
buyer_2,Carmen,,1984-09-05,ES90209507870172975664,TRX_N-00647-29483626,2023-08-13T20:11:24,Zarautz,expenses,leisure,-30.77,-43668.09
buyer_2,Carmen,,1984-09-05,ES90209507870172975664,TRX_N-00648-08565090,2023-08-14T09:10:38,Zarautz,expenses,food,-108.71,-43776.8
buyer_2,Carmen,,1984-09-05,ES90209507870172975664,TRX_N-00649-24871638,2023-08-14T15:12:33,Zarautz,expenses,leisure,-20.35,-43797.15
buyer_2,Carmen,,1984-09-05,ES90209507870172975664,TRX_N-00650-55997323,2023-08-14T09:11:17,Sopela,expenses,healthcare,-63.92,-43861.07
buyer_2,Carmen,,1984-09-05,ES90209507870172975664,TRX_N-00651-51562288,2023-08-16T10:34:14,Zarautz,expenses,cash,-100.0,-43961.07
buyer_2,Carmen,,1984-09-05,ES90209507870172975664,TRX_N-00652-75885231,2023-08-16T06:49:05,Zarautz,expenses,repairs,-202.46,-44163.53
buyer_2,Carmen,,1984-09-05,ES90209507870172975664,TRX_N-00653-46389339,2023-08-17T10:47:59,Zarautz,expenses,cash,-100.0,-44263.53
buyer_2,Carmen,,1984-09-05,ES90209507870172975664,TRX_N-00654-61723342,2023-08-18T19:25:08,Zarautz,expenses,leisure,-66.36,-44329.89
buyer_2,Carmen,,1984-09-05,ES90209507870172975664,TRX_N-00655-14509006,2023-08-22T15:14:40,Labastida,expenses,food,-75.27,-44405.16
buyer_2,Carmen,,1984-09-05,ES90209507870172975664,TRX_N-00656-58196002,2023-08-22T23:11:49,Zarautz,expenses,travel,-1822.13,-46227.29
buyer_2,Carmen,,1984-09-05,ES90209507870172975664,TRX_N-00657-27367951,2023-08-23T13:48:25,Zarautz,expenses,cash,-100.0,-46327.29
buyer_2,Carmen,,1984-09-05,ES90209507870172975664,TRX_N-00658-22615876,2023-08-25T17:55:15,Zarautz,expenses,appliances,-216.51,-46543.8
buyer_2,Carmen,,1984-09-05,ES90209507870172975664,TRX_N-00659-95104269,2023-08-27T23:58:29,Zarautz,expenses,food,-80.0,-46623.8
buyer_2,Carmen,,1984-09-05,ES90209507870172975664,TRX_N-00660-63285192,2023-08-27T18:55:56,Irun,expenses,transport,-65.1,-46688.9
buyer_2,Carmen,,1984-09-05,ES90209507870172975664,TRX_N-00661-66886488,2023-08-28T23:16:18,Sopela,expenses,food,-84.29,-46773.19
buyer_2,Carmen,,1984-09-05,ES90209507870172975664,TRX_N-00662-82015105,2023-08-28T11:43:30,Santurtzi,expenses,gifts,-90.54,-46863.73
buyer_2,Carmen,,1984-09-05,ES90209507870172975664,TRX_N-00663-98412687,2023-08-29T17:18:28,Zarautz,expenses,transport,-88.33,-46952.06
buyer_2,Carmen,,1984-09-05,ES90209507870172975664,TRX_N-00664-65190809,2023-08-30T19:39:11,Labastida,expenses,cash,-100.0,-47052.06
buyer_2,Carmen,,1984-09-05,ES90209507870172975664,TRX_N-00665-07364837,2023-08-31T09:58:05,Hondarribia,expenses,cash,-100.0,-47152.06
buyer_2,Carmen,,1984-09-05,ES90209507870172975664,TRX_N-00666-28074948,2023-09-01T20:36:11,Zarautz,incomes,salary,2035.83,-45116.23
buyer_2,Carmen,,1984-09-05,ES90209507870172975664,TRX_N-00667-46448271,2023-09-01T13:39:36,Zarautz,expenses,transport,-47.91,-45164.14
buyer_2,Carmen,,1984-09-05,ES90209507870172975664,TRX_N-00668-79440338,2023-09-01T13:52:48,Zarautz,expenses,cash,-100.0,-45264.14
buyer_2,Carmen,,1984-09-05,ES90209507870172975664,TRX_N-00669-71355253,2023-09-02T05:09:16,Zarautz,expenses,gifts,-831.74,-46095.88
buyer_2,Carmen,,1984-09-05,ES90209507870172975664,TRX_N-00670-43554594,2023-09-03T14:43:46,Zarautz,expenses,repairs,-190.0,-46285.88
buyer_2,Carmen,,1984-09-05,ES90209507870172975664,TRX_N-00671-80336522,2023-09-04T23:45:33,Zarautz,expenses,mortgage,-703.19,-46989.07
buyer_2,Carmen,,1984-09-05,ES90209507870172975664,TRX_N-00672-82508000,2023-09-05T20:30:35,Zarautz,expenses,water,-38.5,-47027.57
buyer_2,Carmen,,1984-09-05,ES90209507870172975664,TRX_N-00673-00816795,2023-09-05T13:32:57,Zarautz,expenses,phone,-32.41,-47059.98
buyer_2,Carmen,,1984-09-05,ES90209507870172975664,TRX_N-00674-54148415,2023-09-06T15:03:39,Zarautz,expenses,electricity,-80.94,-47140.92
buyer_2,Carmen,,1984-09-05,ES90209507870172975664,TRX_N-00675-17724191,2023-09-06T07:34:06,Zarautz,expenses,clothing,-73.14,-47214.06
buyer_2,Carmen,,1984-09-05,ES90209507870172975664,TRX_N-00676-35015328,2023-09-06T14:34:27,Sopela,expenses,appliances,-332.1,-47546.16
buyer_2,Carmen,,1984-09-05,ES90209507870172975664,TRX_N-00677-56658487,2023-09-07T09:48:49,Zarautz,expenses,transport,-47.59,-47593.75
buyer_2,Carmen,,1984-09-05,ES90209507870172975664,TRX_N-00678-15932275,2023-09-07T15:45:39,Zarautz,expenses,children,-166.56,-47760.31
buyer_2,Carmen,,1984-09-05,ES90209507870172975664,TRX_N-00679-24313697,2023-09-08T17:39:34,Zarautz,expenses,internet,-42.0,-47802.31
buyer_2,Carmen,,1984-09-05,ES90209507870172975664,TRX_N-00680-41200178,2023-09-08T20:00:46,Zarautz,expenses,gas,-46.53,-47848.84
buyer_2,Carmen,,1984-09-05,ES90209507870172975664,TRX_N-00681-38223074,2023-09-09T12:38:38,Zarautz,expenses,repairs,-143.95,-47992.79
buyer_2,Carmen,,1984-09-05,ES90209507870172975664,TRX_N-00682-03081815,2023-09-11T19:33:22,Zarautz,expenses,children,-698.75,-48691.54
buyer_2,Carmen,,1984-09-05,ES90209507870172975664,TRX_N-00683-38249032,2023-09-12T19:32:55,Zarautz,expenses,food,-88.24,-48779.78
buyer_2,Carmen,,1984-09-05,ES90209507870172975664,TRX_N-00684-77547916,2023-09-13T19:54:57,Zarautz,expenses,healthcare,-45.86,-48825.64
buyer_2,Carmen,,1984-09-05,ES90209507870172975664,TRX_N-00685-50500330,2023-09-16T16:18:26,Zarautz,expenses,food,-90.9,-48916.54
buyer_2,Carmen,,1984-09-05,ES90209507870172975664,TRX_N-00686-27612735,2023-09-17T22:17:34,Zarautz,expenses,cash,-100.0,-49016.54
buyer_2,Carmen,,1984-09-05,ES90209507870172975664,TRX_N-00687-55574468,2023-09-18T16:18:06,Zarautz,expenses,transport,-71.63,-49088.17
buyer_2,Carmen,,1984-09-05,ES90209507870172975664,TRX_N-00688-65302357,2023-09-19T22:14:52,Zarautz,expenses,leisure,-23.76,-49111.93
buyer_2,Carmen,,1984-09-05,ES90209507870172975664,TRX_N-00689-44604223,2023-09-23T09:12:52,Zarautz,expenses,repairs,-75.07,-49187.0
buyer_2,Carmen,,1984-09-05,ES90209507870172975664,TRX_N-00690-01079687,2023-09-24T16:01:05,Zarautz,expenses,leisure,-39.69,-49226.69
buyer_2,Carmen,,1984-09-05,ES90209507870172975664,TRX_N-00691-54704287,2023-09-25T17:50:18,Zarautz,expenses,repairs,-93.12,-49319.81
buyer_2,Carmen,,1984-09-05,ES90209507870172975664,TRX_N-00692-43401413,2023-09-26T09:56:27,Zarautz,expenses,food,-81.75,-49401.56
buyer_2,Carmen,,1984-09-05,ES90209507870172975664,TRX_N-00693-39158859,2023-09-26T19:03:02,Getxo,expenses,appliances,-212.73,-49614.29
buyer_2,Carmen,,1984-09-05,ES90209507870172975664,TRX_N-00694-33568525,2023-09-26T09:54:21,Zarautz,expenses,gifts,-807.06,-50421.35
buyer_2,Carmen,,1984-09-05,ES90209507870172975664,TRX_N-00695-26643278,2023-09-28T13:09:38,Zarautz,expenses,transport,-47.17,-50468.52
buyer_2,Carmen,,1984-09-05,ES90209507870172975664,TRX_N-00696-50085793,2023-10-01T11:39:24,Zarautz,incomes,salary,2035.83,-48432.69
buyer_2,Carmen,,1984-09-05,ES90209507870172975664,TRX_N-00697-79471947,2023-10-01T18:25:37,Zarautz,expenses,repairs,-109.18,-48541.87
buyer_2,Carmen,,1984-09-05,ES90209507870172975664,TRX_N-00698-85771638,2023-10-02T19:06:57,Oy√≥n-Oion,expenses,transport,-59.81,-48601.68
buyer_2,Carmen,,1984-09-05,ES90209507870172975664,TRX_N-00699-40369220,2023-10-02T16:22:03,Zarautz,expenses,leisure,-78.65,-48680.33
buyer_2,Carmen,,1984-09-05,ES90209507870172975664,TRX_N-00700-74467178,2023-10-02T15:19:51,Leioa,expenses,healthcare,-146.23,-48826.56
buyer_2,Carmen,,1984-09-05,ES90209507870172975664,TRX_N-00701-09147022,2023-10-03T15:16:07,Zarautz,expenses,healthcare,-123.15,-48949.71
buyer_2,Carmen,,1984-09-05,ES90209507870172975664,TRX_N-00702-10373064,2023-10-04T20:25:51,Zarautz,expenses,mortgage,-703.19,-49652.9
buyer_2,Carmen,,1984-09-05,ES90209507870172975664,TRX_N-00703-68273055,2023-10-05T09:14:19,Zarautz,expenses,water,-37.34,-49690.24
buyer_2,Carmen,,1984-09-05,ES90209507870172975664,TRX_N-00704-82619197,2023-10-05T17:45:59,Zarautz,expenses,transport,-89.85,-49780.09
buyer_2,Carmen,,1984-09-05,ES90209507870172975664,TRX_N-00705-49649468,2023-10-06T08:05:32,Zarautz,expenses,internet,-42.0,-49822.09
buyer_2,Carmen,,1984-09-05,ES90209507870172975664,TRX_N-00706-94431494,2023-10-08T00:20:09,Zarautz,expenses,electricity,-72.52,-49894.61
buyer_2,Carmen,,1984-09-05,ES90209507870172975664,TRX_N-00707-41888057,2023-10-08T20:05:57,Zarautz,expenses,gas,-51.74,-49946.35
buyer_2,Carmen,,1984-09-05,ES90209507870172975664,TRX_N-00708-49173044,2023-10-08T20:30:42,Zarautz,expenses,phone,-39.8,-49986.15
buyer_2,Carmen,,1984-09-05,ES90209507870172975664,TRX_N-00709-51437245,2023-10-08T01:22:59,Zarautz,expenses,food,-113.47,-50099.62
buyer_2,Carmen,,1984-09-05,ES90209507870172975664,TRX_N-00710-06425182,2023-10-09T15:10:35,Labastida,expenses,leisure,-71.12,-50170.74
buyer_2,Carmen,,1984-09-05,ES90209507870172975664,TRX_N-00711-38771710,2023-10-09T08:56:19,Zarautz,expenses,cash,-100.0,-50270.74
buyer_2,Carmen,,1984-09-05,ES90209507870172975664,TRX_N-00712-01548605,2023-10-11T13:22:19,Zarautz,expenses,food,-98.37,-50369.11
buyer_2,Carmen,,1984-09-05,ES90209507870172975664,TRX_N-00713-65113088,2023-10-11T17:53:42,Bilbao,expenses,transport,-49.37,-50418.48
buyer_2,Carmen,,1984-09-05,ES90209507870172975664,TRX_N-00714-68286183,2023-10-11T15:09:00,Zarautz,expenses,gifts,-710.04,-51128.52
buyer_2,Carmen,,1984-09-05,ES90209507870172975664,TRX_N-00715-44903134,2023-10-13T14:48:38,Zarautz,expenses,food,-116.86,-51245.38
buyer_2,Carmen,,1984-09-05,ES90209507870172975664,TRX_N-00716-54427507,2023-10-13T13:41:43,Erandio,expenses,transport,-49.88,-51295.26
buyer_2,Carmen,,1984-09-05,ES90209507870172975664,TRX_N-00717-02889448,2023-10-13T15:25:34,Zarautz,expenses,healthcare,-186.38,-51481.64
buyer_2,Carmen,,1984-09-05,ES90209507870172975664,TRX_N-00718-22030561,2023-10-13T14:10:23,Zarautz,expenses,children,-401.23,-51882.87
buyer_2,Carmen,,1984-09-05,ES90209507870172975664,TRX_N-00719-25203862,2023-10-15T08:58:13,Zarautz,expenses,repairs,-43.13,-51926.0
buyer_2,Carmen,,1984-09-05,ES90209507870172975664,TRX_N-00720-49159399,2023-10-17T10:41:42,Zarautz,expenses,transport,-58.9,-51984.9
buyer_2,Carmen,,1984-09-05,ES90209507870172975664,TRX_N-00721-73190755,2023-10-17T18:26:33,Zarautz,expenses,education,-64.49,-52049.39
buyer_2,Carmen,,1984-09-05,ES90209507870172975664,TRX_N-00722-13872833,2023-10-21T15:02:36,Zarautz,expenses,education,-66.75,-52116.14
buyer_2,Carmen,,1984-09-05,ES90209507870172975664,TRX_N-00723-37663745,2023-10-21T10:44:18,Zarautz,expenses,children,-225.24,-52341.38
buyer_2,Carmen,,1984-09-05,ES90209507870172975664,TRX_N-00724-67220404,2023-10-22T13:15:05,Zarautz,expenses,repairs,-161.46,-52502.84
buyer_2,Carmen,,1984-09-05,ES90209507870172975664,TRX_N-00725-65348385,2023-10-23T20:31:40,Zarautz,expenses,cash,-100.0,-52602.84
buyer_2,Carmen,,1984-09-05,ES90209507870172975664,TRX_N-00726-18172086,2023-10-24T09:12:52,Zarautz,expenses,transport,-86.16,-52689.0
buyer_2,Carmen,,1984-09-05,ES90209507870172975664,TRX_N-00727-71446732,2023-10-24T22:49:46,Zarautz,expenses,cash,-100.0,-52789.0
buyer_2,Carmen,,1984-09-05,ES90209507870172975664,TRX_N-00728-22204618,2023-10-25T09:55:28,Zarautz,expenses,repairs,-115.48,-52904.48
buyer_2,Carmen,,1984-09-05,ES90209507870172975664,TRX_N-00729-79471334,2023-10-27T12:38:08,Zarautz,expenses,education,-68.49,-52972.97
buyer_2,Carmen,,1984-09-05,ES90209507870172975664,TRX_N-00730-16025827,2023-10-27T22:19:57,Zarautz,expenses,cash,-100.0,-53072.97
buyer_2,Carmen,,1984-09-05,ES90209507870172975664,TRX_N-00731-87686974,2023-10-28T08:34:56,Pasaia,expenses,food,-111.66,-53184.63
buyer_2,Carmen,,1984-09-05,ES90209507870172975664,TRX_N-00732-39523729,2023-10-30T02:24:33,Zarautz,expenses,food,-74.52,-53259.15
buyer_2,Carmen,,1984-09-05,ES90209507870172975664,TRX_N-00733-24746894,2023-10-30T11:12:14,Zarautz,expenses,children,-636.14,-53895.29
buyer_2,Carmen,,1984-09-05,ES90209507870172975664,TRX_N-00734-95146908,2023-11-01T14:39:18,Zarautz,incomes,salary,2035.83,-51859.46
buyer_2,Carmen,,1984-09-05,ES90209507870172975664,TRX_N-00735-10916448,2023-11-01T14:39:18,Zarautz,incomes,extra_income,364.42,-51495.04
buyer_2,Carmen,,1984-09-05,ES90209507870172975664,TRX_N-00736-93805080,2023-11-01T08:04:52,Zarautz,expenses,gifts,-43.73,-51538.77
buyer_2,Carmen,,1984-09-05,ES90209507870172975664,TRX_N-00737-43773384,2023-11-04T20:11:03,Zarautz,expenses,mortgage,-703.19,-52241.96
buyer_2,Carmen,,1984-09-05,ES90209507870172975664,TRX_N-00738-25401400,2023-11-05T13:35:29,Zarautz,expenses,water,-43.77,-52285.73
buyer_2,Carmen,,1984-09-05,ES90209507870172975664,TRX_N-00739-17268271,2023-11-05T16:27:28,Zarautz,expenses,phone,-33.21,-52318.94
buyer_2,Carmen,,1984-09-05,ES90209507870172975664,TRX_N-00740-16921298,2023-11-06T11:12:33,Zarautz,expenses,gas,-95.11,-52414.05
buyer_2,Carmen,,1984-09-05,ES90209507870172975664,TRX_N-00741-88072905,2023-11-06T13:30:43,Zarautz,expenses,internet,-42.0,-52456.05
buyer_2,Carmen,,1984-09-05,ES90209507870172975664,TRX_N-00742-23667560,2023-11-06T09:10:20,Zarautz,expenses,travel,-1369.36,-53825.41
buyer_2,Carmen,,1984-09-05,ES90209507870172975664,TRX_N-00743-85525612,2023-11-07T08:35:57,Zarautz,expenses,education,-58.36,-53883.77
buyer_2,Carmen,,1984-09-05,ES90209507870172975664,TRX_N-00744-55464727,2023-11-08T09:49:59,Zarautz,expenses,electricity,-64.91,-53948.68
buyer_2,Carmen,,1984-09-05,ES90209507870172975664,TRX_N-00745-60531357,2023-11-14T10:59:33,Bilbao,expenses,food,-75.26,-54023.94
buyer_2,Carmen,,1984-09-05,ES90209507870172975664,TRX_N-00746-27044651,2023-11-14T17:58:16,Salvatierra/Agurain,expenses,transport,-65.28,-54089.22
buyer_2,Carmen,,1984-09-05,ES90209507870172975664,TRX_N-00747-04651749,2023-11-14T12:54:02,Zarautz,expenses,leisure,-77.23,-54166.45
buyer_2,Carmen,,1984-09-05,ES90209507870172975664,TRX_N-00748-99094867,2023-11-15T04:57:06,Zarautz,expenses,gifts,-613.61,-54780.06
buyer_2,Carmen,,1984-09-05,ES90209507870172975664,TRX_N-00749-52111580,2023-11-16T13:23:54,Zuia,expenses,leisure,-37.29,-54817.35
buyer_2,Carmen,,1984-09-05,ES90209507870172975664,TRX_N-00750-16945393,2023-11-20T22:11:55,Zarautz,expenses,transport,-42.28,-54859.63
buyer_2,Carmen,,1984-09-05,ES90209507870172975664,TRX_N-00751-07832647,2023-11-22T15:15:29,Amurrio,expenses,food,-110.72,-54970.35
buyer_2,Carmen,,1984-09-05,ES90209507870172975664,TRX_N-00752-10898582,2023-11-23T11:36:29,Zarautz,expenses,transport,-41.85,-55012.2
buyer_2,Carmen,,1984-09-05,ES90209507870172975664,TRX_N-00753-95628008,2023-11-23T12:41:27,Donostia,expenses,cash,-100.0,-55112.2
buyer_2,Carmen,,1984-09-05,ES90209507870172975664,TRX_N-00754-06016465,2023-11-24T22:54:36,Zarautz,expenses,transport,-50.33,-55162.53
buyer_2,Carmen,,1984-09-05,ES90209507870172975664,TRX_N-00755-01494684,2023-11-24T08:48:00,Zarautz,expenses,cash,-100.0,-55262.53
buyer_2,Carmen,,1984-09-05,ES90209507870172975664,TRX_N-00756-83476723,2023-11-26T17:17:10,Zarautz,expenses,gifts,-187.43,-55449.96
buyer_2,Carmen,,1984-09-05,ES90209507870172975664,TRX_N-00757-87538115,2023-11-27T07:34:44,Lasarte-Oria,expenses,food,-122.12,-55572.08
buyer_2,Carmen,,1984-09-05,ES90209507870172975664,TRX_N-00758-53674939,2023-11-28T10:47:43,Zarautz,expenses,transport,-83.36,-55655.44
buyer_2,Carmen,,1984-09-05,ES90209507870172975664,TRX_N-00759-32728424,2023-11-29T11:21:06,Zarautz,expenses,food,-75.04,-55730.48
buyer_2,Carmen,,1984-09-05,ES90209507870172975664,TRX_N-00760-13320745,2023-11-29T20:07:46,Llodio,expenses,cash,-100.0,-55830.48
buyer_2,Carmen,,1984-09-05,ES90209507870172975664,TRX_N-00761-79715183,2023-12-01T15:31:17,Zarautz,incomes,salary,2035.83,-53794.65
buyer_2,Carmen,,1984-09-05,ES90209507870172975664,TRX_N-00762-55833104,2023-12-01T15:31:17,Zarautz,incomes,salary_bonus,1494.68,-52299.97
buyer_2,Carmen,,1984-09-05,ES90209507870172975664,TRX_N-00763-24808824,2023-12-01T15:11:21,Zarautz,expenses,education,-67.34,-52367.31
buyer_2,Carmen,,1984-09-05,ES90209507870172975664,TRX_N-00764-92039778,2023-12-02T20:15:32,Zarautz,expenses,leisure,-78.75,-52446.06
buyer_2,Carmen,,1984-09-05,ES90209507870172975664,TRX_N-00765-40892899,2023-12-02T20:38:37,Zarautz,expenses,children,-225.68,-52671.74
buyer_2,Carmen,,1984-09-05,ES90209507870172975664,TRX_N-00766-51020526,2023-12-03T17:43:51,Zarautz,expenses,cash,-100.0,-52771.74
buyer_2,Carmen,,1984-09-05,ES90209507870172975664,TRX_N-00767-00728998,2023-12-04T13:30:01,Zarautz,expenses,mortgage,-703.19,-53474.93
buyer_2,Carmen,,1984-09-05,ES90209507870172975664,TRX_N-00768-64851453,2023-12-05T04:26:08,Zarautz,expenses,water,-24.5,-53499.43
buyer_2,Carmen,,1984-09-05,ES90209507870172975664,TRX_N-00769-41626583,2023-12-05T14:01:41,Zarautz,expenses,internet,-42.0,-53541.43
buyer_2,Carmen,,1984-09-05,ES90209507870172975664,TRX_N-00770-90858559,2023-12-05T13:25:39,Zarautz,expenses,phone,-41.33,-53582.76
buyer_2,Carmen,,1984-09-05,ES90209507870172975664,TRX_N-00771-93076780,2023-12-06T11:42:20,Zarautz,expenses,food,-101.72,-53684.48
buyer_2,Carmen,,1984-09-05,ES90209507870172975664,TRX_N-00772-15281654,2023-12-08T13:20:04,Zarautz,expenses,electricity,-62.78,-53747.26
buyer_2,Carmen,,1984-09-05,ES90209507870172975664,TRX_N-00773-65337300,2023-12-08T12:39:08,Zarautz,expenses,gas,-32.42,-53779.68
buyer_2,Carmen,,1984-09-05,ES90209507870172975664,TRX_N-00774-68733404,2023-12-08T01:50:04,Zarautz,expenses,cash,-100.0,-53879.68
buyer_2,Carmen,,1984-09-05,ES90209507870172975664,TRX_N-00775-10969903,2023-12-09T03:41:03,Vitoria-Gasteiz,expenses,transport,-66.99,-53946.67
buyer_2,Carmen,,1984-09-05,ES90209507870172975664,TRX_N-00776-12775984,2023-12-09T14:30:03,Sopela,expenses,leisure,-43.0,-53989.67
buyer_2,Carmen,,1984-09-05,ES90209507870172975664,TRX_N-00777-84198983,2023-12-09T16:09:25,Zarautz,expenses,cash,-100.0,-54089.67
buyer_2,Carmen,,1984-09-05,ES90209507870172975664,TRX_N-00778-74881167,2023-12-10T14:07:36,Hernani,expenses,leisure,-59.73,-54149.4
buyer_2,Carmen,,1984-09-05,ES90209507870172975664,TRX_N-00779-57014446,2023-12-11T20:58:13,Zarautz,expenses,leisure,-33.07,-54182.47
buyer_2,Carmen,,1984-09-05,ES90209507870172975664,TRX_N-00780-09299865,2023-12-13T20:38:37,Zarautz,expenses,food,-74.02,-54256.49
buyer_2,Carmen,,1984-09-05,ES90209507870172975664,TRX_N-00781-72808286,2023-12-13T19:44:04,Zarautz,expenses,cash,-100.0,-54356.49
buyer_2,Carmen,,1984-09-05,ES90209507870172975664,TRX_N-00782-61393500,2023-12-14T16:59:44,Zarautz,expenses,food,-92.78,-54449.27
buyer_2,Carmen,,1984-09-05,ES90209507870172975664,TRX_N-00783-09085045,2023-12-16T08:28:16,Alegr√≠a-Dulantzi,expenses,clothing,-151.32,-54600.59
buyer_2,Carmen,,1984-09-05,ES90209507870172975664,TRX_N-00784-50847007,2023-12-17T12:41:44,Zarautz,expenses,leisure,-49.77,-54650.36
buyer_2,Carmen,,1984-09-05,ES90209507870172975664,TRX_N-00785-85564472,2023-12-19T16:09:20,Durango,expenses,leisure,-19.38,-54669.74
buyer_2,Carmen,,1984-09-05,ES90209507870172975664,TRX_N-00786-30444122,2023-12-20T17:44:08,Donostia,expenses,gifts,-437.82,-55107.56
buyer_2,Carmen,,1984-09-05,ES90209507870172975664,TRX_N-00787-59617629,2023-12-21T19:48:59,Zarautz,expenses,repairs,-227.07,-55334.63
buyer_2,Carmen,,1984-09-05,ES90209507870172975664,TRX_N-00788-37687993,2023-12-22T17:12:26,Zarautz,expenses,food,-62.72,-55397.35
buyer_2,Carmen,,1984-09-05,ES90209507870172975664,TRX_N-00789-63603228,2023-12-23T15:48:38,Zarautz,expenses,leisure,-23.25,-55420.6
buyer_2,Carmen,,1984-09-05,ES90209507870172975664,TRX_N-00790-43965821,2023-12-25T13:34:48,Zarautz,expenses,food,-90.49,-55511.09
buyer_2,Carmen,,1984-09-05,ES90209507870172975664,TRX_N-00791-32869582,2023-12-25T10:24:30,Zarautz,expenses,healthcare,-152.66,-55663.75
buyer_2,Carmen,,1984-09-05,ES90209507870172975664,TRX_N-00792-22423988,2023-12-26T23:17:18,Zarautz,expenses,repairs,-160.57,-55824.32
buyer_2,Carmen,,1984-09-05,ES90209507870172975664,TRX_N-00793-15330903,2023-12-26T15:53:42,Barakaldo,expenses,gifts,-481.1,-56305.42
buyer_2,Carmen,,1984-09-05,ES90209507870172975664,TRX_N-00794-49943803,2023-12-27T08:41:05,Zarautz,expenses,cash,-100.0,-56405.42
buyer_2,Carmen,,1984-09-05,ES90209507870172975664,TRX_N-00795-62694744,2023-12-29T08:08:38,Zarautz,expenses,clothing,-110.57,-56515.99
buyer_2,Carmen,,1984-09-05,ES90209507870172975664,TRX_N-00796-28310186,2023-12-29T11:14:20,Zarautz,expenses,education,-66.3,-56582.29
buyer_2,Carmen,,1984-09-05,ES90209507870172975664,TRX_N-00797-59572490,2023-12-29T16:28:02,Zarautz,expenses,cash,-100.0,-56682.29
buyer_2,Carmen,,1984-09-05,ES90209507870172975664,TRX_N-00798-36918003,2023-12-31T19:38:46,Zarautz,expenses,education,-59.56,-56741.85
buyer_2,Carmen,,1984-09-05,ES90209507870172975664,TRX_N-00799-74173775,2024-01-01T12:32:54,Zarautz,incomes,salary,2094.47,-54647.38
buyer_2,Carmen,,1984-09-05,ES90209507870172975664,TRX_N-00800-75577769,2024-01-01T20:27:08,Hondarribia,expenses,repairs,-32.83,-54680.21
buyer_2,Carmen,,1984-09-05,ES90209507870172975664,TRX_N-00801-02838878,2024-01-02T09:59:14,Lasarte-Oria,expenses,transport,-85.03,-54765.24
buyer_2,Carmen,,1984-09-05,ES90209507870172975664,TRX_N-00802-79164833,2024-01-02T13:19:04,Zuia,expenses,clothing,-71.89,-54837.13
buyer_2,Carmen,,1984-09-05,ES90209507870172975664,TRX_N-00803-63886504,2024-01-03T11:26:16,Zarautz,expenses,food,-69.34,-54906.47
buyer_2,Carmen,,1984-09-05,ES90209507870172975664,TRX_N-00804-33800152,2024-01-03T13:39:21,Zuia,expenses,cash,-100.0,-55006.47
buyer_2,Carmen,,1984-09-05,ES90209507870172975664,TRX_N-00805-25209562,2024-01-04T18:13:05,Zarautz,expenses,mortgage,-703.19,-55709.66
buyer_2,Carmen,,1984-09-05,ES90209507870172975664,TRX_N-00806-94716492,2024-01-05T14:51:39,Zarautz,expenses,water,-38.18,-55747.84
buyer_2,Carmen,,1984-09-05,ES90209507870172975664,TRX_N-00807-60368231,2024-01-05T19:18:51,Zarautz,expenses,electricity,-57.96,-55805.8
buyer_2,Carmen,,1984-09-05,ES90209507870172975664,TRX_N-00808-88320169,2024-01-05T14:25:22,Zarautz,expenses,repairs,-125.48,-55931.28
buyer_2,Carmen,,1984-09-05,ES90209507870172975664,TRX_N-00809-27297662,2024-01-06T11:58:10,Zarautz,expenses,cash,-100.0,-56031.28
buyer_2,Carmen,,1984-09-05,ES90209507870172975664,TRX_N-00810-35617879,2024-01-07T15:21:44,Zarautz,expenses,gas,-70.11,-56101.39
buyer_2,Carmen,,1984-09-05,ES90209507870172975664,TRX_N-00811-55312812,2024-01-08T06:12:58,Zarautz,expenses,internet,-42.0,-56143.39
buyer_2,Carmen,,1984-09-05,ES90209507870172975664,TRX_N-00812-43227356,2024-01-08T22:18:42,Zarautz,expenses,phone,-34.42,-56177.81
buyer_2,Carmen,,1984-09-05,ES90209507870172975664,TRX_N-00813-85302923,2024-01-09T11:35:40,Arrasate,expenses,food,-94.03,-56271.84
buyer_2,Carmen,,1984-09-05,ES90209507870172975664,TRX_N-00814-09472102,2024-01-13T18:06:55,Zarautz,expenses,leisure,-50.48,-56322.32
buyer_2,Carmen,,1984-09-05,ES90209507870172975664,TRX_N-00815-64815221,2024-01-14T04:35:11,Zarautz,expenses,food,-99.63,-56421.95
buyer_2,Carmen,,1984-09-05,ES90209507870172975664,TRX_N-00816-50171074,2024-01-15T17:27:21,Zarautz,expenses,leisure,-48.62,-56470.57
buyer_2,Carmen,,1984-09-05,ES90209507870172975664,TRX_N-00817-70372466,2024-01-15T16:22:36,Zarautz,expenses,cash,-100.0,-56570.57
buyer_2,Carmen,,1984-09-05,ES90209507870172975664,TRX_N-00818-36900700,2024-01-17T23:53:36,Pasaia,expenses,food,-106.72,-56677.29
buyer_2,Carmen,,1984-09-05,ES90209507870172975664,TRX_N-00819-78607382,2024-01-18T08:47:55,Zarautz,expenses,gifts,-673.22,-57350.51
buyer_2,Carmen,,1984-09-05,ES90209507870172975664,TRX_N-00820-38144330,2024-01-20T09:09:36,Zarautz,expenses,gifts,-766.89,-58117.4
buyer_2,Carmen,,1984-09-05,ES90209507870172975664,TRX_N-00821-37876755,2024-01-21T09:22:18,Zarautz,expenses,healthcare,-179.88,-58297.28
buyer_2,Carmen,,1984-09-05,ES90209507870172975664,TRX_N-00822-22152820,2024-01-22T14:43:31,Zarautz,expenses,leisure,-83.27,-58380.55
buyer_2,Carmen,,1984-09-05,ES90209507870172975664,TRX_N-00823-26779124,2024-01-25T12:37:40,Zarautz,expenses,gifts,-746.57,-59127.12
buyer_2,Carmen,,1984-09-05,ES90209507870172975664,TRX_N-00824-38685353,2024-01-27T14:45:01,Irun,expenses,cash,-100.0,-59227.12
buyer_2,Carmen,,1984-09-05,ES90209507870172975664,TRX_N-00825-47371234,2024-01-28T01:22:47,Salvatierra/Agurain,expenses,leisure,-42.64,-59269.76
buyer_2,Carmen,,1984-09-05,ES90209507870172975664,TRX_N-00826-90357780,2024-01-28T10:34:01,Zarautz,expenses,cash,-100.0,-59369.76
buyer_2,Carmen,,1984-09-05,ES90209507870172975664,TRX_N-00827-18669695,2024-01-29T11:03:15,Zarautz,expenses,food,-95.34,-59465.1
buyer_2,Carmen,,1984-09-05,ES90209507870172975664,TRX_N-00828-22829067,2024-01-29T20:03:40,Zarautz,expenses,cash,-100.0,-59565.1
buyer_2,Carmen,,1984-09-05,ES90209507870172975664,TRX_N-00829-03524649,2024-01-31T15:56:08,Salvatierra/Agurain,expenses,cash,-100.0,-59665.1
buyer_2,Carmen,,1984-09-05,ES90209507870172975664,TRX_N-00830-30194061,2024-01-31T17:56:18,Zarautz,expenses,travel,-894.93,-60560.03
buyer_2,Carmen,,1984-09-05,ES90209507870172975664,TRX_N-00831-67907341,2024-02-01T16:52:57,Zarautz,incomes,salary,2094.47,-58465.56
buyer_2,Carmen,,1984-09-05,ES90209507870172975664,TRX_N-00832-70969547,2024-02-03T21:47:18,Zarautz,expenses,education,-46.41,-58511.97
buyer_2,Carmen,,1984-09-05,ES90209507870172975664,TRX_N-00833-36780791,2024-02-04T16:52:27,Zarautz,expenses,mortgage,-703.19,-59215.16
buyer_2,Carmen,,1984-09-05,ES90209507870172975664,TRX_N-00834-85649022,2024-02-05T13:04:20,Zarautz,expenses,electricity,-48.97,-59264.13
buyer_2,Carmen,,1984-09-05,ES90209507870172975664,TRX_N-00835-16048658,2024-02-05T20:39:06,Zarautz,expenses,food,-81.93,-59346.06
buyer_2,Carmen,,1984-09-05,ES90209507870172975664,TRX_N-00836-25923314,2024-02-06T15:27:06,Zarautz,expenses,leisure,-50.49,-59396.55
buyer_2,Carmen,,1984-09-05,ES90209507870172975664,TRX_N-00837-38404315,2024-02-06T15:20:08,Arrasate,expenses,clothing,-156.61,-59553.16
buyer_2,Carmen,,1984-09-05,ES90209507870172975664,TRX_N-00838-97237207,2024-02-07T13:57:38,Zarautz,expenses,phone,-43.94,-59597.1
buyer_2,Carmen,,1984-09-05,ES90209507870172975664,TRX_N-00839-30114321,2024-02-07T13:33:03,Zarautz,expenses,leisure,-66.97,-59664.07
buyer_2,Carmen,,1984-09-05,ES90209507870172975664,TRX_N-00840-83032985,2024-02-08T20:40:42,Zarautz,expenses,water,-27.86,-59691.93
buyer_2,Carmen,,1984-09-05,ES90209507870172975664,TRX_N-00841-61530989,2024-02-08T15:00:13,Zarautz,expenses,gas,-85.52,-59777.45
buyer_2,Carmen,,1984-09-05,ES90209507870172975664,TRX_N-00842-40272367,2024-02-08T00:23:00,Zarautz,expenses,internet,-42.0,-59819.45
buyer_2,Carmen,,1984-09-05,ES90209507870172975664,TRX_N-00843-95251320,2024-02-08T09:24:36,Zarautz,expenses,repairs,-179.78,-59999.23
buyer_2,Carmen,,1984-09-05,ES90209507870172975664,TRX_N-00844-74444060,2024-02-08T19:13:50,Zarautz,expenses,gifts,-258.08,-60257.31
buyer_2,Carmen,,1984-09-05,ES90209507870172975664,TRX_N-00845-86318052,2024-02-10T17:07:29,Sopela,expenses,food,-96.8,-60354.11
buyer_2,Carmen,,1984-09-05,ES90209507870172975664,TRX_N-00846-19597325,2024-02-10T13:43:47,Zarautz,expenses,appliances,-184.34,-60538.45
buyer_2,Carmen,,1984-09-05,ES90209507870172975664,TRX_N-00847-43207909,2024-02-11T18:04:18,Zarautz,expenses,food,-104.89,-60643.34
buyer_2,Carmen,,1984-09-05,ES90209507870172975664,TRX_N-00848-25620396,2024-02-12T16:42:21,Zarautz,expenses,children,-256.88,-60900.22
buyer_2,Carmen,,1984-09-05,ES90209507870172975664,TRX_N-00849-41850588,2024-02-13T10:36:46,Getxo,expenses,cash,-100.0,-61000.22
buyer_2,Carmen,,1984-09-05,ES90209507870172975664,TRX_N-00850-92349691,2024-02-14T13:26:15,Zarautz,expenses,leisure,-80.28,-61080.5
buyer_2,Carmen,,1984-09-05,ES90209507870172975664,TRX_N-00851-82219675,2024-02-15T18:09:34,Getxo,expenses,food,-92.75,-61173.25
buyer_2,Carmen,,1984-09-05,ES90209507870172975664,TRX_N-00852-66330539,2024-02-18T23:43:23,Hondarribia,expenses,repairs,-149.6,-61322.85
buyer_2,Carmen,,1984-09-05,ES90209507870172975664,TRX_N-00853-82352009,2024-02-20T12:07:57,Andoain,expenses,transport,-44.31,-61367.16
buyer_2,Carmen,,1984-09-05,ES90209507870172975664,TRX_N-00854-60961168,2024-02-22T15:59:08,Bermeo,expenses,food,-84.45,-61451.61
buyer_2,Carmen,,1984-09-05,ES90209507870172975664,TRX_N-00855-27552917,2024-02-25T14:58:22,Zarautz,expenses,food,-68.23,-61519.84
buyer_2,Carmen,,1984-09-05,ES90209507870172975664,TRX_N-00856-44264862,2024-02-25T17:35:48,Pasaia,expenses,cash,-100.0,-61619.84
buyer_2,Carmen,,1984-09-05,ES90209507870172975664,TRX_N-00857-64925427,2024-02-25T01:13:04,Zarautz,expenses,repairs,-267.75,-61887.59
buyer_2,Carmen,,1984-09-05,ES90209507870172975664,TRX_N-00858-35842108,2024-02-26T17:17:30,Zarautz,expenses,food,-81.41,-61969.0
buyer_2,Carmen,,1984-09-05,ES90209507870172975664,TRX_N-00859-01872666,2024-02-26T10:55:50,Zarautz,expenses,transport,-70.01,-62039.01
buyer_2,Carmen,,1984-09-05,ES90209507870172975664,TRX_N-00860-99961526,2024-02-26T12:24:11,Zarautz,expenses,leisure,-33.29,-62072.3
buyer_2,Carmen,,1984-09-05,ES90209507870172975664,TRX_N-00861-50300247,2024-02-28T19:42:54,Zarautz,expenses,leisure,-54.74,-62127.04
buyer_2,Carmen,,1984-09-05,ES90209507870172975664,TRX_N-00862-12798273,2024-02-28T10:54:14,Zarautz,expenses,repairs,-79.12,-62206.16
buyer_2,Carmen,,1984-09-05,ES90209507870172975664,TRX_N-00863-49742755,2024-02-29T02:37:47,Zarautz,expenses,cash,-100.0,-62306.16
buyer_2,Carmen,,1984-09-05,ES90209507870172975664,TRX_N-00864-26698128,2024-03-01T20:32:29,Zarautz,incomes,salary,2094.47,-60211.69
buyer_2,Carmen,,1984-09-05,ES90209507870172975664,TRX_N-00865-92556151,2024-03-01T20:32:29,Zarautz,incomes,extra_income,364.42,-59847.27
buyer_2,Carmen,,1984-09-05,ES90209507870172975664,TRX_N-00866-71739028,2024-03-02T13:03:58,Zarautz,expenses,leisure,-76.0,-59923.27
buyer_2,Carmen,,1984-09-05,ES90209507870172975664,TRX_N-00867-99263873,2024-03-03T22:30:14,Zarautz,expenses,leisure,-66.0,-59989.27
buyer_2,Carmen,,1984-09-05,ES90209507870172975664,TRX_N-00868-00938683,2024-03-04T15:58:35,Zarautz,expenses,mortgage,-703.19,-60692.46
buyer_2,Carmen,,1984-09-05,ES90209507870172975664,TRX_N-00869-75290217,2024-03-05T12:25:19,Zarautz,expenses,phone,-37.63,-60730.09
buyer_2,Carmen,,1984-09-05,ES90209507870172975664,TRX_N-00870-39251577,2024-03-07T13:06:44,Zarautz,expenses,internet,-42.0,-60772.09
buyer_2,Carmen,,1984-09-05,ES90209507870172975664,TRX_N-00871-46419409,2024-03-08T20:11:37,Zarautz,expenses,electricity,-37.64,-60809.73
buyer_2,Carmen,,1984-09-05,ES90209507870172975664,TRX_N-00872-97078610,2024-03-08T20:10:51,Zarautz,expenses,gas,-47.74,-60857.47
buyer_2,Carmen,,1984-09-05,ES90209507870172975664,TRX_N-00873-03846779,2024-03-08T01:37:57,Zarautz,expenses,water,-31.7,-60889.17
buyer_2,Carmen,,1984-09-05,ES90209507870172975664,TRX_N-00874-46370145,2024-03-08T23:57:31,Zarautz,expenses,leisure,-23.23,-60912.4
buyer_2,Carmen,,1984-09-05,ES90209507870172975664,TRX_N-00875-08115558,2024-03-09T09:21:35,Zarautz,expenses,repairs,-203.79,-61116.19
buyer_2,Carmen,,1984-09-05,ES90209507870172975664,TRX_N-00876-96970367,2024-03-12T11:20:43,Zarautz,expenses,cash,-100.0,-61216.19
buyer_2,Carmen,,1984-09-05,ES90209507870172975664,TRX_N-00877-59520669,2024-03-13T09:51:20,Zarautz,expenses,cash,-100.0,-61316.19
buyer_2,Carmen,,1984-09-05,ES90209507870172975664,TRX_N-00878-62429948,2024-03-13T12:30:31,Berango,expenses,repairs,-202.04,-61518.23
buyer_2,Carmen,,1984-09-05,ES90209507870172975664,TRX_N-00879-16647044,2024-03-14T19:20:59,Zarautz,expenses,food,-71.19,-61589.42
buyer_2,Carmen,,1984-09-05,ES90209507870172975664,TRX_N-00880-86916344,2024-03-14T08:26:31,Zarautz,expenses,children,-715.34,-62304.76
buyer_2,Carmen,,1984-09-05,ES90209507870172975664,TRX_N-00881-75618066,2024-03-18T07:52:02,Zarautz,expenses,healthcare,-47.52,-62352.28
buyer_2,Carmen,,1984-09-05,ES90209507870172975664,TRX_N-00882-39852229,2024-03-19T17:05:20,Zarautz,expenses,gifts,-623.1,-62975.38
buyer_2,Carmen,,1984-09-05,ES90209507870172975664,TRX_N-00883-22331202,2024-03-23T15:03:47,Vitoria-Gasteiz,expenses,clothing,-158.23,-63133.61
buyer_2,Carmen,,1984-09-05,ES90209507870172975664,TRX_N-00884-13722993,2024-03-23T20:58:33,Zarautz,expenses,travel,-1799.39,-64933.0
buyer_2,Carmen,,1984-09-05,ES90209507870172975664,TRX_N-00885-00419645,2024-03-24T11:58:18,Zarautz,expenses,repairs,-308.04,-65241.04
buyer_2,Carmen,,1984-09-05,ES90209507870172975664,TRX_N-00886-41345148,2024-03-25T13:08:51,Zarautz,expenses,food,-112.18,-65353.22
buyer_2,Carmen,,1984-09-05,ES90209507870172975664,TRX_N-00887-78173973,2024-03-25T18:38:09,Zarautz,expenses,transport,-49.84,-65403.06
buyer_2,Carmen,,1984-09-05,ES90209507870172975664,TRX_N-00888-02130626,2024-03-26T18:34:02,Zarautz,expenses,children,-169.34,-65572.4
buyer_2,Carmen,,1984-09-05,ES90209507870172975664,TRX_N-00889-75299533,2024-03-27T12:51:11,Zarautz,expenses,gifts,-433.77,-66006.17
buyer_2,Carmen,,1984-09-05,ES90209507870172975664,TRX_N-00890-59906772,2024-03-28T03:27:44,Zarautz,expenses,clothing,-56.47,-66062.64
buyer_2,Carmen,,1984-09-05,ES90209507870172975664,TRX_N-00891-58475857,2024-03-28T16:17:08,Zarautz,expenses,repairs,-139.63,-66202.27
buyer_2,Carmen,,1984-09-05,ES90209507870172975664,TRX_N-00892-68468294,2024-03-29T23:45:04,Arrasate,expenses,food,-112.79,-66315.06
buyer_2,Carmen,,1984-09-05,ES90209507870172975664,TRX_N-00893-56410598,2024-03-31T19:08:45,Zarautz,expenses,healthcare,-81.02,-66396.08
buyer_2,Carmen,,1984-09-05,ES90209507870172975664,TRX_N-00894-44511258,2024-03-31T12:52:02,Erandio,expenses,cash,-100.0,-66496.08
buyer_2,Carmen,,1984-09-05,ES90209507870172975664,TRX_N-00895-31224125,2024-03-31T11:36:32,Elciego,expenses,appliances,-130.86,-66626.94
buyer_2,Carmen,,1984-09-05,ES90209507870172975664,TRX_N-00896-93777522,2024-04-01T15:36:30,Zarautz,incomes,salary,2094.47,-64532.47
buyer_2,Carmen,,1984-09-05,ES90209507870172975664,TRX_N-00897-43264526,2024-04-01T19:49:03,Zarautz,expenses,transport,-60.14,-64592.61
buyer_2,Carmen,,1984-09-05,ES90209507870172975664,TRX_N-00898-20840093,2024-04-02T15:07:20,Zarautz,expenses,children,-697.19,-65289.8
buyer_2,Carmen,,1984-09-05,ES90209507870172975664,TRX_N-00899-59565937,2024-04-03T09:07:55,Pasaia,expenses,repairs,-96.35,-65386.15
buyer_2,Carmen,,1984-09-05,ES90209507870172975664,TRX_N-00900-11745002,2024-04-04T18:10:22,Zarautz,expenses,mortgage,-703.19,-66089.34
buyer_2,Carmen,,1984-09-05,ES90209507870172975664,TRX_N-00901-73819671,2024-04-04T08:37:10,Zarautz,expenses,education,-51.4,-66140.74
buyer_2,Carmen,,1984-09-05,ES90209507870172975664,TRX_N-00902-95106062,2024-04-05T15:46:03,Zarautz,expenses,water,-21.44,-66162.18
buyer_2,Carmen,,1984-09-05,ES90209507870172975664,TRX_N-00903-33311573,2024-04-05T14:04:10,Elciego,expenses,clothing,-139.54,-66301.72
buyer_2,Carmen,,1984-09-05,ES90209507870172975664,TRX_N-00904-42715528,2024-04-06T17:01:02,Zarautz,expenses,phone,-41.99,-66343.71
buyer_2,Carmen,,1984-09-05,ES90209507870172975664,TRX_N-00905-65495050,2024-04-06T20:02:41,Zarautz,expenses,travel,-735.79,-67079.5
buyer_2,Carmen,,1984-09-05,ES90209507870172975664,TRX_N-00906-16826336,2024-04-07T15:47:01,Zarautz,expenses,leisure,-75.3,-67154.8
buyer_2,Carmen,,1984-09-05,ES90209507870172975664,TRX_N-00907-82248835,2024-04-08T16:31:43,Zarautz,expenses,electricity,-72.96,-67227.76
buyer_2,Carmen,,1984-09-05,ES90209507870172975664,TRX_N-00908-04966861,2024-04-08T13:41:28,Zarautz,expenses,gas,-109.04,-67336.8
buyer_2,Carmen,,1984-09-05,ES90209507870172975664,TRX_N-00909-00458746,2024-04-08T09:50:10,Zarautz,expenses,internet,-42.0,-67378.8
buyer_2,Carmen,,1984-09-05,ES90209507870172975664,TRX_N-00910-64470966,2024-04-08T19:37:16,Zarautz,expenses,food,-117.97,-67496.77
buyer_2,Carmen,,1984-09-05,ES90209507870172975664,TRX_N-00911-04946380,2024-04-08T09:23:17,Basauri,expenses,transport,-41.72,-67538.49
buyer_2,Carmen,,1984-09-05,ES90209507870172975664,TRX_N-00912-03032773,2024-04-10T14:59:18,Hernani,expenses,cash,-100.0,-67638.49
buyer_2,Carmen,,1984-09-05,ES90209507870172975664,TRX_N-00913-43006274,2024-04-11T13:47:50,Zarautz,expenses,gifts,-116.22,-67754.71
buyer_2,Carmen,,1984-09-05,ES90209507870172975664,TRX_N-00914-13531226,2024-04-12T10:27:57,Zarautz,expenses,food,-83.39,-67838.1
buyer_2,Carmen,,1984-09-05,ES90209507870172975664,TRX_N-00915-97634448,2024-04-13T21:31:12,Zarautz,expenses,cash,-100.0,-67938.1
buyer_2,Carmen,,1984-09-05,ES90209507870172975664,TRX_N-00916-49013320,2024-04-13T10:38:34,Zarautz,expenses,gifts,-473.33,-68411.43
buyer_2,Carmen,,1984-09-05,ES90209507870172975664,TRX_N-00917-31730720,2024-04-14T08:07:01,Zarautz,expenses,food,-60.43,-68471.86
buyer_2,Carmen,,1984-09-05,ES90209507870172975664,TRX_N-00918-66873760,2024-04-15T09:43:17,Pasaia,expenses,food,-108.95,-68580.81
buyer_2,Carmen,,1984-09-05,ES90209507870172975664,TRX_N-00919-48122979,2024-04-16T12:13:11,Eibar,expenses,cash,-100.0,-68680.81
buyer_2,Carmen,,1984-09-05,ES90209507870172975664,TRX_N-00920-77256802,2024-04-16T16:03:17,Eibar,expenses,gifts,-485.5,-69166.31
buyer_2,Carmen,,1984-09-05,ES90209507870172975664,TRX_N-00921-14014784,2024-04-17T19:40:39,Zarautz,expenses,transport,-86.38,-69252.69
buyer_2,Carmen,,1984-09-05,ES90209507870172975664,TRX_N-00922-24323051,2024-04-19T18:15:26,Zarautz,expenses,leisure,-57.42,-69310.11
buyer_2,Carmen,,1984-09-05,ES90209507870172975664,TRX_N-00923-86228621,2024-04-19T17:08:20,Zarautz,expenses,appliances,-329.25,-69639.36
buyer_2,Carmen,,1984-09-05,ES90209507870172975664,TRX_N-00924-74698873,2024-04-20T10:33:04,Eibar,expenses,leisure,-74.29,-69713.65
buyer_2,Carmen,,1984-09-05,ES90209507870172975664,TRX_N-00925-66439428,2024-04-21T13:24:02,Iru√±a de Oca,expenses,clothing,-153.91,-69867.56
buyer_2,Carmen,,1984-09-05,ES90209507870172975664,TRX_N-00926-40605383,2024-04-22T20:51:22,Zarautz,expenses,food,-100.01,-69967.57
buyer_2,Carmen,,1984-09-05,ES90209507870172975664,TRX_N-00927-92896433,2024-04-22T18:30:19,Zarautz,expenses,cash,-100.0,-70067.57
buyer_2,Carmen,,1984-09-05,ES90209507870172975664,TRX_N-00928-91239547,2024-04-24T17:16:04,Zarautz,expenses,cash,-100.0,-70167.57
buyer_2,Carmen,,1984-09-05,ES90209507870172975664,TRX_N-00929-44650914,2024-04-26T19:44:44,Bilbao,expenses,cash,-100.0,-70267.57
buyer_2,Carmen,,1984-09-05,ES90209507870172975664,TRX_N-00930-56097173,2024-04-26T14:14:58,Oy√≥n-Oion,expenses,repairs,-174.69,-70442.26
buyer_2,Carmen,,1984-09-05,ES90209507870172975664,TRX_N-00931-23653824,2024-04-27T21:32:01,Zarautz,expenses,appliances,-163.54,-70605.8
buyer_2,Carmen,,1984-09-05,ES90209507870172975664,TRX_N-00932-68564034,2024-04-29T14:37:20,Zarautz,expenses,leisure,-79.69,-70685.49
buyer_2,Carmen,,1984-09-05,ES90209507870172975664,TRX_N-00933-76024249,2024-04-30T11:54:29,Zarautz,expenses,transport,-74.57,-70760.06
buyer_2,Carmen,,1984-09-05,ES90209507870172975664,TRX_N-00934-01797638,2024-05-01T14:57:19,Zarautz,incomes,salary,2094.47,-68665.59
buyer_2,Carmen,,1984-09-05,ES90209507870172975664,TRX_N-00935-72483416,2024-05-01T17:13:49,Zarautz,expenses,cash,-100.0,-68765.59
buyer_2,Carmen,,1984-09-05,ES90209507870172975664,TRX_N-00936-44609512,2024-05-03T18:26:08,Zarautz,expenses,transport,-80.04,-68845.63
buyer_2,Carmen,,1984-09-05,ES90209507870172975664,TRX_N-00937-92675785,2024-05-03T13:52:16,Zarautz,expenses,cash,-100.0,-68945.63
buyer_2,Carmen,,1984-09-05,ES90209507870172975664,TRX_N-00938-53151466,2024-05-04T17:41:15,Zarautz,expenses,mortgage,-703.19,-69648.82
buyer_2,Carmen,,1984-09-05,ES90209507870172975664,TRX_N-00939-03319691,2024-05-04T13:50:39,Leioa,expenses,food,-60.41,-69709.23
buyer_2,Carmen,,1984-09-05,ES90209507870172975664,TRX_N-00940-75842756,2024-05-05T20:16:55,Zarautz,expenses,electricity,-66.96,-69776.19
buyer_2,Carmen,,1984-09-05,ES90209507870172975664,TRX_N-00941-09738930,2024-05-05T19:38:48,Zarautz,expenses,food,-66.83,-69843.02
buyer_2,Carmen,,1984-09-05,ES90209507870172975664,TRX_N-00942-40952632,2024-05-05T19:37:19,Zarautz,expenses,transport,-52.47,-69895.49
buyer_2,Carmen,,1984-09-05,ES90209507870172975664,TRX_N-00943-16023171,2024-05-05T15:55:22,Zarautz,expenses,leisure,-40.42,-69935.91
buyer_2,Carmen,,1984-09-05,ES90209507870172975664,TRX_N-00944-05568234,2024-05-05T08:39:05,Zarautz,expenses,education,-69.2,-70005.11
buyer_2,Carmen,,1984-09-05,ES90209507870172975664,TRX_N-00945-96733548,2024-05-06T13:38:59,Zarautz,expenses,water,-43.64,-70048.75
buyer_2,Carmen,,1984-09-05,ES90209507870172975664,TRX_N-00946-59197031,2024-05-06T08:44:03,Zarautz,expenses,internet,-42.0,-70090.75
buyer_2,Carmen,,1984-09-05,ES90209507870172975664,TRX_N-00947-07521037,2024-05-07T11:29:18,Zarautz,expenses,repairs,-138.52,-70229.27
buyer_2,Carmen,,1984-09-05,ES90209507870172975664,TRX_N-00948-31804370,2024-05-08T09:32:58,Zarautz,expenses,gas,-67.95,-70297.22
buyer_2,Carmen,,1984-09-05,ES90209507870172975664,TRX_N-00949-67598048,2024-05-08T12:05:37,Zarautz,expenses,phone,-33.28,-70330.5
buyer_2,Carmen,,1984-09-05,ES90209507870172975664,TRX_N-00950-72959647,2024-05-08T13:09:06,Zarautz,expenses,cash,-100.0,-70430.5
buyer_2,Carmen,,1984-09-05,ES90209507870172975664,TRX_N-00951-17187953,2024-05-09T19:30:35,Zarautz,expenses,food,-103.52,-70534.02
buyer_2,Carmen,,1984-09-05,ES90209507870172975664,TRX_N-00952-07522000,2024-05-13T16:22:58,Amurrio,expenses,food,-88.54,-70622.56
buyer_2,Carmen,,1984-09-05,ES90209507870172975664,TRX_N-00953-93015822,2024-05-15T18:18:06,Zarautz,expenses,clothing,-89.41,-70711.97
buyer_2,Carmen,,1984-09-05,ES90209507870172975664,TRX_N-00954-43031489,2024-05-17T15:57:56,Zarautz,expenses,food,-79.13,-70791.1
buyer_2,Carmen,,1984-09-05,ES90209507870172975664,TRX_N-00955-70132961,2024-05-18T12:37:53,Zarautz,expenses,appliances,-168.21,-70959.31
buyer_2,Carmen,,1984-09-05,ES90209507870172975664,TRX_N-00956-17416485,2024-05-19T10:45:43,Zarautz,expenses,food,-74.17,-71033.48
buyer_2,Carmen,,1984-09-05,ES90209507870172975664,TRX_N-00957-54347925,2024-05-22T08:31:55,Zarautz,expenses,clothing,-71.46,-71104.94
buyer_2,Carmen,,1984-09-05,ES90209507870172975664,TRX_N-00958-74636160,2024-05-24T18:19:29,Zarautz,expenses,clothing,-107.4,-71212.34
buyer_2,Carmen,,1984-09-05,ES90209507870172975664,TRX_N-00959-82907543,2024-05-25T12:16:09,Donostia,expenses,leisure,-63.51,-71275.85
buyer_2,Carmen,,1984-09-05,ES90209507870172975664,TRX_N-00960-36090443,2024-05-25T19:05:13,Donostia,expenses,healthcare,-159.44,-71435.29
buyer_2,Carmen,,1984-09-05,ES90209507870172975664,TRX_N-00961-00594901,2024-05-25T19:30:27,Zarautz,expenses,travel,-632.83,-72068.12
buyer_2,Carmen,,1984-09-05,ES90209507870172975664,TRX_N-00962-54927601,2024-05-27T23:51:01,Santurtzi,expenses,gifts,-392.72,-72460.84
buyer_2,Carmen,,1984-09-05,ES90209507870172975664,TRX_N-00963-96962618,2024-05-28T07:19:15,Zarautz,expenses,cash,-100.0,-72560.84
buyer_2,Carmen,,1984-09-05,ES90209507870172975664,TRX_N-00964-56702498,2024-05-28T12:42:18,Zarautz,expenses,children,-170.74,-72731.58
buyer_2,Carmen,,1984-09-05,ES90209507870172975664,TRX_N-00965-90112466,2024-05-30T16:43:58,Llodio,expenses,transport,-64.98,-72796.56
buyer_2,Carmen,,1984-09-05,ES90209507870172975664,TRX_N-00966-88977346,2024-06-01T17:07:40,Zarautz,incomes,salary,2094.47,-70702.09
buyer_2,Carmen,,1984-09-05,ES90209507870172975664,TRX_N-00967-20205626,2024-06-01T17:07:40,Zarautz,incomes,extra_income,364.42,-70337.67
buyer_2,Carmen,,1984-09-05,ES90209507870172975664,TRX_N-00968-44324636,2024-06-01T17:07:40,Zarautz,incomes,salary_bonus,1501.83,-68835.84
buyer_2,Carmen,,1984-09-05,ES90209507870172975664,TRX_N-00969-02459856,2024-06-04T10:12:43,Zarautz,expenses,mortgage,-703.19,-69539.03
buyer_2,Carmen,,1984-09-05,ES90209507870172975664,TRX_N-00970-02337579,2024-06-05T10:20:19,Zarautz,expenses,water,-30.92,-69569.95
buyer_2,Carmen,,1984-09-05,ES90209507870172975664,TRX_N-00971-87352247,2024-06-06T19:10:59,Zarautz,expenses,electricity,-81.57,-69651.52
buyer_2,Carmen,,1984-09-05,ES90209507870172975664,TRX_N-00972-74018024,2024-06-06T09:44:36,Zarautz,expenses,gas,-110.49,-69762.01
buyer_2,Carmen,,1984-09-05,ES90209507870172975664,TRX_N-00973-06036417,2024-06-06T04:20:51,Zarautz,expenses,phone,-33.98,-69795.99
buyer_2,Carmen,,1984-09-05,ES90209507870172975664,TRX_N-00974-77842529,2024-06-06T12:03:35,Zarautz,expenses,education,-75.65,-69871.64
buyer_2,Carmen,,1984-09-05,ES90209507870172975664,TRX_N-00975-19119010,2024-06-08T16:40:44,Zarautz,expenses,internet,-42.0,-69913.64
buyer_2,Carmen,,1984-09-05,ES90209507870172975664,TRX_N-00976-40680387,2024-06-08T10:00:14,Zarautz,expenses,cash,-100.0,-70013.64
buyer_2,Carmen,,1984-09-05,ES90209507870172975664,TRX_N-00977-99386207,2024-06-08T09:32:06,Zarautz,expenses,appliances,-91.91,-70105.55
buyer_2,Carmen,,1984-09-05,ES90209507870172975664,TRX_N-00978-47232055,2024-06-09T15:32:31,Zarautz,expenses,leisure,-63.09,-70168.64
buyer_2,Carmen,,1984-09-05,ES90209507870172975664,TRX_N-00979-79142297,2024-06-09T09:09:36,Zarautz,expenses,clothing,-60.72,-70229.36
buyer_2,Carmen,,1984-09-05,ES90209507870172975664,TRX_N-00980-13628827,2024-06-11T14:11:34,Zarautz,expenses,clothing,-50.99,-70280.35
buyer_2,Carmen,,1984-09-05,ES90209507870172975664,TRX_N-00981-92173224,2024-06-12T16:19:35,Zarautz,expenses,cash,-100.0,-70380.35
buyer_2,Carmen,,1984-09-05,ES90209507870172975664,TRX_N-00982-62183487,2024-06-13T07:13:06,Zarautz,expenses,food,-68.44,-70448.79
buyer_2,Carmen,,1984-09-05,ES90209507870172975664,TRX_N-00983-75595441,2024-06-13T13:08:51,Zarautz,expenses,cash,-100.0,-70548.79
buyer_2,Carmen,,1984-09-05,ES90209507870172975664,TRX_N-00984-29831698,2024-06-14T16:39:56,Zarautz,expenses,transport,-86.99,-70635.78
buyer_2,Carmen,,1984-09-05,ES90209507870172975664,TRX_N-00985-22541087,2024-06-16T19:19:12,Zuia,expenses,transport,-49.71,-70685.49
buyer_2,Carmen,,1984-09-05,ES90209507870172975664,TRX_N-00986-35999364,2024-06-17T09:26:54,Zarautz,expenses,clothing,-46.37,-70731.86
buyer_2,Carmen,,1984-09-05,ES90209507870172975664,TRX_N-00987-91925255,2024-06-17T15:18:35,Zarautz,expenses,cash,-100.0,-70831.86
buyer_2,Carmen,,1984-09-05,ES90209507870172975664,TRX_N-00988-07924426,2024-06-18T19:53:44,Zarautz,expenses,clothing,-117.67,-70949.53
buyer_2,Carmen,,1984-09-05,ES90209507870172975664,TRX_N-00989-49239368,2024-06-18T11:12:04,Hernani,expenses,cash,-100.0,-71049.53
buyer_2,Carmen,,1984-09-05,ES90209507870172975664,TRX_N-00990-44166304,2024-06-18T13:02:07,Zarautz,expenses,repairs,-61.91,-71111.44
buyer_2,Carmen,,1984-09-05,ES90209507870172975664,TRX_N-00991-49968956,2024-06-20T06:26:56,Zarautz,expenses,clothing,-116.2,-71227.64
buyer_2,Carmen,,1984-09-05,ES90209507870172975664,TRX_N-00992-50212081,2024-06-20T18:54:27,Barakaldo,expenses,cash,-100.0,-71327.64
buyer_2,Carmen,,1984-09-05,ES90209507870172975664,TRX_N-00993-39918485,2024-06-21T12:01:35,Zarautz,expenses,education,-50.25,-71377.89
buyer_2,Carmen,,1984-09-05,ES90209507870172975664,TRX_N-00994-73368530,2024-06-21T17:55:56,Zarautz,expenses,children,-171.78,-71549.67
buyer_2,Carmen,,1984-09-05,ES90209507870172975664,TRX_N-00995-31243050,2024-06-22T13:18:48,Zarautz,expenses,gifts,-210.15,-71759.82
buyer_2,Carmen,,1984-09-05,ES90209507870172975664,TRX_N-00996-05640785,2024-06-23T18:22:58,Zarautz,expenses,cash,-100.0,-71859.82
buyer_2,Carmen,,1984-09-05,ES90209507870172975664,TRX_N-00997-77905628,2024-06-24T12:04:59,Zarautz,expenses,cash,-100.0,-71959.82
buyer_2,Carmen,,1984-09-05,ES90209507870172975664,TRX_N-00998-47760000,2024-06-24T15:13:30,Zarautz,expenses,gifts,-420.52,-72380.34
buyer_2,Carmen,,1984-09-05,ES90209507870172975664,TRX_N-00999-13904712,2024-06-26T18:33:51,Zarautz,expenses,transport,-81.32,-72461.66
buyer_2,Carmen,,1984-09-05,ES90209507870172975664,TRX_N-01000-56611085,2024-06-26T19:11:56,Zarautz,expenses,leisure,-20.04,-72481.7
buyer_2,Carmen,,1984-09-05,ES90209507870172975664,TRX_N-01001-56469726,2024-06-27T14:57:47,Zarautz,expenses,repairs,-182.83,-72664.53
buyer_2,Carmen,,1984-09-05,ES90209507870172975664,TRX_N-01002-62559207,2024-06-28T09:42:11,Zarautz,expenses,gifts,-449.55,-73114.08
buyer_2,Carmen,,1984-09-05,ES90209507870172975664,TRX_N-01003-42947781,2024-06-30T11:12:48,Zarautz,expenses,cash,-100.0,-73214.08
buyer_2,Carmen,,1984-09-05,ES90209507870172975664,TRX_N-01004-90225661,2024-07-01T21:31:41,Zarautz,incomes,salary,2094.47,-71119.61
buyer_2,Carmen,,1984-09-05,ES90209507870172975664,TRX_N-01005-66658522,2024-07-02T10:29:05,Zarautz,expenses,cash,-100.0,-71219.61
buyer_2,Carmen,,1984-09-05,ES90209507870172975664,TRX_N-01006-85978558,2024-07-02T15:47:56,Zarautz,expenses,gifts,-355.6,-71575.21
buyer_2,Carmen,,1984-09-05,ES90209507870172975664,TRX_N-01007-05382130,2024-07-04T10:22:05,Zarautz,expenses,mortgage,-703.19,-72278.4
buyer_2,Carmen,,1984-09-05,ES90209507870172975664,TRX_N-01008-87744550,2024-07-05T09:25:23,Zarautz,expenses,internet,-42.0,-72320.4
buyer_2,Carmen,,1984-09-05,ES90209507870172975664,TRX_N-01009-76674305,2024-07-05T13:38:31,Zarautz,expenses,education,-70.76,-72391.16
buyer_2,Carmen,,1984-09-05,ES90209507870172975664,TRX_N-01010-42330943,2024-07-05T15:52:51,Barakaldo,expenses,appliances,-354.72,-72745.88
buyer_2,Carmen,,1984-09-05,ES90209507870172975664,TRX_N-01011-49078986,2024-07-06T18:24:31,Zarautz,expenses,electricity,-26.94,-72772.82
buyer_2,Carmen,,1984-09-05,ES90209507870172975664,TRX_N-01012-17667385,2024-07-06T13:53:41,Zarautz,expenses,gas,-46.19,-72819.01
buyer_2,Carmen,,1984-09-05,ES90209507870172975664,TRX_N-01013-35516153,2024-07-08T15:26:08,Zarautz,expenses,water,-29.21,-72848.22
buyer_2,Carmen,,1984-09-05,ES90209507870172975664,TRX_N-01014-94833197,2024-07-08T18:43:58,Zarautz,expenses,phone,-41.07,-72889.29
buyer_2,Carmen,,1984-09-05,ES90209507870172975664,TRX_N-01015-14589700,2024-07-08T09:32:51,Llodio,expenses,transport,-60.5,-72949.79
buyer_2,Carmen,,1984-09-05,ES90209507870172975664,TRX_N-01016-69562266,2024-07-09T09:57:28,Oy√≥n-Oion,expenses,appliances,-357.09,-73306.88
buyer_2,Carmen,,1984-09-05,ES90209507870172975664,TRX_N-01017-69405634,2024-07-10T20:08:09,Zarautz,expenses,leisure,-49.3,-73356.18
buyer_2,Carmen,,1984-09-05,ES90209507870172975664,TRX_N-01018-77183632,2024-07-10T13:02:58,Zarautz,expenses,gifts,-134.27,-73490.45
buyer_2,Carmen,,1984-09-05,ES90209507870172975664,TRX_N-01019-42221314,2024-07-11T18:43:13,Zarautz,expenses,transport,-78.52,-73568.97
buyer_2,Carmen,,1984-09-05,ES90209507870172975664,TRX_N-01020-31742454,2024-07-11T18:25:37,Zarautz,expenses,leisure,-79.44,-73648.41
buyer_2,Carmen,,1984-09-05,ES90209507870172975664,TRX_N-01021-51405907,2024-07-12T14:43:01,Bermeo,expenses,food,-87.4,-73735.81
buyer_2,Carmen,,1984-09-05,ES90209507870172975664,TRX_N-01022-65774700,2024-07-12T13:03:14,Zarautz,expenses,transport,-55.26,-73791.07
buyer_2,Carmen,,1984-09-05,ES90209507870172975664,TRX_N-01023-90689350,2024-07-13T12:35:49,Zarautz,expenses,food,-65.6,-73856.67
buyer_2,Carmen,,1984-09-05,ES90209507870172975664,TRX_N-01024-39316720,2024-07-13T10:39:36,Zarautz,expenses,healthcare,-127.57,-73984.24
buyer_2,Carmen,,1984-09-05,ES90209507870172975664,TRX_N-01025-25621765,2024-07-17T16:48:00,Arrasate,expenses,transport,-65.3,-74049.54
buyer_2,Carmen,,1984-09-05,ES90209507870172975664,TRX_N-01026-51525177,2024-07-18T08:00:25,Zarautz,expenses,food,-115.98,-74165.52
buyer_2,Carmen,,1984-09-05,ES90209507870172975664,TRX_N-01027-59248389,2024-07-18T10:40:59,Leioa,expenses,leisure,-49.43,-74214.95
buyer_2,Carmen,,1984-09-05,ES90209507870172975664,TRX_N-01028-34499677,2024-07-18T18:51:48,Galdakao,expenses,appliances,-348.46,-74563.41
buyer_2,Carmen,,1984-09-05,ES90209507870172975664,TRX_N-01029-16411926,2024-07-20T23:42:18,Basauri,expenses,travel,-1648.86,-76212.27
buyer_2,Carmen,,1984-09-05,ES90209507870172975664,TRX_N-01030-70413707,2024-07-23T20:10:12,Berango,expenses,food,-86.33,-76298.6
buyer_2,Carmen,,1984-09-05,ES90209507870172975664,TRX_N-01031-68148090,2024-07-26T05:37:35,Zuia,expenses,leisure,-48.32,-76346.92
buyer_2,Carmen,,1984-09-05,ES90209507870172975664,TRX_N-01032-69800035,2024-07-27T18:50:18,Zarautz,expenses,leisure,-58.88,-76405.8
buyer_2,Carmen,,1984-09-05,ES90209507870172975664,TRX_N-01033-84614076,2024-07-28T10:21:51,Zarautz,expenses,transport,-86.64,-76492.44
buyer_2,Carmen,,1984-09-05,ES90209507870172975664,TRX_N-01034-59280752,2024-07-28T09:14:29,Bermeo,expenses,cash,-100.0,-76592.44
buyer_2,Carmen,,1984-09-05,ES90209507870172975664,TRX_N-01035-06278652,2024-07-28T16:21:55,Zarautz,expenses,children,-462.41,-77054.85
buyer_2,Carmen,,1984-09-05,ES90209507870172975664,TRX_N-01036-35492379,2024-07-29T18:53:32,Zarautz,expenses,cash,-100.0,-77154.85
buyer_2,Carmen,,1984-09-05,ES90209507870172975664,TRX_N-01037-00781628,2024-07-31T20:36:20,Zarautz,expenses,food,-98.41,-77253.26
buyer_2,Carmen,,1984-09-05,ES90209507870172975664,TRX_N-01038-56485245,2024-08-01T20:27:54,Zarautz,incomes,salary,2094.47,-75158.79
buyer_2,Carmen,,1984-09-05,ES90209507870172975664,TRX_N-01039-67816645,2024-08-01T09:11:16,Zarautz,expenses,transport,-52.83,-75211.62
buyer_2,Carmen,,1984-09-05,ES90209507870172975664,TRX_N-01040-71892834,2024-08-01T15:46:29,Zarautz,expenses,healthcare,-54.83,-75266.45
buyer_2,Carmen,,1984-09-05,ES90209507870172975664,TRX_N-01041-29221753,2024-08-02T17:25:57,Zarautz,expenses,cash,-100.0,-75366.45
buyer_2,Carmen,,1984-09-05,ES90209507870172975664,TRX_N-01042-23164743,2024-08-03T21:19:03,Zarautz,expenses,leisure,-20.38,-75386.83
buyer_2,Carmen,,1984-09-05,ES90209507870172975664,TRX_N-01043-34465578,2024-08-04T14:21:22,Zarautz,expenses,mortgage,-703.19,-76090.02
buyer_2,Carmen,,1984-09-05,ES90209507870172975664,TRX_N-01044-89969667,2024-08-05T15:34:28,Zarautz,expenses,phone,-35.56,-76125.58
buyer_2,Carmen,,1984-09-05,ES90209507870172975664,TRX_N-01045-62498555,2024-08-05T12:56:34,Zarautz,expenses,transport,-78.8,-76204.38
buyer_2,Carmen,,1984-09-05,ES90209507870172975664,TRX_N-01046-13814757,2024-08-05T10:17:40,Zarautz,expenses,gifts,-419.91,-76624.29
buyer_2,Carmen,,1984-09-05,ES90209507870172975664,TRX_N-01047-55057158,2024-08-06T17:11:08,Zarautz,expenses,gas,-36.13,-76660.42
buyer_2,Carmen,,1984-09-05,ES90209507870172975664,TRX_N-01048-77575735,2024-08-06T17:34:26,Zarautz,expenses,internet,-42.0,-76702.42
buyer_2,Carmen,,1984-09-05,ES90209507870172975664,TRX_N-01049-10653707,2024-08-07T14:27:30,Zarautz,expenses,water,-39.96,-76742.38
buyer_2,Carmen,,1984-09-05,ES90209507870172975664,TRX_N-01050-54903393,2024-08-07T18:16:10,Zarautz,expenses,leisure,-29.9,-76772.28
buyer_2,Carmen,,1984-09-05,ES90209507870172975664,TRX_N-01051-70087158,2024-08-07T18:54:09,Zarautz,expenses,cash,-100.0,-76872.28
buyer_2,Carmen,,1984-09-05,ES90209507870172975664,TRX_N-01052-54953904,2024-08-07T16:59:30,Zarautz,expenses,gifts,-602.07,-77474.35
buyer_2,Carmen,,1984-09-05,ES90209507870172975664,TRX_N-01053-29731281,2024-08-08T09:20:44,Zarautz,expenses,electricity,-37.97,-77512.32
buyer_2,Carmen,,1984-09-05,ES90209507870172975664,TRX_N-01054-77287990,2024-08-09T12:09:06,Zarautz,expenses,leisure,-56.24,-77568.56
buyer_2,Carmen,,1984-09-05,ES90209507870172975664,TRX_N-01055-84932534,2024-08-10T09:22:22,Eibar,expenses,healthcare,-82.59,-77651.15
buyer_2,Carmen,,1984-09-05,ES90209507870172975664,TRX_N-01056-75617730,2024-08-10T19:31:17,Santurtzi,expenses,cash,-100.0,-77751.15
buyer_2,Carmen,,1984-09-05,ES90209507870172975664,TRX_N-01057-45664554,2024-08-12T10:02:38,Irun,expenses,clothing,-83.33,-77834.48
buyer_2,Carmen,,1984-09-05,ES90209507870172975664,TRX_N-01058-56412726,2024-08-12T12:18:11,Galdakao,expenses,healthcare,-98.26,-77932.74
buyer_2,Carmen,,1984-09-05,ES90209507870172975664,TRX_N-01059-48242299,2024-08-15T14:09:54,Zarautz,expenses,repairs,-266.54,-78199.28
buyer_2,Carmen,,1984-09-05,ES90209507870172975664,TRX_N-01060-97281057,2024-08-16T12:10:51,Zarautz,expenses,cash,-100.0,-78299.28
buyer_2,Carmen,,1984-09-05,ES90209507870172975664,TRX_N-01061-13121890,2024-08-16T14:20:21,Zarautz,expenses,gifts,-699.07,-78998.35
buyer_2,Carmen,,1984-09-05,ES90209507870172975664,TRX_N-01062-10377281,2024-08-18T13:48:55,Zarautz,expenses,cash,-100.0,-79098.35
buyer_2,Carmen,,1984-09-05,ES90209507870172975664,TRX_N-01063-73214709,2024-08-19T17:06:50,Zarautz,expenses,transport,-48.95,-79147.3
buyer_2,Carmen,,1984-09-05,ES90209507870172975664,TRX_N-01064-87252071,2024-08-19T16:38:57,Zarautz,expenses,leisure,-74.31,-79221.61
buyer_2,Carmen,,1984-09-05,ES90209507870172975664,TRX_N-01065-91008937,2024-08-19T14:19:08,Zarautz,expenses,cash,-100.0,-79321.61
buyer_2,Carmen,,1984-09-05,ES90209507870172975664,TRX_N-01066-35597146,2024-08-20T09:38:25,Zarautz,expenses,children,-714.48,-80036.09
buyer_2,Carmen,,1984-09-05,ES90209507870172975664,TRX_N-01067-54549161,2024-08-21T14:57:35,Basauri,expenses,repairs,-292.35,-80328.44
buyer_2,Carmen,,1984-09-05,ES90209507870172975664,TRX_N-01068-42556860,2024-08-23T19:00:27,Zarautz,expenses,cash,-100.0,-80428.44
buyer_2,Carmen,,1984-09-05,ES90209507870172975664,TRX_N-01069-01151462,2024-08-24T14:34:34,Zarautz,expenses,clothing,-157.62,-80586.06
buyer_2,Carmen,,1984-09-05,ES90209507870172975664,TRX_N-01070-29290063,2024-08-27T21:21:25,Zarautz,expenses,food,-113.54,-80699.6
buyer_2,Carmen,,1984-09-05,ES90209507870172975664,TRX_N-01071-14398779,2024-08-27T08:12:20,Zarautz,expenses,education,-73.04,-80772.64
buyer_2,Carmen,,1984-09-05,ES90209507870172975664,TRX_N-01072-37108528,2024-08-28T17:09:32,Zarautz,expenses,leisure,-75.31,-80847.95
buyer_2,Carmen,,1984-09-05,ES90209507870172975664,TRX_N-01073-52229126,2024-08-29T09:12:35,Zarautz,expenses,food,-85.11,-80933.06
buyer_2,Carmen,,1984-09-05,ES90209507870172975664,TRX_N-01074-60535785,2024-08-31T15:42:10,Zarautz,expenses,gifts,-754.12,-81687.18
buyer_2,Carmen,,1984-09-05,ES90209507870172975664,TRX_N-01075-04841003,2024-09-01T16:20:21,Zarautz,incomes,salary,2094.47,-79592.71
buyer_2,Carmen,,1984-09-05,ES90209507870172975664,TRX_N-01076-77231051,2024-09-01T16:20:21,Zarautz,incomes,extra_income,364.42,-79228.29
buyer_2,Carmen,,1984-09-05,ES90209507870172975664,TRX_N-01077-74448166,2024-09-01T20:28:11,Labastida,expenses,leisure,-73.79,-79302.08
buyer_2,Carmen,,1984-09-05,ES90209507870172975664,TRX_N-01078-95205646,2024-09-02T11:45:57,Zarautz,expenses,food,-85.48,-79387.56
buyer_2,Carmen,,1984-09-05,ES90209507870172975664,TRX_N-01079-04715931,2024-09-02T12:17:39,Zarautz,expenses,education,-64.44,-79452.0
buyer_2,Carmen,,1984-09-05,ES90209507870172975664,TRX_N-01080-65563541,2024-09-03T13:42:39,Bilbao,expenses,gifts,-657.97,-80109.97
buyer_2,Carmen,,1984-09-05,ES90209507870172975664,TRX_N-01081-44713040,2024-09-04T12:36:40,Zarautz,expenses,mortgage,-703.19,-80813.16
buyer_2,Carmen,,1984-09-05,ES90209507870172975664,TRX_N-01082-13232560,2024-09-04T08:35:28,Zarautz,expenses,repairs,-299.59,-81112.75
buyer_2,Carmen,,1984-09-05,ES90209507870172975664,TRX_N-01083-76940911,2024-09-05T17:22:53,Zarautz,expenses,water,-39.05,-81151.8
buyer_2,Carmen,,1984-09-05,ES90209507870172975664,TRX_N-01084-07842140,2024-09-05T13:44:51,Zarautz,expenses,food,-96.91,-81248.71
buyer_2,Carmen,,1984-09-05,ES90209507870172975664,TRX_N-01085-81774469,2024-09-05T14:50:45,Lasarte-Oria,expenses,cash,-100.0,-81348.71
buyer_2,Carmen,,1984-09-05,ES90209507870172975664,TRX_N-01086-24612670,2024-09-05T16:12:01,Zarautz,expenses,gifts,-677.0,-82025.71
buyer_2,Carmen,,1984-09-05,ES90209507870172975664,TRX_N-01087-97683851,2024-09-06T08:46:38,Zarautz,expenses,gas,-81.8,-82107.51
buyer_2,Carmen,,1984-09-05,ES90209507870172975664,TRX_N-01088-99718079,2024-09-06T18:16:17,Zarautz,expenses,phone,-40.0,-82147.51
buyer_2,Carmen,,1984-09-05,ES90209507870172975664,TRX_N-01089-45380731,2024-09-06T12:31:47,Zarautz,expenses,leisure,-63.59,-82211.1
buyer_2,Carmen,,1984-09-05,ES90209507870172975664,TRX_N-01090-10694048,2024-09-07T20:37:52,Zarautz,expenses,electricity,-31.63,-82242.73
buyer_2,Carmen,,1984-09-05,ES90209507870172975664,TRX_N-01091-45686518,2024-09-07T12:32:08,Irun,expenses,gifts,-439.84,-82682.57
buyer_2,Carmen,,1984-09-05,ES90209507870172975664,TRX_N-01092-20800597,2024-09-08T13:51:55,Zarautz,expenses,internet,-42.0,-82724.57
buyer_2,Carmen,,1984-09-05,ES90209507870172975664,TRX_N-01093-85557299,2024-09-10T09:08:01,Zarautz,expenses,clothing,-112.2,-82836.77
buyer_2,Carmen,,1984-09-05,ES90209507870172975664,TRX_N-01094-30874543,2024-09-11T10:24:47,Zarautz,expenses,children,-535.05,-83371.82
buyer_2,Carmen,,1984-09-05,ES90209507870172975664,TRX_N-01095-74291370,2024-09-13T13:24:06,Zarautz,expenses,food,-120.39,-83492.21
buyer_2,Carmen,,1984-09-05,ES90209507870172975664,TRX_N-01096-28864629,2024-09-16T15:06:11,Zarautz,expenses,gifts,-277.88,-83770.09
buyer_2,Carmen,,1984-09-05,ES90209507870172975664,TRX_N-01097-98133936,2024-09-19T17:29:09,Iru√±a de Oca,expenses,food,-90.69,-83860.78
buyer_2,Carmen,,1984-09-05,ES90209507870172975664,TRX_N-01098-03828869,2024-09-19T12:55:56,Zarautz,expenses,repairs,-299.98,-84160.76
buyer_2,Carmen,,1984-09-05,ES90209507870172975664,TRX_N-01099-69775145,2024-09-20T13:11:41,Zarautz,expenses,cash,-100.0,-84260.76
buyer_2,Carmen,,1984-09-05,ES90209507870172975664,TRX_N-01100-35734556,2024-09-20T08:32:21,Zarautz,expenses,gifts,-795.13,-85055.89
buyer_2,Carmen,,1984-09-05,ES90209507870172975664,TRX_N-01101-69421681,2024-09-22T19:18:19,Zarautz,expenses,food,-97.48,-85153.37
buyer_2,Carmen,,1984-09-05,ES90209507870172975664,TRX_N-01102-84011458,2024-09-22T14:08:37,Zarautz,expenses,gifts,-624.03,-85777.4
buyer_2,Carmen,,1984-09-05,ES90209507870172975664,TRX_N-01103-53332851,2024-09-23T17:31:13,Zarautz,expenses,cash,-100.0,-85877.4
buyer_2,Carmen,,1984-09-05,ES90209507870172975664,TRX_N-01104-49562663,2024-09-26T20:21:06,Zarautz,expenses,food,-122.06,-85999.46
buyer_2,Carmen,,1984-09-05,ES90209507870172975664,TRX_N-01105-04504853,2024-09-26T01:42:23,Zarautz,expenses,cash,-100.0,-86099.46
buyer_2,Carmen,,1984-09-05,ES90209507870172975664,TRX_N-01106-01565854,2024-09-27T11:03:08,Portugalete,expenses,leisure,-51.38,-86150.84
buyer_2,Carmen,,1984-09-05,ES90209507870172975664,TRX_N-01107-61956196,2024-09-27T08:21:54,Zarautz,expenses,repairs,-278.34,-86429.18
buyer_2,Carmen,,1984-09-05,ES90209507870172975664,TRX_N-01108-39200266,2024-09-28T11:10:20,Zarautz,expenses,transport,-62.15,-86491.33
buyer_2,Carmen,,1984-09-05,ES90209507870172975664,TRX_N-01109-31372955,2024-09-30T23:09:17,Zarautz,expenses,appliances,-269.47,-86760.8
buyer_2,Carmen,,1984-09-05,ES90209507870172975664,TRX_N-01110-50955632,2024-10-01T13:45:42,Zarautz,incomes,salary,2094.47,-84666.33
buyer_2,Carmen,,1984-09-05,ES90209507870172975664,TRX_N-01111-21998137,2024-10-01T18:03:43,Zarautz,expenses,healthcare,-149.61,-84815.94
buyer_2,Carmen,,1984-09-05,ES90209507870172975664,TRX_N-01112-58852997,2024-10-02T08:45:56,Zarautz,expenses,cash,-100.0,-84915.94
buyer_2,Carmen,,1984-09-05,ES90209507870172975664,TRX_N-01113-82592753,2024-10-04T18:07:05,Zarautz,expenses,mortgage,-703.19,-85619.13
buyer_2,Carmen,,1984-09-05,ES90209507870172975664,TRX_N-01114-48667863,2024-10-05T10:38:24,Zarautz,expenses,electricity,-26.25,-85645.38
buyer_2,Carmen,,1984-09-05,ES90209507870172975664,TRX_N-01115-01006192,2024-10-06T21:18:46,Zarautz,expenses,internet,-42.0,-85687.38
buyer_2,Carmen,,1984-09-05,ES90209507870172975664,TRX_N-01116-58154727,2024-10-07T21:50:58,Zarautz,expenses,gas,-76.66,-85764.04
buyer_2,Carmen,,1984-09-05,ES90209507870172975664,TRX_N-01117-10375779,2024-10-07T18:28:11,Zarautz,expenses,phone,-44.14,-85808.18
buyer_2,Carmen,,1984-09-05,ES90209507870172975664,TRX_N-01118-82511345,2024-10-08T11:16:15,Zarautz,expenses,water,-38.58,-85846.76
buyer_2,Carmen,,1984-09-05,ES90209507870172975664,TRX_N-01119-29810642,2024-10-09T05:23:08,Zarautz,expenses,repairs,-107.73,-85954.49
buyer_3,Ana,,1989-08-23,ES60209500003562397206,TRX_N-00001-76850700,2022-01-01T16:55:33,Amurrio,incomes,salary,3536.84,10231.63
buyer_3,Ana,,1989-08-23,ES60209500003562397206,TRX_N-00002-27598377,2022-01-01T16:55:33,Amurrio,incomes,salary_partner,3830.29,14061.92
buyer_3,Ana,,1989-08-23,ES60209500003562397206,TRX_N-00003-00220750,2022-01-03T19:50:17,Vitoria-Gasteiz,expenses,food,-107.04,13954.88
buyer_3,Ana,,1989-08-23,ES60209500003562397206,TRX_N-00004-85257082,2022-01-03T18:37:13,Amurrio,expenses,transport,-70.98,13883.9
buyer_3,Ana,,1989-08-23,ES60209500003562397206,TRX_N-00005-79026920,2022-01-04T10:03:32,Amurrio,expenses,mortgage,-1069.75,12814.15
buyer_3,Ana,,1989-08-23,ES60209500003562397206,TRX_N-00006-85299916,2022-01-05T15:32:41,Amurrio,expenses,leisure,-81.95,12732.2
buyer_3,Ana,,1989-08-23,ES60209500003562397206,TRX_N-00007-17202156,2022-01-06T16:01:27,Amurrio,expenses,gas,-34.13,12698.07
buyer_3,Ana,,1989-08-23,ES60209500003562397206,TRX_N-00008-23377569,2022-01-06T20:55:32,Amurrio,expenses,phone,-32.03,12666.04
buyer_3,Ana,,1989-08-23,ES60209500003562397206,TRX_N-00009-21526188,2022-01-07T09:09:47,Amurrio,expenses,water,-41.04,12625.0
buyer_3,Ana,,1989-08-23,ES60209500003562397206,TRX_N-00010-64807953,2022-01-08T14:49:38,Amurrio,expenses,electricity,-88.87,12536.13
buyer_3,Ana,,1989-08-23,ES60209500003562397206,TRX_N-00011-21769663,2022-01-08T06:05:34,Amurrio,expenses,internet,-42.0,12494.13
buyer_3,Ana,,1989-08-23,ES60209500003562397206,TRX_N-00012-98454825,2022-01-10T17:50:56,Portugalete,expenses,food,-68.2,12425.93
buyer_3,Ana,,1989-08-23,ES60209500003562397206,TRX_N-00013-07905952,2022-01-14T10:12:47,Amurrio,expenses,education,-54.44,12371.49
buyer_3,Ana,,1989-08-23,ES60209500003562397206,TRX_N-00014-70557225,2022-01-18T13:04:35,Amurrio,expenses,clothing,-119.92,12251.57
buyer_3,Ana,,1989-08-23,ES60209500003562397206,TRX_N-00015-29415222,2022-01-20T13:27:45,Amurrio,expenses,gifts,-560.08,11691.49
buyer_3,Ana,,1989-08-23,ES60209500003562397206,TRX_N-00016-37160518,2022-01-22T20:06:53,Amurrio,expenses,leisure,-72.24,11619.25
buyer_3,Ana,,1989-08-23,ES60209500003562397206,TRX_N-00017-72904992,2022-01-25T09:48:26,Amurrio,expenses,food,-102.92,11516.33
buyer_3,Ana,,1989-08-23,ES60209500003562397206,TRX_N-00018-94060231,2022-01-25T16:01:37,Amurrio,expenses,cash,-100.0,11416.33
buyer_3,Ana,,1989-08-23,ES60209500003562397206,TRX_N-00019-24124096,2022-01-25T16:09:20,Amurrio,expenses,repairs,-150.89,11265.44
buyer_3,Ana,,1989-08-23,ES60209500003562397206,TRX_N-00020-23791750,2022-01-26T16:41:43,Amurrio,expenses,repairs,-313.38,10952.06
buyer_3,Ana,,1989-08-23,ES60209500003562397206,TRX_N-00021-26047598,2022-01-27T14:48:52,Amurrio,expenses,food,-77.52,10874.54
buyer_3,Ana,,1989-08-23,ES60209500003562397206,TRX_N-00022-89756175,2022-01-27T10:37:21,Amurrio,expenses,leisure,-71.45,10803.09
buyer_3,Ana,,1989-08-23,ES60209500003562397206,TRX_N-00023-76506543,2022-01-30T14:10:55,Amurrio,expenses,cash,-100.0,10703.09
buyer_3,Ana,,1989-08-23,ES60209500003562397206,TRX_N-00024-82550456,2022-02-01T09:33:49,Amurrio,incomes,salary,3536.84,14239.93
buyer_3,Ana,,1989-08-23,ES60209500003562397206,TRX_N-00025-26675866,2022-02-01T09:33:49,Amurrio,incomes,salary_partner,3830.29,18070.22
buyer_3,Ana,,1989-08-23,ES60209500003562397206,TRX_N-00026-54463196,2022-02-01T07:15:23,Amurrio,expenses,food,-97.16,17973.06
buyer_3,Ana,,1989-08-23,ES60209500003562397206,TRX_N-00027-35558400,2022-02-04T20:11:50,Amurrio,expenses,mortgage,-1069.75,16903.31
buyer_3,Ana,,1989-08-23,ES60209500003562397206,TRX_N-00028-32724767,2022-02-04T11:39:03,Iru√±a de Oca,expenses,food,-121.22,16782.09
buyer_3,Ana,,1989-08-23,ES60209500003562397206,TRX_N-00029-62944834,2022-02-04T20:43:09,Amurrio,expenses,cash,-100.0,16682.09
buyer_3,Ana,,1989-08-23,ES60209500003562397206,TRX_N-00030-26050000,2022-02-05T19:04:14,Amurrio,expenses,food,-99.52,16582.57
buyer_3,Ana,,1989-08-23,ES60209500003562397206,TRX_N-00031-43018794,2022-02-05T12:17:19,Amurrio,expenses,cash,-100.0,16482.57
buyer_3,Ana,,1989-08-23,ES60209500003562397206,TRX_N-00032-81413698,2022-02-06T14:41:31,Amurrio,expenses,water,-38.14,16444.43
buyer_3,Ana,,1989-08-23,ES60209500003562397206,TRX_N-00033-39227083,2022-02-06T03:17:55,Amurrio,expenses,electricity,-86.01,16358.42
buyer_3,Ana,,1989-08-23,ES60209500003562397206,TRX_N-00034-00780858,2022-02-06T08:51:37,Amurrio,expenses,gifts,-400.55,15957.87
buyer_3,Ana,,1989-08-23,ES60209500003562397206,TRX_N-00035-22873861,2022-02-07T19:36:33,Amurrio,expenses,internet,-42.0,15915.87
buyer_3,Ana,,1989-08-23,ES60209500003562397206,TRX_N-00036-14188962,2022-02-07T01:41:30,Amurrio,expenses,transport,-56.51,15859.36
buyer_3,Ana,,1989-08-23,ES60209500003562397206,TRX_N-00037-23205313,2022-02-07T19:27:17,Amurrio,expenses,leisure,-32.64,15826.72
buyer_3,Ana,,1989-08-23,ES60209500003562397206,TRX_N-00038-44233898,2022-02-07T14:35:41,Getxo,expenses,cash,-100.0,15726.72
buyer_3,Ana,,1989-08-23,ES60209500003562397206,TRX_N-00039-45110333,2022-02-08T10:09:07,Amurrio,expenses,gas,-83.36,15643.36
buyer_3,Ana,,1989-08-23,ES60209500003562397206,TRX_N-00040-39343458,2022-02-08T21:44:22,Amurrio,expenses,phone,-36.59,15606.77
buyer_3,Ana,,1989-08-23,ES60209500003562397206,TRX_N-00041-24050884,2022-02-08T15:34:25,Amurrio,expenses,food,-102.06,15504.71
buyer_3,Ana,,1989-08-23,ES60209500003562397206,TRX_N-00042-81423744,2022-02-08T20:02:06,Amurrio,expenses,clothing,-63.92,15440.79
buyer_3,Ana,,1989-08-23,ES60209500003562397206,TRX_N-00043-79626800,2022-02-08T22:18:49,Amurrio,expenses,healthcare,-137.73,15303.06
buyer_3,Ana,,1989-08-23,ES60209500003562397206,TRX_N-00044-41806000,2022-02-10T17:05:03,Amurrio,expenses,cash,-100.0,15203.06
buyer_3,Ana,,1989-08-23,ES60209500003562397206,TRX_N-00045-93479136,2022-02-11T16:39:00,Amurrio,expenses,clothing,-55.45,15147.61
buyer_3,Ana,,1989-08-23,ES60209500003562397206,TRX_N-00046-14035862,2022-02-13T10:22:40,Amurrio,expenses,leisure,-24.2,15123.41
buyer_3,Ana,,1989-08-23,ES60209500003562397206,TRX_N-00047-56183478,2022-02-13T07:44:39,Amurrio,expenses,appliances,-229.14,14894.27
buyer_3,Ana,,1989-08-23,ES60209500003562397206,TRX_N-00048-27720336,2022-02-16T16:52:02,Amurrio,expenses,healthcare,-115.31,14778.96
buyer_3,Ana,,1989-08-23,ES60209500003562397206,TRX_N-00049-81968138,2022-02-16T09:46:40,Amurrio,expenses,cash,-100.0,14678.96
buyer_3,Ana,,1989-08-23,ES60209500003562397206,TRX_N-00050-67283680,2022-02-18T17:00:16,Amurrio,expenses,food,-63.13,14615.83
buyer_3,Ana,,1989-08-23,ES60209500003562397206,TRX_N-00051-27865531,2022-02-18T14:25:24,Irun,expenses,cash,-100.0,14515.83
buyer_3,Ana,,1989-08-23,ES60209500003562397206,TRX_N-00052-90980844,2022-02-18T06:52:46,Amurrio,expenses,repairs,-183.63,14332.2
buyer_3,Ana,,1989-08-23,ES60209500003562397206,TRX_N-00053-63225658,2022-02-20T17:57:20,Amurrio,expenses,leisure,-66.95,14265.25
buyer_3,Ana,,1989-08-23,ES60209500003562397206,TRX_N-00054-31495130,2022-02-21T15:40:32,Amurrio,expenses,repairs,-222.82,14042.43
buyer_3,Ana,,1989-08-23,ES60209500003562397206,TRX_N-00055-82757881,2022-02-26T16:17:12,Amurrio,expenses,food,-71.28,13971.15
buyer_3,Ana,,1989-08-23,ES60209500003562397206,TRX_N-00056-52078658,2022-02-27T11:08:24,Arrasate,expenses,food,-124.01,13847.14
buyer_3,Ana,,1989-08-23,ES60209500003562397206,TRX_N-00057-11469696,2022-03-01T13:05:05,Amurrio,incomes,salary,3536.84,17383.98
buyer_3,Ana,,1989-08-23,ES60209500003562397206,TRX_N-00058-01141637,2022-03-01T13:05:05,Amurrio,incomes,salary_partner,3830.29,21214.27
buyer_3,Ana,,1989-08-23,ES60209500003562397206,TRX_N-00059-87693330,2022-03-01T13:05:05,Amurrio,incomes,extra_income,437.39,21651.66
buyer_3,Ana,,1989-08-23,ES60209500003562397206,TRX_N-00060-70287816,2022-03-02T10:33:18,Hernani,expenses,leisure,-58.23,21593.43
buyer_3,Ana,,1989-08-23,ES60209500003562397206,TRX_N-00061-36251249,2022-03-02T23:48:38,Amurrio,expenses,cash,-100.0,21493.43
buyer_3,Ana,,1989-08-23,ES60209500003562397206,TRX_N-00062-36669850,2022-03-03T14:43:01,Amurrio,expenses,travel,-431.7,21061.73
buyer_3,Ana,,1989-08-23,ES60209500003562397206,TRX_N-00063-09174399,2022-03-04T09:00:54,Amurrio,expenses,mortgage,-1069.75,19991.98
buyer_3,Ana,,1989-08-23,ES60209500003562397206,TRX_N-00064-65028232,2022-03-05T17:57:41,Amurrio,expenses,electricity,-61.68,19930.3
buyer_3,Ana,,1989-08-23,ES60209500003562397206,TRX_N-00065-54812399,2022-03-05T08:16:56,Amurrio,expenses,gas,-47.88,19882.42
buyer_3,Ana,,1989-08-23,ES60209500003562397206,TRX_N-00066-82519478,2022-03-05T13:39:09,Amurrio,expenses,phone,-43.4,19839.02
buyer_3,Ana,,1989-08-23,ES60209500003562397206,TRX_N-00067-92071879,2022-03-05T13:53:39,Amurrio,expenses,cash,-100.0,19739.02
buyer_3,Ana,,1989-08-23,ES60209500003562397206,TRX_N-00068-79887651,2022-03-06T21:58:12,Amurrio,expenses,food,-65.01,19674.01
buyer_3,Ana,,1989-08-23,ES60209500003562397206,TRX_N-00069-37148029,2022-03-07T09:12:02,Amurrio,expenses,internet,-42.0,19632.01
buyer_3,Ana,,1989-08-23,ES60209500003562397206,TRX_N-00070-82754845,2022-03-08T16:35:10,Amurrio,expenses,water,-22.57,19609.44
buyer_3,Ana,,1989-08-23,ES60209500003562397206,TRX_N-00071-05805327,2022-03-09T17:10:16,Amurrio,expenses,food,-109.73,19499.71
buyer_3,Ana,,1989-08-23,ES60209500003562397206,TRX_N-00072-33170204,2022-03-09T11:41:10,Amurrio,expenses,cash,-100.0,19399.71
buyer_3,Ana,,1989-08-23,ES60209500003562397206,TRX_N-00073-85480397,2022-03-09T19:48:50,Salvatierra/Agurain,expenses,gifts,-229.4,19170.31
buyer_3,Ana,,1989-08-23,ES60209500003562397206,TRX_N-00074-18777760,2022-03-10T13:06:16,Amurrio,expenses,transport,-51.81,19118.5
buyer_3,Ana,,1989-08-23,ES60209500003562397206,TRX_N-00075-98809000,2022-03-11T12:32:54,Amurrio,expenses,education,-67.31,19051.19
buyer_3,Ana,,1989-08-23,ES60209500003562397206,TRX_N-00076-24798838,2022-03-12T14:10:02,Barakaldo,expenses,leisure,-65.39,18985.8
buyer_3,Ana,,1989-08-23,ES60209500003562397206,TRX_N-00077-46572533,2022-03-12T17:27:42,Amurrio,expenses,car,-218.58,18767.22
buyer_3,Ana,,1989-08-23,ES60209500003562397206,TRX_N-00078-42067537,2022-03-13T15:18:40,Amurrio,expenses,food,-68.34,18698.88
buyer_3,Ana,,1989-08-23,ES60209500003562397206,TRX_N-00079-42865226,2022-03-14T20:56:06,Amurrio,expenses,gifts,-504.71,18194.17
buyer_3,Ana,,1989-08-23,ES60209500003562397206,TRX_N-00080-48161072,2022-03-16T10:33:35,Amurrio,expenses,cash,-100.0,18094.17
buyer_3,Ana,,1989-08-23,ES60209500003562397206,TRX_N-00081-32260377,2022-03-17T15:23:59,Amurrio,expenses,transport,-82.21,18011.96
buyer_3,Ana,,1989-08-23,ES60209500003562397206,TRX_N-00082-42581326,2022-03-18T11:56:39,Amurrio,expenses,transport,-63.96,17948.0
buyer_3,Ana,,1989-08-23,ES60209500003562397206,TRX_N-00083-56324615,2022-03-19T23:12:37,Amurrio,expenses,cash,-100.0,17848.0
buyer_3,Ana,,1989-08-23,ES60209500003562397206,TRX_N-00084-28538390,2022-03-21T09:51:09,Hondarribia,expenses,food,-63.32,17784.68
buyer_3,Ana,,1989-08-23,ES60209500003562397206,TRX_N-00085-86861125,2022-03-23T13:20:21,Amurrio,expenses,cash,-100.0,17684.68
buyer_3,Ana,,1989-08-23,ES60209500003562397206,TRX_N-00086-20210431,2022-03-24T15:05:05,Amurrio,expenses,transport,-54.17,17630.51
buyer_3,Ana,,1989-08-23,ES60209500003562397206,TRX_N-00087-57825190,2022-03-25T14:24:10,Amurrio,expenses,leisure,-80.17,17550.34
buyer_3,Ana,,1989-08-23,ES60209500003562397206,TRX_N-00088-61228817,2022-03-25T11:41:40,Amurrio,expenses,cash,-100.0,17450.34
buyer_3,Ana,,1989-08-23,ES60209500003562397206,TRX_N-00089-00229314,2022-03-26T13:25:06,Amurrio,expenses,cash,-100.0,17350.34
buyer_3,Ana,,1989-08-23,ES60209500003562397206,TRX_N-00090-78437102,2022-03-28T13:24:59,Amurrio,expenses,leisure,-20.61,17329.73
buyer_3,Ana,,1989-08-23,ES60209500003562397206,TRX_N-00091-60955381,2022-03-28T14:24:58,Amurrio,expenses,clothing,-52.6,17277.13
buyer_3,Ana,,1989-08-23,ES60209500003562397206,TRX_N-00092-82478644,2022-03-29T19:36:38,Basauri,expenses,repairs,-160.03,17117.1
buyer_3,Ana,,1989-08-23,ES60209500003562397206,TRX_N-00093-85385896,2022-03-31T09:37:23,Amurrio,expenses,cash,-100.0,17017.1
buyer_3,Ana,,1989-08-23,ES60209500003562397206,TRX_N-00094-81607777,2022-03-31T12:10:13,Amurrio,expenses,repairs,-67.85,16949.25
buyer_3,Ana,,1989-08-23,ES60209500003562397206,TRX_N-00095-33359263,2022-04-01T20:39:47,Amurrio,incomes,salary,3536.84,20486.09
buyer_3,Ana,,1989-08-23,ES60209500003562397206,TRX_N-00096-26628275,2022-04-01T20:39:47,Amurrio,incomes,salary_partner,3830.29,24316.38
buyer_3,Ana,,1989-08-23,ES60209500003562397206,TRX_N-00097-17619840,2022-04-01T10:15:29,Amurrio,expenses,food,-66.37,24250.01
buyer_3,Ana,,1989-08-23,ES60209500003562397206,TRX_N-00098-49751777,2022-04-02T15:49:49,Amurrio,expenses,cash,-100.0,24150.01
buyer_3,Ana,,1989-08-23,ES60209500003562397206,TRX_N-00099-17892136,2022-04-04T12:11:02,Amurrio,expenses,mortgage,-1069.75,23080.26
buyer_3,Ana,,1989-08-23,ES60209500003562397206,TRX_N-00100-83101805,2022-04-04T18:13:47,Amurrio,expenses,leisure,-81.5,22998.76
buyer_3,Ana,,1989-08-23,ES60209500003562397206,TRX_N-00101-21637079,2022-04-04T09:39:44,Amurrio,expenses,gifts,-400.61,22598.15
buyer_3,Ana,,1989-08-23,ES60209500003562397206,TRX_N-00102-08602903,2022-04-05T11:41:16,Amurrio,expenses,water,-32.63,22565.52
buyer_3,Ana,,1989-08-23,ES60209500003562397206,TRX_N-00103-18244603,2022-04-05T13:54:12,Amurrio,expenses,phone,-38.25,22527.27
buyer_3,Ana,,1989-08-23,ES60209500003562397206,TRX_N-00104-41624719,2022-04-05T14:30:25,Salvatierra/Agurain,expenses,leisure,-62.46,22464.81
buyer_3,Ana,,1989-08-23,ES60209500003562397206,TRX_N-00105-82584493,2022-04-05T11:49:37,Amurrio,expenses,gifts,-317.11,22147.7
buyer_3,Ana,,1989-08-23,ES60209500003562397206,TRX_N-00106-06697732,2022-04-06T08:16:27,Amurrio,expenses,cash,-100.0,22047.7
buyer_3,Ana,,1989-08-23,ES60209500003562397206,TRX_N-00107-11466462,2022-04-07T08:58:36,Amurrio,expenses,gas,-98.81,21948.89
buyer_3,Ana,,1989-08-23,ES60209500003562397206,TRX_N-00108-84672945,2022-04-07T15:30:54,Amurrio,expenses,internet,-42.0,21906.89
buyer_3,Ana,,1989-08-23,ES60209500003562397206,TRX_N-00109-85565913,2022-04-07T09:24:03,Amurrio,expenses,repairs,-259.84,21647.05
buyer_3,Ana,,1989-08-23,ES60209500003562397206,TRX_N-00110-33397367,2022-04-08T19:43:03,Amurrio,expenses,electricity,-34.2,21612.85
buyer_3,Ana,,1989-08-23,ES60209500003562397206,TRX_N-00111-53977337,2022-04-10T12:22:16,Amurrio,expenses,education,-74.54,21538.31
buyer_3,Ana,,1989-08-23,ES60209500003562397206,TRX_N-00112-24771443,2022-04-11T20:36:14,Amurrio,expenses,clothing,-149.18,21389.13
buyer_3,Ana,,1989-08-23,ES60209500003562397206,TRX_N-00113-45419775,2022-04-12T23:13:27,Amurrio,expenses,leisure,-54.45,21334.68
buyer_3,Ana,,1989-08-23,ES60209500003562397206,TRX_N-00114-82461073,2022-04-14T09:44:41,Amurrio,expenses,healthcare,-38.15,21296.53
buyer_3,Ana,,1989-08-23,ES60209500003562397206,TRX_N-00115-47779159,2022-04-16T06:55:15,Amurrio,expenses,leisure,-73.73,21222.8
buyer_3,Ana,,1989-08-23,ES60209500003562397206,TRX_N-00116-84300103,2022-04-16T21:04:55,Amurrio,expenses,education,-70.86,21151.94
buyer_3,Ana,,1989-08-23,ES60209500003562397206,TRX_N-00117-74071440,2022-04-18T08:38:47,Amurrio,expenses,food,-93.94,21058.0
buyer_3,Ana,,1989-08-23,ES60209500003562397206,TRX_N-00118-27714324,2022-04-19T16:37:08,Amurrio,expenses,education,-62.66,20995.34
buyer_3,Ana,,1989-08-23,ES60209500003562397206,TRX_N-00119-91277148,2022-04-19T16:59:24,Amurrio,expenses,cash,-100.0,20895.34
buyer_3,Ana,,1989-08-23,ES60209500003562397206,TRX_N-00120-63503153,2022-04-22T19:34:38,Amurrio,expenses,leisure,-68.38,20826.96
buyer_3,Ana,,1989-08-23,ES60209500003562397206,TRX_N-00121-55959920,2022-04-24T15:39:37,Amurrio,expenses,leisure,-50.95,20776.01
buyer_3,Ana,,1989-08-23,ES60209500003562397206,TRX_N-00122-06657769,2022-04-24T09:58:41,Irun,expenses,cash,-100.0,20676.01
buyer_3,Ana,,1989-08-23,ES60209500003562397206,TRX_N-00123-45659800,2022-04-25T14:48:19,Amurrio,expenses,food,-103.78,20572.23
buyer_3,Ana,,1989-08-23,ES60209500003562397206,TRX_N-00124-74261553,2022-04-26T16:45:30,Amurrio,expenses,clothing,-119.25,20452.98
buyer_3,Ana,,1989-08-23,ES60209500003562397206,TRX_N-00125-35769642,2022-04-27T15:04:05,Amurrio,expenses,healthcare,-123.45,20329.53
buyer_3,Ana,,1989-08-23,ES60209500003562397206,TRX_N-00126-73408337,2022-04-27T12:02:54,Amurrio,expenses,appliances,-127.64,20201.89
buyer_3,Ana,,1989-08-23,ES60209500003562397206,TRX_N-00127-52603605,2022-04-28T06:48:46,Iru√±a de Oca,expenses,gifts,-731.8,19470.09
buyer_3,Ana,,1989-08-23,ES60209500003562397206,TRX_N-00128-68101075,2022-04-29T16:45:12,Amurrio,expenses,food,-108.09,19362.0
buyer_3,Ana,,1989-08-23,ES60209500003562397206,TRX_N-00129-00685594,2022-04-30T23:49:52,Amurrio,expenses,repairs,-83.07,19278.93
buyer_3,Ana,,1989-08-23,ES60209500003562397206,TRX_N-00130-81641848,2022-05-01T08:50:25,Amurrio,incomes,salary,3536.84,22815.77
buyer_3,Ana,,1989-08-23,ES60209500003562397206,TRX_N-00131-55385181,2022-05-01T08:50:25,Amurrio,incomes,salary_partner,3830.29,26646.06
buyer_3,Ana,,1989-08-23,ES60209500003562397206,TRX_N-00132-35921553,2022-05-01T19:41:21,Amurrio,expenses,food,-92.04,26554.02
buyer_3,Ana,,1989-08-23,ES60209500003562397206,TRX_N-00133-83441921,2022-05-03T18:39:52,Amurrio,expenses,food,-88.53,26465.49
buyer_3,Ana,,1989-08-23,ES60209500003562397206,TRX_N-00134-03364896,2022-05-03T08:45:31,Amurrio,expenses,leisure,-77.44,26388.05
buyer_3,Ana,,1989-08-23,ES60209500003562397206,TRX_N-00135-74724591,2022-05-04T08:00:14,Amurrio,expenses,mortgage,-1069.75,25318.3
buyer_3,Ana,,1989-08-23,ES60209500003562397206,TRX_N-00136-71140618,2022-05-04T20:27:01,Amurrio,expenses,clothing,-110.46,25207.84
buyer_3,Ana,,1989-08-23,ES60209500003562397206,TRX_N-00137-42583384,2022-05-04T06:20:35,Amurrio,expenses,cash,-100.0,25107.84
buyer_3,Ana,,1989-08-23,ES60209500003562397206,TRX_N-00138-56579674,2022-05-05T23:18:17,Amurrio,expenses,water,-21.41,25086.43
buyer_3,Ana,,1989-08-23,ES60209500003562397206,TRX_N-00139-69958534,2022-05-05T14:46:10,Amurrio,expenses,food,-124.26,24962.17
buyer_3,Ana,,1989-08-23,ES60209500003562397206,TRX_N-00140-70570088,2022-05-06T11:22:43,Amurrio,expenses,electricity,-70.61,24891.56
buyer_3,Ana,,1989-08-23,ES60209500003562397206,TRX_N-00141-19406266,2022-05-06T03:05:26,Amurrio,expenses,gas,-67.64,24823.92
buyer_3,Ana,,1989-08-23,ES60209500003562397206,TRX_N-00142-70526081,2022-05-06T18:57:30,Amurrio,expenses,food,-78.97,24744.95
buyer_3,Ana,,1989-08-23,ES60209500003562397206,TRX_N-00143-25036040,2022-05-08T10:00:46,Amurrio,expenses,internet,-42.0,24702.95
buyer_3,Ana,,1989-08-23,ES60209500003562397206,TRX_N-00144-75940720,2022-05-08T15:18:10,Amurrio,expenses,phone,-39.31,24663.64
buyer_3,Ana,,1989-08-23,ES60209500003562397206,TRX_N-00145-86664708,2022-05-08T05:18:10,Amurrio,expenses,transport,-48.22,24615.42
buyer_3,Ana,,1989-08-23,ES60209500003562397206,TRX_N-00146-04637945,2022-05-09T10:57:11,Amurrio,expenses,repairs,-146.53,24468.89
buyer_3,Ana,,1989-08-23,ES60209500003562397206,TRX_N-00147-69909780,2022-05-10T08:53:28,Amurrio,expenses,cash,-100.0,24368.89
buyer_3,Ana,,1989-08-23,ES60209500003562397206,TRX_N-00148-37429003,2022-05-10T08:57:25,Errenteria,expenses,gifts,-238.09,24130.8
buyer_3,Ana,,1989-08-23,ES60209500003562397206,TRX_N-00149-65754692,2022-05-11T17:02:32,Erandio,expenses,cash,-100.0,24030.8
buyer_3,Ana,,1989-08-23,ES60209500003562397206,TRX_N-00150-46633159,2022-05-11T13:50:23,Amurrio,expenses,appliances,-416.39,23614.41
buyer_3,Ana,,1989-08-23,ES60209500003562397206,TRX_N-00151-75595803,2022-05-12T10:45:55,Amurrio,expenses,clothing,-138.52,23475.89
buyer_3,Ana,,1989-08-23,ES60209500003562397206,TRX_N-00152-35437140,2022-05-12T05:23:51,Arrasate,expenses,cash,-100.0,23375.89
buyer_3,Ana,,1989-08-23,ES60209500003562397206,TRX_N-00153-26182540,2022-05-12T14:26:00,Hondarribia,expenses,gifts,-404.1,22971.79
buyer_3,Ana,,1989-08-23,ES60209500003562397206,TRX_N-00154-75989230,2022-05-17T16:31:00,Amurrio,expenses,leisure,-78.84,22892.95
buyer_3,Ana,,1989-08-23,ES60209500003562397206,TRX_N-00155-99543883,2022-05-17T00:42:54,Amurrio,expenses,education,-50.21,22842.74
buyer_3,Ana,,1989-08-23,ES60209500003562397206,TRX_N-00156-36699137,2022-05-17T15:15:20,Amurrio,expenses,cash,-100.0,22742.74
buyer_3,Ana,,1989-08-23,ES60209500003562397206,TRX_N-00157-05883553,2022-05-18T21:19:04,Amurrio,expenses,leisure,-18.54,22724.2
buyer_3,Ana,,1989-08-23,ES60209500003562397206,TRX_N-00158-30610819,2022-05-18T17:31:58,Amurrio,expenses,cash,-100.0,22624.2
buyer_3,Ana,,1989-08-23,ES60209500003562397206,TRX_N-00159-71159152,2022-05-19T11:09:44,Amurrio,expenses,leisure,-68.01,22556.19
buyer_3,Ana,,1989-08-23,ES60209500003562397206,TRX_N-00160-20674693,2022-05-19T09:36:17,Andoain,expenses,gifts,-247.24,22308.95
buyer_3,Ana,,1989-08-23,ES60209500003562397206,TRX_N-00161-52931170,2022-05-20T20:00:36,Amurrio,expenses,repairs,-185.4,22123.55
buyer_3,Ana,,1989-08-23,ES60209500003562397206,TRX_N-00162-96920454,2022-05-21T12:31:02,Amurrio,expenses,food,-121.27,22002.28
buyer_3,Ana,,1989-08-23,ES60209500003562397206,TRX_N-00163-89587546,2022-05-21T17:37:23,Amurrio,expenses,cash,-100.0,21902.28
buyer_3,Ana,,1989-08-23,ES60209500003562397206,TRX_N-00164-08288878,2022-05-23T18:05:42,Amurrio,expenses,gifts,-278.58,21623.7
buyer_3,Ana,,1989-08-23,ES60209500003562397206,TRX_N-00165-25339216,2022-05-24T18:53:17,Amurrio,expenses,leisure,-59.4,21564.3
buyer_3,Ana,,1989-08-23,ES60209500003562397206,TRX_N-00166-82002296,2022-05-26T18:45:31,Amurrio,expenses,repairs,-330.93,21233.37
buyer_3,Ana,,1989-08-23,ES60209500003562397206,TRX_N-00167-88792101,2022-05-27T14:55:27,Amurrio,expenses,clothing,-122.83,21110.54
buyer_3,Ana,,1989-08-23,ES60209500003562397206,TRX_N-00168-85564971,2022-05-28T16:51:21,Lasarte-Oria,expenses,gifts,-764.6,20345.94
buyer_3,Ana,,1989-08-23,ES60209500003562397206,TRX_N-00169-05415995,2022-05-29T21:25:57,Amurrio,expenses,leisure,-40.31,20305.63
buyer_3,Ana,,1989-08-23,ES60209500003562397206,TRX_N-00170-38880263,2022-05-30T16:04:19,Amurrio,expenses,gifts,-742.97,19562.66
buyer_3,Ana,,1989-08-23,ES60209500003562397206,TRX_N-00171-67379372,2022-06-01T08:31:16,Amurrio,incomes,salary,3536.84,23099.5
buyer_3,Ana,,1989-08-23,ES60209500003562397206,TRX_N-00172-30312770,2022-06-01T08:31:16,Amurrio,incomes,salary_partner,3830.29,26929.79
buyer_3,Ana,,1989-08-23,ES60209500003562397206,TRX_N-00173-65837401,2022-06-01T08:31:16,Amurrio,incomes,salary_bonus,2595.73,29525.52
buyer_3,Ana,,1989-08-23,ES60209500003562397206,TRX_N-00174-55112220,2022-06-01T08:31:16,Amurrio,incomes,salary_partner_bonus,2990.73,32516.25
buyer_3,Ana,,1989-08-23,ES60209500003562397206,TRX_N-00175-83410585,2022-06-03T16:19:03,Amurrio,expenses,repairs,-174.67,32341.58
buyer_3,Ana,,1989-08-23,ES60209500003562397206,TRX_N-00176-83611256,2022-06-04T19:59:23,Amurrio,expenses,mortgage,-1069.75,31271.83
buyer_3,Ana,,1989-08-23,ES60209500003562397206,TRX_N-00177-47233954,2022-06-05T09:10:21,Amurrio,expenses,phone,-31.57,31240.26
buyer_3,Ana,,1989-08-23,ES60209500003562397206,TRX_N-00178-46790099,2022-06-08T19:51:41,Amurrio,expenses,internet,-42.0,31198.26
buyer_3,Ana,,1989-08-23,ES60209500003562397206,TRX_N-00179-94319242,2022-06-08T11:45:40,Amurrio,expenses,water,-22.89,31175.37
buyer_3,Ana,,1989-08-23,ES60209500003562397206,TRX_N-00180-98962550,2022-06-08T12:04:25,Amurrio,expenses,electricity,-71.09,31104.28
buyer_3,Ana,,1989-08-23,ES60209500003562397206,TRX_N-00181-61507873,2022-06-08T21:28:46,Amurrio,expenses,gas,-76.73,31027.55
buyer_3,Ana,,1989-08-23,ES60209500003562397206,TRX_N-00182-66308608,2022-06-08T08:48:33,Zuia,expenses,healthcare,-177.16,30850.39
buyer_3,Ana,,1989-08-23,ES60209500003562397206,TRX_N-00183-50754906,2022-06-08T12:19:40,Amurrio,expenses,repairs,-282.55,30567.84
buyer_3,Ana,,1989-08-23,ES60209500003562397206,TRX_N-00184-36597054,2022-06-10T10:50:27,Amurrio,expenses,cash,-100.0,30467.84
buyer_3,Ana,,1989-08-23,ES60209500003562397206,TRX_N-00185-85243606,2022-06-10T14:29:27,Amurrio,expenses,repairs,-290.78,30177.06
buyer_3,Ana,,1989-08-23,ES60209500003562397206,TRX_N-00186-89077342,2022-06-11T12:55:05,Amurrio,expenses,transport,-58.09,30118.97
buyer_3,Ana,,1989-08-23,ES60209500003562397206,TRX_N-00187-69298401,2022-06-12T00:51:37,Amurrio,expenses,food,-62.53,30056.44
buyer_3,Ana,,1989-08-23,ES60209500003562397206,TRX_N-00188-96404207,2022-06-15T15:39:33,Amurrio,expenses,food,-102.09,29954.35
buyer_3,Ana,,1989-08-23,ES60209500003562397206,TRX_N-00189-43331396,2022-06-16T13:52:05,Amurrio,expenses,cash,-100.0,29854.35
buyer_3,Ana,,1989-08-23,ES60209500003562397206,TRX_N-00190-31470917,2022-06-17T11:43:54,Amurrio,expenses,leisure,-62.04,29792.31
buyer_3,Ana,,1989-08-23,ES60209500003562397206,TRX_N-00191-22902026,2022-06-20T14:59:04,Amurrio,expenses,healthcare,-84.43,29707.88
buyer_3,Ana,,1989-08-23,ES60209500003562397206,TRX_N-00192-95853805,2022-06-20T18:34:35,Amurrio,expenses,repairs,-274.43,29433.45
buyer_3,Ana,,1989-08-23,ES60209500003562397206,TRX_N-00193-30693476,2022-06-21T12:20:19,Amurrio,expenses,food,-64.43,29369.02
buyer_3,Ana,,1989-08-23,ES60209500003562397206,TRX_N-00194-36933016,2022-06-21T16:58:26,Amurrio,expenses,transport,-44.14,29324.88
buyer_3,Ana,,1989-08-23,ES60209500003562397206,TRX_N-00195-83589279,2022-06-22T12:32:06,Zuia,expenses,food,-76.23,29248.65
buyer_3,Ana,,1989-08-23,ES60209500003562397206,TRX_N-00196-30279914,2022-06-22T18:01:56,Amurrio,expenses,transport,-52.58,29196.07
buyer_3,Ana,,1989-08-23,ES60209500003562397206,TRX_N-00197-48560178,2022-06-23T09:40:52,Amurrio,expenses,food,-106.94,29089.13
buyer_3,Ana,,1989-08-23,ES60209500003562397206,TRX_N-00198-76815834,2022-06-25T19:04:07,Barakaldo,expenses,cash,-100.0,28989.13
buyer_3,Ana,,1989-08-23,ES60209500003562397206,TRX_N-00199-94070930,2022-06-25T19:13:30,Amurrio,expenses,gifts,-390.89,28598.24
buyer_3,Ana,,1989-08-23,ES60209500003562397206,TRX_N-00200-59520841,2022-07-01T05:44:52,Amurrio,incomes,salary,3536.84,32135.08
buyer_3,Ana,,1989-08-23,ES60209500003562397206,TRX_N-00201-58529773,2022-07-01T05:44:52,Amurrio,incomes,salary_partner,3830.29,35965.37
buyer_3,Ana,,1989-08-23,ES60209500003562397206,TRX_N-00202-51744413,2022-07-01T05:44:52,Amurrio,incomes,extra_income,437.39,36402.76
buyer_3,Ana,,1989-08-23,ES60209500003562397206,TRX_N-00203-18922207,2022-07-02T18:18:36,Amurrio,expenses,leisure,-29.12,36373.64
buyer_3,Ana,,1989-08-23,ES60209500003562397206,TRX_N-00204-98089457,2022-07-03T15:12:43,Amurrio,expenses,food,-71.17,36302.47
buyer_3,Ana,,1989-08-23,ES60209500003562397206,TRX_N-00205-47687595,2022-07-04T11:16:59,Amurrio,expenses,mortgage,-1069.75,35232.72
buyer_3,Ana,,1989-08-23,ES60209500003562397206,TRX_N-00206-11074838,2022-07-05T20:24:14,Amurrio,expenses,water,-34.55,35198.17
buyer_3,Ana,,1989-08-23,ES60209500003562397206,TRX_N-00207-22142054,2022-07-05T09:02:53,Amurrio,expenses,internet,-42.0,35156.17
buyer_3,Ana,,1989-08-23,ES60209500003562397206,TRX_N-00208-28974606,2022-07-05T16:48:40,Amurrio,expenses,transport,-65.58,35090.59
buyer_3,Ana,,1989-08-23,ES60209500003562397206,TRX_N-00209-18086233,2022-07-06T16:22:33,Amurrio,expenses,electricity,-73.89,35016.7
buyer_3,Ana,,1989-08-23,ES60209500003562397206,TRX_N-00210-09311879,2022-07-06T20:40:03,Amurrio,expenses,phone,-38.43,34978.27
buyer_3,Ana,,1989-08-23,ES60209500003562397206,TRX_N-00211-80613478,2022-07-06T01:43:38,Amurrio,expenses,cash,-100.0,34878.27
buyer_3,Ana,,1989-08-23,ES60209500003562397206,TRX_N-00212-56874738,2022-07-07T20:47:04,Amurrio,expenses,repairs,-287.22,34591.05
buyer_3,Ana,,1989-08-23,ES60209500003562397206,TRX_N-00213-35717789,2022-07-08T09:41:22,Amurrio,expenses,gas,-83.63,34507.42
buyer_3,Ana,,1989-08-23,ES60209500003562397206,TRX_N-00214-89243393,2022-07-08T21:10:10,Bermeo,expenses,food,-70.07,34437.35
buyer_3,Ana,,1989-08-23,ES60209500003562397206,TRX_N-00215-65636770,2022-07-08T11:08:57,Amurrio,expenses,education,-57.08,34380.27
buyer_3,Ana,,1989-08-23,ES60209500003562397206,TRX_N-00216-40866674,2022-07-09T15:28:14,Amurrio,expenses,cash,-100.0,34280.27
buyer_3,Ana,,1989-08-23,ES60209500003562397206,TRX_N-00217-35172300,2022-07-10T20:50:47,Amurrio,expenses,food,-122.82,34157.45
buyer_3,Ana,,1989-08-23,ES60209500003562397206,TRX_N-00218-08771107,2022-07-10T06:31:54,Amurrio,expenses,transport,-85.6,34071.85
buyer_3,Ana,,1989-08-23,ES60209500003562397206,TRX_N-00219-09320275,2022-07-12T20:30:53,Amurrio,expenses,transport,-60.68,34011.17
buyer_3,Ana,,1989-08-23,ES60209500003562397206,TRX_N-00220-68721053,2022-07-14T03:14:22,Amurrio,expenses,cash,-100.0,33911.17
buyer_3,Ana,,1989-08-23,ES60209500003562397206,TRX_N-00221-33294058,2022-07-16T14:21:02,Amurrio,expenses,food,-63.14,33848.03
buyer_3,Ana,,1989-08-23,ES60209500003562397206,TRX_N-00222-82734921,2022-07-17T21:25:54,Elciego,expenses,food,-79.53,33768.5
buyer_3,Ana,,1989-08-23,ES60209500003562397206,TRX_N-00223-86623676,2022-07-18T16:33:42,Amurrio,expenses,leisure,-56.97,33711.53
buyer_3,Ana,,1989-08-23,ES60209500003562397206,TRX_N-00224-66596432,2022-07-19T10:45:36,Amurrio,expenses,leisure,-29.57,33681.96
buyer_3,Ana,,1989-08-23,ES60209500003562397206,TRX_N-00225-34148023,2022-07-21T15:50:17,Amurrio,expenses,leisure,-61.9,33620.06
buyer_3,Ana,,1989-08-23,ES60209500003562397206,TRX_N-00226-23676094,2022-07-22T23:55:50,Amurrio,expenses,transport,-42.97,33577.09
buyer_3,Ana,,1989-08-23,ES60209500003562397206,TRX_N-00227-04335302,2022-07-24T15:38:26,Amurrio,expenses,education,-62.56,33514.53
buyer_3,Ana,,1989-08-23,ES60209500003562397206,TRX_N-00228-54846080,2022-07-25T10:00:03,Amurrio,expenses,food,-96.53,33418.0
buyer_3,Ana,,1989-08-23,ES60209500003562397206,TRX_N-00229-59904979,2022-07-28T16:35:48,Lasarte-Oria,expenses,leisure,-64.08,33353.92
buyer_3,Ana,,1989-08-23,ES60209500003562397206,TRX_N-00230-87282135,2022-07-29T20:36:56,Amurrio,expenses,cash,-100.0,33253.92
buyer_3,Ana,,1989-08-23,ES60209500003562397206,TRX_N-00231-31513618,2022-07-30T08:35:40,Amurrio,expenses,leisure,-63.38,33190.54
buyer_3,Ana,,1989-08-23,ES60209500003562397206,TRX_N-00232-50136866,2022-07-31T10:49:01,Hondarribia,expenses,healthcare,-94.68,33095.86
buyer_3,Ana,,1989-08-23,ES60209500003562397206,TRX_N-00233-03458415,2022-08-01T09:56:57,Amurrio,incomes,salary,3536.84,36632.7
buyer_3,Ana,,1989-08-23,ES60209500003562397206,TRX_N-00234-27141489,2022-08-01T09:56:57,Amurrio,incomes,salary_partner,3830.29,40462.99
buyer_3,Ana,,1989-08-23,ES60209500003562397206,TRX_N-00235-53714623,2022-08-01T18:59:34,Amurrio,expenses,cash,-100.0,40362.99
buyer_3,Ana,,1989-08-23,ES60209500003562397206,TRX_N-00236-08394314,2022-08-03T15:41:21,Pasaia,expenses,food,-95.38,40267.61
buyer_3,Ana,,1989-08-23,ES60209500003562397206,TRX_N-00237-86418496,2022-08-03T11:20:24,Amurrio,expenses,clothing,-151.31,40116.3
buyer_3,Ana,,1989-08-23,ES60209500003562397206,TRX_N-00238-39534527,2022-08-04T09:06:13,Amurrio,expenses,mortgage,-1069.75,39046.55
buyer_3,Ana,,1989-08-23,ES60209500003562397206,TRX_N-00239-64474458,2022-08-04T17:09:44,Amurrio,expenses,transport,-66.57,38979.98
buyer_3,Ana,,1989-08-23,ES60209500003562397206,TRX_N-00240-01241003,2022-08-04T14:54:45,Amurrio,expenses,gifts,-102.74,38877.24
buyer_3,Ana,,1989-08-23,ES60209500003562397206,TRX_N-00241-34979927,2022-08-05T13:23:14,Amurrio,expenses,appliances,-410.92,38466.32
buyer_3,Ana,,1989-08-23,ES60209500003562397206,TRX_N-00242-95172186,2022-08-06T12:38:08,Amurrio,expenses,leisure,-32.13,38434.19
buyer_3,Ana,,1989-08-23,ES60209500003562397206,TRX_N-00243-82691856,2022-08-07T12:03:56,Amurrio,expenses,internet,-42.0,38392.19
buyer_3,Ana,,1989-08-23,ES60209500003562397206,TRX_N-00244-68027683,2022-08-08T09:08:29,Amurrio,expenses,water,-34.3,38357.89
buyer_3,Ana,,1989-08-23,ES60209500003562397206,TRX_N-00245-51458772,2022-08-08T09:57:36,Amurrio,expenses,electricity,-47.95,38309.94
buyer_3,Ana,,1989-08-23,ES60209500003562397206,TRX_N-00246-46890351,2022-08-08T03:48:47,Amurrio,expenses,gas,-101.31,38208.63
buyer_3,Ana,,1989-08-23,ES60209500003562397206,TRX_N-00247-50236077,2022-08-08T16:37:05,Amurrio,expenses,phone,-35.19,38173.44
buyer_3,Ana,,1989-08-23,ES60209500003562397206,TRX_N-00248-80112049,2022-08-08T21:50:59,Amurrio,expenses,food,-96.09,38077.35
buyer_3,Ana,,1989-08-23,ES60209500003562397206,TRX_N-00249-14822445,2022-08-08T19:46:34,Amurrio,expenses,repairs,-311.96,37765.39
buyer_3,Ana,,1989-08-23,ES60209500003562397206,TRX_N-00250-96780713,2022-08-09T13:44:42,Llodio,expenses,leisure,-62.58,37702.81
buyer_3,Ana,,1989-08-23,ES60209500003562397206,TRX_N-00251-40008809,2022-08-11T16:10:55,Amurrio,expenses,clothing,-157.05,37545.76
buyer_3,Ana,,1989-08-23,ES60209500003562397206,TRX_N-00252-64227096,2022-08-11T22:04:08,Amurrio,expenses,healthcare,-99.28,37446.48
buyer_3,Ana,,1989-08-23,ES60209500003562397206,TRX_N-00253-84024148,2022-08-12T09:02:35,Amurrio,expenses,education,-73.37,37373.11
buyer_3,Ana,,1989-08-23,ES60209500003562397206,TRX_N-00254-00239060,2022-08-12T15:57:28,Irun,expenses,cash,-100.0,37273.11
buyer_3,Ana,,1989-08-23,ES60209500003562397206,TRX_N-00255-36730646,2022-08-13T17:10:03,Erandio,expenses,transport,-83.56,37189.55
buyer_3,Ana,,1989-08-23,ES60209500003562397206,TRX_N-00256-95697970,2022-08-15T09:33:54,Amurrio,expenses,clothing,-85.82,37103.73
buyer_3,Ana,,1989-08-23,ES60209500003562397206,TRX_N-00257-38039309,2022-08-16T09:33:14,Sopela,expenses,food,-65.38,37038.35
buyer_3,Ana,,1989-08-23,ES60209500003562397206,TRX_N-00258-50137299,2022-08-16T18:20:53,Amurrio,expenses,cash,-100.0,36938.35
buyer_3,Ana,,1989-08-23,ES60209500003562397206,TRX_N-00259-18764194,2022-08-17T01:22:39,Lasarte-Oria,expenses,food,-71.98,36866.37
buyer_3,Ana,,1989-08-23,ES60209500003562397206,TRX_N-00260-76060826,2022-08-20T13:29:07,Amurrio,expenses,food,-70.56,36795.81
buyer_3,Ana,,1989-08-23,ES60209500003562397206,TRX_N-00261-44754924,2022-08-20T21:13:44,Amurrio,expenses,repairs,-71.43,36724.38
buyer_3,Ana,,1989-08-23,ES60209500003562397206,TRX_N-00262-57599743,2022-08-22T18:11:50,Amurrio,expenses,leisure,-43.63,36680.75
buyer_3,Ana,,1989-08-23,ES60209500003562397206,TRX_N-00263-73198229,2022-08-23T22:43:03,Amurrio,expenses,transport,-68.97,36611.78
buyer_3,Ana,,1989-08-23,ES60209500003562397206,TRX_N-00264-69933456,2022-08-24T20:18:34,Amurrio,expenses,repairs,-58.93,36552.85
buyer_3,Ana,,1989-08-23,ES60209500003562397206,TRX_N-00265-65428698,2022-08-26T15:12:33,Amurrio,expenses,healthcare,-55.36,36497.49
buyer_3,Ana,,1989-08-23,ES60209500003562397206,TRX_N-00266-71388262,2022-08-26T15:42:01,Amurrio,expenses,cash,-100.0,36397.49
buyer_3,Ana,,1989-08-23,ES60209500003562397206,TRX_N-00267-64780069,2022-08-28T12:23:36,Elciego,expenses,food,-88.46,36309.03
buyer_3,Ana,,1989-08-23,ES60209500003562397206,TRX_N-00268-25379208,2022-08-30T14:32:50,Amurrio,expenses,transport,-82.25,36226.78
buyer_3,Ana,,1989-08-23,ES60209500003562397206,TRX_N-00269-80118063,2022-09-01T19:33:24,Amurrio,incomes,salary,3536.84,39763.62
buyer_3,Ana,,1989-08-23,ES60209500003562397206,TRX_N-00270-95762068,2022-09-01T19:33:24,Amurrio,incomes,salary_partner,3830.29,43593.91
buyer_3,Ana,,1989-08-23,ES60209500003562397206,TRX_N-00271-37703006,2022-09-01T20:36:37,Amurrio,expenses,clothing,-155.12,43438.79
buyer_3,Ana,,1989-08-23,ES60209500003562397206,TRX_N-00272-80336817,2022-09-02T19:07:58,Amurrio,expenses,transport,-59.66,43379.13
buyer_3,Ana,,1989-08-23,ES60209500003562397206,TRX_N-00273-18547421,2022-09-03T18:10:48,Berango,expenses,cash,-100.0,43279.13
buyer_3,Ana,,1989-08-23,ES60209500003562397206,TRX_N-00274-11195159,2022-09-04T13:07:23,Amurrio,expenses,mortgage,-1069.75,42209.38
buyer_3,Ana,,1989-08-23,ES60209500003562397206,TRX_N-00275-14246155,2022-09-04T12:41:34,Amurrio,expenses,clothing,-141.3,42068.08
buyer_3,Ana,,1989-08-23,ES60209500003562397206,TRX_N-00276-36118793,2022-09-04T13:07:57,Amurrio,expenses,education,-76.3,41991.78
buyer_3,Ana,,1989-08-23,ES60209500003562397206,TRX_N-00277-80408365,2022-09-05T14:17:28,Amurrio,expenses,water,-38.27,41953.51
buyer_3,Ana,,1989-08-23,ES60209500003562397206,TRX_N-00278-81780452,2022-09-05T16:25:24,Amurrio,expenses,electricity,-70.52,41882.99
buyer_3,Ana,,1989-08-23,ES60209500003562397206,TRX_N-00279-52298922,2022-09-05T13:59:35,Amurrio,expenses,gas,-49.66,41833.33
buyer_3,Ana,,1989-08-23,ES60209500003562397206,TRX_N-00280-01324668,2022-09-05T12:39:01,Amurrio,expenses,cash,-100.0,41733.33
buyer_3,Ana,,1989-08-23,ES60209500003562397206,TRX_N-00281-96349690,2022-09-07T00:06:37,Amurrio,expenses,phone,-39.07,41694.26
buyer_3,Ana,,1989-08-23,ES60209500003562397206,TRX_N-00282-84475526,2022-09-07T20:04:06,Amurrio,expenses,clothing,-133.19,41561.07
buyer_3,Ana,,1989-08-23,ES60209500003562397206,TRX_N-00283-49529844,2022-09-08T06:12:15,Amurrio,expenses,internet,-42.0,41519.07
buyer_3,Ana,,1989-08-23,ES60209500003562397206,TRX_N-00284-17552087,2022-09-09T13:26:00,Amurrio,expenses,car,-164.78,41354.29
buyer_3,Ana,,1989-08-23,ES60209500003562397206,TRX_N-00285-07240876,2022-09-10T06:41:30,Amurrio,expenses,food,-99.84,41254.45
buyer_3,Ana,,1989-08-23,ES60209500003562397206,TRX_N-00286-68569548,2022-09-11T22:42:15,Amurrio,expenses,transport,-40.93,41213.52
buyer_3,Ana,,1989-08-23,ES60209500003562397206,TRX_N-00287-70890562,2022-09-11T20:21:32,Amurrio,expenses,clothing,-51.09,41162.43
buyer_3,Ana,,1989-08-23,ES60209500003562397206,TRX_N-00288-88446691,2022-09-14T09:39:33,Amurrio,expenses,cash,-100.0,41062.43
buyer_3,Ana,,1989-08-23,ES60209500003562397206,TRX_N-00289-21642412,2022-09-14T13:11:51,Amurrio,expenses,repairs,-145.81,40916.62
buyer_3,Ana,,1989-08-23,ES60209500003562397206,TRX_N-00290-44277566,2022-09-14T02:06:23,Amurrio,expenses,gifts,-602.85,40313.77
buyer_3,Ana,,1989-08-23,ES60209500003562397206,TRX_N-00291-49736906,2022-09-16T21:27:44,Amurrio,expenses,cash,-100.0,40213.77
buyer_3,Ana,,1989-08-23,ES60209500003562397206,TRX_N-00292-83457483,2022-09-19T11:12:36,Amurrio,expenses,education,-67.29,40146.48
buyer_3,Ana,,1989-08-23,ES60209500003562397206,TRX_N-00293-29608247,2022-09-20T17:58:13,Amurrio,expenses,food,-113.86,40032.62
buyer_3,Ana,,1989-08-23,ES60209500003562397206,TRX_N-00294-22090087,2022-09-21T16:39:04,Amurrio,expenses,food,-84.22,39948.4
buyer_3,Ana,,1989-08-23,ES60209500003562397206,TRX_N-00295-46634499,2022-09-22T05:40:29,Amurrio,expenses,leisure,-21.68,39926.72
buyer_3,Ana,,1989-08-23,ES60209500003562397206,TRX_N-00296-51832445,2022-09-22T08:46:09,Amurrio,expenses,cash,-100.0,39826.72
buyer_3,Ana,,1989-08-23,ES60209500003562397206,TRX_N-00297-26936175,2022-09-23T09:09:13,Berango,expenses,gifts,-26.74,39799.98
buyer_3,Ana,,1989-08-23,ES60209500003562397206,TRX_N-00298-94902548,2022-09-26T08:03:03,Amurrio,expenses,cash,-100.0,39699.98
buyer_3,Ana,,1989-08-23,ES60209500003562397206,TRX_N-00299-01148174,2022-09-27T17:13:09,Amurrio,expenses,clothing,-89.78,39610.2
buyer_3,Ana,,1989-08-23,ES60209500003562397206,TRX_N-00300-97449684,2022-09-28T18:03:11,Amurrio,expenses,clothing,-94.77,39515.43
buyer_3,Ana,,1989-08-23,ES60209500003562397206,TRX_N-00301-22389937,2022-09-29T13:12:42,Amurrio,expenses,food,-109.71,39405.72
buyer_3,Ana,,1989-08-23,ES60209500003562397206,TRX_N-00302-86668817,2022-09-29T19:32:23,Amurrio,expenses,gifts,-260.61,39145.11
buyer_3,Ana,,1989-08-23,ES60209500003562397206,TRX_N-00303-54576550,2022-09-30T13:35:45,Elciego,expenses,transport,-49.97,39095.14
buyer_3,Ana,,1989-08-23,ES60209500003562397206,TRX_N-00304-61612370,2022-10-01T11:15:49,Amurrio,incomes,salary,3536.84,42631.98
buyer_3,Ana,,1989-08-23,ES60209500003562397206,TRX_N-00305-81889196,2022-10-01T11:15:49,Amurrio,incomes,salary_partner,3830.29,46462.27
buyer_3,Ana,,1989-08-23,ES60209500003562397206,TRX_N-00306-47774033,2022-10-01T11:15:49,Amurrio,incomes,extra_income,437.39,46899.66
buyer_3,Ana,,1989-08-23,ES60209500003562397206,TRX_N-00307-82157338,2022-10-01T19:47:18,Amurrio,expenses,cash,-100.0,46799.66
buyer_3,Ana,,1989-08-23,ES60209500003562397206,TRX_N-00308-12759129,2022-10-03T13:50:09,Amurrio,expenses,food,-96.43,46703.23
buyer_3,Ana,,1989-08-23,ES60209500003562397206,TRX_N-00309-34693715,2022-10-03T17:33:11,Amurrio,expenses,leisure,-27.34,46675.89
buyer_3,Ana,,1989-08-23,ES60209500003562397206,TRX_N-00310-78333850,2022-10-03T04:48:27,Amurrio,expenses,gifts,-392.74,46283.15
buyer_3,Ana,,1989-08-23,ES60209500003562397206,TRX_N-00311-82510383,2022-10-04T18:45:48,Amurrio,expenses,mortgage,-1069.75,45213.4
buyer_3,Ana,,1989-08-23,ES60209500003562397206,TRX_N-00312-98722248,2022-10-04T10:48:46,Amurrio,expenses,transport,-71.66,45141.74
buyer_3,Ana,,1989-08-23,ES60209500003562397206,TRX_N-00313-80626589,2022-10-05T08:17:27,Amurrio,expenses,water,-43.16,45098.58
buyer_3,Ana,,1989-08-23,ES60209500003562397206,TRX_N-00314-37034313,2022-10-05T18:27:16,Amurrio,expenses,phone,-30.59,45067.99
buyer_3,Ana,,1989-08-23,ES60209500003562397206,TRX_N-00315-55677554,2022-10-05T17:59:02,Amurrio,expenses,repairs,-223.44,44844.55
buyer_3,Ana,,1989-08-23,ES60209500003562397206,TRX_N-00316-11857196,2022-10-06T12:03:17,Amurrio,expenses,food,-71.0,44773.55
buyer_3,Ana,,1989-08-23,ES60209500003562397206,TRX_N-00317-58680926,2022-10-06T17:40:37,Amurrio,expenses,cash,-100.0,44673.55
buyer_3,Ana,,1989-08-23,ES60209500003562397206,TRX_N-00318-93780251,2022-10-07T21:04:00,Amurrio,expenses,gas,-99.15,44574.4
buyer_3,Ana,,1989-08-23,ES60209500003562397206,TRX_N-00319-32675646,2022-10-08T14:25:44,Amurrio,expenses,electricity,-67.62,44506.78
buyer_3,Ana,,1989-08-23,ES60209500003562397206,TRX_N-00320-92919960,2022-10-08T12:47:53,Amurrio,expenses,internet,-42.0,44464.78
buyer_3,Ana,,1989-08-23,ES60209500003562397206,TRX_N-00321-86628513,2022-10-09T21:18:48,Amurrio,expenses,food,-83.04,44381.74
buyer_3,Ana,,1989-08-23,ES60209500003562397206,TRX_N-00322-42335367,2022-10-09T13:44:39,Amurrio,expenses,leisure,-76.32,44305.42
buyer_3,Ana,,1989-08-23,ES60209500003562397206,TRX_N-00323-08173590,2022-10-09T12:28:31,Amurrio,expenses,clothing,-131.74,44173.68
buyer_3,Ana,,1989-08-23,ES60209500003562397206,TRX_N-00324-11617394,2022-10-15T21:21:05,Amurrio,expenses,repairs,-222.3,43951.38
buyer_3,Ana,,1989-08-23,ES60209500003562397206,TRX_N-00325-95895417,2022-10-15T20:53:56,Amurrio,expenses,gifts,-56.43,43894.95
buyer_3,Ana,,1989-08-23,ES60209500003562397206,TRX_N-00326-44151237,2022-10-16T14:38:32,Lasarte-Oria,expenses,cash,-100.0,43794.95
buyer_3,Ana,,1989-08-23,ES60209500003562397206,TRX_N-00327-62977579,2022-10-17T12:49:29,Amurrio,expenses,cash,-100.0,43694.95
buyer_3,Ana,,1989-08-23,ES60209500003562397206,TRX_N-00328-68203559,2022-10-17T13:34:31,Amurrio,expenses,appliances,-190.53,43504.42
buyer_3,Ana,,1989-08-23,ES60209500003562397206,TRX_N-00329-28265049,2022-10-20T14:18:59,Amurrio,expenses,cash,-100.0,43404.42
buyer_3,Ana,,1989-08-23,ES60209500003562397206,TRX_N-00330-62967334,2022-10-23T14:48:27,Amurrio,expenses,clothing,-94.11,43310.31
buyer_3,Ana,,1989-08-23,ES60209500003562397206,TRX_N-00331-99477933,2022-10-23T09:01:10,Sopela,expenses,cash,-100.0,43210.31
buyer_3,Ana,,1989-08-23,ES60209500003562397206,TRX_N-00332-65352277,2022-10-24T01:15:25,Amurrio,expenses,food,-118.01,43092.3
buyer_3,Ana,,1989-08-23,ES60209500003562397206,TRX_N-00333-67423312,2022-10-24T15:38:39,Amurrio,expenses,education,-68.5,43023.8
buyer_3,Ana,,1989-08-23,ES60209500003562397206,TRX_N-00334-37298021,2022-10-24T18:35:07,Amurrio,expenses,gifts,-391.65,42632.15
buyer_3,Ana,,1989-08-23,ES60209500003562397206,TRX_N-00335-93916571,2022-10-25T17:17:02,Amurrio,expenses,food,-123.44,42508.71
buyer_3,Ana,,1989-08-23,ES60209500003562397206,TRX_N-00336-86946396,2022-10-25T17:44:11,Amurrio,expenses,cash,-100.0,42408.71
buyer_3,Ana,,1989-08-23,ES60209500003562397206,TRX_N-00337-12564192,2022-10-26T11:36:02,Amurrio,expenses,leisure,-70.98,42337.73
buyer_3,Ana,,1989-08-23,ES60209500003562397206,TRX_N-00338-59328910,2022-10-26T15:50:23,Amurrio,expenses,cash,-100.0,42237.73
buyer_3,Ana,,1989-08-23,ES60209500003562397206,TRX_N-00339-62992242,2022-10-27T08:09:15,Amurrio,expenses,transport,-52.09,42185.64
buyer_3,Ana,,1989-08-23,ES60209500003562397206,TRX_N-00340-03318091,2022-10-29T10:22:46,Amurrio,expenses,leisure,-45.79,42139.85
buyer_3,Ana,,1989-08-23,ES60209500003562397206,TRX_N-00341-08233126,2022-10-29T17:03:27,Amurrio,expenses,healthcare,-61.39,42078.46
buyer_3,Ana,,1989-08-23,ES60209500003562397206,TRX_N-00342-50607764,2022-10-29T09:42:38,Amurrio,expenses,appliances,-211.32,41867.14
buyer_3,Ana,,1989-08-23,ES60209500003562397206,TRX_N-00343-80775959,2022-10-30T20:14:19,Amurrio,expenses,food,-78.98,41788.16
buyer_3,Ana,,1989-08-23,ES60209500003562397206,TRX_N-00344-19025309,2022-10-31T07:11:07,Amurrio,expenses,cash,-100.0,41688.16
buyer_3,Ana,,1989-08-23,ES60209500003562397206,TRX_N-00345-18581118,2022-10-31T09:11:32,Amurrio,expenses,gifts,-124.0,41564.16
buyer_3,Ana,,1989-08-23,ES60209500003562397206,TRX_N-00346-25098219,2022-11-01T16:47:27,Amurrio,incomes,salary,3536.84,45101.0
buyer_3,Ana,,1989-08-23,ES60209500003562397206,TRX_N-00347-80893136,2022-11-01T16:47:27,Amurrio,incomes,salary_partner,3830.29,48931.29
buyer_3,Ana,,1989-08-23,ES60209500003562397206,TRX_N-00348-42552908,2022-11-01T20:43:46,Amurrio,expenses,education,-54.85,48876.44
buyer_3,Ana,,1989-08-23,ES60209500003562397206,TRX_N-00349-60887876,2022-11-03T14:54:31,Amurrio,expenses,cash,-100.0,48776.44
buyer_3,Ana,,1989-08-23,ES60209500003562397206,TRX_N-00350-03521065,2022-11-04T21:22:33,Amurrio,expenses,mortgage,-1069.75,47706.69
buyer_3,Ana,,1989-08-23,ES60209500003562397206,TRX_N-00351-71082429,2022-11-04T15:31:13,Amurrio,expenses,education,-72.53,47634.16
buyer_3,Ana,,1989-08-23,ES60209500003562397206,TRX_N-00352-49818674,2022-11-04T10:59:44,Amurrio,expenses,car,-124.56,47509.6
buyer_3,Ana,,1989-08-23,ES60209500003562397206,TRX_N-00353-13883777,2022-11-06T13:41:20,Amurrio,expenses,gas,-30.53,47479.07
buyer_3,Ana,,1989-08-23,ES60209500003562397206,TRX_N-00354-51304135,2022-11-07T19:36:52,Amurrio,expenses,internet,-42.0,47437.07
buyer_3,Ana,,1989-08-23,ES60209500003562397206,TRX_N-00355-81801614,2022-11-07T23:38:53,Amurrio,expenses,transport,-43.81,47393.26
buyer_3,Ana,,1989-08-23,ES60209500003562397206,TRX_N-00356-87536758,2022-11-08T11:12:57,Amurrio,expenses,phone,-34.83,47358.43
buyer_3,Ana,,1989-08-23,ES60209500003562397206,TRX_N-00357-04690250,2022-11-08T11:31:23,Amurrio,expenses,water,-23.04,47335.39
buyer_3,Ana,,1989-08-23,ES60209500003562397206,TRX_N-00358-26499933,2022-11-08T20:53:55,Amurrio,expenses,electricity,-62.03,47273.36
buyer_3,Ana,,1989-08-23,ES60209500003562397206,TRX_N-00359-14575882,2022-11-09T16:15:00,Vitoria-Gasteiz,expenses,cash,-100.0,47173.36
buyer_3,Ana,,1989-08-23,ES60209500003562397206,TRX_N-00360-44790909,2022-11-10T10:10:36,Amurrio,expenses,appliances,-86.93,47086.43
buyer_3,Ana,,1989-08-23,ES60209500003562397206,TRX_N-00361-32703310,2022-11-15T15:03:55,Amurrio,expenses,gifts,-453.17,46633.26
buyer_3,Ana,,1989-08-23,ES60209500003562397206,TRX_N-00362-03311839,2022-11-16T00:25:27,Basauri,expenses,food,-82.84,46550.42
buyer_3,Ana,,1989-08-23,ES60209500003562397206,TRX_N-00363-55511450,2022-11-19T16:06:29,Amurrio,expenses,cash,-100.0,46450.42
buyer_3,Ana,,1989-08-23,ES60209500003562397206,TRX_N-00364-64716366,2022-11-21T20:32:00,Amurrio,expenses,travel,-1382.2,45068.22
buyer_3,Ana,,1989-08-23,ES60209500003562397206,TRX_N-00365-00208238,2022-11-23T18:04:05,Amurrio,expenses,cash,-100.0,44968.22
buyer_3,Ana,,1989-08-23,ES60209500003562397206,TRX_N-00366-67090133,2022-11-25T18:26:49,Amurrio,expenses,cash,-100.0,44868.22
buyer_3,Ana,,1989-08-23,ES60209500003562397206,TRX_N-00367-22236770,2022-11-26T19:50:45,Amurrio,expenses,cash,-100.0,44768.22
buyer_3,Ana,,1989-08-23,ES60209500003562397206,TRX_N-00368-12712748,2022-11-27T10:53:45,Amurrio,expenses,transport,-87.2,44681.02
buyer_3,Ana,,1989-08-23,ES60209500003562397206,TRX_N-00369-15463686,2022-11-28T13:07:30,Amurrio,expenses,cash,-100.0,44581.02
buyer_3,Ana,,1989-08-23,ES60209500003562397206,TRX_N-00370-24147381,2022-11-28T17:17:14,Amurrio,expenses,repairs,-300.58,44280.44
buyer_3,Ana,,1989-08-23,ES60209500003562397206,TRX_N-00371-60951895,2022-11-29T10:08:38,Llodio,expenses,food,-80.81,44199.63
buyer_3,Ana,,1989-08-23,ES60209500003562397206,TRX_N-00372-03162733,2022-11-29T12:46:17,Amurrio,expenses,leisure,-23.72,44175.91
buyer_3,Ana,,1989-08-23,ES60209500003562397206,TRX_N-00373-78286962,2022-11-30T09:36:06,Amurrio,expenses,food,-94.71,44081.2
buyer_3,Ana,,1989-08-23,ES60209500003562397206,TRX_N-00374-96947075,2022-12-01T10:03:46,Amurrio,incomes,salary,3536.84,47618.04
buyer_3,Ana,,1989-08-23,ES60209500003562397206,TRX_N-00375-80309215,2022-12-01T10:03:46,Amurrio,incomes,salary_partner,3830.29,51448.33
buyer_3,Ana,,1989-08-23,ES60209500003562397206,TRX_N-00376-86757173,2022-12-01T10:03:46,Amurrio,incomes,salary_bonus,2577.22,54025.55
buyer_3,Ana,,1989-08-23,ES60209500003562397206,TRX_N-00377-60971776,2022-12-01T10:03:46,Amurrio,incomes,salary_partner_bonus,3004.83,57030.38
buyer_3,Ana,,1989-08-23,ES60209500003562397206,TRX_N-00378-62271028,2022-12-01T09:07:09,Amurrio,expenses,cash,-100.0,56930.38
buyer_3,Ana,,1989-08-23,ES60209500003562397206,TRX_N-00379-59880751,2022-12-03T19:49:35,Amurrio,expenses,food,-65.23,56865.15
buyer_3,Ana,,1989-08-23,ES60209500003562397206,TRX_N-00380-06086628,2022-12-04T20:14:02,Amurrio,expenses,mortgage,-1069.75,55795.4
buyer_3,Ana,,1989-08-23,ES60209500003562397206,TRX_N-00381-08933568,2022-12-05T18:57:56,Amurrio,expenses,gas,-96.47,55698.93
buyer_3,Ana,,1989-08-23,ES60209500003562397206,TRX_N-00382-76786819,2022-12-05T11:47:02,Amurrio,expenses,internet,-42.0,55656.93
buyer_3,Ana,,1989-08-23,ES60209500003562397206,TRX_N-00383-58287326,2022-12-06T05:26:07,Amurrio,expenses,water,-36.4,55620.53
buyer_3,Ana,,1989-08-23,ES60209500003562397206,TRX_N-00384-43513783,2022-12-08T08:01:00,Amurrio,expenses,electricity,-86.88,55533.65
buyer_3,Ana,,1989-08-23,ES60209500003562397206,TRX_N-00385-84720775,2022-12-08T10:18:29,Amurrio,expenses,phone,-38.34,55495.31
buyer_3,Ana,,1989-08-23,ES60209500003562397206,TRX_N-00386-07176153,2022-12-08T15:26:50,Amurrio,expenses,leisure,-82.45,55412.86
buyer_3,Ana,,1989-08-23,ES60209500003562397206,TRX_N-00387-98457349,2022-12-10T17:23:04,Amurrio,expenses,cash,-100.0,55312.86
buyer_3,Ana,,1989-08-23,ES60209500003562397206,TRX_N-00388-83488976,2022-12-13T10:46:06,Amurrio,expenses,transport,-56.37,55256.49
buyer_3,Ana,,1989-08-23,ES60209500003562397206,TRX_N-00389-54485747,2022-12-14T18:38:13,Amurrio,expenses,gifts,-550.49,54706.0
buyer_3,Ana,,1989-08-23,ES60209500003562397206,TRX_N-00390-66330376,2022-12-15T09:19:46,Galdakao,expenses,cash,-100.0,54606.0
buyer_3,Ana,,1989-08-23,ES60209500003562397206,TRX_N-00391-82260246,2022-12-17T13:54:54,Amurrio,expenses,food,-65.69,54540.31
buyer_3,Ana,,1989-08-23,ES60209500003562397206,TRX_N-00392-47163028,2022-12-17T10:25:49,Amurrio,expenses,education,-53.12,54487.19
buyer_3,Ana,,1989-08-23,ES60209500003562397206,TRX_N-00393-32624008,2022-12-18T13:57:51,Amurrio,expenses,food,-115.31,54371.88
buyer_3,Ana,,1989-08-23,ES60209500003562397206,TRX_N-00394-96927922,2022-12-21T19:22:19,Amurrio,expenses,food,-101.73,54270.15
buyer_3,Ana,,1989-08-23,ES60209500003562397206,TRX_N-00395-53824710,2022-12-22T19:00:19,Amurrio,expenses,cash,-100.0,54170.15
buyer_3,Ana,,1989-08-23,ES60209500003562397206,TRX_N-00396-87556081,2022-12-23T19:26:36,Amurrio,expenses,leisure,-66.72,54103.43
buyer_3,Ana,,1989-08-23,ES60209500003562397206,TRX_N-00397-88126483,2022-12-24T12:41:51,Amurrio,expenses,education,-75.68,54027.75
buyer_3,Ana,,1989-08-23,ES60209500003562397206,TRX_N-00398-39625534,2022-12-24T23:10:53,Amurrio,expenses,cash,-100.0,53927.75
buyer_3,Ana,,1989-08-23,ES60209500003562397206,TRX_N-00399-33625297,2022-12-24T16:52:07,Amurrio,expenses,repairs,-209.79,53717.96
buyer_3,Ana,,1989-08-23,ES60209500003562397206,TRX_N-00400-82089258,2022-12-25T16:45:38,Amurrio,expenses,cash,-100.0,53617.96
buyer_3,Ana,,1989-08-23,ES60209500003562397206,TRX_N-00401-54344807,2022-12-26T22:38:59,Amurrio,expenses,transport,-82.64,53535.32
buyer_3,Ana,,1989-08-23,ES60209500003562397206,TRX_N-00402-13114229,2022-12-29T08:25:40,Amurrio,expenses,food,-124.35,53410.97
buyer_3,Ana,,1989-08-23,ES60209500003562397206,TRX_N-00403-72000750,2022-12-29T14:03:59,Amurrio,expenses,leisure,-52.26,53358.71
buyer_3,Ana,,1989-08-23,ES60209500003562397206,TRX_N-00404-57648278,2023-01-01T03:09:12,Amurrio,incomes,salary,3674.41,57033.12
buyer_3,Ana,,1989-08-23,ES60209500003562397206,TRX_N-00405-06683439,2023-01-01T03:09:12,Amurrio,incomes,salary_partner,3979.27,61012.39
buyer_3,Ana,,1989-08-23,ES60209500003562397206,TRX_N-00406-36599687,2023-01-01T03:09:12,Amurrio,incomes,extra_income,437.39,61449.78
buyer_3,Ana,,1989-08-23,ES60209500003562397206,TRX_N-00407-44665143,2023-01-01T13:41:59,Amurrio,expenses,transport,-42.02,61407.76
buyer_3,Ana,,1989-08-23,ES60209500003562397206,TRX_N-00408-63349635,2023-01-01T17:31:47,Amurrio,expenses,gifts,-827.52,60580.24
buyer_3,Ana,,1989-08-23,ES60209500003562397206,TRX_N-00409-06380758,2023-01-02T14:26:45,Amurrio,expenses,clothing,-69.85,60510.39
buyer_3,Ana,,1989-08-23,ES60209500003562397206,TRX_N-00410-24264750,2023-01-04T12:26:17,Amurrio,expenses,mortgage,-1069.75,59440.64
buyer_3,Ana,,1989-08-23,ES60209500003562397206,TRX_N-00411-18146621,2023-01-04T19:49:14,Zuia,expenses,cash,-100.0,59340.64
buyer_3,Ana,,1989-08-23,ES60209500003562397206,TRX_N-00412-04115387,2023-01-05T08:51:55,Amurrio,expenses,gas,-86.11,59254.53
buyer_3,Ana,,1989-08-23,ES60209500003562397206,TRX_N-00413-00822507,2023-01-07T21:56:50,Amurrio,expenses,electricity,-43.09,59211.44
buyer_3,Ana,,1989-08-23,ES60209500003562397206,TRX_N-00414-15026300,2023-01-07T13:34:58,Amurrio,expenses,cash,-100.0,59111.44
buyer_3,Ana,,1989-08-23,ES60209500003562397206,TRX_N-00415-75549061,2023-01-08T14:27:32,Amurrio,expenses,water,-42.57,59068.87
buyer_3,Ana,,1989-08-23,ES60209500003562397206,TRX_N-00416-20111862,2023-01-08T09:04:10,Amurrio,expenses,internet,-42.0,59026.87
buyer_3,Ana,,1989-08-23,ES60209500003562397206,TRX_N-00417-64664773,2023-01-08T18:33:31,Amurrio,expenses,phone,-43.46,58983.41
buyer_3,Ana,,1989-08-23,ES60209500003562397206,TRX_N-00418-85102975,2023-01-09T18:05:07,Amurrio,expenses,travel,-374.7,58608.71
buyer_3,Ana,,1989-08-23,ES60209500003562397206,TRX_N-00419-85476583,2023-01-10T08:03:00,Amurrio,expenses,cash,-100.0,58508.71
buyer_3,Ana,,1989-08-23,ES60209500003562397206,TRX_N-00420-87238750,2023-01-11T12:34:20,Sestao,expenses,food,-87.84,58420.87
buyer_3,Ana,,1989-08-23,ES60209500003562397206,TRX_N-00421-84923999,2023-01-12T13:17:47,Amurrio,expenses,leisure,-66.38,58354.49
buyer_3,Ana,,1989-08-23,ES60209500003562397206,TRX_N-00422-61618035,2023-01-13T15:48:36,Amurrio,expenses,cash,-100.0,58254.49
buyer_3,Ana,,1989-08-23,ES60209500003562397206,TRX_N-00423-62186810,2023-01-14T09:45:48,Amurrio,expenses,cash,-100.0,58154.49
buyer_3,Ana,,1989-08-23,ES60209500003562397206,TRX_N-00424-93592508,2023-01-14T11:45:21,Amurrio,expenses,repairs,-318.3,57836.19
buyer_3,Ana,,1989-08-23,ES60209500003562397206,TRX_N-00425-46442499,2023-01-15T16:32:54,Amurrio,expenses,cash,-100.0,57736.19
buyer_3,Ana,,1989-08-23,ES60209500003562397206,TRX_N-00426-55569942,2023-01-15T11:44:01,Amurrio,expenses,gifts,-173.83,57562.36
buyer_3,Ana,,1989-08-23,ES60209500003562397206,TRX_N-00427-23495695,2023-01-21T09:31:20,Amurrio,expenses,leisure,-21.07,57541.29
buyer_3,Ana,,1989-08-23,ES60209500003562397206,TRX_N-00428-87613453,2023-01-21T17:36:17,Amurrio,expenses,cash,-100.0,57441.29
buyer_3,Ana,,1989-08-23,ES60209500003562397206,TRX_N-00429-32180555,2023-01-22T10:00:32,Amurrio,expenses,leisure,-84.55,57356.74
buyer_3,Ana,,1989-08-23,ES60209500003562397206,TRX_N-00430-90981166,2023-01-23T19:01:44,Amurrio,expenses,leisure,-75.45,57281.29
buyer_3,Ana,,1989-08-23,ES60209500003562397206,TRX_N-00431-77455269,2023-01-26T09:32:50,Amurrio,expenses,food,-109.23,57172.06
buyer_3,Ana,,1989-08-23,ES60209500003562397206,TRX_N-00432-68084370,2023-01-26T18:22:14,Amurrio,expenses,leisure,-66.5,57105.56
buyer_3,Ana,,1989-08-23,ES60209500003562397206,TRX_N-00433-16232498,2023-01-26T14:13:34,Amurrio,expenses,car,-165.0,56940.56
buyer_3,Ana,,1989-08-23,ES60209500003562397206,TRX_N-00434-49079346,2023-01-31T02:47:36,Amurrio,expenses,transport,-68.88,56871.68
buyer_3,Ana,,1989-08-23,ES60209500003562397206,TRX_N-00435-75448709,2023-01-31T15:19:35,Berango,expenses,clothing,-118.45,56753.23
buyer_3,Ana,,1989-08-23,ES60209500003562397206,TRX_N-00436-87743736,2023-02-01T09:45:34,Amurrio,incomes,salary,3674.41,60427.64
buyer_3,Ana,,1989-08-23,ES60209500003562397206,TRX_N-00437-91895344,2023-02-01T09:45:34,Amurrio,incomes,salary_partner,3979.27,64406.91
buyer_3,Ana,,1989-08-23,ES60209500003562397206,TRX_N-00438-51630928,2023-02-04T19:53:23,Amurrio,expenses,mortgage,-1069.75,63337.16
buyer_3,Ana,,1989-08-23,ES60209500003562397206,TRX_N-00439-37807678,2023-02-07T08:13:33,Amurrio,expenses,food,-61.0,63276.16
buyer_3,Ana,,1989-08-23,ES60209500003562397206,TRX_N-00440-85326842,2023-02-07T17:24:26,Getxo,expenses,cash,-100.0,63176.16
buyer_3,Ana,,1989-08-23,ES60209500003562397206,TRX_N-00441-67139103,2023-02-08T11:49:13,Amurrio,expenses,electricity,-36.27,63139.89
buyer_3,Ana,,1989-08-23,ES60209500003562397206,TRX_N-00442-88165922,2023-02-08T14:39:22,Amurrio,expenses,water,-29.52,63110.37
buyer_3,Ana,,1989-08-23,ES60209500003562397206,TRX_N-00443-34504057,2023-02-08T20:19:48,Amurrio,expenses,gas,-108.31,63002.06
buyer_3,Ana,,1989-08-23,ES60209500003562397206,TRX_N-00444-62359392,2023-02-08T09:49:02,Amurrio,expenses,internet,-42.0,62960.06
buyer_3,Ana,,1989-08-23,ES60209500003562397206,TRX_N-00445-99720163,2023-02-08T10:16:27,Amurrio,expenses,phone,-31.48,62928.58
buyer_3,Ana,,1989-08-23,ES60209500003562397206,TRX_N-00446-41297240,2023-02-08T13:54:38,Amurrio,expenses,transport,-89.46,62839.12
buyer_3,Ana,,1989-08-23,ES60209500003562397206,TRX_N-00447-94557459,2023-02-08T22:05:29,Amurrio,expenses,leisure,-58.73,62780.39
buyer_3,Ana,,1989-08-23,ES60209500003562397206,TRX_N-00448-84813688,2023-02-09T09:59:36,Portugalete,expenses,appliances,-177.88,62602.51
buyer_3,Ana,,1989-08-23,ES60209500003562397206,TRX_N-00449-17949782,2023-02-11T19:56:36,Amurrio,expenses,healthcare,-158.93,62443.58
buyer_3,Ana,,1989-08-23,ES60209500003562397206,TRX_N-00450-19509099,2023-02-12T17:44:38,Amurrio,expenses,food,-61.71,62381.87
buyer_3,Ana,,1989-08-23,ES60209500003562397206,TRX_N-00451-84028237,2023-02-13T13:02:45,Amurrio,expenses,food,-123.39,62258.48
buyer_3,Ana,,1989-08-23,ES60209500003562397206,TRX_N-00452-49865216,2023-02-13T09:09:45,Amurrio,expenses,gifts,-102.56,62155.92
buyer_3,Ana,,1989-08-23,ES60209500003562397206,TRX_N-00453-56746013,2023-02-15T16:17:27,Amurrio,expenses,leisure,-35.17,62120.75
buyer_3,Ana,,1989-08-23,ES60209500003562397206,TRX_N-00454-45585529,2023-02-15T17:44:57,Amurrio,expenses,cash,-100.0,62020.75
buyer_3,Ana,,1989-08-23,ES60209500003562397206,TRX_N-00455-08750963,2023-02-16T08:31:36,Amurrio,expenses,gifts,-99.72,61921.03
buyer_3,Ana,,1989-08-23,ES60209500003562397206,TRX_N-00456-40941628,2023-02-20T08:03:38,Amurrio,expenses,healthcare,-78.23,61842.8
buyer_3,Ana,,1989-08-23,ES60209500003562397206,TRX_N-00457-47146358,2023-02-21T21:39:42,Amurrio,expenses,cash,-100.0,61742.8
buyer_3,Ana,,1989-08-23,ES60209500003562397206,TRX_N-00458-94884672,2023-02-21T13:37:12,Amurrio,expenses,gifts,-303.42,61439.38
buyer_3,Ana,,1989-08-23,ES60209500003562397206,TRX_N-00459-71018639,2023-02-23T12:07:01,Amurrio,expenses,transport,-51.35,61388.03
buyer_3,Ana,,1989-08-23,ES60209500003562397206,TRX_N-00460-64332039,2023-02-24T11:57:32,Amurrio,expenses,food,-86.09,61301.94
buyer_3,Ana,,1989-08-23,ES60209500003562397206,TRX_N-00461-91762965,2023-02-25T09:43:01,Amurrio,expenses,food,-96.67,61205.27
buyer_3,Ana,,1989-08-23,ES60209500003562397206,TRX_N-00462-35640471,2023-03-01T18:49:29,Amurrio,incomes,salary,3674.41,64879.68
buyer_3,Ana,,1989-08-23,ES60209500003562397206,TRX_N-00463-39320588,2023-03-01T18:49:29,Amurrio,incomes,salary_partner,3979.27,68858.95
buyer_3,Ana,,1989-08-23,ES60209500003562397206,TRX_N-00464-77598970,2023-03-01T20:13:21,Amurrio,expenses,cash,-100.0,68758.95
buyer_3,Ana,,1989-08-23,ES60209500003562397206,TRX_N-00465-17170974,2023-03-04T17:51:43,Amurrio,expenses,mortgage,-1069.75,67689.2
buyer_3,Ana,,1989-08-23,ES60209500003562397206,TRX_N-00466-69454966,2023-03-04T15:55:09,Amurrio,expenses,food,-70.46,67618.74
buyer_3,Ana,,1989-08-23,ES60209500003562397206,TRX_N-00467-35871928,2023-03-04T15:47:57,Amurrio,expenses,leisure,-39.53,67579.21
buyer_3,Ana,,1989-08-23,ES60209500003562397206,TRX_N-00468-68948411,2023-03-04T16:28:44,Amurrio,expenses,cash,-100.0,67479.21
buyer_3,Ana,,1989-08-23,ES60209500003562397206,TRX_N-00469-60090308,2023-03-05T13:49:52,Amurrio,expenses,electricity,-69.59,67409.62
buyer_3,Ana,,1989-08-23,ES60209500003562397206,TRX_N-00470-94877995,2023-03-05T09:28:21,Amurrio,expenses,gas,-34.41,67375.21
buyer_3,Ana,,1989-08-23,ES60209500003562397206,TRX_N-00471-64599975,2023-03-05T17:14:56,Amurrio,expenses,food,-123.95,67251.26
buyer_3,Ana,,1989-08-23,ES60209500003562397206,TRX_N-00472-84207549,2023-03-05T16:14:08,Sopela,expenses,healthcare,-169.09,67082.17
buyer_3,Ana,,1989-08-23,ES60209500003562397206,TRX_N-00473-66520751,2023-03-07T08:05:45,Amurrio,expenses,water,-41.24,67040.93
buyer_3,Ana,,1989-08-23,ES60209500003562397206,TRX_N-00474-97595398,2023-03-07T12:29:50,Amurrio,expenses,food,-93.25,66947.68
buyer_3,Ana,,1989-08-23,ES60209500003562397206,TRX_N-00475-35663917,2023-03-07T22:33:06,Amurrio,expenses,gifts,-65.6,66882.08
buyer_3,Ana,,1989-08-23,ES60209500003562397206,TRX_N-00476-64787604,2023-03-08T19:40:49,Amurrio,expenses,internet,-42.0,66840.08
buyer_3,Ana,,1989-08-23,ES60209500003562397206,TRX_N-00477-69387490,2023-03-08T12:06:23,Amurrio,expenses,phone,-40.3,66799.78
buyer_3,Ana,,1989-08-23,ES60209500003562397206,TRX_N-00478-39012250,2023-03-08T20:54:00,Amurrio,expenses,leisure,-56.6,66743.18
buyer_3,Ana,,1989-08-23,ES60209500003562397206,TRX_N-00479-65754106,2023-03-09T16:10:22,Amurrio,expenses,gifts,-731.5,66011.68
buyer_3,Ana,,1989-08-23,ES60209500003562397206,TRX_N-00480-49928900,2023-03-11T10:19:25,Amurrio,expenses,cash,-100.0,65911.68
buyer_3,Ana,,1989-08-23,ES60209500003562397206,TRX_N-00481-31871849,2023-03-14T01:13:43,Amurrio,expenses,transport,-52.64,65859.04
buyer_3,Ana,,1989-08-23,ES60209500003562397206,TRX_N-00482-72355149,2023-03-15T08:02:22,Pasaia,expenses,education,-75.32,65783.72
buyer_3,Ana,,1989-08-23,ES60209500003562397206,TRX_N-00483-18105949,2023-03-15T10:38:12,Amurrio,expenses,cash,-100.0,65683.72
buyer_3,Ana,,1989-08-23,ES60209500003562397206,TRX_N-00484-99747803,2023-03-18T20:27:41,Amurrio,expenses,food,-73.19,65610.53
buyer_3,Ana,,1989-08-23,ES60209500003562397206,TRX_N-00485-62534304,2023-03-20T16:54:52,Amurrio,expenses,clothing,-111.2,65499.33
buyer_3,Ana,,1989-08-23,ES60209500003562397206,TRX_N-00486-79950158,2023-03-21T08:39:52,Amurrio,expenses,transport,-42.63,65456.7
buyer_3,Ana,,1989-08-23,ES60209500003562397206,TRX_N-00487-84212659,2023-03-22T13:16:44,Donostia,expenses,cash,-100.0,65356.7
buyer_3,Ana,,1989-08-23,ES60209500003562397206,TRX_N-00488-99330911,2023-03-23T23:23:30,Amurrio,expenses,gifts,-46.92,65309.78
buyer_3,Ana,,1989-08-23,ES60209500003562397206,TRX_N-00489-80489458,2023-03-24T20:37:13,Amurrio,expenses,cash,-100.0,65209.78
buyer_3,Ana,,1989-08-23,ES60209500003562397206,TRX_N-00490-52458872,2023-03-25T14:53:58,Donostia,expenses,cash,-100.0,65109.78
buyer_3,Ana,,1989-08-23,ES60209500003562397206,TRX_N-00491-73529555,2023-03-26T14:50:39,Amurrio,expenses,cash,-100.0,65009.78
buyer_3,Ana,,1989-08-23,ES60209500003562397206,TRX_N-00492-91101488,2023-03-28T13:05:56,Amurrio,expenses,transport,-69.53,64940.25
buyer_3,Ana,,1989-08-23,ES60209500003562397206,TRX_N-00493-13017902,2023-03-28T14:28:43,Amurrio,expenses,healthcare,-142.07,64798.18
buyer_3,Ana,,1989-08-23,ES60209500003562397206,TRX_N-00494-65105978,2023-03-28T15:24:20,Amurrio,expenses,appliances,-187.42,64610.76
buyer_3,Ana,,1989-08-23,ES60209500003562397206,TRX_N-00495-88399017,2023-03-29T16:51:39,Amurrio,expenses,transport,-43.78,64566.98
buyer_3,Ana,,1989-08-23,ES60209500003562397206,TRX_N-00496-91382829,2023-04-01T15:15:52,Amurrio,incomes,salary,3674.41,68241.39
buyer_3,Ana,,1989-08-23,ES60209500003562397206,TRX_N-00497-78911386,2023-04-01T15:15:52,Amurrio,incomes,salary_partner,3979.27,72220.66
buyer_3,Ana,,1989-08-23,ES60209500003562397206,TRX_N-00498-85120215,2023-04-01T09:19:30,Portugalete,expenses,leisure,-66.73,72153.93
buyer_3,Ana,,1989-08-23,ES60209500003562397206,TRX_N-00499-92459352,2023-04-02T18:43:56,Amurrio,expenses,cash,-100.0,72053.93
buyer_3,Ana,,1989-08-23,ES60209500003562397206,TRX_N-00500-02556929,2023-04-03T12:53:07,Arrasate,expenses,repairs,-261.22,71792.71
buyer_3,Ana,,1989-08-23,ES60209500003562397206,TRX_N-00501-57357864,2023-04-03T02:13:10,Amurrio,expenses,gifts,-30.89,71761.82
buyer_3,Ana,,1989-08-23,ES60209500003562397206,TRX_N-00502-28982120,2023-04-04T11:03:54,Amurrio,expenses,mortgage,-1069.75,70692.07
buyer_3,Ana,,1989-08-23,ES60209500003562397206,TRX_N-00503-13822838,2023-04-04T20:38:52,Amurrio,expenses,leisure,-45.41,70646.66
buyer_3,Ana,,1989-08-23,ES60209500003562397206,TRX_N-00504-68052702,2023-04-05T18:14:35,Amurrio,expenses,phone,-40.26,70606.4
buyer_3,Ana,,1989-08-23,ES60209500003562397206,TRX_N-00505-04961445,2023-04-06T18:36:30,Amurrio,expenses,education,-52.57,70553.83
buyer_3,Ana,,1989-08-23,ES60209500003562397206,TRX_N-00506-98298475,2023-04-06T18:12:47,Amurrio,expenses,cash,-100.0,70453.83
buyer_3,Ana,,1989-08-23,ES60209500003562397206,TRX_N-00507-72027969,2023-04-06T19:10:09,Amurrio,expenses,car,-145.26,70308.57
buyer_3,Ana,,1989-08-23,ES60209500003562397206,TRX_N-00508-33212363,2023-04-07T11:46:41,Amurrio,expenses,water,-42.4,70266.17
buyer_3,Ana,,1989-08-23,ES60209500003562397206,TRX_N-00509-67762609,2023-04-07T13:39:36,Amurrio,expenses,gas,-84.78,70181.39
buyer_3,Ana,,1989-08-23,ES60209500003562397206,TRX_N-00510-11914757,2023-04-07T17:03:39,Amurrio,expenses,internet,-42.0,70139.39
buyer_3,Ana,,1989-08-23,ES60209500003562397206,TRX_N-00511-66605805,2023-04-07T13:19:32,Amurrio,expenses,appliances,-320.9,69818.49
buyer_3,Ana,,1989-08-23,ES60209500003562397206,TRX_N-00512-59335842,2023-04-08T16:36:48,Amurrio,expenses,electricity,-43.31,69775.18
buyer_3,Ana,,1989-08-23,ES60209500003562397206,TRX_N-00513-33589096,2023-04-10T18:53:29,Vitoria-Gasteiz,expenses,leisure,-18.43,69756.75
buyer_3,Ana,,1989-08-23,ES60209500003562397206,TRX_N-00514-72758428,2023-04-12T16:32:38,Amurrio,expenses,cash,-100.0,69656.75
buyer_3,Ana,,1989-08-23,ES60209500003562397206,TRX_N-00515-42736001,2023-04-15T18:06:42,Amurrio,expenses,food,-80.87,69575.88
buyer_3,Ana,,1989-08-23,ES60209500003562397206,TRX_N-00516-37329781,2023-04-15T20:44:48,Amurrio,expenses,healthcare,-113.94,69461.94
buyer_3,Ana,,1989-08-23,ES60209500003562397206,TRX_N-00517-90730589,2023-04-15T10:47:46,Amurrio,expenses,repairs,-327.91,69134.03
buyer_3,Ana,,1989-08-23,ES60209500003562397206,TRX_N-00518-18827865,2023-04-16T12:31:33,Amurrio,expenses,leisure,-37.94,69096.09
buyer_3,Ana,,1989-08-23,ES60209500003562397206,TRX_N-00519-58159781,2023-04-16T18:19:25,Llodio,expenses,repairs,-293.11,68802.98
buyer_3,Ana,,1989-08-23,ES60209500003562397206,TRX_N-00520-80976829,2023-04-18T16:45:12,Amurrio,expenses,cash,-100.0,68702.98
buyer_3,Ana,,1989-08-23,ES60209500003562397206,TRX_N-00521-24129766,2023-04-20T18:27:09,Amurrio,expenses,leisure,-45.02,68657.96
buyer_3,Ana,,1989-08-23,ES60209500003562397206,TRX_N-00522-65373979,2023-04-23T11:24:49,Amurrio,expenses,food,-119.3,68538.66
buyer_3,Ana,,1989-08-23,ES60209500003562397206,TRX_N-00523-74518507,2023-04-25T13:31:23,Amurrio,expenses,food,-83.95,68454.71
buyer_3,Ana,,1989-08-23,ES60209500003562397206,TRX_N-00524-10753857,2023-04-26T20:58:05,Amurrio,expenses,healthcare,-162.47,68292.24
buyer_3,Ana,,1989-08-23,ES60209500003562397206,TRX_N-00525-88579071,2023-04-26T13:00:52,Amurrio,expenses,education,-66.56,68225.68
buyer_3,Ana,,1989-08-23,ES60209500003562397206,TRX_N-00526-22527386,2023-04-28T12:21:23,Amurrio,expenses,transport,-58.83,68166.85
buyer_3,Ana,,1989-08-23,ES60209500003562397206,TRX_N-00527-74545479,2023-04-29T08:49:55,Oy√≥n-Oion,expenses,transport,-40.48,68126.37
buyer_3,Ana,,1989-08-23,ES60209500003562397206,TRX_N-00528-58267043,2023-04-30T14:12:22,Amurrio,expenses,clothing,-65.02,68061.35
buyer_3,Ana,,1989-08-23,ES60209500003562397206,TRX_N-00529-09955692,2023-04-30T10:58:47,Amurrio,expenses,repairs,-101.64,67959.71
buyer_3,Ana,,1989-08-23,ES60209500003562397206,TRX_N-00530-92102668,2023-05-01T02:16:02,Amurrio,incomes,salary,3674.41,71634.12
buyer_3,Ana,,1989-08-23,ES60209500003562397206,TRX_N-00531-76730527,2023-05-01T02:16:02,Amurrio,incomes,salary_partner,3979.27,75613.39
buyer_3,Ana,,1989-08-23,ES60209500003562397206,TRX_N-00532-41051655,2023-05-01T02:16:02,Amurrio,incomes,extra_income,437.39,76050.78
buyer_3,Ana,,1989-08-23,ES60209500003562397206,TRX_N-00533-03847795,2023-05-01T09:11:55,Amurrio,expenses,travel,-1277.99,74772.79
buyer_3,Ana,,1989-08-23,ES60209500003562397206,TRX_N-00534-65489435,2023-05-02T05:36:29,Galdakao,expenses,leisure,-58.84,74713.95
buyer_3,Ana,,1989-08-23,ES60209500003562397206,TRX_N-00535-70812273,2023-05-03T00:00:12,Amurrio,expenses,healthcare,-124.26,74589.69
buyer_3,Ana,,1989-08-23,ES60209500003562397206,TRX_N-00536-93203329,2023-05-03T16:48:29,Amurrio,expenses,car,-280.28,74309.41
buyer_3,Ana,,1989-08-23,ES60209500003562397206,TRX_N-00537-05313288,2023-05-04T11:30:49,Amurrio,expenses,mortgage,-1069.75,73239.66
buyer_3,Ana,,1989-08-23,ES60209500003562397206,TRX_N-00538-54622915,2023-05-04T20:41:40,Amurrio,expenses,food,-88.73,73150.93
buyer_3,Ana,,1989-08-23,ES60209500003562397206,TRX_N-00539-94084393,2023-05-05T12:41:11,Amurrio,expenses,electricity,-59.26,73091.67
buyer_3,Ana,,1989-08-23,ES60209500003562397206,TRX_N-00540-15189441,2023-05-05T11:23:34,Amurrio,expenses,gas,-95.54,72996.13
buyer_3,Ana,,1989-08-23,ES60209500003562397206,TRX_N-00541-63226053,2023-05-05T19:31:16,Amurrio,expenses,food,-69.01,72927.12
buyer_3,Ana,,1989-08-23,ES60209500003562397206,TRX_N-00542-44918215,2023-05-05T03:17:31,Amurrio,expenses,transport,-80.52,72846.6
buyer_3,Ana,,1989-08-23,ES60209500003562397206,TRX_N-00543-42834989,2023-05-05T20:00:12,Hernani,expenses,repairs,-226.2,72620.4
buyer_3,Ana,,1989-08-23,ES60209500003562397206,TRX_N-00544-13373989,2023-05-06T10:53:11,Amurrio,expenses,transport,-76.07,72544.33
buyer_3,Ana,,1989-08-23,ES60209500003562397206,TRX_N-00545-79652715,2023-05-07T13:06:55,Amurrio,expenses,water,-44.13,72500.2
buyer_3,Ana,,1989-08-23,ES60209500003562397206,TRX_N-00546-23919295,2023-05-07T11:15:11,Amurrio,expenses,internet,-42.0,72458.2
buyer_3,Ana,,1989-08-23,ES60209500003562397206,TRX_N-00547-53344064,2023-05-07T17:23:17,Zarautz,expenses,food,-60.02,72398.18
buyer_3,Ana,,1989-08-23,ES60209500003562397206,TRX_N-00548-14247256,2023-05-07T09:24:17,Amurrio,expenses,transport,-40.19,72357.99
buyer_3,Ana,,1989-08-23,ES60209500003562397206,TRX_N-00549-51704529,2023-05-07T12:06:40,Amurrio,expenses,leisure,-50.69,72307.3
buyer_3,Ana,,1989-08-23,ES60209500003562397206,TRX_N-00550-94226111,2023-05-08T14:44:19,Amurrio,expenses,phone,-31.37,72275.93
buyer_3,Ana,,1989-08-23,ES60209500003562397206,TRX_N-00551-14642648,2023-05-11T06:35:34,Amurrio,expenses,transport,-89.96,72185.97
buyer_3,Ana,,1989-08-23,ES60209500003562397206,TRX_N-00552-28391750,2023-05-13T07:23:14,Amurrio,expenses,leisure,-53.87,72132.1
buyer_3,Ana,,1989-08-23,ES60209500003562397206,TRX_N-00553-99700180,2023-05-14T19:38:23,Amurrio,expenses,cash,-100.0,72032.1
buyer_3,Ana,,1989-08-23,ES60209500003562397206,TRX_N-00554-46249708,2023-05-16T16:10:31,Amurrio,expenses,food,-68.26,71963.84
buyer_3,Ana,,1989-08-23,ES60209500003562397206,TRX_N-00555-87732064,2023-05-17T16:06:25,Amurrio,expenses,transport,-79.09,71884.75
buyer_3,Ana,,1989-08-23,ES60209500003562397206,TRX_N-00556-01498034,2023-05-17T14:56:42,Amurrio,expenses,appliances,-366.88,71517.87
buyer_3,Ana,,1989-08-23,ES60209500003562397206,TRX_N-00557-70037009,2023-05-18T14:30:10,Salvatierra/Agurain,expenses,transport,-71.59,71446.28
buyer_3,Ana,,1989-08-23,ES60209500003562397206,TRX_N-00558-01743370,2023-05-19T11:22:52,Galdakao,expenses,clothing,-111.77,71334.51
buyer_3,Ana,,1989-08-23,ES60209500003562397206,TRX_N-00559-72048255,2023-05-26T04:31:44,Amurrio,expenses,food,-76.17,71258.34
buyer_3,Ana,,1989-08-23,ES60209500003562397206,TRX_N-00560-11593656,2023-05-26T17:16:59,Amurrio,expenses,transport,-88.7,71169.64
buyer_3,Ana,,1989-08-23,ES60209500003562397206,TRX_N-00561-03711244,2023-05-26T17:50:19,Arrasate,expenses,repairs,-67.03,71102.61
buyer_3,Ana,,1989-08-23,ES60209500003562397206,TRX_N-00562-06826878,2023-05-31T07:50:22,Llodio,expenses,education,-50.29,71052.32
buyer_3,Ana,,1989-08-23,ES60209500003562397206,TRX_N-00563-61609645,2023-05-31T08:33:26,Amurrio,expenses,cash,-100.0,70952.32
buyer_3,Ana,,1989-08-23,ES60209500003562397206,TRX_N-00564-02002917,2023-06-01T01:42:57,Amurrio,incomes,salary,3674.41,74626.73
buyer_3,Ana,,1989-08-23,ES60209500003562397206,TRX_N-00565-63735120,2023-06-01T01:42:57,Amurrio,incomes,salary_partner,3979.27,78606.0
buyer_3,Ana,,1989-08-23,ES60209500003562397206,TRX_N-00566-95721969,2023-06-01T01:42:57,Amurrio,incomes,salary_bonus,2687.58,81293.58
buyer_3,Ana,,1989-08-23,ES60209500003562397206,TRX_N-00567-93114747,2023-06-01T01:42:57,Amurrio,incomes,salary_partner_bonus,3095.83,84389.41
buyer_3,Ana,,1989-08-23,ES60209500003562397206,TRX_N-00568-34269235,2023-06-01T08:41:15,Amurrio,expenses,food,-106.09,84283.32
buyer_3,Ana,,1989-08-23,ES60209500003562397206,TRX_N-00569-61445715,2023-06-01T14:05:56,Amurrio,expenses,leisure,-27.48,84255.84
buyer_3,Ana,,1989-08-23,ES60209500003562397206,TRX_N-00570-55182297,2023-06-01T13:30:15,Amurrio,expenses,gifts,-837.53,83418.31
buyer_3,Ana,,1989-08-23,ES60209500003562397206,TRX_N-00571-28672213,2023-06-03T15:54:53,Amurrio,expenses,gifts,-31.79,83386.52
buyer_3,Ana,,1989-08-23,ES60209500003562397206,TRX_N-00572-77181733,2023-06-04T02:37:27,Amurrio,expenses,mortgage,-1069.75,82316.77
buyer_3,Ana,,1989-08-23,ES60209500003562397206,TRX_N-00573-69318425,2023-06-04T12:11:34,Amurrio,expenses,healthcare,-81.92,82234.85
buyer_3,Ana,,1989-08-23,ES60209500003562397206,TRX_N-00574-56306714,2023-06-04T15:33:31,Amurrio,expenses,cash,-100.0,82134.85
buyer_3,Ana,,1989-08-23,ES60209500003562397206,TRX_N-00575-58479792,2023-06-06T16:03:01,Amurrio,expenses,electricity,-86.73,82048.12
buyer_3,Ana,,1989-08-23,ES60209500003562397206,TRX_N-00576-22399302,2023-06-06T05:41:34,Amurrio,expenses,gas,-71.83,81976.29
buyer_3,Ana,,1989-08-23,ES60209500003562397206,TRX_N-00577-58662579,2023-06-06T11:29:10,Amurrio,expenses,phone,-43.35,81932.94
buyer_3,Ana,,1989-08-23,ES60209500003562397206,TRX_N-00578-90086092,2023-06-07T18:49:41,Amurrio,expenses,water,-25.88,81907.06
buyer_3,Ana,,1989-08-23,ES60209500003562397206,TRX_N-00579-77900674,2023-06-07T23:03:09,Amurrio,expenses,leisure,-60.76,81846.3
buyer_3,Ana,,1989-08-23,ES60209500003562397206,TRX_N-00580-43356173,2023-06-08T14:40:07,Amurrio,expenses,internet,-42.0,81804.3
buyer_3,Ana,,1989-08-23,ES60209500003562397206,TRX_N-00581-82695251,2023-06-08T14:33:00,Amurrio,expenses,leisure,-81.56,81722.74
buyer_3,Ana,,1989-08-23,ES60209500003562397206,TRX_N-00582-60081920,2023-06-08T12:29:36,Amurrio,expenses,travel,-1512.06,80210.68
buyer_3,Ana,,1989-08-23,ES60209500003562397206,TRX_N-00583-24385588,2023-06-10T16:19:46,Amurrio,expenses,transport,-88.05,80122.63
buyer_3,Ana,,1989-08-23,ES60209500003562397206,TRX_N-00584-66819348,2023-06-10T06:10:44,Erandio,expenses,leisure,-78.26,80044.37
buyer_3,Ana,,1989-08-23,ES60209500003562397206,TRX_N-00585-01455032,2023-06-11T18:07:25,Amurrio,expenses,cash,-100.0,79944.37
buyer_3,Ana,,1989-08-23,ES60209500003562397206,TRX_N-00586-98109846,2023-06-12T02:42:25,Amurrio,expenses,transport,-69.71,79874.66
buyer_3,Ana,,1989-08-23,ES60209500003562397206,TRX_N-00587-97356731,2023-06-12T12:31:15,Amurrio,expenses,leisure,-29.95,79844.71
buyer_3,Ana,,1989-08-23,ES60209500003562397206,TRX_N-00588-42376255,2023-06-12T19:18:27,Amurrio,expenses,gifts,-349.23,79495.48
buyer_3,Ana,,1989-08-23,ES60209500003562397206,TRX_N-00589-41673780,2023-06-15T12:20:37,Alegr√≠a-Dulantzi,expenses,education,-42.91,79452.57
buyer_3,Ana,,1989-08-23,ES60209500003562397206,TRX_N-00590-71739076,2023-06-15T08:28:07,Amurrio,expenses,repairs,-249.29,79203.28
buyer_3,Ana,,1989-08-23,ES60209500003562397206,TRX_N-00591-18748864,2023-06-16T13:30:25,Amurrio,expenses,food,-72.1,79131.18
buyer_3,Ana,,1989-08-23,ES60209500003562397206,TRX_N-00592-41651170,2023-06-18T18:41:22,Amurrio,expenses,food,-122.36,79008.82
buyer_3,Ana,,1989-08-23,ES60209500003562397206,TRX_N-00593-55720796,2023-06-18T09:01:07,Amurrio,expenses,leisure,-79.51,78929.31
buyer_3,Ana,,1989-08-23,ES60209500003562397206,TRX_N-00594-51498635,2023-06-18T22:58:59,Amurrio,expenses,clothing,-95.74,78833.57
buyer_3,Ana,,1989-08-23,ES60209500003562397206,TRX_N-00595-84554241,2023-06-21T20:02:36,Amurrio,expenses,gifts,-616.29,78217.28
buyer_3,Ana,,1989-08-23,ES60209500003562397206,TRX_N-00596-71427049,2023-06-27T15:59:49,Amurrio,expenses,food,-79.42,78137.86
buyer_3,Ana,,1989-08-23,ES60209500003562397206,TRX_N-00597-50433555,2023-06-28T10:48:27,Amurrio,expenses,transport,-59.24,78078.62
buyer_3,Ana,,1989-08-23,ES60209500003562397206,TRX_N-00598-41367485,2023-06-28T02:05:27,Amurrio,expenses,cash,-100.0,77978.62
buyer_3,Ana,,1989-08-23,ES60209500003562397206,TRX_N-00599-91854712,2023-06-28T17:29:49,Amurrio,expenses,repairs,-328.83,77649.79
buyer_3,Ana,,1989-08-23,ES60209500003562397206,TRX_N-00600-86826627,2023-06-30T16:28:45,Amurrio,expenses,leisure,-39.17,77610.62
buyer_3,Ana,,1989-08-23,ES60209500003562397206,TRX_N-00601-10082279,2023-06-30T09:05:17,Amurrio,expenses,cash,-100.0,77510.62
buyer_3,Ana,,1989-08-23,ES60209500003562397206,TRX_N-00602-28005547,2023-06-30T10:00:25,Amurrio,expenses,gifts,-151.43,77359.19
buyer_3,Ana,,1989-08-23,ES60209500003562397206,TRX_N-00603-88237266,2023-07-01T20:43:29,Amurrio,incomes,salary,3674.41,81033.6
buyer_3,Ana,,1989-08-23,ES60209500003562397206,TRX_N-00604-87187260,2023-07-01T20:43:29,Amurrio,incomes,salary_partner,3979.27,85012.87
buyer_3,Ana,,1989-08-23,ES60209500003562397206,TRX_N-00605-14990842,2023-07-01T11:46:43,Amurrio,expenses,clothing,-122.36,84890.51
buyer_3,Ana,,1989-08-23,ES60209500003562397206,TRX_N-00606-68390552,2023-07-01T20:07:50,Amurrio,expenses,repairs,-63.84,84826.67
buyer_3,Ana,,1989-08-23,ES60209500003562397206,TRX_N-00607-63682645,2023-07-02T15:16:35,Amurrio,expenses,food,-113.25,84713.42
buyer_3,Ana,,1989-08-23,ES60209500003562397206,TRX_N-00608-74913198,2023-07-02T18:05:28,Amurrio,expenses,leisure,-54.81,84658.61
buyer_3,Ana,,1989-08-23,ES60209500003562397206,TRX_N-00609-54780490,2023-07-02T20:55:19,Amurrio,expenses,gifts,-68.54,84590.07
buyer_3,Ana,,1989-08-23,ES60209500003562397206,TRX_N-00610-69731543,2023-07-04T04:18:31,Amurrio,expenses,mortgage,-1069.75,83520.32
buyer_3,Ana,,1989-08-23,ES60209500003562397206,TRX_N-00611-16553584,2023-07-04T20:48:10,Amurrio,expenses,cash,-100.0,83420.32
buyer_3,Ana,,1989-08-23,ES60209500003562397206,TRX_N-00612-92313819,2023-07-04T11:41:34,Amurrio,expenses,repairs,-190.59,83229.73
buyer_3,Ana,,1989-08-23,ES60209500003562397206,TRX_N-00613-42290790,2023-07-05T17:13:17,Amurrio,expenses,gas,-109.23,83120.5
buyer_3,Ana,,1989-08-23,ES60209500003562397206,TRX_N-00614-53016543,2023-07-06T11:28:07,Salvatierra/Agurain,expenses,food,-106.48,83014.02
buyer_3,Ana,,1989-08-23,ES60209500003562397206,TRX_N-00615-50662908,2023-07-06T12:21:54,Amurrio,expenses,leisure,-61.05,82952.97
buyer_3,Ana,,1989-08-23,ES60209500003562397206,TRX_N-00616-57936632,2023-07-06T15:22:17,Amurrio,expenses,healthcare,-177.59,82775.38
buyer_3,Ana,,1989-08-23,ES60209500003562397206,TRX_N-00617-65062462,2023-07-06T20:23:54,Vitoria-Gasteiz,expenses,education,-43.12,82732.26
buyer_3,Ana,,1989-08-23,ES60209500003562397206,TRX_N-00618-37683800,2023-07-07T09:16:48,Sestao,expenses,healthcare,-120.81,82611.45
buyer_3,Ana,,1989-08-23,ES60209500003562397206,TRX_N-00619-11415562,2023-07-07T08:27:33,Amurrio,expenses,cash,-100.0,82511.45
buyer_3,Ana,,1989-08-23,ES60209500003562397206,TRX_N-00620-53339481,2023-07-08T08:13:02,Amurrio,expenses,water,-38.68,82472.77
buyer_3,Ana,,1989-08-23,ES60209500003562397206,TRX_N-00621-41127250,2023-07-08T10:31:56,Amurrio,expenses,electricity,-29.26,82443.51
buyer_3,Ana,,1989-08-23,ES60209500003562397206,TRX_N-00622-77368607,2023-07-08T08:55:06,Amurrio,expenses,internet,-42.0,82401.51
buyer_3,Ana,,1989-08-23,ES60209500003562397206,TRX_N-00623-06392080,2023-07-08T23:36:28,Amurrio,expenses,phone,-37.9,82363.61
buyer_3,Ana,,1989-08-23,ES60209500003562397206,TRX_N-00624-15636196,2023-07-08T11:04:25,Labastida,expenses,food,-99.84,82263.77
buyer_3,Ana,,1989-08-23,ES60209500003562397206,TRX_N-00625-29036857,2023-07-09T18:32:57,Amurrio,expenses,gifts,-499.51,81764.26
buyer_3,Ana,,1989-08-23,ES60209500003562397206,TRX_N-00626-48148442,2023-07-10T09:37:18,Amurrio,expenses,leisure,-31.51,81732.75
buyer_3,Ana,,1989-08-23,ES60209500003562397206,TRX_N-00627-15120701,2023-07-11T13:08:23,Amurrio,expenses,cash,-100.0,81632.75
buyer_3,Ana,,1989-08-23,ES60209500003562397206,TRX_N-00628-97939746,2023-07-13T10:37:05,Amurrio,expenses,leisure,-67.37,81565.38
buyer_3,Ana,,1989-08-23,ES60209500003562397206,TRX_N-00629-75459441,2023-07-13T16:47:50,Santurtzi,expenses,clothing,-79.19,81486.19
buyer_3,Ana,,1989-08-23,ES60209500003562397206,TRX_N-00630-96763463,2023-07-14T18:46:33,Amurrio,expenses,food,-104.59,81381.6
buyer_3,Ana,,1989-08-23,ES60209500003562397206,TRX_N-00631-74506176,2023-07-15T17:00:58,Amurrio,expenses,cash,-100.0,81281.6
buyer_3,Ana,,1989-08-23,ES60209500003562397206,TRX_N-00632-92917468,2023-07-16T06:39:58,Amurrio,expenses,food,-103.48,81178.12
buyer_3,Ana,,1989-08-23,ES60209500003562397206,TRX_N-00633-36282227,2023-07-17T10:44:37,Amurrio,expenses,appliances,-143.31,81034.81
buyer_3,Ana,,1989-08-23,ES60209500003562397206,TRX_N-00634-58175434,2023-07-21T20:11:31,Amurrio,expenses,education,-62.0,80972.81
buyer_3,Ana,,1989-08-23,ES60209500003562397206,TRX_N-00635-80794113,2023-07-24T23:29:30,Getxo,expenses,food,-120.38,80852.43
buyer_3,Ana,,1989-08-23,ES60209500003562397206,TRX_N-00636-62980507,2023-07-24T22:59:07,Amurrio,expenses,leisure,-80.44,80771.99
buyer_3,Ana,,1989-08-23,ES60209500003562397206,TRX_N-00637-90817079,2023-07-24T21:00:22,Amurrio,expenses,cash,-100.0,80671.99
buyer_3,Ana,,1989-08-23,ES60209500003562397206,TRX_N-00638-98617794,2023-07-26T16:11:37,Amurrio,expenses,leisure,-30.0,80641.99
buyer_3,Ana,,1989-08-23,ES60209500003562397206,TRX_N-00639-37985339,2023-07-28T18:31:14,Amurrio,expenses,transport,-74.13,80567.86
buyer_3,Ana,,1989-08-23,ES60209500003562397206,TRX_N-00640-27514248,2023-07-29T22:46:29,Amurrio,expenses,gifts,-763.42,79804.44
buyer_3,Ana,,1989-08-23,ES60209500003562397206,TRX_N-00641-11529883,2023-07-30T17:21:17,Amurrio,expenses,transport,-73.54,79730.9
buyer_3,Ana,,1989-08-23,ES60209500003562397206,TRX_N-00642-94762716,2023-08-01T09:26:21,Amurrio,incomes,salary,3674.41,83405.31
buyer_3,Ana,,1989-08-23,ES60209500003562397206,TRX_N-00643-88233066,2023-08-01T09:26:21,Amurrio,incomes,salary_partner,3979.27,87384.58
buyer_3,Ana,,1989-08-23,ES60209500003562397206,TRX_N-00644-13823221,2023-08-01T09:26:21,Amurrio,incomes,extra_income,437.39,87821.97
buyer_3,Ana,,1989-08-23,ES60209500003562397206,TRX_N-00645-63146018,2023-08-02T17:23:32,Amurrio,expenses,food,-92.65,87729.32
buyer_3,Ana,,1989-08-23,ES60209500003562397206,TRX_N-00646-84440182,2023-08-04T16:02:00,Amurrio,expenses,mortgage,-1069.75,86659.57
buyer_3,Ana,,1989-08-23,ES60209500003562397206,TRX_N-00647-59706764,2023-08-04T21:13:28,Amurrio,expenses,cash,-100.0,86559.57
buyer_3,Ana,,1989-08-23,ES60209500003562397206,TRX_N-00648-30810691,2023-08-04T20:11:20,Amurrio,expenses,appliances,-371.8,86187.77
buyer_3,Ana,,1989-08-23,ES60209500003562397206,TRX_N-00649-38758992,2023-08-06T19:45:46,Amurrio,expenses,water,-28.38,86159.39
buyer_3,Ana,,1989-08-23,ES60209500003562397206,TRX_N-00650-71516242,2023-08-06T10:11:42,Amurrio,expenses,leisure,-34.54,86124.85
buyer_3,Ana,,1989-08-23,ES60209500003562397206,TRX_N-00651-25160563,2023-08-06T11:42:33,Hernani,expenses,clothing,-109.84,86015.01
buyer_3,Ana,,1989-08-23,ES60209500003562397206,TRX_N-00652-96867919,2023-08-07T20:40:31,Amurrio,expenses,gas,-83.5,85931.51
buyer_3,Ana,,1989-08-23,ES60209500003562397206,TRX_N-00653-58248085,2023-08-07T13:18:42,Vitoria-Gasteiz,expenses,food,-70.87,85860.64
buyer_3,Ana,,1989-08-23,ES60209500003562397206,TRX_N-00654-01545900,2023-08-08T18:01:41,Amurrio,expenses,internet,-42.0,85818.64
buyer_3,Ana,,1989-08-23,ES60209500003562397206,TRX_N-00655-55725335,2023-08-08T14:25:34,Amurrio,expenses,electricity,-70.96,85747.68
buyer_3,Ana,,1989-08-23,ES60209500003562397206,TRX_N-00656-33033245,2023-08-08T09:05:59,Amurrio,expenses,phone,-39.14,85708.54
buyer_3,Ana,,1989-08-23,ES60209500003562397206,TRX_N-00657-43575519,2023-08-08T13:57:08,Amurrio,expenses,education,-73.42,85635.12
buyer_3,Ana,,1989-08-23,ES60209500003562397206,TRX_N-00658-13035865,2023-08-09T16:33:48,Pasaia,expenses,transport,-80.22,85554.9
buyer_3,Ana,,1989-08-23,ES60209500003562397206,TRX_N-00659-34479520,2023-08-09T10:36:10,Amurrio,expenses,leisure,-48.36,85506.54
buyer_3,Ana,,1989-08-23,ES60209500003562397206,TRX_N-00660-78179607,2023-08-11T20:22:06,Amurrio,expenses,transport,-75.74,85430.8
buyer_3,Ana,,1989-08-23,ES60209500003562397206,TRX_N-00661-65721174,2023-08-12T11:23:17,Amurrio,expenses,food,-102.78,85328.02
buyer_3,Ana,,1989-08-23,ES60209500003562397206,TRX_N-00662-26982826,2023-08-12T21:50:25,Amurrio,expenses,leisure,-34.71,85293.31
buyer_3,Ana,,1989-08-23,ES60209500003562397206,TRX_N-00663-76026134,2023-08-12T08:58:10,Amurrio,expenses,clothing,-59.94,85233.37
buyer_3,Ana,,1989-08-23,ES60209500003562397206,TRX_N-00664-12441786,2023-08-13T09:57:55,Amurrio,expenses,repairs,-287.46,84945.91
buyer_3,Ana,,1989-08-23,ES60209500003562397206,TRX_N-00665-83945044,2023-08-14T06:04:16,Amurrio,expenses,leisure,-61.99,84883.92
buyer_3,Ana,,1989-08-23,ES60209500003562397206,TRX_N-00666-05389852,2023-08-14T13:59:19,Amurrio,expenses,clothing,-78.72,84805.2
buyer_3,Ana,,1989-08-23,ES60209500003562397206,TRX_N-00667-38560002,2023-08-15T14:02:49,Salvatierra/Agurain,expenses,food,-69.55,84735.65
buyer_3,Ana,,1989-08-23,ES60209500003562397206,TRX_N-00668-84084051,2023-08-16T16:34:09,Amurrio,expenses,food,-112.01,84623.64
buyer_3,Ana,,1989-08-23,ES60209500003562397206,TRX_N-00669-45818167,2023-08-16T08:09:02,Amurrio,expenses,transport,-68.7,84554.94
buyer_3,Ana,,1989-08-23,ES60209500003562397206,TRX_N-00670-26228941,2023-08-18T20:23:17,Amurrio,expenses,healthcare,-151.42,84403.52
buyer_3,Ana,,1989-08-23,ES60209500003562397206,TRX_N-00671-83146823,2023-08-19T18:05:03,Amurrio,expenses,cash,-100.0,84303.52
buyer_3,Ana,,1989-08-23,ES60209500003562397206,TRX_N-00672-63782752,2023-08-20T11:13:43,Amurrio,expenses,leisure,-73.05,84230.47
buyer_3,Ana,,1989-08-23,ES60209500003562397206,TRX_N-00673-81983020,2023-08-21T13:39:00,Amurrio,expenses,cash,-100.0,84130.47
buyer_3,Ana,,1989-08-23,ES60209500003562397206,TRX_N-00674-08776647,2023-08-22T09:39:55,Amurrio,expenses,leisure,-30.4,84100.07
buyer_3,Ana,,1989-08-23,ES60209500003562397206,TRX_N-00675-27676946,2023-08-22T16:08:07,Donostia,expenses,education,-52.68,84047.39
buyer_3,Ana,,1989-08-23,ES60209500003562397206,TRX_N-00676-10742413,2023-08-22T11:02:36,Amurrio,expenses,repairs,-182.34,83865.05
buyer_3,Ana,,1989-08-23,ES60209500003562397206,TRX_N-00677-62639521,2023-08-23T20:17:49,Amurrio,expenses,cash,-100.0,83765.05
buyer_3,Ana,,1989-08-23,ES60209500003562397206,TRX_N-00678-83207456,2023-08-26T17:57:46,Amurrio,expenses,food,-62.99,83702.06
buyer_3,Ana,,1989-08-23,ES60209500003562397206,TRX_N-00679-18542185,2023-08-28T10:28:53,Amurrio,expenses,repairs,-286.37,83415.69
buyer_3,Ana,,1989-08-23,ES60209500003562397206,TRX_N-00680-64054740,2023-08-29T20:51:42,Amurrio,expenses,transport,-71.38,83344.31
buyer_3,Ana,,1989-08-23,ES60209500003562397206,TRX_N-00681-77766313,2023-08-29T17:12:02,Amurrio,expenses,leisure,-72.17,83272.14
buyer_3,Ana,,1989-08-23,ES60209500003562397206,TRX_N-00682-45436145,2023-08-29T00:17:52,Amurrio,expenses,cash,-100.0,83172.14
buyer_3,Ana,,1989-08-23,ES60209500003562397206,TRX_N-00683-27931790,2023-08-30T19:35:22,Getxo,expenses,gifts,-478.96,82693.18
buyer_3,Ana,,1989-08-23,ES60209500003562397206,TRX_N-00684-77975833,2023-08-31T09:16:31,Amurrio,expenses,leisure,-34.67,82658.51
buyer_3,Ana,,1989-08-23,ES60209500003562397206,TRX_N-00685-16347925,2023-08-31T08:21:53,Sopela,expenses,cash,-100.0,82558.51
buyer_3,Ana,,1989-08-23,ES60209500003562397206,TRX_N-00686-23878274,2023-09-01T03:52:11,Amurrio,incomes,salary,3674.41,86232.92
buyer_3,Ana,,1989-08-23,ES60209500003562397206,TRX_N-00687-82140297,2023-09-01T03:52:11,Amurrio,incomes,salary_partner,3979.27,90212.19
buyer_3,Ana,,1989-08-23,ES60209500003562397206,TRX_N-00688-25653579,2023-09-04T11:14:19,Amurrio,expenses,mortgage,-1069.75,89142.44
buyer_3,Ana,,1989-08-23,ES60209500003562397206,TRX_N-00689-80679264,2023-09-04T14:47:30,Amurrio,expenses,food,-111.23,89031.21
buyer_3,Ana,,1989-08-23,ES60209500003562397206,TRX_N-00690-34423779,2023-09-06T04:09:43,Amurrio,expenses,food,-62.32,88968.89
buyer_3,Ana,,1989-08-23,ES60209500003562397206,TRX_N-00691-67470046,2023-09-07T23:23:44,Amurrio,expenses,phone,-31.46,88937.43
buyer_3,Ana,,1989-08-23,ES60209500003562397206,TRX_N-00692-72541792,2023-09-07T09:02:54,Amurrio,expenses,transport,-76.04,88861.39
buyer_3,Ana,,1989-08-23,ES60209500003562397206,TRX_N-00693-35935053,2023-09-08T09:16:41,Amurrio,expenses,water,-21.86,88839.53
buyer_3,Ana,,1989-08-23,ES60209500003562397206,TRX_N-00694-00199870,2023-09-08T20:05:36,Amurrio,expenses,electricity,-40.85,88798.68
buyer_3,Ana,,1989-08-23,ES60209500003562397206,TRX_N-00695-79841726,2023-09-08T17:55:52,Amurrio,expenses,gas,-95.67,88703.01
buyer_3,Ana,,1989-08-23,ES60209500003562397206,TRX_N-00696-75394463,2023-09-08T10:54:56,Amurrio,expenses,internet,-42.0,88661.01
buyer_3,Ana,,1989-08-23,ES60209500003562397206,TRX_N-00697-42919709,2023-09-08T12:29:56,Amurrio,expenses,cash,-100.0,88561.01
buyer_3,Ana,,1989-08-23,ES60209500003562397206,TRX_N-00698-65058616,2023-09-09T11:15:35,Amurrio,expenses,food,-68.54,88492.47
buyer_3,Ana,,1989-08-23,ES60209500003562397206,TRX_N-00699-50622720,2023-09-10T10:32:55,Amurrio,expenses,appliances,-230.54,88261.93
buyer_3,Ana,,1989-08-23,ES60209500003562397206,TRX_N-00700-13311527,2023-09-11T12:50:32,Amurrio,expenses,repairs,-230.4,88031.53
buyer_3,Ana,,1989-08-23,ES60209500003562397206,TRX_N-00701-05022493,2023-09-13T18:57:09,Amurrio,expenses,transport,-64.86,87966.67
buyer_3,Ana,,1989-08-23,ES60209500003562397206,TRX_N-00702-06205879,2023-09-13T15:35:00,Amurrio,expenses,cash,-100.0,87866.67
buyer_3,Ana,,1989-08-23,ES60209500003562397206,TRX_N-00703-32721657,2023-09-14T16:27:37,Hernani,expenses,cash,-100.0,87766.67
buyer_3,Ana,,1989-08-23,ES60209500003562397206,TRX_N-00704-54579399,2023-09-16T15:22:07,Portugalete,expenses,transport,-88.85,87677.82
buyer_3,Ana,,1989-08-23,ES60209500003562397206,TRX_N-00705-03547394,2023-09-16T11:16:53,Amurrio,expenses,cash,-100.0,87577.82
buyer_3,Ana,,1989-08-23,ES60209500003562397206,TRX_N-00706-38960161,2023-09-17T22:18:35,Amurrio,expenses,transport,-77.55,87500.27
buyer_3,Ana,,1989-08-23,ES60209500003562397206,TRX_N-00707-57563648,2023-09-17T23:24:21,Amurrio,expenses,leisure,-49.02,87451.25
buyer_3,Ana,,1989-08-23,ES60209500003562397206,TRX_N-00708-49270811,2023-09-18T16:29:58,Amurrio,expenses,cash,-100.0,87351.25
buyer_3,Ana,,1989-08-23,ES60209500003562397206,TRX_N-00709-71361156,2023-09-18T14:43:40,Amurrio,expenses,travel,-324.09,87027.16
buyer_3,Ana,,1989-08-23,ES60209500003562397206,TRX_N-00710-56209548,2023-09-21T08:36:59,Amurrio,expenses,cash,-100.0,86927.16
buyer_3,Ana,,1989-08-23,ES60209500003562397206,TRX_N-00711-08846060,2023-09-26T12:25:26,Amurrio,expenses,food,-72.72,86854.44
buyer_3,Ana,,1989-08-23,ES60209500003562397206,TRX_N-00712-41148482,2023-09-26T15:03:16,Amurrio,expenses,leisure,-83.08,86771.36
buyer_3,Ana,,1989-08-23,ES60209500003562397206,TRX_N-00713-79178572,2023-09-29T09:25:53,Amurrio,expenses,food,-109.75,86661.61
buyer_3,Ana,,1989-08-23,ES60209500003562397206,TRX_N-00714-40761496,2023-10-01T20:48:32,Amurrio,incomes,salary,3674.41,90336.02
buyer_3,Ana,,1989-08-23,ES60209500003562397206,TRX_N-00715-13096390,2023-10-01T20:48:32,Amurrio,incomes,salary_partner,3979.27,94315.29
buyer_3,Ana,,1989-08-23,ES60209500003562397206,TRX_N-00716-44245163,2023-10-01T15:52:03,Amurrio,expenses,transport,-47.63,94267.66
buyer_3,Ana,,1989-08-23,ES60209500003562397206,TRX_N-00717-49368196,2023-10-04T16:45:21,Amurrio,expenses,mortgage,-1069.75,93197.91
buyer_3,Ana,,1989-08-23,ES60209500003562397206,TRX_N-00718-70910644,2023-10-04T19:20:19,Amurrio,expenses,transport,-73.44,93124.47
buyer_3,Ana,,1989-08-23,ES60209500003562397206,TRX_N-00719-97274235,2023-10-05T09:36:04,Amurrio,expenses,electricity,-62.76,93061.71
buyer_3,Ana,,1989-08-23,ES60209500003562397206,TRX_N-00720-83191184,2023-10-05T15:27:35,Amurrio,expenses,repairs,-201.05,92860.66
buyer_3,Ana,,1989-08-23,ES60209500003562397206,TRX_N-00721-79598426,2023-10-06T10:54:16,Amurrio,expenses,phone,-41.12,92819.54
buyer_3,Ana,,1989-08-23,ES60209500003562397206,TRX_N-00722-64076078,2023-10-06T15:14:03,Portugalete,expenses,gifts,-678.77,92140.77
buyer_3,Ana,,1989-08-23,ES60209500003562397206,TRX_N-00723-34856309,2023-10-07T02:50:01,Vitoria-Gasteiz,expenses,food,-101.86,92038.91
buyer_3,Ana,,1989-08-23,ES60209500003562397206,TRX_N-00724-28570517,2023-10-08T15:17:07,Amurrio,expenses,water,-35.3,92003.61
buyer_3,Ana,,1989-08-23,ES60209500003562397206,TRX_N-00725-59568710,2023-10-08T11:54:48,Amurrio,expenses,gas,-50.16,91953.45
buyer_3,Ana,,1989-08-23,ES60209500003562397206,TRX_N-00726-14968584,2023-10-08T17:39:19,Amurrio,expenses,internet,-42.0,91911.45
buyer_3,Ana,,1989-08-23,ES60209500003562397206,TRX_N-00727-58929142,2023-10-08T12:20:15,Amurrio,expenses,cash,-100.0,91811.45
buyer_3,Ana,,1989-08-23,ES60209500003562397206,TRX_N-00728-18780203,2023-10-11T15:22:10,Amurrio,expenses,food,-61.79,91749.66
buyer_3,Ana,,1989-08-23,ES60209500003562397206,TRX_N-00729-05349041,2023-10-14T19:47:40,Barakaldo,expenses,clothing,-91.13,91658.53
buyer_3,Ana,,1989-08-23,ES60209500003562397206,TRX_N-00730-96701078,2023-10-15T16:31:33,Zuia,expenses,food,-83.79,91574.74
buyer_3,Ana,,1989-08-23,ES60209500003562397206,TRX_N-00731-99904724,2023-10-15T17:25:01,Amurrio,expenses,cash,-100.0,91474.74
buyer_3,Ana,,1989-08-23,ES60209500003562397206,TRX_N-00732-41261420,2023-10-16T14:02:40,Lasarte-Oria,expenses,clothing,-83.79,91390.95
buyer_3,Ana,,1989-08-23,ES60209500003562397206,TRX_N-00733-05890732,2023-10-17T06:52:21,Amurrio,expenses,cash,-100.0,91290.95
buyer_3,Ana,,1989-08-23,ES60209500003562397206,TRX_N-00734-27738311,2023-10-19T16:09:45,Amurrio,expenses,food,-114.88,91176.07
buyer_3,Ana,,1989-08-23,ES60209500003562397206,TRX_N-00735-97491787,2023-10-21T16:27:02,Amurrio,expenses,food,-68.13,91107.94
buyer_3,Ana,,1989-08-23,ES60209500003562397206,TRX_N-00736-95281628,2023-10-23T13:25:40,Llodio,expenses,leisure,-50.49,91057.45
buyer_3,Ana,,1989-08-23,ES60209500003562397206,TRX_N-00737-57359708,2023-10-26T15:28:54,Amurrio,expenses,cash,-100.0,90957.45
buyer_3,Ana,,1989-08-23,ES60209500003562397206,TRX_N-00738-82990626,2023-10-26T18:57:10,Amurrio,expenses,gifts,-394.31,90563.14
buyer_3,Ana,,1989-08-23,ES60209500003562397206,TRX_N-00739-10736646,2023-10-27T12:06:55,Amurrio,expenses,transport,-62.82,90500.32
buyer_3,Ana,,1989-08-23,ES60209500003562397206,TRX_N-00740-94843055,2023-10-30T10:21:08,Amurrio,expenses,food,-117.26,90383.06
buyer_3,Ana,,1989-08-23,ES60209500003562397206,TRX_N-00741-76355395,2023-10-30T16:32:54,Amurrio,expenses,leisure,-32.71,90350.35
buyer_3,Ana,,1989-08-23,ES60209500003562397206,TRX_N-00742-02385242,2023-10-31T21:26:17,Amurrio,expenses,healthcare,-152.41,90197.94
buyer_3,Ana,,1989-08-23,ES60209500003562397206,TRX_N-00743-62171645,2023-11-01T10:28:21,Amurrio,incomes,salary,3674.41,93872.35
buyer_3,Ana,,1989-08-23,ES60209500003562397206,TRX_N-00744-64469432,2023-11-01T10:28:21,Amurrio,incomes,salary_partner,3979.27,97851.62
buyer_3,Ana,,1989-08-23,ES60209500003562397206,TRX_N-00745-31180229,2023-11-01T08:04:04,Zarautz,expenses,food,-101.6,97750.02
buyer_3,Ana,,1989-08-23,ES60209500003562397206,TRX_N-00746-92839741,2023-11-03T17:14:17,Galdakao,expenses,leisure,-58.83,97691.19
buyer_3,Ana,,1989-08-23,ES60209500003562397206,TRX_N-00747-39269932,2023-11-04T19:48:18,Amurrio,expenses,mortgage,-1069.75,96621.44
buyer_3,Ana,,1989-08-23,ES60209500003562397206,TRX_N-00748-67929970,2023-11-04T17:01:12,Amurrio,expenses,transport,-55.44,96566.0
buyer_3,Ana,,1989-08-23,ES60209500003562397206,TRX_N-00749-87672434,2023-11-04T19:58:23,Amurrio,expenses,education,-63.32,96502.68
buyer_3,Ana,,1989-08-23,ES60209500003562397206,TRX_N-00750-50798970,2023-11-04T07:32:52,Amurrio,expenses,cash,-100.0,96402.68
buyer_3,Ana,,1989-08-23,ES60209500003562397206,TRX_N-00751-27309234,2023-11-05T18:49:05,Amurrio,expenses,phone,-43.01,96359.67
buyer_3,Ana,,1989-08-23,ES60209500003562397206,TRX_N-00752-76762245,2023-11-05T19:50:53,Amurrio,expenses,transport,-68.68,96290.99
buyer_3,Ana,,1989-08-23,ES60209500003562397206,TRX_N-00753-72852080,2023-11-06T13:49:16,Amurrio,expenses,food,-92.77,96198.22
buyer_3,Ana,,1989-08-23,ES60209500003562397206,TRX_N-00754-01920017,2023-11-07T19:11:20,Amurrio,expenses,food,-70.28,96127.94
buyer_3,Ana,,1989-08-23,ES60209500003562397206,TRX_N-00755-39727202,2023-11-07T09:05:45,Amurrio,expenses,transport,-64.18,96063.76
buyer_3,Ana,,1989-08-23,ES60209500003562397206,TRX_N-00756-77737744,2023-11-07T21:11:53,Amurrio,expenses,repairs,-248.29,95815.47
buyer_3,Ana,,1989-08-23,ES60209500003562397206,TRX_N-00757-09967771,2023-11-08T16:27:54,Amurrio,expenses,electricity,-75.25,95740.22
buyer_3,Ana,,1989-08-23,ES60209500003562397206,TRX_N-00758-36735032,2023-11-08T19:54:47,Amurrio,expenses,water,-30.25,95709.97
buyer_3,Ana,,1989-08-23,ES60209500003562397206,TRX_N-00759-67177105,2023-11-08T10:15:49,Amurrio,expenses,gas,-86.63,95623.34
buyer_3,Ana,,1989-08-23,ES60209500003562397206,TRX_N-00760-97210370,2023-11-08T14:12:21,Amurrio,expenses,internet,-42.0,95581.34
buyer_3,Ana,,1989-08-23,ES60209500003562397206,TRX_N-00761-82454053,2023-11-08T05:40:10,Amurrio,expenses,cash,-100.0,95481.34
buyer_3,Ana,,1989-08-23,ES60209500003562397206,TRX_N-00762-12180319,2023-11-09T20:22:45,Durango,expenses,cash,-100.0,95381.34
buyer_3,Ana,,1989-08-23,ES60209500003562397206,TRX_N-00763-67362575,2023-11-09T23:41:40,Amurrio,expenses,appliances,-307.65,95073.69
buyer_3,Ana,,1989-08-23,ES60209500003562397206,TRX_N-00764-96825160,2023-11-10T19:56:32,Portugalete,expenses,repairs,-149.45,94924.24
buyer_3,Ana,,1989-08-23,ES60209500003562397206,TRX_N-00765-64857536,2023-11-13T19:28:55,Amurrio,expenses,food,-101.61,94822.63
buyer_3,Ana,,1989-08-23,ES60209500003562397206,TRX_N-00766-20733986,2023-11-13T17:59:49,Amurrio,expenses,cash,-100.0,94722.63
buyer_3,Ana,,1989-08-23,ES60209500003562397206,TRX_N-00767-40980102,2023-11-14T14:16:56,Amurrio,expenses,leisure,-75.84,94646.79
buyer_3,Ana,,1989-08-23,ES60209500003562397206,TRX_N-00768-19460297,2023-11-15T12:09:02,Sestao,expenses,gifts,-818.36,93828.43
buyer_3,Ana,,1989-08-23,ES60209500003562397206,TRX_N-00769-04349095,2023-11-17T11:16:49,Mungia,expenses,transport,-85.01,93743.42
buyer_3,Ana,,1989-08-23,ES60209500003562397206,TRX_N-00770-97343876,2023-11-17T08:24:32,Llodio,expenses,gifts,-98.39,93645.03
buyer_3,Ana,,1989-08-23,ES60209500003562397206,TRX_N-00771-37968815,2023-11-18T13:10:52,Lasarte-Oria,expenses,transport,-81.93,93563.1
buyer_3,Ana,,1989-08-23,ES60209500003562397206,TRX_N-00772-73429235,2023-11-18T19:51:53,Amurrio,expenses,leisure,-30.28,93532.82
buyer_3,Ana,,1989-08-23,ES60209500003562397206,TRX_N-00773-78989871,2023-11-19T14:28:42,Amurrio,expenses,food,-117.79,93415.03
buyer_3,Ana,,1989-08-23,ES60209500003562397206,TRX_N-00774-97091787,2023-11-19T00:29:04,Santurtzi,expenses,cash,-100.0,93315.03
buyer_3,Ana,,1989-08-23,ES60209500003562397206,TRX_N-00775-04825180,2023-11-22T11:04:12,Amurrio,expenses,leisure,-60.89,93254.14
buyer_3,Ana,,1989-08-23,ES60209500003562397206,TRX_N-00776-08695366,2023-11-23T12:13:12,Vitoria-Gasteiz,expenses,food,-98.99,93155.15
buyer_3,Ana,,1989-08-23,ES60209500003562397206,TRX_N-00777-80101618,2023-11-23T13:08:01,Amurrio,expenses,cash,-100.0,93055.15
buyer_3,Ana,,1989-08-23,ES60209500003562397206,TRX_N-00778-51806162,2023-11-25T08:52:42,Amurrio,expenses,repairs,-29.85,93025.3
buyer_3,Ana,,1989-08-23,ES60209500003562397206,TRX_N-00779-49767256,2023-11-26T19:42:01,Amurrio,expenses,transport,-63.14,92962.16
buyer_3,Ana,,1989-08-23,ES60209500003562397206,TRX_N-00780-42695215,2023-11-26T23:06:42,Amurrio,expenses,leisure,-77.31,92884.85
buyer_3,Ana,,1989-08-23,ES60209500003562397206,TRX_N-00781-11848335,2023-11-27T12:20:36,Erandio,expenses,transport,-63.62,92821.23
buyer_3,Ana,,1989-08-23,ES60209500003562397206,TRX_N-00782-81372836,2023-11-27T19:15:00,Amurrio,expenses,leisure,-82.79,92738.44
buyer_3,Ana,,1989-08-23,ES60209500003562397206,TRX_N-00783-62081145,2023-11-27T11:35:22,Amurrio,expenses,education,-65.1,92673.34
buyer_3,Ana,,1989-08-23,ES60209500003562397206,TRX_N-00784-51710611,2023-11-27T13:37:19,Amurrio,expenses,gifts,-726.06,91947.28
buyer_3,Ana,,1989-08-23,ES60209500003562397206,TRX_N-00785-07574323,2023-11-30T14:12:08,Zarautz,expenses,appliances,-200.5,91746.78
buyer_3,Ana,,1989-08-23,ES60209500003562397206,TRX_N-00786-67113089,2023-12-01T08:53:56,Amurrio,incomes,salary,3674.41,95421.19
buyer_3,Ana,,1989-08-23,ES60209500003562397206,TRX_N-00787-07621763,2023-12-01T08:53:56,Amurrio,incomes,salary_partner,3979.27,99400.46
buyer_3,Ana,,1989-08-23,ES60209500003562397206,TRX_N-00788-04222765,2023-12-01T08:53:56,Amurrio,incomes,extra_income,437.39,99837.85
buyer_3,Ana,,1989-08-23,ES60209500003562397206,TRX_N-00789-10619684,2023-12-01T08:53:56,Amurrio,incomes,salary_bonus,2867.74,102705.59
buyer_3,Ana,,1989-08-23,ES60209500003562397206,TRX_N-00790-86864970,2023-12-01T08:53:56,Amurrio,incomes,salary_partner_bonus,3136.18,105841.77
buyer_3,Ana,,1989-08-23,ES60209500003562397206,TRX_N-00791-17695759,2023-12-01T10:10:33,Amurrio,expenses,leisure,-21.96,105819.81
buyer_3,Ana,,1989-08-23,ES60209500003562397206,TRX_N-00792-51354924,2023-12-02T16:32:52,Amurrio,expenses,cash,-100.0,105719.81
buyer_3,Ana,,1989-08-23,ES60209500003562397206,TRX_N-00793-76377202,2023-12-03T16:27:15,Errenteria,expenses,food,-99.06,105620.75
buyer_3,Ana,,1989-08-23,ES60209500003562397206,TRX_N-00794-61421947,2023-12-03T22:14:49,Amurrio,expenses,cash,-100.0,105520.75
buyer_3,Ana,,1989-08-23,ES60209500003562397206,TRX_N-00795-04801536,2023-12-04T15:42:22,Amurrio,expenses,mortgage,-1069.75,104451.0
buyer_3,Ana,,1989-08-23,ES60209500003562397206,TRX_N-00796-29345639,2023-12-04T20:40:50,Amurrio,expenses,gifts,-178.52,104272.48
buyer_3,Ana,,1989-08-23,ES60209500003562397206,TRX_N-00797-61973705,2023-12-05T14:53:44,Amurrio,expenses,water,-20.29,104252.19
buyer_3,Ana,,1989-08-23,ES60209500003562397206,TRX_N-00798-31118608,2023-12-05T13:17:33,Amurrio,expenses,electricity,-61.36,104190.83
buyer_3,Ana,,1989-08-23,ES60209500003562397206,TRX_N-00799-68808159,2023-12-05T14:55:55,Amurrio,expenses,gas,-79.01,104111.82
buyer_3,Ana,,1989-08-23,ES60209500003562397206,TRX_N-00800-78940696,2023-12-08T10:28:57,Amurrio,expenses,internet,-42.0,104069.82
buyer_3,Ana,,1989-08-23,ES60209500003562397206,TRX_N-00801-52785375,2023-12-08T14:58:35,Amurrio,expenses,phone,-37.01,104032.81
buyer_3,Ana,,1989-08-23,ES60209500003562397206,TRX_N-00802-31781705,2023-12-10T19:38:24,Amurrio,expenses,food,-60.95,103971.86
buyer_3,Ana,,1989-08-23,ES60209500003562397206,TRX_N-00803-91531153,2023-12-10T08:18:14,Amurrio,expenses,cash,-100.0,103871.86
buyer_3,Ana,,1989-08-23,ES60209500003562397206,TRX_N-00804-03496604,2023-12-11T23:56:36,Labastida,expenses,transport,-61.13,103810.73
buyer_3,Ana,,1989-08-23,ES60209500003562397206,TRX_N-00805-89155115,2023-12-11T11:19:34,Amurrio,expenses,leisure,-75.35,103735.38
buyer_3,Ana,,1989-08-23,ES60209500003562397206,TRX_N-00806-59509229,2023-12-14T16:06:40,Amurrio,expenses,cash,-100.0,103635.38
buyer_3,Ana,,1989-08-23,ES60209500003562397206,TRX_N-00807-81098569,2023-12-14T15:31:58,Amurrio,expenses,repairs,-255.14,103380.24
buyer_3,Ana,,1989-08-23,ES60209500003562397206,TRX_N-00808-10955591,2023-12-15T14:58:52,Elciego,expenses,education,-62.4,103317.84
buyer_3,Ana,,1989-08-23,ES60209500003562397206,TRX_N-00809-29726490,2023-12-15T09:44:26,Amurrio,expenses,repairs,-291.83,103026.01
buyer_3,Ana,,1989-08-23,ES60209500003562397206,TRX_N-00810-90012338,2023-12-17T19:26:35,Amurrio,expenses,cash,-100.0,102926.01
buyer_3,Ana,,1989-08-23,ES60209500003562397206,TRX_N-00811-85098567,2023-12-20T17:00:25,Amurrio,expenses,leisure,-53.01,102873.0
buyer_3,Ana,,1989-08-23,ES60209500003562397206,TRX_N-00812-51123206,2023-12-21T11:57:02,Amurrio,expenses,food,-124.0,102749.0
buyer_3,Ana,,1989-08-23,ES60209500003562397206,TRX_N-00813-26848752,2023-12-23T09:37:05,Amurrio,expenses,transport,-56.99,102692.01
buyer_3,Ana,,1989-08-23,ES60209500003562397206,TRX_N-00814-72301548,2023-12-23T10:24:37,Amurrio,expenses,clothing,-87.37,102604.64
buyer_3,Ana,,1989-08-23,ES60209500003562397206,TRX_N-00815-75983635,2023-12-24T14:05:55,Amurrio,expenses,leisure,-44.23,102560.41
buyer_3,Ana,,1989-08-23,ES60209500003562397206,TRX_N-00816-21134826,2023-12-26T17:47:10,Amurrio,expenses,leisure,-50.46,102509.95
buyer_3,Ana,,1989-08-23,ES60209500003562397206,TRX_N-00817-77226252,2023-12-27T13:44:11,Amurrio,expenses,education,-72.28,102437.67
buyer_3,Ana,,1989-08-23,ES60209500003562397206,TRX_N-00818-22734244,2023-12-28T03:24:33,Amurrio,expenses,leisure,-38.23,102399.44
buyer_3,Ana,,1989-08-23,ES60209500003562397206,TRX_N-00819-29059201,2023-12-29T14:30:40,Amurrio,expenses,cash,-100.0,102299.44
buyer_3,Ana,,1989-08-23,ES60209500003562397206,TRX_N-00820-47498050,2023-12-30T09:33:44,Amurrio,expenses,cash,-100.0,102199.44
buyer_3,Ana,,1989-08-23,ES60209500003562397206,TRX_N-00821-39727540,2023-12-31T16:46:32,Alegr√≠a-Dulantzi,expenses,cash,-100.0,102099.44
buyer_3,Ana,,1989-08-23,ES60209500003562397206,TRX_N-00822-81182127,2024-01-01T04:56:55,Amurrio,incomes,salary,3813.5,105912.94
buyer_3,Ana,,1989-08-23,ES60209500003562397206,TRX_N-00823-31268732,2024-01-01T04:56:55,Amurrio,incomes,salary_partner,4129.9,110042.84
buyer_3,Ana,,1989-08-23,ES60209500003562397206,TRX_N-00824-43476589,2024-01-03T12:35:17,Amurrio,expenses,cash,-100.0,109942.84
buyer_3,Ana,,1989-08-23,ES60209500003562397206,TRX_N-00825-77256816,2024-01-04T15:36:18,Amurrio,expenses,mortgage,-1069.75,108873.09
buyer_3,Ana,,1989-08-23,ES60209500003562397206,TRX_N-00826-52948664,2024-01-05T08:32:07,Amurrio,expenses,water,-22.05,108851.04
buyer_3,Ana,,1989-08-23,ES60209500003562397206,TRX_N-00827-11658948,2024-01-05T04:28:34,Amurrio,expenses,internet,-42.0,108809.04
buyer_3,Ana,,1989-08-23,ES60209500003562397206,TRX_N-00828-75406568,2024-01-05T09:16:20,Amurrio,expenses,transport,-45.84,108763.2
buyer_3,Ana,,1989-08-23,ES60209500003562397206,TRX_N-00829-91863559,2024-01-06T13:46:18,Amurrio,expenses,cash,-100.0,108663.2
buyer_3,Ana,,1989-08-23,ES60209500003562397206,TRX_N-00830-03283021,2024-01-07T12:29:29,Amurrio,expenses,food,-104.67,108558.53
buyer_3,Ana,,1989-08-23,ES60209500003562397206,TRX_N-00831-67601648,2024-01-08T22:08:45,Amurrio,expenses,electricity,-70.38,108488.15
buyer_3,Ana,,1989-08-23,ES60209500003562397206,TRX_N-00832-92748675,2024-01-08T10:45:29,Amurrio,expenses,gas,-103.62,108384.53
buyer_3,Ana,,1989-08-23,ES60209500003562397206,TRX_N-00833-08316886,2024-01-08T20:44:39,Amurrio,expenses,phone,-43.79,108340.74
buyer_3,Ana,,1989-08-23,ES60209500003562397206,TRX_N-00834-51239805,2024-01-10T08:27:20,Amurrio,expenses,leisure,-65.3,108275.44
buyer_3,Ana,,1989-08-23,ES60209500003562397206,TRX_N-00835-98435506,2024-01-11T03:38:47,Amurrio,expenses,education,-72.84,108202.6
buyer_3,Ana,,1989-08-23,ES60209500003562397206,TRX_N-00836-57759662,2024-01-12T21:51:34,Amurrio,expenses,leisure,-69.65,108132.95
buyer_3,Ana,,1989-08-23,ES60209500003562397206,TRX_N-00837-50538784,2024-01-13T17:14:54,Getxo,expenses,leisure,-61.25,108071.7
buyer_3,Ana,,1989-08-23,ES60209500003562397206,TRX_N-00838-98793232,2024-01-17T14:00:08,Amurrio,expenses,repairs,-31.02,108040.68
buyer_3,Ana,,1989-08-23,ES60209500003562397206,TRX_N-00839-64122039,2024-01-18T09:16:11,Amurrio,expenses,transport,-83.26,107957.42
buyer_3,Ana,,1989-08-23,ES60209500003562397206,TRX_N-00840-30547162,2024-01-19T08:41:16,Amurrio,expenses,leisure,-36.63,107920.79
buyer_3,Ana,,1989-08-23,ES60209500003562397206,TRX_N-00841-88453065,2024-01-19T12:31:45,Amurrio,expenses,clothing,-133.48,107787.31
buyer_3,Ana,,1989-08-23,ES60209500003562397206,TRX_N-00842-57872442,2024-01-20T16:18:28,Lasarte-Oria,expenses,cash,-100.0,107687.31
buyer_3,Ana,,1989-08-23,ES60209500003562397206,TRX_N-00843-12411209,2024-01-21T10:42:30,Amurrio,expenses,food,-96.05,107591.26
buyer_3,Ana,,1989-08-23,ES60209500003562397206,TRX_N-00844-08908714,2024-01-22T20:37:34,Amurrio,expenses,education,-55.27,107535.99
buyer_3,Ana,,1989-08-23,ES60209500003562397206,TRX_N-00845-85263481,2024-01-24T08:09:27,Bilbao,expenses,cash,-100.0,107435.99
buyer_3,Ana,,1989-08-23,ES60209500003562397206,TRX_N-00846-54453480,2024-01-24T13:50:18,Amurrio,expenses,appliances,-220.59,107215.4
buyer_3,Ana,,1989-08-23,ES60209500003562397206,TRX_N-00847-05895905,2024-01-25T13:21:47,Amurrio,expenses,leisure,-33.4,107182.0
buyer_3,Ana,,1989-08-23,ES60209500003562397206,TRX_N-00848-99678347,2024-01-25T12:27:32,Amurrio,expenses,repairs,-165.26,107016.74
buyer_3,Ana,,1989-08-23,ES60209500003562397206,TRX_N-00849-70908686,2024-01-26T11:56:21,Labastida,expenses,leisure,-57.92,106958.82
buyer_3,Ana,,1989-08-23,ES60209500003562397206,TRX_N-00850-48126232,2024-01-26T11:18:02,Amurrio,expenses,cash,-100.0,106858.82
buyer_3,Ana,,1989-08-23,ES60209500003562397206,TRX_N-00851-61454939,2024-01-31T20:53:48,Amurrio,expenses,cash,-100.0,106758.82
buyer_3,Ana,,1989-08-23,ES60209500003562397206,TRX_N-00852-10385341,2024-02-01T08:02:08,Amurrio,incomes,salary,3813.5,110572.32
buyer_3,Ana,,1989-08-23,ES60209500003562397206,TRX_N-00853-78053515,2024-02-01T08:02:08,Amurrio,incomes,salary_partner,4129.9,114702.22
buyer_3,Ana,,1989-08-23,ES60209500003562397206,TRX_N-00854-51423501,2024-02-01T09:49:06,Amurrio,expenses,leisure,-50.21,114652.01
buyer_3,Ana,,1989-08-23,ES60209500003562397206,TRX_N-00855-62219058,2024-02-02T20:35:34,Amurrio,expenses,food,-97.69,114554.32
buyer_3,Ana,,1989-08-23,ES60209500003562397206,TRX_N-00856-98865606,2024-02-03T19:49:06,Amurrio,expenses,repairs,-279.8,114274.52
buyer_3,Ana,,1989-08-23,ES60209500003562397206,TRX_N-00857-57059245,2024-02-04T22:49:46,Amurrio,expenses,mortgage,-1069.75,113204.77
buyer_3,Ana,,1989-08-23,ES60209500003562397206,TRX_N-00858-71611875,2024-02-04T17:27:27,Amurrio,expenses,healthcare,-107.39,113097.38
buyer_3,Ana,,1989-08-23,ES60209500003562397206,TRX_N-00859-04962354,2024-02-05T08:33:23,Amurrio,expenses,water,-37.11,113060.27
buyer_3,Ana,,1989-08-23,ES60209500003562397206,TRX_N-00860-81066452,2024-02-05T10:35:39,Amurrio,expenses,gas,-73.55,112986.72
buyer_3,Ana,,1989-08-23,ES60209500003562397206,TRX_N-00861-95985694,2024-02-06T12:14:53,Eibar,expenses,food,-110.86,112875.86
buyer_3,Ana,,1989-08-23,ES60209500003562397206,TRX_N-00862-85380127,2024-02-07T14:49:47,Amurrio,expenses,electricity,-36.87,112838.99
buyer_3,Ana,,1989-08-23,ES60209500003562397206,TRX_N-00863-79430931,2024-02-07T17:16:40,Barakaldo,expenses,gifts,-349.22,112489.77
buyer_3,Ana,,1989-08-23,ES60209500003562397206,TRX_N-00864-88348014,2024-02-08T12:05:40,Amurrio,expenses,internet,-42.0,112447.77
buyer_3,Ana,,1989-08-23,ES60209500003562397206,TRX_N-00865-29066639,2024-02-08T22:28:20,Amurrio,expenses,phone,-43.47,112404.3
buyer_3,Ana,,1989-08-23,ES60209500003562397206,TRX_N-00866-10791487,2024-02-08T08:42:54,Amurrio,expenses,education,-49.9,112354.4
buyer_3,Ana,,1989-08-23,ES60209500003562397206,TRX_N-00867-10718248,2024-02-08T14:11:56,Amurrio,expenses,repairs,-192.43,112161.97
buyer_3,Ana,,1989-08-23,ES60209500003562397206,TRX_N-00868-32333049,2024-02-08T19:42:54,Sestao,expenses,gifts,-180.38,111981.59
buyer_3,Ana,,1989-08-23,ES60209500003562397206,TRX_N-00869-99908235,2024-02-09T09:20:02,Amurrio,expenses,cash,-100.0,111881.59
buyer_3,Ana,,1989-08-23,ES60209500003562397206,TRX_N-00870-56685229,2024-02-10T16:11:27,Amurrio,expenses,transport,-73.1,111808.49
buyer_3,Ana,,1989-08-23,ES60209500003562397206,TRX_N-00871-28451817,2024-02-12T16:59:32,Amurrio,expenses,repairs,-122.37,111686.12
buyer_3,Ana,,1989-08-23,ES60209500003562397206,TRX_N-00872-15910054,2024-02-13T10:13:26,Amurrio,expenses,food,-77.45,111608.67
buyer_3,Ana,,1989-08-23,ES60209500003562397206,TRX_N-00873-67863957,2024-02-14T09:22:49,Amurrio,expenses,food,-105.99,111502.68
buyer_3,Ana,,1989-08-23,ES60209500003562397206,TRX_N-00874-77242814,2024-02-15T16:34:36,Amurrio,expenses,food,-68.03,111434.65
buyer_3,Ana,,1989-08-23,ES60209500003562397206,TRX_N-00875-80512832,2024-02-15T10:14:42,Arrasate,expenses,cash,-100.0,111334.65
buyer_3,Ana,,1989-08-23,ES60209500003562397206,TRX_N-00876-53464605,2024-02-17T14:43:28,Irun,expenses,cash,-100.0,111234.65
buyer_3,Ana,,1989-08-23,ES60209500003562397206,TRX_N-00877-14246797,2024-02-18T11:40:41,Amurrio,expenses,transport,-57.82,111176.83
buyer_3,Ana,,1989-08-23,ES60209500003562397206,TRX_N-00878-07384502,2024-02-19T11:16:59,Amurrio,expenses,food,-84.25,111092.58
buyer_3,Ana,,1989-08-23,ES60209500003562397206,TRX_N-00879-40904506,2024-02-19T15:45:10,Amurrio,expenses,transport,-72.57,111020.01
buyer_3,Ana,,1989-08-23,ES60209500003562397206,TRX_N-00880-06519360,2024-02-20T10:19:51,Donostia,expenses,leisure,-44.78,110975.23
buyer_3,Ana,,1989-08-23,ES60209500003562397206,TRX_N-00881-64949262,2024-02-21T23:36:37,Amurrio,expenses,food,-113.92,110861.31
buyer_3,Ana,,1989-08-23,ES60209500003562397206,TRX_N-00882-09454276,2024-02-21T20:00:41,Amurrio,expenses,education,-61.76,110799.55
buyer_3,Ana,,1989-08-23,ES60209500003562397206,TRX_N-00883-60745471,2024-02-22T23:15:36,Amurrio,expenses,transport,-60.86,110738.69
buyer_3,Ana,,1989-08-23,ES60209500003562397206,TRX_N-00884-56551181,2024-02-22T13:32:38,Amurrio,expenses,repairs,-326.99,110411.7
buyer_3,Ana,,1989-08-23,ES60209500003562397206,TRX_N-00885-04944081,2024-02-24T08:00:23,Amurrio,expenses,clothing,-62.17,110349.53
buyer_3,Ana,,1989-08-23,ES60209500003562397206,TRX_N-00886-19359365,2024-02-24T19:47:05,Amurrio,expenses,cash,-100.0,110249.53
buyer_3,Ana,,1989-08-23,ES60209500003562397206,TRX_N-00887-87860934,2024-02-25T13:41:15,Amurrio,expenses,repairs,-63.24,110186.29
buyer_3,Ana,,1989-08-23,ES60209500003562397206,TRX_N-00888-82314172,2024-02-27T09:07:45,Amurrio,expenses,leisure,-52.01,110134.28
buyer_3,Ana,,1989-08-23,ES60209500003562397206,TRX_N-00889-75068822,2024-02-27T19:39:15,Amurrio,expenses,cash,-100.0,110034.28
buyer_3,Ana,,1989-08-23,ES60209500003562397206,TRX_N-00890-58440104,2024-02-28T20:52:45,Amurrio,expenses,cash,-100.0,109934.28
buyer_3,Ana,,1989-08-23,ES60209500003562397206,TRX_N-00891-20923757,2024-02-28T16:40:19,Amurrio,expenses,gifts,-455.8,109478.48
buyer_3,Ana,,1989-08-23,ES60209500003562397206,TRX_N-00892-69776154,2024-02-29T09:22:35,Amurrio,expenses,transport,-63.23,109415.25
buyer_3,Ana,,1989-08-23,ES60209500003562397206,TRX_N-00893-65016427,2024-02-29T11:32:46,Portugalete,expenses,appliances,-347.12,109068.13
buyer_3,Ana,,1989-08-23,ES60209500003562397206,TRX_N-00894-55662060,2024-03-01T09:15:07,Amurrio,incomes,salary,3813.5,112881.63
buyer_3,Ana,,1989-08-23,ES60209500003562397206,TRX_N-00895-73495078,2024-03-01T09:15:07,Amurrio,incomes,salary_partner,4129.9,117011.53
buyer_3,Ana,,1989-08-23,ES60209500003562397206,TRX_N-00896-28867718,2024-03-02T08:06:41,Amurrio,expenses,food,-123.8,116887.73
buyer_3,Ana,,1989-08-23,ES60209500003562397206,TRX_N-00897-44870043,2024-03-04T13:42:23,Amurrio,expenses,mortgage,-1069.75,115817.98
buyer_3,Ana,,1989-08-23,ES60209500003562397206,TRX_N-00898-35913782,2024-03-05T08:25:35,Amurrio,expenses,gas,-59.04,115758.94
buyer_3,Ana,,1989-08-23,ES60209500003562397206,TRX_N-00899-72741881,2024-03-06T05:27:08,Amurrio,expenses,food,-87.89,115671.05
buyer_3,Ana,,1989-08-23,ES60209500003562397206,TRX_N-00900-06572791,2024-03-06T17:24:44,Bermeo,expenses,cash,-100.0,115571.05
buyer_3,Ana,,1989-08-23,ES60209500003562397206,TRX_N-00901-21831729,2024-03-07T17:49:48,Amurrio,expenses,phone,-33.66,115537.39
buyer_3,Ana,,1989-08-23,ES60209500003562397206,TRX_N-00902-35666291,2024-03-07T22:01:46,Amurrio,expenses,food,-67.29,115470.1
buyer_3,Ana,,1989-08-23,ES60209500003562397206,TRX_N-00903-34627030,2024-03-08T20:27:11,Amurrio,expenses,internet,-42.0,115428.1
buyer_3,Ana,,1989-08-23,ES60209500003562397206,TRX_N-00904-99656598,2024-03-08T09:40:03,Amurrio,expenses,water,-21.74,115406.36
buyer_3,Ana,,1989-08-23,ES60209500003562397206,TRX_N-00905-77029317,2024-03-08T19:10:48,Amurrio,expenses,electricity,-66.0,115340.36
buyer_3,Ana,,1989-08-23,ES60209500003562397206,TRX_N-00906-72650574,2024-03-08T15:57:17,Amurrio,expenses,cash,-100.0,115240.36
buyer_3,Ana,,1989-08-23,ES60209500003562397206,TRX_N-00907-93327886,2024-03-09T14:51:28,Amurrio,expenses,food,-118.71,115121.65
buyer_3,Ana,,1989-08-23,ES60209500003562397206,TRX_N-00908-60834678,2024-03-09T05:36:28,Amurrio,expenses,leisure,-21.07,115100.58
buyer_3,Ana,,1989-08-23,ES60209500003562397206,TRX_N-00909-01588816,2024-03-09T22:37:34,Amurrio,expenses,clothing,-143.24,114957.34
buyer_3,Ana,,1989-08-23,ES60209500003562397206,TRX_N-00910-37854962,2024-03-10T17:56:48,Durango,expenses,food,-117.05,114840.29
buyer_3,Ana,,1989-08-23,ES60209500003562397206,TRX_N-00911-27102413,2024-03-10T23:06:54,Amurrio,expenses,cash,-100.0,114740.29
buyer_3,Ana,,1989-08-23,ES60209500003562397206,TRX_N-00912-61718681,2024-03-14T12:33:33,Amurrio,expenses,transport,-43.28,114697.01
buyer_3,Ana,,1989-08-23,ES60209500003562397206,TRX_N-00913-22990013,2024-03-14T18:31:39,Lasarte-Oria,expenses,leisure,-24.98,114672.03
buyer_3,Ana,,1989-08-23,ES60209500003562397206,TRX_N-00914-91441309,2024-03-16T13:25:27,Amurrio,expenses,food,-88.55,114583.48
buyer_3,Ana,,1989-08-23,ES60209500003562397206,TRX_N-00915-83679828,2024-03-17T16:52:15,Errenteria,expenses,cash,-100.0,114483.48
buyer_3,Ana,,1989-08-23,ES60209500003562397206,TRX_N-00916-63820731,2024-03-20T15:46:06,Amurrio,expenses,cash,-100.0,114383.48
buyer_3,Ana,,1989-08-23,ES60209500003562397206,TRX_N-00917-81106647,2024-03-24T22:49:23,Amurrio,expenses,food,-82.96,114300.52
buyer_3,Ana,,1989-08-23,ES60209500003562397206,TRX_N-00918-44075789,2024-03-24T02:08:14,Amurrio,expenses,cash,-100.0,114200.52
buyer_3,Ana,,1989-08-23,ES60209500003562397206,TRX_N-00919-17789748,2024-03-25T09:08:01,Amurrio,expenses,transport,-54.71,114145.81
buyer_3,Ana,,1989-08-23,ES60209500003562397206,TRX_N-00920-88419216,2024-03-25T10:17:03,Amurrio,expenses,leisure,-60.47,114085.34
buyer_3,Ana,,1989-08-23,ES60209500003562397206,TRX_N-00921-51339642,2024-03-25T09:29:19,Amurrio,expenses,clothing,-90.54,113994.8
buyer_3,Ana,,1989-08-23,ES60209500003562397206,TRX_N-00922-22683110,2024-03-26T13:52:42,Amurrio,expenses,cash,-100.0,113894.8
buyer_3,Ana,,1989-08-23,ES60209500003562397206,TRX_N-00923-36372346,2024-03-26T10:28:44,Amurrio,expenses,repairs,-175.96,113718.84
buyer_3,Ana,,1989-08-23,ES60209500003562397206,TRX_N-00924-46388951,2024-03-27T16:48:32,Amurrio,expenses,transport,-53.91,113664.93
buyer_3,Ana,,1989-08-23,ES60209500003562397206,TRX_N-00925-40735667,2024-03-28T12:15:57,Amurrio,expenses,food,-72.18,113592.75
buyer_3,Ana,,1989-08-23,ES60209500003562397206,TRX_N-00926-62826309,2024-03-29T10:15:03,Amurrio,expenses,food,-93.27,113499.48
buyer_3,Ana,,1989-08-23,ES60209500003562397206,TRX_N-00927-72253302,2024-03-29T21:26:47,Amurrio,expenses,repairs,-164.8,113334.68
buyer_3,Ana,,1989-08-23,ES60209500003562397206,TRX_N-00928-38660450,2024-03-30T16:12:43,Amurrio,expenses,cash,-100.0,113234.68
buyer_3,Ana,,1989-08-23,ES60209500003562397206,TRX_N-00929-61178453,2024-03-31T12:31:36,Amurrio,expenses,cash,-100.0,113134.68
buyer_3,Ana,,1989-08-23,ES60209500003562397206,TRX_N-00930-62179946,2024-03-31T10:26:43,Amurrio,expenses,appliances,-230.21,112904.47
buyer_3,Ana,,1989-08-23,ES60209500003562397206,TRX_N-00931-56329440,2024-04-01T02:49:22,Amurrio,incomes,salary,3813.5,116717.97
buyer_3,Ana,,1989-08-23,ES60209500003562397206,TRX_N-00932-59971692,2024-04-01T02:49:22,Amurrio,incomes,salary_partner,4129.9,120847.87
buyer_3,Ana,,1989-08-23,ES60209500003562397206,TRX_N-00933-12253406,2024-04-01T02:49:22,Amurrio,incomes,extra_income,437.39,121285.26
buyer_3,Ana,,1989-08-23,ES60209500003562397206,TRX_N-00934-58309698,2024-04-01T18:02:36,Amurrio,expenses,appliances,-355.35,120929.91
buyer_3,Ana,,1989-08-23,ES60209500003562397206,TRX_N-00935-64735330,2024-04-02T13:29:19,Amurrio,expenses,clothing,-87.34,120842.57
buyer_3,Ana,,1989-08-23,ES60209500003562397206,TRX_N-00936-12840376,2024-04-02T20:31:16,Amurrio,expenses,cash,-100.0,120742.57
buyer_3,Ana,,1989-08-23,ES60209500003562397206,TRX_N-00937-49773052,2024-04-03T16:08:27,Barakaldo,expenses,food,-87.1,120655.47
buyer_3,Ana,,1989-08-23,ES60209500003562397206,TRX_N-00938-65354547,2024-04-03T08:32:01,Hondarribia,expenses,repairs,-76.55,120578.92
buyer_3,Ana,,1989-08-23,ES60209500003562397206,TRX_N-00939-64152450,2024-04-04T09:21:01,Amurrio,expenses,mortgage,-1069.75,119509.17
buyer_3,Ana,,1989-08-23,ES60209500003562397206,TRX_N-00940-57657540,2024-04-05T21:57:21,Amurrio,expenses,phone,-32.66,119476.51
buyer_3,Ana,,1989-08-23,ES60209500003562397206,TRX_N-00941-96157805,2024-04-06T16:01:55,Amurrio,expenses,water,-27.9,119448.61
buyer_3,Ana,,1989-08-23,ES60209500003562397206,TRX_N-00942-34196044,2024-04-06T20:11:07,Amurrio,expenses,gas,-82.26,119366.35
buyer_3,Ana,,1989-08-23,ES60209500003562397206,TRX_N-00943-20363498,2024-04-06T22:27:01,Amurrio,expenses,repairs,-311.46,119054.89
buyer_3,Ana,,1989-08-23,ES60209500003562397206,TRX_N-00944-71063303,2024-04-08T15:26:39,Amurrio,expenses,electricity,-89.76,118965.13
buyer_3,Ana,,1989-08-23,ES60209500003562397206,TRX_N-00945-64709754,2024-04-08T04:25:14,Amurrio,expenses,internet,-42.0,118923.13
buyer_3,Ana,,1989-08-23,ES60209500003562397206,TRX_N-00946-60358044,2024-04-08T18:35:37,Amurrio,expenses,cash,-100.0,118823.13
buyer_3,Ana,,1989-08-23,ES60209500003562397206,TRX_N-00947-52392432,2024-04-11T10:23:04,Amurrio,expenses,food,-99.7,118723.43
buyer_3,Ana,,1989-08-23,ES60209500003562397206,TRX_N-00948-76810222,2024-04-11T12:50:51,Amurrio,expenses,leisure,-20.98,118702.45
buyer_3,Ana,,1989-08-23,ES60209500003562397206,TRX_N-00949-34490435,2024-04-13T14:48:55,Amurrio,expenses,food,-103.24,118599.21
buyer_3,Ana,,1989-08-23,ES60209500003562397206,TRX_N-00950-21441303,2024-04-14T11:15:06,Amurrio,expenses,transport,-41.86,118557.35
buyer_3,Ana,,1989-08-23,ES60209500003562397206,TRX_N-00951-53314132,2024-04-15T16:00:42,Amurrio,expenses,food,-65.57,118491.78
buyer_3,Ana,,1989-08-23,ES60209500003562397206,TRX_N-00952-58910450,2024-04-16T21:56:39,Amurrio,expenses,food,-111.73,118380.05
buyer_3,Ana,,1989-08-23,ES60209500003562397206,TRX_N-00953-68503012,2024-04-16T10:05:13,Amurrio,expenses,gifts,-494.42,117885.63
buyer_3,Ana,,1989-08-23,ES60209500003562397206,TRX_N-00954-16019238,2024-04-18T14:48:09,Amurrio,expenses,leisure,-48.58,117837.05
buyer_3,Ana,,1989-08-23,ES60209500003562397206,TRX_N-00955-30522587,2024-04-19T03:02:18,Amurrio,expenses,cash,-100.0,117737.05
buyer_3,Ana,,1989-08-23,ES60209500003562397206,TRX_N-00956-07524482,2024-04-20T12:14:49,Amurrio,expenses,cash,-100.0,117637.05
buyer_3,Ana,,1989-08-23,ES60209500003562397206,TRX_N-00957-71751676,2024-04-21T15:00:30,Amurrio,expenses,repairs,-73.11,117563.94
buyer_3,Ana,,1989-08-23,ES60209500003562397206,TRX_N-00958-72491200,2024-04-22T16:07:28,Amurrio,expenses,clothing,-111.26,117452.68
buyer_3,Ana,,1989-08-23,ES60209500003562397206,TRX_N-00959-39852017,2024-04-23T08:22:19,Amurrio,expenses,clothing,-77.49,117375.19
buyer_3,Ana,,1989-08-23,ES60209500003562397206,TRX_N-00960-13457745,2024-04-24T11:55:09,Amurrio,expenses,education,-69.11,117306.08
buyer_3,Ana,,1989-08-23,ES60209500003562397206,TRX_N-00961-65171178,2024-04-24T23:26:22,Amurrio,expenses,travel,-959.87,116346.21
buyer_3,Ana,,1989-08-23,ES60209500003562397206,TRX_N-00962-83471337,2024-04-24T09:02:05,Amurrio,expenses,repairs,-263.68,116082.53
buyer_3,Ana,,1989-08-23,ES60209500003562397206,TRX_N-00963-14152678,2024-04-25T17:29:57,Amurrio,expenses,cash,-100.0,115982.53
buyer_3,Ana,,1989-08-23,ES60209500003562397206,TRX_N-00964-73848412,2024-04-26T20:06:08,Barakaldo,expenses,leisure,-34.72,115947.81
buyer_3,Ana,,1989-08-23,ES60209500003562397206,TRX_N-00965-92873470,2024-04-30T10:08:05,Amurrio,expenses,repairs,-227.9,115719.91
buyer_3,Ana,,1989-08-23,ES60209500003562397206,TRX_N-00966-33628804,2024-05-01T11:02:37,Amurrio,incomes,salary,3813.5,119533.41
buyer_3,Ana,,1989-08-23,ES60209500003562397206,TRX_N-00967-79311096,2024-05-01T11:02:37,Amurrio,incomes,salary_partner,4129.9,123663.31
buyer_3,Ana,,1989-08-23,ES60209500003562397206,TRX_N-00968-77681793,2024-05-01T08:00:02,Amurrio,expenses,leisure,-25.67,123637.64
buyer_3,Ana,,1989-08-23,ES60209500003562397206,TRX_N-00969-07084808,2024-05-02T11:42:37,Amurrio,expenses,clothing,-89.69,123547.95
buyer_3,Ana,,1989-08-23,ES60209500003562397206,TRX_N-00970-89804958,2024-05-03T12:07:28,Amurrio,expenses,clothing,-79.73,123468.22
buyer_3,Ana,,1989-08-23,ES60209500003562397206,TRX_N-00971-25901968,2024-05-04T20:31:32,Amurrio,expenses,mortgage,-1069.75,122398.47
buyer_3,Ana,,1989-08-23,ES60209500003562397206,TRX_N-00972-06323339,2024-05-04T21:38:26,Amurrio,expenses,healthcare,-136.79,122261.68
buyer_3,Ana,,1989-08-23,ES60209500003562397206,TRX_N-00973-47377879,2024-05-04T23:07:11,Amurrio,expenses,cash,-100.0,122161.68
buyer_3,Ana,,1989-08-23,ES60209500003562397206,TRX_N-00974-85311310,2024-05-05T17:10:27,Amurrio,expenses,leisure,-64.72,122096.96
buyer_3,Ana,,1989-08-23,ES60209500003562397206,TRX_N-00975-83340789,2024-05-05T23:52:49,Amurrio,expenses,clothing,-102.5,121994.46
buyer_3,Ana,,1989-08-23,ES60209500003562397206,TRX_N-00976-80234531,2024-05-05T14:16:14,Amurrio,expenses,cash,-100.0,121894.46
buyer_3,Ana,,1989-08-23,ES60209500003562397206,TRX_N-00977-76946270,2024-05-05T08:29:32,Amurrio,expenses,travel,-1882.25,120012.21
buyer_3,Ana,,1989-08-23,ES60209500003562397206,TRX_N-00978-18134355,2024-05-05T20:55:31,Amurrio,expenses,gifts,-183.62,119828.59
buyer_3,Ana,,1989-08-23,ES60209500003562397206,TRX_N-00979-61856640,2024-05-06T10:09:25,Iru√±a de Oca,expenses,healthcare,-173.05,119655.54
buyer_3,Ana,,1989-08-23,ES60209500003562397206,TRX_N-00980-22822795,2024-05-07T08:05:16,Amurrio,expenses,food,-88.95,119566.59
buyer_3,Ana,,1989-08-23,ES60209500003562397206,TRX_N-00981-17769654,2024-05-08T18:59:57,Amurrio,expenses,water,-21.91,119544.68
buyer_3,Ana,,1989-08-23,ES60209500003562397206,TRX_N-00982-82751413,2024-05-08T12:21:31,Amurrio,expenses,electricity,-87.12,119457.56
buyer_3,Ana,,1989-08-23,ES60209500003562397206,TRX_N-00983-69474434,2024-05-08T09:38:55,Amurrio,expenses,gas,-81.14,119376.42
buyer_3,Ana,,1989-08-23,ES60209500003562397206,TRX_N-00984-33990425,2024-05-08T09:25:59,Amurrio,expenses,internet,-42.0,119334.42
buyer_3,Ana,,1989-08-23,ES60209500003562397206,TRX_N-00985-22973529,2024-05-08T18:31:55,Amurrio,expenses,phone,-40.48,119293.94
buyer_3,Ana,,1989-08-23,ES60209500003562397206,TRX_N-00986-87888956,2024-05-09T11:37:40,Amurrio,expenses,healthcare,-159.47,119134.47
buyer_3,Ana,,1989-08-23,ES60209500003562397206,TRX_N-00987-07455110,2024-05-12T13:37:16,Amurrio,expenses,repairs,-155.66,118978.81
buyer_3,Ana,,1989-08-23,ES60209500003562397206,TRX_N-00988-78408841,2024-05-12T02:12:54,Amurrio,expenses,gifts,-703.14,118275.67
buyer_3,Ana,,1989-08-23,ES60209500003562397206,TRX_N-00989-42864865,2024-05-14T21:03:30,Llodio,expenses,cash,-100.0,118175.67
buyer_3,Ana,,1989-08-23,ES60209500003562397206,TRX_N-00990-61099104,2024-05-16T17:43:11,Amurrio,expenses,food,-71.96,118103.71
buyer_3,Ana,,1989-08-23,ES60209500003562397206,TRX_N-00991-09478891,2024-05-18T00:25:03,Amurrio,expenses,cash,-100.0,118003.71
buyer_3,Ana,,1989-08-23,ES60209500003562397206,TRX_N-00992-26367523,2024-05-19T08:36:52,Amurrio,expenses,clothing,-75.2,117928.51
buyer_3,Ana,,1989-08-23,ES60209500003562397206,TRX_N-00993-77687365,2024-05-19T04:54:52,Amurrio,expenses,cash,-100.0,117828.51
buyer_3,Ana,,1989-08-23,ES60209500003562397206,TRX_N-00994-65738221,2024-05-24T04:22:03,Amurrio,expenses,gifts,-419.76,117408.75
buyer_3,Ana,,1989-08-23,ES60209500003562397206,TRX_N-00995-50790077,2024-05-25T12:28:04,Amurrio,expenses,food,-83.14,117325.61
buyer_3,Ana,,1989-08-23,ES60209500003562397206,TRX_N-00996-93650028,2024-05-26T17:50:16,Amurrio,expenses,food,-103.96,117221.65
buyer_3,Ana,,1989-08-23,ES60209500003562397206,TRX_N-00997-59687888,2024-05-28T19:01:28,Amurrio,expenses,food,-63.41,117158.24
buyer_3,Ana,,1989-08-23,ES60209500003562397206,TRX_N-00998-36516557,2024-05-28T13:42:17,Amurrio,expenses,leisure,-84.95,117073.29
buyer_3,Ana,,1989-08-23,ES60209500003562397206,TRX_N-00999-68762839,2024-06-01T18:45:25,Amurrio,incomes,salary,3813.5,120886.79
buyer_3,Ana,,1989-08-23,ES60209500003562397206,TRX_N-01000-49694110,2024-06-01T18:45:25,Amurrio,incomes,salary_partner,4129.9,125016.69
buyer_3,Ana,,1989-08-23,ES60209500003562397206,TRX_N-01001-15813663,2024-06-01T18:45:25,Amurrio,incomes,salary_bonus,2881.02,127897.71
buyer_3,Ana,,1989-08-23,ES60209500003562397206,TRX_N-01002-10647961,2024-06-01T18:45:25,Amurrio,incomes,salary_partner_bonus,3014.58,130912.29
buyer_3,Ana,,1989-08-23,ES60209500003562397206,TRX_N-01003-20401842,2024-06-01T14:58:37,Amurrio,expenses,transport,-40.49,130871.8
buyer_3,Ana,,1989-08-23,ES60209500003562397206,TRX_N-01004-33181752,2024-06-02T17:34:58,Bilbao,expenses,cash,-100.0,130771.8
buyer_3,Ana,,1989-08-23,ES60209500003562397206,TRX_N-01005-61167949,2024-06-02T19:34:04,Amurrio,expenses,travel,-930.83,129840.97
buyer_3,Ana,,1989-08-23,ES60209500003562397206,TRX_N-01006-95489597,2024-06-04T14:17:17,Amurrio,expenses,mortgage,-1069.75,128771.22
buyer_3,Ana,,1989-08-23,ES60209500003562397206,TRX_N-01007-91342158,2024-06-04T11:43:17,Amurrio,expenses,food,-85.03,128686.19
buyer_3,Ana,,1989-08-23,ES60209500003562397206,TRX_N-01008-48756847,2024-06-05T13:29:06,Amurrio,expenses,gas,-109.2,128576.99
buyer_3,Ana,,1989-08-23,ES60209500003562397206,TRX_N-01009-34643012,2024-06-05T20:03:24,Amurrio,expenses,internet,-42.0,128534.99
buyer_3,Ana,,1989-08-23,ES60209500003562397206,TRX_N-01010-59846136,2024-06-05T14:45:54,Amurrio,expenses,food,-64.2,128470.79
buyer_3,Ana,,1989-08-23,ES60209500003562397206,TRX_N-01011-79885906,2024-06-05T16:51:11,Amurrio,expenses,transport,-58.55,128412.24
buyer_3,Ana,,1989-08-23,ES60209500003562397206,TRX_N-01012-86142810,2024-06-06T14:20:50,Amurrio,expenses,electricity,-47.06,128365.18
buyer_3,Ana,,1989-08-23,ES60209500003562397206,TRX_N-01013-32351052,2024-06-06T09:27:00,Amurrio,expenses,phone,-34.28,128330.9
buyer_3,Ana,,1989-08-23,ES60209500003562397206,TRX_N-01014-79369416,2024-06-06T13:06:37,Amurrio,expenses,transport,-49.09,128281.81
buyer_3,Ana,,1989-08-23,ES60209500003562397206,TRX_N-01015-57175898,2024-06-06T09:19:29,Mungia,expenses,repairs,-203.6,128078.21
buyer_3,Ana,,1989-08-23,ES60209500003562397206,TRX_N-01016-71787851,2024-06-07T12:35:59,Amurrio,expenses,food,-86.84,127991.37
buyer_3,Ana,,1989-08-23,ES60209500003562397206,TRX_N-01017-59503819,2024-06-08T08:09:26,Amurrio,expenses,water,-37.69,127953.68
buyer_3,Ana,,1989-08-23,ES60209500003562397206,TRX_N-01018-48035176,2024-06-08T11:10:48,Irun,expenses,education,-66.18,127887.5
buyer_3,Ana,,1989-08-23,ES60209500003562397206,TRX_N-01019-07374213,2024-06-08T08:44:45,Amurrio,expenses,gifts,-665.08,127222.42
buyer_3,Ana,,1989-08-23,ES60209500003562397206,TRX_N-01020-25484441,2024-06-11T16:35:49,Amurrio,expenses,food,-86.23,127136.19
buyer_3,Ana,,1989-08-23,ES60209500003562397206,TRX_N-01021-25708524,2024-06-12T15:12:05,Amurrio,expenses,cash,-100.0,127036.19
buyer_3,Ana,,1989-08-23,ES60209500003562397206,TRX_N-01022-75883685,2024-06-13T22:37:25,Vitoria-Gasteiz,expenses,food,-64.35,126971.84
buyer_3,Ana,,1989-08-23,ES60209500003562397206,TRX_N-01023-82119705,2024-06-13T14:37:47,Amurrio,expenses,education,-56.53,126915.31
buyer_3,Ana,,1989-08-23,ES60209500003562397206,TRX_N-01024-90149795,2024-06-20T21:56:13,Elciego,expenses,food,-87.08,126828.23
buyer_3,Ana,,1989-08-23,ES60209500003562397206,TRX_N-01025-79878430,2024-06-22T00:48:34,Amurrio,expenses,food,-67.59,126760.64
buyer_3,Ana,,1989-08-23,ES60209500003562397206,TRX_N-01026-98940775,2024-06-23T12:02:29,Amurrio,expenses,clothing,-46.71,126713.93
buyer_3,Ana,,1989-08-23,ES60209500003562397206,TRX_N-01027-04679489,2024-06-26T09:22:18,Amurrio,expenses,clothing,-102.69,126611.24
buyer_3,Ana,,1989-08-23,ES60209500003562397206,TRX_N-01028-45814377,2024-06-27T19:54:48,Amurrio,expenses,repairs,-273.51,126337.73
buyer_3,Ana,,1989-08-23,ES60209500003562397206,TRX_N-01029-23675076,2024-06-28T17:14:59,Amurrio,expenses,food,-117.68,126220.05
buyer_3,Ana,,1989-08-23,ES60209500003562397206,TRX_N-01030-63790794,2024-06-29T23:26:28,Amurrio,expenses,appliances,-147.08,126072.97
buyer_3,Ana,,1989-08-23,ES60209500003562397206,TRX_N-01031-45907160,2024-07-01T18:47:57,Amurrio,incomes,salary,3813.5,129886.47
buyer_3,Ana,,1989-08-23,ES60209500003562397206,TRX_N-01032-84985480,2024-07-01T18:47:57,Amurrio,incomes,salary_partner,4129.9,134016.37
buyer_3,Ana,,1989-08-23,ES60209500003562397206,TRX_N-01033-48044109,2024-07-01T17:49:36,Amurrio,expenses,healthcare,-187.21,133829.16
buyer_3,Ana,,1989-08-23,ES60209500003562397206,TRX_N-01034-13301387,2024-07-03T10:18:46,Hondarribia,expenses,food,-76.61,133752.55
buyer_3,Ana,,1989-08-23,ES60209500003562397206,TRX_N-01035-16922441,2024-07-03T15:57:24,Amurrio,expenses,leisure,-23.28,133729.27
buyer_3,Ana,,1989-08-23,ES60209500003562397206,TRX_N-01036-66368410,2024-07-03T10:34:26,Amurrio,expenses,gifts,-830.78,132898.49
buyer_3,Ana,,1989-08-23,ES60209500003562397206,TRX_N-01037-57355380,2024-07-04T09:35:41,Amurrio,expenses,mortgage,-1069.75,131828.74
buyer_3,Ana,,1989-08-23,ES60209500003562397206,TRX_N-01038-86917909,2024-07-04T20:01:17,Amurrio,expenses,food,-84.84,131743.9
buyer_3,Ana,,1989-08-23,ES60209500003562397206,TRX_N-01039-03244388,2024-07-04T19:22:19,Amurrio,expenses,transport,-65.38,131678.52
buyer_3,Ana,,1989-08-23,ES60209500003562397206,TRX_N-01040-31752194,2024-07-04T11:45:56,Amurrio,expenses,clothing,-52.85,131625.67
buyer_3,Ana,,1989-08-23,ES60209500003562397206,TRX_N-01041-36112180,2024-07-05T03:09:11,Amurrio,expenses,phone,-36.44,131589.23
buyer_3,Ana,,1989-08-23,ES60209500003562397206,TRX_N-01042-02850369,2024-07-06T18:51:19,Amurrio,expenses,water,-37.2,131552.03
buyer_3,Ana,,1989-08-23,ES60209500003562397206,TRX_N-01043-87103229,2024-07-06T17:16:34,Amurrio,expenses,transport,-43.46,131508.57
buyer_3,Ana,,1989-08-23,ES60209500003562397206,TRX_N-01044-90241598,2024-07-08T11:23:24,Amurrio,expenses,electricity,-68.01,131440.56
buyer_3,Ana,,1989-08-23,ES60209500003562397206,TRX_N-01045-70916254,2024-07-08T18:14:19,Amurrio,expenses,gas,-111.19,131329.37
buyer_3,Ana,,1989-08-23,ES60209500003562397206,TRX_N-01046-39237013,2024-07-08T08:19:45,Amurrio,expenses,internet,-42.0,131287.37
buyer_3,Ana,,1989-08-23,ES60209500003562397206,TRX_N-01047-31684419,2024-07-08T08:44:23,Amurrio,expenses,food,-107.68,131179.69
buyer_3,Ana,,1989-08-23,ES60209500003562397206,TRX_N-01048-68235937,2024-07-12T21:24:44,Amurrio,expenses,transport,-67.52,131112.17
buyer_3,Ana,,1989-08-23,ES60209500003562397206,TRX_N-01049-76583317,2024-07-12T20:08:55,Amurrio,expenses,cash,-100.0,131012.17
buyer_3,Ana,,1989-08-23,ES60209500003562397206,TRX_N-01050-29387490,2024-07-15T17:25:55,Amurrio,expenses,education,-54.04,130958.13
buyer_3,Ana,,1989-08-23,ES60209500003562397206,TRX_N-01051-98480784,2024-07-16T08:01:26,Amurrio,expenses,food,-68.68,130889.45
buyer_3,Ana,,1989-08-23,ES60209500003562397206,TRX_N-01052-15221707,2024-07-17T11:58:16,Amurrio,expenses,education,-53.6,130835.85
buyer_3,Ana,,1989-08-23,ES60209500003562397206,TRX_N-01053-53747800,2024-07-17T14:25:17,Amurrio,expenses,cash,-100.0,130735.85
buyer_3,Ana,,1989-08-23,ES60209500003562397206,TRX_N-01054-37334727,2024-07-19T19:21:09,Amurrio,expenses,transport,-53.25,130682.6
buyer_3,Ana,,1989-08-23,ES60209500003562397206,TRX_N-01055-89978436,2024-07-19T20:06:36,Amurrio,expenses,appliances,-293.35,130389.25
buyer_3,Ana,,1989-08-23,ES60209500003562397206,TRX_N-01056-88210050,2024-07-20T08:56:21,Amurrio,expenses,travel,-1094.6,129294.65
buyer_3,Ana,,1989-08-23,ES60209500003562397206,TRX_N-01057-98855998,2024-07-21T15:54:44,Amurrio,expenses,clothing,-151.84,129142.81
buyer_3,Ana,,1989-08-23,ES60209500003562397206,TRX_N-01058-31271860,2024-07-23T17:29:16,Amurrio,expenses,food,-109.84,129032.97
buyer_3,Ana,,1989-08-23,ES60209500003562397206,TRX_N-01059-62701303,2024-07-23T08:58:24,Amurrio,expenses,cash,-100.0,128932.97
buyer_3,Ana,,1989-08-23,ES60209500003562397206,TRX_N-01060-46369495,2024-07-28T13:16:22,Amurrio,expenses,food,-81.29,128851.68
buyer_3,Ana,,1989-08-23,ES60209500003562397206,TRX_N-01061-71066921,2024-07-28T12:58:31,Mungia,expenses,education,-44.3,128807.38
buyer_3,Ana,,1989-08-23,ES60209500003562397206,TRX_N-01062-19172935,2024-07-31T20:31:13,Amurrio,expenses,leisure,-30.96,128776.42
buyer_3,Ana,,1989-08-23,ES60209500003562397206,TRX_N-01063-47818076,2024-07-31T11:23:15,Amurrio,expenses,cash,-100.0,128676.42
buyer_3,Ana,,1989-08-23,ES60209500003562397206,TRX_N-01064-12174338,2024-08-01T19:56:28,Amurrio,incomes,salary,3813.5,132489.92
buyer_3,Ana,,1989-08-23,ES60209500003562397206,TRX_N-01065-03845659,2024-08-01T19:56:28,Amurrio,incomes,salary_partner,4129.9,136619.82
buyer_3,Ana,,1989-08-23,ES60209500003562397206,TRX_N-01066-25521580,2024-08-01T19:56:28,Amurrio,incomes,extra_income,437.39,137057.21
buyer_3,Ana,,1989-08-23,ES60209500003562397206,TRX_N-01067-11193732,2024-08-02T18:36:38,Durango,expenses,food,-106.51,136950.7
buyer_3,Ana,,1989-08-23,ES60209500003562397206,TRX_N-01068-70305092,2024-08-02T19:19:06,Amurrio,expenses,clothing,-155.97,136794.73
buyer_3,Ana,,1989-08-23,ES60209500003562397206,TRX_N-01069-89403784,2024-08-02T10:01:37,Barakaldo,expenses,education,-74.54,136720.19
buyer_3,Ana,,1989-08-23,ES60209500003562397206,TRX_N-01070-54142591,2024-08-03T09:02:10,Amurrio,expenses,cash,-100.0,136620.19
buyer_3,Ana,,1989-08-23,ES60209500003562397206,TRX_N-01071-41674565,2024-08-04T13:34:17,Amurrio,expenses,mortgage,-1069.75,135550.44
buyer_3,Ana,,1989-08-23,ES60209500003562397206,TRX_N-01072-77550342,2024-08-04T02:15:57,Zuia,expenses,cash,-100.0,135450.44
buyer_3,Ana,,1989-08-23,ES60209500003562397206,TRX_N-01073-23782895,2024-08-05T01:22:32,Amurrio,expenses,water,-43.43,135407.01
buyer_3,Ana,,1989-08-23,ES60209500003562397206,TRX_N-01074-42221455,2024-08-05T12:26:20,Amurrio,expenses,leisure,-25.25,135381.76
buyer_3,Ana,,1989-08-23,ES60209500003562397206,TRX_N-01075-27671960,2024-08-05T20:00:55,Amurrio,expenses,clothing,-140.08,135241.68
buyer_3,Ana,,1989-08-23,ES60209500003562397206,TRX_N-01076-56008791,2024-08-05T06:23:52,Amurrio,expenses,repairs,-150.56,135091.12
buyer_3,Ana,,1989-08-23,ES60209500003562397206,TRX_N-01077-87729060,2024-08-06T15:03:59,Amurrio,expenses,gas,-73.31,135017.81
buyer_3,Ana,,1989-08-23,ES60209500003562397206,TRX_N-01078-17697369,2024-08-07T10:56:18,Amurrio,expenses,electricity,-46.63,134971.18
buyer_3,Ana,,1989-08-23,ES60209500003562397206,TRX_N-01079-04295890,2024-08-07T03:39:58,Amurrio,expenses,cash,-100.0,134871.18
buyer_3,Ana,,1989-08-23,ES60209500003562397206,TRX_N-01080-48058586,2024-08-07T23:53:16,Amurrio,expenses,appliances,-228.08,134643.1
buyer_3,Ana,,1989-08-23,ES60209500003562397206,TRX_N-01081-79265486,2024-08-08T13:24:14,Amurrio,expenses,phone,-38.56,134604.54
buyer_3,Ana,,1989-08-23,ES60209500003562397206,TRX_N-01082-23631197,2024-08-08T20:27:44,Amurrio,expenses,internet,-42.0,134562.54
buyer_3,Ana,,1989-08-23,ES60209500003562397206,TRX_N-01083-74083507,2024-08-08T20:13:51,Amurrio,expenses,food,-112.77,134449.77
buyer_3,Ana,,1989-08-23,ES60209500003562397206,TRX_N-01084-60795268,2024-08-09T23:02:25,Amurrio,expenses,education,-70.05,134379.72
buyer_3,Ana,,1989-08-23,ES60209500003562397206,TRX_N-01085-41457922,2024-08-09T11:07:47,Amurrio,expenses,repairs,-286.49,134093.23
buyer_3,Ana,,1989-08-23,ES60209500003562397206,TRX_N-01086-95094547,2024-08-11T23:43:26,Amurrio,expenses,leisure,-59.57,134033.66
buyer_3,Ana,,1989-08-23,ES60209500003562397206,TRX_N-01087-22084613,2024-08-11T13:46:30,Amurrio,expenses,gifts,-584.76,133448.9
buyer_3,Ana,,1989-08-23,ES60209500003562397206,TRX_N-01088-10159422,2024-08-12T09:11:43,Amurrio,expenses,cash,-100.0,133348.9
buyer_3,Ana,,1989-08-23,ES60209500003562397206,TRX_N-01089-74549312,2024-08-12T08:04:43,Amurrio,expenses,repairs,-120.86,133228.04
buyer_3,Ana,,1989-08-23,ES60209500003562397206,TRX_N-01090-28733693,2024-08-13T13:25:31,Amurrio,expenses,healthcare,-147.98,133080.06
buyer_3,Ana,,1989-08-23,ES60209500003562397206,TRX_N-01091-62853581,2024-08-14T18:34:36,Amurrio,expenses,clothing,-151.34,132928.72
buyer_3,Ana,,1989-08-23,ES60209500003562397206,TRX_N-01092-83677684,2024-08-14T13:38:15,Amurrio,expenses,cash,-100.0,132828.72
buyer_3,Ana,,1989-08-23,ES60209500003562397206,TRX_N-01093-04680058,2024-08-15T09:13:08,Amurrio,expenses,transport,-57.52,132771.2
buyer_3,Ana,,1989-08-23,ES60209500003562397206,TRX_N-01094-81843113,2024-08-23T09:28:28,Hernani,expenses,repairs,-289.29,132481.91
buyer_3,Ana,,1989-08-23,ES60209500003562397206,TRX_N-01095-09178614,2024-08-23T20:04:12,Eibar,expenses,gifts,-66.53,132415.38
buyer_3,Ana,,1989-08-23,ES60209500003562397206,TRX_N-01096-75495959,2024-08-26T12:49:10,Amurrio,expenses,education,-54.42,132360.96
buyer_3,Ana,,1989-08-23,ES60209500003562397206,TRX_N-01097-72789478,2024-08-26T19:14:28,Oy√≥n-Oion,expenses,cash,-100.0,132260.96
buyer_3,Ana,,1989-08-23,ES60209500003562397206,TRX_N-01098-58482397,2024-08-26T20:53:10,Amurrio,expenses,repairs,-292.23,131968.73
buyer_3,Ana,,1989-08-23,ES60209500003562397206,TRX_N-01099-78478787,2024-08-27T18:03:10,Sestao,expenses,leisure,-30.27,131938.46
buyer_3,Ana,,1989-08-23,ES60209500003562397206,TRX_N-01100-18943344,2024-08-29T08:21:19,Amurrio,expenses,healthcare,-135.44,131803.02
buyer_3,Ana,,1989-08-23,ES60209500003562397206,TRX_N-01101-46332072,2024-08-30T16:13:52,Amurrio,expenses,food,-121.38,131681.64
buyer_3,Ana,,1989-08-23,ES60209500003562397206,TRX_N-01102-43611404,2024-08-30T13:53:48,Irun,expenses,cash,-100.0,131581.64
buyer_3,Ana,,1989-08-23,ES60209500003562397206,TRX_N-01103-50824460,2024-09-01T13:54:21,Amurrio,incomes,salary,3813.5,135395.14
buyer_3,Ana,,1989-08-23,ES60209500003562397206,TRX_N-01104-16356025,2024-09-01T13:54:21,Amurrio,incomes,salary_partner,4129.9,139525.04
buyer_3,Ana,,1989-08-23,ES60209500003562397206,TRX_N-01105-46495725,2024-09-01T16:04:13,Amurrio,expenses,cash,-100.0,139425.04
buyer_3,Ana,,1989-08-23,ES60209500003562397206,TRX_N-01106-33355654,2024-09-04T16:10:22,Amurrio,expenses,mortgage,-1069.75,138355.29
buyer_3,Ana,,1989-08-23,ES60209500003562397206,TRX_N-01107-20234350,2024-09-05T10:13:15,Amurrio,expenses,phone,-43.4,138311.89
buyer_3,Ana,,1989-08-23,ES60209500003562397206,TRX_N-01108-21287119,2024-09-05T20:22:01,Amurrio,expenses,transport,-61.93,138249.96
buyer_3,Ana,,1989-08-23,ES60209500003562397206,TRX_N-01109-76143710,2024-09-05T13:50:29,Amurrio,expenses,leisure,-61.97,138187.99
buyer_3,Ana,,1989-08-23,ES60209500003562397206,TRX_N-01110-52368673,2024-09-07T18:22:38,Amurrio,expenses,food,-108.28,138079.71
buyer_3,Ana,,1989-08-23,ES60209500003562397206,TRX_N-01111-80445093,2024-09-08T14:17:05,Amurrio,expenses,water,-32.07,138047.64
buyer_3,Ana,,1989-08-23,ES60209500003562397206,TRX_N-01112-81532907,2024-09-08T19:15:31,Amurrio,expenses,electricity,-88.89,137958.75
buyer_3,Ana,,1989-08-23,ES60209500003562397206,TRX_N-01113-00554301,2024-09-08T00:04:10,Amurrio,expenses,gas,-56.3,137902.45
buyer_3,Ana,,1989-08-23,ES60209500003562397206,TRX_N-01114-68268925,2024-09-08T11:53:41,Amurrio,expenses,internet,-42.0,137860.45
buyer_3,Ana,,1989-08-23,ES60209500003562397206,TRX_N-01115-49097672,2024-09-08T18:54:04,Amurrio,expenses,leisure,-19.25,137841.2
buyer_3,Ana,,1989-08-23,ES60209500003562397206,TRX_N-01116-88234603,2024-09-08T10:37:04,Amurrio,expenses,cash,-100.0,137741.2
buyer_3,Ana,,1989-08-23,ES60209500003562397206,TRX_N-01117-01909677,2024-09-10T14:36:21,Amurrio,expenses,cash,-100.0,137641.2
buyer_3,Ana,,1989-08-23,ES60209500003562397206,TRX_N-01118-40424463,2024-09-13T16:35:18,Amurrio,expenses,repairs,-100.14,137541.06
buyer_3,Ana,,1989-08-23,ES60209500003562397206,TRX_N-01119-61918773,2024-09-14T20:14:26,Amurrio,expenses,education,-78.01,137463.05
buyer_3,Ana,,1989-08-23,ES60209500003562397206,TRX_N-01120-80898133,2024-09-14T08:27:41,Amurrio,expenses,gifts,-461.08,137001.97
buyer_3,Ana,,1989-08-23,ES60209500003562397206,TRX_N-01121-69509680,2024-09-15T11:03:25,Vitoria-Gasteiz,expenses,leisure,-59.39,136942.58
buyer_3,Ana,,1989-08-23,ES60209500003562397206,TRX_N-01122-23668155,2024-09-17T15:35:57,Amurrio,expenses,repairs,-170.52,136772.06
buyer_3,Ana,,1989-08-23,ES60209500003562397206,TRX_N-01123-26867359,2024-09-18T08:19:41,Amurrio,expenses,food,-98.74,136673.32
buyer_3,Ana,,1989-08-23,ES60209500003562397206,TRX_N-01124-79536826,2024-09-19T12:06:50,Amurrio,expenses,cash,-100.0,136573.32
buyer_3,Ana,,1989-08-23,ES60209500003562397206,TRX_N-01125-63411205,2024-09-21T21:32:29,Amurrio,expenses,cash,-100.0,136473.32
buyer_3,Ana,,1989-08-23,ES60209500003562397206,TRX_N-01126-57389216,2024-09-22T15:48:36,Amurrio,expenses,clothing,-145.86,136327.46
buyer_3,Ana,,1989-08-23,ES60209500003562397206,TRX_N-01127-26738908,2024-09-22T17:28:02,Amurrio,expenses,cash,-100.0,136227.46
buyer_3,Ana,,1989-08-23,ES60209500003562397206,TRX_N-01128-70563524,2024-09-23T13:54:40,Amurrio,expenses,leisure,-69.71,136157.75
buyer_3,Ana,,1989-08-23,ES60209500003562397206,TRX_N-01129-25871091,2024-09-24T11:09:32,Amurrio,expenses,food,-74.89,136082.86
buyer_3,Ana,,1989-08-23,ES60209500003562397206,TRX_N-01130-85081386,2024-09-26T13:20:43,Amurrio,expenses,leisure,-82.32,136000.54
buyer_3,Ana,,1989-08-23,ES60209500003562397206,TRX_N-01131-21119687,2024-09-27T16:27:31,Amurrio,expenses,transport,-89.14,135911.4
buyer_3,Ana,,1989-08-23,ES60209500003562397206,TRX_N-01132-81263747,2024-09-28T16:19:00,Amurrio,expenses,food,-124.53,135786.87
buyer_3,Ana,,1989-08-23,ES60209500003562397206,TRX_N-01133-01274231,2024-09-28T16:23:24,Amurrio,expenses,transport,-63.47,135723.4
buyer_3,Ana,,1989-08-23,ES60209500003562397206,TRX_N-01134-36196739,2024-09-28T08:09:16,Amurrio,expenses,leisure,-75.43,135647.97
buyer_3,Ana,,1989-08-23,ES60209500003562397206,TRX_N-01135-01574078,2024-09-29T18:29:56,Amurrio,expenses,clothing,-90.7,135557.27
buyer_3,Ana,,1989-08-23,ES60209500003562397206,TRX_N-01136-68278594,2024-09-30T18:28:27,Amurrio,expenses,food,-123.09,135434.18
buyer_3,Ana,,1989-08-23,ES60209500003562397206,TRX_N-01137-23760941,2024-09-30T04:09:37,Andoain,expenses,clothing,-152.95,135281.23
buyer_3,Ana,,1989-08-23,ES60209500003562397206,TRX_N-01138-81052317,2024-09-30T17:23:44,Amurrio,expenses,appliances,-134.0,135147.23
buyer_3,Ana,,1989-08-23,ES60209500003562397206,TRX_N-01139-03362505,2024-10-01T15:12:44,Amurrio,incomes,salary,3813.5,138960.73
buyer_3,Ana,,1989-08-23,ES60209500003562397206,TRX_N-01140-72835125,2024-10-01T15:12:44,Amurrio,incomes,salary_partner,4129.9,143090.63
buyer_3,Ana,,1989-08-23,ES60209500003562397206,TRX_N-01141-13061668,2024-10-04T08:50:16,Amurrio,expenses,mortgage,-1069.75,142020.88
buyer_3,Ana,,1989-08-23,ES60209500003562397206,TRX_N-01142-23356815,2024-10-04T12:47:50,Amurrio,expenses,leisure,-77.68,141943.2
buyer_3,Ana,,1989-08-23,ES60209500003562397206,TRX_N-01143-95927903,2024-10-05T17:41:15,Amurrio,expenses,phone,-44.22,141898.98
buyer_3,Ana,,1989-08-23,ES60209500003562397206,TRX_N-01144-31253165,2024-10-05T11:36:47,Amurrio,expenses,cash,-100.0,141798.98
buyer_3,Ana,,1989-08-23,ES60209500003562397206,TRX_N-01145-66595504,2024-10-06T10:49:16,Amurrio,expenses,electricity,-55.91,141743.07
buyer_3,Ana,,1989-08-23,ES60209500003562397206,TRX_N-01146-19750127,2024-10-06T15:22:12,Amurrio,expenses,cash,-100.0,141643.07
buyer_3,Ana,,1989-08-23,ES60209500003562397206,TRX_N-01147-18317446,2024-10-08T14:13:40,Amurrio,expenses,water,-30.59,141612.48
buyer_3,Ana,,1989-08-23,ES60209500003562397206,TRX_N-01148-47481993,2024-10-08T18:00:43,Amurrio,expenses,internet,-42.0,141570.48
buyer_3,Ana,,1989-08-23,ES60209500003562397206,TRX_N-01149-31895698,2024-10-08T14:43:36,Amurrio,expenses,gas,-47.22,141523.26
buyer_3,Ana,,1989-08-23,ES60209500003562397206,TRX_N-01150-97886626,2024-10-09T14:27:22,Amurrio,expenses,transport,-49.63,141473.63
buyer_3,Ana,,1989-08-23,ES60209500003562397206,TRX_N-01151-21626109,2024-10-09T13:32:20,Amurrio,expenses,leisure,-76.98,141396.65
buyer_4,Jorge,,1974-05-23,ES23209580590409199953,TRX_N-00001-45317710,2022-01-01T23:46:41,Galdakao,incomes,salary,1629.29,6691.81
buyer_4,Jorge,,1974-05-23,ES23209580590409199953,TRX_N-00002-26282437,2022-01-01T07:15:19,Galdakao,expenses,food,-107.26,6584.55
buyer_4,Jorge,,1974-05-23,ES23209580590409199953,TRX_N-00003-64265750,2022-01-04T08:11:39,Galdakao,expenses,mortgage,-1032.74,5551.81
buyer_4,Jorge,,1974-05-23,ES23209580590409199953,TRX_N-00004-92992423,2022-01-04T12:27:12,Galdakao,expenses,leisure,-49.23,5502.58
buyer_4,Jorge,,1974-05-23,ES23209580590409199953,TRX_N-00005-93019056,2022-01-04T16:16:52,Galdakao,expenses,cash,-100.0,5402.58
buyer_4,Jorge,,1974-05-23,ES23209580590409199953,TRX_N-00006-02701059,2022-01-05T19:53:44,Galdakao,expenses,leisure,-56.12,5346.46
buyer_4,Jorge,,1974-05-23,ES23209580590409199953,TRX_N-00007-11790209,2022-01-05T16:57:23,Galdakao,expenses,car,-218.2,5128.26
buyer_4,Jorge,,1974-05-23,ES23209580590409199953,TRX_N-00008-31338079,2022-01-06T17:50:17,Galdakao,expenses,internet,-42.0,5086.26
buyer_4,Jorge,,1974-05-23,ES23209580590409199953,TRX_N-00009-41130439,2022-01-06T13:26:23,Galdakao,expenses,phone,-41.28,5044.98
buyer_4,Jorge,,1974-05-23,ES23209580590409199953,TRX_N-00010-22886804,2022-01-07T23:18:25,Galdakao,expenses,gas,-69.94,4975.04
buyer_4,Jorge,,1974-05-23,ES23209580590409199953,TRX_N-00011-65187393,2022-01-07T20:47:32,Galdakao,expenses,food,-105.91,4869.13
buyer_4,Jorge,,1974-05-23,ES23209580590409199953,TRX_N-00012-27276184,2022-01-07T21:58:16,Galdakao,expenses,children,-768.48,4100.65
buyer_4,Jorge,,1974-05-23,ES23209580590409199953,TRX_N-00013-25514383,2022-01-08T10:41:33,Galdakao,expenses,water,-26.8,4073.85
buyer_4,Jorge,,1974-05-23,ES23209580590409199953,TRX_N-00014-75675679,2022-01-08T15:35:40,Galdakao,expenses,electricity,-55.71,4018.14
buyer_4,Jorge,,1974-05-23,ES23209580590409199953,TRX_N-00015-05090954,2022-01-08T09:43:03,Galdakao,expenses,food,-99.28,3918.86
buyer_4,Jorge,,1974-05-23,ES23209580590409199953,TRX_N-00016-91779228,2022-01-10T14:05:54,Galdakao,expenses,gifts,-217.35,3701.51
buyer_4,Jorge,,1974-05-23,ES23209580590409199953,TRX_N-00017-56435570,2022-01-12T20:21:21,Galdakao,expenses,leisure,-62.27,3639.24
buyer_4,Jorge,,1974-05-23,ES23209580590409199953,TRX_N-00018-39363497,2022-01-12T11:10:00,Galdakao,expenses,clothing,-126.21,3513.03
buyer_4,Jorge,,1974-05-23,ES23209580590409199953,TRX_N-00019-64248805,2022-01-12T16:42:17,Amurrio,expenses,cash,-100.0,3413.03
buyer_4,Jorge,,1974-05-23,ES23209580590409199953,TRX_N-00020-04252705,2022-01-13T09:20:43,Bermeo,expenses,transport,-71.49,3341.54
buyer_4,Jorge,,1974-05-23,ES23209580590409199953,TRX_N-00021-61378751,2022-01-13T16:01:32,Lasarte-Oria,expenses,appliances,-305.12,3036.42
buyer_4,Jorge,,1974-05-23,ES23209580590409199953,TRX_N-00022-96789740,2022-01-17T02:27:01,Galdakao,expenses,children,-1027.63,2008.79
buyer_4,Jorge,,1974-05-23,ES23209580590409199953,TRX_N-00023-72197749,2022-01-19T20:42:38,Galdakao,expenses,leisure,-42.88,1965.91
buyer_4,Jorge,,1974-05-23,ES23209580590409199953,TRX_N-00024-84449784,2022-01-20T15:12:56,Galdakao,expenses,appliances,-303.18,1662.73
buyer_4,Jorge,,1974-05-23,ES23209580590409199953,TRX_N-00025-15040463,2022-01-21T08:51:52,Vitoria-Gasteiz,expenses,food,-88.39,1574.34
buyer_4,Jorge,,1974-05-23,ES23209580590409199953,TRX_N-00026-33995341,2022-01-21T20:36:36,Galdakao,expenses,repairs,-254.5,1319.84
buyer_4,Jorge,,1974-05-23,ES23209580590409199953,TRX_N-00027-35583046,2022-01-22T13:44:52,Galdakao,expenses,leisure,-34.77,1285.07
buyer_4,Jorge,,1974-05-23,ES23209580590409199953,TRX_N-00028-50186733,2022-01-22T02:11:24,Galdakao,expenses,gifts,-607.5,677.57
buyer_4,Jorge,,1974-05-23,ES23209580590409199953,TRX_N-00029-14930574,2022-01-24T19:26:30,Galdakao,expenses,food,-67.58,609.99
buyer_4,Jorge,,1974-05-23,ES23209580590409199953,TRX_N-00030-41672086,2022-01-25T18:40:56,Galdakao,expenses,clothing,-60.42,549.57
buyer_4,Jorge,,1974-05-23,ES23209580590409199953,TRX_N-00031-89756482,2022-01-26T03:23:12,Alegr√≠a-Dulantzi,expenses,repairs,-303.59,245.98
buyer_4,Jorge,,1974-05-23,ES23209580590409199953,TRX_N-00032-71104774,2022-01-31T10:08:51,Galdakao,expenses,leisure,-54.38,191.6
buyer_4,Jorge,,1974-05-23,ES23209580590409199953,TRX_N-00033-00683179,2022-02-01T21:44:36,Galdakao,incomes,salary,1629.29,1820.89
buyer_4,Jorge,,1974-05-23,ES23209580590409199953,TRX_N-00034-78056591,2022-02-02T15:35:47,Galdakao,expenses,food,-119.53,1701.36
buyer_4,Jorge,,1974-05-23,ES23209580590409199953,TRX_N-00035-32009721,2022-02-02T05:43:54,Galdakao,expenses,transport,-80.08,1621.28
buyer_4,Jorge,,1974-05-23,ES23209580590409199953,TRX_N-00036-02562108,2022-02-04T22:59:52,Galdakao,expenses,mortgage,-1032.74,588.54
buyer_4,Jorge,,1974-05-23,ES23209580590409199953,TRX_N-00037-75083060,2022-02-04T14:36:48,Galdakao,expenses,food,-80.85,507.69
buyer_4,Jorge,,1974-05-23,ES23209580590409199953,TRX_N-00038-18146562,2022-02-05T20:34:06,Galdakao,expenses,electricity,-52.73,454.96
buyer_4,Jorge,,1974-05-23,ES23209580590409199953,TRX_N-00039-04171394,2022-02-05T17:01:24,Galdakao,expenses,food,-64.26,390.7
buyer_4,Jorge,,1974-05-23,ES23209580590409199953,TRX_N-00040-53197913,2022-02-06T08:02:49,Galdakao,expenses,phone,-44.23,346.47
buyer_4,Jorge,,1974-05-23,ES23209580590409199953,TRX_N-00041-95736288,2022-02-07T20:05:54,Galdakao,expenses,water,-29.69,316.78
buyer_4,Jorge,,1974-05-23,ES23209580590409199953,TRX_N-00042-03288157,2022-02-07T23:03:25,Galdakao,expenses,transport,-74.65,242.13
buyer_4,Jorge,,1974-05-23,ES23209580590409199953,TRX_N-00043-92015329,2022-02-07T12:23:10,Galdakao,expenses,leisure,-84.71,157.42
buyer_4,Jorge,,1974-05-23,ES23209580590409199953,TRX_N-00044-99924317,2022-02-08T13:23:56,Galdakao,expenses,gas,-82.8,74.62
buyer_4,Jorge,,1974-05-23,ES23209580590409199953,TRX_N-00045-54222105,2022-02-08T22:19:15,Galdakao,expenses,internet,-42.0,32.62
buyer_4,Jorge,,1974-05-23,ES23209580590409199953,TRX_N-00046-33481154,2022-02-08T09:36:05,Galdakao,expenses,leisure,-69.74,-37.12
buyer_4,Jorge,,1974-05-23,ES23209580590409199953,TRX_N-00047-84250781,2022-02-08T18:02:17,Galdakao,expenses,children,-1242.96,-1280.08
buyer_4,Jorge,,1974-05-23,ES23209580590409199953,TRX_N-00048-07721651,2022-02-09T17:09:43,Getxo,expenses,food,-81.5,-1361.58
buyer_4,Jorge,,1974-05-23,ES23209580590409199953,TRX_N-00049-73196567,2022-02-09T13:28:49,Galdakao,expenses,children,-1067.18,-2428.76
buyer_4,Jorge,,1974-05-23,ES23209580590409199953,TRX_N-00050-15865707,2022-02-13T08:30:16,Galdakao,expenses,repairs,-293.44,-2722.2
buyer_4,Jorge,,1974-05-23,ES23209580590409199953,TRX_N-00051-07501468,2022-02-16T18:25:29,Galdakao,expenses,healthcare,-43.44,-2765.64
buyer_4,Jorge,,1974-05-23,ES23209580590409199953,TRX_N-00052-92079382,2022-02-18T14:50:48,Galdakao,expenses,food,-111.88,-2877.52
buyer_4,Jorge,,1974-05-23,ES23209580590409199953,TRX_N-00053-65060481,2022-02-19T09:10:17,Galdakao,expenses,clothing,-131.68,-3009.2
buyer_4,Jorge,,1974-05-23,ES23209580590409199953,TRX_N-00054-61463425,2022-02-22T19:21:38,Galdakao,expenses,food,-70.79,-3079.99
buyer_4,Jorge,,1974-05-23,ES23209580590409199953,TRX_N-00055-86640727,2022-02-22T23:49:07,Galdakao,expenses,appliances,-193.65,-3273.64
buyer_4,Jorge,,1974-05-23,ES23209580590409199953,TRX_N-00056-01006557,2022-02-24T16:59:38,Getxo,expenses,transport,-54.45,-3328.09
buyer_4,Jorge,,1974-05-23,ES23209580590409199953,TRX_N-00057-76929591,2022-02-26T20:08:52,Galdakao,expenses,repairs,-237.24,-3565.33
buyer_4,Jorge,,1974-05-23,ES23209580590409199953,TRX_N-00058-79740695,2022-02-28T16:25:01,Galdakao,expenses,travel,-1105.17,-4670.5
buyer_4,Jorge,,1974-05-23,ES23209580590409199953,TRX_N-00059-17276633,2022-02-28T12:57:18,Galdakao,expenses,appliances,-279.04,-4949.54
buyer_4,Jorge,,1974-05-23,ES23209580590409199953,TRX_N-00060-13068750,2022-03-01T20:23:30,Galdakao,incomes,salary,1629.29,-3320.25
buyer_4,Jorge,,1974-05-23,ES23209580590409199953,TRX_N-00061-61822144,2022-03-01T20:23:30,Galdakao,incomes,extra_income,296.42,-3023.83
buyer_4,Jorge,,1974-05-23,ES23209580590409199953,TRX_N-00062-94051502,2022-03-01T02:24:29,Galdakao,expenses,education,-76.77,-3100.6
buyer_4,Jorge,,1974-05-23,ES23209580590409199953,TRX_N-00063-08818825,2022-03-01T19:00:48,Galdakao,expenses,children,-1177.06,-4277.66
buyer_4,Jorge,,1974-05-23,ES23209580590409199953,TRX_N-00064-65597277,2022-03-02T16:00:53,Galdakao,expenses,clothing,-67.44,-4345.1
buyer_4,Jorge,,1974-05-23,ES23209580590409199953,TRX_N-00065-63322942,2022-03-04T21:19:04,Galdakao,expenses,mortgage,-1032.74,-5377.84
buyer_4,Jorge,,1974-05-23,ES23209580590409199953,TRX_N-00066-00511576,2022-03-04T06:42:56,Galdakao,expenses,leisure,-30.85,-5408.69
buyer_4,Jorge,,1974-05-23,ES23209580590409199953,TRX_N-00067-24875361,2022-03-04T19:09:19,Galdakao,expenses,cash,-100.0,-5508.69
buyer_4,Jorge,,1974-05-23,ES23209580590409199953,TRX_N-00068-94148803,2022-03-05T17:22:47,Galdakao,expenses,gas,-101.04,-5609.73
buyer_4,Jorge,,1974-05-23,ES23209580590409199953,TRX_N-00069-70904513,2022-03-06T12:48:47,Galdakao,expenses,food,-72.77,-5682.5
buyer_4,Jorge,,1974-05-23,ES23209580590409199953,TRX_N-00070-49389180,2022-03-07T11:41:18,Galdakao,expenses,cash,-100.0,-5782.5
buyer_4,Jorge,,1974-05-23,ES23209580590409199953,TRX_N-00071-31103467,2022-03-08T20:55:53,Galdakao,expenses,electricity,-75.66,-5858.16
buyer_4,Jorge,,1974-05-23,ES23209580590409199953,TRX_N-00072-10935485,2022-03-08T17:21:31,Galdakao,expenses,internet,-42.0,-5900.16
buyer_4,Jorge,,1974-05-23,ES23209580590409199953,TRX_N-00073-49512524,2022-03-08T10:27:22,Galdakao,expenses,water,-26.69,-5926.85
buyer_4,Jorge,,1974-05-23,ES23209580590409199953,TRX_N-00074-21803878,2022-03-08T22:06:55,Galdakao,expenses,phone,-34.21,-5961.06
buyer_4,Jorge,,1974-05-23,ES23209580590409199953,TRX_N-00075-26472603,2022-03-08T13:50:50,Galdakao,expenses,cash,-100.0,-6061.06
buyer_4,Jorge,,1974-05-23,ES23209580590409199953,TRX_N-00076-66631479,2022-03-09T17:30:27,Galdakao,expenses,appliances,-230.35,-6291.41
buyer_4,Jorge,,1974-05-23,ES23209580590409199953,TRX_N-00077-35310759,2022-03-09T14:04:54,Galdakao,expenses,repairs,-112.3,-6403.71
buyer_4,Jorge,,1974-05-23,ES23209580590409199953,TRX_N-00078-84004080,2022-03-12T22:01:10,Durango,expenses,leisure,-23.24,-6426.95
buyer_4,Jorge,,1974-05-23,ES23209580590409199953,TRX_N-00079-16414725,2022-03-15T18:03:50,Galdakao,expenses,clothing,-62.58,-6489.53
buyer_4,Jorge,,1974-05-23,ES23209580590409199953,TRX_N-00080-24405576,2022-03-15T04:44:40,Alegr√≠a-Dulantzi,expenses,cash,-100.0,-6589.53
buyer_4,Jorge,,1974-05-23,ES23209580590409199953,TRX_N-00081-77372967,2022-03-16T18:39:32,Galdakao,expenses,leisure,-28.61,-6618.14
buyer_4,Jorge,,1974-05-23,ES23209580590409199953,TRX_N-00082-98662839,2022-03-17T14:05:57,Lasarte-Oria,expenses,repairs,-200.32,-6818.46
buyer_4,Jorge,,1974-05-23,ES23209580590409199953,TRX_N-00083-86279275,2022-03-18T13:58:51,Galdakao,expenses,leisure,-79.36,-6897.82
buyer_4,Jorge,,1974-05-23,ES23209580590409199953,TRX_N-00084-87029918,2022-03-18T12:45:17,Alegr√≠a-Dulantzi,expenses,clothing,-134.42,-7032.24
buyer_4,Jorge,,1974-05-23,ES23209580590409199953,TRX_N-00085-65293816,2022-03-20T23:23:34,Galdakao,expenses,food,-82.78,-7115.02
buyer_4,Jorge,,1974-05-23,ES23209580590409199953,TRX_N-00086-73462353,2022-03-21T15:57:12,Galdakao,expenses,leisure,-71.28,-7186.3
buyer_4,Jorge,,1974-05-23,ES23209580590409199953,TRX_N-00087-86908993,2022-03-21T08:16:54,Galdakao,expenses,cash,-100.0,-7286.3
buyer_4,Jorge,,1974-05-23,ES23209580590409199953,TRX_N-00088-52378696,2022-03-26T02:36:35,Galdakao,expenses,clothing,-74.87,-7361.17
buyer_4,Jorge,,1974-05-23,ES23209580590409199953,TRX_N-00089-85409181,2022-03-26T06:41:24,Galdakao,expenses,gifts,-607.39,-7968.56
buyer_4,Jorge,,1974-05-23,ES23209580590409199953,TRX_N-00090-60414596,2022-03-27T13:15:03,Galdakao,expenses,transport,-62.93,-8031.49
buyer_4,Jorge,,1974-05-23,ES23209580590409199953,TRX_N-00091-56158795,2022-03-30T14:58:31,Galdakao,expenses,leisure,-81.53,-8113.02
buyer_4,Jorge,,1974-05-23,ES23209580590409199953,TRX_N-00092-10342607,2022-03-31T15:47:23,Galdakao,expenses,food,-72.71,-8185.73
buyer_4,Jorge,,1974-05-23,ES23209580590409199953,TRX_N-00093-11157064,2022-03-31T16:51:28,Galdakao,expenses,leisure,-62.9,-8248.63
buyer_4,Jorge,,1974-05-23,ES23209580590409199953,TRX_N-00094-23693549,2022-04-01T15:02:06,Galdakao,incomes,salary,1629.29,-6619.34
buyer_4,Jorge,,1974-05-23,ES23209580590409199953,TRX_N-00095-95398778,2022-04-01T14:52:39,Galdakao,expenses,transport,-47.55,-6666.89
buyer_4,Jorge,,1974-05-23,ES23209580590409199953,TRX_N-00096-75584242,2022-04-01T03:39:35,Galdakao,expenses,cash,-100.0,-6766.89
buyer_4,Jorge,,1974-05-23,ES23209580590409199953,TRX_N-00097-04952165,2022-04-02T18:07:26,Llodio,expenses,gifts,-813.51,-7580.4
buyer_4,Jorge,,1974-05-23,ES23209580590409199953,TRX_N-00098-04706443,2022-04-03T20:47:42,Galdakao,expenses,cash,-100.0,-7680.4
buyer_4,Jorge,,1974-05-23,ES23209580590409199953,TRX_N-00099-56035410,2022-04-04T16:31:22,Galdakao,expenses,mortgage,-1032.74,-8713.14
buyer_4,Jorge,,1974-05-23,ES23209580590409199953,TRX_N-00100-29361461,2022-04-04T14:28:51,Galdakao,expenses,food,-68.39,-8781.53
buyer_4,Jorge,,1974-05-23,ES23209580590409199953,TRX_N-00101-41747935,2022-04-05T05:07:36,Galdakao,expenses,gas,-112.63,-8894.16
buyer_4,Jorge,,1974-05-23,ES23209580590409199953,TRX_N-00102-75281694,2022-04-05T19:50:51,Galdakao,expenses,cash,-100.0,-8994.16
buyer_4,Jorge,,1974-05-23,ES23209580590409199953,TRX_N-00103-69027291,2022-04-06T15:29:08,Galdakao,expenses,water,-28.71,-9022.87
buyer_4,Jorge,,1974-05-23,ES23209580590409199953,TRX_N-00104-65777448,2022-04-07T15:00:28,Galdakao,expenses,food,-77.73,-9100.6
buyer_4,Jorge,,1974-05-23,ES23209580590409199953,TRX_N-00105-13982403,2022-04-08T16:57:00,Galdakao,expenses,electricity,-57.82,-9158.42
buyer_4,Jorge,,1974-05-23,ES23209580590409199953,TRX_N-00106-81765731,2022-04-08T13:05:33,Galdakao,expenses,internet,-42.0,-9200.42
buyer_4,Jorge,,1974-05-23,ES23209580590409199953,TRX_N-00107-98725439,2022-04-08T08:31:58,Galdakao,expenses,phone,-39.5,-9239.92
buyer_4,Jorge,,1974-05-23,ES23209580590409199953,TRX_N-00108-00560343,2022-04-08T18:37:28,Galdakao,expenses,food,-91.99,-9331.91
buyer_4,Jorge,,1974-05-23,ES23209580590409199953,TRX_N-00109-92127253,2022-04-12T09:25:21,Galdakao,expenses,cash,-100.0,-9431.91
buyer_4,Jorge,,1974-05-23,ES23209580590409199953,TRX_N-00110-67931930,2022-04-17T11:09:54,Galdakao,expenses,cash,-100.0,-9531.91
buyer_4,Jorge,,1974-05-23,ES23209580590409199953,TRX_N-00111-34417849,2022-04-19T19:27:01,Lasarte-Oria,expenses,appliances,-228.66,-9760.57
buyer_4,Jorge,,1974-05-23,ES23209580590409199953,TRX_N-00112-91718300,2022-04-20T14:32:08,Portugalete,expenses,cash,-100.0,-9860.57
buyer_4,Jorge,,1974-05-23,ES23209580590409199953,TRX_N-00113-83894847,2022-04-23T12:59:21,Galdakao,expenses,repairs,-87.98,-9948.55
buyer_4,Jorge,,1974-05-23,ES23209580590409199953,TRX_N-00114-60841529,2022-04-24T10:57:30,Galdakao,expenses,transport,-63.12,-10011.67
buyer_4,Jorge,,1974-05-23,ES23209580590409199953,TRX_N-00115-92319382,2022-04-24T12:55:09,Andoain,expenses,clothing,-140.18,-10151.85
buyer_4,Jorge,,1974-05-23,ES23209580590409199953,TRX_N-00116-20269139,2022-04-25T19:49:58,Galdakao,expenses,cash,-100.0,-10251.85
buyer_4,Jorge,,1974-05-23,ES23209580590409199953,TRX_N-00117-83723004,2022-04-26T15:19:47,Galdakao,expenses,leisure,-37.19,-10289.04
buyer_4,Jorge,,1974-05-23,ES23209580590409199953,TRX_N-00118-46500545,2022-04-27T16:26:49,Erandio,expenses,cash,-100.0,-10389.04
buyer_4,Jorge,,1974-05-23,ES23209580590409199953,TRX_N-00119-77397373,2022-04-28T12:00:53,Galdakao,expenses,gifts,-361.0,-10750.04
buyer_4,Jorge,,1974-05-23,ES23209580590409199953,TRX_N-00120-81661324,2022-04-29T15:40:08,Galdakao,expenses,food,-96.53,-10846.57
buyer_4,Jorge,,1974-05-23,ES23209580590409199953,TRX_N-00121-70284408,2022-04-29T02:50:55,Galdakao,expenses,leisure,-61.71,-10908.28
buyer_4,Jorge,,1974-05-23,ES23209580590409199953,TRX_N-00122-79552010,2022-04-29T09:55:40,Portugalete,expenses,cash,-100.0,-11008.28
buyer_4,Jorge,,1974-05-23,ES23209580590409199953,TRX_N-00123-76274265,2022-04-29T12:18:49,Galdakao,expenses,appliances,-264.7,-11272.98
buyer_4,Jorge,,1974-05-23,ES23209580590409199953,TRX_N-00124-61351790,2022-05-01T10:53:24,Galdakao,incomes,salary,1629.29,-9643.69
buyer_4,Jorge,,1974-05-23,ES23209580590409199953,TRX_N-00125-47120391,2022-05-04T11:01:43,Galdakao,expenses,mortgage,-1032.74,-10676.43
buyer_4,Jorge,,1974-05-23,ES23209580590409199953,TRX_N-00126-41399161,2022-05-04T22:59:21,Llodio,expenses,cash,-100.0,-10776.43
buyer_4,Jorge,,1974-05-23,ES23209580590409199953,TRX_N-00127-89710158,2022-05-05T17:54:08,Galdakao,expenses,leisure,-45.13,-10821.56
buyer_4,Jorge,,1974-05-23,ES23209580590409199953,TRX_N-00128-96270315,2022-05-06T07:00:39,Galdakao,expenses,gas,-97.78,-10919.34
buyer_4,Jorge,,1974-05-23,ES23209580590409199953,TRX_N-00129-70725367,2022-05-07T16:04:06,Santurtzi,expenses,education,-57.66,-10977.0
buyer_4,Jorge,,1974-05-23,ES23209580590409199953,TRX_N-00130-78332354,2022-05-07T14:02:24,Pasaia,expenses,appliances,-256.0,-11233.0
buyer_4,Jorge,,1974-05-23,ES23209580590409199953,TRX_N-00131-10190982,2022-05-08T20:05:42,Galdakao,expenses,electricity,-83.91,-11316.91
buyer_4,Jorge,,1974-05-23,ES23209580590409199953,TRX_N-00132-60182587,2022-05-08T16:30:07,Galdakao,expenses,water,-40.84,-11357.75
buyer_4,Jorge,,1974-05-23,ES23209580590409199953,TRX_N-00133-25347950,2022-05-08T08:12:05,Galdakao,expenses,internet,-42.0,-11399.75
buyer_4,Jorge,,1974-05-23,ES23209580590409199953,TRX_N-00134-17966644,2022-05-08T17:12:35,Galdakao,expenses,phone,-42.1,-11441.85
buyer_4,Jorge,,1974-05-23,ES23209580590409199953,TRX_N-00135-26831595,2022-05-08T13:45:03,Galdakao,expenses,transport,-77.61,-11519.46
buyer_4,Jorge,,1974-05-23,ES23209580590409199953,TRX_N-00136-01064848,2022-05-08T14:31:10,Bermeo,expenses,leisure,-66.26,-11585.72
buyer_4,Jorge,,1974-05-23,ES23209580590409199953,TRX_N-00137-30847260,2022-05-10T12:18:16,Galdakao,expenses,gifts,-291.87,-11877.59
buyer_4,Jorge,,1974-05-23,ES23209580590409199953,TRX_N-00138-82241333,2022-05-11T09:18:31,Galdakao,expenses,cash,-100.0,-11977.59
buyer_4,Jorge,,1974-05-23,ES23209580590409199953,TRX_N-00139-87824420,2022-05-11T14:07:19,Galdakao,expenses,children,-246.19,-12223.78
buyer_4,Jorge,,1974-05-23,ES23209580590409199953,TRX_N-00140-30829431,2022-05-13T03:13:35,Galdakao,expenses,food,-84.54,-12308.32
buyer_4,Jorge,,1974-05-23,ES23209580590409199953,TRX_N-00141-25828936,2022-05-17T05:01:18,Elciego,expenses,repairs,-108.46,-12416.78
buyer_4,Jorge,,1974-05-23,ES23209580590409199953,TRX_N-00142-19706179,2022-05-17T17:21:02,Galdakao,expenses,children,-1150.99,-13567.77
buyer_4,Jorge,,1974-05-23,ES23209580590409199953,TRX_N-00143-66129974,2022-05-19T18:34:53,Galdakao,expenses,leisure,-21.37,-13589.14
buyer_4,Jorge,,1974-05-23,ES23209580590409199953,TRX_N-00144-18332452,2022-05-19T14:13:47,Galdakao,expenses,children,-881.09,-14470.23
buyer_4,Jorge,,1974-05-23,ES23209580590409199953,TRX_N-00145-13419656,2022-05-20T12:37:30,Galdakao,expenses,leisure,-55.07,-14525.3
buyer_4,Jorge,,1974-05-23,ES23209580590409199953,TRX_N-00146-05041445,2022-05-21T08:31:56,Galdakao,expenses,cash,-100.0,-14625.3
buyer_4,Jorge,,1974-05-23,ES23209580590409199953,TRX_N-00147-01217677,2022-05-22T22:29:43,Galdakao,expenses,repairs,-247.14,-14872.44
buyer_4,Jorge,,1974-05-23,ES23209580590409199953,TRX_N-00148-11454014,2022-05-23T18:38:19,Galdakao,expenses,cash,-100.0,-14972.44
buyer_4,Jorge,,1974-05-23,ES23209580590409199953,TRX_N-00149-66058128,2022-05-24T09:10:55,Galdakao,expenses,education,-64.29,-15036.73
buyer_4,Jorge,,1974-05-23,ES23209580590409199953,TRX_N-00150-58053939,2022-05-24T14:40:13,Galdakao,expenses,cash,-100.0,-15136.73
buyer_4,Jorge,,1974-05-23,ES23209580590409199953,TRX_N-00151-42413051,2022-05-26T22:26:24,Galdakao,expenses,cash,-100.0,-15236.73
buyer_4,Jorge,,1974-05-23,ES23209580590409199953,TRX_N-00152-52619960,2022-05-30T16:45:31,Galdakao,expenses,food,-79.52,-15316.25
buyer_4,Jorge,,1974-05-23,ES23209580590409199953,TRX_N-00153-71165712,2022-05-30T16:05:22,Galdakao,expenses,appliances,-338.14,-15654.39
buyer_4,Jorge,,1974-05-23,ES23209580590409199953,TRX_N-00154-11443737,2022-06-01T10:38:30,Galdakao,incomes,salary,1629.29,-14025.1
buyer_4,Jorge,,1974-05-23,ES23209580590409199953,TRX_N-00155-82349191,2022-06-01T10:38:30,Galdakao,incomes,extra_income,296.42,-13728.68
buyer_4,Jorge,,1974-05-23,ES23209580590409199953,TRX_N-00156-38062156,2022-06-01T10:38:30,Galdakao,incomes,salary_bonus,1232.82,-12495.86
buyer_4,Jorge,,1974-05-23,ES23209580590409199953,TRX_N-00157-09983824,2022-06-01T12:52:06,Galdakao,expenses,food,-119.21,-12615.07
buyer_4,Jorge,,1974-05-23,ES23209580590409199953,TRX_N-00158-74780122,2022-06-02T20:43:46,Hondarribia,expenses,food,-122.21,-12737.28
buyer_4,Jorge,,1974-05-23,ES23209580590409199953,TRX_N-00159-77734453,2022-06-02T08:33:17,Galdakao,expenses,children,-483.65,-13220.93
buyer_4,Jorge,,1974-05-23,ES23209580590409199953,TRX_N-00160-99943964,2022-06-04T21:38:47,Galdakao,expenses,mortgage,-1032.74,-14253.67
buyer_4,Jorge,,1974-05-23,ES23209580590409199953,TRX_N-00161-71264028,2022-06-04T16:08:14,Galdakao,expenses,leisure,-62.75,-14316.42
buyer_4,Jorge,,1974-05-23,ES23209580590409199953,TRX_N-00162-13288792,2022-06-04T19:16:24,Galdakao,expenses,clothing,-97.67,-14414.09
buyer_4,Jorge,,1974-05-23,ES23209580590409199953,TRX_N-00163-89486658,2022-06-04T08:12:42,Galdakao,expenses,healthcare,-60.65,-14474.74
buyer_4,Jorge,,1974-05-23,ES23209580590409199953,TRX_N-00164-05139081,2022-06-04T13:02:43,Berango,expenses,repairs,-168.42,-14643.16
buyer_4,Jorge,,1974-05-23,ES23209580590409199953,TRX_N-00165-62018873,2022-06-04T13:41:58,Galdakao,expenses,gifts,-580.92,-15224.08
buyer_4,Jorge,,1974-05-23,ES23209580590409199953,TRX_N-00166-26235892,2022-06-05T17:16:14,Galdakao,expenses,phone,-42.05,-15266.13
buyer_4,Jorge,,1974-05-23,ES23209580590409199953,TRX_N-00167-00269266,2022-06-06T10:12:03,Salvatierra/Agurain,expenses,food,-79.21,-15345.34
buyer_4,Jorge,,1974-05-23,ES23209580590409199953,TRX_N-00168-06756601,2022-06-08T09:39:37,Galdakao,expenses,water,-21.95,-15367.29
buyer_4,Jorge,,1974-05-23,ES23209580590409199953,TRX_N-00169-78973817,2022-06-08T13:31:08,Galdakao,expenses,electricity,-58.25,-15425.54
buyer_4,Jorge,,1974-05-23,ES23209580590409199953,TRX_N-00170-92180247,2022-06-08T12:12:59,Galdakao,expenses,gas,-65.57,-15491.11
buyer_4,Jorge,,1974-05-23,ES23209580590409199953,TRX_N-00171-60008564,2022-06-08T16:50:05,Galdakao,expenses,internet,-42.0,-15533.11
buyer_4,Jorge,,1974-05-23,ES23209580590409199953,TRX_N-00172-05890531,2022-06-09T12:19:15,Galdakao,expenses,gifts,-41.23,-15574.34
buyer_4,Jorge,,1974-05-23,ES23209580590409199953,TRX_N-00173-47157427,2022-06-10T00:40:53,Galdakao,expenses,food,-85.46,-15659.8
buyer_4,Jorge,,1974-05-23,ES23209580590409199953,TRX_N-00174-25772509,2022-06-10T03:06:05,Galdakao,expenses,cash,-100.0,-15759.8
buyer_4,Jorge,,1974-05-23,ES23209580590409199953,TRX_N-00175-35495642,2022-06-11T15:41:44,Galdakao,expenses,food,-82.05,-15841.85
buyer_4,Jorge,,1974-05-23,ES23209580590409199953,TRX_N-00176-15527663,2022-06-12T13:30:10,Galdakao,expenses,food,-81.56,-15923.41
buyer_4,Jorge,,1974-05-23,ES23209580590409199953,TRX_N-00177-88128847,2022-06-14T11:32:17,Galdakao,expenses,food,-66.14,-15989.55
buyer_4,Jorge,,1974-05-23,ES23209580590409199953,TRX_N-00178-78513136,2022-06-15T11:51:06,Galdakao,expenses,cash,-100.0,-16089.55
buyer_4,Jorge,,1974-05-23,ES23209580590409199953,TRX_N-00179-44710146,2022-06-16T18:16:29,Galdakao,expenses,transport,-46.11,-16135.66
buyer_4,Jorge,,1974-05-23,ES23209580590409199953,TRX_N-00180-91471418,2022-06-16T23:53:51,Galdakao,expenses,leisure,-66.3,-16201.96
buyer_4,Jorge,,1974-05-23,ES23209580590409199953,TRX_N-00181-19595183,2022-06-16T15:54:46,Galdakao,expenses,repairs,-326.72,-16528.68
buyer_4,Jorge,,1974-05-23,ES23209580590409199953,TRX_N-00182-42062901,2022-06-18T14:49:43,Galdakao,expenses,leisure,-57.29,-16585.97
buyer_4,Jorge,,1974-05-23,ES23209580590409199953,TRX_N-00183-29675595,2022-06-18T19:54:09,Galdakao,expenses,gifts,-157.4,-16743.37
buyer_4,Jorge,,1974-05-23,ES23209580590409199953,TRX_N-00184-97683430,2022-06-19T20:13:24,Galdakao,expenses,food,-116.88,-16860.25
buyer_4,Jorge,,1974-05-23,ES23209580590409199953,TRX_N-00185-67151013,2022-06-19T14:45:59,Galdakao,expenses,travel,-1572.48,-18432.73
buyer_4,Jorge,,1974-05-23,ES23209580590409199953,TRX_N-00186-53762521,2022-06-21T07:36:02,Galdakao,expenses,leisure,-27.33,-18460.06
buyer_4,Jorge,,1974-05-23,ES23209580590409199953,TRX_N-00187-52899281,2022-06-21T18:18:05,Galdakao,expenses,cash,-100.0,-18560.06
buyer_4,Jorge,,1974-05-23,ES23209580590409199953,TRX_N-00188-24432211,2022-06-21T07:08:40,Galdakao,expenses,gifts,-712.67,-19272.73
buyer_4,Jorge,,1974-05-23,ES23209580590409199953,TRX_N-00189-38234511,2022-06-24T13:07:19,Galdakao,expenses,food,-68.44,-19341.17
buyer_4,Jorge,,1974-05-23,ES23209580590409199953,TRX_N-00190-00793876,2022-06-25T20:33:15,Galdakao,expenses,transport,-56.82,-19397.99
buyer_4,Jorge,,1974-05-23,ES23209580590409199953,TRX_N-00191-08624276,2022-06-25T20:56:32,Galdakao,expenses,education,-53.96,-19451.95
buyer_4,Jorge,,1974-05-23,ES23209580590409199953,TRX_N-00192-82541594,2022-06-25T23:54:42,Barakaldo,expenses,gifts,-155.27,-19607.22
buyer_4,Jorge,,1974-05-23,ES23209580590409199953,TRX_N-00193-58570560,2022-06-26T19:38:26,Galdakao,expenses,leisure,-61.3,-19668.52
buyer_4,Jorge,,1974-05-23,ES23209580590409199953,TRX_N-00194-45881139,2022-06-26T05:25:07,Hernani,expenses,clothing,-75.62,-19744.14
buyer_4,Jorge,,1974-05-23,ES23209580590409199953,TRX_N-00195-41655726,2022-06-27T15:31:28,Galdakao,expenses,transport,-70.76,-19814.9
buyer_4,Jorge,,1974-05-23,ES23209580590409199953,TRX_N-00196-82688150,2022-06-27T14:07:15,Portugalete,expenses,travel,-1256.08,-21070.98
buyer_4,Jorge,,1974-05-23,ES23209580590409199953,TRX_N-00197-74937004,2022-06-28T10:50:18,Galdakao,expenses,food,-90.23,-21161.21
buyer_4,Jorge,,1974-05-23,ES23209580590409199953,TRX_N-00198-04375818,2022-06-28T01:08:13,Galdakao,expenses,education,-64.33,-21225.54
buyer_4,Jorge,,1974-05-23,ES23209580590409199953,TRX_N-00199-80027559,2022-06-30T07:27:40,Hondarribia,expenses,food,-82.92,-21308.46
buyer_4,Jorge,,1974-05-23,ES23209580590409199953,TRX_N-00200-17908961,2022-06-30T11:37:29,Galdakao,expenses,appliances,-252.14,-21560.6
buyer_4,Jorge,,1974-05-23,ES23209580590409199953,TRX_N-00201-50776913,2022-07-01T06:54:15,Galdakao,incomes,salary,1629.29,-19931.31
buyer_4,Jorge,,1974-05-23,ES23209580590409199953,TRX_N-00202-22016272,2022-07-01T05:01:34,Galdakao,expenses,travel,-1867.24,-21798.55
buyer_4,Jorge,,1974-05-23,ES23209580590409199953,TRX_N-00203-31640740,2022-07-02T01:15:55,Galdakao,expenses,food,-84.04,-21882.59
buyer_4,Jorge,,1974-05-23,ES23209580590409199953,TRX_N-00204-71217354,2022-07-02T15:31:18,Galdakao,expenses,transport,-69.04,-21951.63
buyer_4,Jorge,,1974-05-23,ES23209580590409199953,TRX_N-00205-56282400,2022-07-03T13:44:15,Galdakao,expenses,children,-803.28,-22754.91
buyer_4,Jorge,,1974-05-23,ES23209580590409199953,TRX_N-00206-74330654,2022-07-04T10:22:50,Galdakao,expenses,mortgage,-1032.74,-23787.65
buyer_4,Jorge,,1974-05-23,ES23209580590409199953,TRX_N-00207-10968952,2022-07-04T20:36:10,Galdakao,expenses,food,-68.88,-23856.53
buyer_4,Jorge,,1974-05-23,ES23209580590409199953,TRX_N-00208-26128357,2022-07-04T08:38:25,Galdakao,expenses,education,-48.02,-23904.55
buyer_4,Jorge,,1974-05-23,ES23209580590409199953,TRX_N-00209-63718929,2022-07-04T14:03:09,Eibar,expenses,repairs,-312.58,-24217.13
buyer_4,Jorge,,1974-05-23,ES23209580590409199953,TRX_N-00210-34684814,2022-07-05T19:56:19,Galdakao,expenses,electricity,-85.46,-24302.59
buyer_4,Jorge,,1974-05-23,ES23209580590409199953,TRX_N-00211-24398552,2022-07-05T07:09:09,Galdakao,expenses,phone,-40.03,-24342.62
buyer_4,Jorge,,1974-05-23,ES23209580590409199953,TRX_N-00212-00074264,2022-07-06T15:42:40,Galdakao,expenses,gas,-51.37,-24393.99
buyer_4,Jorge,,1974-05-23,ES23209580590409199953,TRX_N-00213-56659365,2022-07-06T17:31:14,Galdakao,expenses,cash,-100.0,-24493.99
buyer_4,Jorge,,1974-05-23,ES23209580590409199953,TRX_N-00214-14752670,2022-07-06T20:04:43,Galdakao,expenses,children,-828.72,-25322.71
buyer_4,Jorge,,1974-05-23,ES23209580590409199953,TRX_N-00215-55837094,2022-07-07T13:53:24,Galdakao,expenses,water,-36.02,-25358.73
buyer_4,Jorge,,1974-05-23,ES23209580590409199953,TRX_N-00216-81008369,2022-07-07T14:41:55,Galdakao,expenses,internet,-42.0,-25400.73
buyer_4,Jorge,,1974-05-23,ES23209580590409199953,TRX_N-00217-94125735,2022-07-08T16:40:08,Galdakao,expenses,food,-73.31,-25474.04
buyer_4,Jorge,,1974-05-23,ES23209580590409199953,TRX_N-00218-23360901,2022-07-08T10:56:27,Galdakao,expenses,cash,-100.0,-25574.04
buyer_4,Jorge,,1974-05-23,ES23209580590409199953,TRX_N-00219-54040601,2022-07-09T01:09:09,Galdakao,expenses,gifts,-242.22,-25816.26
buyer_4,Jorge,,1974-05-23,ES23209580590409199953,TRX_N-00220-91595947,2022-07-11T15:43:12,Galdakao,expenses,repairs,-257.16,-26073.42
buyer_4,Jorge,,1974-05-23,ES23209580590409199953,TRX_N-00221-69214742,2022-07-12T19:13:20,Galdakao,expenses,repairs,-157.68,-26231.1
buyer_4,Jorge,,1974-05-23,ES23209580590409199953,TRX_N-00222-00679105,2022-07-14T08:21:22,Galdakao,expenses,cash,-100.0,-26331.1
buyer_4,Jorge,,1974-05-23,ES23209580590409199953,TRX_N-00223-35463039,2022-07-15T07:39:21,Galdakao,expenses,repairs,-201.41,-26532.51
buyer_4,Jorge,,1974-05-23,ES23209580590409199953,TRX_N-00224-99589108,2022-07-16T10:06:17,Galdakao,expenses,repairs,-117.55,-26650.06
buyer_4,Jorge,,1974-05-23,ES23209580590409199953,TRX_N-00225-89254583,2022-07-17T15:50:01,Galdakao,expenses,cash,-100.0,-26750.06
buyer_4,Jorge,,1974-05-23,ES23209580590409199953,TRX_N-00226-72157048,2022-07-19T12:15:13,Galdakao,expenses,food,-104.88,-26854.94
buyer_4,Jorge,,1974-05-23,ES23209580590409199953,TRX_N-00227-31157203,2022-07-20T17:06:08,Galdakao,expenses,travel,-1640.46,-28495.4
buyer_4,Jorge,,1974-05-23,ES23209580590409199953,TRX_N-00228-69247308,2022-07-22T11:12:17,Galdakao,expenses,appliances,-84.84,-28580.24
buyer_4,Jorge,,1974-05-23,ES23209580590409199953,TRX_N-00229-76470441,2022-07-24T11:20:06,Galdakao,expenses,food,-76.8,-28657.04
buyer_4,Jorge,,1974-05-23,ES23209580590409199953,TRX_N-00230-31610028,2022-07-24T19:54:36,Galdakao,expenses,repairs,-240.13,-28897.17
buyer_4,Jorge,,1974-05-23,ES23209580590409199953,TRX_N-00231-54430141,2022-07-25T17:49:34,Galdakao,expenses,gifts,-187.59,-29084.76
buyer_4,Jorge,,1974-05-23,ES23209580590409199953,TRX_N-00232-79303314,2022-07-26T13:21:19,Galdakao,expenses,transport,-43.63,-29128.39
buyer_4,Jorge,,1974-05-23,ES23209580590409199953,TRX_N-00233-55979872,2022-07-31T19:51:35,Galdakao,expenses,leisure,-24.93,-29153.32
buyer_4,Jorge,,1974-05-23,ES23209580590409199953,TRX_N-00234-00624635,2022-08-01T15:23:39,Galdakao,incomes,salary,1629.29,-27524.03
buyer_4,Jorge,,1974-05-23,ES23209580590409199953,TRX_N-00235-11817795,2022-08-04T13:10:05,Galdakao,expenses,mortgage,-1032.74,-28556.77
buyer_4,Jorge,,1974-05-23,ES23209580590409199953,TRX_N-00236-24518921,2022-08-04T15:13:03,Galdakao,expenses,gifts,-296.04,-28852.81
buyer_4,Jorge,,1974-05-23,ES23209580590409199953,TRX_N-00237-32779102,2022-08-05T15:56:11,Galdakao,expenses,internet,-42.0,-28894.81
buyer_4,Jorge,,1974-05-23,ES23209580590409199953,TRX_N-00238-33415692,2022-08-07T20:44:05,Galdakao,expenses,gas,-49.0,-28943.81
buyer_4,Jorge,,1974-05-23,ES23209580590409199953,TRX_N-00239-86227350,2022-08-07T10:27:16,Galdakao,expenses,cash,-100.0,-29043.81
buyer_4,Jorge,,1974-05-23,ES23209580590409199953,TRX_N-00240-29765646,2022-08-08T18:40:27,Galdakao,expenses,water,-35.16,-29078.97
buyer_4,Jorge,,1974-05-23,ES23209580590409199953,TRX_N-00241-67470253,2022-08-08T08:04:10,Galdakao,expenses,electricity,-25.91,-29104.88
buyer_4,Jorge,,1974-05-23,ES23209580590409199953,TRX_N-00242-48337472,2022-08-08T10:13:24,Galdakao,expenses,phone,-35.58,-29140.46
buyer_4,Jorge,,1974-05-23,ES23209580590409199953,TRX_N-00243-90929916,2022-08-08T12:05:25,Irun,expenses,appliances,-349.89,-29490.35
buyer_4,Jorge,,1974-05-23,ES23209580590409199953,TRX_N-00244-36495260,2022-08-08T11:40:03,Galdakao,expenses,children,-577.92,-30068.27
buyer_4,Jorge,,1974-05-23,ES23209580590409199953,TRX_N-00245-62795588,2022-08-12T10:34:52,Salvatierra/Agurain,expenses,cash,-100.0,-30168.27
buyer_4,Jorge,,1974-05-23,ES23209580590409199953,TRX_N-00246-89473195,2022-08-15T13:30:29,Galdakao,expenses,food,-74.69,-30242.96
buyer_4,Jorge,,1974-05-23,ES23209580590409199953,TRX_N-00247-57167627,2022-08-19T22:47:03,Galdakao,expenses,gifts,-291.88,-30534.84
buyer_4,Jorge,,1974-05-23,ES23209580590409199953,TRX_N-00248-77621680,2022-08-21T19:57:55,Galdakao,expenses,cash,-100.0,-30634.84
buyer_4,Jorge,,1974-05-23,ES23209580590409199953,TRX_N-00249-94615043,2022-08-21T18:04:24,Sestao,expenses,repairs,-40.9,-30675.74
buyer_4,Jorge,,1974-05-23,ES23209580590409199953,TRX_N-00250-06946446,2022-08-25T17:07:42,Erandio,expenses,cash,-100.0,-30775.74
buyer_4,Jorge,,1974-05-23,ES23209580590409199953,TRX_N-00251-07162708,2022-08-26T18:10:57,Galdakao,expenses,gifts,-122.68,-30898.42
buyer_4,Jorge,,1974-05-23,ES23209580590409199953,TRX_N-00252-42020304,2022-08-27T17:21:19,Galdakao,expenses,food,-114.83,-31013.25
buyer_4,Jorge,,1974-05-23,ES23209580590409199953,TRX_N-00253-88141352,2022-08-28T17:12:41,Amurrio,expenses,cash,-100.0,-31113.25
buyer_4,Jorge,,1974-05-23,ES23209580590409199953,TRX_N-00254-70056144,2022-08-30T10:36:26,Galdakao,expenses,leisure,-43.02,-31156.27
buyer_4,Jorge,,1974-05-23,ES23209580590409199953,TRX_N-00255-28444852,2022-08-30T11:48:30,Galdakao,expenses,gifts,-581.68,-31737.95
buyer_4,Jorge,,1974-05-23,ES23209580590409199953,TRX_N-00256-41138303,2022-09-01T18:56:26,Galdakao,incomes,salary,1629.29,-30108.66
buyer_4,Jorge,,1974-05-23,ES23209580590409199953,TRX_N-00257-49362815,2022-09-01T20:16:46,Galdakao,expenses,gifts,-361.02,-30469.68
buyer_4,Jorge,,1974-05-23,ES23209580590409199953,TRX_N-00258-46848118,2022-09-04T16:06:46,Galdakao,expenses,mortgage,-1032.74,-31502.42
buyer_4,Jorge,,1974-05-23,ES23209580590409199953,TRX_N-00259-29923020,2022-09-04T23:02:43,Irun,expenses,cash,-100.0,-31602.42
buyer_4,Jorge,,1974-05-23,ES23209580590409199953,TRX_N-00260-74174539,2022-09-05T09:24:22,Galdakao,expenses,electricity,-72.97,-31675.39
buyer_4,Jorge,,1974-05-23,ES23209580590409199953,TRX_N-00261-82501475,2022-09-05T19:12:09,Galdakao,expenses,internet,-42.0,-31717.39
buyer_4,Jorge,,1974-05-23,ES23209580590409199953,TRX_N-00262-76590201,2022-09-05T02:31:35,Galdakao,expenses,cash,-100.0,-31817.39
buyer_4,Jorge,,1974-05-23,ES23209580590409199953,TRX_N-00263-79523481,2022-09-06T15:34:51,Galdakao,expenses,phone,-42.44,-31859.83
buyer_4,Jorge,,1974-05-23,ES23209580590409199953,TRX_N-00264-53553269,2022-09-06T12:36:50,Erandio,expenses,food,-75.3,-31935.13
buyer_4,Jorge,,1974-05-23,ES23209580590409199953,TRX_N-00265-53800419,2022-09-06T11:35:49,Galdakao,expenses,healthcare,-99.55,-32034.68
buyer_4,Jorge,,1974-05-23,ES23209580590409199953,TRX_N-00266-28700978,2022-09-06T11:39:40,Galdakao,expenses,cash,-100.0,-32134.68
buyer_4,Jorge,,1974-05-23,ES23209580590409199953,TRX_N-00267-83077505,2022-09-07T13:28:13,Galdakao,expenses,children,-937.78,-33072.46
buyer_4,Jorge,,1974-05-23,ES23209580590409199953,TRX_N-00268-08324200,2022-09-08T10:06:10,Galdakao,expenses,gas,-87.54,-33160.0
buyer_4,Jorge,,1974-05-23,ES23209580590409199953,TRX_N-00269-72378949,2022-09-08T15:32:31,Galdakao,expenses,water,-40.61,-33200.61
buyer_4,Jorge,,1974-05-23,ES23209580590409199953,TRX_N-00270-75288709,2022-09-08T09:35:03,Andoain,expenses,cash,-100.0,-33300.61
buyer_4,Jorge,,1974-05-23,ES23209580590409199953,TRX_N-00271-15274412,2022-09-08T13:59:00,Getxo,expenses,repairs,-124.7,-33425.31
buyer_4,Jorge,,1974-05-23,ES23209580590409199953,TRX_N-00272-30249228,2022-09-09T23:36:18,Galdakao,expenses,appliances,-391.64,-33816.95
buyer_4,Jorge,,1974-05-23,ES23209580590409199953,TRX_N-00273-10163239,2022-09-10T09:30:44,Galdakao,expenses,cash,-100.0,-33916.95
buyer_4,Jorge,,1974-05-23,ES23209580590409199953,TRX_N-00274-64723125,2022-09-10T17:36:52,Galdakao,expenses,gifts,-256.82,-34173.77
buyer_4,Jorge,,1974-05-23,ES23209580590409199953,TRX_N-00275-80833550,2022-09-13T13:35:08,Galdakao,expenses,food,-91.36,-34265.13
buyer_4,Jorge,,1974-05-23,ES23209580590409199953,TRX_N-00276-74369181,2022-09-14T22:17:20,Basauri,expenses,healthcare,-175.88,-34441.01
buyer_4,Jorge,,1974-05-23,ES23209580590409199953,TRX_N-00277-01002429,2022-09-15T08:05:25,Galdakao,expenses,food,-65.59,-34506.6
buyer_4,Jorge,,1974-05-23,ES23209580590409199953,TRX_N-00278-18106751,2022-09-15T18:09:11,Galdakao,expenses,transport,-64.48,-34571.08
buyer_4,Jorge,,1974-05-23,ES23209580590409199953,TRX_N-00279-23399928,2022-09-15T20:39:56,Galdakao,expenses,education,-50.71,-34621.79
buyer_4,Jorge,,1974-05-23,ES23209580590409199953,TRX_N-00280-47800987,2022-09-15T13:40:09,Galdakao,expenses,cash,-100.0,-34721.79
buyer_4,Jorge,,1974-05-23,ES23209580590409199953,TRX_N-00281-97911776,2022-09-15T14:50:21,Galdakao,expenses,repairs,-315.54,-35037.33
buyer_4,Jorge,,1974-05-23,ES23209580590409199953,TRX_N-00282-00226295,2022-09-19T08:23:32,Galdakao,expenses,leisure,-19.6,-35056.93
buyer_4,Jorge,,1974-05-23,ES23209580590409199953,TRX_N-00283-35476448,2022-09-21T13:28:12,Galdakao,expenses,cash,-100.0,-35156.93
buyer_4,Jorge,,1974-05-23,ES23209580590409199953,TRX_N-00284-71243834,2022-09-22T21:31:24,Galdakao,expenses,food,-107.79,-35264.72
buyer_4,Jorge,,1974-05-23,ES23209580590409199953,TRX_N-00285-30512382,2022-09-22T17:25:30,Galdakao,expenses,gifts,-701.8,-35966.52
buyer_4,Jorge,,1974-05-23,ES23209580590409199953,TRX_N-00286-82372995,2022-09-23T13:29:39,Galdakao,expenses,food,-85.64,-36052.16
buyer_4,Jorge,,1974-05-23,ES23209580590409199953,TRX_N-00287-72730881,2022-09-26T15:46:22,Galdakao,expenses,transport,-49.83,-36101.99
buyer_4,Jorge,,1974-05-23,ES23209580590409199953,TRX_N-00288-76321083,2022-09-28T17:57:45,Galdakao,expenses,repairs,-96.76,-36198.75
buyer_4,Jorge,,1974-05-23,ES23209580590409199953,TRX_N-00289-80868167,2022-09-29T20:05:33,Galdakao,expenses,cash,-100.0,-36298.75
buyer_4,Jorge,,1974-05-23,ES23209580590409199953,TRX_N-00290-63732710,2022-10-01T13:19:51,Galdakao,incomes,salary,1629.29,-34669.46
buyer_4,Jorge,,1974-05-23,ES23209580590409199953,TRX_N-00291-12657921,2022-10-01T13:19:51,Galdakao,incomes,extra_income,296.42,-34373.04
buyer_4,Jorge,,1974-05-23,ES23209580590409199953,TRX_N-00292-63412610,2022-10-01T11:19:10,Galdakao,expenses,food,-69.66,-34442.7
buyer_4,Jorge,,1974-05-23,ES23209580590409199953,TRX_N-00293-57401951,2022-10-01T15:09:15,Galdakao,expenses,transport,-87.59,-34530.29
buyer_4,Jorge,,1974-05-23,ES23209580590409199953,TRX_N-00294-23294182,2022-10-02T19:27:40,Galdakao,expenses,clothing,-89.64,-34619.93
buyer_4,Jorge,,1974-05-23,ES23209580590409199953,TRX_N-00295-67069083,2022-10-04T17:49:08,Galdakao,expenses,mortgage,-1032.74,-35652.67
buyer_4,Jorge,,1974-05-23,ES23209580590409199953,TRX_N-00296-29950583,2022-10-04T20:59:24,Galdakao,expenses,education,-52.11,-35704.78
buyer_4,Jorge,,1974-05-23,ES23209580590409199953,TRX_N-00297-77749277,2022-10-04T14:27:14,Galdakao,expenses,gifts,-757.95,-36462.73
buyer_4,Jorge,,1974-05-23,ES23209580590409199953,TRX_N-00298-51637378,2022-10-05T10:36:35,Galdakao,expenses,food,-96.91,-36559.64
buyer_4,Jorge,,1974-05-23,ES23209580590409199953,TRX_N-00299-82803511,2022-10-06T20:50:04,Galdakao,expenses,water,-34.38,-36594.02
buyer_4,Jorge,,1974-05-23,ES23209580590409199953,TRX_N-00300-65652420,2022-10-07T14:13:48,Galdakao,expenses,phone,-31.37,-36625.39
buyer_4,Jorge,,1974-05-23,ES23209580590409199953,TRX_N-00301-65631636,2022-10-08T15:55:24,Galdakao,expenses,internet,-42.0,-36667.39
buyer_4,Jorge,,1974-05-23,ES23209580590409199953,TRX_N-00302-53448208,2022-10-08T12:03:14,Galdakao,expenses,electricity,-39.97,-36707.36
buyer_4,Jorge,,1974-05-23,ES23209580590409199953,TRX_N-00303-65380350,2022-10-08T06:54:42,Galdakao,expenses,gas,-82.77,-36790.13
buyer_4,Jorge,,1974-05-23,ES23209580590409199953,TRX_N-00304-77581732,2022-10-08T13:08:20,Galdakao,expenses,leisure,-37.08,-36827.21
buyer_4,Jorge,,1974-05-23,ES23209580590409199953,TRX_N-00305-85077954,2022-10-08T15:33:35,Galdakao,expenses,healthcare,-90.65,-36917.86
buyer_4,Jorge,,1974-05-23,ES23209580590409199953,TRX_N-00306-38304083,2022-10-09T20:47:12,Galdakao,expenses,gifts,-749.89,-37667.75
buyer_4,Jorge,,1974-05-23,ES23209580590409199953,TRX_N-00307-92583954,2022-10-11T18:34:50,Galdakao,expenses,food,-118.72,-37786.47
buyer_4,Jorge,,1974-05-23,ES23209580590409199953,TRX_N-00308-88309201,2022-10-11T10:49:26,Galdakao,expenses,clothing,-50.99,-37837.46
buyer_4,Jorge,,1974-05-23,ES23209580590409199953,TRX_N-00309-42270785,2022-10-12T20:57:12,Galdakao,expenses,transport,-87.25,-37924.71
buyer_4,Jorge,,1974-05-23,ES23209580590409199953,TRX_N-00310-66923105,2022-10-13T18:26:18,Galdakao,expenses,gifts,-190.69,-38115.4
buyer_4,Jorge,,1974-05-23,ES23209580590409199953,TRX_N-00311-97697455,2022-10-14T09:11:18,Iru√±a de Oca,expenses,transport,-81.05,-38196.45
buyer_4,Jorge,,1974-05-23,ES23209580590409199953,TRX_N-00312-24749284,2022-10-15T12:20:11,Galdakao,expenses,food,-98.08,-38294.53
buyer_4,Jorge,,1974-05-23,ES23209580590409199953,TRX_N-00313-52386842,2022-10-15T15:55:36,Galdakao,expenses,appliances,-331.74,-38626.27
buyer_4,Jorge,,1974-05-23,ES23209580590409199953,TRX_N-00314-90873704,2022-10-20T17:19:52,Galdakao,expenses,transport,-76.75,-38703.02
buyer_4,Jorge,,1974-05-23,ES23209580590409199953,TRX_N-00315-33904055,2022-10-20T15:58:01,Galdakao,expenses,leisure,-61.35,-38764.37
buyer_4,Jorge,,1974-05-23,ES23209580590409199953,TRX_N-00316-35983930,2022-10-25T14:22:11,Galdakao,expenses,cash,-100.0,-38864.37
buyer_4,Jorge,,1974-05-23,ES23209580590409199953,TRX_N-00317-20938240,2022-10-25T20:39:36,Galdakao,expenses,repairs,-293.29,-39157.66
buyer_4,Jorge,,1974-05-23,ES23209580590409199953,TRX_N-00318-84321880,2022-10-27T13:59:57,Galdakao,expenses,transport,-84.83,-39242.49
buyer_4,Jorge,,1974-05-23,ES23209580590409199953,TRX_N-00319-38629008,2022-10-27T08:03:05,Galdakao,expenses,children,-1182.72,-40425.21
buyer_4,Jorge,,1974-05-23,ES23209580590409199953,TRX_N-00320-97183848,2022-10-28T08:26:15,Hondarribia,expenses,cash,-100.0,-40525.21
buyer_4,Jorge,,1974-05-23,ES23209580590409199953,TRX_N-00321-31317158,2022-10-30T11:54:21,Galdakao,expenses,food,-107.32,-40632.53
buyer_4,Jorge,,1974-05-23,ES23209580590409199953,TRX_N-00322-12728777,2022-10-30T12:00:50,Galdakao,expenses,children,-1136.35,-41768.88
buyer_4,Jorge,,1974-05-23,ES23209580590409199953,TRX_N-00323-97503177,2022-10-31T10:45:14,Arrasate,expenses,leisure,-73.71,-41842.59
buyer_4,Jorge,,1974-05-23,ES23209580590409199953,TRX_N-00324-83860115,2022-11-01T19:13:24,Galdakao,incomes,salary,1629.29,-40213.3
buyer_4,Jorge,,1974-05-23,ES23209580590409199953,TRX_N-00325-71667425,2022-11-01T23:54:46,Galdakao,expenses,transport,-88.83,-40302.13
buyer_4,Jorge,,1974-05-23,ES23209580590409199953,TRX_N-00326-63680086,2022-11-01T15:38:12,Vitoria-Gasteiz,expenses,repairs,-313.92,-40616.05
buyer_4,Jorge,,1974-05-23,ES23209580590409199953,TRX_N-00327-82918270,2022-11-04T13:17:20,Galdakao,expenses,mortgage,-1032.74,-41648.79
buyer_4,Jorge,,1974-05-23,ES23209580590409199953,TRX_N-00328-34591458,2022-11-04T11:04:30,Galdakao,expenses,transport,-64.93,-41713.72
buyer_4,Jorge,,1974-05-23,ES23209580590409199953,TRX_N-00329-50207951,2022-11-04T10:42:56,Hernani,expenses,leisure,-68.47,-41782.19
buyer_4,Jorge,,1974-05-23,ES23209580590409199953,TRX_N-00330-19985416,2022-11-04T16:34:46,Galdakao,expenses,gifts,-174.7,-41956.89
buyer_4,Jorge,,1974-05-23,ES23209580590409199953,TRX_N-00331-69077159,2022-11-05T16:18:05,Galdakao,expenses,food,-74.63,-42031.52
buyer_4,Jorge,,1974-05-23,ES23209580590409199953,TRX_N-00332-04143939,2022-11-05T14:51:24,Galdakao,expenses,cash,-100.0,-42131.52
buyer_4,Jorge,,1974-05-23,ES23209580590409199953,TRX_N-00333-15523806,2022-11-05T09:30:49,Galdakao,expenses,car,-264.11,-42395.63
buyer_4,Jorge,,1974-05-23,ES23209580590409199953,TRX_N-00334-95057176,2022-11-06T11:02:11,Galdakao,expenses,internet,-42.0,-42437.63
buyer_4,Jorge,,1974-05-23,ES23209580590409199953,TRX_N-00335-57647700,2022-11-07T08:03:48,Galdakao,expenses,water,-32.75,-42470.38
buyer_4,Jorge,,1974-05-23,ES23209580590409199953,TRX_N-00336-70985281,2022-11-07T15:04:16,Galdakao,expenses,food,-89.82,-42560.2
buyer_4,Jorge,,1974-05-23,ES23209580590409199953,TRX_N-00337-95654011,2022-11-08T11:38:56,Galdakao,expenses,electricity,-46.49,-42606.69
buyer_4,Jorge,,1974-05-23,ES23209580590409199953,TRX_N-00338-85170495,2022-11-08T09:01:02,Galdakao,expenses,gas,-58.33,-42665.02
buyer_4,Jorge,,1974-05-23,ES23209580590409199953,TRX_N-00339-90231954,2022-11-08T23:47:55,Galdakao,expenses,phone,-35.17,-42700.19
buyer_4,Jorge,,1974-05-23,ES23209580590409199953,TRX_N-00340-42185063,2022-11-11T16:13:18,Galdakao,expenses,transport,-48.88,-42749.07
buyer_4,Jorge,,1974-05-23,ES23209580590409199953,TRX_N-00341-44981050,2022-11-11T13:08:27,Galdakao,expenses,leisure,-44.38,-42793.45
buyer_4,Jorge,,1974-05-23,ES23209580590409199953,TRX_N-00342-97174245,2022-11-11T21:34:30,Galdakao,expenses,cash,-100.0,-42893.45
buyer_4,Jorge,,1974-05-23,ES23209580590409199953,TRX_N-00343-32883926,2022-11-14T18:03:41,Salvatierra/Agurain,expenses,cash,-100.0,-42993.45
buyer_4,Jorge,,1974-05-23,ES23209580590409199953,TRX_N-00344-63459532,2022-11-14T15:24:53,Galdakao,expenses,children,-279.74,-43273.19
buyer_4,Jorge,,1974-05-23,ES23209580590409199953,TRX_N-00345-37104330,2022-11-15T20:23:08,Galdakao,expenses,food,-101.08,-43374.27
buyer_4,Jorge,,1974-05-23,ES23209580590409199953,TRX_N-00346-40584022,2022-11-15T13:04:00,Galdakao,expenses,repairs,-76.04,-43450.31
buyer_4,Jorge,,1974-05-23,ES23209580590409199953,TRX_N-00347-42099894,2022-11-17T11:43:10,Oy√≥n-Oion,expenses,food,-115.25,-43565.56
buyer_4,Jorge,,1974-05-23,ES23209580590409199953,TRX_N-00348-28077004,2022-11-18T16:49:12,Galdakao,expenses,food,-72.77,-43638.33
buyer_4,Jorge,,1974-05-23,ES23209580590409199953,TRX_N-00349-78568656,2022-11-18T15:56:59,Galdakao,expenses,leisure,-29.07,-43667.4
buyer_4,Jorge,,1974-05-23,ES23209580590409199953,TRX_N-00350-06920852,2022-11-19T20:00:49,Durango,expenses,leisure,-44.8,-43712.2
buyer_4,Jorge,,1974-05-23,ES23209580590409199953,TRX_N-00351-88710980,2022-11-20T14:09:57,Galdakao,expenses,leisure,-77.2,-43789.4
buyer_4,Jorge,,1974-05-23,ES23209580590409199953,TRX_N-00352-29750415,2022-11-21T05:16:37,Galdakao,expenses,food,-92.61,-43882.01
buyer_4,Jorge,,1974-05-23,ES23209580590409199953,TRX_N-00353-82960270,2022-11-21T10:13:19,Galdakao,expenses,transport,-82.32,-43964.33
buyer_4,Jorge,,1974-05-23,ES23209580590409199953,TRX_N-00354-76185471,2022-11-21T19:15:48,Galdakao,expenses,children,-1258.13,-45222.46
buyer_4,Jorge,,1974-05-23,ES23209580590409199953,TRX_N-00355-95159268,2022-11-24T11:33:09,Galdakao,expenses,cash,-100.0,-45322.46
buyer_4,Jorge,,1974-05-23,ES23209580590409199953,TRX_N-00356-24083110,2022-11-27T20:12:16,Galdakao,expenses,transport,-63.86,-45386.32
buyer_4,Jorge,,1974-05-23,ES23209580590409199953,TRX_N-00357-25134058,2022-11-27T15:38:35,Galdakao,expenses,cash,-100.0,-45486.32
buyer_4,Jorge,,1974-05-23,ES23209580590409199953,TRX_N-00358-34024826,2022-11-29T16:31:13,Galdakao,expenses,leisure,-50.27,-45536.59
buyer_4,Jorge,,1974-05-23,ES23209580590409199953,TRX_N-00359-29645055,2022-11-29T14:11:15,Galdakao,expenses,cash,-100.0,-45636.59
buyer_4,Jorge,,1974-05-23,ES23209580590409199953,TRX_N-00360-77896593,2022-11-30T18:48:24,Hernani,expenses,food,-64.24,-45700.83
buyer_4,Jorge,,1974-05-23,ES23209580590409199953,TRX_N-00361-68185342,2022-11-30T07:06:13,Galdakao,expenses,repairs,-291.26,-45992.09
buyer_4,Jorge,,1974-05-23,ES23209580590409199953,TRX_N-00362-80928345,2022-12-01T22:34:39,Galdakao,incomes,salary,1629.29,-44362.8
buyer_4,Jorge,,1974-05-23,ES23209580590409199953,TRX_N-00363-25536543,2022-12-01T22:34:39,Galdakao,incomes,salary_bonus,1176.64,-43186.16
buyer_4,Jorge,,1974-05-23,ES23209580590409199953,TRX_N-00364-89012617,2022-12-01T09:03:22,Galdakao,expenses,appliances,-282.49,-43468.65
buyer_4,Jorge,,1974-05-23,ES23209580590409199953,TRX_N-00365-56608403,2022-12-02T18:49:41,Galdakao,expenses,food,-71.75,-43540.4
buyer_4,Jorge,,1974-05-23,ES23209580590409199953,TRX_N-00366-70672400,2022-12-04T10:20:30,Galdakao,expenses,mortgage,-1032.74,-44573.14
buyer_4,Jorge,,1974-05-23,ES23209580590409199953,TRX_N-00367-44477211,2022-12-04T16:40:09,Galdakao,expenses,cash,-100.0,-44673.14
buyer_4,Jorge,,1974-05-23,ES23209580590409199953,TRX_N-00368-59705822,2022-12-05T17:52:08,Galdakao,expenses,phone,-39.82,-44712.96
buyer_4,Jorge,,1974-05-23,ES23209580590409199953,TRX_N-00369-02703770,2022-12-05T02:01:37,Sestao,expenses,food,-76.5,-44789.46
buyer_4,Jorge,,1974-05-23,ES23209580590409199953,TRX_N-00370-52797385,2022-12-06T15:37:19,Galdakao,expenses,electricity,-87.25,-44876.71
buyer_4,Jorge,,1974-05-23,ES23209580590409199953,TRX_N-00371-86651123,2022-12-06T15:14:13,Galdakao,expenses,internet,-42.0,-44918.71
buyer_4,Jorge,,1974-05-23,ES23209580590409199953,TRX_N-00372-73659163,2022-12-07T08:01:30,Galdakao,expenses,water,-30.14,-44948.85
buyer_4,Jorge,,1974-05-23,ES23209580590409199953,TRX_N-00373-64624943,2022-12-07T02:25:12,Galdakao,expenses,gas,-111.33,-45060.18
buyer_4,Jorge,,1974-05-23,ES23209580590409199953,TRX_N-00374-73042083,2022-12-08T13:48:18,Errenteria,expenses,food,-98.9,-45159.08
buyer_4,Jorge,,1974-05-23,ES23209580590409199953,TRX_N-00375-77270434,2022-12-08T16:13:51,Galdakao,expenses,transport,-46.36,-45205.44
buyer_4,Jorge,,1974-05-23,ES23209580590409199953,TRX_N-00376-67894079,2022-12-08T02:50:00,Galdakao,expenses,cash,-100.0,-45305.44
buyer_4,Jorge,,1974-05-23,ES23209580590409199953,TRX_N-00377-39124541,2022-12-10T13:06:16,Zuia,expenses,gifts,-49.59,-45355.03
buyer_4,Jorge,,1974-05-23,ES23209580590409199953,TRX_N-00378-66105086,2022-12-11T09:42:15,Galdakao,expenses,gifts,-841.34,-46196.37
buyer_4,Jorge,,1974-05-23,ES23209580590409199953,TRX_N-00379-97601747,2022-12-12T17:07:33,Elciego,expenses,transport,-43.13,-46239.5
buyer_4,Jorge,,1974-05-23,ES23209580590409199953,TRX_N-00380-54503952,2022-12-12T18:48:00,Galdakao,expenses,leisure,-76.73,-46316.23
buyer_4,Jorge,,1974-05-23,ES23209580590409199953,TRX_N-00381-14406268,2022-12-12T08:19:20,Galdakao,expenses,travel,-1380.39,-47696.62
buyer_4,Jorge,,1974-05-23,ES23209580590409199953,TRX_N-00382-21977913,2022-12-14T20:20:24,Galdakao,expenses,clothing,-147.97,-47844.59
buyer_4,Jorge,,1974-05-23,ES23209580590409199953,TRX_N-00383-75742676,2022-12-14T20:35:46,Galdakao,expenses,appliances,-248.27,-48092.86
buyer_4,Jorge,,1974-05-23,ES23209580590409199953,TRX_N-00384-68093323,2022-12-15T06:31:15,Sopela,expenses,transport,-85.9,-48178.76
buyer_4,Jorge,,1974-05-23,ES23209580590409199953,TRX_N-00385-61068390,2022-12-15T08:28:58,Galdakao,expenses,education,-64.87,-48243.63
buyer_4,Jorge,,1974-05-23,ES23209580590409199953,TRX_N-00386-27321654,2022-12-15T10:58:32,Galdakao,expenses,cash,-100.0,-48343.63
buyer_4,Jorge,,1974-05-23,ES23209580590409199953,TRX_N-00387-35792976,2022-12-16T09:48:06,Galdakao,expenses,cash,-100.0,-48443.63
buyer_4,Jorge,,1974-05-23,ES23209580590409199953,TRX_N-00388-69859595,2022-12-17T16:49:08,Galdakao,expenses,leisure,-45.21,-48488.84
buyer_4,Jorge,,1974-05-23,ES23209580590409199953,TRX_N-00389-30399417,2022-12-21T16:32:37,Galdakao,expenses,food,-66.51,-48555.35
buyer_4,Jorge,,1974-05-23,ES23209580590409199953,TRX_N-00390-40545000,2022-12-21T17:15:06,Galdakao,expenses,transport,-74.97,-48630.32
buyer_4,Jorge,,1974-05-23,ES23209580590409199953,TRX_N-00391-91778362,2022-12-23T13:07:42,Galdakao,expenses,education,-73.36,-48703.68
buyer_4,Jorge,,1974-05-23,ES23209580590409199953,TRX_N-00392-93155963,2022-12-27T11:14:52,Galdakao,expenses,transport,-81.16,-48784.84
buyer_4,Jorge,,1974-05-23,ES23209580590409199953,TRX_N-00393-54171369,2022-12-28T22:17:40,Galdakao,expenses,clothing,-62.88,-48847.72
buyer_4,Jorge,,1974-05-23,ES23209580590409199953,TRX_N-00394-94678304,2022-12-29T15:52:15,Galdakao,expenses,food,-62.95,-48910.67
buyer_4,Jorge,,1974-05-23,ES23209580590409199953,TRX_N-00395-85644959,2022-12-29T10:24:26,Galdakao,expenses,children,-351.12,-49261.79
buyer_4,Jorge,,1974-05-23,ES23209580590409199953,TRX_N-00396-96198870,2022-12-30T11:03:12,Galdakao,expenses,cash,-100.0,-49361.79
buyer_4,Jorge,,1974-05-23,ES23209580590409199953,TRX_N-00397-07530009,2022-12-31T16:27:43,Galdakao,expenses,cash,-100.0,-49461.79
buyer_4,Jorge,,1974-05-23,ES23209580590409199953,TRX_N-00398-53179213,2023-01-01T16:50:40,Galdakao,incomes,salary,1690.87,-47770.92
buyer_4,Jorge,,1974-05-23,ES23209580590409199953,TRX_N-00399-91363222,2023-01-01T16:50:40,Galdakao,incomes,extra_income,296.42,-47474.5
buyer_4,Jorge,,1974-05-23,ES23209580590409199953,TRX_N-00400-68686951,2023-01-01T16:46:30,Galdakao,expenses,leisure,-61.79,-47536.29
buyer_4,Jorge,,1974-05-23,ES23209580590409199953,TRX_N-00401-93445662,2023-01-03T02:05:55,Galdakao,expenses,gifts,-115.16,-47651.45
buyer_4,Jorge,,1974-05-23,ES23209580590409199953,TRX_N-00402-42485361,2023-01-04T14:46:46,Galdakao,expenses,mortgage,-1032.74,-48684.19
buyer_4,Jorge,,1974-05-23,ES23209580590409199953,TRX_N-00403-38253464,2023-01-05T20:32:09,Galdakao,expenses,internet,-42.0,-48726.19
buyer_4,Jorge,,1974-05-23,ES23209580590409199953,TRX_N-00404-85056569,2023-01-05T18:31:04,Galdakao,expenses,leisure,-29.26,-48755.45
buyer_4,Jorge,,1974-05-23,ES23209580590409199953,TRX_N-00405-17844656,2023-01-06T06:17:30,Galdakao,expenses,leisure,-70.88,-48826.33
buyer_4,Jorge,,1974-05-23,ES23209580590409199953,TRX_N-00406-07987169,2023-01-08T16:09:34,Galdakao,expenses,water,-25.69,-48852.02
buyer_4,Jorge,,1974-05-23,ES23209580590409199953,TRX_N-00407-26826981,2023-01-08T11:14:41,Galdakao,expenses,electricity,-71.35,-48923.37
buyer_4,Jorge,,1974-05-23,ES23209580590409199953,TRX_N-00408-47818650,2023-01-08T16:52:35,Galdakao,expenses,gas,-87.87,-49011.24
buyer_4,Jorge,,1974-05-23,ES23209580590409199953,TRX_N-00409-54567874,2023-01-08T12:27:52,Galdakao,expenses,phone,-31.02,-49042.26
buyer_4,Jorge,,1974-05-23,ES23209580590409199953,TRX_N-00410-13138274,2023-01-09T01:27:11,Galdakao,expenses,food,-97.05,-49139.31
buyer_4,Jorge,,1974-05-23,ES23209580590409199953,TRX_N-00411-47953013,2023-01-09T18:53:28,Galdakao,expenses,cash,-100.0,-49239.31
buyer_4,Jorge,,1974-05-23,ES23209580590409199953,TRX_N-00412-61855676,2023-01-10T15:34:33,Galdakao,expenses,clothing,-95.51,-49334.82
buyer_4,Jorge,,1974-05-23,ES23209580590409199953,TRX_N-00413-79583818,2023-01-10T21:54:30,Galdakao,expenses,children,-718.56,-50053.38
buyer_4,Jorge,,1974-05-23,ES23209580590409199953,TRX_N-00414-96044232,2023-01-16T22:14:25,Galdakao,expenses,transport,-50.71,-50104.09
buyer_4,Jorge,,1974-05-23,ES23209580590409199953,TRX_N-00415-10440014,2023-01-17T14:55:23,Galdakao,expenses,food,-122.95,-50227.04
buyer_4,Jorge,,1974-05-23,ES23209580590409199953,TRX_N-00416-42947107,2023-01-17T10:41:04,Galdakao,expenses,cash,-100.0,-50327.04
buyer_4,Jorge,,1974-05-23,ES23209580590409199953,TRX_N-00417-03841062,2023-01-18T12:04:41,Galdakao,expenses,leisure,-80.7,-50407.74
buyer_4,Jorge,,1974-05-23,ES23209580590409199953,TRX_N-00418-48437214,2023-01-19T14:28:02,Galdakao,expenses,food,-102.91,-50510.65
buyer_4,Jorge,,1974-05-23,ES23209580590409199953,TRX_N-00419-38486207,2023-01-21T21:23:38,Galdakao,expenses,leisure,-22.71,-50533.36
buyer_4,Jorge,,1974-05-23,ES23209580590409199953,TRX_N-00420-62093751,2023-01-21T16:27:45,Mungia,expenses,cash,-100.0,-50633.36
buyer_4,Jorge,,1974-05-23,ES23209580590409199953,TRX_N-00421-93968390,2023-01-22T11:15:18,Basauri,expenses,transport,-62.0,-50695.36
buyer_4,Jorge,,1974-05-23,ES23209580590409199953,TRX_N-00422-68687312,2023-01-22T19:04:59,Galdakao,expenses,leisure,-40.98,-50736.34
buyer_4,Jorge,,1974-05-23,ES23209580590409199953,TRX_N-00423-16608201,2023-01-22T08:45:02,Galdakao,expenses,healthcare,-144.46,-50880.8
buyer_4,Jorge,,1974-05-23,ES23209580590409199953,TRX_N-00424-54087496,2023-01-22T09:54:39,Erandio,expenses,repairs,-76.54,-50957.34
buyer_4,Jorge,,1974-05-23,ES23209580590409199953,TRX_N-00425-28644218,2023-01-24T20:30:21,Galdakao,expenses,leisure,-79.57,-51036.91
buyer_4,Jorge,,1974-05-23,ES23209580590409199953,TRX_N-00426-21660376,2023-01-24T22:40:12,Pasaia,expenses,gifts,-162.02,-51198.93
buyer_4,Jorge,,1974-05-23,ES23209580590409199953,TRX_N-00427-92193519,2023-01-24T18:49:18,Galdakao,expenses,children,-1239.98,-52438.91
buyer_4,Jorge,,1974-05-23,ES23209580590409199953,TRX_N-00428-33981057,2023-01-27T11:11:27,Galdakao,expenses,food,-76.85,-52515.76
buyer_4,Jorge,,1974-05-23,ES23209580590409199953,TRX_N-00429-99279888,2023-01-27T08:19:09,Galdakao,expenses,leisure,-40.02,-52555.78
buyer_4,Jorge,,1974-05-23,ES23209580590409199953,TRX_N-00430-77193306,2023-01-27T18:37:29,Galdakao,expenses,cash,-100.0,-52655.78
buyer_4,Jorge,,1974-05-23,ES23209580590409199953,TRX_N-00431-29751883,2023-01-28T02:14:13,Galdakao,expenses,healthcare,-177.26,-52833.04
buyer_4,Jorge,,1974-05-23,ES23209580590409199953,TRX_N-00432-85855733,2023-01-28T12:14:08,Galdakao,expenses,repairs,-297.15,-53130.19
buyer_4,Jorge,,1974-05-23,ES23209580590409199953,TRX_N-00433-20277705,2023-01-30T14:45:03,Eibar,expenses,leisure,-23.53,-53153.72
buyer_4,Jorge,,1974-05-23,ES23209580590409199953,TRX_N-00434-30315510,2023-01-31T19:19:51,Galdakao,expenses,leisure,-67.9,-53221.62
buyer_4,Jorge,,1974-05-23,ES23209580590409199953,TRX_N-00435-34050694,2023-02-01T04:04:54,Galdakao,incomes,salary,1690.87,-51530.75
buyer_4,Jorge,,1974-05-23,ES23209580590409199953,TRX_N-00436-55811100,2023-02-01T19:06:02,Galdakao,expenses,transport,-78.97,-51609.72
buyer_4,Jorge,,1974-05-23,ES23209580590409199953,TRX_N-00437-99152120,2023-02-02T05:03:25,Galdakao,expenses,education,-62.68,-51672.4
buyer_4,Jorge,,1974-05-23,ES23209580590409199953,TRX_N-00438-52859092,2023-02-03T17:05:56,Galdakao,expenses,leisure,-62.1,-51734.5
buyer_4,Jorge,,1974-05-23,ES23209580590409199953,TRX_N-00439-06697087,2023-02-03T10:13:55,Galdakao,expenses,cash,-100.0,-51834.5
buyer_4,Jorge,,1974-05-23,ES23209580590409199953,TRX_N-00440-33469868,2023-02-03T18:21:04,Galdakao,expenses,repairs,-215.53,-52050.03
buyer_4,Jorge,,1974-05-23,ES23209580590409199953,TRX_N-00441-24575475,2023-02-04T11:46:08,Galdakao,expenses,mortgage,-1032.74,-53082.77
buyer_4,Jorge,,1974-05-23,ES23209580590409199953,TRX_N-00442-26909011,2023-02-04T17:59:48,Galdakao,expenses,cash,-100.0,-53182.77
buyer_4,Jorge,,1974-05-23,ES23209580590409199953,TRX_N-00443-02772460,2023-02-04T16:50:25,Galdakao,expenses,travel,-1120.19,-54302.96
buyer_4,Jorge,,1974-05-23,ES23209580590409199953,TRX_N-00444-62134771,2023-02-04T06:38:28,Galdakao,expenses,children,-1334.16,-55637.12
buyer_4,Jorge,,1974-05-23,ES23209580590409199953,TRX_N-00445-40138023,2023-02-06T13:42:50,Galdakao,expenses,gas,-90.75,-55727.87
buyer_4,Jorge,,1974-05-23,ES23209580590409199953,TRX_N-00446-49807407,2023-02-07T15:46:07,Galdakao,expenses,water,-38.31,-55766.18
buyer_4,Jorge,,1974-05-23,ES23209580590409199953,TRX_N-00447-25133201,2023-02-07T12:17:37,Vitoria-Gasteiz,expenses,education,-76.11,-55842.29
buyer_4,Jorge,,1974-05-23,ES23209580590409199953,TRX_N-00448-00604275,2023-02-08T12:40:57,Galdakao,expenses,electricity,-50.8,-55893.09
buyer_4,Jorge,,1974-05-23,ES23209580590409199953,TRX_N-00449-80869104,2023-02-08T19:26:49,Galdakao,expenses,internet,-42.0,-55935.09
buyer_4,Jorge,,1974-05-23,ES23209580590409199953,TRX_N-00450-36852207,2023-02-08T20:22:39,Galdakao,expenses,phone,-36.17,-55971.26
buyer_4,Jorge,,1974-05-23,ES23209580590409199953,TRX_N-00451-92835325,2023-02-10T16:14:51,Galdakao,expenses,transport,-65.73,-56036.99
buyer_4,Jorge,,1974-05-23,ES23209580590409199953,TRX_N-00452-66980313,2023-02-10T10:17:15,Galdakao,expenses,cash,-100.0,-56136.99
buyer_4,Jorge,,1974-05-23,ES23209580590409199953,TRX_N-00453-75223864,2023-02-11T17:58:56,Galdakao,expenses,leisure,-62.89,-56199.88
buyer_4,Jorge,,1974-05-23,ES23209580590409199953,TRX_N-00454-77954938,2023-02-12T16:22:07,Galdakao,expenses,food,-112.28,-56312.16
buyer_4,Jorge,,1974-05-23,ES23209580590409199953,TRX_N-00455-17103782,2023-02-12T17:19:37,Galdakao,expenses,leisure,-29.93,-56342.09
buyer_4,Jorge,,1974-05-23,ES23209580590409199953,TRX_N-00456-19290415,2023-02-15T09:14:23,Galdakao,expenses,repairs,-84.13,-56426.22
buyer_4,Jorge,,1974-05-23,ES23209580590409199953,TRX_N-00457-66064354,2023-02-16T01:10:28,Galdakao,expenses,cash,-100.0,-56526.22
buyer_4,Jorge,,1974-05-23,ES23209580590409199953,TRX_N-00458-56434536,2023-02-17T16:35:15,Salvatierra/Agurain,expenses,clothing,-50.58,-56576.8
buyer_4,Jorge,,1974-05-23,ES23209580590409199953,TRX_N-00459-67768935,2023-02-18T17:30:53,Galdakao,expenses,cash,-100.0,-56676.8
buyer_4,Jorge,,1974-05-23,ES23209580590409199953,TRX_N-00460-56346391,2023-02-20T18:16:43,Galdakao,expenses,leisure,-38.79,-56715.59
buyer_4,Jorge,,1974-05-23,ES23209580590409199953,TRX_N-00461-96486008,2023-02-21T02:21:54,Galdakao,expenses,transport,-65.78,-56781.37
buyer_4,Jorge,,1974-05-23,ES23209580590409199953,TRX_N-00462-70431300,2023-02-21T15:31:34,Galdakao,expenses,children,-369.55,-57150.92
buyer_4,Jorge,,1974-05-23,ES23209580590409199953,TRX_N-00463-10757520,2023-02-22T08:20:04,Galdakao,expenses,appliances,-409.37,-57560.29
buyer_4,Jorge,,1974-05-23,ES23209580590409199953,TRX_N-00464-61355491,2023-02-25T19:40:11,Galdakao,expenses,food,-63.22,-57623.51
buyer_4,Jorge,,1974-05-23,ES23209580590409199953,TRX_N-00465-86015421,2023-02-25T10:35:12,Galdakao,expenses,cash,-100.0,-57723.51
buyer_4,Jorge,,1974-05-23,ES23209580590409199953,TRX_N-00466-52708702,2023-02-27T14:20:32,Galdakao,expenses,healthcare,-56.67,-57780.18
buyer_4,Jorge,,1974-05-23,ES23209580590409199953,TRX_N-00467-56718320,2023-03-01T20:54:12,Galdakao,incomes,salary,1690.87,-56089.31
buyer_4,Jorge,,1974-05-23,ES23209580590409199953,TRX_N-00468-76866720,2023-03-04T11:24:32,Galdakao,expenses,mortgage,-1032.74,-57122.05
buyer_4,Jorge,,1974-05-23,ES23209580590409199953,TRX_N-00469-22114134,2023-03-04T16:15:56,Galdakao,expenses,transport,-68.47,-57190.52
buyer_4,Jorge,,1974-05-23,ES23209580590409199953,TRX_N-00470-05392703,2023-03-04T02:59:02,Galdakao,expenses,healthcare,-189.65,-57380.17
buyer_4,Jorge,,1974-05-23,ES23209580590409199953,TRX_N-00471-16246002,2023-03-05T11:09:45,Galdakao,expenses,water,-36.54,-57416.71
buyer_4,Jorge,,1974-05-23,ES23209580590409199953,TRX_N-00472-70052659,2023-03-05T20:24:05,Galdakao,expenses,food,-87.94,-57504.65
buyer_4,Jorge,,1974-05-23,ES23209580590409199953,TRX_N-00473-57793745,2023-03-07T21:39:33,Galdakao,expenses,internet,-42.0,-57546.65
buyer_4,Jorge,,1974-05-23,ES23209580590409199953,TRX_N-00474-37805308,2023-03-07T09:06:09,Galdakao,expenses,food,-92.56,-57639.21
buyer_4,Jorge,,1974-05-23,ES23209580590409199953,TRX_N-00475-53962178,2023-03-08T15:37:38,Galdakao,expenses,electricity,-28.34,-57667.55
buyer_4,Jorge,,1974-05-23,ES23209580590409199953,TRX_N-00476-09025821,2023-03-08T11:21:36,Galdakao,expenses,gas,-59.69,-57727.24
buyer_4,Jorge,,1974-05-23,ES23209580590409199953,TRX_N-00477-45884543,2023-03-08T10:05:15,Galdakao,expenses,phone,-32.2,-57759.44
buyer_4,Jorge,,1974-05-23,ES23209580590409199953,TRX_N-00478-49242278,2023-03-08T19:23:31,Galdakao,expenses,food,-109.31,-57868.75
buyer_4,Jorge,,1974-05-23,ES23209580590409199953,TRX_N-00479-95771360,2023-03-11T19:12:17,Galdakao,expenses,food,-87.0,-57955.75
buyer_4,Jorge,,1974-05-23,ES23209580590409199953,TRX_N-00480-75744243,2023-03-11T18:18:51,Galdakao,expenses,education,-49.23,-58004.98
buyer_4,Jorge,,1974-05-23,ES23209580590409199953,TRX_N-00481-70602086,2023-03-11T17:51:43,Galdakao,expenses,repairs,-249.56,-58254.54
buyer_4,Jorge,,1974-05-23,ES23209580590409199953,TRX_N-00482-31936190,2023-03-13T07:50:13,Sestao,expenses,clothing,-87.02,-58341.56
buyer_4,Jorge,,1974-05-23,ES23209580590409199953,TRX_N-00483-39108667,2023-03-13T20:34:45,Galdakao,expenses,cash,-100.0,-58441.56
buyer_4,Jorge,,1974-05-23,ES23209580590409199953,TRX_N-00484-27749212,2023-03-14T05:42:18,Irun,expenses,leisure,-52.97,-58494.53
buyer_4,Jorge,,1974-05-23,ES23209580590409199953,TRX_N-00485-52545012,2023-03-15T17:10:38,Hondarribia,expenses,healthcare,-141.84,-58636.37
buyer_4,Jorge,,1974-05-23,ES23209580590409199953,TRX_N-00486-88441620,2023-03-15T10:29:50,Durango,expenses,cash,-100.0,-58736.37
buyer_4,Jorge,,1974-05-23,ES23209580590409199953,TRX_N-00487-80033292,2023-03-16T10:04:01,Salvatierra/Agurain,expenses,food,-122.82,-58859.19
buyer_4,Jorge,,1974-05-23,ES23209580590409199953,TRX_N-00488-18454264,2023-03-16T12:44:34,Galdakao,expenses,children,-1016.3,-59875.49
buyer_4,Jorge,,1974-05-23,ES23209580590409199953,TRX_N-00489-33882250,2023-03-17T19:16:38,Galdakao,expenses,leisure,-38.19,-59913.68
buyer_4,Jorge,,1974-05-23,ES23209580590409199953,TRX_N-00490-89417471,2023-03-17T15:40:13,Galdakao,expenses,clothing,-82.19,-59995.87
buyer_4,Jorge,,1974-05-23,ES23209580590409199953,TRX_N-00491-45801231,2023-03-17T16:53:38,Galdakao,expenses,cash,-100.0,-60095.87
buyer_4,Jorge,,1974-05-23,ES23209580590409199953,TRX_N-00492-28680926,2023-03-18T20:31:50,Galdakao,expenses,food,-91.79,-60187.66
buyer_4,Jorge,,1974-05-23,ES23209580590409199953,TRX_N-00493-96716132,2023-03-18T20:43:17,Galdakao,expenses,cash,-100.0,-60287.66
buyer_4,Jorge,,1974-05-23,ES23209580590409199953,TRX_N-00494-82661852,2023-03-19T08:54:25,Galdakao,expenses,food,-81.69,-60369.35
buyer_4,Jorge,,1974-05-23,ES23209580590409199953,TRX_N-00495-63429746,2023-03-19T20:06:03,Galdakao,expenses,education,-68.9,-60438.25
buyer_4,Jorge,,1974-05-23,ES23209580590409199953,TRX_N-00496-21409221,2023-03-20T10:58:11,Galdakao,expenses,food,-123.32,-60561.57
buyer_4,Jorge,,1974-05-23,ES23209580590409199953,TRX_N-00497-54711284,2023-03-20T22:25:19,Galdakao,expenses,transport,-60.42,-60621.99
buyer_4,Jorge,,1974-05-23,ES23209580590409199953,TRX_N-00498-07957478,2023-03-20T16:27:16,Irun,expenses,cash,-100.0,-60721.99
buyer_4,Jorge,,1974-05-23,ES23209580590409199953,TRX_N-00499-75507824,2023-03-20T21:24:22,Galdakao,expenses,children,-1080.24,-61802.23
buyer_4,Jorge,,1974-05-23,ES23209580590409199953,TRX_N-00500-21873198,2023-03-21T17:32:36,Galdakao,expenses,children,-789.74,-62591.97
buyer_4,Jorge,,1974-05-23,ES23209580590409199953,TRX_N-00501-00122801,2023-03-22T10:16:34,Galdakao,expenses,transport,-70.36,-62662.33
buyer_4,Jorge,,1974-05-23,ES23209580590409199953,TRX_N-00502-78542349,2023-03-23T05:21:30,Galdakao,expenses,clothing,-129.42,-62791.75
buyer_4,Jorge,,1974-05-23,ES23209580590409199953,TRX_N-00503-55750961,2023-03-23T16:11:50,Galdakao,expenses,children,-705.17,-63496.92
buyer_4,Jorge,,1974-05-23,ES23209580590409199953,TRX_N-00504-95679836,2023-03-24T08:50:10,Galdakao,expenses,clothing,-64.38,-63561.3
buyer_4,Jorge,,1974-05-23,ES23209580590409199953,TRX_N-00505-02847068,2023-03-25T13:21:50,Galdakao,expenses,cash,-100.0,-63661.3
buyer_4,Jorge,,1974-05-23,ES23209580590409199953,TRX_N-00506-48037723,2023-03-26T20:44:37,Galdakao,expenses,repairs,-248.04,-63909.34
buyer_4,Jorge,,1974-05-23,ES23209580590409199953,TRX_N-00507-48551091,2023-03-28T19:43:39,Galdakao,expenses,healthcare,-118.42,-64027.76
buyer_4,Jorge,,1974-05-23,ES23209580590409199953,TRX_N-00508-62243732,2023-03-28T09:46:58,Lasarte-Oria,expenses,gifts,-174.64,-64202.4
buyer_4,Jorge,,1974-05-23,ES23209580590409199953,TRX_N-00509-09865532,2023-03-29T14:26:19,Hernani,expenses,clothing,-101.19,-64303.59
buyer_4,Jorge,,1974-05-23,ES23209580590409199953,TRX_N-00510-09244350,2023-03-30T12:39:38,Galdakao,expenses,food,-113.16,-64416.75
buyer_4,Jorge,,1974-05-23,ES23209580590409199953,TRX_N-00511-47949486,2023-03-30T11:40:52,Arrasate,expenses,leisure,-53.3,-64470.05
buyer_4,Jorge,,1974-05-23,ES23209580590409199953,TRX_N-00512-49352456,2023-04-01T16:22:52,Galdakao,incomes,salary,1690.87,-62779.18
buyer_4,Jorge,,1974-05-23,ES23209580590409199953,TRX_N-00513-56810631,2023-04-01T09:33:26,Galdakao,expenses,cash,-100.0,-62879.18
buyer_4,Jorge,,1974-05-23,ES23209580590409199953,TRX_N-00514-72342261,2023-04-02T11:10:02,Galdakao,expenses,food,-96.66,-62975.84
buyer_4,Jorge,,1974-05-23,ES23209580590409199953,TRX_N-00515-81280375,2023-04-02T09:00:55,Galdakao,expenses,transport,-74.71,-63050.55
buyer_4,Jorge,,1974-05-23,ES23209580590409199953,TRX_N-00516-43462244,2023-04-04T12:01:39,Galdakao,expenses,mortgage,-1032.74,-64083.29
buyer_4,Jorge,,1974-05-23,ES23209580590409199953,TRX_N-00517-10804170,2023-04-04T08:54:23,Galdakao,expenses,cash,-100.0,-64183.29
buyer_4,Jorge,,1974-05-23,ES23209580590409199953,TRX_N-00518-01634275,2023-04-06T11:26:46,Galdakao,expenses,transport,-82.99,-64266.28
buyer_4,Jorge,,1974-05-23,ES23209580590409199953,TRX_N-00519-67241322,2023-04-06T13:46:29,Galdakao,expenses,gifts,-99.96,-64366.24
buyer_4,Jorge,,1974-05-23,ES23209580590409199953,TRX_N-00520-74177131,2023-04-07T15:23:02,Galdakao,expenses,water,-37.17,-64403.41
buyer_4,Jorge,,1974-05-23,ES23209580590409199953,TRX_N-00521-63602529,2023-04-07T11:21:29,Galdakao,expenses,electricity,-86.88,-64490.29
buyer_4,Jorge,,1974-05-23,ES23209580590409199953,TRX_N-00522-18448348,2023-04-07T00:44:34,Galdakao,expenses,gifts,-387.05,-64877.34
buyer_4,Jorge,,1974-05-23,ES23209580590409199953,TRX_N-00523-51273007,2023-04-08T11:00:11,Galdakao,expenses,gas,-72.01,-64949.35
buyer_4,Jorge,,1974-05-23,ES23209580590409199953,TRX_N-00524-10010318,2023-04-08T12:35:12,Galdakao,expenses,internet,-42.0,-64991.35
buyer_4,Jorge,,1974-05-23,ES23209580590409199953,TRX_N-00525-78439760,2023-04-08T22:14:22,Galdakao,expenses,phone,-42.55,-65033.9
buyer_4,Jorge,,1974-05-23,ES23209580590409199953,TRX_N-00526-98616542,2023-04-08T21:36:17,Galdakao,expenses,cash,-100.0,-65133.9
buyer_4,Jorge,,1974-05-23,ES23209580590409199953,TRX_N-00527-71763596,2023-04-08T20:02:40,Galdakao,expenses,children,-1069.2,-66203.1
buyer_4,Jorge,,1974-05-23,ES23209580590409199953,TRX_N-00528-34322824,2023-04-09T11:06:38,Pasaia,expenses,food,-95.27,-66298.37
buyer_4,Jorge,,1974-05-23,ES23209580590409199953,TRX_N-00529-99431681,2023-04-12T11:39:13,Galdakao,expenses,leisure,-46.98,-66345.35
buyer_4,Jorge,,1974-05-23,ES23209580590409199953,TRX_N-00530-08325924,2023-04-13T13:57:45,Galdakao,expenses,food,-122.62,-66467.97
buyer_4,Jorge,,1974-05-23,ES23209580590409199953,TRX_N-00531-14214965,2023-04-13T13:57:06,Galdakao,expenses,leisure,-33.44,-66501.41
buyer_4,Jorge,,1974-05-23,ES23209580590409199953,TRX_N-00532-60277608,2023-04-14T09:16:21,Galdakao,expenses,leisure,-38.46,-66539.87
buyer_4,Jorge,,1974-05-23,ES23209580590409199953,TRX_N-00533-07934973,2023-04-14T08:37:56,Galdakao,expenses,cash,-100.0,-66639.87
buyer_4,Jorge,,1974-05-23,ES23209580590409199953,TRX_N-00534-68103935,2023-04-14T20:22:42,Galdakao,expenses,appliances,-319.35,-66959.22
buyer_4,Jorge,,1974-05-23,ES23209580590409199953,TRX_N-00535-72025429,2023-04-15T16:54:53,Galdakao,expenses,children,-338.59,-67297.81
buyer_4,Jorge,,1974-05-23,ES23209580590409199953,TRX_N-00536-17957222,2023-04-18T09:04:08,Galdakao,expenses,repairs,-225.46,-67523.27
buyer_4,Jorge,,1974-05-23,ES23209580590409199953,TRX_N-00537-31308062,2023-04-20T11:40:08,Arrasate,expenses,leisure,-53.73,-67577.0
buyer_4,Jorge,,1974-05-23,ES23209580590409199953,TRX_N-00538-38228703,2023-04-20T16:50:21,Galdakao,expenses,cash,-100.0,-67677.0
buyer_4,Jorge,,1974-05-23,ES23209580590409199953,TRX_N-00539-67863202,2023-04-21T08:01:49,Galdakao,expenses,food,-77.22,-67754.22
buyer_4,Jorge,,1974-05-23,ES23209580590409199953,TRX_N-00540-73514670,2023-04-21T15:29:13,Galdakao,expenses,cash,-100.0,-67854.22
buyer_4,Jorge,,1974-05-23,ES23209580590409199953,TRX_N-00541-41904712,2023-04-22T20:56:56,Galdakao,expenses,transport,-89.03,-67943.25
buyer_4,Jorge,,1974-05-23,ES23209580590409199953,TRX_N-00542-55087435,2023-04-22T20:05:58,Galdakao,expenses,cash,-100.0,-68043.25
buyer_4,Jorge,,1974-05-23,ES23209580590409199953,TRX_N-00543-99972104,2023-04-24T13:13:41,Galdakao,expenses,leisure,-46.22,-68089.47
buyer_4,Jorge,,1974-05-23,ES23209580590409199953,TRX_N-00544-17405807,2023-04-26T18:18:15,Getxo,expenses,transport,-52.15,-68141.62
buyer_4,Jorge,,1974-05-23,ES23209580590409199953,TRX_N-00545-67410206,2023-04-27T19:37:35,Galdakao,expenses,children,-1175.66,-69317.28
buyer_4,Jorge,,1974-05-23,ES23209580590409199953,TRX_N-00546-02957941,2023-04-28T18:22:29,Berango,expenses,food,-121.37,-69438.65
buyer_4,Jorge,,1974-05-23,ES23209580590409199953,TRX_N-00547-09028086,2023-04-28T15:58:37,Galdakao,expenses,clothing,-79.99,-69518.64
buyer_4,Jorge,,1974-05-23,ES23209580590409199953,TRX_N-00548-81346443,2023-04-28T13:57:39,Galdakao,expenses,appliances,-292.17,-69810.81
buyer_4,Jorge,,1974-05-23,ES23209580590409199953,TRX_N-00549-68077027,2023-04-28T07:50:36,Galdakao,expenses,children,-284.4,-70095.21
buyer_4,Jorge,,1974-05-23,ES23209580590409199953,TRX_N-00550-81574835,2023-04-30T08:00:00,Galdakao,expenses,education,-61.5,-70156.71
buyer_4,Jorge,,1974-05-23,ES23209580590409199953,TRX_N-00551-35815540,2023-05-01T20:11:17,Galdakao,incomes,salary,1690.87,-68465.84
buyer_4,Jorge,,1974-05-23,ES23209580590409199953,TRX_N-00552-00199074,2023-05-01T20:11:17,Galdakao,incomes,extra_income,296.42,-68169.42
buyer_4,Jorge,,1974-05-23,ES23209580590409199953,TRX_N-00553-61978809,2023-05-01T23:58:37,Galdakao,expenses,clothing,-90.11,-68259.53
buyer_4,Jorge,,1974-05-23,ES23209580590409199953,TRX_N-00554-63585450,2023-05-01T15:59:47,Galdakao,expenses,cash,-100.0,-68359.53
buyer_4,Jorge,,1974-05-23,ES23209580590409199953,TRX_N-00555-45560033,2023-05-04T17:33:28,Galdakao,expenses,mortgage,-1032.74,-69392.27
buyer_4,Jorge,,1974-05-23,ES23209580590409199953,TRX_N-00556-61570037,2023-05-04T19:46:16,Galdakao,expenses,leisure,-57.62,-69449.89
buyer_4,Jorge,,1974-05-23,ES23209580590409199953,TRX_N-00557-86198805,2023-05-04T10:01:09,Galdakao,expenses,cash,-100.0,-69549.89
buyer_4,Jorge,,1974-05-23,ES23209580590409199953,TRX_N-00558-44385347,2023-05-05T11:47:48,Galdakao,expenses,food,-80.48,-69630.37
buyer_4,Jorge,,1974-05-23,ES23209580590409199953,TRX_N-00559-28140412,2023-05-05T17:54:35,Galdakao,expenses,cash,-100.0,-69730.37
buyer_4,Jorge,,1974-05-23,ES23209580590409199953,TRX_N-00560-34753880,2023-05-06T15:23:23,Galdakao,expenses,electricity,-71.03,-69801.4
buyer_4,Jorge,,1974-05-23,ES23209580590409199953,TRX_N-00561-06197322,2023-05-06T09:03:11,Sestao,expenses,transport,-52.71,-69854.11
buyer_4,Jorge,,1974-05-23,ES23209580590409199953,TRX_N-00562-75802919,2023-05-07T14:46:30,Galdakao,expenses,gas,-51.67,-69905.78
buyer_4,Jorge,,1974-05-23,ES23209580590409199953,TRX_N-00563-49946628,2023-05-07T12:11:56,Zuia,expenses,clothing,-90.24,-69996.02
buyer_4,Jorge,,1974-05-23,ES23209580590409199953,TRX_N-00564-85558569,2023-05-08T09:20:22,Galdakao,expenses,water,-30.94,-70026.96
buyer_4,Jorge,,1974-05-23,ES23209580590409199953,TRX_N-00565-48095188,2023-05-08T07:43:38,Galdakao,expenses,internet,-42.0,-70068.96
buyer_4,Jorge,,1974-05-23,ES23209580590409199953,TRX_N-00566-32189979,2023-05-08T08:46:35,Galdakao,expenses,phone,-35.06,-70104.02
buyer_4,Jorge,,1974-05-23,ES23209580590409199953,TRX_N-00567-29381912,2023-05-09T16:10:58,Galdakao,expenses,cash,-100.0,-70204.02
buyer_4,Jorge,,1974-05-23,ES23209580590409199953,TRX_N-00568-61089846,2023-05-11T13:18:40,Galdakao,expenses,food,-65.01,-70269.03
buyer_4,Jorge,,1974-05-23,ES23209580590409199953,TRX_N-00569-00520890,2023-05-11T16:13:38,Galdakao,expenses,transport,-88.9,-70357.93
buyer_4,Jorge,,1974-05-23,ES23209580590409199953,TRX_N-00570-87500688,2023-05-11T14:18:38,Galdakao,expenses,travel,-1703.16,-72061.09
buyer_4,Jorge,,1974-05-23,ES23209580590409199953,TRX_N-00571-89843729,2023-05-12T19:21:45,Galdakao,expenses,gifts,-733.41,-72794.5
buyer_4,Jorge,,1974-05-23,ES23209580590409199953,TRX_N-00572-55905758,2023-05-14T23:04:37,Galdakao,expenses,food,-96.41,-72890.91
buyer_4,Jorge,,1974-05-23,ES23209580590409199953,TRX_N-00573-73861515,2023-05-15T15:05:22,Galdakao,expenses,appliances,-103.12,-72994.03
buyer_4,Jorge,,1974-05-23,ES23209580590409199953,TRX_N-00574-54048286,2023-05-19T17:22:31,Basauri,expenses,food,-67.59,-73061.62
buyer_4,Jorge,,1974-05-23,ES23209580590409199953,TRX_N-00575-60039109,2023-05-19T16:29:41,Sopela,expenses,transport,-87.54,-73149.16
buyer_4,Jorge,,1974-05-23,ES23209580590409199953,TRX_N-00576-61089626,2023-05-20T08:51:13,Galdakao,expenses,cash,-100.0,-73249.16
buyer_4,Jorge,,1974-05-23,ES23209580590409199953,TRX_N-00577-82245268,2023-05-21T10:21:57,Galdakao,expenses,cash,-100.0,-73349.16
buyer_4,Jorge,,1974-05-23,ES23209580590409199953,TRX_N-00578-48835033,2023-05-22T17:16:31,Galdakao,expenses,leisure,-54.11,-73403.27
buyer_4,Jorge,,1974-05-23,ES23209580590409199953,TRX_N-00579-85065774,2023-05-23T10:58:43,Galdakao,expenses,food,-92.38,-73495.65
buyer_4,Jorge,,1974-05-23,ES23209580590409199953,TRX_N-00580-51292062,2023-05-28T08:59:20,Galdakao,expenses,leisure,-45.01,-73540.66
buyer_4,Jorge,,1974-05-23,ES23209580590409199953,TRX_N-00581-85037930,2023-05-28T20:05:11,Galdakao,expenses,appliances,-327.25,-73867.91
buyer_4,Jorge,,1974-05-23,ES23209580590409199953,TRX_N-00582-03998865,2023-05-28T13:24:48,Galdakao,expenses,gifts,-151.38,-74019.29
buyer_4,Jorge,,1974-05-23,ES23209580590409199953,TRX_N-00583-14515457,2023-05-29T01:06:00,Galdakao,expenses,transport,-51.47,-74070.76
buyer_4,Jorge,,1974-05-23,ES23209580590409199953,TRX_N-00584-80361362,2023-05-30T21:46:12,Galdakao,expenses,clothing,-97.29,-74168.05
buyer_4,Jorge,,1974-05-23,ES23209580590409199953,TRX_N-00585-39754921,2023-05-30T18:07:02,Galdakao,expenses,education,-78.69,-74246.74
buyer_4,Jorge,,1974-05-23,ES23209580590409199953,TRX_N-00586-30217056,2023-05-31T22:51:23,Galdakao,expenses,leisure,-66.62,-74313.36
buyer_4,Jorge,,1974-05-23,ES23209580590409199953,TRX_N-00587-73368905,2023-06-01T15:43:48,Galdakao,incomes,salary,1690.87,-72622.49
buyer_4,Jorge,,1974-05-23,ES23209580590409199953,TRX_N-00588-43624847,2023-06-01T15:43:48,Galdakao,incomes,salary_bonus,1259.55,-71362.94
buyer_4,Jorge,,1974-05-23,ES23209580590409199953,TRX_N-00589-31375227,2023-06-01T13:04:00,Galdakao,expenses,education,-43.06,-71406.0
buyer_4,Jorge,,1974-05-23,ES23209580590409199953,TRX_N-00590-03796008,2023-06-02T17:03:16,Galdakao,expenses,transport,-48.51,-71454.51
buyer_4,Jorge,,1974-05-23,ES23209580590409199953,TRX_N-00591-55780768,2023-06-02T16:20:04,Mungia,expenses,education,-76.33,-71530.84
buyer_4,Jorge,,1974-05-23,ES23209580590409199953,TRX_N-00592-61510733,2023-06-02T08:56:46,Bermeo,expenses,gifts,-245.8,-71776.64
buyer_4,Jorge,,1974-05-23,ES23209580590409199953,TRX_N-00593-22982729,2023-06-03T13:05:16,Galdakao,expenses,cash,-100.0,-71876.64
buyer_4,Jorge,,1974-05-23,ES23209580590409199953,TRX_N-00594-76951326,2023-06-04T12:14:38,Galdakao,expenses,mortgage,-1032.74,-72909.38
buyer_4,Jorge,,1974-05-23,ES23209580590409199953,TRX_N-00595-40508655,2023-06-04T20:10:04,Galdakao,expenses,cash,-100.0,-73009.38
buyer_4,Jorge,,1974-05-23,ES23209580590409199953,TRX_N-00596-25860143,2023-06-04T12:39:44,Donostia,expenses,travel,-1155.41,-74164.79
buyer_4,Jorge,,1974-05-23,ES23209580590409199953,TRX_N-00597-35155050,2023-06-05T14:06:44,Galdakao,expenses,gas,-36.17,-74200.96
buyer_4,Jorge,,1974-05-23,ES23209580590409199953,TRX_N-00598-51230368,2023-06-06T10:43:45,Galdakao,expenses,clothing,-88.39,-74289.35
buyer_4,Jorge,,1974-05-23,ES23209580590409199953,TRX_N-00599-15362776,2023-06-06T10:35:31,Galdakao,expenses,cash,-100.0,-74389.35
buyer_4,Jorge,,1974-05-23,ES23209580590409199953,TRX_N-00600-85690806,2023-06-08T18:21:38,Galdakao,expenses,water,-27.12,-74416.47
buyer_4,Jorge,,1974-05-23,ES23209580590409199953,TRX_N-00601-37486030,2023-06-08T19:34:40,Galdakao,expenses,electricity,-85.59,-74502.06
buyer_4,Jorge,,1974-05-23,ES23209580590409199953,TRX_N-00602-39861684,2023-06-08T20:35:22,Galdakao,expenses,internet,-42.0,-74544.06
buyer_4,Jorge,,1974-05-23,ES23209580590409199953,TRX_N-00603-75232710,2023-06-08T21:29:42,Galdakao,expenses,phone,-41.27,-74585.33
buyer_4,Jorge,,1974-05-23,ES23209580590409199953,TRX_N-00604-19971618,2023-06-08T09:31:20,Galdakao,expenses,food,-124.99,-74710.32
buyer_4,Jorge,,1974-05-23,ES23209580590409199953,TRX_N-00605-93423713,2023-06-10T20:50:13,Galdakao,expenses,leisure,-70.49,-74780.81
buyer_4,Jorge,,1974-05-23,ES23209580590409199953,TRX_N-00606-38175319,2023-06-10T19:09:19,Alegr√≠a-Dulantzi,expenses,clothing,-64.38,-74845.19
buyer_4,Jorge,,1974-05-23,ES23209580590409199953,TRX_N-00607-50184514,2023-06-11T03:33:53,Galdakao,expenses,car,-161.59,-75006.78
buyer_4,Jorge,,1974-05-23,ES23209580590409199953,TRX_N-00608-03572362,2023-06-12T21:38:57,Galdakao,expenses,appliances,-373.7,-75380.48
buyer_4,Jorge,,1974-05-23,ES23209580590409199953,TRX_N-00609-97897348,2023-06-13T08:47:27,Galdakao,expenses,transport,-50.6,-75431.08
buyer_4,Jorge,,1974-05-23,ES23209580590409199953,TRX_N-00610-92434016,2023-06-15T08:36:46,Galdakao,expenses,cash,-100.0,-75531.08
buyer_4,Jorge,,1974-05-23,ES23209580590409199953,TRX_N-00611-30252387,2023-06-16T20:16:03,Galdakao,expenses,cash,-100.0,-75631.08
buyer_4,Jorge,,1974-05-23,ES23209580590409199953,TRX_N-00612-63033991,2023-06-17T14:49:10,Galdakao,expenses,leisure,-33.12,-75664.2
buyer_4,Jorge,,1974-05-23,ES23209580590409199953,TRX_N-00613-65193040,2023-06-20T16:04:43,Galdakao,expenses,cash,-100.0,-75764.2
buyer_4,Jorge,,1974-05-23,ES23209580590409199953,TRX_N-00614-13929273,2023-06-21T11:07:44,Galdakao,expenses,food,-75.63,-75839.83
buyer_4,Jorge,,1974-05-23,ES23209580590409199953,TRX_N-00615-62895724,2023-06-27T16:28:35,Galdakao,expenses,food,-65.68,-75905.51
buyer_4,Jorge,,1974-05-23,ES23209580590409199953,TRX_N-00616-40045143,2023-06-27T19:20:22,Arrasate,expenses,transport,-69.04,-75974.55
buyer_4,Jorge,,1974-05-23,ES23209580590409199953,TRX_N-00617-63685496,2023-06-28T09:44:08,Zuia,expenses,food,-98.84,-76073.39
buyer_4,Jorge,,1974-05-23,ES23209580590409199953,TRX_N-00618-13917130,2023-06-28T10:01:12,Galdakao,expenses,clothing,-53.99,-76127.38
buyer_4,Jorge,,1974-05-23,ES23209580590409199953,TRX_N-00619-47853212,2023-06-29T23:02:10,Galdakao,expenses,leisure,-81.52,-76208.9
buyer_4,Jorge,,1974-05-23,ES23209580590409199953,TRX_N-00620-49663410,2023-06-30T21:21:56,Galdakao,expenses,education,-75.29,-76284.19
buyer_4,Jorge,,1974-05-23,ES23209580590409199953,TRX_N-00621-91175987,2023-06-30T15:02:10,Galdakao,expenses,children,-1164.96,-77449.15
buyer_4,Jorge,,1974-05-23,ES23209580590409199953,TRX_N-00622-12311836,2023-07-01T10:06:51,Galdakao,incomes,salary,1690.87,-75758.28
buyer_4,Jorge,,1974-05-23,ES23209580590409199953,TRX_N-00623-28984259,2023-07-03T18:44:35,Galdakao,expenses,food,-60.27,-75818.55
buyer_4,Jorge,,1974-05-23,ES23209580590409199953,TRX_N-00624-39788882,2023-07-04T12:16:34,Galdakao,expenses,mortgage,-1032.74,-76851.29
buyer_4,Jorge,,1974-05-23,ES23209580590409199953,TRX_N-00625-93887147,2023-07-05T11:17:50,Iru√±a de Oca,expenses,appliances,-245.44,-77096.73
buyer_4,Jorge,,1974-05-23,ES23209580590409199953,TRX_N-00626-04306311,2023-07-06T11:26:12,Galdakao,expenses,electricity,-28.57,-77125.3
buyer_4,Jorge,,1974-05-23,ES23209580590409199953,TRX_N-00627-70676212,2023-07-06T10:14:53,Galdakao,expenses,transport,-62.72,-77188.02
buyer_4,Jorge,,1974-05-23,ES23209580590409199953,TRX_N-00628-62765667,2023-07-06T15:49:59,Arrasate,expenses,leisure,-29.84,-77217.86
buyer_4,Jorge,,1974-05-23,ES23209580590409199953,TRX_N-00629-77818606,2023-07-06T21:43:35,Galdakao,expenses,education,-65.52,-77283.38
buyer_4,Jorge,,1974-05-23,ES23209580590409199953,TRX_N-00630-80694265,2023-07-07T16:38:51,Galdakao,expenses,gas,-105.8,-77389.18
buyer_4,Jorge,,1974-05-23,ES23209580590409199953,TRX_N-00631-23606686,2023-07-08T15:51:56,Galdakao,expenses,internet,-42.0,-77431.18
buyer_4,Jorge,,1974-05-23,ES23209580590409199953,TRX_N-00632-17783082,2023-07-08T17:36:15,Galdakao,expenses,water,-28.79,-77459.97
buyer_4,Jorge,,1974-05-23,ES23209580590409199953,TRX_N-00633-88934262,2023-07-08T11:11:48,Galdakao,expenses,phone,-34.14,-77494.11
buyer_4,Jorge,,1974-05-23,ES23209580590409199953,TRX_N-00634-54280665,2023-07-08T13:25:39,Galdakao,expenses,food,-112.88,-77606.99
buyer_4,Jorge,,1974-05-23,ES23209580590409199953,TRX_N-00635-46051272,2023-07-10T15:00:41,Galdakao,expenses,food,-83.75,-77690.74
buyer_4,Jorge,,1974-05-23,ES23209580590409199953,TRX_N-00636-87023674,2023-07-10T13:13:05,Galdakao,expenses,education,-45.69,-77736.43
buyer_4,Jorge,,1974-05-23,ES23209580590409199953,TRX_N-00637-85253023,2023-07-10T19:09:26,Galdakao,expenses,cash,-100.0,-77836.43
buyer_4,Jorge,,1974-05-23,ES23209580590409199953,TRX_N-00638-92172311,2023-07-11T12:41:33,Galdakao,expenses,food,-90.59,-77927.02
buyer_4,Jorge,,1974-05-23,ES23209580590409199953,TRX_N-00639-80624125,2023-07-13T09:20:01,Galdakao,expenses,leisure,-30.64,-77957.66
buyer_4,Jorge,,1974-05-23,ES23209580590409199953,TRX_N-00640-69732168,2023-07-13T18:59:24,Santurtzi,expenses,repairs,-288.86,-78246.52
buyer_4,Jorge,,1974-05-23,ES23209580590409199953,TRX_N-00641-06917165,2023-07-14T16:47:59,Galdakao,expenses,repairs,-97.5,-78344.02
buyer_4,Jorge,,1974-05-23,ES23209580590409199953,TRX_N-00642-89534677,2023-07-16T15:20:12,Galdakao,expenses,healthcare,-115.3,-78459.32
buyer_4,Jorge,,1974-05-23,ES23209580590409199953,TRX_N-00643-60085259,2023-07-16T20:10:51,Galdakao,expenses,children,-679.82,-79139.14
buyer_4,Jorge,,1974-05-23,ES23209580590409199953,TRX_N-00644-04590414,2023-07-17T21:38:19,Galdakao,expenses,food,-68.35,-79207.49
buyer_4,Jorge,,1974-05-23,ES23209580590409199953,TRX_N-00645-01911309,2023-07-18T19:28:09,Galdakao,expenses,gifts,-253.47,-79460.96
buyer_4,Jorge,,1974-05-23,ES23209580590409199953,TRX_N-00646-37955662,2023-07-22T16:58:19,Galdakao,expenses,food,-100.93,-79561.89
buyer_4,Jorge,,1974-05-23,ES23209580590409199953,TRX_N-00647-20709673,2023-07-22T17:59:59,Galdakao,expenses,cash,-100.0,-79661.89
buyer_4,Jorge,,1974-05-23,ES23209580590409199953,TRX_N-00648-13467052,2023-07-24T17:07:59,Galdakao,expenses,leisure,-54.9,-79716.79
buyer_4,Jorge,,1974-05-23,ES23209580590409199953,TRX_N-00649-41824031,2023-07-24T17:05:37,Galdakao,expenses,children,-885.98,-80602.77
buyer_4,Jorge,,1974-05-23,ES23209580590409199953,TRX_N-00650-62355412,2023-07-25T13:07:05,Galdakao,expenses,leisure,-79.2,-80681.97
buyer_4,Jorge,,1974-05-23,ES23209580590409199953,TRX_N-00651-07723848,2023-07-26T14:21:56,Donostia,expenses,transport,-85.19,-80767.16
buyer_4,Jorge,,1974-05-23,ES23209580590409199953,TRX_N-00652-23374530,2023-07-28T15:22:55,Galdakao,expenses,leisure,-63.82,-80830.98
buyer_4,Jorge,,1974-05-23,ES23209580590409199953,TRX_N-00653-77153681,2023-07-29T16:52:04,Galdakao,expenses,food,-88.4,-80919.38
buyer_4,Jorge,,1974-05-23,ES23209580590409199953,TRX_N-00654-25020119,2023-07-29T19:50:29,Galdakao,expenses,cash,-100.0,-81019.38
buyer_4,Jorge,,1974-05-23,ES23209580590409199953,TRX_N-00655-25709815,2023-07-29T21:49:07,Galdakao,expenses,repairs,-45.2,-81064.58
buyer_4,Jorge,,1974-05-23,ES23209580590409199953,TRX_N-00656-32441968,2023-07-31T12:37:30,Galdakao,expenses,cash,-100.0,-81164.58
buyer_4,Jorge,,1974-05-23,ES23209580590409199953,TRX_N-00657-88829448,2023-08-01T04:08:56,Galdakao,incomes,salary,1690.87,-79473.71
buyer_4,Jorge,,1974-05-23,ES23209580590409199953,TRX_N-00658-35678165,2023-08-01T20:51:14,Galdakao,expenses,food,-94.38,-79568.09
buyer_4,Jorge,,1974-05-23,ES23209580590409199953,TRX_N-00659-93022935,2023-08-01T01:49:02,Basauri,expenses,cash,-100.0,-79668.09
buyer_4,Jorge,,1974-05-23,ES23209580590409199953,TRX_N-00660-79372994,2023-08-02T12:19:21,Galdakao,expenses,cash,-100.0,-79768.09
buyer_4,Jorge,,1974-05-23,ES23209580590409199953,TRX_N-00661-19058283,2023-08-04T19:05:21,Galdakao,expenses,mortgage,-1032.74,-80800.83
buyer_4,Jorge,,1974-05-23,ES23209580590409199953,TRX_N-00662-51667607,2023-08-05T11:36:42,Galdakao,expenses,electricity,-56.45,-80857.28
buyer_4,Jorge,,1974-05-23,ES23209580590409199953,TRX_N-00663-93000301,2023-08-05T22:36:57,Galdakao,expenses,phone,-41.64,-80898.92
buyer_4,Jorge,,1974-05-23,ES23209580590409199953,TRX_N-00664-94436885,2023-08-05T15:53:51,Galdakao,expenses,transport,-72.35,-80971.27
buyer_4,Jorge,,1974-05-23,ES23209580590409199953,TRX_N-00665-87635313,2023-08-05T19:46:44,Mungia,expenses,cash,-100.0,-81071.27
buyer_4,Jorge,,1974-05-23,ES23209580590409199953,TRX_N-00666-22308477,2023-08-05T15:42:38,Galdakao,expenses,children,-664.27,-81735.54
buyer_4,Jorge,,1974-05-23,ES23209580590409199953,TRX_N-00667-95497405,2023-08-08T12:59:03,Galdakao,expenses,internet,-42.0,-81777.54
buyer_4,Jorge,,1974-05-23,ES23209580590409199953,TRX_N-00668-42683894,2023-08-08T12:17:00,Galdakao,expenses,water,-25.47,-81803.01
buyer_4,Jorge,,1974-05-23,ES23209580590409199953,TRX_N-00669-23933053,2023-08-08T17:07:06,Galdakao,expenses,gas,-79.25,-81882.26
buyer_4,Jorge,,1974-05-23,ES23209580590409199953,TRX_N-00670-20981815,2023-08-10T13:27:25,Galdakao,expenses,food,-111.15,-81993.41
buyer_4,Jorge,,1974-05-23,ES23209580590409199953,TRX_N-00671-56190083,2023-08-10T08:21:10,Durango,expenses,cash,-100.0,-82093.41
buyer_4,Jorge,,1974-05-23,ES23209580590409199953,TRX_N-00672-34931898,2023-08-11T14:43:43,Hondarribia,expenses,leisure,-82.27,-82175.68
buyer_4,Jorge,,1974-05-23,ES23209580590409199953,TRX_N-00673-82909335,2023-08-11T13:27:37,Galdakao,expenses,cash,-100.0,-82275.68
buyer_4,Jorge,,1974-05-23,ES23209580590409199953,TRX_N-00674-03562460,2023-08-11T16:13:11,Galdakao,expenses,repairs,-120.41,-82396.09
buyer_4,Jorge,,1974-05-23,ES23209580590409199953,TRX_N-00675-40608541,2023-08-12T12:55:44,Galdakao,expenses,appliances,-88.91,-82485.0
buyer_4,Jorge,,1974-05-23,ES23209580590409199953,TRX_N-00676-29619535,2023-08-13T19:50:42,Galdakao,expenses,transport,-40.03,-82525.03
buyer_4,Jorge,,1974-05-23,ES23209580590409199953,TRX_N-00677-50740724,2023-08-14T12:20:45,Galdakao,expenses,cash,-100.0,-82625.03
buyer_4,Jorge,,1974-05-23,ES23209580590409199953,TRX_N-00678-18985617,2023-08-14T16:43:53,Galdakao,expenses,repairs,-176.91,-82801.94
buyer_4,Jorge,,1974-05-23,ES23209580590409199953,TRX_N-00679-77165080,2023-08-15T11:40:10,Galdakao,expenses,repairs,-122.51,-82924.45
buyer_4,Jorge,,1974-05-23,ES23209580590409199953,TRX_N-00680-42243542,2023-08-16T09:15:31,Galdakao,expenses,transport,-46.03,-82970.48
buyer_4,Jorge,,1974-05-23,ES23209580590409199953,TRX_N-00681-26631063,2023-08-16T10:38:25,Galdakao,expenses,gifts,-634.86,-83605.34
buyer_4,Jorge,,1974-05-23,ES23209580590409199953,TRX_N-00682-52539315,2023-08-17T19:48:41,Iru√±a de Oca,expenses,gifts,-284.45,-83889.79
buyer_4,Jorge,,1974-05-23,ES23209580590409199953,TRX_N-00683-15325353,2023-08-20T23:34:14,Galdakao,expenses,leisure,-51.78,-83941.57
buyer_4,Jorge,,1974-05-23,ES23209580590409199953,TRX_N-00684-04190733,2023-08-20T21:57:51,Galdakao,expenses,cash,-100.0,-84041.57
buyer_4,Jorge,,1974-05-23,ES23209580590409199953,TRX_N-00685-40390795,2023-08-21T20:45:36,Galdakao,expenses,food,-113.06,-84154.63
buyer_4,Jorge,,1974-05-23,ES23209580590409199953,TRX_N-00686-38364714,2023-08-22T18:17:19,Andoain,expenses,leisure,-56.35,-84210.98
buyer_4,Jorge,,1974-05-23,ES23209580590409199953,TRX_N-00687-24264196,2023-08-25T11:44:51,Galdakao,expenses,cash,-100.0,-84310.98
buyer_4,Jorge,,1974-05-23,ES23209580590409199953,TRX_N-00688-57625467,2023-08-26T13:13:05,Zarautz,expenses,transport,-59.03,-84370.01
buyer_4,Jorge,,1974-05-23,ES23209580590409199953,TRX_N-00689-00078858,2023-08-26T06:46:05,Galdakao,expenses,cash,-100.0,-84470.01
buyer_4,Jorge,,1974-05-23,ES23209580590409199953,TRX_N-00690-09292136,2023-08-28T09:55:34,Galdakao,expenses,healthcare,-76.18,-84546.19
buyer_4,Jorge,,1974-05-23,ES23209580590409199953,TRX_N-00691-09621789,2023-08-28T12:26:10,Zuia,expenses,cash,-100.0,-84646.19
buyer_4,Jorge,,1974-05-23,ES23209580590409199953,TRX_N-00692-54248230,2023-08-29T23:47:19,Getxo,expenses,food,-113.94,-84760.13
buyer_4,Jorge,,1974-05-23,ES23209580590409199953,TRX_N-00693-92464064,2023-08-29T14:58:26,Galdakao,expenses,clothing,-75.87,-84836.0
buyer_4,Jorge,,1974-05-23,ES23209580590409199953,TRX_N-00694-22967049,2023-08-29T15:55:33,Zarautz,expenses,gifts,-485.6,-85321.6
buyer_4,Jorge,,1974-05-23,ES23209580590409199953,TRX_N-00695-75339605,2023-08-29T20:14:02,Galdakao,expenses,children,-904.46,-86226.06
buyer_4,Jorge,,1974-05-23,ES23209580590409199953,TRX_N-00696-21323489,2023-08-30T13:31:44,Galdakao,expenses,transport,-69.82,-86295.88
buyer_4,Jorge,,1974-05-23,ES23209580590409199953,TRX_N-00697-24702818,2023-08-30T15:19:45,Galdakao,expenses,education,-63.7,-86359.58
buyer_4,Jorge,,1974-05-23,ES23209580590409199953,TRX_N-00698-15674199,2023-08-30T19:13:03,Galdakao,expenses,repairs,-273.46,-86633.04
buyer_4,Jorge,,1974-05-23,ES23209580590409199953,TRX_N-00699-33688853,2023-08-31T17:47:21,Iru√±a de Oca,expenses,leisure,-37.22,-86670.26
buyer_4,Jorge,,1974-05-23,ES23209580590409199953,TRX_N-00700-24637965,2023-09-01T23:40:40,Galdakao,incomes,salary,1690.87,-84979.39
buyer_4,Jorge,,1974-05-23,ES23209580590409199953,TRX_N-00701-80903935,2023-09-01T23:40:40,Galdakao,incomes,extra_income,296.42,-84682.97
buyer_4,Jorge,,1974-05-23,ES23209580590409199953,TRX_N-00702-97361985,2023-09-01T08:35:47,Galdakao,expenses,transport,-61.51,-84744.48
buyer_4,Jorge,,1974-05-23,ES23209580590409199953,TRX_N-00703-08146908,2023-09-02T16:14:57,Galdakao,expenses,cash,-100.0,-84844.48
buyer_4,Jorge,,1974-05-23,ES23209580590409199953,TRX_N-00704-93750259,2023-09-03T19:24:48,Galdakao,expenses,cash,-100.0,-84944.48
buyer_4,Jorge,,1974-05-23,ES23209580590409199953,TRX_N-00705-93975884,2023-09-04T15:43:08,Galdakao,expenses,mortgage,-1032.74,-85977.22
buyer_4,Jorge,,1974-05-23,ES23209580590409199953,TRX_N-00706-17324127,2023-09-05T19:51:10,Galdakao,expenses,internet,-42.0,-86019.22
buyer_4,Jorge,,1974-05-23,ES23209580590409199953,TRX_N-00707-23932844,2023-09-05T16:39:03,Galdakao,expenses,repairs,-256.12,-86275.34
buyer_4,Jorge,,1974-05-23,ES23209580590409199953,TRX_N-00708-33147038,2023-09-06T04:41:35,Galdakao,expenses,water,-42.97,-86318.31
buyer_4,Jorge,,1974-05-23,ES23209580590409199953,TRX_N-00709-14659013,2023-09-06T14:18:37,Galdakao,expenses,gas,-100.26,-86418.57
buyer_4,Jorge,,1974-05-23,ES23209580590409199953,TRX_N-00710-06790018,2023-09-08T07:42:16,Galdakao,expenses,electricity,-55.06,-86473.63
buyer_4,Jorge,,1974-05-23,ES23209580590409199953,TRX_N-00711-53765177,2023-09-08T08:50:22,Galdakao,expenses,phone,-31.91,-86505.54
buyer_4,Jorge,,1974-05-23,ES23209580590409199953,TRX_N-00712-35669010,2023-09-08T17:54:59,Mungia,expenses,food,-79.91,-86585.45
buyer_4,Jorge,,1974-05-23,ES23209580590409199953,TRX_N-00713-15636221,2023-09-08T16:15:53,Galdakao,expenses,leisure,-49.93,-86635.38
buyer_4,Jorge,,1974-05-23,ES23209580590409199953,TRX_N-00714-83249841,2023-09-08T11:18:30,Galdakao,expenses,clothing,-155.51,-86790.89
buyer_4,Jorge,,1974-05-23,ES23209580590409199953,TRX_N-00715-26909023,2023-09-08T18:36:15,Galdakao,expenses,gifts,-202.8,-86993.69
buyer_4,Jorge,,1974-05-23,ES23209580590409199953,TRX_N-00716-72464052,2023-09-09T19:38:59,Getxo,expenses,cash,-100.0,-87093.69
buyer_4,Jorge,,1974-05-23,ES23209580590409199953,TRX_N-00717-18315155,2023-09-11T20:07:51,Galdakao,expenses,gifts,-124.15,-87217.84
buyer_4,Jorge,,1974-05-23,ES23209580590409199953,TRX_N-00718-40853432,2023-09-12T23:10:14,Galdakao,expenses,children,-528.05,-87745.89
buyer_4,Jorge,,1974-05-23,ES23209580590409199953,TRX_N-00719-11629190,2023-09-13T06:59:31,Galdakao,expenses,cash,-100.0,-87845.89
buyer_4,Jorge,,1974-05-23,ES23209580590409199953,TRX_N-00720-84518165,2023-09-13T14:21:58,Galdakao,expenses,appliances,-78.05,-87923.94
buyer_4,Jorge,,1974-05-23,ES23209580590409199953,TRX_N-00721-52936538,2023-09-14T03:57:01,Galdakao,expenses,transport,-74.45,-87998.39
buyer_4,Jorge,,1974-05-23,ES23209580590409199953,TRX_N-00722-40235807,2023-09-15T18:45:00,Galdakao,expenses,travel,-529.35,-88527.74
buyer_4,Jorge,,1974-05-23,ES23209580590409199953,TRX_N-00723-29090562,2023-09-17T18:48:11,Galdakao,expenses,leisure,-83.13,-88610.87
buyer_4,Jorge,,1974-05-23,ES23209580590409199953,TRX_N-00724-76898631,2023-09-17T08:56:54,Galdakao,expenses,gifts,-366.82,-88977.69
buyer_4,Jorge,,1974-05-23,ES23209580590409199953,TRX_N-00725-71669785,2023-09-19T14:23:29,Galdakao,expenses,transport,-78.92,-89056.61
buyer_4,Jorge,,1974-05-23,ES23209580590409199953,TRX_N-00726-68965779,2023-09-19T08:15:44,Leioa,expenses,repairs,-278.15,-89334.76
buyer_4,Jorge,,1974-05-23,ES23209580590409199953,TRX_N-00727-82733658,2023-09-20T13:10:33,Barakaldo,expenses,food,-107.25,-89442.01
buyer_4,Jorge,,1974-05-23,ES23209580590409199953,TRX_N-00728-93368167,2023-09-20T11:17:03,Arrasate,expenses,gifts,-469.2,-89911.21
buyer_4,Jorge,,1974-05-23,ES23209580590409199953,TRX_N-00729-90049106,2023-09-21T13:45:53,Galdakao,expenses,transport,-57.43,-89968.64
buyer_4,Jorge,,1974-05-23,ES23209580590409199953,TRX_N-00730-61711138,2023-09-21T03:28:17,Galdakao,expenses,gifts,-848.83,-90817.47
buyer_4,Jorge,,1974-05-23,ES23209580590409199953,TRX_N-00731-47633378,2023-09-22T20:31:05,Galdakao,expenses,cash,-100.0,-90917.47
buyer_4,Jorge,,1974-05-23,ES23209580590409199953,TRX_N-00732-93457451,2023-09-24T16:22:46,Galdakao,expenses,food,-91.2,-91008.67
buyer_4,Jorge,,1974-05-23,ES23209580590409199953,TRX_N-00733-23698641,2023-09-24T20:51:26,Labastida,expenses,clothing,-99.89,-91108.56
buyer_4,Jorge,,1974-05-23,ES23209580590409199953,TRX_N-00734-65281408,2023-09-24T15:35:44,Galdakao,expenses,gifts,-750.8,-91859.36
buyer_4,Jorge,,1974-05-23,ES23209580590409199953,TRX_N-00735-25851024,2023-09-26T11:06:47,Galdakao,expenses,gifts,-355.01,-92214.37
buyer_4,Jorge,,1974-05-23,ES23209580590409199953,TRX_N-00736-58536645,2023-09-27T17:25:33,Galdakao,expenses,food,-103.13,-92317.5
buyer_4,Jorge,,1974-05-23,ES23209580590409199953,TRX_N-00737-12172930,2023-09-28T14:57:40,Galdakao,expenses,cash,-100.0,-92417.5
buyer_4,Jorge,,1974-05-23,ES23209580590409199953,TRX_N-00738-77169222,2023-09-29T15:46:31,Galdakao,expenses,cash,-100.0,-92517.5
buyer_4,Jorge,,1974-05-23,ES23209580590409199953,TRX_N-00739-19862764,2023-09-30T10:13:55,Elciego,expenses,transport,-77.4,-92594.9
buyer_4,Jorge,,1974-05-23,ES23209580590409199953,TRX_N-00740-27260000,2023-09-30T13:37:35,Galdakao,expenses,clothing,-150.63,-92745.53
buyer_4,Jorge,,1974-05-23,ES23209580590409199953,TRX_N-00741-87488386,2023-09-30T08:41:27,Galdakao,expenses,repairs,-98.96,-92844.49
buyer_4,Jorge,,1974-05-23,ES23209580590409199953,TRX_N-00742-38937866,2023-10-01T20:55:43,Galdakao,incomes,salary,1690.87,-91153.62
buyer_4,Jorge,,1974-05-23,ES23209580590409199953,TRX_N-00743-65446184,2023-10-01T22:25:54,Galdakao,expenses,cash,-100.0,-91253.62
buyer_4,Jorge,,1974-05-23,ES23209580590409199953,TRX_N-00744-78320721,2023-10-02T13:38:10,Galdakao,expenses,transport,-67.78,-91321.4
buyer_4,Jorge,,1974-05-23,ES23209580590409199953,TRX_N-00745-64312849,2023-10-02T19:07:10,Erandio,expenses,cash,-100.0,-91421.4
buyer_4,Jorge,,1974-05-23,ES23209580590409199953,TRX_N-00746-62813553,2023-10-02T19:30:53,Galdakao,expenses,children,-525.65,-91947.05
buyer_4,Jorge,,1974-05-23,ES23209580590409199953,TRX_N-00747-85162675,2023-10-04T08:08:02,Galdakao,expenses,mortgage,-1032.74,-92979.79
buyer_4,Jorge,,1974-05-23,ES23209580590409199953,TRX_N-00748-23301294,2023-10-05T20:50:07,Galdakao,expenses,phone,-40.12,-93019.91
buyer_4,Jorge,,1974-05-23,ES23209580590409199953,TRX_N-00749-05987374,2023-10-06T09:01:01,Galdakao,expenses,internet,-42.0,-93061.91
buyer_4,Jorge,,1974-05-23,ES23209580590409199953,TRX_N-00750-03013160,2023-10-07T02:34:45,Galdakao,expenses,electricity,-48.63,-93110.54
buyer_4,Jorge,,1974-05-23,ES23209580590409199953,TRX_N-00751-63541521,2023-10-07T13:01:23,Galdakao,expenses,children,-290.98,-93401.52
buyer_4,Jorge,,1974-05-23,ES23209580590409199953,TRX_N-00752-44173734,2023-10-08T19:09:12,Galdakao,expenses,water,-40.01,-93441.53
buyer_4,Jorge,,1974-05-23,ES23209580590409199953,TRX_N-00753-30569706,2023-10-08T12:22:26,Galdakao,expenses,gas,-74.81,-93516.34
buyer_4,Jorge,,1974-05-23,ES23209580590409199953,TRX_N-00754-16524292,2023-10-10T12:09:36,Galdakao,expenses,food,-108.93,-93625.27
buyer_4,Jorge,,1974-05-23,ES23209580590409199953,TRX_N-00755-78151560,2023-10-10T16:57:49,Errenteria,expenses,leisure,-32.01,-93657.28
buyer_4,Jorge,,1974-05-23,ES23209580590409199953,TRX_N-00756-82508853,2023-10-10T13:20:18,Galdakao,expenses,cash,-100.0,-93757.28
buyer_4,Jorge,,1974-05-23,ES23209580590409199953,TRX_N-00757-19444902,2023-10-11T15:30:12,Galdakao,expenses,appliances,-207.31,-93964.59
buyer_4,Jorge,,1974-05-23,ES23209580590409199953,TRX_N-00758-70371769,2023-10-12T09:06:29,Galdakao,expenses,clothing,-81.51,-94046.1
buyer_4,Jorge,,1974-05-23,ES23209580590409199953,TRX_N-00759-90528349,2023-10-12T20:04:25,Galdakao,expenses,appliances,-309.52,-94355.62
buyer_4,Jorge,,1974-05-23,ES23209580590409199953,TRX_N-00760-84616899,2023-10-13T17:21:24,Hernani,expenses,food,-82.23,-94437.85
buyer_4,Jorge,,1974-05-23,ES23209580590409199953,TRX_N-00761-42822742,2023-10-13T16:27:10,Galdakao,expenses,education,-65.85,-94503.7
buyer_4,Jorge,,1974-05-23,ES23209580590409199953,TRX_N-00762-71156024,2023-10-14T18:57:25,Mungia,expenses,gifts,-656.22,-95159.92
buyer_4,Jorge,,1974-05-23,ES23209580590409199953,TRX_N-00763-24929116,2023-10-15T09:30:00,Galdakao,expenses,education,-45.71,-95205.63
buyer_4,Jorge,,1974-05-23,ES23209580590409199953,TRX_N-00764-51450522,2023-10-15T11:43:38,Galdakao,expenses,repairs,-316.53,-95522.16
buyer_4,Jorge,,1974-05-23,ES23209580590409199953,TRX_N-00765-75888078,2023-10-16T22:07:07,Bilbao,expenses,cash,-100.0,-95622.16
buyer_4,Jorge,,1974-05-23,ES23209580590409199953,TRX_N-00766-17686639,2023-10-16T12:49:06,Galdakao,expenses,gifts,-167.97,-95790.13
buyer_4,Jorge,,1974-05-23,ES23209580590409199953,TRX_N-00767-39193348,2023-10-20T03:26:26,Galdakao,expenses,repairs,-35.71,-95825.84
buyer_4,Jorge,,1974-05-23,ES23209580590409199953,TRX_N-00768-37460434,2023-10-23T13:46:28,Galdakao,expenses,cash,-100.0,-95925.84
buyer_4,Jorge,,1974-05-23,ES23209580590409199953,TRX_N-00769-02523278,2023-10-25T11:43:35,Galdakao,expenses,food,-100.69,-96026.53
buyer_4,Jorge,,1974-05-23,ES23209580590409199953,TRX_N-00770-87137272,2023-10-25T09:52:58,Galdakao,expenses,cash,-100.0,-96126.53
buyer_4,Jorge,,1974-05-23,ES23209580590409199953,TRX_N-00771-39849701,2023-10-26T13:12:53,Galdakao,expenses,clothing,-89.89,-96216.42
buyer_4,Jorge,,1974-05-23,ES23209580590409199953,TRX_N-00772-82839361,2023-10-26T20:39:28,Galdakao,expenses,gifts,-642.81,-96859.23
buyer_4,Jorge,,1974-05-23,ES23209580590409199953,TRX_N-00773-64038010,2023-10-27T04:33:14,Galdakao,expenses,transport,-73.42,-96932.65
buyer_4,Jorge,,1974-05-23,ES23209580590409199953,TRX_N-00774-24538940,2023-10-28T18:15:26,Galdakao,expenses,transport,-74.25,-97006.9
buyer_4,Jorge,,1974-05-23,ES23209580590409199953,TRX_N-00775-93537206,2023-10-31T08:11:05,Galdakao,expenses,leisure,-77.26,-97084.16
buyer_4,Jorge,,1974-05-23,ES23209580590409199953,TRX_N-00776-05800045,2023-11-01T08:48:59,Galdakao,incomes,salary,1690.87,-95393.29
buyer_4,Jorge,,1974-05-23,ES23209580590409199953,TRX_N-00777-35127099,2023-11-02T09:23:21,Galdakao,expenses,food,-117.98,-95511.27
buyer_4,Jorge,,1974-05-23,ES23209580590409199953,TRX_N-00778-09262822,2023-11-02T23:43:18,Galdakao,expenses,transport,-84.38,-95595.65
buyer_4,Jorge,,1974-05-23,ES23209580590409199953,TRX_N-00779-75414332,2023-11-04T14:55:53,Galdakao,expenses,mortgage,-1032.74,-96628.39
buyer_4,Jorge,,1974-05-23,ES23209580590409199953,TRX_N-00780-21281501,2023-11-04T07:35:41,Galdakao,expenses,leisure,-40.55,-96668.94
buyer_4,Jorge,,1974-05-23,ES23209580590409199953,TRX_N-00781-10875888,2023-11-05T12:27:39,Galdakao,expenses,water,-30.11,-96699.05
buyer_4,Jorge,,1974-05-23,ES23209580590409199953,TRX_N-00782-78081654,2023-11-05T22:40:36,Galdakao,expenses,gas,-76.83,-96775.88
buyer_4,Jorge,,1974-05-23,ES23209580590409199953,TRX_N-00783-79213781,2023-11-06T11:46:13,Galdakao,expenses,electricity,-60.64,-96836.52
buyer_4,Jorge,,1974-05-23,ES23209580590409199953,TRX_N-00784-31574594,2023-11-06T17:22:29,Galdakao,expenses,transport,-41.48,-96878.0
buyer_4,Jorge,,1974-05-23,ES23209580590409199953,TRX_N-00785-31281445,2023-11-06T18:10:25,Galdakao,expenses,repairs,-176.82,-97054.82
buyer_4,Jorge,,1974-05-23,ES23209580590409199953,TRX_N-00786-55166521,2023-11-07T16:27:54,Galdakao,expenses,internet,-42.0,-97096.82
buyer_4,Jorge,,1974-05-23,ES23209580590409199953,TRX_N-00787-29384305,2023-11-07T16:14:55,Galdakao,expenses,education,-59.02,-97155.84
buyer_4,Jorge,,1974-05-23,ES23209580590409199953,TRX_N-00788-72331976,2023-11-07T16:03:41,Galdakao,expenses,repairs,-173.98,-97329.82
buyer_4,Jorge,,1974-05-23,ES23209580590409199953,TRX_N-00789-77850296,2023-11-08T22:11:43,Galdakao,expenses,phone,-40.01,-97369.83
buyer_4,Jorge,,1974-05-23,ES23209580590409199953,TRX_N-00790-16289630,2023-11-08T23:17:43,Galdakao,expenses,education,-78.04,-97447.87
buyer_4,Jorge,,1974-05-23,ES23209580590409199953,TRX_N-00791-95098709,2023-11-13T08:50:43,Galdakao,expenses,cash,-100.0,-97547.87
buyer_4,Jorge,,1974-05-23,ES23209580590409199953,TRX_N-00792-85474060,2023-11-14T14:23:48,Mungia,expenses,leisure,-49.0,-97596.87
buyer_4,Jorge,,1974-05-23,ES23209580590409199953,TRX_N-00793-70870417,2023-11-14T12:18:28,Llodio,expenses,repairs,-295.98,-97892.85
buyer_4,Jorge,,1974-05-23,ES23209580590409199953,TRX_N-00794-73596538,2023-11-15T13:40:41,Galdakao,expenses,repairs,-77.54,-97970.39
buyer_4,Jorge,,1974-05-23,ES23209580590409199953,TRX_N-00795-90905432,2023-11-16T15:14:06,Galdakao,expenses,food,-109.96,-98080.35
buyer_4,Jorge,,1974-05-23,ES23209580590409199953,TRX_N-00796-22981280,2023-11-16T17:30:21,Galdakao,expenses,repairs,-157.71,-98238.06
buyer_4,Jorge,,1974-05-23,ES23209580590409199953,TRX_N-00797-44179552,2023-11-17T19:40:38,Hondarribia,expenses,food,-67.11,-98305.17
buyer_4,Jorge,,1974-05-23,ES23209580590409199953,TRX_N-00798-57359449,2023-11-17T12:26:25,Bermeo,expenses,leisure,-40.65,-98345.82
buyer_4,Jorge,,1974-05-23,ES23209580590409199953,TRX_N-00799-31985447,2023-11-19T10:24:05,Galdakao,expenses,children,-1289.38,-99635.2
buyer_4,Jorge,,1974-05-23,ES23209580590409199953,TRX_N-00800-98199020,2023-11-20T11:19:51,Galdakao,expenses,gifts,-710.12,-100345.32
buyer_4,Jorge,,1974-05-23,ES23209580590409199953,TRX_N-00801-54111631,2023-11-21T14:08:21,Galdakao,expenses,food,-81.74,-100427.06
buyer_4,Jorge,,1974-05-23,ES23209580590409199953,TRX_N-00802-28746054,2023-11-22T17:32:48,Galdakao,expenses,food,-78.93,-100505.99
buyer_4,Jorge,,1974-05-23,ES23209580590409199953,TRX_N-00803-75141265,2023-11-22T12:23:47,Galdakao,expenses,leisure,-78.58,-100584.57
buyer_4,Jorge,,1974-05-23,ES23209580590409199953,TRX_N-00804-34799604,2023-11-23T20:38:27,Mungia,expenses,gifts,-591.88,-101176.45
buyer_4,Jorge,,1974-05-23,ES23209580590409199953,TRX_N-00805-66293248,2023-11-24T22:23:26,Galdakao,expenses,food,-103.68,-101280.13
buyer_4,Jorge,,1974-05-23,ES23209580590409199953,TRX_N-00806-33607239,2023-11-25T19:42:04,Galdakao,expenses,leisure,-63.19,-101343.32
buyer_4,Jorge,,1974-05-23,ES23209580590409199953,TRX_N-00807-69093682,2023-11-25T16:18:52,Galdakao,expenses,appliances,-378.03,-101721.35
buyer_4,Jorge,,1974-05-23,ES23209580590409199953,TRX_N-00808-17624188,2023-11-26T06:40:44,Galdakao,expenses,food,-65.17,-101786.52
buyer_4,Jorge,,1974-05-23,ES23209580590409199953,TRX_N-00809-44925562,2023-11-28T10:08:51,Galdakao,expenses,food,-124.21,-101910.73
buyer_4,Jorge,,1974-05-23,ES23209580590409199953,TRX_N-00810-12059731,2023-11-29T22:46:44,Galdakao,expenses,food,-118.21,-102028.94
buyer_4,Jorge,,1974-05-23,ES23209580590409199953,TRX_N-00811-78285639,2023-11-29T09:23:57,Galdakao,expenses,transport,-52.52,-102081.46
buyer_4,Jorge,,1974-05-23,ES23209580590409199953,TRX_N-00812-72432027,2023-11-29T18:23:42,Galdakao,expenses,healthcare,-139.42,-102220.88
buyer_4,Jorge,,1974-05-23,ES23209580590409199953,TRX_N-00813-01150813,2023-12-01T14:41:12,Galdakao,incomes,salary,1690.87,-100530.01
buyer_4,Jorge,,1974-05-23,ES23209580590409199953,TRX_N-00814-43582145,2023-12-01T14:41:12,Galdakao,incomes,extra_income,296.42,-100233.59
buyer_4,Jorge,,1974-05-23,ES23209580590409199953,TRX_N-00815-03753391,2023-12-01T14:41:12,Galdakao,incomes,salary_bonus,1336.74,-98896.85
buyer_4,Jorge,,1974-05-23,ES23209580590409199953,TRX_N-00816-83686885,2023-12-01T11:01:59,Galdakao,expenses,leisure,-76.06,-98972.91
buyer_4,Jorge,,1974-05-23,ES23209580590409199953,TRX_N-00817-82841656,2023-12-02T14:25:49,Galdakao,expenses,repairs,-328.56,-99301.47
buyer_4,Jorge,,1974-05-23,ES23209580590409199953,TRX_N-00818-70083058,2023-12-03T11:45:54,Galdakao,expenses,repairs,-124.7,-99426.17
buyer_4,Jorge,,1974-05-23,ES23209580590409199953,TRX_N-00819-56858251,2023-12-04T21:48:26,Galdakao,expenses,mortgage,-1032.74,-100458.91
buyer_4,Jorge,,1974-05-23,ES23209580590409199953,TRX_N-00820-48527259,2023-12-04T12:10:03,Galdakao,expenses,food,-89.66,-100548.57
buyer_4,Jorge,,1974-05-23,ES23209580590409199953,TRX_N-00821-71359697,2023-12-05T18:39:56,Galdakao,expenses,phone,-31.44,-100580.01
buyer_4,Jorge,,1974-05-23,ES23209580590409199953,TRX_N-00822-42654916,2023-12-05T14:59:33,Galdakao,expenses,repairs,-85.26,-100665.27
buyer_4,Jorge,,1974-05-23,ES23209580590409199953,TRX_N-00823-06117639,2023-12-06T08:12:38,Galdakao,expenses,gas,-37.97,-100703.24
buyer_4,Jorge,,1974-05-23,ES23209580590409199953,TRX_N-00824-22497711,2023-12-06T15:40:46,Galdakao,expenses,internet,-42.0,-100745.24
buyer_4,Jorge,,1974-05-23,ES23209580590409199953,TRX_N-00825-93169730,2023-12-07T18:44:03,Galdakao,expenses,water,-26.28,-100771.52
buyer_4,Jorge,,1974-05-23,ES23209580590409199953,TRX_N-00826-22680220,2023-12-07T15:39:54,Galdakao,expenses,education,-56.51,-100828.03
buyer_4,Jorge,,1974-05-23,ES23209580590409199953,TRX_N-00827-57578861,2023-12-08T21:50:21,Galdakao,expenses,electricity,-48.89,-100876.92
buyer_4,Jorge,,1974-05-23,ES23209580590409199953,TRX_N-00828-39490251,2023-12-08T16:39:15,Galdakao,expenses,leisure,-84.03,-100960.95
buyer_4,Jorge,,1974-05-23,ES23209580590409199953,TRX_N-00829-28279955,2023-12-08T09:37:53,Lasarte-Oria,expenses,clothing,-118.2,-101079.15
buyer_4,Jorge,,1974-05-23,ES23209580590409199953,TRX_N-00830-45296649,2023-12-10T16:50:11,Galdakao,expenses,transport,-84.63,-101163.78
buyer_4,Jorge,,1974-05-23,ES23209580590409199953,TRX_N-00831-85038482,2023-12-10T14:30:57,Galdakao,expenses,travel,-1017.59,-102181.37
buyer_4,Jorge,,1974-05-23,ES23209580590409199953,TRX_N-00832-98392676,2023-12-11T11:18:32,Erandio,expenses,transport,-50.84,-102232.21
buyer_4,Jorge,,1974-05-23,ES23209580590409199953,TRX_N-00833-59474749,2023-12-13T18:33:57,Galdakao,expenses,healthcare,-149.03,-102381.24
buyer_4,Jorge,,1974-05-23,ES23209580590409199953,TRX_N-00834-24602099,2023-12-13T11:00:03,Galdakao,expenses,children,-1212.19,-103593.43
buyer_4,Jorge,,1974-05-23,ES23209580590409199953,TRX_N-00835-32614330,2023-12-14T17:44:27,Galdakao,expenses,transport,-65.71,-103659.14
buyer_4,Jorge,,1974-05-23,ES23209580590409199953,TRX_N-00836-22584861,2023-12-15T15:27:19,Galdakao,expenses,healthcare,-108.87,-103768.01
buyer_4,Jorge,,1974-05-23,ES23209580590409199953,TRX_N-00837-92493655,2023-12-16T12:11:18,Galdakao,expenses,clothing,-78.89,-103846.9
buyer_4,Jorge,,1974-05-23,ES23209580590409199953,TRX_N-00838-69434676,2023-12-17T18:05:17,Galdakao,expenses,leisure,-35.18,-103882.08
buyer_4,Jorge,,1974-05-23,ES23209580590409199953,TRX_N-00839-31927290,2023-12-20T16:27:56,Galdakao,expenses,transport,-45.15,-103927.23
buyer_4,Jorge,,1974-05-23,ES23209580590409199953,TRX_N-00840-95803954,2023-12-20T14:55:12,Galdakao,expenses,gifts,-185.07,-104112.3
buyer_4,Jorge,,1974-05-23,ES23209580590409199953,TRX_N-00841-62797540,2023-12-22T14:53:41,Galdakao,expenses,transport,-54.72,-104167.02
buyer_4,Jorge,,1974-05-23,ES23209580590409199953,TRX_N-00842-45476677,2023-12-23T18:14:31,Galdakao,expenses,education,-52.84,-104219.86
buyer_4,Jorge,,1974-05-23,ES23209580590409199953,TRX_N-00843-07011633,2023-12-24T10:30:39,Galdakao,expenses,food,-124.8,-104344.66
buyer_4,Jorge,,1974-05-23,ES23209580590409199953,TRX_N-00844-64391218,2023-12-24T17:23:05,Galdakao,expenses,cash,-100.0,-104444.66
buyer_4,Jorge,,1974-05-23,ES23209580590409199953,TRX_N-00845-62173722,2023-12-24T11:50:15,Galdakao,expenses,appliances,-366.9,-104811.56
buyer_4,Jorge,,1974-05-23,ES23209580590409199953,TRX_N-00846-41037684,2023-12-25T13:29:25,Galdakao,expenses,leisure,-79.57,-104891.13
buyer_4,Jorge,,1974-05-23,ES23209580590409199953,TRX_N-00847-59207735,2023-12-26T19:29:26,Iru√±a de Oca,expenses,gifts,-488.81,-105379.94
buyer_4,Jorge,,1974-05-23,ES23209580590409199953,TRX_N-00848-35054889,2023-12-28T15:21:33,Galdakao,expenses,food,-67.95,-105447.89
buyer_4,Jorge,,1974-05-23,ES23209580590409199953,TRX_N-00849-85553972,2023-12-28T14:33:31,Galdakao,expenses,leisure,-53.52,-105501.41
buyer_4,Jorge,,1974-05-23,ES23209580590409199953,TRX_N-00850-69736912,2023-12-29T17:46:52,Galdakao,expenses,transport,-42.11,-105543.52
buyer_4,Jorge,,1974-05-23,ES23209580590409199953,TRX_N-00851-09067652,2023-12-29T17:56:23,Galdakao,expenses,leisure,-81.59,-105625.11
buyer_4,Jorge,,1974-05-23,ES23209580590409199953,TRX_N-00852-64696274,2023-12-30T18:59:04,Galdakao,expenses,leisure,-58.22,-105683.33
buyer_4,Jorge,,1974-05-23,ES23209580590409199953,TRX_N-00853-37677131,2023-12-30T19:28:10,Galdakao,expenses,cash,-100.0,-105783.33
buyer_4,Jorge,,1974-05-23,ES23209580590409199953,TRX_N-00854-51165921,2023-12-31T08:54:55,Galdakao,expenses,food,-71.2,-105854.53
buyer_4,Jorge,,1974-05-23,ES23209580590409199953,TRX_N-00855-85836758,2023-12-31T17:17:15,Donostia,expenses,healthcare,-64.62,-105919.15
buyer_4,Jorge,,1974-05-23,ES23209580590409199953,TRX_N-00856-02907584,2024-01-01T11:28:33,Galdakao,incomes,salary,1740.06,-104179.09
buyer_4,Jorge,,1974-05-23,ES23209580590409199953,TRX_N-00857-40742839,2024-01-01T15:34:47,Galdakao,expenses,cash,-100.0,-104279.09
buyer_4,Jorge,,1974-05-23,ES23209580590409199953,TRX_N-00858-33279926,2024-01-02T08:35:15,Galdakao,expenses,cash,-100.0,-104379.09
buyer_4,Jorge,,1974-05-23,ES23209580590409199953,TRX_N-00859-91841493,2024-01-03T17:31:57,Galdakao,expenses,food,-100.91,-104480.0
buyer_4,Jorge,,1974-05-23,ES23209580590409199953,TRX_N-00860-90951458,2024-01-04T10:45:00,Galdakao,expenses,mortgage,-1032.74,-105512.74
buyer_4,Jorge,,1974-05-23,ES23209580590409199953,TRX_N-00861-65481912,2024-01-05T12:16:31,Galdakao,expenses,repairs,-83.02,-105595.76
buyer_4,Jorge,,1974-05-23,ES23209580590409199953,TRX_N-00862-85437668,2024-01-06T16:08:17,Galdakao,expenses,internet,-42.0,-105637.76
buyer_4,Jorge,,1974-05-23,ES23209580590409199953,TRX_N-00863-73148901,2024-01-06T08:27:42,Galdakao,expenses,phone,-36.84,-105674.6
buyer_4,Jorge,,1974-05-23,ES23209580590409199953,TRX_N-00864-08705375,2024-01-07T16:29:13,Galdakao,expenses,electricity,-28.28,-105702.88
buyer_4,Jorge,,1974-05-23,ES23209580590409199953,TRX_N-00865-72456624,2024-01-07T11:47:22,Galdakao,expenses,gas,-84.99,-105787.87
buyer_4,Jorge,,1974-05-23,ES23209580590409199953,TRX_N-00866-42331313,2024-01-08T10:18:04,Galdakao,expenses,water,-28.04,-105815.91
buyer_4,Jorge,,1974-05-23,ES23209580590409199953,TRX_N-00867-68592883,2024-01-08T13:57:43,Zuia,expenses,gifts,-553.32,-106369.23
buyer_4,Jorge,,1974-05-23,ES23209580590409199953,TRX_N-00868-92052007,2024-01-10T18:38:34,Galdakao,expenses,transport,-42.1,-106411.33
buyer_4,Jorge,,1974-05-23,ES23209580590409199953,TRX_N-00869-09627752,2024-01-10T17:54:02,Zuia,expenses,gifts,-480.88,-106892.21
buyer_4,Jorge,,1974-05-23,ES23209580590409199953,TRX_N-00870-58296423,2024-01-10T03:09:18,Galdakao,expenses,children,-581.18,-107473.39
buyer_4,Jorge,,1974-05-23,ES23209580590409199953,TRX_N-00871-27681970,2024-01-11T13:29:55,Erandio,expenses,leisure,-84.79,-107558.18
buyer_4,Jorge,,1974-05-23,ES23209580590409199953,TRX_N-00872-31084426,2024-01-12T20:34:18,Galdakao,expenses,repairs,-185.67,-107743.85
buyer_4,Jorge,,1974-05-23,ES23209580590409199953,TRX_N-00873-89630233,2024-01-13T20:57:39,Santurtzi,expenses,transport,-62.94,-107806.79
buyer_4,Jorge,,1974-05-23,ES23209580590409199953,TRX_N-00874-30837809,2024-01-13T15:33:27,Galdakao,expenses,appliances,-103.29,-107910.08
buyer_4,Jorge,,1974-05-23,ES23209580590409199953,TRX_N-00875-59804943,2024-01-14T22:01:49,Galdakao,expenses,transport,-63.94,-107974.02
buyer_4,Jorge,,1974-05-23,ES23209580590409199953,TRX_N-00876-94106613,2024-01-14T18:51:41,Galdakao,expenses,repairs,-193.93,-108167.95
buyer_4,Jorge,,1974-05-23,ES23209580590409199953,TRX_N-00877-28031054,2024-01-15T12:21:42,Galdakao,expenses,repairs,-281.28,-108449.23
buyer_4,Jorge,,1974-05-23,ES23209580590409199953,TRX_N-00878-14046398,2024-01-16T22:57:49,Galdakao,expenses,transport,-46.15,-108495.38
buyer_4,Jorge,,1974-05-23,ES23209580590409199953,TRX_N-00879-78860584,2024-01-16T07:48:08,Galdakao,expenses,clothing,-139.86,-108635.24
buyer_4,Jorge,,1974-05-23,ES23209580590409199953,TRX_N-00880-75036355,2024-01-16T14:49:12,Galdakao,expenses,repairs,-88.38,-108723.62
buyer_4,Jorge,,1974-05-23,ES23209580590409199953,TRX_N-00881-00414987,2024-01-18T15:42:08,Galdakao,expenses,food,-67.2,-108790.82
buyer_4,Jorge,,1974-05-23,ES23209580590409199953,TRX_N-00882-00151631,2024-01-18T22:46:44,Amurrio,expenses,repairs,-212.28,-109003.1
buyer_4,Jorge,,1974-05-23,ES23209580590409199953,TRX_N-00883-21948758,2024-01-19T09:02:26,Durango,expenses,food,-65.51,-109068.61
buyer_4,Jorge,,1974-05-23,ES23209580590409199953,TRX_N-00884-47958730,2024-01-20T08:23:29,Basauri,expenses,appliances,-285.67,-109354.28
buyer_4,Jorge,,1974-05-23,ES23209580590409199953,TRX_N-00885-50031310,2024-01-20T14:28:22,Galdakao,expenses,repairs,-310.34,-109664.62
buyer_4,Jorge,,1974-05-23,ES23209580590409199953,TRX_N-00886-44016288,2024-01-21T18:12:19,Zuia,expenses,cash,-100.0,-109764.62
buyer_4,Jorge,,1974-05-23,ES23209580590409199953,TRX_N-00887-51005765,2024-01-22T18:13:58,Galdakao,expenses,transport,-88.96,-109853.58
buyer_4,Jorge,,1974-05-23,ES23209580590409199953,TRX_N-00888-97383266,2024-01-22T18:44:21,Galdakao,expenses,healthcare,-52.5,-109906.08
buyer_4,Jorge,,1974-05-23,ES23209580590409199953,TRX_N-00889-77739839,2024-01-23T10:05:30,Pasaia,expenses,leisure,-56.12,-109962.2
buyer_4,Jorge,,1974-05-23,ES23209580590409199953,TRX_N-00890-59993067,2024-01-24T20:04:12,Sopela,expenses,repairs,-294.27,-110256.47
buyer_4,Jorge,,1974-05-23,ES23209580590409199953,TRX_N-00891-90279226,2024-01-26T14:53:57,Galdakao,expenses,gifts,-741.67,-110998.14
buyer_4,Jorge,,1974-05-23,ES23209580590409199953,TRX_N-00892-63510374,2024-01-27T08:20:31,Galdakao,expenses,food,-74.61,-111072.75
buyer_4,Jorge,,1974-05-23,ES23209580590409199953,TRX_N-00893-54688540,2024-01-27T08:11:31,Galdakao,expenses,clothing,-53.5,-111126.25
buyer_4,Jorge,,1974-05-23,ES23209580590409199953,TRX_N-00894-23085669,2024-01-27T20:29:08,Sestao,expenses,repairs,-30.66,-111156.91
buyer_4,Jorge,,1974-05-23,ES23209580590409199953,TRX_N-00895-09136044,2024-01-28T16:55:26,Galdakao,expenses,leisure,-51.71,-111208.62
buyer_4,Jorge,,1974-05-23,ES23209580590409199953,TRX_N-00896-77648237,2024-01-28T09:51:50,Galdakao,expenses,education,-68.32,-111276.94
buyer_4,Jorge,,1974-05-23,ES23209580590409199953,TRX_N-00897-01655733,2024-02-01T16:16:05,Galdakao,incomes,salary,1740.06,-109536.88
buyer_4,Jorge,,1974-05-23,ES23209580590409199953,TRX_N-00898-57528694,2024-02-03T06:15:22,Alegr√≠a-Dulantzi,expenses,clothing,-57.7,-109594.58
buyer_4,Jorge,,1974-05-23,ES23209580590409199953,TRX_N-00899-66485325,2024-02-03T06:22:03,Basauri,expenses,cash,-100.0,-109694.58
buyer_4,Jorge,,1974-05-23,ES23209580590409199953,TRX_N-00900-00728031,2024-02-04T10:43:45,Galdakao,expenses,mortgage,-1032.74,-110727.32
buyer_4,Jorge,,1974-05-23,ES23209580590409199953,TRX_N-00901-26932490,2024-02-04T16:25:12,Galdakao,expenses,cash,-100.0,-110827.32
buyer_4,Jorge,,1974-05-23,ES23209580590409199953,TRX_N-00902-66620436,2024-02-04T10:34:38,Galdakao,expenses,gifts,-118.53,-110945.85
buyer_4,Jorge,,1974-05-23,ES23209580590409199953,TRX_N-00903-99535851,2024-02-05T13:00:01,Galdakao,expenses,internet,-42.0,-110987.85
buyer_4,Jorge,,1974-05-23,ES23209580590409199953,TRX_N-00904-16660476,2024-02-05T20:43:41,Galdakao,expenses,phone,-34.21,-111022.06
buyer_4,Jorge,,1974-05-23,ES23209580590409199953,TRX_N-00905-49291208,2024-02-06T17:01:53,Galdakao,expenses,water,-43.61,-111065.67
buyer_4,Jorge,,1974-05-23,ES23209580590409199953,TRX_N-00906-00526965,2024-02-07T10:57:08,Galdakao,expenses,electricity,-48.97,-111114.64
buyer_4,Jorge,,1974-05-23,ES23209580590409199953,TRX_N-00907-58786087,2024-02-08T18:39:29,Galdakao,expenses,gas,-94.34,-111208.98
buyer_4,Jorge,,1974-05-23,ES23209580590409199953,TRX_N-00908-22906146,2024-02-08T10:34:45,Galdakao,expenses,leisure,-51.39,-111260.37
buyer_4,Jorge,,1974-05-23,ES23209580590409199953,TRX_N-00909-58414514,2024-02-11T13:56:31,Galdakao,expenses,transport,-55.77,-111316.14
buyer_4,Jorge,,1974-05-23,ES23209580590409199953,TRX_N-00910-28691692,2024-02-13T20:27:19,Galdakao,expenses,food,-81.06,-111397.2
buyer_4,Jorge,,1974-05-23,ES23209580590409199953,TRX_N-00911-15076560,2024-02-13T20:21:15,Galdakao,expenses,gifts,-615.95,-112013.15
buyer_4,Jorge,,1974-05-23,ES23209580590409199953,TRX_N-00912-15155420,2024-02-15T15:29:51,Labastida,expenses,transport,-43.07,-112056.22
buyer_4,Jorge,,1974-05-23,ES23209580590409199953,TRX_N-00913-31468280,2024-02-15T03:36:03,Galdakao,expenses,clothing,-114.53,-112170.75
buyer_4,Jorge,,1974-05-23,ES23209580590409199953,TRX_N-00914-80786228,2024-02-16T12:39:13,Galdakao,expenses,repairs,-154.78,-112325.53
buyer_4,Jorge,,1974-05-23,ES23209580590409199953,TRX_N-00915-07318716,2024-02-17T20:06:27,Galdakao,expenses,food,-87.36,-112412.89
buyer_4,Jorge,,1974-05-23,ES23209580590409199953,TRX_N-00916-81757929,2024-02-17T15:14:31,Galdakao,expenses,cash,-100.0,-112512.89
buyer_4,Jorge,,1974-05-23,ES23209580590409199953,TRX_N-00917-94710351,2024-02-18T11:02:12,Galdakao,expenses,cash,-100.0,-112612.89
buyer_4,Jorge,,1974-05-23,ES23209580590409199953,TRX_N-00918-01894726,2024-02-18T20:36:17,Galdakao,expenses,gifts,-523.69,-113136.58
buyer_4,Jorge,,1974-05-23,ES23209580590409199953,TRX_N-00919-04061653,2024-02-19T11:07:30,Galdakao,expenses,transport,-74.79,-113211.37
buyer_4,Jorge,,1974-05-23,ES23209580590409199953,TRX_N-00920-27809927,2024-02-19T14:40:05,Galdakao,expenses,clothing,-136.59,-113347.96
buyer_4,Jorge,,1974-05-23,ES23209580590409199953,TRX_N-00921-48634622,2024-02-21T13:40:36,Galdakao,expenses,transport,-75.95,-113423.91
buyer_4,Jorge,,1974-05-23,ES23209580590409199953,TRX_N-00922-92874001,2024-02-21T14:24:00,Galdakao,expenses,gifts,-560.27,-113984.18
buyer_4,Jorge,,1974-05-23,ES23209580590409199953,TRX_N-00923-00849945,2024-02-22T12:02:19,Galdakao,expenses,cash,-100.0,-114084.18
buyer_4,Jorge,,1974-05-23,ES23209580590409199953,TRX_N-00924-23805512,2024-02-22T08:43:19,Galdakao,expenses,repairs,-151.36,-114235.54
buyer_4,Jorge,,1974-05-23,ES23209580590409199953,TRX_N-00925-05845360,2024-03-01T08:34:05,Galdakao,incomes,salary,1740.06,-112495.48
buyer_4,Jorge,,1974-05-23,ES23209580590409199953,TRX_N-00926-70334949,2024-03-02T15:03:35,Galdakao,expenses,leisure,-55.1,-112550.58
buyer_4,Jorge,,1974-05-23,ES23209580590409199953,TRX_N-00927-60356348,2024-03-04T03:16:17,Galdakao,expenses,mortgage,-1032.74,-113583.32
buyer_4,Jorge,,1974-05-23,ES23209580590409199953,TRX_N-00928-75491321,2024-03-05T11:16:21,Galdakao,expenses,phone,-34.72,-113618.04
buyer_4,Jorge,,1974-05-23,ES23209580590409199953,TRX_N-00929-82242196,2024-03-05T12:46:19,Galdakao,expenses,gifts,-600.63,-114218.67
buyer_4,Jorge,,1974-05-23,ES23209580590409199953,TRX_N-00930-06547940,2024-03-07T19:47:09,Galdakao,expenses,internet,-42.0,-114260.67
buyer_4,Jorge,,1974-05-23,ES23209580590409199953,TRX_N-00931-63516111,2024-03-07T09:46:06,Errenteria,expenses,transport,-89.94,-114350.61
buyer_4,Jorge,,1974-05-23,ES23209580590409199953,TRX_N-00932-94951380,2024-03-08T10:27:45,Galdakao,expenses,electricity,-88.29,-114438.9
buyer_4,Jorge,,1974-05-23,ES23209580590409199953,TRX_N-00933-24257022,2024-03-08T08:25:08,Galdakao,expenses,water,-23.44,-114462.34
buyer_4,Jorge,,1974-05-23,ES23209580590409199953,TRX_N-00934-82006137,2024-03-08T09:28:59,Galdakao,expenses,gas,-91.19,-114553.53
buyer_4,Jorge,,1974-05-23,ES23209580590409199953,TRX_N-00935-45705226,2024-03-11T11:38:50,Galdakao,expenses,food,-119.49,-114673.02
buyer_4,Jorge,,1974-05-23,ES23209580590409199953,TRX_N-00936-99070684,2024-03-12T07:40:12,Leioa,expenses,cash,-100.0,-114773.02
buyer_4,Jorge,,1974-05-23,ES23209580590409199953,TRX_N-00937-13289241,2024-03-13T06:06:34,Galdakao,expenses,transport,-53.5,-114826.52
buyer_4,Jorge,,1974-05-23,ES23209580590409199953,TRX_N-00938-35849443,2024-03-13T13:22:06,Galdakao,expenses,education,-77.0,-114903.52
buyer_4,Jorge,,1974-05-23,ES23209580590409199953,TRX_N-00939-72492904,2024-03-13T19:05:20,Galdakao,expenses,cash,-100.0,-115003.52
buyer_4,Jorge,,1974-05-23,ES23209580590409199953,TRX_N-00940-77282007,2024-03-14T18:05:35,Hernani,expenses,cash,-100.0,-115103.52
buyer_4,Jorge,,1974-05-23,ES23209580590409199953,TRX_N-00941-43910459,2024-03-15T12:11:55,Galdakao,expenses,travel,-503.28,-115606.8
buyer_4,Jorge,,1974-05-23,ES23209580590409199953,TRX_N-00942-89399493,2024-03-19T19:48:57,Galdakao,expenses,healthcare,-53.08,-115659.88
buyer_4,Jorge,,1974-05-23,ES23209580590409199953,TRX_N-00943-99411665,2024-03-19T12:19:15,Galdakao,expenses,gifts,-774.58,-116434.46
buyer_4,Jorge,,1974-05-23,ES23209580590409199953,TRX_N-00944-22402081,2024-03-20T12:32:14,Galdakao,expenses,food,-80.01,-116514.47
buyer_4,Jorge,,1974-05-23,ES23209580590409199953,TRX_N-00945-45249859,2024-03-21T09:27:40,Zuia,expenses,transport,-42.38,-116556.85
buyer_4,Jorge,,1974-05-23,ES23209580590409199953,TRX_N-00946-70343488,2024-03-21T23:36:43,Galdakao,expenses,cash,-100.0,-116656.85
buyer_4,Jorge,,1974-05-23,ES23209580590409199953,TRX_N-00947-65522888,2024-03-21T06:59:58,Galdakao,expenses,repairs,-251.1,-116907.95
buyer_4,Jorge,,1974-05-23,ES23209580590409199953,TRX_N-00948-48803005,2024-03-22T01:23:47,Galdakao,expenses,transport,-50.94,-116958.89
buyer_4,Jorge,,1974-05-23,ES23209580590409199953,TRX_N-00949-07007990,2024-03-22T10:34:51,Galdakao,expenses,leisure,-47.49,-117006.38
buyer_4,Jorge,,1974-05-23,ES23209580590409199953,TRX_N-00950-37319504,2024-03-23T10:54:23,Galdakao,expenses,education,-50.12,-117056.5
buyer_4,Jorge,,1974-05-23,ES23209580590409199953,TRX_N-00951-99412827,2024-03-23T13:44:28,Getxo,expenses,cash,-100.0,-117156.5
buyer_4,Jorge,,1974-05-23,ES23209580590409199953,TRX_N-00952-05799969,2024-03-24T21:45:09,Amurrio,expenses,transport,-69.56,-117226.06
buyer_4,Jorge,,1974-05-23,ES23209580590409199953,TRX_N-00953-28957307,2024-03-27T08:15:35,Galdakao,expenses,children,-672.38,-117898.44
buyer_4,Jorge,,1974-05-23,ES23209580590409199953,TRX_N-00954-85635155,2024-03-29T21:46:50,Galdakao,expenses,transport,-70.73,-117969.17
buyer_4,Jorge,,1974-05-23,ES23209580590409199953,TRX_N-00955-58117593,2024-03-29T08:00:16,Galdakao,expenses,cash,-100.0,-118069.17
buyer_4,Jorge,,1974-05-23,ES23209580590409199953,TRX_N-00956-28065372,2024-03-31T12:09:51,Andoain,expenses,food,-89.64,-118158.81
buyer_4,Jorge,,1974-05-23,ES23209580590409199953,TRX_N-00957-65612126,2024-03-31T15:00:27,Labastida,expenses,healthcare,-82.78,-118241.59
buyer_4,Jorge,,1974-05-23,ES23209580590409199953,TRX_N-00958-10753500,2024-04-01T09:27:02,Galdakao,incomes,salary,1740.06,-116501.53
buyer_4,Jorge,,1974-05-23,ES23209580590409199953,TRX_N-00959-07012711,2024-04-01T09:27:02,Galdakao,incomes,extra_income,296.42,-116205.11
buyer_4,Jorge,,1974-05-23,ES23209580590409199953,TRX_N-00960-23736505,2024-04-01T07:12:55,Galdakao,expenses,food,-75.4,-116280.51
buyer_4,Jorge,,1974-05-23,ES23209580590409199953,TRX_N-00961-57430159,2024-04-01T19:54:24,Galdakao,expenses,leisure,-82.0,-116362.51
buyer_4,Jorge,,1974-05-23,ES23209580590409199953,TRX_N-00962-13564354,2024-04-03T10:43:11,Galdakao,expenses,education,-45.45,-116407.96
buyer_4,Jorge,,1974-05-23,ES23209580590409199953,TRX_N-00963-32144484,2024-04-04T11:26:52,Galdakao,expenses,mortgage,-1032.74,-117440.7
buyer_4,Jorge,,1974-05-23,ES23209580590409199953,TRX_N-00964-02980553,2024-04-04T08:36:41,Galdakao,expenses,cash,-100.0,-117540.7
buyer_4,Jorge,,1974-05-23,ES23209580590409199953,TRX_N-00965-03683745,2024-04-05T20:10:13,Galdakao,expenses,phone,-38.75,-117579.45
buyer_4,Jorge,,1974-05-23,ES23209580590409199953,TRX_N-00966-14360287,2024-04-06T09:30:56,Galdakao,expenses,water,-32.82,-117612.27
buyer_4,Jorge,,1974-05-23,ES23209580590409199953,TRX_N-00967-05959076,2024-04-07T08:19:01,Galdakao,expenses,food,-115.93,-117728.2
buyer_4,Jorge,,1974-05-23,ES23209580590409199953,TRX_N-00968-94061896,2024-04-07T20:08:12,Galdakao,expenses,transport,-77.8,-117806.0
buyer_4,Jorge,,1974-05-23,ES23209580590409199953,TRX_N-00969-73300205,2024-04-08T14:47:03,Galdakao,expenses,electricity,-78.24,-117884.24
buyer_4,Jorge,,1974-05-23,ES23209580590409199953,TRX_N-00970-25864401,2024-04-08T00:31:35,Galdakao,expenses,gas,-86.67,-117970.91
buyer_4,Jorge,,1974-05-23,ES23209580590409199953,TRX_N-00971-70709482,2024-04-08T21:59:56,Galdakao,expenses,internet,-42.0,-118012.91
buyer_4,Jorge,,1974-05-23,ES23209580590409199953,TRX_N-00972-86880763,2024-04-09T10:11:39,Galdakao,expenses,clothing,-54.61,-118067.52
buyer_4,Jorge,,1974-05-23,ES23209580590409199953,TRX_N-00973-00176609,2024-04-13T17:57:26,Galdakao,expenses,food,-100.77,-118168.29
buyer_4,Jorge,,1974-05-23,ES23209580590409199953,TRX_N-00974-60086302,2024-04-13T17:22:42,Galdakao,expenses,cash,-100.0,-118268.29
buyer_4,Jorge,,1974-05-23,ES23209580590409199953,TRX_N-00975-24442779,2024-04-14T08:03:25,Galdakao,expenses,leisure,-70.35,-118338.64
buyer_4,Jorge,,1974-05-23,ES23209580590409199953,TRX_N-00976-31137748,2024-04-14T16:08:10,Galdakao,expenses,clothing,-54.79,-118393.43
buyer_4,Jorge,,1974-05-23,ES23209580590409199953,TRX_N-00977-77086038,2024-04-14T17:20:13,Galdakao,expenses,repairs,-198.87,-118592.3
buyer_4,Jorge,,1974-05-23,ES23209580590409199953,TRX_N-00978-08241288,2024-04-17T11:59:21,Mungia,expenses,cash,-100.0,-118692.3
buyer_4,Jorge,,1974-05-23,ES23209580590409199953,TRX_N-00979-59456703,2024-04-17T15:28:15,Galdakao,expenses,appliances,-403.23,-119095.53
buyer_4,Jorge,,1974-05-23,ES23209580590409199953,TRX_N-00980-74094304,2024-04-18T10:07:14,Galdakao,expenses,food,-107.96,-119203.49
buyer_4,Jorge,,1974-05-23,ES23209580590409199953,TRX_N-00981-76520646,2024-04-18T11:02:20,Galdakao,expenses,repairs,-130.77,-119334.26
buyer_4,Jorge,,1974-05-23,ES23209580590409199953,TRX_N-00982-83012929,2024-04-19T14:15:13,Irun,expenses,leisure,-36.66,-119370.92
buyer_4,Jorge,,1974-05-23,ES23209580590409199953,TRX_N-00983-79351705,2024-04-20T10:55:16,Galdakao,expenses,food,-63.0,-119433.92
buyer_4,Jorge,,1974-05-23,ES23209580590409199953,TRX_N-00984-60311400,2024-04-22T09:16:09,Galdakao,expenses,food,-74.1,-119508.02
buyer_4,Jorge,,1974-05-23,ES23209580590409199953,TRX_N-00985-12400553,2024-04-23T09:38:24,Labastida,expenses,cash,-100.0,-119608.02
buyer_4,Jorge,,1974-05-23,ES23209580590409199953,TRX_N-00986-92817905,2024-04-24T05:33:37,Galdakao,expenses,transport,-68.28,-119676.3
buyer_4,Jorge,,1974-05-23,ES23209580590409199953,TRX_N-00987-33632335,2024-04-25T12:03:47,Galdakao,expenses,transport,-79.37,-119755.67
buyer_4,Jorge,,1974-05-23,ES23209580590409199953,TRX_N-00988-72717498,2024-04-25T10:22:53,Galdakao,expenses,appliances,-257.96,-120013.63
buyer_4,Jorge,,1974-05-23,ES23209580590409199953,TRX_N-00989-99816249,2024-04-27T18:30:59,Galdakao,expenses,appliances,-136.24,-120149.87
buyer_4,Jorge,,1974-05-23,ES23209580590409199953,TRX_N-00990-62901009,2024-04-27T14:47:26,Galdakao,expenses,repairs,-179.49,-120329.36
buyer_4,Jorge,,1974-05-23,ES23209580590409199953,TRX_N-00991-08510722,2024-04-27T08:18:40,Galdakao,expenses,gifts,-230.12,-120559.48
buyer_4,Jorge,,1974-05-23,ES23209580590409199953,TRX_N-00992-85396937,2024-04-28T18:01:12,Galdakao,expenses,food,-87.78,-120647.26
buyer_4,Jorge,,1974-05-23,ES23209580590409199953,TRX_N-00993-96726753,2024-04-28T12:08:20,Galdakao,expenses,cash,-100.0,-120747.26
buyer_4,Jorge,,1974-05-23,ES23209580590409199953,TRX_N-00994-00562962,2024-05-01T08:12:37,Galdakao,incomes,salary,1740.06,-119007.2
buyer_4,Jorge,,1974-05-23,ES23209580590409199953,TRX_N-00995-74023547,2024-05-03T21:22:44,Salvatierra/Agurain,expenses,food,-89.97,-119097.17
buyer_4,Jorge,,1974-05-23,ES23209580590409199953,TRX_N-00996-07190289,2024-05-03T06:52:14,Galdakao,expenses,clothing,-55.83,-119153.0
buyer_4,Jorge,,1974-05-23,ES23209580590409199953,TRX_N-00997-39415573,2024-05-04T12:14:29,Galdakao,expenses,mortgage,-1032.74,-120185.74
buyer_4,Jorge,,1974-05-23,ES23209580590409199953,TRX_N-00998-72311697,2024-05-05T10:49:15,Galdakao,expenses,electricity,-39.83,-120225.57
buyer_4,Jorge,,1974-05-23,ES23209580590409199953,TRX_N-00999-21620286,2024-05-05T18:13:35,Hondarribia,expenses,appliances,-412.56,-120638.13
buyer_4,Jorge,,1974-05-23,ES23209580590409199953,TRX_N-01000-92230361,2024-05-05T10:10:53,Galdakao,expenses,children,-920.21,-121558.34
buyer_4,Jorge,,1974-05-23,ES23209580590409199953,TRX_N-01001-67227661,2024-05-06T01:47:18,Galdakao,expenses,gas,-42.66,-121601.0
buyer_4,Jorge,,1974-05-23,ES23209580590409199953,TRX_N-01002-39472429,2024-05-06T05:43:37,Galdakao,expenses,leisure,-48.54,-121649.54
buyer_4,Jorge,,1974-05-23,ES23209580590409199953,TRX_N-01003-85015669,2024-05-06T20:19:20,Hernani,expenses,cash,-100.0,-121749.54
buyer_4,Jorge,,1974-05-23,ES23209580590409199953,TRX_N-01004-41712159,2024-05-07T23:49:54,Galdakao,expenses,phone,-34.41,-121783.95
buyer_4,Jorge,,1974-05-23,ES23209580590409199953,TRX_N-01005-42747171,2024-05-07T20:55:18,Galdakao,expenses,repairs,-78.1,-121862.05
buyer_4,Jorge,,1974-05-23,ES23209580590409199953,TRX_N-01006-74874994,2024-05-08T16:28:01,Galdakao,expenses,water,-20.32,-121882.37
buyer_4,Jorge,,1974-05-23,ES23209580590409199953,TRX_N-01007-97592336,2024-05-08T22:09:29,Galdakao,expenses,internet,-42.0,-121924.37
buyer_4,Jorge,,1974-05-23,ES23209580590409199953,TRX_N-01008-36591999,2024-05-08T16:22:09,Galdakao,expenses,cash,-100.0,-122024.37
buyer_4,Jorge,,1974-05-23,ES23209580590409199953,TRX_N-01009-26362923,2024-05-11T09:40:04,Galdakao,expenses,transport,-49.06,-122073.43
buyer_4,Jorge,,1974-05-23,ES23209580590409199953,TRX_N-01010-72075729,2024-05-11T11:07:40,Galdakao,expenses,cash,-100.0,-122173.43
buyer_4,Jorge,,1974-05-23,ES23209580590409199953,TRX_N-01011-18419807,2024-05-13T13:48:09,Galdakao,expenses,food,-60.33,-122233.76
buyer_4,Jorge,,1974-05-23,ES23209580590409199953,TRX_N-01012-39236684,2024-05-13T17:20:24,Galdakao,expenses,leisure,-66.0,-122299.76
buyer_4,Jorge,,1974-05-23,ES23209580590409199953,TRX_N-01013-43564423,2024-05-14T16:26:42,Galdakao,expenses,leisure,-73.91,-122373.67
buyer_4,Jorge,,1974-05-23,ES23209580590409199953,TRX_N-01014-95445042,2024-05-14T20:32:50,Galdakao,expenses,healthcare,-52.06,-122425.73
buyer_4,Jorge,,1974-05-23,ES23209580590409199953,TRX_N-01015-84225679,2024-05-15T08:56:35,Galdakao,expenses,leisure,-34.32,-122460.05
buyer_4,Jorge,,1974-05-23,ES23209580590409199953,TRX_N-01016-64559316,2024-05-15T11:15:07,Galdakao,expenses,repairs,-74.64,-122534.69
buyer_4,Jorge,,1974-05-23,ES23209580590409199953,TRX_N-01017-44665012,2024-05-16T16:22:46,Galdakao,expenses,transport,-71.72,-122606.41
buyer_4,Jorge,,1974-05-23,ES23209580590409199953,TRX_N-01018-26277023,2024-05-17T19:46:08,Galdakao,expenses,food,-97.49,-122703.9
buyer_4,Jorge,,1974-05-23,ES23209580590409199953,TRX_N-01019-63297907,2024-05-17T19:55:09,Galdakao,expenses,cash,-100.0,-122803.9
buyer_4,Jorge,,1974-05-23,ES23209580590409199953,TRX_N-01020-01683639,2024-05-18T10:50:11,Galdakao,expenses,food,-109.39,-122913.29
buyer_4,Jorge,,1974-05-23,ES23209580590409199953,TRX_N-01021-91550175,2024-05-19T13:38:12,Galdakao,expenses,clothing,-76.59,-122989.88
buyer_4,Jorge,,1974-05-23,ES23209580590409199953,TRX_N-01022-52103492,2024-05-19T15:43:22,Galdakao,expenses,cash,-100.0,-123089.88
buyer_4,Jorge,,1974-05-23,ES23209580590409199953,TRX_N-01023-27173699,2024-05-20T17:15:26,Galdakao,expenses,cash,-100.0,-123189.88
buyer_4,Jorge,,1974-05-23,ES23209580590409199953,TRX_N-01024-11593488,2024-05-21T12:09:20,Galdakao,expenses,cash,-100.0,-123289.88
buyer_4,Jorge,,1974-05-23,ES23209580590409199953,TRX_N-01025-94760529,2024-05-22T21:04:44,Sopela,expenses,transport,-59.1,-123348.98
buyer_4,Jorge,,1974-05-23,ES23209580590409199953,TRX_N-01026-22699356,2024-05-23T12:24:42,Galdakao,expenses,leisure,-46.3,-123395.28
buyer_4,Jorge,,1974-05-23,ES23209580590409199953,TRX_N-01027-86176833,2024-05-25T05:24:12,Galdakao,expenses,transport,-71.19,-123466.47
buyer_4,Jorge,,1974-05-23,ES23209580590409199953,TRX_N-01028-79588201,2024-05-26T14:14:01,Galdakao,expenses,repairs,-262.95,-123729.42
buyer_4,Jorge,,1974-05-23,ES23209580590409199953,TRX_N-01029-06720729,2024-05-28T17:44:14,Galdakao,expenses,leisure,-25.52,-123754.94
buyer_4,Jorge,,1974-05-23,ES23209580590409199953,TRX_N-01030-51247139,2024-05-29T12:14:57,Galdakao,expenses,cash,-100.0,-123854.94
buyer_4,Jorge,,1974-05-23,ES23209580590409199953,TRX_N-01031-02682072,2024-06-01T10:40:34,Galdakao,incomes,salary,1740.06,-122114.88
buyer_4,Jorge,,1974-05-23,ES23209580590409199953,TRX_N-01032-92899540,2024-06-01T10:40:34,Galdakao,incomes,salary_bonus,1373.69,-120741.19
buyer_4,Jorge,,1974-05-23,ES23209580590409199953,TRX_N-01033-60733402,2024-06-02T19:21:49,Andoain,expenses,transport,-84.33,-120825.52
buyer_4,Jorge,,1974-05-23,ES23209580590409199953,TRX_N-01034-07874335,2024-06-04T00:52:26,Galdakao,expenses,mortgage,-1032.74,-121858.26
buyer_4,Jorge,,1974-05-23,ES23209580590409199953,TRX_N-01035-34171511,2024-06-05T19:47:34,Arrasate,expenses,travel,-1093.7,-122951.96
buyer_4,Jorge,,1974-05-23,ES23209580590409199953,TRX_N-01036-71470996,2024-06-06T15:44:00,Galdakao,expenses,water,-38.93,-122990.89
buyer_4,Jorge,,1974-05-23,ES23209580590409199953,TRX_N-01037-20309224,2024-06-06T13:17:00,Galdakao,expenses,internet,-42.0,-123032.89
buyer_4,Jorge,,1974-05-23,ES23209580590409199953,TRX_N-01038-07515478,2024-06-07T01:47:39,Galdakao,expenses,gas,-88.17,-123121.06
buyer_4,Jorge,,1974-05-23,ES23209580590409199953,TRX_N-01039-74661844,2024-06-07T14:39:39,Galdakao,expenses,clothing,-88.8,-123209.86
buyer_4,Jorge,,1974-05-23,ES23209580590409199953,TRX_N-01040-68671692,2024-06-08T10:16:31,Galdakao,expenses,electricity,-63.46,-123273.32
buyer_4,Jorge,,1974-05-23,ES23209580590409199953,TRX_N-01041-13758495,2024-06-08T12:34:39,Galdakao,expenses,phone,-39.56,-123312.88
buyer_4,Jorge,,1974-05-23,ES23209580590409199953,TRX_N-01042-06120443,2024-06-09T14:44:20,Galdakao,expenses,leisure,-76.9,-123389.78
buyer_4,Jorge,,1974-05-23,ES23209580590409199953,TRX_N-01043-03167717,2024-06-09T11:10:43,Galdakao,expenses,healthcare,-133.26,-123523.04
buyer_4,Jorge,,1974-05-23,ES23209580590409199953,TRX_N-01044-59493686,2024-06-10T19:10:04,Galdakao,expenses,appliances,-397.05,-123920.09
buyer_4,Jorge,,1974-05-23,ES23209580590409199953,TRX_N-01045-68996398,2024-06-11T11:47:51,Galdakao,expenses,food,-79.52,-123999.61
buyer_4,Jorge,,1974-05-23,ES23209580590409199953,TRX_N-01046-70662737,2024-06-11T08:48:37,Galdakao,expenses,appliances,-157.83,-124157.44
buyer_4,Jorge,,1974-05-23,ES23209580590409199953,TRX_N-01047-48277666,2024-06-12T04:50:05,Galdakao,expenses,cash,-100.0,-124257.44
buyer_4,Jorge,,1974-05-23,ES23209580590409199953,TRX_N-01048-85656445,2024-06-13T20:59:29,Lasarte-Oria,expenses,food,-70.3,-124327.74
buyer_4,Jorge,,1974-05-23,ES23209580590409199953,TRX_N-01049-70661687,2024-06-13T03:20:59,Galdakao,expenses,cash,-100.0,-124427.74
buyer_4,Jorge,,1974-05-23,ES23209580590409199953,TRX_N-01050-16221715,2024-06-15T23:08:07,Berango,expenses,leisure,-41.57,-124469.31
buyer_4,Jorge,,1974-05-23,ES23209580590409199953,TRX_N-01051-21708161,2024-06-17T17:49:56,Andoain,expenses,cash,-100.0,-124569.31
buyer_4,Jorge,,1974-05-23,ES23209580590409199953,TRX_N-01052-19297863,2024-06-17T09:05:24,Galdakao,expenses,travel,-928.58,-125497.89
buyer_4,Jorge,,1974-05-23,ES23209580590409199953,TRX_N-01053-66185008,2024-06-17T20:31:35,Galdakao,expenses,appliances,-85.93,-125583.82
buyer_4,Jorge,,1974-05-23,ES23209580590409199953,TRX_N-01054-16241986,2024-06-19T14:08:39,Galdakao,expenses,transport,-88.59,-125672.41
buyer_4,Jorge,,1974-05-23,ES23209580590409199953,TRX_N-01055-01265978,2024-06-20T09:40:52,Galdakao,expenses,leisure,-27.15,-125699.56
buyer_4,Jorge,,1974-05-23,ES23209580590409199953,TRX_N-01056-36790661,2024-06-20T09:14:12,Galdakao,expenses,repairs,-49.45,-125749.01
buyer_4,Jorge,,1974-05-23,ES23209580590409199953,TRX_N-01057-28285959,2024-06-22T16:46:32,Galdakao,expenses,appliances,-197.51,-125946.52
buyer_4,Jorge,,1974-05-23,ES23209580590409199953,TRX_N-01058-32021941,2024-06-23T08:07:33,Galdakao,expenses,children,-786.86,-126733.38
buyer_4,Jorge,,1974-05-23,ES23209580590409199953,TRX_N-01059-53268789,2024-06-26T07:26:43,Galdakao,expenses,food,-84.43,-126817.81
buyer_4,Jorge,,1974-05-23,ES23209580590409199953,TRX_N-01060-78791925,2024-06-26T10:13:17,Galdakao,expenses,leisure,-36.55,-126854.36
buyer_4,Jorge,,1974-05-23,ES23209580590409199953,TRX_N-01061-13835010,2024-06-26T09:14:54,Galdakao,expenses,cash,-100.0,-126954.36
buyer_4,Jorge,,1974-05-23,ES23209580590409199953,TRX_N-01062-21355756,2024-06-27T14:50:54,Galdakao,expenses,education,-48.62,-127002.98
buyer_4,Jorge,,1974-05-23,ES23209580590409199953,TRX_N-01063-21078291,2024-06-29T15:36:27,Galdakao,expenses,travel,-1644.7,-128647.68
buyer_4,Jorge,,1974-05-23,ES23209580590409199953,TRX_N-01064-35548577,2024-07-01T14:21:10,Galdakao,incomes,salary,1740.06,-126907.62
buyer_4,Jorge,,1974-05-23,ES23209580590409199953,TRX_N-01065-83526117,2024-07-01T15:46:32,Galdakao,expenses,food,-114.11,-127021.73
buyer_4,Jorge,,1974-05-23,ES23209580590409199953,TRX_N-01066-23478409,2024-07-01T17:30:37,Galdakao,expenses,cash,-100.0,-127121.73
buyer_4,Jorge,,1974-05-23,ES23209580590409199953,TRX_N-01067-94934632,2024-07-04T14:14:50,Galdakao,expenses,mortgage,-1032.74,-128154.47
buyer_4,Jorge,,1974-05-23,ES23209580590409199953,TRX_N-01068-59437738,2024-07-04T15:31:06,Galdakao,expenses,leisure,-80.34,-128234.81
buyer_4,Jorge,,1974-05-23,ES23209580590409199953,TRX_N-01069-64919499,2024-07-05T17:45:23,Galdakao,expenses,water,-39.36,-128274.17
buyer_4,Jorge,,1974-05-23,ES23209580590409199953,TRX_N-01070-85925252,2024-07-05T17:13:43,Galdakao,expenses,gas,-98.08,-128372.25
buyer_4,Jorge,,1974-05-23,ES23209580590409199953,TRX_N-01071-92748637,2024-07-05T07:46:33,Galdakao,expenses,internet,-42.0,-128414.25
buyer_4,Jorge,,1974-05-23,ES23209580590409199953,TRX_N-01072-29629101,2024-07-05T09:45:38,Galdakao,expenses,cash,-100.0,-128514.25
buyer_4,Jorge,,1974-05-23,ES23209580590409199953,TRX_N-01073-01805775,2024-07-06T17:58:30,Galdakao,expenses,phone,-42.26,-128556.51
buyer_4,Jorge,,1974-05-23,ES23209580590409199953,TRX_N-01074-04170455,2024-07-07T10:28:59,Galdakao,expenses,electricity,-36.81,-128593.32
buyer_4,Jorge,,1974-05-23,ES23209580590409199953,TRX_N-01075-96549858,2024-07-07T00:57:32,Galdakao,expenses,clothing,-58.3,-128651.62
buyer_4,Jorge,,1974-05-23,ES23209580590409199953,TRX_N-01076-66515803,2024-07-09T09:30:24,Galdakao,expenses,transport,-81.0,-128732.62
buyer_4,Jorge,,1974-05-23,ES23209580590409199953,TRX_N-01077-30082431,2024-07-10T14:57:40,Galdakao,expenses,repairs,-87.0,-128819.62
buyer_4,Jorge,,1974-05-23,ES23209580590409199953,TRX_N-01078-00832055,2024-07-13T12:58:22,Galdakao,expenses,leisure,-67.9,-128887.52
buyer_4,Jorge,,1974-05-23,ES23209580590409199953,TRX_N-01079-13961080,2024-07-13T22:23:31,Galdakao,expenses,clothing,-57.55,-128945.07
buyer_4,Jorge,,1974-05-23,ES23209580590409199953,TRX_N-01080-03816750,2024-07-14T15:42:00,Galdakao,expenses,food,-73.03,-129018.1
buyer_4,Jorge,,1974-05-23,ES23209580590409199953,TRX_N-01081-98118012,2024-07-14T04:08:08,Galdakao,expenses,cash,-100.0,-129118.1
buyer_4,Jorge,,1974-05-23,ES23209580590409199953,TRX_N-01082-77951212,2024-07-15T16:22:57,Berango,expenses,clothing,-119.33,-129237.43
buyer_4,Jorge,,1974-05-23,ES23209580590409199953,TRX_N-01083-52666778,2024-07-17T14:13:26,Oy√≥n-Oion,expenses,cash,-100.0,-129337.43
buyer_4,Jorge,,1974-05-23,ES23209580590409199953,TRX_N-01084-88052576,2024-07-18T16:03:56,Galdakao,expenses,cash,-100.0,-129437.43
buyer_4,Jorge,,1974-05-23,ES23209580590409199953,TRX_N-01085-78440121,2024-07-19T20:40:00,Galdakao,expenses,food,-87.72,-129525.15
buyer_4,Jorge,,1974-05-23,ES23209580590409199953,TRX_N-01086-94976885,2024-07-19T19:13:14,Galdakao,expenses,transport,-42.55,-129567.7
buyer_4,Jorge,,1974-05-23,ES23209580590409199953,TRX_N-01087-99318571,2024-07-19T17:50:45,Galdakao,expenses,education,-65.08,-129632.78
buyer_4,Jorge,,1974-05-23,ES23209580590409199953,TRX_N-01088-73756786,2024-07-20T14:53:31,Galdakao,expenses,gifts,-176.73,-129809.51
buyer_4,Jorge,,1974-05-23,ES23209580590409199953,TRX_N-01089-09866407,2024-07-21T18:29:01,Amurrio,expenses,food,-63.21,-129872.72
buyer_4,Jorge,,1974-05-23,ES23209580590409199953,TRX_N-01090-05899380,2024-07-21T11:50:48,Mungia,expenses,cash,-100.0,-129972.72
buyer_4,Jorge,,1974-05-23,ES23209580590409199953,TRX_N-01091-31044864,2024-07-22T01:39:18,Galdakao,expenses,food,-71.81,-130044.53
buyer_4,Jorge,,1974-05-23,ES23209580590409199953,TRX_N-01092-60441577,2024-07-22T18:31:59,Zuia,expenses,transport,-48.26,-130092.79
buyer_4,Jorge,,1974-05-23,ES23209580590409199953,TRX_N-01093-88601591,2024-07-22T12:29:13,Galdakao,expenses,cash,-100.0,-130192.79
buyer_4,Jorge,,1974-05-23,ES23209580590409199953,TRX_N-01094-28535832,2024-07-23T10:01:03,Galdakao,expenses,repairs,-262.53,-130455.32
buyer_4,Jorge,,1974-05-23,ES23209580590409199953,TRX_N-01095-87181971,2024-07-24T12:57:05,Galdakao,expenses,gifts,-137.15,-130592.47
buyer_4,Jorge,,1974-05-23,ES23209580590409199953,TRX_N-01096-30909783,2024-07-25T04:58:57,Galdakao,expenses,leisure,-82.27,-130674.74
buyer_4,Jorge,,1974-05-23,ES23209580590409199953,TRX_N-01097-60680238,2024-07-26T14:38:54,Galdakao,expenses,cash,-100.0,-130774.74
buyer_4,Jorge,,1974-05-23,ES23209580590409199953,TRX_N-01098-27323796,2024-08-01T09:14:20,Galdakao,incomes,salary,1740.06,-129034.68
buyer_4,Jorge,,1974-05-23,ES23209580590409199953,TRX_N-01099-61327697,2024-08-01T09:14:20,Galdakao,incomes,extra_income,296.42,-128738.26
buyer_4,Jorge,,1974-05-23,ES23209580590409199953,TRX_N-01100-50647658,2024-08-01T09:43:08,Galdakao,expenses,leisure,-28.2,-128766.46
buyer_4,Jorge,,1974-05-23,ES23209580590409199953,TRX_N-01101-67800802,2024-08-03T21:49:35,Galdakao,expenses,healthcare,-176.31,-128942.77
buyer_4,Jorge,,1974-05-23,ES23209580590409199953,TRX_N-01102-87647526,2024-08-04T20:23:01,Galdakao,expenses,mortgage,-1032.74,-129975.51
buyer_4,Jorge,,1974-05-23,ES23209580590409199953,TRX_N-01103-54474074,2024-08-05T20:15:56,Galdakao,expenses,water,-30.61,-130006.12
buyer_4,Jorge,,1974-05-23,ES23209580590409199953,TRX_N-01104-50492089,2024-08-05T00:57:40,Galdakao,expenses,internet,-42.0,-130048.12
buyer_4,Jorge,,1974-05-23,ES23209580590409199953,TRX_N-01105-19038752,2024-08-05T14:19:06,Galdakao,expenses,food,-116.61,-130164.73
buyer_4,Jorge,,1974-05-23,ES23209580590409199953,TRX_N-01106-94015223,2024-08-05T00:15:51,Galdakao,expenses,gifts,-668.19,-130832.92
buyer_4,Jorge,,1974-05-23,ES23209580590409199953,TRX_N-01107-02974707,2024-08-06T09:36:07,Bermeo,expenses,transport,-69.3,-130902.22
buyer_4,Jorge,,1974-05-23,ES23209580590409199953,TRX_N-01108-34537603,2024-08-07T08:50:10,Galdakao,expenses,transport,-80.47,-130982.69
buyer_4,Jorge,,1974-05-23,ES23209580590409199953,TRX_N-01109-40691206,2024-08-08T17:36:37,Galdakao,expenses,gas,-48.81,-131031.5
buyer_4,Jorge,,1974-05-23,ES23209580590409199953,TRX_N-01110-94409307,2024-08-08T15:09:15,Galdakao,expenses,phone,-30.95,-131062.45
buyer_4,Jorge,,1974-05-23,ES23209580590409199953,TRX_N-01111-02165675,2024-08-08T13:25:19,Galdakao,expenses,electricity,-84.6,-131147.05
buyer_4,Jorge,,1974-05-23,ES23209580590409199953,TRX_N-01112-33386311,2024-08-08T09:16:30,Galdakao,expenses,food,-97.29,-131244.34
buyer_4,Jorge,,1974-05-23,ES23209580590409199953,TRX_N-01113-75236934,2024-08-08T07:26:53,Donostia,expenses,leisure,-24.93,-131269.27
buyer_4,Jorge,,1974-05-23,ES23209580590409199953,TRX_N-01114-06245686,2024-08-12T11:37:10,Donostia,expenses,healthcare,-41.29,-131310.56
buyer_4,Jorge,,1974-05-23,ES23209580590409199953,TRX_N-01115-83461751,2024-08-13T17:16:44,Donostia,expenses,appliances,-157.28,-131467.84
buyer_4,Jorge,,1974-05-23,ES23209580590409199953,TRX_N-01116-39803855,2024-08-17T08:52:46,Mungia,expenses,leisure,-40.82,-131508.66
buyer_4,Jorge,,1974-05-23,ES23209580590409199953,TRX_N-01117-47219866,2024-08-17T11:51:54,Galdakao,expenses,cash,-100.0,-131608.66
buyer_4,Jorge,,1974-05-23,ES23209580590409199953,TRX_N-01118-22831471,2024-08-20T08:01:43,Galdakao,expenses,food,-112.86,-131721.52
buyer_4,Jorge,,1974-05-23,ES23209580590409199953,TRX_N-01119-50326992,2024-08-20T14:18:25,Galdakao,expenses,travel,-718.85,-132440.37
buyer_4,Jorge,,1974-05-23,ES23209580590409199953,TRX_N-01120-90209162,2024-08-22T15:14:04,Salvatierra/Agurain,expenses,food,-110.26,-132550.63
buyer_4,Jorge,,1974-05-23,ES23209580590409199953,TRX_N-01121-73670156,2024-08-22T20:17:38,Galdakao,expenses,clothing,-76.33,-132626.96
buyer_4,Jorge,,1974-05-23,ES23209580590409199953,TRX_N-01122-75170431,2024-08-25T15:38:16,Galdakao,expenses,cash,-100.0,-132726.96
buyer_4,Jorge,,1974-05-23,ES23209580590409199953,TRX_N-01123-51516878,2024-08-26T13:54:07,Galdakao,expenses,cash,-100.0,-132826.96
buyer_4,Jorge,,1974-05-23,ES23209580590409199953,TRX_N-01124-17495256,2024-08-27T16:54:59,Galdakao,expenses,cash,-100.0,-132926.96
buyer_4,Jorge,,1974-05-23,ES23209580590409199953,TRX_N-01125-84496686,2024-08-28T13:30:31,Basauri,expenses,transport,-84.06,-133011.02
buyer_4,Jorge,,1974-05-23,ES23209580590409199953,TRX_N-01126-89312677,2024-08-28T17:28:00,Galdakao,expenses,cash,-100.0,-133111.02
buyer_4,Jorge,,1974-05-23,ES23209580590409199953,TRX_N-01127-63579535,2024-08-29T05:29:11,Galdakao,expenses,food,-119.71,-133230.73
buyer_4,Jorge,,1974-05-23,ES23209580590409199953,TRX_N-01128-48818327,2024-08-29T09:32:55,Galdakao,expenses,cash,-100.0,-133330.73
buyer_4,Jorge,,1974-05-23,ES23209580590409199953,TRX_N-01129-23865678,2024-08-30T23:46:16,Galdakao,expenses,food,-66.42,-133397.15
buyer_4,Jorge,,1974-05-23,ES23209580590409199953,TRX_N-01130-69230713,2024-09-01T12:31:56,Galdakao,incomes,salary,1740.06,-131657.09
buyer_4,Jorge,,1974-05-23,ES23209580590409199953,TRX_N-01131-69856148,2024-09-03T18:17:00,Galdakao,expenses,clothing,-148.62,-131805.71
buyer_4,Jorge,,1974-05-23,ES23209580590409199953,TRX_N-01132-07268923,2024-09-03T22:39:14,Galdakao,expenses,healthcare,-41.1,-131846.81
buyer_4,Jorge,,1974-05-23,ES23209580590409199953,TRX_N-01133-63211001,2024-09-04T08:21:48,Galdakao,expenses,mortgage,-1032.74,-132879.55
buyer_4,Jorge,,1974-05-23,ES23209580590409199953,TRX_N-01134-85336675,2024-09-05T14:17:47,Galdakao,expenses,internet,-42.0,-132921.55
buyer_4,Jorge,,1974-05-23,ES23209580590409199953,TRX_N-01135-53872178,2024-09-05T11:39:22,Amurrio,expenses,food,-102.89,-133024.44
buyer_4,Jorge,,1974-05-23,ES23209580590409199953,TRX_N-01136-90632730,2024-09-05T09:10:01,Galdakao,expenses,leisure,-25.76,-133050.2
buyer_4,Jorge,,1974-05-23,ES23209580590409199953,TRX_N-01137-79738186,2024-09-07T08:16:40,Galdakao,expenses,water,-39.65,-133089.85
buyer_4,Jorge,,1974-05-23,ES23209580590409199953,TRX_N-01138-92095738,2024-09-07T17:21:50,Galdakao,expenses,phone,-37.37,-133127.22
buyer_4,Jorge,,1974-05-23,ES23209580590409199953,TRX_N-01139-65972410,2024-09-08T08:56:37,Galdakao,expenses,electricity,-78.43,-133205.65
buyer_4,Jorge,,1974-05-23,ES23209580590409199953,TRX_N-01140-99429328,2024-09-08T18:10:30,Galdakao,expenses,gas,-91.69,-133297.34
buyer_4,Jorge,,1974-05-23,ES23209580590409199953,TRX_N-01141-66625799,2024-09-08T16:16:25,Galdakao,expenses,transport,-50.06,-133347.4
buyer_4,Jorge,,1974-05-23,ES23209580590409199953,TRX_N-01142-10775837,2024-09-09T16:00:41,Galdakao,expenses,food,-72.22,-133419.62
buyer_4,Jorge,,1974-05-23,ES23209580590409199953,TRX_N-01143-87891014,2024-09-10T17:07:43,Galdakao,expenses,cash,-100.0,-133519.62
buyer_4,Jorge,,1974-05-23,ES23209580590409199953,TRX_N-01144-18644114,2024-09-11T20:56:32,Galdakao,expenses,food,-109.15,-133628.77
buyer_4,Jorge,,1974-05-23,ES23209580590409199953,TRX_N-01145-26563490,2024-09-11T11:12:31,Galdakao,expenses,transport,-42.97,-133671.74
buyer_4,Jorge,,1974-05-23,ES23209580590409199953,TRX_N-01146-66830885,2024-09-11T15:18:14,Galdakao,expenses,clothing,-124.33,-133796.07
buyer_4,Jorge,,1974-05-23,ES23209580590409199953,TRX_N-01147-78703816,2024-09-11T16:09:52,Galdakao,expenses,cash,-100.0,-133896.07
buyer_4,Jorge,,1974-05-23,ES23209580590409199953,TRX_N-01148-03260182,2024-09-11T17:05:04,Galdakao,expenses,children,-563.09,-134459.16
buyer_4,Jorge,,1974-05-23,ES23209580590409199953,TRX_N-01149-41494427,2024-09-12T11:04:16,Galdakao,expenses,gifts,-172.82,-134631.98
buyer_4,Jorge,,1974-05-23,ES23209580590409199953,TRX_N-01150-25453057,2024-09-13T18:13:28,Galdakao,expenses,transport,-64.2,-134696.18
buyer_4,Jorge,,1974-05-23,ES23209580590409199953,TRX_N-01151-77219257,2024-09-13T12:25:14,Galdakao,expenses,education,-72.71,-134768.89
buyer_4,Jorge,,1974-05-23,ES23209580590409199953,TRX_N-01152-88736321,2024-09-13T06:23:31,Hondarribia,expenses,repairs,-280.01,-135048.9
buyer_4,Jorge,,1974-05-23,ES23209580590409199953,TRX_N-01153-04750286,2024-09-15T18:59:51,Galdakao,expenses,repairs,-237.77,-135286.67
buyer_4,Jorge,,1974-05-23,ES23209580590409199953,TRX_N-01154-24003101,2024-09-16T10:17:16,Galdakao,expenses,cash,-100.0,-135386.67
buyer_4,Jorge,,1974-05-23,ES23209580590409199953,TRX_N-01155-79917075,2024-09-16T15:57:39,Galdakao,expenses,repairs,-189.17,-135575.84
buyer_4,Jorge,,1974-05-23,ES23209580590409199953,TRX_N-01156-06612919,2024-09-17T14:02:44,Galdakao,expenses,food,-86.49,-135662.33
buyer_4,Jorge,,1974-05-23,ES23209580590409199953,TRX_N-01157-38618366,2024-09-18T23:29:21,Galdakao,expenses,cash,-100.0,-135762.33
buyer_4,Jorge,,1974-05-23,ES23209580590409199953,TRX_N-01158-43919653,2024-09-20T22:23:13,Galdakao,expenses,cash,-100.0,-135862.33
buyer_4,Jorge,,1974-05-23,ES23209580590409199953,TRX_N-01159-65569995,2024-09-20T10:37:30,Galdakao,expenses,children,-797.9,-136660.23
buyer_4,Jorge,,1974-05-23,ES23209580590409199953,TRX_N-01160-65792598,2024-09-22T13:43:13,Galdakao,expenses,cash,-100.0,-136760.23
buyer_4,Jorge,,1974-05-23,ES23209580590409199953,TRX_N-01161-97807338,2024-09-23T12:00:44,Galdakao,expenses,food,-93.76,-136853.99
buyer_4,Jorge,,1974-05-23,ES23209580590409199953,TRX_N-01162-97711226,2024-09-23T14:30:18,Oy√≥n-Oion,expenses,cash,-100.0,-136953.99
buyer_4,Jorge,,1974-05-23,ES23209580590409199953,TRX_N-01163-91927082,2024-09-27T13:02:37,Galdakao,expenses,leisure,-48.26,-137002.25
buyer_4,Jorge,,1974-05-23,ES23209580590409199953,TRX_N-01164-16625673,2024-09-28T09:59:51,Galdakao,expenses,leisure,-26.74,-137028.99
buyer_4,Jorge,,1974-05-23,ES23209580590409199953,TRX_N-01165-79633079,2024-09-28T10:37:56,Galdakao,expenses,clothing,-107.93,-137136.92
buyer_4,Jorge,,1974-05-23,ES23209580590409199953,TRX_N-01166-43585939,2024-09-28T10:42:42,Galdakao,expenses,cash,-100.0,-137236.92
buyer_4,Jorge,,1974-05-23,ES23209580590409199953,TRX_N-01167-44608739,2024-09-29T18:03:54,Galdakao,expenses,appliances,-91.29,-137328.21
buyer_4,Jorge,,1974-05-23,ES23209580590409199953,TRX_N-01168-92456787,2024-10-01T14:55:27,Galdakao,incomes,salary,1740.06,-135588.15
buyer_4,Jorge,,1974-05-23,ES23209580590409199953,TRX_N-01169-09367465,2024-10-03T17:37:31,Berango,expenses,leisure,-79.14,-135667.29
buyer_4,Jorge,,1974-05-23,ES23209580590409199953,TRX_N-01170-49693203,2024-10-03T15:41:36,Errenteria,expenses,cash,-100.0,-135767.29
buyer_4,Jorge,,1974-05-23,ES23209580590409199953,TRX_N-01171-30845072,2024-10-04T09:00:47,Galdakao,expenses,mortgage,-1032.74,-136800.03
buyer_4,Jorge,,1974-05-23,ES23209580590409199953,TRX_N-01172-25006308,2024-10-04T23:20:19,Galdakao,expenses,gifts,-341.1,-137141.13
buyer_4,Jorge,,1974-05-23,ES23209580590409199953,TRX_N-01173-60201033,2024-10-05T14:58:34,Galdakao,expenses,water,-40.18,-137181.31
buyer_4,Jorge,,1974-05-23,ES23209580590409199953,TRX_N-01174-73876415,2024-10-05T13:29:22,Galdakao,expenses,electricity,-50.19,-137231.5
buyer_4,Jorge,,1974-05-23,ES23209580590409199953,TRX_N-01175-28284154,2024-10-05T19:07:48,Galdakao,expenses,phone,-32.28,-137263.78
buyer_4,Jorge,,1974-05-23,ES23209580590409199953,TRX_N-01176-20439759,2024-10-05T11:35:01,Vitoria-Gasteiz,expenses,repairs,-184.02,-137447.8
buyer_4,Jorge,,1974-05-23,ES23209580590409199953,TRX_N-01177-89508966,2024-10-06T12:17:21,Galdakao,expenses,gas,-69.56,-137517.36
buyer_4,Jorge,,1974-05-23,ES23209580590409199953,TRX_N-01178-34131777,2024-10-06T17:34:15,Galdakao,expenses,internet,-42.0,-137559.36
buyer_4,Jorge,,1974-05-23,ES23209580590409199953,TRX_N-01179-27029509,2024-10-06T11:09:32,Labastida,expenses,transport,-65.09,-137624.45
buyer_4,Jorge,,1974-05-23,ES23209580590409199953,TRX_N-01180-63432343,2024-10-07T10:29:20,Galdakao,expenses,leisure,-21.22,-137645.67
buyer_4,Jorge,,1974-05-23,ES23209580590409199953,TRX_N-01181-83047846,2024-10-07T13:29:51,Galdakao,expenses,cash,-100.0,-137745.67
buyer_4,Jorge,,1974-05-23,ES23209580590409199953,TRX_N-01182-22752169,2024-10-08T19:55:43,Bermeo,expenses,cash,-100.0,-137845.67
buyer_4,Jorge,,1974-05-23,ES23209580590409199953,TRX_N-01183-37858334,2024-10-09T19:14:58,Bermeo,expenses,transport,-46.15,-137891.82
buyer_5,Sara,,1994-03-12,ES75209517551006251525,TRX_N-00001-78137040,2022-01-01T12:58:06,Donostia,incomes,salary,2342.59,4036.69
buyer_5,Sara,,1994-03-12,ES75209517551006251525,TRX_N-00002-49355329,2022-01-01T12:58:06,Donostia,incomes,salary_partner,2567.69,6604.38
buyer_5,Sara,,1994-03-12,ES75209517551006251525,TRX_N-00003-49612208,2022-01-02T11:05:35,Donostia,expenses,transport,-65.59,6538.79
buyer_5,Sara,,1994-03-12,ES75209517551006251525,TRX_N-00004-92467231,2022-01-04T10:57:02,Donostia,expenses,mortgage,-754.18,5784.61
buyer_5,Sara,,1994-03-12,ES75209517551006251525,TRX_N-00005-09500082,2022-01-05T12:35:11,Donostia,expenses,internet,-42.0,5742.61
buyer_5,Sara,,1994-03-12,ES75209517551006251525,TRX_N-00006-56683292,2022-01-05T16:01:51,Donostia,expenses,education,-63.7,5678.91
buyer_5,Sara,,1994-03-12,ES75209517551006251525,TRX_N-00007-21297129,2022-01-06T12:36:06,Donostia,expenses,water,-30.16,5648.75
buyer_5,Sara,,1994-03-12,ES75209517551006251525,TRX_N-00008-10496533,2022-01-07T12:40:27,Donostia,expenses,food,-94.46,5554.29
buyer_5,Sara,,1994-03-12,ES75209517551006251525,TRX_N-00009-36033689,2022-01-08T17:51:57,Donostia,expenses,electricity,-82.96,5471.33
buyer_5,Sara,,1994-03-12,ES75209517551006251525,TRX_N-00010-35870772,2022-01-08T15:57:38,Donostia,expenses,gas,-95.24,5376.09
buyer_5,Sara,,1994-03-12,ES75209517551006251525,TRX_N-00011-89216976,2022-01-08T14:55:06,Donostia,expenses,phone,-31.49,5344.6
buyer_5,Sara,,1994-03-12,ES75209517551006251525,TRX_N-00012-82884320,2022-01-08T10:29:26,Donostia,expenses,cash,-100.0,5244.6
buyer_5,Sara,,1994-03-12,ES75209517551006251525,TRX_N-00013-40696701,2022-01-12T20:46:53,Donostia,expenses,healthcare,-45.33,5199.27
buyer_5,Sara,,1994-03-12,ES75209517551006251525,TRX_N-00014-61210463,2022-01-12T09:09:52,Andoain,expenses,cash,-100.0,5099.27
buyer_5,Sara,,1994-03-12,ES75209517551006251525,TRX_N-00015-71323233,2022-01-15T09:57:36,Donostia,expenses,repairs,-316.56,4782.71
buyer_5,Sara,,1994-03-12,ES75209517551006251525,TRX_N-00016-41928528,2022-01-17T05:55:51,Donostia,expenses,transport,-73.89,4708.82
buyer_5,Sara,,1994-03-12,ES75209517551006251525,TRX_N-00017-45297893,2022-01-17T18:30:30,Donostia,expenses,leisure,-84.31,4624.51
buyer_5,Sara,,1994-03-12,ES75209517551006251525,TRX_N-00018-11264479,2022-01-18T09:44:25,Sopela,expenses,cash,-100.0,4524.51
buyer_5,Sara,,1994-03-12,ES75209517551006251525,TRX_N-00019-01099990,2022-01-18T08:04:43,Donostia,expenses,travel,-1468.73,3055.78
buyer_5,Sara,,1994-03-12,ES75209517551006251525,TRX_N-00020-68680274,2022-01-19T09:04:04,Donostia,expenses,appliances,-384.39,2671.39
buyer_5,Sara,,1994-03-12,ES75209517551006251525,TRX_N-00021-20626659,2022-01-21T10:00:28,Donostia,expenses,gifts,-437.41,2233.98
buyer_5,Sara,,1994-03-12,ES75209517551006251525,TRX_N-00022-00714541,2022-01-23T00:59:12,Donostia,expenses,healthcare,-127.12,2106.86
buyer_5,Sara,,1994-03-12,ES75209517551006251525,TRX_N-00023-91196720,2022-01-23T16:48:11,Donostia,expenses,repairs,-217.59,1889.27
buyer_5,Sara,,1994-03-12,ES75209517551006251525,TRX_N-00024-99257748,2022-01-24T16:31:07,Donostia,expenses,clothing,-52.02,1837.25
buyer_5,Sara,,1994-03-12,ES75209517551006251525,TRX_N-00025-41629362,2022-01-25T08:52:15,Bermeo,expenses,food,-81.18,1756.07
buyer_5,Sara,,1994-03-12,ES75209517551006251525,TRX_N-00026-45926495,2022-01-26T20:25:46,Getxo,expenses,travel,-1205.64,550.43
buyer_5,Sara,,1994-03-12,ES75209517551006251525,TRX_N-00027-68168217,2022-01-28T10:30:41,Donostia,expenses,cash,-100.0,450.43
buyer_5,Sara,,1994-03-12,ES75209517551006251525,TRX_N-00028-44728385,2022-02-01T18:06:29,Donostia,incomes,salary,2342.59,2793.02
buyer_5,Sara,,1994-03-12,ES75209517551006251525,TRX_N-00029-60021780,2022-02-01T18:06:29,Donostia,incomes,salary_partner,2567.69,5360.71
buyer_5,Sara,,1994-03-12,ES75209517551006251525,TRX_N-00030-72867125,2022-02-01T11:55:11,Donostia,expenses,leisure,-23.95,5336.76
buyer_5,Sara,,1994-03-12,ES75209517551006251525,TRX_N-00031-15853042,2022-02-02T01:40:51,Donostia,expenses,travel,-681.73,4655.03
buyer_5,Sara,,1994-03-12,ES75209517551006251525,TRX_N-00032-48069605,2022-02-03T04:37:11,Galdakao,expenses,transport,-67.2,4587.83
buyer_5,Sara,,1994-03-12,ES75209517551006251525,TRX_N-00033-86501177,2022-02-03T09:37:23,Donostia,expenses,cash,-100.0,4487.83
buyer_5,Sara,,1994-03-12,ES75209517551006251525,TRX_N-00034-02815689,2022-02-04T22:24:42,Donostia,expenses,mortgage,-754.18,3733.65
buyer_5,Sara,,1994-03-12,ES75209517551006251525,TRX_N-00035-37574386,2022-02-05T10:24:22,Donostia,expenses,gas,-97.0,3636.65
buyer_5,Sara,,1994-03-12,ES75209517551006251525,TRX_N-00036-51440950,2022-02-05T22:00:19,Errenteria,expenses,leisure,-34.01,3602.64
buyer_5,Sara,,1994-03-12,ES75209517551006251525,TRX_N-00037-06990802,2022-02-05T19:25:45,Donostia,expenses,education,-65.31,3537.33
buyer_5,Sara,,1994-03-12,ES75209517551006251525,TRX_N-00038-42964701,2022-02-06T08:33:32,Donostia,expenses,repairs,-193.38,3343.95
buyer_5,Sara,,1994-03-12,ES75209517551006251525,TRX_N-00039-67366205,2022-02-08T08:34:51,Donostia,expenses,water,-30.33,3313.62
buyer_5,Sara,,1994-03-12,ES75209517551006251525,TRX_N-00040-38544292,2022-02-08T00:36:09,Donostia,expenses,electricity,-27.53,3286.09
buyer_5,Sara,,1994-03-12,ES75209517551006251525,TRX_N-00041-54371426,2022-02-08T17:24:34,Donostia,expenses,internet,-42.0,3244.09
buyer_5,Sara,,1994-03-12,ES75209517551006251525,TRX_N-00042-55412648,2022-02-08T12:18:42,Donostia,expenses,phone,-44.73,3199.36
buyer_5,Sara,,1994-03-12,ES75209517551006251525,TRX_N-00043-64654778,2022-02-10T04:27:38,Erandio,expenses,repairs,-93.02,3106.34
buyer_5,Sara,,1994-03-12,ES75209517551006251525,TRX_N-00044-33032383,2022-02-11T05:33:19,Zuia,expenses,food,-73.1,3033.24
buyer_5,Sara,,1994-03-12,ES75209517551006251525,TRX_N-00045-79365700,2022-02-12T03:01:00,Donostia,expenses,leisure,-70.87,2962.37
buyer_5,Sara,,1994-03-12,ES75209517551006251525,TRX_N-00046-65529862,2022-02-12T13:13:50,Irun,expenses,education,-71.11,2891.26
buyer_5,Sara,,1994-03-12,ES75209517551006251525,TRX_N-00047-41236667,2022-02-12T17:49:59,Donostia,expenses,cash,-100.0,2791.26
buyer_5,Sara,,1994-03-12,ES75209517551006251525,TRX_N-00048-70631819,2022-02-13T10:51:45,Donostia,expenses,food,-100.06,2691.2
buyer_5,Sara,,1994-03-12,ES75209517551006251525,TRX_N-00049-35462926,2022-02-14T12:20:29,Donostia,expenses,transport,-56.44,2634.76
buyer_5,Sara,,1994-03-12,ES75209517551006251525,TRX_N-00050-40609424,2022-02-15T17:23:44,Donostia,expenses,cash,-100.0,2534.76
buyer_5,Sara,,1994-03-12,ES75209517551006251525,TRX_N-00051-98327416,2022-02-18T19:42:09,Donostia,expenses,food,-99.83,2434.93
buyer_5,Sara,,1994-03-12,ES75209517551006251525,TRX_N-00052-26162521,2022-02-19T18:58:38,Donostia,expenses,appliances,-238.13,2196.8
buyer_5,Sara,,1994-03-12,ES75209517551006251525,TRX_N-00053-01679617,2022-02-21T19:34:21,Donostia,expenses,cash,-100.0,2096.8
buyer_5,Sara,,1994-03-12,ES75209517551006251525,TRX_N-00054-07256546,2022-02-23T20:24:20,Zuia,expenses,leisure,-58.29,2038.51
buyer_5,Sara,,1994-03-12,ES75209517551006251525,TRX_N-00055-02894212,2022-02-23T10:06:40,Donostia,expenses,travel,-524.56,1513.95
buyer_5,Sara,,1994-03-12,ES75209517551006251525,TRX_N-00056-61168518,2022-02-23T16:14:24,Donostia,expenses,gifts,-265.52,1248.43
buyer_5,Sara,,1994-03-12,ES75209517551006251525,TRX_N-00057-41873575,2022-02-24T18:24:14,Donostia,expenses,cash,-100.0,1148.43
buyer_5,Sara,,1994-03-12,ES75209517551006251525,TRX_N-00058-45303225,2022-02-26T20:49:35,Donostia,expenses,transport,-72.68,1075.75
buyer_5,Sara,,1994-03-12,ES75209517551006251525,TRX_N-00059-00801270,2022-02-26T20:33:41,Donostia,expenses,travel,-1489.9,-414.15
buyer_5,Sara,,1994-03-12,ES75209517551006251525,TRX_N-00060-58888746,2022-02-26T02:20:06,Arrasate,expenses,appliances,-183.98,-598.13
buyer_5,Sara,,1994-03-12,ES75209517551006251525,TRX_N-00061-21807067,2022-02-28T09:41:39,Donostia,expenses,cash,-100.0,-698.13
buyer_5,Sara,,1994-03-12,ES75209517551006251525,TRX_N-00062-44898033,2022-02-28T09:27:58,Donostia,expenses,appliances,-214.47,-912.6
buyer_5,Sara,,1994-03-12,ES75209517551006251525,TRX_N-00063-74782021,2022-03-01T14:07:57,Donostia,incomes,salary,2342.59,1429.99
buyer_5,Sara,,1994-03-12,ES75209517551006251525,TRX_N-00064-72338850,2022-03-01T14:07:57,Donostia,incomes,salary_partner,2567.69,3997.68
buyer_5,Sara,,1994-03-12,ES75209517551006251525,TRX_N-00065-67454966,2022-03-01T18:25:18,Donostia,expenses,cash,-100.0,3897.68
buyer_5,Sara,,1994-03-12,ES75209517551006251525,TRX_N-00066-98986878,2022-03-02T19:48:58,Donostia,expenses,gifts,-185.49,3712.19
buyer_5,Sara,,1994-03-12,ES75209517551006251525,TRX_N-00067-70657016,2022-03-03T13:23:37,Donostia,expenses,food,-78.15,3634.04
buyer_5,Sara,,1994-03-12,ES75209517551006251525,TRX_N-00068-55907216,2022-03-03T15:37:58,Donostia,expenses,cash,-100.0,3534.04
buyer_5,Sara,,1994-03-12,ES75209517551006251525,TRX_N-00069-91603059,2022-03-04T13:36:42,Donostia,expenses,mortgage,-754.18,2779.86
buyer_5,Sara,,1994-03-12,ES75209517551006251525,TRX_N-00070-19719953,2022-03-05T08:22:37,Donostia,expenses,internet,-42.0,2737.86
buyer_5,Sara,,1994-03-12,ES75209517551006251525,TRX_N-00071-55818942,2022-03-05T09:42:30,Donostia,expenses,repairs,-151.35,2586.51
buyer_5,Sara,,1994-03-12,ES75209517551006251525,TRX_N-00072-60879782,2022-03-06T17:06:41,Donostia,expenses,water,-37.09,2549.42
buyer_5,Sara,,1994-03-12,ES75209517551006251525,TRX_N-00073-83162901,2022-03-06T12:21:19,Andoain,expenses,travel,-1239.85,1309.57
buyer_5,Sara,,1994-03-12,ES75209517551006251525,TRX_N-00074-88957923,2022-03-08T20:44:27,Donostia,expenses,electricity,-36.7,1272.87
buyer_5,Sara,,1994-03-12,ES75209517551006251525,TRX_N-00075-93480412,2022-03-08T16:36:17,Donostia,expenses,gas,-111.08,1161.79
buyer_5,Sara,,1994-03-12,ES75209517551006251525,TRX_N-00076-56591631,2022-03-08T20:41:53,Donostia,expenses,phone,-44.57,1117.22
buyer_5,Sara,,1994-03-12,ES75209517551006251525,TRX_N-00077-12718308,2022-03-10T19:13:52,Donostia,expenses,cash,-100.0,1017.22
buyer_5,Sara,,1994-03-12,ES75209517551006251525,TRX_N-00078-09636145,2022-03-11T13:18:12,Mungia,expenses,food,-106.57,910.65
buyer_5,Sara,,1994-03-12,ES75209517551006251525,TRX_N-00079-62715354,2022-03-12T17:27:56,Donostia,expenses,cash,-100.0,810.65
buyer_5,Sara,,1994-03-12,ES75209517551006251525,TRX_N-00080-88879897,2022-03-12T09:59:42,Donostia,expenses,repairs,-89.67,720.98
buyer_5,Sara,,1994-03-12,ES75209517551006251525,TRX_N-00081-82733363,2022-03-13T09:40:51,Donostia,expenses,transport,-59.98,661.0
buyer_5,Sara,,1994-03-12,ES75209517551006251525,TRX_N-00082-40039984,2022-03-13T13:56:38,Lasarte-Oria,expenses,cash,-100.0,561.0
buyer_5,Sara,,1994-03-12,ES75209517551006251525,TRX_N-00083-90881116,2022-03-13T14:10:12,Donostia,expenses,appliances,-394.76,166.24
buyer_5,Sara,,1994-03-12,ES75209517551006251525,TRX_N-00084-93342905,2022-03-14T21:39:33,Donostia,expenses,food,-115.29,50.95
buyer_5,Sara,,1994-03-12,ES75209517551006251525,TRX_N-00085-12780227,2022-03-14T13:15:11,Donostia,expenses,cash,-100.0,-49.05
buyer_5,Sara,,1994-03-12,ES75209517551006251525,TRX_N-00086-12753782,2022-03-15T14:46:12,Donostia,expenses,leisure,-48.1,-97.15
buyer_5,Sara,,1994-03-12,ES75209517551006251525,TRX_N-00087-84306144,2022-03-15T18:26:03,Portugalete,expenses,cash,-100.0,-197.15
buyer_5,Sara,,1994-03-12,ES75209517551006251525,TRX_N-00088-64899218,2022-03-17T14:50:33,Donostia,expenses,cash,-100.0,-297.15
buyer_5,Sara,,1994-03-12,ES75209517551006251525,TRX_N-00089-21287316,2022-03-18T09:37:37,Donostia,expenses,food,-84.11,-381.26
buyer_5,Sara,,1994-03-12,ES75209517551006251525,TRX_N-00090-47843641,2022-03-18T12:07:24,Donostia,expenses,transport,-79.6,-460.86
buyer_5,Sara,,1994-03-12,ES75209517551006251525,TRX_N-00091-38865278,2022-03-20T08:53:50,Donostia,expenses,cash,-100.0,-560.86
buyer_5,Sara,,1994-03-12,ES75209517551006251525,TRX_N-00092-25485314,2022-03-22T16:08:15,Alegr√≠a-Dulantzi,expenses,healthcare,-143.84,-704.7
buyer_5,Sara,,1994-03-12,ES75209517551006251525,TRX_N-00093-10945921,2022-03-22T21:04:28,Donostia,expenses,cash,-100.0,-804.7
buyer_5,Sara,,1994-03-12,ES75209517551006251525,TRX_N-00094-27551545,2022-03-23T14:42:51,Donostia,expenses,leisure,-50.58,-855.28
buyer_5,Sara,,1994-03-12,ES75209517551006251525,TRX_N-00095-38709273,2022-03-25T09:34:47,Donostia,expenses,cash,-100.0,-955.28
buyer_5,Sara,,1994-03-12,ES75209517551006251525,TRX_N-00096-63096613,2022-03-26T17:02:12,Erandio,expenses,repairs,-103.29,-1058.57
buyer_5,Sara,,1994-03-12,ES75209517551006251525,TRX_N-00097-28631842,2022-03-29T18:10:19,Donostia,expenses,leisure,-23.46,-1082.03
buyer_5,Sara,,1994-03-12,ES75209517551006251525,TRX_N-00098-73948273,2022-04-01T15:19:48,Donostia,incomes,salary,2342.59,1260.56
buyer_5,Sara,,1994-03-12,ES75209517551006251525,TRX_N-00099-63109685,2022-04-01T15:19:48,Donostia,incomes,salary_partner,2567.69,3828.25
buyer_5,Sara,,1994-03-12,ES75209517551006251525,TRX_N-00100-71911308,2022-04-01T15:19:48,Donostia,incomes,extra_income,234.39,4062.64
buyer_5,Sara,,1994-03-12,ES75209517551006251525,TRX_N-00101-84560883,2022-04-03T18:16:13,Donostia,expenses,leisure,-41.09,4021.55
buyer_5,Sara,,1994-03-12,ES75209517551006251525,TRX_N-00102-46186501,2022-04-04T11:04:24,Donostia,expenses,mortgage,-754.18,3267.37
buyer_5,Sara,,1994-03-12,ES75209517551006251525,TRX_N-00103-36814538,2022-04-04T09:05:22,Sopela,expenses,food,-122.51,3144.86
buyer_5,Sara,,1994-03-12,ES75209517551006251525,TRX_N-00104-71741072,2022-04-04T09:15:01,Donostia,expenses,transport,-77.99,3066.87
buyer_5,Sara,,1994-03-12,ES75209517551006251525,TRX_N-00105-20460618,2022-04-04T16:22:12,Donostia,expenses,travel,-1566.53,1500.34
buyer_5,Sara,,1994-03-12,ES75209517551006251525,TRX_N-00106-94090176,2022-04-04T16:30:01,Donostia,expenses,gifts,-764.38,735.96
buyer_5,Sara,,1994-03-12,ES75209517551006251525,TRX_N-00107-67010409,2022-04-05T08:26:06,Donostia,expenses,water,-39.35,696.61
buyer_5,Sara,,1994-03-12,ES75209517551006251525,TRX_N-00108-05259579,2022-04-05T09:01:15,Donostia,expenses,appliances,-333.08,363.53
buyer_5,Sara,,1994-03-12,ES75209517551006251525,TRX_N-00109-92052416,2022-04-06T22:49:21,Donostia,expenses,internet,-42.0,321.53
buyer_5,Sara,,1994-03-12,ES75209517551006251525,TRX_N-00110-74835355,2022-04-08T12:01:47,Donostia,expenses,phone,-38.51,283.02
buyer_5,Sara,,1994-03-12,ES75209517551006251525,TRX_N-00111-26631659,2022-04-08T10:39:03,Donostia,expenses,electricity,-30.7,252.32
buyer_5,Sara,,1994-03-12,ES75209517551006251525,TRX_N-00112-85587908,2022-04-08T08:54:25,Donostia,expenses,gas,-99.37,152.95
buyer_5,Sara,,1994-03-12,ES75209517551006251525,TRX_N-00113-80528385,2022-04-08T20:19:33,Andoain,expenses,clothing,-66.43,86.52
buyer_5,Sara,,1994-03-12,ES75209517551006251525,TRX_N-00114-60234506,2022-04-12T15:10:58,Donostia,expenses,repairs,-157.65,-71.13
buyer_5,Sara,,1994-03-12,ES75209517551006251525,TRX_N-00115-94800081,2022-04-12T16:55:11,Donostia,expenses,gifts,-622.84,-693.97
buyer_5,Sara,,1994-03-12,ES75209517551006251525,TRX_N-00116-36712205,2022-04-14T12:20:21,Donostia,expenses,food,-88.12,-782.09
buyer_5,Sara,,1994-03-12,ES75209517551006251525,TRX_N-00117-80351992,2022-04-14T08:49:53,Donostia,expenses,leisure,-47.9,-829.99
buyer_5,Sara,,1994-03-12,ES75209517551006251525,TRX_N-00118-75972063,2022-04-14T10:15:02,Donostia,expenses,cash,-100.0,-929.99
buyer_5,Sara,,1994-03-12,ES75209517551006251525,TRX_N-00119-68218101,2022-04-19T09:40:03,Donostia,expenses,leisure,-44.14,-974.13
buyer_5,Sara,,1994-03-12,ES75209517551006251525,TRX_N-00120-09086639,2022-04-19T23:29:07,Donostia,expenses,cash,-100.0,-1074.13
buyer_5,Sara,,1994-03-12,ES75209517551006251525,TRX_N-00121-88792314,2022-04-20T23:06:39,Donostia,expenses,leisure,-75.69,-1149.82
buyer_5,Sara,,1994-03-12,ES75209517551006251525,TRX_N-00122-17836203,2022-04-22T11:31:21,Donostia,expenses,food,-88.22,-1238.04
buyer_5,Sara,,1994-03-12,ES75209517551006251525,TRX_N-00123-25351745,2022-04-22T09:42:27,Donostia,expenses,leisure,-46.65,-1284.69
buyer_5,Sara,,1994-03-12,ES75209517551006251525,TRX_N-00124-31231207,2022-04-23T20:35:07,Erandio,expenses,gifts,-703.25,-1987.94
buyer_5,Sara,,1994-03-12,ES75209517551006251525,TRX_N-00125-01959855,2022-04-24T11:07:35,Donostia,expenses,transport,-59.06,-2047.0
buyer_5,Sara,,1994-03-12,ES75209517551006251525,TRX_N-00126-80043920,2022-04-25T17:49:58,Donostia,expenses,food,-73.31,-2120.31
buyer_5,Sara,,1994-03-12,ES75209517551006251525,TRX_N-00127-50525575,2022-04-25T11:58:58,Donostia,expenses,transport,-83.45,-2203.76
buyer_5,Sara,,1994-03-12,ES75209517551006251525,TRX_N-00128-39290286,2022-04-28T11:55:51,Donostia,expenses,cash,-100.0,-2303.76
buyer_5,Sara,,1994-03-12,ES75209517551006251525,TRX_N-00129-07313676,2022-04-29T04:13:18,Donostia,expenses,transport,-77.4,-2381.16
buyer_5,Sara,,1994-03-12,ES75209517551006251525,TRX_N-00130-82502236,2022-04-30T18:13:09,Donostia,expenses,cash,-100.0,-2481.16
buyer_5,Sara,,1994-03-12,ES75209517551006251525,TRX_N-00131-27894926,2022-05-01T17:59:21,Donostia,incomes,salary,2342.59,-138.57
buyer_5,Sara,,1994-03-12,ES75209517551006251525,TRX_N-00132-21701755,2022-05-01T17:59:21,Donostia,incomes,salary_partner,2567.69,2429.12
buyer_5,Sara,,1994-03-12,ES75209517551006251525,TRX_N-00133-46944136,2022-05-01T11:03:41,Alegr√≠a-Dulantzi,expenses,education,-61.47,2367.65
buyer_5,Sara,,1994-03-12,ES75209517551006251525,TRX_N-00134-38786176,2022-05-02T20:55:44,Donostia,expenses,leisure,-36.36,2331.29
buyer_5,Sara,,1994-03-12,ES75209517551006251525,TRX_N-00135-37767786,2022-05-03T09:46:14,Donostia,expenses,food,-113.49,2217.8
buyer_5,Sara,,1994-03-12,ES75209517551006251525,TRX_N-00136-49624305,2022-05-03T10:04:37,Donostia,expenses,clothing,-73.44,2144.36
buyer_5,Sara,,1994-03-12,ES75209517551006251525,TRX_N-00137-13310866,2022-05-04T09:41:02,Donostia,expenses,mortgage,-754.18,1390.18
buyer_5,Sara,,1994-03-12,ES75209517551006251525,TRX_N-00138-32414534,2022-05-04T05:05:24,Donostia,expenses,repairs,-148.5,1241.68
buyer_5,Sara,,1994-03-12,ES75209517551006251525,TRX_N-00139-13231138,2022-05-05T16:52:06,Donostia,expenses,gas,-69.31,1172.37
buyer_5,Sara,,1994-03-12,ES75209517551006251525,TRX_N-00140-44677398,2022-05-05T11:13:50,Amurrio,expenses,travel,-781.42,390.95
buyer_5,Sara,,1994-03-12,ES75209517551006251525,TRX_N-00141-80375543,2022-05-06T08:14:35,Donostia,expenses,cash,-100.0,290.95
buyer_5,Sara,,1994-03-12,ES75209517551006251525,TRX_N-00142-59229121,2022-05-08T16:44:09,Donostia,expenses,water,-33.95,257.0
buyer_5,Sara,,1994-03-12,ES75209517551006251525,TRX_N-00143-51612440,2022-05-08T17:13:18,Donostia,expenses,electricity,-79.14,177.86
buyer_5,Sara,,1994-03-12,ES75209517551006251525,TRX_N-00144-82254742,2022-05-08T17:07:07,Donostia,expenses,internet,-42.0,135.86
buyer_5,Sara,,1994-03-12,ES75209517551006251525,TRX_N-00145-85170188,2022-05-08T14:41:18,Donostia,expenses,phone,-31.74,104.12
buyer_5,Sara,,1994-03-12,ES75209517551006251525,TRX_N-00146-75929103,2022-05-09T11:01:07,Donostia,expenses,transport,-68.86,35.26
buyer_5,Sara,,1994-03-12,ES75209517551006251525,TRX_N-00147-65967353,2022-05-12T08:18:44,Donostia,expenses,food,-66.96,-31.7
buyer_5,Sara,,1994-03-12,ES75209517551006251525,TRX_N-00148-04812385,2022-05-12T10:03:02,Donostia,expenses,transport,-54.6,-86.3
buyer_5,Sara,,1994-03-12,ES75209517551006251525,TRX_N-00149-49232199,2022-05-14T19:54:52,Leioa,expenses,food,-71.28,-157.58
buyer_5,Sara,,1994-03-12,ES75209517551006251525,TRX_N-00150-53835076,2022-05-14T15:49:21,Errenteria,expenses,gifts,-491.02,-648.6
buyer_5,Sara,,1994-03-12,ES75209517551006251525,TRX_N-00151-97975965,2022-05-17T12:42:36,Donostia,expenses,leisure,-80.24,-728.84
buyer_5,Sara,,1994-03-12,ES75209517551006251525,TRX_N-00152-98209233,2022-05-17T11:06:05,Portugalete,expenses,gifts,-558.34,-1287.18
buyer_5,Sara,,1994-03-12,ES75209517551006251525,TRX_N-00153-65415447,2022-05-21T23:43:10,Donostia,expenses,healthcare,-94.52,-1381.7
buyer_5,Sara,,1994-03-12,ES75209517551006251525,TRX_N-00154-13341293,2022-05-23T15:16:12,Donostia,expenses,cash,-100.0,-1481.7
buyer_5,Sara,,1994-03-12,ES75209517551006251525,TRX_N-00155-56537126,2022-05-24T03:29:14,Donostia,expenses,repairs,-235.4,-1717.1
buyer_5,Sara,,1994-03-12,ES75209517551006251525,TRX_N-00156-21763472,2022-05-25T18:01:01,Donostia,expenses,food,-89.32,-1806.42
buyer_5,Sara,,1994-03-12,ES75209517551006251525,TRX_N-00157-64906889,2022-05-25T15:05:01,Donostia,expenses,leisure,-43.32,-1849.74
buyer_5,Sara,,1994-03-12,ES75209517551006251525,TRX_N-00158-97148317,2022-05-25T09:02:08,Getxo,expenses,repairs,-146.06,-1995.8
buyer_5,Sara,,1994-03-12,ES75209517551006251525,TRX_N-00159-20535626,2022-05-29T13:49:16,Amurrio,expenses,cash,-100.0,-2095.8
buyer_5,Sara,,1994-03-12,ES75209517551006251525,TRX_N-00160-06430920,2022-05-29T11:26:06,Donostia,expenses,repairs,-43.6,-2139.4
buyer_5,Sara,,1994-03-12,ES75209517551006251525,TRX_N-00161-11318909,2022-05-30T17:57:45,Donostia,expenses,clothing,-113.16,-2252.56
buyer_5,Sara,,1994-03-12,ES75209517551006251525,TRX_N-00162-47167361,2022-05-31T12:10:02,Galdakao,expenses,food,-86.93,-2339.49
buyer_5,Sara,,1994-03-12,ES75209517551006251525,TRX_N-00163-34976556,2022-06-01T22:38:34,Donostia,incomes,salary,2342.59,3.1
buyer_5,Sara,,1994-03-12,ES75209517551006251525,TRX_N-00164-10917474,2022-06-01T22:38:34,Donostia,incomes,salary_partner,2567.69,2570.79
buyer_5,Sara,,1994-03-12,ES75209517551006251525,TRX_N-00165-17348156,2022-06-01T22:38:34,Donostia,incomes,salary_bonus,1691.49,4262.28
buyer_5,Sara,,1994-03-12,ES75209517551006251525,TRX_N-00166-80056306,2022-06-01T22:38:34,Donostia,incomes,salary_partner_bonus,1971.93,6234.21
buyer_5,Sara,,1994-03-12,ES75209517551006251525,TRX_N-00167-64276895,2022-06-01T08:25:41,Salvatierra/Agurain,expenses,food,-120.45,6113.76
buyer_5,Sara,,1994-03-12,ES75209517551006251525,TRX_N-00168-76585902,2022-06-01T07:09:38,Amurrio,expenses,transport,-45.75,6068.01
buyer_5,Sara,,1994-03-12,ES75209517551006251525,TRX_N-00169-14835295,2022-06-02T23:03:44,Donostia,expenses,leisure,-55.1,6012.91
buyer_5,Sara,,1994-03-12,ES75209517551006251525,TRX_N-00170-39247159,2022-06-04T08:42:07,Donostia,expenses,mortgage,-754.18,5258.73
buyer_5,Sara,,1994-03-12,ES75209517551006251525,TRX_N-00171-96192259,2022-06-04T15:16:41,Berango,expenses,transport,-82.19,5176.54
buyer_5,Sara,,1994-03-12,ES75209517551006251525,TRX_N-00172-03606342,2022-06-04T22:20:16,Donostia,expenses,cash,-100.0,5076.54
buyer_5,Sara,,1994-03-12,ES75209517551006251525,TRX_N-00173-59703267,2022-06-05T11:50:53,Donostia,expenses,electricity,-87.18,4989.36
buyer_5,Sara,,1994-03-12,ES75209517551006251525,TRX_N-00174-17847683,2022-06-05T16:51:22,Donostia,expenses,phone,-41.34,4948.02
buyer_5,Sara,,1994-03-12,ES75209517551006251525,TRX_N-00175-79079201,2022-06-05T15:44:55,Donostia,expenses,transport,-67.29,4880.73
buyer_5,Sara,,1994-03-12,ES75209517551006251525,TRX_N-00176-15074050,2022-06-05T09:34:03,Donostia,expenses,clothing,-68.52,4812.21
buyer_5,Sara,,1994-03-12,ES75209517551006251525,TRX_N-00177-78087532,2022-06-05T09:53:37,Donostia,expenses,cash,-100.0,4712.21
buyer_5,Sara,,1994-03-12,ES75209517551006251525,TRX_N-00178-95501439,2022-06-06T10:48:09,Donostia,expenses,water,-38.61,4673.6
buyer_5,Sara,,1994-03-12,ES75209517551006251525,TRX_N-00179-76096171,2022-06-06T17:02:41,Donostia,expenses,gas,-38.18,4635.42
buyer_5,Sara,,1994-03-12,ES75209517551006251525,TRX_N-00180-59119916,2022-06-06T12:58:46,Donostia,expenses,internet,-42.0,4593.42
buyer_5,Sara,,1994-03-12,ES75209517551006251525,TRX_N-00181-38509692,2022-06-07T21:52:11,Donostia,expenses,leisure,-63.48,4529.94
buyer_5,Sara,,1994-03-12,ES75209517551006251525,TRX_N-00182-19504788,2022-06-08T15:04:59,Donostia,expenses,food,-99.99,4429.95
buyer_5,Sara,,1994-03-12,ES75209517551006251525,TRX_N-00183-67833431,2022-06-08T22:15:09,Donostia,expenses,clothing,-104.72,4325.23
buyer_5,Sara,,1994-03-12,ES75209517551006251525,TRX_N-00184-97839879,2022-06-08T13:55:04,Donostia,expenses,gifts,-324.04,4001.19
buyer_5,Sara,,1994-03-12,ES75209517551006251525,TRX_N-00185-92232073,2022-06-09T08:40:19,Donostia,expenses,transport,-52.02,3949.17
buyer_5,Sara,,1994-03-12,ES75209517551006251525,TRX_N-00186-07182735,2022-06-10T03:41:32,Donostia,expenses,leisure,-43.86,3905.31
buyer_5,Sara,,1994-03-12,ES75209517551006251525,TRX_N-00187-35864031,2022-06-11T11:24:18,Donostia,expenses,gifts,-566.36,3338.95
buyer_5,Sara,,1994-03-12,ES75209517551006251525,TRX_N-00188-14915413,2022-06-12T11:17:06,Donostia,expenses,food,-66.72,3272.23
buyer_5,Sara,,1994-03-12,ES75209517551006251525,TRX_N-00189-58465178,2022-06-16T09:24:48,Donostia,expenses,food,-92.75,3179.48
buyer_5,Sara,,1994-03-12,ES75209517551006251525,TRX_N-00190-55934484,2022-06-17T17:12:36,Donostia,expenses,leisure,-50.5,3128.98
buyer_5,Sara,,1994-03-12,ES75209517551006251525,TRX_N-00191-19094297,2022-06-18T04:22:16,Donostia,expenses,food,-70.13,3058.85
buyer_5,Sara,,1994-03-12,ES75209517551006251525,TRX_N-00192-79760144,2022-06-18T08:45:16,Donostia,expenses,travel,-1220.47,1838.38
buyer_5,Sara,,1994-03-12,ES75209517551006251525,TRX_N-00193-31991503,2022-06-20T16:20:17,Donostia,expenses,gifts,-130.34,1708.04
buyer_5,Sara,,1994-03-12,ES75209517551006251525,TRX_N-00194-48579321,2022-06-21T16:22:28,Donostia,expenses,food,-83.97,1624.07
buyer_5,Sara,,1994-03-12,ES75209517551006251525,TRX_N-00195-08415124,2022-06-23T23:47:09,Eibar,expenses,transport,-52.0,1572.07
buyer_5,Sara,,1994-03-12,ES75209517551006251525,TRX_N-00196-84206404,2022-06-23T15:59:25,Iru√±a de Oca,expenses,cash,-100.0,1472.07
buyer_5,Sara,,1994-03-12,ES75209517551006251525,TRX_N-00197-38622394,2022-06-24T13:15:59,Donostia,expenses,clothing,-139.02,1333.05
buyer_5,Sara,,1994-03-12,ES75209517551006251525,TRX_N-00198-79864856,2022-06-24T19:11:58,Donostia,expenses,education,-49.47,1283.58
buyer_5,Sara,,1994-03-12,ES75209517551006251525,TRX_N-00199-23902433,2022-06-25T09:09:04,Donostia,expenses,transport,-64.75,1218.83
buyer_5,Sara,,1994-03-12,ES75209517551006251525,TRX_N-00200-02580228,2022-06-25T12:09:37,Donostia,expenses,gifts,-253.46,965.37
buyer_5,Sara,,1994-03-12,ES75209517551006251525,TRX_N-00201-57938140,2022-06-26T14:14:39,Donostia,expenses,leisure,-84.8,880.57
buyer_5,Sara,,1994-03-12,ES75209517551006251525,TRX_N-00202-07259398,2022-06-26T16:15:14,Donostia,expenses,clothing,-108.69,771.88
buyer_5,Sara,,1994-03-12,ES75209517551006251525,TRX_N-00203-01460347,2022-06-26T17:10:52,Donostia,expenses,appliances,-94.5,677.38
buyer_5,Sara,,1994-03-12,ES75209517551006251525,TRX_N-00204-97791277,2022-06-29T16:47:02,Donostia,expenses,leisure,-67.11,610.27
buyer_5,Sara,,1994-03-12,ES75209517551006251525,TRX_N-00205-48563075,2022-07-01T21:47:58,Donostia,incomes,salary,2342.59,2952.86
buyer_5,Sara,,1994-03-12,ES75209517551006251525,TRX_N-00206-60499370,2022-07-01T21:47:58,Donostia,incomes,salary_partner,2567.69,5520.55
buyer_5,Sara,,1994-03-12,ES75209517551006251525,TRX_N-00207-95593806,2022-07-01T21:47:58,Donostia,incomes,extra_income,234.39,5754.94
buyer_5,Sara,,1994-03-12,ES75209517551006251525,TRX_N-00208-73213129,2022-07-02T12:07:51,Barakaldo,expenses,healthcare,-152.83,5602.11
buyer_5,Sara,,1994-03-12,ES75209517551006251525,TRX_N-00209-31365603,2022-07-03T20:17:50,Donostia,expenses,food,-63.21,5538.9
buyer_5,Sara,,1994-03-12,ES75209517551006251525,TRX_N-00210-08166707,2022-07-04T11:36:39,Donostia,expenses,mortgage,-754.18,4784.72
buyer_5,Sara,,1994-03-12,ES75209517551006251525,TRX_N-00211-30569285,2022-07-05T20:15:06,Donostia,expenses,water,-24.49,4760.23
buyer_5,Sara,,1994-03-12,ES75209517551006251525,TRX_N-00212-62521892,2022-07-05T02:36:32,Donostia,expenses,electricity,-23.32,4736.91
buyer_5,Sara,,1994-03-12,ES75209517551006251525,TRX_N-00213-51740349,2022-07-05T15:06:02,Donostia,expenses,gas,-92.74,4644.17
buyer_5,Sara,,1994-03-12,ES75209517551006251525,TRX_N-00214-94890694,2022-07-05T13:43:15,Donostia,expenses,food,-85.46,4558.71
buyer_5,Sara,,1994-03-12,ES75209517551006251525,TRX_N-00215-26710816,2022-07-05T12:19:29,Donostia,expenses,transport,-48.21,4510.5
buyer_5,Sara,,1994-03-12,ES75209517551006251525,TRX_N-00216-47159431,2022-07-05T10:14:22,Donostia,expenses,cash,-100.0,4410.5
buyer_5,Sara,,1994-03-12,ES75209517551006251525,TRX_N-00217-33214942,2022-07-06T14:47:17,Donostia,expenses,leisure,-49.47,4361.03
buyer_5,Sara,,1994-03-12,ES75209517551006251525,TRX_N-00218-30998763,2022-07-07T19:00:09,Donostia,expenses,phone,-33.21,4327.82
buyer_5,Sara,,1994-03-12,ES75209517551006251525,TRX_N-00219-51953809,2022-07-07T20:01:30,Donostia,expenses,food,-116.53,4211.29
buyer_5,Sara,,1994-03-12,ES75209517551006251525,TRX_N-00220-15186903,2022-07-08T00:26:43,Donostia,expenses,internet,-42.0,4169.29
buyer_5,Sara,,1994-03-12,ES75209517551006251525,TRX_N-00221-98250794,2022-07-08T17:20:10,Donostia,expenses,food,-70.95,4098.34
buyer_5,Sara,,1994-03-12,ES75209517551006251525,TRX_N-00222-01591206,2022-07-08T17:57:45,Donostia,expenses,healthcare,-77.53,4020.81
buyer_5,Sara,,1994-03-12,ES75209517551006251525,TRX_N-00223-80277597,2022-07-11T20:47:27,Donostia,expenses,food,-95.29,3925.52
buyer_5,Sara,,1994-03-12,ES75209517551006251525,TRX_N-00224-34273891,2022-07-13T15:44:19,Donostia,expenses,food,-87.39,3838.13
buyer_5,Sara,,1994-03-12,ES75209517551006251525,TRX_N-00225-04501817,2022-07-15T14:20:07,Donostia,expenses,leisure,-31.06,3807.07
buyer_5,Sara,,1994-03-12,ES75209517551006251525,TRX_N-00226-53585139,2022-07-15T18:12:32,Donostia,expenses,clothing,-61.1,3745.97
buyer_5,Sara,,1994-03-12,ES75209517551006251525,TRX_N-00227-92652051,2022-07-15T14:41:17,Donostia,expenses,education,-69.39,3676.58
buyer_5,Sara,,1994-03-12,ES75209517551006251525,TRX_N-00228-20502246,2022-07-15T14:24:41,Donostia,expenses,repairs,-263.15,3413.43
buyer_5,Sara,,1994-03-12,ES75209517551006251525,TRX_N-00229-55340959,2022-07-17T14:35:36,Donostia,expenses,repairs,-204.61,3208.82
buyer_5,Sara,,1994-03-12,ES75209517551006251525,TRX_N-00230-54744766,2022-07-17T11:53:19,Erandio,expenses,gifts,-359.02,2849.8
buyer_5,Sara,,1994-03-12,ES75209517551006251525,TRX_N-00231-04288374,2022-07-18T13:11:24,Donostia,expenses,appliances,-254.85,2594.95
buyer_5,Sara,,1994-03-12,ES75209517551006251525,TRX_N-00232-34679568,2022-07-21T10:39:55,Donostia,expenses,food,-86.18,2508.77
buyer_5,Sara,,1994-03-12,ES75209517551006251525,TRX_N-00233-13664635,2022-07-21T16:51:09,Donostia,expenses,repairs,-253.33,2255.44
buyer_5,Sara,,1994-03-12,ES75209517551006251525,TRX_N-00234-50524189,2022-07-22T17:36:56,Iru√±a de Oca,expenses,transport,-42.77,2212.67
buyer_5,Sara,,1994-03-12,ES75209517551006251525,TRX_N-00235-41823011,2022-07-22T04:04:53,Lasarte-Oria,expenses,leisure,-36.37,2176.3
buyer_5,Sara,,1994-03-12,ES75209517551006251525,TRX_N-00236-12789029,2022-07-23T15:18:20,Alegr√≠a-Dulantzi,expenses,food,-123.69,2052.61
buyer_5,Sara,,1994-03-12,ES75209517551006251525,TRX_N-00237-92647172,2022-07-25T00:11:47,Donostia,expenses,leisure,-34.6,2018.01
buyer_5,Sara,,1994-03-12,ES75209517551006251525,TRX_N-00238-02861433,2022-07-31T19:43:33,Donostia,expenses,repairs,-44.36,1973.65
buyer_5,Sara,,1994-03-12,ES75209517551006251525,TRX_N-00239-25763767,2022-08-01T12:45:35,Donostia,incomes,salary,2342.59,4316.24
buyer_5,Sara,,1994-03-12,ES75209517551006251525,TRX_N-00240-17704791,2022-08-01T12:45:35,Donostia,incomes,salary_partner,2567.69,6883.93
buyer_5,Sara,,1994-03-12,ES75209517551006251525,TRX_N-00241-31842581,2022-08-01T19:45:11,Donostia,expenses,cash,-100.0,6783.93
buyer_5,Sara,,1994-03-12,ES75209517551006251525,TRX_N-00242-31598786,2022-08-02T21:54:24,Donostia,expenses,leisure,-46.28,6737.65
buyer_5,Sara,,1994-03-12,ES75209517551006251525,TRX_N-00243-19147793,2022-08-03T02:54:22,Donostia,expenses,clothing,-48.52,6689.13
buyer_5,Sara,,1994-03-12,ES75209517551006251525,TRX_N-00244-53591415,2022-08-04T11:41:31,Donostia,expenses,mortgage,-754.18,5934.95
buyer_5,Sara,,1994-03-12,ES75209517551006251525,TRX_N-00245-70036892,2022-08-05T12:05:11,Donostia,expenses,cash,-100.0,5834.95
buyer_5,Sara,,1994-03-12,ES75209517551006251525,TRX_N-00246-15564498,2022-08-05T08:46:36,Donostia,expenses,travel,-1758.02,4076.93
buyer_5,Sara,,1994-03-12,ES75209517551006251525,TRX_N-00247-54720420,2022-08-06T05:03:29,Donostia,expenses,electricity,-82.22,3994.71
buyer_5,Sara,,1994-03-12,ES75209517551006251525,TRX_N-00248-91699799,2022-08-06T18:23:01,Donostia,expenses,leisure,-73.85,3920.86
buyer_5,Sara,,1994-03-12,ES75209517551006251525,TRX_N-00249-56683431,2022-08-06T18:42:18,Errenteria,expenses,cash,-100.0,3820.86
buyer_5,Sara,,1994-03-12,ES75209517551006251525,TRX_N-00250-59253747,2022-08-07T11:04:57,Donostia,expenses,phone,-36.21,3784.65
buyer_5,Sara,,1994-03-12,ES75209517551006251525,TRX_N-00251-37552522,2022-08-07T17:43:23,Donostia,expenses,food,-107.38,3677.27
buyer_5,Sara,,1994-03-12,ES75209517551006251525,TRX_N-00252-19118693,2022-08-07T07:04:00,Donostia,expenses,transport,-72.16,3605.11
buyer_5,Sara,,1994-03-12,ES75209517551006251525,TRX_N-00253-28377615,2022-08-07T10:27:21,Irun,expenses,repairs,-120.33,3484.78
buyer_5,Sara,,1994-03-12,ES75209517551006251525,TRX_N-00254-61562521,2022-08-08T20:46:44,Donostia,expenses,water,-35.54,3449.24
buyer_5,Sara,,1994-03-12,ES75209517551006251525,TRX_N-00255-18772140,2022-08-08T10:29:51,Donostia,expenses,gas,-76.88,3372.36
buyer_5,Sara,,1994-03-12,ES75209517551006251525,TRX_N-00256-23746698,2022-08-08T19:14:35,Donostia,expenses,internet,-42.0,3330.36
buyer_5,Sara,,1994-03-12,ES75209517551006251525,TRX_N-00257-37752204,2022-08-10T22:32:00,Pasaia,expenses,leisure,-28.96,3301.4
buyer_5,Sara,,1994-03-12,ES75209517551006251525,TRX_N-00258-84064655,2022-08-10T15:08:47,Donostia,expenses,appliances,-98.72,3202.68
buyer_5,Sara,,1994-03-12,ES75209517551006251525,TRX_N-00259-80276467,2022-08-12T17:15:35,Donostia,expenses,leisure,-60.64,3142.04
buyer_5,Sara,,1994-03-12,ES75209517551006251525,TRX_N-00260-85608640,2022-08-14T20:15:21,Donostia,expenses,leisure,-62.49,3079.55
buyer_5,Sara,,1994-03-12,ES75209517551006251525,TRX_N-00261-96821186,2022-08-14T15:03:16,Donostia,expenses,education,-63.75,3015.8
buyer_5,Sara,,1994-03-12,ES75209517551006251525,TRX_N-00262-68270973,2022-08-15T12:02:57,Donostia,expenses,appliances,-147.39,2868.41
buyer_5,Sara,,1994-03-12,ES75209517551006251525,TRX_N-00263-49458091,2022-08-16T11:16:33,Donostia,expenses,repairs,-36.93,2831.48
buyer_5,Sara,,1994-03-12,ES75209517551006251525,TRX_N-00264-15085342,2022-08-17T15:54:48,Donostia,expenses,transport,-56.31,2775.17
buyer_5,Sara,,1994-03-12,ES75209517551006251525,TRX_N-00265-88536079,2022-08-19T15:15:11,Donostia,expenses,food,-105.52,2669.65
buyer_5,Sara,,1994-03-12,ES75209517551006251525,TRX_N-00266-67783231,2022-08-19T13:48:45,Donostia,expenses,transport,-59.19,2610.46
buyer_5,Sara,,1994-03-12,ES75209517551006251525,TRX_N-00267-46210737,2022-08-20T18:19:24,Donostia,expenses,gifts,-687.5,1922.96
buyer_5,Sara,,1994-03-12,ES75209517551006251525,TRX_N-00268-04730584,2022-08-21T10:10:56,Donostia,expenses,clothing,-69.46,1853.5
buyer_5,Sara,,1994-03-12,ES75209517551006251525,TRX_N-00269-33112330,2022-08-23T14:12:12,Donostia,expenses,food,-74.94,1778.56
buyer_5,Sara,,1994-03-12,ES75209517551006251525,TRX_N-00270-87539703,2022-08-23T23:54:17,Donostia,expenses,transport,-66.18,1712.38
buyer_5,Sara,,1994-03-12,ES75209517551006251525,TRX_N-00271-70943691,2022-08-23T14:09:17,Donostia,expenses,repairs,-282.52,1429.86
buyer_5,Sara,,1994-03-12,ES75209517551006251525,TRX_N-00272-39644445,2022-08-24T16:17:42,Donostia,expenses,cash,-100.0,1329.86
buyer_5,Sara,,1994-03-12,ES75209517551006251525,TRX_N-00273-20430410,2022-08-25T12:51:37,Donostia,expenses,education,-69.04,1260.82
buyer_5,Sara,,1994-03-12,ES75209517551006251525,TRX_N-00274-85161333,2022-08-26T08:07:42,Donostia,expenses,transport,-67.42,1193.4
buyer_5,Sara,,1994-03-12,ES75209517551006251525,TRX_N-00275-64274883,2022-08-26T12:57:11,Donostia,expenses,cash,-100.0,1093.4
buyer_5,Sara,,1994-03-12,ES75209517551006251525,TRX_N-00276-65022475,2022-08-27T15:32:15,Llodio,expenses,transport,-53.92,1039.48
buyer_5,Sara,,1994-03-12,ES75209517551006251525,TRX_N-00277-36310883,2022-08-27T18:24:11,Elciego,expenses,education,-72.07,967.41
buyer_5,Sara,,1994-03-12,ES75209517551006251525,TRX_N-00278-03911119,2022-08-27T16:50:58,Donostia,expenses,appliances,-291.78,675.63
buyer_5,Sara,,1994-03-12,ES75209517551006251525,TRX_N-00279-66200057,2022-08-27T17:51:49,Donostia,expenses,repairs,-145.77,529.86
buyer_5,Sara,,1994-03-12,ES75209517551006251525,TRX_N-00280-10664589,2022-08-28T18:58:32,Lasarte-Oria,expenses,education,-67.97,461.89
buyer_5,Sara,,1994-03-12,ES75209517551006251525,TRX_N-00281-32412246,2022-08-29T17:45:15,Donostia,expenses,leisure,-38.02,423.87
buyer_5,Sara,,1994-03-12,ES75209517551006251525,TRX_N-00282-23599380,2022-08-30T14:40:14,Donostia,expenses,transport,-83.71,340.16
buyer_5,Sara,,1994-03-12,ES75209517551006251525,TRX_N-00283-95897529,2022-08-30T17:12:44,Donostia,expenses,clothing,-132.63,207.53
buyer_5,Sara,,1994-03-12,ES75209517551006251525,TRX_N-00284-07285015,2022-09-01T08:53:00,Donostia,incomes,salary,2342.59,2550.12
buyer_5,Sara,,1994-03-12,ES75209517551006251525,TRX_N-00285-56335475,2022-09-01T08:53:00,Donostia,incomes,salary_partner,2567.69,5117.81
buyer_5,Sara,,1994-03-12,ES75209517551006251525,TRX_N-00286-47696893,2022-09-01T23:41:09,Leioa,expenses,cash,-100.0,5017.81
buyer_5,Sara,,1994-03-12,ES75209517551006251525,TRX_N-00287-67009253,2022-09-02T08:41:18,Donostia,expenses,clothing,-135.45,4882.36
buyer_5,Sara,,1994-03-12,ES75209517551006251525,TRX_N-00288-12568414,2022-09-02T20:04:22,Donostia,expenses,cash,-100.0,4782.36
buyer_5,Sara,,1994-03-12,ES75209517551006251525,TRX_N-00289-98408288,2022-09-04T10:04:01,Donostia,expenses,mortgage,-754.18,4028.18
buyer_5,Sara,,1994-03-12,ES75209517551006251525,TRX_N-00290-49002857,2022-09-05T16:39:33,Donostia,expenses,electricity,-89.49,3938.69
buyer_5,Sara,,1994-03-12,ES75209517551006251525,TRX_N-00291-21750583,2022-09-05T13:53:37,Andoain,expenses,clothing,-153.03,3785.66
buyer_5,Sara,,1994-03-12,ES75209517551006251525,TRX_N-00292-93659461,2022-09-06T08:09:22,Donostia,expenses,internet,-42.0,3743.66
buyer_5,Sara,,1994-03-12,ES75209517551006251525,TRX_N-00293-90026539,2022-09-06T19:43:40,Donostia,expenses,phone,-30.53,3713.13
buyer_5,Sara,,1994-03-12,ES75209517551006251525,TRX_N-00294-78778564,2022-09-07T12:41:32,Donostia,expenses,leisure,-67.94,3645.19
buyer_5,Sara,,1994-03-12,ES75209517551006251525,TRX_N-00295-70439373,2022-09-07T08:26:59,Donostia,expenses,appliances,-358.95,3286.24
buyer_5,Sara,,1994-03-12,ES75209517551006251525,TRX_N-00296-56608323,2022-09-08T16:31:28,Donostia,expenses,water,-34.37,3251.87
buyer_5,Sara,,1994-03-12,ES75209517551006251525,TRX_N-00297-79374377,2022-09-08T20:20:11,Donostia,expenses,gas,-103.4,3148.47
buyer_5,Sara,,1994-03-12,ES75209517551006251525,TRX_N-00298-15855911,2022-09-08T07:23:08,Donostia,expenses,education,-55.07,3093.4
buyer_5,Sara,,1994-03-12,ES75209517551006251525,TRX_N-00299-04188729,2022-09-08T03:02:13,Getxo,expenses,repairs,-81.23,3012.17
buyer_5,Sara,,1994-03-12,ES75209517551006251525,TRX_N-00300-48884308,2022-09-14T16:06:18,Donostia,expenses,cash,-100.0,2912.17
buyer_5,Sara,,1994-03-12,ES75209517551006251525,TRX_N-00301-52797700,2022-09-15T14:45:23,Donostia,expenses,cash,-100.0,2812.17
buyer_5,Sara,,1994-03-12,ES75209517551006251525,TRX_N-00302-24227536,2022-09-16T23:28:43,Donostia,expenses,transport,-45.03,2767.14
buyer_5,Sara,,1994-03-12,ES75209517551006251525,TRX_N-00303-06629315,2022-09-17T08:58:21,Zarautz,expenses,leisure,-47.91,2719.23
buyer_5,Sara,,1994-03-12,ES75209517551006251525,TRX_N-00304-28232965,2022-09-17T13:29:14,Donostia,expenses,education,-43.87,2675.36
buyer_5,Sara,,1994-03-12,ES75209517551006251525,TRX_N-00305-35418330,2022-09-17T15:45:03,Lasarte-Oria,expenses,cash,-100.0,2575.36
buyer_5,Sara,,1994-03-12,ES75209517551006251525,TRX_N-00306-30504085,2022-09-17T13:57:29,Donostia,expenses,repairs,-238.73,2336.63
buyer_5,Sara,,1994-03-12,ES75209517551006251525,TRX_N-00307-01950631,2022-09-18T13:18:47,Donostia,expenses,leisure,-83.11,2253.52
buyer_5,Sara,,1994-03-12,ES75209517551006251525,TRX_N-00308-66235255,2022-09-19T13:51:29,Donostia,expenses,food,-119.46,2134.06
buyer_5,Sara,,1994-03-12,ES75209517551006251525,TRX_N-00309-93908322,2022-09-20T08:14:21,Donostia,expenses,food,-90.22,2043.84
buyer_5,Sara,,1994-03-12,ES75209517551006251525,TRX_N-00310-99263384,2022-09-20T08:42:20,Donostia,expenses,transport,-45.87,1997.97
buyer_5,Sara,,1994-03-12,ES75209517551006251525,TRX_N-00311-10207519,2022-09-21T18:28:50,Donostia,expenses,food,-81.46,1916.51
buyer_5,Sara,,1994-03-12,ES75209517551006251525,TRX_N-00312-92968843,2022-09-21T11:34:18,Donostia,expenses,healthcare,-89.37,1827.14
buyer_5,Sara,,1994-03-12,ES75209517551006251525,TRX_N-00313-83746004,2022-09-23T14:32:31,Donostia,expenses,repairs,-307.31,1519.83
buyer_5,Sara,,1994-03-12,ES75209517551006251525,TRX_N-00314-94757359,2022-09-27T09:17:01,Donostia,expenses,food,-65.42,1454.41
buyer_5,Sara,,1994-03-12,ES75209517551006251525,TRX_N-00315-94498400,2022-09-27T10:04:15,Donostia,expenses,cash,-100.0,1354.41
buyer_5,Sara,,1994-03-12,ES75209517551006251525,TRX_N-00316-05830914,2022-09-29T21:11:06,Donostia,expenses,leisure,-34.01,1320.4
buyer_5,Sara,,1994-03-12,ES75209517551006251525,TRX_N-00317-54108214,2022-10-01T20:40:12,Donostia,incomes,salary,2342.59,3662.99
buyer_5,Sara,,1994-03-12,ES75209517551006251525,TRX_N-00318-40883338,2022-10-01T20:40:12,Donostia,incomes,salary_partner,2567.69,6230.68
buyer_5,Sara,,1994-03-12,ES75209517551006251525,TRX_N-00319-05057574,2022-10-01T08:28:45,Donostia,expenses,repairs,-163.76,6066.92
buyer_5,Sara,,1994-03-12,ES75209517551006251525,TRX_N-00320-52556522,2022-10-04T17:19:27,Donostia,expenses,mortgage,-754.18,5312.74
buyer_5,Sara,,1994-03-12,ES75209517551006251525,TRX_N-00321-19694377,2022-10-05T10:36:49,Donostia,expenses,phone,-38.17,5274.57
buyer_5,Sara,,1994-03-12,ES75209517551006251525,TRX_N-00322-74505485,2022-10-05T01:34:41,Donostia,expenses,repairs,-166.57,5108.0
buyer_5,Sara,,1994-03-12,ES75209517551006251525,TRX_N-00323-22938290,2022-10-06T08:30:48,Donostia,expenses,gas,-68.18,5039.82
buyer_5,Sara,,1994-03-12,ES75209517551006251525,TRX_N-00324-08042290,2022-10-06T15:59:45,Donostia,expenses,cash,-100.0,4939.82
buyer_5,Sara,,1994-03-12,ES75209517551006251525,TRX_N-00325-49579833,2022-10-08T15:39:59,Donostia,expenses,water,-20.93,4918.89
buyer_5,Sara,,1994-03-12,ES75209517551006251525,TRX_N-00326-54825688,2022-10-08T08:02:51,Donostia,expenses,electricity,-26.54,4892.35
buyer_5,Sara,,1994-03-12,ES75209517551006251525,TRX_N-00327-15703482,2022-10-08T11:22:22,Donostia,expenses,internet,-42.0,4850.35
buyer_5,Sara,,1994-03-12,ES75209517551006251525,TRX_N-00328-02445409,2022-10-08T15:13:56,Donostia,expenses,healthcare,-186.5,4663.85
buyer_5,Sara,,1994-03-12,ES75209517551006251525,TRX_N-00329-40645242,2022-10-09T08:41:52,Donostia,expenses,food,-93.39,4570.46
buyer_5,Sara,,1994-03-12,ES75209517551006251525,TRX_N-00330-72330368,2022-10-13T14:57:30,Donostia,expenses,travel,-1348.38,3222.08
buyer_5,Sara,,1994-03-12,ES75209517551006251525,TRX_N-00331-14948815,2022-10-14T10:46:40,Donostia,expenses,education,-64.39,3157.69
buyer_5,Sara,,1994-03-12,ES75209517551006251525,TRX_N-00332-31292514,2022-10-15T07:38:03,Galdakao,expenses,gifts,-808.62,2349.07
buyer_5,Sara,,1994-03-12,ES75209517551006251525,TRX_N-00333-48768378,2022-10-16T05:33:12,Donostia,expenses,leisure,-74.52,2274.55
buyer_5,Sara,,1994-03-12,ES75209517551006251525,TRX_N-00334-80563370,2022-10-18T10:28:42,Donostia,expenses,food,-109.56,2164.99
buyer_5,Sara,,1994-03-12,ES75209517551006251525,TRX_N-00335-06380796,2022-10-20T13:54:54,Donostia,expenses,leisure,-28.24,2136.75
buyer_5,Sara,,1994-03-12,ES75209517551006251525,TRX_N-00336-96362988,2022-10-21T15:34:10,Bermeo,expenses,gifts,-403.97,1732.78
buyer_5,Sara,,1994-03-12,ES75209517551006251525,TRX_N-00337-13474494,2022-10-23T07:16:45,Donostia,expenses,food,-107.73,1625.05
buyer_5,Sara,,1994-03-12,ES75209517551006251525,TRX_N-00338-16240647,2022-10-23T17:56:41,Donostia,expenses,leisure,-24.5,1600.55
buyer_5,Sara,,1994-03-12,ES75209517551006251525,TRX_N-00339-42970886,2022-10-23T09:43:38,Donostia,expenses,education,-48.85,1551.7
buyer_5,Sara,,1994-03-12,ES75209517551006251525,TRX_N-00340-82904641,2022-10-27T05:38:10,Donostia,expenses,food,-106.86,1444.84
buyer_5,Sara,,1994-03-12,ES75209517551006251525,TRX_N-00341-48501877,2022-10-29T15:08:02,Donostia,expenses,food,-73.09,1371.75
buyer_5,Sara,,1994-03-12,ES75209517551006251525,TRX_N-00342-21488390,2022-10-29T15:40:55,Bermeo,expenses,gifts,-670.69,701.06
buyer_5,Sara,,1994-03-12,ES75209517551006251525,TRX_N-00343-11536341,2022-10-30T13:39:08,Donostia,expenses,healthcare,-90.85,610.21
buyer_5,Sara,,1994-03-12,ES75209517551006251525,TRX_N-00344-68036706,2022-10-31T23:54:46,Salvatierra/Agurain,expenses,cash,-100.0,510.21
buyer_5,Sara,,1994-03-12,ES75209517551006251525,TRX_N-00345-58404739,2022-10-31T08:31:29,Donostia,expenses,repairs,-250.13,260.08
buyer_5,Sara,,1994-03-12,ES75209517551006251525,TRX_N-00346-83245633,2022-11-01T16:17:40,Donostia,incomes,salary,2342.59,2602.67
buyer_5,Sara,,1994-03-12,ES75209517551006251525,TRX_N-00347-06260782,2022-11-01T16:17:40,Donostia,incomes,salary_partner,2567.69,5170.36
buyer_5,Sara,,1994-03-12,ES75209517551006251525,TRX_N-00348-86284591,2022-11-01T16:17:40,Donostia,incomes,extra_income,234.39,5404.75
buyer_5,Sara,,1994-03-12,ES75209517551006251525,TRX_N-00349-56893551,2022-11-02T13:32:49,Donostia,expenses,leisure,-81.99,5322.76
buyer_5,Sara,,1994-03-12,ES75209517551006251525,TRX_N-00350-03820890,2022-11-02T17:17:50,Donostia,expenses,repairs,-221.28,5101.48
buyer_5,Sara,,1994-03-12,ES75209517551006251525,TRX_N-00351-30027083,2022-11-04T19:23:56,Donostia,expenses,mortgage,-754.18,4347.3
buyer_5,Sara,,1994-03-12,ES75209517551006251525,TRX_N-00352-15785539,2022-11-05T20:03:02,Donostia,expenses,cash,-100.0,4247.3
buyer_5,Sara,,1994-03-12,ES75209517551006251525,TRX_N-00353-95381667,2022-11-08T15:16:24,Donostia,expenses,water,-27.14,4220.16
buyer_5,Sara,,1994-03-12,ES75209517551006251525,TRX_N-00354-58726559,2022-11-08T20:46:02,Donostia,expenses,electricity,-87.23,4132.93
buyer_5,Sara,,1994-03-12,ES75209517551006251525,TRX_N-00355-66408163,2022-11-08T21:12:30,Donostia,expenses,gas,-37.58,4095.35
buyer_5,Sara,,1994-03-12,ES75209517551006251525,TRX_N-00356-33613311,2022-11-08T15:18:06,Donostia,expenses,internet,-42.0,4053.35
buyer_5,Sara,,1994-03-12,ES75209517551006251525,TRX_N-00357-06175278,2022-11-08T12:38:41,Donostia,expenses,phone,-31.7,4021.65
buyer_5,Sara,,1994-03-12,ES75209517551006251525,TRX_N-00358-13072380,2022-11-08T09:40:54,Vitoria-Gasteiz,expenses,food,-119.39,3902.26
buyer_5,Sara,,1994-03-12,ES75209517551006251525,TRX_N-00359-24955639,2022-11-10T16:53:17,Donostia,expenses,gifts,-545.04,3357.22
buyer_5,Sara,,1994-03-12,ES75209517551006251525,TRX_N-00360-91586653,2022-11-11T16:15:04,Donostia,expenses,food,-124.3,3232.92
buyer_5,Sara,,1994-03-12,ES75209517551006251525,TRX_N-00361-98069529,2022-11-11T11:28:27,Portugalete,expenses,cash,-100.0,3132.92
buyer_5,Sara,,1994-03-12,ES75209517551006251525,TRX_N-00362-55694567,2022-11-12T12:15:23,Donostia,expenses,education,-43.03,3089.89
buyer_5,Sara,,1994-03-12,ES75209517551006251525,TRX_N-00363-72059926,2022-11-13T16:22:51,Elciego,expenses,food,-110.95,2978.94
buyer_5,Sara,,1994-03-12,ES75209517551006251525,TRX_N-00364-44721287,2022-11-13T08:40:14,Donostia,expenses,education,-43.61,2935.33
buyer_5,Sara,,1994-03-12,ES75209517551006251525,TRX_N-00365-31480070,2022-11-15T20:48:02,Donostia,expenses,food,-80.74,2854.59
buyer_5,Sara,,1994-03-12,ES75209517551006251525,TRX_N-00366-80028977,2022-11-15T11:26:30,Galdakao,expenses,repairs,-255.34,2599.25
buyer_5,Sara,,1994-03-12,ES75209517551006251525,TRX_N-00367-67101015,2022-11-16T08:51:59,Donostia,expenses,leisure,-56.44,2542.81
buyer_5,Sara,,1994-03-12,ES75209517551006251525,TRX_N-00368-29446655,2022-11-18T19:50:31,Donostia,expenses,leisure,-83.21,2459.6
buyer_5,Sara,,1994-03-12,ES75209517551006251525,TRX_N-00369-95944042,2022-11-20T20:06:38,Donostia,expenses,appliances,-329.91,2129.69
buyer_5,Sara,,1994-03-12,ES75209517551006251525,TRX_N-00370-10563830,2022-11-22T11:06:35,Donostia,expenses,transport,-48.87,2080.82
buyer_5,Sara,,1994-03-12,ES75209517551006251525,TRX_N-00371-64816703,2022-11-23T16:59:10,Donostia,expenses,food,-91.41,1989.41
buyer_5,Sara,,1994-03-12,ES75209517551006251525,TRX_N-00372-45145485,2022-11-24T06:17:57,Donostia,expenses,transport,-66.14,1923.27
buyer_5,Sara,,1994-03-12,ES75209517551006251525,TRX_N-00373-22129196,2022-11-24T19:02:44,Sopela,expenses,leisure,-49.49,1873.78
buyer_5,Sara,,1994-03-12,ES75209517551006251525,TRX_N-00374-18593663,2022-11-24T04:05:03,Donostia,expenses,education,-43.1,1830.68
buyer_5,Sara,,1994-03-12,ES75209517551006251525,TRX_N-00375-42615769,2022-11-25T16:10:40,Donostia,expenses,transport,-64.97,1765.71
buyer_5,Sara,,1994-03-12,ES75209517551006251525,TRX_N-00376-95417350,2022-11-25T00:15:31,Getxo,expenses,leisure,-33.48,1732.23
buyer_5,Sara,,1994-03-12,ES75209517551006251525,TRX_N-00377-24357174,2022-11-25T19:01:49,Donostia,expenses,cash,-100.0,1632.23
buyer_5,Sara,,1994-03-12,ES75209517551006251525,TRX_N-00378-78075904,2022-11-25T12:10:24,Arrasate,expenses,gifts,-522.25,1109.98
buyer_5,Sara,,1994-03-12,ES75209517551006251525,TRX_N-00379-89423650,2022-11-26T22:37:32,Donostia,expenses,education,-60.88,1049.1
buyer_5,Sara,,1994-03-12,ES75209517551006251525,TRX_N-00380-52998872,2022-11-27T15:37:27,Eibar,expenses,transport,-89.34,959.76
buyer_5,Sara,,1994-03-12,ES75209517551006251525,TRX_N-00381-53214663,2022-11-27T19:58:23,Donostia,expenses,travel,-337.92,621.84
buyer_5,Sara,,1994-03-12,ES75209517551006251525,TRX_N-00382-56175682,2022-11-27T17:32:14,Hondarribia,expenses,repairs,-185.32,436.52
buyer_5,Sara,,1994-03-12,ES75209517551006251525,TRX_N-00383-88184233,2022-11-28T12:02:13,Erandio,expenses,healthcare,-85.88,350.64
buyer_5,Sara,,1994-03-12,ES75209517551006251525,TRX_N-00384-58682804,2022-11-29T16:10:45,Donostia,expenses,healthcare,-79.42,271.22
buyer_5,Sara,,1994-03-12,ES75209517551006251525,TRX_N-00385-55658947,2022-11-30T19:34:54,Andoain,expenses,leisure,-29.14,242.08
buyer_5,Sara,,1994-03-12,ES75209517551006251525,TRX_N-00386-07445680,2022-12-01T15:15:38,Donostia,incomes,salary,2342.59,2584.67
buyer_5,Sara,,1994-03-12,ES75209517551006251525,TRX_N-00387-43657389,2022-12-01T15:15:38,Donostia,incomes,salary_partner,2567.69,5152.36
buyer_5,Sara,,1994-03-12,ES75209517551006251525,TRX_N-00388-32261554,2022-12-01T15:15:38,Donostia,incomes,salary_bonus,1709.52,6861.88
buyer_5,Sara,,1994-03-12,ES75209517551006251525,TRX_N-00389-49704084,2022-12-01T15:15:38,Donostia,incomes,salary_partner_bonus,1880.32,8742.2
buyer_5,Sara,,1994-03-12,ES75209517551006251525,TRX_N-00390-58626807,2022-12-01T12:16:10,Donostia,expenses,cash,-100.0,8642.2
buyer_5,Sara,,1994-03-12,ES75209517551006251525,TRX_N-00391-22354117,2022-12-03T03:39:21,Donostia,expenses,leisure,-22.83,8619.37
buyer_5,Sara,,1994-03-12,ES75209517551006251525,TRX_N-00392-66462928,2022-12-04T17:13:52,Donostia,expenses,mortgage,-754.18,7865.19
buyer_5,Sara,,1994-03-12,ES75209517551006251525,TRX_N-00393-04871254,2022-12-04T15:50:09,Donostia,expenses,cash,-100.0,7765.19
buyer_5,Sara,,1994-03-12,ES75209517551006251525,TRX_N-00394-25986374,2022-12-06T17:52:17,Donostia,expenses,gas,-90.31,7674.88
buyer_5,Sara,,1994-03-12,ES75209517551006251525,TRX_N-00395-69911019,2022-12-06T09:42:34,Donostia,expenses,phone,-32.73,7642.15
buyer_5,Sara,,1994-03-12,ES75209517551006251525,TRX_N-00396-32431491,2022-12-07T08:52:40,Donostia,expenses,electricity,-51.28,7590.87
buyer_5,Sara,,1994-03-12,ES75209517551006251525,TRX_N-00397-69042889,2022-12-07T18:23:07,Donostia,expenses,internet,-42.0,7548.87
buyer_5,Sara,,1994-03-12,ES75209517551006251525,TRX_N-00398-55475974,2022-12-08T15:22:42,Donostia,expenses,water,-20.99,7527.88
buyer_5,Sara,,1994-03-12,ES75209517551006251525,TRX_N-00399-66973330,2022-12-08T09:17:47,Errenteria,expenses,food,-77.99,7449.89
buyer_5,Sara,,1994-03-12,ES75209517551006251525,TRX_N-00400-00529911,2022-12-09T19:23:44,Donostia,expenses,repairs,-227.6,7222.29
buyer_5,Sara,,1994-03-12,ES75209517551006251525,TRX_N-00401-41157455,2022-12-10T22:49:25,Errenteria,expenses,transport,-42.02,7180.27
buyer_5,Sara,,1994-03-12,ES75209517551006251525,TRX_N-00402-39330823,2022-12-10T19:04:21,Donostia,expenses,gifts,-78.29,7101.98
buyer_5,Sara,,1994-03-12,ES75209517551006251525,TRX_N-00403-21585762,2022-12-12T15:43:36,Donostia,expenses,cash,-100.0,7001.98
buyer_5,Sara,,1994-03-12,ES75209517551006251525,TRX_N-00404-77670177,2022-12-16T15:35:00,Donostia,expenses,transport,-87.32,6914.66
buyer_5,Sara,,1994-03-12,ES75209517551006251525,TRX_N-00405-35428253,2022-12-16T09:58:41,Leioa,expenses,leisure,-19.87,6894.79
buyer_5,Sara,,1994-03-12,ES75209517551006251525,TRX_N-00406-49746540,2022-12-16T10:25:27,Salvatierra/Agurain,expenses,appliances,-117.27,6777.52
buyer_5,Sara,,1994-03-12,ES75209517551006251525,TRX_N-00407-54164583,2022-12-17T15:00:38,Donostia,expenses,transport,-45.57,6731.95
buyer_5,Sara,,1994-03-12,ES75209517551006251525,TRX_N-00408-13713469,2022-12-19T16:07:41,Donostia,expenses,leisure,-53.74,6678.21
buyer_5,Sara,,1994-03-12,ES75209517551006251525,TRX_N-00409-16627685,2022-12-19T13:32:40,Donostia,expenses,repairs,-198.63,6479.58
buyer_5,Sara,,1994-03-12,ES75209517551006251525,TRX_N-00410-25253614,2022-12-20T20:12:44,Donostia,expenses,transport,-80.88,6398.7
buyer_5,Sara,,1994-03-12,ES75209517551006251525,TRX_N-00411-60614265,2022-12-20T10:25:10,Portugalete,expenses,education,-44.95,6353.75
buyer_5,Sara,,1994-03-12,ES75209517551006251525,TRX_N-00412-86775750,2022-12-20T16:19:02,Donostia,expenses,travel,-790.53,5563.22
buyer_5,Sara,,1994-03-12,ES75209517551006251525,TRX_N-00413-20112016,2022-12-21T13:40:21,Hondarribia,expenses,repairs,-210.34,5352.88
buyer_5,Sara,,1994-03-12,ES75209517551006251525,TRX_N-00414-55253606,2022-12-22T20:45:02,Donostia,expenses,cash,-100.0,5252.88
buyer_5,Sara,,1994-03-12,ES75209517551006251525,TRX_N-00415-05108655,2022-12-22T16:45:17,Elciego,expenses,gifts,-663.36,4589.52
buyer_5,Sara,,1994-03-12,ES75209517551006251525,TRX_N-00416-10263932,2022-12-23T19:52:17,Donostia,expenses,clothing,-64.09,4525.43
buyer_5,Sara,,1994-03-12,ES75209517551006251525,TRX_N-00417-82471351,2022-12-23T20:08:22,Donostia,expenses,repairs,-123.77,4401.66
buyer_5,Sara,,1994-03-12,ES75209517551006251525,TRX_N-00418-42804479,2022-12-25T12:02:01,Erandio,expenses,travel,-1032.97,3368.69
buyer_5,Sara,,1994-03-12,ES75209517551006251525,TRX_N-00419-92611031,2022-12-27T08:49:40,Donostia,expenses,food,-66.82,3301.87
buyer_5,Sara,,1994-03-12,ES75209517551006251525,TRX_N-00420-99425747,2022-12-27T16:03:18,Donostia,expenses,education,-66.16,3235.71
buyer_5,Sara,,1994-03-12,ES75209517551006251525,TRX_N-00421-42889054,2022-12-28T18:27:27,Donostia,expenses,food,-62.74,3172.97
buyer_5,Sara,,1994-03-12,ES75209517551006251525,TRX_N-00422-00964320,2022-12-28T20:25:06,Donostia,expenses,repairs,-212.36,2960.61
buyer_5,Sara,,1994-03-12,ES75209517551006251525,TRX_N-00423-58760699,2022-12-29T16:03:24,Donostia,expenses,healthcare,-58.34,2902.27
buyer_5,Sara,,1994-03-12,ES75209517551006251525,TRX_N-00424-67550597,2022-12-29T21:57:46,Donostia,expenses,education,-42.84,2859.43
buyer_5,Sara,,1994-03-12,ES75209517551006251525,TRX_N-00425-21534882,2022-12-30T10:45:42,Donostia,expenses,cash,-100.0,2759.43
buyer_5,Sara,,1994-03-12,ES75209517551006251525,TRX_N-00426-03883415,2022-12-31T13:25:46,Donostia,expenses,transport,-42.34,2717.09
buyer_5,Sara,,1994-03-12,ES75209517551006251525,TRX_N-00427-80885619,2022-12-31T14:10:44,Sestao,expenses,clothing,-112.45,2604.64
buyer_5,Sara,,1994-03-12,ES75209517551006251525,TRX_N-00428-15174229,2022-12-31T21:39:53,Donostia,expenses,healthcare,-126.94,2477.7
buyer_5,Sara,,1994-03-12,ES75209517551006251525,TRX_N-00429-05763852,2023-01-01T18:24:27,Donostia,incomes,salary,2420.36,4898.06
buyer_5,Sara,,1994-03-12,ES75209517551006251525,TRX_N-00430-38333969,2023-01-01T18:24:27,Donostia,incomes,salary_partner,2652.93,7550.99
buyer_5,Sara,,1994-03-12,ES75209517551006251525,TRX_N-00431-86184603,2023-01-01T09:40:58,Irun,expenses,appliances,-107.45,7443.54
buyer_5,Sara,,1994-03-12,ES75209517551006251525,TRX_N-00432-12869777,2023-01-02T08:46:48,Donostia,expenses,food,-120.21,7323.33
buyer_5,Sara,,1994-03-12,ES75209517551006251525,TRX_N-00433-03049609,2023-01-02T18:11:18,Donostia,expenses,healthcare,-75.94,7247.39
buyer_5,Sara,,1994-03-12,ES75209517551006251525,TRX_N-00434-98293463,2023-01-03T19:32:56,Donostia,expenses,transport,-60.63,7186.76
buyer_5,Sara,,1994-03-12,ES75209517551006251525,TRX_N-00435-56784396,2023-01-04T15:06:51,Donostia,expenses,mortgage,-754.18,6432.58
buyer_5,Sara,,1994-03-12,ES75209517551006251525,TRX_N-00436-12485436,2023-01-05T18:50:25,Donostia,expenses,transport,-63.69,6368.89
buyer_5,Sara,,1994-03-12,ES75209517551006251525,TRX_N-00437-34813648,2023-01-05T07:27:18,Donostia,expenses,leisure,-82.81,6286.08
buyer_5,Sara,,1994-03-12,ES75209517551006251525,TRX_N-00438-62002019,2023-01-05T22:03:59,Donostia,expenses,repairs,-184.5,6101.58
buyer_5,Sara,,1994-03-12,ES75209517551006251525,TRX_N-00439-34159100,2023-01-06T07:43:38,Donostia,expenses,food,-118.26,5983.32
buyer_5,Sara,,1994-03-12,ES75209517551006251525,TRX_N-00440-52700309,2023-01-06T08:51:53,Donostia,expenses,transport,-70.63,5912.69
buyer_5,Sara,,1994-03-12,ES75209517551006251525,TRX_N-00441-19702565,2023-01-07T11:31:05,Donostia,expenses,gas,-95.66,5817.03
buyer_5,Sara,,1994-03-12,ES75209517551006251525,TRX_N-00442-61341639,2023-01-08T07:26:49,Donostia,expenses,phone,-37.06,5779.97
buyer_5,Sara,,1994-03-12,ES75209517551006251525,TRX_N-00443-76300316,2023-01-08T18:06:06,Donostia,expenses,water,-41.96,5738.01
buyer_5,Sara,,1994-03-12,ES75209517551006251525,TRX_N-00444-33379217,2023-01-08T23:20:11,Donostia,expenses,electricity,-43.68,5694.33
buyer_5,Sara,,1994-03-12,ES75209517551006251525,TRX_N-00445-03558419,2023-01-08T22:31:52,Donostia,expenses,internet,-42.0,5652.33
buyer_5,Sara,,1994-03-12,ES75209517551006251525,TRX_N-00446-06322446,2023-01-08T11:32:09,Donostia,expenses,food,-111.55,5540.78
buyer_5,Sara,,1994-03-12,ES75209517551006251525,TRX_N-00447-66889096,2023-01-08T11:15:48,Donostia,expenses,healthcare,-85.07,5455.71
buyer_5,Sara,,1994-03-12,ES75209517551006251525,TRX_N-00448-56477802,2023-01-08T11:03:15,Bilbao,expenses,gifts,-48.35,5407.36
buyer_5,Sara,,1994-03-12,ES75209517551006251525,TRX_N-00449-91775046,2023-01-09T12:23:05,Donostia,expenses,food,-70.56,5336.8
buyer_5,Sara,,1994-03-12,ES75209517551006251525,TRX_N-00450-00727081,2023-01-09T15:40:44,Donostia,expenses,leisure,-67.33,5269.47
buyer_5,Sara,,1994-03-12,ES75209517551006251525,TRX_N-00451-95142613,2023-01-10T20:11:08,Donostia,expenses,cash,-100.0,5169.47
buyer_5,Sara,,1994-03-12,ES75209517551006251525,TRX_N-00452-78898710,2023-01-10T22:50:37,Donostia,expenses,repairs,-237.02,4932.45
buyer_5,Sara,,1994-03-12,ES75209517551006251525,TRX_N-00453-97223084,2023-01-12T10:57:59,Donostia,expenses,leisure,-38.09,4894.36
buyer_5,Sara,,1994-03-12,ES75209517551006251525,TRX_N-00454-26143090,2023-01-13T12:45:01,Donostia,expenses,leisure,-81.83,4812.53
buyer_5,Sara,,1994-03-12,ES75209517551006251525,TRX_N-00455-20267098,2023-01-13T11:32:27,Donostia,expenses,repairs,-299.95,4512.58
buyer_5,Sara,,1994-03-12,ES75209517551006251525,TRX_N-00456-12870370,2023-01-14T18:37:20,Donostia,expenses,cash,-100.0,4412.58
buyer_5,Sara,,1994-03-12,ES75209517551006251525,TRX_N-00457-93231968,2023-01-16T18:14:46,Donostia,expenses,food,-64.61,4347.97
buyer_5,Sara,,1994-03-12,ES75209517551006251525,TRX_N-00458-10195333,2023-01-16T20:25:12,Donostia,expenses,cash,-100.0,4247.97
buyer_5,Sara,,1994-03-12,ES75209517551006251525,TRX_N-00459-00477739,2023-01-17T17:35:45,Donostia,expenses,food,-102.3,4145.67
buyer_5,Sara,,1994-03-12,ES75209517551006251525,TRX_N-00460-99347044,2023-01-17T09:16:35,Donostia,expenses,leisure,-45.95,4099.72
buyer_5,Sara,,1994-03-12,ES75209517551006251525,TRX_N-00461-89035518,2023-01-21T14:23:03,Donostia,expenses,healthcare,-164.78,3934.94
buyer_5,Sara,,1994-03-12,ES75209517551006251525,TRX_N-00462-27416628,2023-01-22T09:40:59,Donostia,expenses,gifts,-115.79,3819.15
buyer_5,Sara,,1994-03-12,ES75209517551006251525,TRX_N-00463-51502718,2023-01-23T09:10:25,Sopela,expenses,appliances,-123.0,3696.15
buyer_5,Sara,,1994-03-12,ES75209517551006251525,TRX_N-00464-47939016,2023-01-24T18:22:18,Barakaldo,expenses,repairs,-138.08,3558.07
buyer_5,Sara,,1994-03-12,ES75209517551006251525,TRX_N-00465-87345381,2023-01-25T07:18:45,Bilbao,expenses,transport,-43.81,3514.26
buyer_5,Sara,,1994-03-12,ES75209517551006251525,TRX_N-00466-17285253,2023-01-25T18:03:22,Donostia,expenses,travel,-1584.17,1930.09
buyer_5,Sara,,1994-03-12,ES75209517551006251525,TRX_N-00467-90320297,2023-01-28T22:14:05,Donostia,expenses,repairs,-325.82,1604.27
buyer_5,Sara,,1994-03-12,ES75209517551006251525,TRX_N-00468-43241897,2023-01-29T11:35:14,Donostia,expenses,cash,-100.0,1504.27
buyer_5,Sara,,1994-03-12,ES75209517551006251525,TRX_N-00469-06185918,2023-01-30T21:01:22,Donostia,expenses,food,-106.26,1398.01
buyer_5,Sara,,1994-03-12,ES75209517551006251525,TRX_N-00470-96597335,2023-01-31T23:01:09,Donostia,expenses,food,-89.09,1308.92
buyer_5,Sara,,1994-03-12,ES75209517551006251525,TRX_N-00471-62332943,2023-02-01T13:05:31,Donostia,incomes,salary,2420.36,3729.28
buyer_5,Sara,,1994-03-12,ES75209517551006251525,TRX_N-00472-70537409,2023-02-01T13:05:31,Donostia,incomes,salary_partner,2652.93,6382.21
buyer_5,Sara,,1994-03-12,ES75209517551006251525,TRX_N-00473-23861669,2023-02-01T13:05:31,Donostia,incomes,extra_income,234.39,6616.6
buyer_5,Sara,,1994-03-12,ES75209517551006251525,TRX_N-00474-34735135,2023-02-02T20:42:52,Lasarte-Oria,expenses,cash,-100.0,6516.6
buyer_5,Sara,,1994-03-12,ES75209517551006251525,TRX_N-00475-49276207,2023-02-02T19:54:48,Donostia,expenses,gifts,-458.87,6057.73
buyer_5,Sara,,1994-03-12,ES75209517551006251525,TRX_N-00476-56851643,2023-02-04T09:53:36,Donostia,expenses,mortgage,-754.18,5303.55
buyer_5,Sara,,1994-03-12,ES75209517551006251525,TRX_N-00477-36301225,2023-02-04T17:49:19,Donostia,expenses,education,-76.09,5227.46
buyer_5,Sara,,1994-03-12,ES75209517551006251525,TRX_N-00478-77877257,2023-02-05T16:29:16,Donostia,expenses,water,-33.87,5193.59
buyer_5,Sara,,1994-03-12,ES75209517551006251525,TRX_N-00479-52008101,2023-02-05T05:18:43,Donostia,expenses,gas,-93.99,5099.6
buyer_5,Sara,,1994-03-12,ES75209517551006251525,TRX_N-00480-86475996,2023-02-06T15:26:35,Donostia,expenses,education,-56.77,5042.83
buyer_5,Sara,,1994-03-12,ES75209517551006251525,TRX_N-00481-60806545,2023-02-07T16:38:40,Donostia,expenses,phone,-43.2,4999.63
buyer_5,Sara,,1994-03-12,ES75209517551006251525,TRX_N-00482-01780498,2023-02-07T16:03:17,Donostia,expenses,repairs,-147.95,4851.68
buyer_5,Sara,,1994-03-12,ES75209517551006251525,TRX_N-00483-82707346,2023-02-08T16:11:44,Donostia,expenses,electricity,-36.47,4815.21
buyer_5,Sara,,1994-03-12,ES75209517551006251525,TRX_N-00484-27912197,2023-02-08T10:08:00,Donostia,expenses,internet,-42.0,4773.21
buyer_5,Sara,,1994-03-12,ES75209517551006251525,TRX_N-00485-13303543,2023-02-11T09:13:06,Galdakao,expenses,transport,-84.42,4688.79
buyer_5,Sara,,1994-03-12,ES75209517551006251525,TRX_N-00486-28264511,2023-02-11T16:55:07,Donostia,expenses,cash,-100.0,4588.79
buyer_5,Sara,,1994-03-12,ES75209517551006251525,TRX_N-00487-20773165,2023-02-12T19:26:48,Donostia,expenses,food,-95.88,4492.91
buyer_5,Sara,,1994-03-12,ES75209517551006251525,TRX_N-00488-19953136,2023-02-14T11:09:41,Donostia,expenses,leisure,-28.76,4464.15
buyer_5,Sara,,1994-03-12,ES75209517551006251525,TRX_N-00489-37410009,2023-02-15T17:26:28,Hondarribia,expenses,leisure,-75.83,4388.32
buyer_5,Sara,,1994-03-12,ES75209517551006251525,TRX_N-00490-72686519,2023-02-16T14:54:23,Donostia,expenses,clothing,-115.75,4272.57
buyer_5,Sara,,1994-03-12,ES75209517551006251525,TRX_N-00491-25295330,2023-02-16T11:51:28,Donostia,expenses,cash,-100.0,4172.57
buyer_5,Sara,,1994-03-12,ES75209517551006251525,TRX_N-00492-46816092,2023-02-17T04:14:00,Donostia,expenses,food,-96.68,4075.89
buyer_5,Sara,,1994-03-12,ES75209517551006251525,TRX_N-00493-94182357,2023-02-19T15:21:11,Donostia,expenses,leisure,-64.63,4011.26
buyer_5,Sara,,1994-03-12,ES75209517551006251525,TRX_N-00494-54283038,2023-02-19T09:45:43,Donostia,expenses,cash,-100.0,3911.26
buyer_5,Sara,,1994-03-12,ES75209517551006251525,TRX_N-00495-64354753,2023-02-22T06:53:19,Donostia,expenses,gifts,-152.81,3758.45
buyer_5,Sara,,1994-03-12,ES75209517551006251525,TRX_N-00496-90258649,2023-02-23T11:40:38,Donostia,expenses,cash,-100.0,3658.45
buyer_5,Sara,,1994-03-12,ES75209517551006251525,TRX_N-00497-07570084,2023-02-23T15:17:23,Irun,expenses,travel,-1162.2,2496.25
buyer_5,Sara,,1994-03-12,ES75209517551006251525,TRX_N-00498-18021837,2023-02-24T21:50:23,Donostia,expenses,food,-79.1,2417.15
buyer_5,Sara,,1994-03-12,ES75209517551006251525,TRX_N-00499-72246953,2023-02-25T11:39:30,Donostia,expenses,food,-97.07,2320.08
buyer_5,Sara,,1994-03-12,ES75209517551006251525,TRX_N-00500-23121343,2023-02-25T19:57:03,Donostia,expenses,healthcare,-171.86,2148.22
buyer_5,Sara,,1994-03-12,ES75209517551006251525,TRX_N-00501-13642778,2023-02-27T16:13:32,Donostia,expenses,gifts,-372.25,1775.97
buyer_5,Sara,,1994-03-12,ES75209517551006251525,TRX_N-00502-25108644,2023-02-28T17:21:10,Donostia,expenses,healthcare,-71.94,1704.03
buyer_5,Sara,,1994-03-12,ES75209517551006251525,TRX_N-00503-03880391,2023-03-01T19:05:18,Donostia,incomes,salary,2420.36,4124.39
buyer_5,Sara,,1994-03-12,ES75209517551006251525,TRX_N-00504-59574643,2023-03-01T19:05:18,Donostia,incomes,salary_partner,2652.93,6777.32
buyer_5,Sara,,1994-03-12,ES75209517551006251525,TRX_N-00505-76594933,2023-03-02T21:28:35,Labastida,expenses,leisure,-45.0,6732.32
buyer_5,Sara,,1994-03-12,ES75209517551006251525,TRX_N-00506-78615859,2023-03-03T13:02:42,Donostia,expenses,healthcare,-74.9,6657.42
buyer_5,Sara,,1994-03-12,ES75209517551006251525,TRX_N-00507-25510478,2023-03-04T09:38:35,Donostia,expenses,mortgage,-754.18,5903.24
buyer_5,Sara,,1994-03-12,ES75209517551006251525,TRX_N-00508-85827402,2023-03-05T16:15:02,Donostia,expenses,food,-110.07,5793.17
buyer_5,Sara,,1994-03-12,ES75209517551006251525,TRX_N-00509-17865393,2023-03-05T23:19:00,Donostia,expenses,education,-50.73,5742.44
buyer_5,Sara,,1994-03-12,ES75209517551006251525,TRX_N-00510-71359312,2023-03-06T11:36:14,Donostia,expenses,water,-37.77,5704.67
buyer_5,Sara,,1994-03-12,ES75209517551006251525,TRX_N-00511-95102858,2023-03-06T12:24:38,Donostia,expenses,gas,-101.44,5603.23
buyer_5,Sara,,1994-03-12,ES75209517551006251525,TRX_N-00512-20254108,2023-03-06T12:03:26,Donostia,expenses,internet,-42.0,5561.23
buyer_5,Sara,,1994-03-12,ES75209517551006251525,TRX_N-00513-40711335,2023-03-06T19:59:50,Donostia,expenses,phone,-32.61,5528.62
buyer_5,Sara,,1994-03-12,ES75209517551006251525,TRX_N-00514-99163152,2023-03-08T15:32:40,Donostia,expenses,electricity,-79.78,5448.84
buyer_5,Sara,,1994-03-12,ES75209517551006251525,TRX_N-00515-12348563,2023-03-09T16:12:50,Donostia,expenses,food,-111.62,5337.22
buyer_5,Sara,,1994-03-12,ES75209517551006251525,TRX_N-00516-70831774,2023-03-09T21:47:43,Arrasate,expenses,repairs,-177.77,5159.45
buyer_5,Sara,,1994-03-12,ES75209517551006251525,TRX_N-00517-54197806,2023-03-10T20:45:29,Barakaldo,expenses,transport,-84.32,5075.13
buyer_5,Sara,,1994-03-12,ES75209517551006251525,TRX_N-00518-39177754,2023-03-10T02:16:28,Donostia,expenses,education,-47.15,5027.98
buyer_5,Sara,,1994-03-12,ES75209517551006251525,TRX_N-00519-35612688,2023-03-11T17:47:12,Donostia,expenses,repairs,-223.25,4804.73
buyer_5,Sara,,1994-03-12,ES75209517551006251525,TRX_N-00520-64466978,2023-03-12T14:14:40,Donostia,expenses,clothing,-56.03,4748.7
buyer_5,Sara,,1994-03-12,ES75209517551006251525,TRX_N-00521-11534829,2023-03-13T09:50:55,Donostia,expenses,cash,-100.0,4648.7
buyer_5,Sara,,1994-03-12,ES75209517551006251525,TRX_N-00522-71084292,2023-03-14T11:36:31,Donostia,expenses,clothing,-92.53,4556.17
buyer_5,Sara,,1994-03-12,ES75209517551006251525,TRX_N-00523-11823486,2023-03-15T08:24:25,Donostia,expenses,leisure,-21.86,4534.31
buyer_5,Sara,,1994-03-12,ES75209517551006251525,TRX_N-00524-42346025,2023-03-16T20:45:23,Donostia,expenses,transport,-81.92,4452.39
buyer_5,Sara,,1994-03-12,ES75209517551006251525,TRX_N-00525-66704739,2023-03-20T11:52:53,Donostia,expenses,food,-69.51,4382.88
buyer_5,Sara,,1994-03-12,ES75209517551006251525,TRX_N-00526-77255408,2023-03-20T10:32:04,Eibar,expenses,leisure,-33.71,4349.17
buyer_5,Sara,,1994-03-12,ES75209517551006251525,TRX_N-00527-20417499,2023-03-20T15:23:56,Donostia,expenses,education,-76.95,4272.22
buyer_5,Sara,,1994-03-12,ES75209517551006251525,TRX_N-00528-37779402,2023-03-22T12:32:16,Donostia,expenses,transport,-88.46,4183.76
buyer_5,Sara,,1994-03-12,ES75209517551006251525,TRX_N-00529-45557662,2023-03-22T02:21:08,Donostia,expenses,clothing,-60.7,4123.06
buyer_5,Sara,,1994-03-12,ES75209517551006251525,TRX_N-00530-05200464,2023-03-23T08:55:56,Donostia,expenses,transport,-58.33,4064.73
buyer_5,Sara,,1994-03-12,ES75209517551006251525,TRX_N-00531-53561811,2023-03-23T20:55:03,Donostia,expenses,repairs,-208.05,3856.68
buyer_5,Sara,,1994-03-12,ES75209517551006251525,TRX_N-00532-05314763,2023-03-24T12:57:53,Donostia,expenses,transport,-82.27,3774.41
buyer_5,Sara,,1994-03-12,ES75209517551006251525,TRX_N-00533-53417056,2023-03-24T14:16:33,Donostia,expenses,leisure,-24.69,3749.72
buyer_5,Sara,,1994-03-12,ES75209517551006251525,TRX_N-00534-46447473,2023-03-24T19:49:07,Donostia,expenses,repairs,-272.22,3477.5
buyer_5,Sara,,1994-03-12,ES75209517551006251525,TRX_N-00535-11569635,2023-03-27T08:18:33,Donostia,expenses,transport,-48.25,3429.25
buyer_5,Sara,,1994-03-12,ES75209517551006251525,TRX_N-00536-63244485,2023-03-29T13:42:38,Donostia,expenses,food,-93.98,3335.27
buyer_5,Sara,,1994-03-12,ES75209517551006251525,TRX_N-00537-53903112,2023-03-29T13:17:41,Donostia,expenses,leisure,-58.75,3276.52
buyer_5,Sara,,1994-03-12,ES75209517551006251525,TRX_N-00538-23734087,2023-03-29T09:57:03,Donostia,expenses,gifts,-479.34,2797.18
buyer_5,Sara,,1994-03-12,ES75209517551006251525,TRX_N-00539-64400636,2023-03-30T09:50:35,Donostia,expenses,repairs,-29.14,2768.04
buyer_5,Sara,,1994-03-12,ES75209517551006251525,TRX_N-00540-85503839,2023-03-31T09:04:08,Donostia,expenses,food,-82.19,2685.85
buyer_5,Sara,,1994-03-12,ES75209517551006251525,TRX_N-00541-87825095,2023-04-01T20:12:44,Donostia,incomes,salary,2420.36,5106.21
buyer_5,Sara,,1994-03-12,ES75209517551006251525,TRX_N-00542-40002991,2023-04-01T20:12:44,Donostia,incomes,salary_partner,2652.93,7759.14
buyer_5,Sara,,1994-03-12,ES75209517551006251525,TRX_N-00543-78069935,2023-04-01T11:36:15,Donostia,expenses,cash,-100.0,7659.14
buyer_5,Sara,,1994-03-12,ES75209517551006251525,TRX_N-00544-76650961,2023-04-02T09:19:55,Donostia,expenses,cash,-100.0,7559.14
buyer_5,Sara,,1994-03-12,ES75209517551006251525,TRX_N-00545-59084898,2023-04-02T09:52:49,Donostia,expenses,gifts,-87.01,7472.13
buyer_5,Sara,,1994-03-12,ES75209517551006251525,TRX_N-00546-74044072,2023-04-03T19:34:11,Donostia,expenses,cash,-100.0,7372.13
buyer_5,Sara,,1994-03-12,ES75209517551006251525,TRX_N-00547-63918969,2023-04-04T11:43:09,Donostia,expenses,mortgage,-754.18,6617.95
buyer_5,Sara,,1994-03-12,ES75209517551006251525,TRX_N-00548-56481322,2023-04-05T19:32:11,Donostia,expenses,electricity,-36.1,6581.85
buyer_5,Sara,,1994-03-12,ES75209517551006251525,TRX_N-00549-02963417,2023-04-05T00:24:00,Donostia,expenses,leisure,-40.32,6541.53
buyer_5,Sara,,1994-03-12,ES75209517551006251525,TRX_N-00550-32177796,2023-04-05T06:43:20,Bilbao,expenses,cash,-100.0,6441.53
buyer_5,Sara,,1994-03-12,ES75209517551006251525,TRX_N-00551-00598157,2023-04-06T10:10:01,Donostia,expenses,water,-33.85,6407.68
buyer_5,Sara,,1994-03-12,ES75209517551006251525,TRX_N-00552-06496437,2023-04-07T12:59:55,Donostia,expenses,internet,-42.0,6365.68
buyer_5,Sara,,1994-03-12,ES75209517551006251525,TRX_N-00553-95032836,2023-04-08T16:25:02,Donostia,expenses,gas,-48.55,6317.13
buyer_5,Sara,,1994-03-12,ES75209517551006251525,TRX_N-00554-58889898,2023-04-08T09:08:50,Donostia,expenses,phone,-32.6,6284.53
buyer_5,Sara,,1994-03-12,ES75209517551006251525,TRX_N-00555-44899816,2023-04-09T09:46:34,Donostia,expenses,transport,-50.91,6233.62
buyer_5,Sara,,1994-03-12,ES75209517551006251525,TRX_N-00556-95239603,2023-04-10T17:11:37,Donostia,expenses,food,-70.53,6163.09
buyer_5,Sara,,1994-03-12,ES75209517551006251525,TRX_N-00557-19983521,2023-04-10T08:07:13,Zuia,expenses,cash,-100.0,6063.09
buyer_5,Sara,,1994-03-12,ES75209517551006251525,TRX_N-00558-68568107,2023-04-11T08:07:56,Donostia,expenses,healthcare,-74.18,5988.91
buyer_5,Sara,,1994-03-12,ES75209517551006251525,TRX_N-00559-02630932,2023-04-12T23:39:07,Hondarribia,expenses,leisure,-20.56,5968.35
buyer_5,Sara,,1994-03-12,ES75209517551006251525,TRX_N-00560-02608406,2023-04-15T14:07:34,Labastida,expenses,food,-105.06,5863.29
buyer_5,Sara,,1994-03-12,ES75209517551006251525,TRX_N-00561-05670339,2023-04-15T05:53:13,Donostia,expenses,leisure,-68.94,5794.35
buyer_5,Sara,,1994-03-12,ES75209517551006251525,TRX_N-00562-12279285,2023-04-16T19:04:35,Donostia,expenses,transport,-61.82,5732.53
buyer_5,Sara,,1994-03-12,ES75209517551006251525,TRX_N-00563-72274380,2023-04-17T10:08:04,Santurtzi,expenses,food,-110.69,5621.84
buyer_5,Sara,,1994-03-12,ES75209517551006251525,TRX_N-00564-47044402,2023-04-17T14:17:40,Alegr√≠a-Dulantzi,expenses,cash,-100.0,5521.84
buyer_5,Sara,,1994-03-12,ES75209517551006251525,TRX_N-00565-07809458,2023-04-18T02:44:45,Eibar,expenses,leisure,-33.8,5488.04
buyer_5,Sara,,1994-03-12,ES75209517551006251525,TRX_N-00566-42293459,2023-04-18T11:13:06,Donostia,expenses,repairs,-70.39,5417.65
buyer_5,Sara,,1994-03-12,ES75209517551006251525,TRX_N-00567-07208585,2023-04-19T08:38:14,Donostia,expenses,transport,-48.38,5369.27
buyer_5,Sara,,1994-03-12,ES75209517551006251525,TRX_N-00568-99703479,2023-04-19T23:47:38,Donostia,expenses,cash,-100.0,5269.27
buyer_5,Sara,,1994-03-12,ES75209517551006251525,TRX_N-00569-33092003,2023-04-20T10:58:59,Donostia,expenses,cash,-100.0,5169.27
buyer_5,Sara,,1994-03-12,ES75209517551006251525,TRX_N-00570-50188221,2023-04-24T18:49:22,Donostia,expenses,food,-65.59,5103.68
buyer_5,Sara,,1994-03-12,ES75209517551006251525,TRX_N-00571-84444219,2023-04-25T13:41:41,Portugalete,expenses,food,-123.39,4980.29
buyer_5,Sara,,1994-03-12,ES75209517551006251525,TRX_N-00572-00948061,2023-04-26T16:07:06,Donostia,expenses,clothing,-132.92,4847.37
buyer_5,Sara,,1994-03-12,ES75209517551006251525,TRX_N-00573-27019606,2023-04-27T13:42:51,Arrasate,expenses,leisure,-55.21,4792.16
buyer_5,Sara,,1994-03-12,ES75209517551006251525,TRX_N-00574-69028008,2023-04-27T13:32:23,Donostia,expenses,cash,-100.0,4692.16
buyer_5,Sara,,1994-03-12,ES75209517551006251525,TRX_N-00575-50543755,2023-05-01T09:01:56,Donostia,incomes,salary,2420.36,7112.52
buyer_5,Sara,,1994-03-12,ES75209517551006251525,TRX_N-00576-27759874,2023-05-01T09:01:56,Donostia,incomes,salary_partner,2652.93,9765.45
buyer_5,Sara,,1994-03-12,ES75209517551006251525,TRX_N-00577-36606319,2023-05-01T09:16:00,Donostia,expenses,transport,-89.09,9676.36
buyer_5,Sara,,1994-03-12,ES75209517551006251525,TRX_N-00578-20901121,2023-05-01T03:31:08,Donostia,expenses,healthcare,-81.44,9594.92
buyer_5,Sara,,1994-03-12,ES75209517551006251525,TRX_N-00579-54590315,2023-05-03T02:28:19,Donostia,expenses,education,-53.07,9541.85
buyer_5,Sara,,1994-03-12,ES75209517551006251525,TRX_N-00580-92364614,2023-05-03T16:36:11,Donostia,expenses,appliances,-204.24,9337.61
buyer_5,Sara,,1994-03-12,ES75209517551006251525,TRX_N-00581-31173849,2023-05-03T22:48:59,Donostia,expenses,gifts,-768.06,8569.55
buyer_5,Sara,,1994-03-12,ES75209517551006251525,TRX_N-00582-08658461,2023-05-04T08:37:52,Donostia,expenses,mortgage,-754.18,7815.37
buyer_5,Sara,,1994-03-12,ES75209517551006251525,TRX_N-00583-55726760,2023-05-04T09:50:51,Donostia,expenses,transport,-40.89,7774.48
buyer_5,Sara,,1994-03-12,ES75209517551006251525,TRX_N-00584-24001585,2023-05-05T09:05:19,Donostia,expenses,cash,-100.0,7674.48
buyer_5,Sara,,1994-03-12,ES75209517551006251525,TRX_N-00585-38140654,2023-05-05T20:43:00,Hernani,expenses,gifts,-820.29,6854.19
buyer_5,Sara,,1994-03-12,ES75209517551006251525,TRX_N-00586-69475910,2023-05-06T05:16:45,Donostia,expenses,electricity,-64.34,6789.85
buyer_5,Sara,,1994-03-12,ES75209517551006251525,TRX_N-00587-99469717,2023-05-06T08:29:18,Donostia,expenses,gas,-107.14,6682.71
buyer_5,Sara,,1994-03-12,ES75209517551006251525,TRX_N-00588-73895257,2023-05-06T19:37:41,Donostia,expenses,internet,-42.0,6640.71
buyer_5,Sara,,1994-03-12,ES75209517551006251525,TRX_N-00589-18709020,2023-05-06T18:59:11,Donostia,expenses,phone,-43.71,6597.0
buyer_5,Sara,,1994-03-12,ES75209517551006251525,TRX_N-00590-14468049,2023-05-06T15:55:09,Andoain,expenses,leisure,-77.18,6519.82
buyer_5,Sara,,1994-03-12,ES75209517551006251525,TRX_N-00591-54715554,2023-05-06T08:00:17,Donostia,expenses,education,-54.27,6465.55
buyer_5,Sara,,1994-03-12,ES75209517551006251525,TRX_N-00592-74903698,2023-05-08T20:34:20,Donostia,expenses,water,-35.02,6430.53
buyer_5,Sara,,1994-03-12,ES75209517551006251525,TRX_N-00593-34209612,2023-05-10T08:16:38,Donostia,expenses,food,-120.31,6310.22
buyer_5,Sara,,1994-03-12,ES75209517551006251525,TRX_N-00594-16834174,2023-05-11T16:16:08,Basauri,expenses,leisure,-51.25,6258.97
buyer_5,Sara,,1994-03-12,ES75209517551006251525,TRX_N-00595-71559176,2023-05-16T07:57:39,Donostia,expenses,transport,-65.77,6193.2
buyer_5,Sara,,1994-03-12,ES75209517551006251525,TRX_N-00596-99907896,2023-05-16T09:49:12,Donostia,expenses,leisure,-81.57,6111.63
buyer_5,Sara,,1994-03-12,ES75209517551006251525,TRX_N-00597-23183989,2023-05-19T18:07:47,Donostia,expenses,cash,-100.0,6011.63
buyer_5,Sara,,1994-03-12,ES75209517551006251525,TRX_N-00598-22502515,2023-05-20T10:08:21,Donostia,expenses,food,-60.45,5951.18
buyer_5,Sara,,1994-03-12,ES75209517551006251525,TRX_N-00599-27737356,2023-05-21T20:11:37,Donostia,expenses,leisure,-52.81,5898.37
buyer_5,Sara,,1994-03-12,ES75209517551006251525,TRX_N-00600-22704200,2023-05-21T18:10:38,Donostia,expenses,cash,-100.0,5798.37
buyer_5,Sara,,1994-03-12,ES75209517551006251525,TRX_N-00601-91869355,2023-05-22T00:40:26,Donostia,expenses,transport,-88.84,5709.53
buyer_5,Sara,,1994-03-12,ES75209517551006251525,TRX_N-00602-55344265,2023-05-23T14:00:08,Donostia,expenses,leisure,-27.46,5682.07
buyer_5,Sara,,1994-03-12,ES75209517551006251525,TRX_N-00603-49366347,2023-05-24T13:02:50,Donostia,expenses,leisure,-26.79,5655.28
buyer_5,Sara,,1994-03-12,ES75209517551006251525,TRX_N-00604-34558833,2023-05-25T17:27:38,Donostia,expenses,education,-68.03,5587.25
buyer_5,Sara,,1994-03-12,ES75209517551006251525,TRX_N-00605-79101181,2023-05-25T19:08:26,Hondarribia,expenses,cash,-100.0,5487.25
buyer_5,Sara,,1994-03-12,ES75209517551006251525,TRX_N-00606-30438187,2023-05-26T09:06:09,Donostia,expenses,transport,-71.07,5416.18
buyer_5,Sara,,1994-03-12,ES75209517551006251525,TRX_N-00607-98836548,2023-05-28T11:35:41,Donostia,expenses,leisure,-82.48,5333.7
buyer_5,Sara,,1994-03-12,ES75209517551006251525,TRX_N-00608-38836953,2023-05-30T22:27:35,Donostia,expenses,food,-96.64,5237.06
buyer_5,Sara,,1994-03-12,ES75209517551006251525,TRX_N-00609-46376970,2023-05-30T13:51:10,Donostia,expenses,repairs,-233.31,5003.75
buyer_5,Sara,,1994-03-12,ES75209517551006251525,TRX_N-00610-46916381,2023-05-31T14:24:01,Donostia,expenses,leisure,-59.86,4943.89
buyer_5,Sara,,1994-03-12,ES75209517551006251525,TRX_N-00611-07636605,2023-06-01T15:38:53,Donostia,incomes,salary,2420.36,7364.25
buyer_5,Sara,,1994-03-12,ES75209517551006251525,TRX_N-00612-21257161,2023-06-01T15:38:53,Donostia,incomes,salary_partner,2652.93,10017.18
buyer_5,Sara,,1994-03-12,ES75209517551006251525,TRX_N-00613-61671571,2023-06-01T15:38:53,Donostia,incomes,extra_income,234.39,10251.57
buyer_5,Sara,,1994-03-12,ES75209517551006251525,TRX_N-00614-81946810,2023-06-01T15:38:53,Donostia,incomes,salary_bonus,1928.92,12180.49
buyer_5,Sara,,1994-03-12,ES75209517551006251525,TRX_N-00615-46102063,2023-06-01T15:38:53,Donostia,incomes,salary_partner_bonus,2069.32,14249.81
buyer_5,Sara,,1994-03-12,ES75209517551006251525,TRX_N-00616-15585370,2023-06-02T23:09:34,Donostia,expenses,cash,-100.0,14149.81
buyer_5,Sara,,1994-03-12,ES75209517551006251525,TRX_N-00617-83487711,2023-06-03T13:37:29,Donostia,expenses,transport,-47.71,14102.1
buyer_5,Sara,,1994-03-12,ES75209517551006251525,TRX_N-00618-30165980,2023-06-03T20:28:48,Donostia,expenses,repairs,-294.76,13807.34
buyer_5,Sara,,1994-03-12,ES75209517551006251525,TRX_N-00619-09623910,2023-06-04T19:12:38,Donostia,expenses,mortgage,-754.18,13053.16
buyer_5,Sara,,1994-03-12,ES75209517551006251525,TRX_N-00620-01333419,2023-06-05T14:22:24,Donostia,expenses,phone,-40.73,13012.43
buyer_5,Sara,,1994-03-12,ES75209517551006251525,TRX_N-00621-01169490,2023-06-06T15:02:37,Donostia,expenses,water,-20.66,12991.77
buyer_5,Sara,,1994-03-12,ES75209517551006251525,TRX_N-00622-22182797,2023-06-06T18:48:05,Donostia,expenses,internet,-42.0,12949.77
buyer_5,Sara,,1994-03-12,ES75209517551006251525,TRX_N-00623-41754547,2023-06-06T14:41:31,Amurrio,expenses,gifts,-114.95,12834.82
buyer_5,Sara,,1994-03-12,ES75209517551006251525,TRX_N-00624-89387179,2023-06-07T18:28:54,Donostia,expenses,cash,-100.0,12734.82
buyer_5,Sara,,1994-03-12,ES75209517551006251525,TRX_N-00625-14394869,2023-06-08T23:40:39,Donostia,expenses,gas,-73.41,12661.41
buyer_5,Sara,,1994-03-12,ES75209517551006251525,TRX_N-00626-92955866,2023-06-08T13:42:31,Donostia,expenses,electricity,-67.96,12593.45
buyer_5,Sara,,1994-03-12,ES75209517551006251525,TRX_N-00627-69558696,2023-06-11T18:47:36,Donostia,expenses,clothing,-99.74,12493.71
buyer_5,Sara,,1994-03-12,ES75209517551006251525,TRX_N-00628-89458672,2023-06-11T12:53:25,Donostia,expenses,cash,-100.0,12393.71
buyer_5,Sara,,1994-03-12,ES75209517551006251525,TRX_N-00629-46800498,2023-06-13T08:20:01,Donostia,expenses,education,-63.88,12329.83
buyer_5,Sara,,1994-03-12,ES75209517551006251525,TRX_N-00630-60316608,2023-06-16T19:05:42,Donostia,expenses,clothing,-129.07,12200.76
buyer_5,Sara,,1994-03-12,ES75209517551006251525,TRX_N-00631-16775524,2023-06-16T12:16:52,Donostia,expenses,healthcare,-143.19,12057.57
buyer_5,Sara,,1994-03-12,ES75209517551006251525,TRX_N-00632-69162786,2023-06-16T20:07:35,Andoain,expenses,repairs,-206.38,11851.19
buyer_5,Sara,,1994-03-12,ES75209517551006251525,TRX_N-00633-77590621,2023-06-17T12:01:03,Donostia,expenses,repairs,-183.51,11667.68
buyer_5,Sara,,1994-03-12,ES75209517551006251525,TRX_N-00634-80351230,2023-06-18T11:29:47,Donostia,expenses,leisure,-74.52,11593.16
buyer_5,Sara,,1994-03-12,ES75209517551006251525,TRX_N-00635-58527968,2023-06-20T15:54:08,Donostia,expenses,food,-112.27,11480.89
buyer_5,Sara,,1994-03-12,ES75209517551006251525,TRX_N-00636-67599524,2023-06-21T10:56:01,Donostia,expenses,food,-62.63,11418.26
buyer_5,Sara,,1994-03-12,ES75209517551006251525,TRX_N-00637-63854036,2023-06-21T20:20:10,Donostia,expenses,transport,-61.78,11356.48
buyer_5,Sara,,1994-03-12,ES75209517551006251525,TRX_N-00638-31795029,2023-06-21T19:34:06,Donostia,expenses,repairs,-217.75,11138.73
buyer_5,Sara,,1994-03-12,ES75209517551006251525,TRX_N-00639-10576927,2023-06-25T13:49:31,Donostia,expenses,transport,-79.95,11058.78
buyer_5,Sara,,1994-03-12,ES75209517551006251525,TRX_N-00640-46643779,2023-06-26T17:43:02,Donostia,expenses,leisure,-29.96,11028.82
buyer_5,Sara,,1994-03-12,ES75209517551006251525,TRX_N-00641-78838032,2023-06-28T14:17:17,Lasarte-Oria,expenses,cash,-100.0,10928.82
buyer_5,Sara,,1994-03-12,ES75209517551006251525,TRX_N-00642-27116799,2023-06-30T06:02:46,Donostia,expenses,transport,-46.81,10882.01
buyer_5,Sara,,1994-03-12,ES75209517551006251525,TRX_N-00643-20504796,2023-07-01T15:05:54,Donostia,incomes,salary,2420.36,13302.37
buyer_5,Sara,,1994-03-12,ES75209517551006251525,TRX_N-00644-64894416,2023-07-01T15:05:54,Donostia,incomes,salary_partner,2652.93,15955.3
buyer_5,Sara,,1994-03-12,ES75209517551006251525,TRX_N-00645-82396290,2023-07-01T09:03:19,Donostia,expenses,cash,-100.0,15855.3
buyer_5,Sara,,1994-03-12,ES75209517551006251525,TRX_N-00646-72019719,2023-07-02T22:05:51,Donostia,expenses,healthcare,-180.8,15674.5
buyer_5,Sara,,1994-03-12,ES75209517551006251525,TRX_N-00647-75895962,2023-07-04T16:42:12,Donostia,expenses,mortgage,-754.18,14920.32
buyer_5,Sara,,1994-03-12,ES75209517551006251525,TRX_N-00648-66127954,2023-07-05T11:20:05,Donostia,expenses,gas,-76.68,14843.64
buyer_5,Sara,,1994-03-12,ES75209517551006251525,TRX_N-00649-64054837,2023-07-05T03:28:13,Donostia,expenses,phone,-37.14,14806.5
buyer_5,Sara,,1994-03-12,ES75209517551006251525,TRX_N-00650-58085743,2023-07-05T09:51:35,Erandio,expenses,transport,-43.16,14763.34
buyer_5,Sara,,1994-03-12,ES75209517551006251525,TRX_N-00651-46848615,2023-07-06T17:53:33,Donostia,expenses,water,-31.76,14731.58
buyer_5,Sara,,1994-03-12,ES75209517551006251525,TRX_N-00652-55143406,2023-07-06T17:32:36,Donostia,expenses,electricity,-48.57,14683.01
buyer_5,Sara,,1994-03-12,ES75209517551006251525,TRX_N-00653-32671299,2023-07-07T12:31:13,Donostia,expenses,internet,-42.0,14641.01
buyer_5,Sara,,1994-03-12,ES75209517551006251525,TRX_N-00654-57842574,2023-07-08T18:11:22,Donostia,expenses,cash,-100.0,14541.01
buyer_5,Sara,,1994-03-12,ES75209517551006251525,TRX_N-00655-67793573,2023-07-11T17:09:36,Donostia,expenses,food,-120.08,14420.93
buyer_5,Sara,,1994-03-12,ES75209517551006251525,TRX_N-00656-96585058,2023-07-11T08:00:31,Donostia,expenses,leisure,-23.19,14397.74
buyer_5,Sara,,1994-03-12,ES75209517551006251525,TRX_N-00657-17118773,2023-07-11T01:08:40,Bilbao,expenses,cash,-100.0,14297.74
buyer_5,Sara,,1994-03-12,ES75209517551006251525,TRX_N-00658-17084074,2023-07-14T16:38:54,Donostia,expenses,cash,-100.0,14197.74
buyer_5,Sara,,1994-03-12,ES75209517551006251525,TRX_N-00659-77709466,2023-07-17T20:20:59,Donostia,expenses,repairs,-230.69,13967.05
buyer_5,Sara,,1994-03-12,ES75209517551006251525,TRX_N-00660-48967864,2023-07-21T08:02:49,Donostia,expenses,food,-114.07,13852.98
buyer_5,Sara,,1994-03-12,ES75209517551006251525,TRX_N-00661-53013254,2023-07-21T03:52:11,Donostia,expenses,transport,-59.25,13793.73
buyer_5,Sara,,1994-03-12,ES75209517551006251525,TRX_N-00662-41025142,2023-07-22T19:50:27,Donostia,expenses,cash,-100.0,13693.73
buyer_5,Sara,,1994-03-12,ES75209517551006251525,TRX_N-00663-91125553,2023-07-24T15:11:24,Donostia,expenses,gifts,-267.49,13426.24
buyer_5,Sara,,1994-03-12,ES75209517551006251525,TRX_N-00664-10734521,2023-07-25T13:29:23,Donostia,expenses,transport,-80.31,13345.93
buyer_5,Sara,,1994-03-12,ES75209517551006251525,TRX_N-00665-58939374,2023-07-26T14:33:59,Donostia,expenses,healthcare,-138.95,13206.98
buyer_5,Sara,,1994-03-12,ES75209517551006251525,TRX_N-00666-75676659,2023-07-29T17:11:23,Donostia,expenses,food,-73.99,13132.99
buyer_5,Sara,,1994-03-12,ES75209517551006251525,TRX_N-00667-68950365,2023-07-29T11:08:54,Zarautz,expenses,cash,-100.0,13032.99
buyer_5,Sara,,1994-03-12,ES75209517551006251525,TRX_N-00668-67962118,2023-07-30T05:12:26,Donostia,expenses,healthcare,-156.91,12876.08
buyer_5,Sara,,1994-03-12,ES75209517551006251525,TRX_N-00669-91452800,2023-07-30T13:00:36,Labastida,expenses,appliances,-297.76,12578.32
buyer_5,Sara,,1994-03-12,ES75209517551006251525,TRX_N-00670-50132515,2023-07-30T11:47:44,Donostia,expenses,repairs,-320.07,12258.25
buyer_5,Sara,,1994-03-12,ES75209517551006251525,TRX_N-00671-23884689,2023-07-31T19:34:35,Donostia,expenses,food,-122.91,12135.34
buyer_5,Sara,,1994-03-12,ES75209517551006251525,TRX_N-00672-61253092,2023-07-31T19:11:01,Donostia,expenses,leisure,-84.48,12050.86
buyer_5,Sara,,1994-03-12,ES75209517551006251525,TRX_N-00673-79630496,2023-07-31T12:21:27,Donostia,expenses,cash,-100.0,11950.86
buyer_5,Sara,,1994-03-12,ES75209517551006251525,TRX_N-00674-69567138,2023-08-01T15:45:43,Donostia,incomes,salary,2420.36,14371.22
buyer_5,Sara,,1994-03-12,ES75209517551006251525,TRX_N-00675-25828677,2023-08-01T15:45:43,Donostia,incomes,salary_partner,2652.93,17024.15
buyer_5,Sara,,1994-03-12,ES75209517551006251525,TRX_N-00676-08529523,2023-08-01T21:35:27,Donostia,expenses,cash,-100.0,16924.15
buyer_5,Sara,,1994-03-12,ES75209517551006251525,TRX_N-00677-25601995,2023-08-02T13:38:41,Donostia,expenses,cash,-100.0,16824.15
buyer_5,Sara,,1994-03-12,ES75209517551006251525,TRX_N-00678-58563590,2023-08-04T20:35:24,Donostia,expenses,mortgage,-754.18,16069.97
buyer_5,Sara,,1994-03-12,ES75209517551006251525,TRX_N-00679-22938283,2023-08-04T04:46:41,Donostia,expenses,cash,-100.0,15969.97
buyer_5,Sara,,1994-03-12,ES75209517551006251525,TRX_N-00680-76477449,2023-08-05T23:46:43,Donostia,expenses,gas,-103.78,15866.19
buyer_5,Sara,,1994-03-12,ES75209517551006251525,TRX_N-00681-82621337,2023-08-05T11:28:07,Donostia,expenses,transport,-66.13,15800.06
buyer_5,Sara,,1994-03-12,ES75209517551006251525,TRX_N-00682-36919623,2023-08-05T10:56:41,Donostia,expenses,gifts,-819.14,14980.92
buyer_5,Sara,,1994-03-12,ES75209517551006251525,TRX_N-00683-60510309,2023-08-06T08:18:10,Donostia,expenses,electricity,-85.89,14895.03
buyer_5,Sara,,1994-03-12,ES75209517551006251525,TRX_N-00684-10441533,2023-08-08T15:17:12,Donostia,expenses,water,-32.88,14862.15
buyer_5,Sara,,1994-03-12,ES75209517551006251525,TRX_N-00685-29082004,2023-08-08T11:24:32,Donostia,expenses,internet,-42.0,14820.15
buyer_5,Sara,,1994-03-12,ES75209517551006251525,TRX_N-00686-68513361,2023-08-08T18:17:10,Donostia,expenses,phone,-36.5,14783.65
buyer_5,Sara,,1994-03-12,ES75209517551006251525,TRX_N-00687-40354476,2023-08-08T14:58:11,Donostia,expenses,food,-64.9,14718.75
buyer_5,Sara,,1994-03-12,ES75209517551006251525,TRX_N-00688-00736466,2023-08-09T08:27:51,Donostia,expenses,repairs,-243.15,14475.6
buyer_5,Sara,,1994-03-12,ES75209517551006251525,TRX_N-00689-39449429,2023-08-09T14:49:48,Donostia,expenses,gifts,-83.95,14391.65
buyer_5,Sara,,1994-03-12,ES75209517551006251525,TRX_N-00690-36610016,2023-08-10T13:37:44,Iru√±a de Oca,expenses,cash,-100.0,14291.65
buyer_5,Sara,,1994-03-12,ES75209517551006251525,TRX_N-00691-05253366,2023-08-12T12:00:51,Donostia,expenses,leisure,-35.24,14256.41
buyer_5,Sara,,1994-03-12,ES75209517551006251525,TRX_N-00692-02355479,2023-08-17T14:04:21,Andoain,expenses,repairs,-36.33,14220.08
buyer_5,Sara,,1994-03-12,ES75209517551006251525,TRX_N-00693-17368698,2023-08-18T10:15:16,Donostia,expenses,transport,-87.82,14132.26
buyer_5,Sara,,1994-03-12,ES75209517551006251525,TRX_N-00694-59981648,2023-08-18T09:30:10,Zuia,expenses,leisure,-81.65,14050.61
buyer_5,Sara,,1994-03-12,ES75209517551006251525,TRX_N-00695-26811072,2023-08-20T20:17:24,Donostia,expenses,food,-71.92,13978.69
buyer_5,Sara,,1994-03-12,ES75209517551006251525,TRX_N-00696-49839644,2023-08-20T02:07:06,Donostia,expenses,healthcare,-65.44,13913.25
buyer_5,Sara,,1994-03-12,ES75209517551006251525,TRX_N-00697-39498919,2023-08-21T20:48:02,Donostia,expenses,cash,-100.0,13813.25
buyer_5,Sara,,1994-03-12,ES75209517551006251525,TRX_N-00698-58642322,2023-08-22T12:24:24,Donostia,expenses,healthcare,-151.56,13661.69
buyer_5,Sara,,1994-03-12,ES75209517551006251525,TRX_N-00699-47697973,2023-08-22T02:20:15,Donostia,expenses,repairs,-178.34,13483.35
buyer_5,Sara,,1994-03-12,ES75209517551006251525,TRX_N-00700-86641753,2023-08-23T09:17:15,Donostia,expenses,leisure,-67.26,13416.09
buyer_5,Sara,,1994-03-12,ES75209517551006251525,TRX_N-00701-86176036,2023-08-25T22:16:54,Donostia,expenses,leisure,-67.14,13348.95
buyer_5,Sara,,1994-03-12,ES75209517551006251525,TRX_N-00702-72519932,2023-08-26T15:50:56,Donostia,expenses,clothing,-58.67,13290.28
buyer_5,Sara,,1994-03-12,ES75209517551006251525,TRX_N-00703-19043143,2023-08-27T10:39:07,Labastida,expenses,leisure,-19.79,13270.49
buyer_5,Sara,,1994-03-12,ES75209517551006251525,TRX_N-00704-07262835,2023-08-27T18:51:05,Donostia,expenses,clothing,-137.14,13133.35
buyer_5,Sara,,1994-03-12,ES75209517551006251525,TRX_N-00705-65528355,2023-08-27T09:59:15,Donostia,expenses,cash,-100.0,13033.35
buyer_5,Sara,,1994-03-12,ES75209517551006251525,TRX_N-00706-00481569,2023-08-28T14:12:16,Donostia,expenses,food,-116.45,12916.9
buyer_5,Sara,,1994-03-12,ES75209517551006251525,TRX_N-00707-91992802,2023-08-28T11:52:37,Donostia,expenses,cash,-100.0,12816.9
buyer_5,Sara,,1994-03-12,ES75209517551006251525,TRX_N-00708-26969729,2023-08-29T13:16:11,Donostia,expenses,healthcare,-65.58,12751.32
buyer_5,Sara,,1994-03-12,ES75209517551006251525,TRX_N-00709-94741738,2023-08-30T17:10:44,Donostia,expenses,leisure,-18.56,12732.76
buyer_5,Sara,,1994-03-12,ES75209517551006251525,TRX_N-00710-82965934,2023-08-30T15:58:46,Mungia,expenses,cash,-100.0,12632.76
buyer_5,Sara,,1994-03-12,ES75209517551006251525,TRX_N-00711-38643527,2023-08-30T12:43:57,Donostia,expenses,appliances,-118.34,12514.42
buyer_5,Sara,,1994-03-12,ES75209517551006251525,TRX_N-00712-53942501,2023-08-31T18:37:02,Donostia,expenses,leisure,-48.86,12465.56
buyer_5,Sara,,1994-03-12,ES75209517551006251525,TRX_N-00713-85016132,2023-09-01T12:41:24,Donostia,incomes,salary,2420.36,14885.92
buyer_5,Sara,,1994-03-12,ES75209517551006251525,TRX_N-00714-93187409,2023-09-01T12:41:24,Donostia,incomes,salary_partner,2652.93,17538.85
buyer_5,Sara,,1994-03-12,ES75209517551006251525,TRX_N-00715-85652147,2023-09-01T21:40:09,Donostia,expenses,clothing,-130.02,17408.83
buyer_5,Sara,,1994-03-12,ES75209517551006251525,TRX_N-00716-51823377,2023-09-01T20:55:24,Basauri,expenses,gifts,-841.06,16567.77
buyer_5,Sara,,1994-03-12,ES75209517551006251525,TRX_N-00717-12756664,2023-09-02T16:49:25,Berango,expenses,repairs,-267.91,16299.86
buyer_5,Sara,,1994-03-12,ES75209517551006251525,TRX_N-00718-83015367,2023-09-04T18:21:19,Donostia,expenses,mortgage,-754.18,15545.68
buyer_5,Sara,,1994-03-12,ES75209517551006251525,TRX_N-00719-69005842,2023-09-04T20:30:14,Donostia,expenses,repairs,-217.18,15328.5
buyer_5,Sara,,1994-03-12,ES75209517551006251525,TRX_N-00720-30334717,2023-09-05T16:23:55,Donostia,expenses,electricity,-32.71,15295.79
buyer_5,Sara,,1994-03-12,ES75209517551006251525,TRX_N-00721-87636051,2023-09-05T07:53:29,Donostia,expenses,phone,-44.88,15250.91
buyer_5,Sara,,1994-03-12,ES75209517551006251525,TRX_N-00722-34698334,2023-09-05T16:03:14,Hernani,expenses,food,-71.19,15179.72
buyer_5,Sara,,1994-03-12,ES75209517551006251525,TRX_N-00723-78226340,2023-09-06T15:01:19,Donostia,expenses,internet,-42.0,15137.72
buyer_5,Sara,,1994-03-12,ES75209517551006251525,TRX_N-00724-87045466,2023-09-07T17:05:39,Donostia,expenses,gas,-70.98,15066.74
buyer_5,Sara,,1994-03-12,ES75209517551006251525,TRX_N-00725-40791042,2023-09-08T20:02:52,Donostia,expenses,water,-29.12,15037.62
buyer_5,Sara,,1994-03-12,ES75209517551006251525,TRX_N-00726-41684472,2023-09-08T19:06:39,Donostia,expenses,repairs,-271.04,14766.58
buyer_5,Sara,,1994-03-12,ES75209517551006251525,TRX_N-00727-10139648,2023-09-10T15:56:22,Donostia,expenses,transport,-82.97,14683.61
buyer_5,Sara,,1994-03-12,ES75209517551006251525,TRX_N-00728-30984332,2023-09-10T19:57:18,Donostia,expenses,cash,-100.0,14583.61
buyer_5,Sara,,1994-03-12,ES75209517551006251525,TRX_N-00729-23427851,2023-09-10T06:38:50,Donostia,expenses,gifts,-152.8,14430.81
buyer_5,Sara,,1994-03-12,ES75209517551006251525,TRX_N-00730-91529764,2023-09-11T14:24:07,Donostia,expenses,food,-98.58,14332.23
buyer_5,Sara,,1994-03-12,ES75209517551006251525,TRX_N-00731-60247435,2023-09-11T16:22:49,Donostia,expenses,clothing,-137.21,14195.02
buyer_5,Sara,,1994-03-12,ES75209517551006251525,TRX_N-00732-86226784,2023-09-12T14:22:03,Berango,expenses,food,-68.08,14126.94
buyer_5,Sara,,1994-03-12,ES75209517551006251525,TRX_N-00733-40495424,2023-09-12T15:41:57,Donostia,expenses,cash,-100.0,14026.94
buyer_5,Sara,,1994-03-12,ES75209517551006251525,TRX_N-00734-39912610,2023-09-13T10:22:52,Donostia,expenses,leisure,-79.41,13947.53
buyer_5,Sara,,1994-03-12,ES75209517551006251525,TRX_N-00735-52821241,2023-09-13T11:42:21,Donostia,expenses,clothing,-82.24,13865.29
buyer_5,Sara,,1994-03-12,ES75209517551006251525,TRX_N-00736-61460654,2023-09-14T20:27:30,Amurrio,expenses,transport,-69.38,13795.91
buyer_5,Sara,,1994-03-12,ES75209517551006251525,TRX_N-00737-06201273,2023-09-15T13:38:07,Basauri,expenses,education,-44.51,13751.4
buyer_5,Sara,,1994-03-12,ES75209517551006251525,TRX_N-00738-99199079,2023-09-17T11:10:54,Donostia,expenses,cash,-100.0,13651.4
buyer_5,Sara,,1994-03-12,ES75209517551006251525,TRX_N-00739-81180028,2023-09-18T10:44:43,Donostia,expenses,appliances,-160.42,13490.98
buyer_5,Sara,,1994-03-12,ES75209517551006251525,TRX_N-00740-17808524,2023-09-19T14:31:20,Donostia,expenses,food,-70.03,13420.95
buyer_5,Sara,,1994-03-12,ES75209517551006251525,TRX_N-00741-30442461,2023-09-19T11:33:59,Donostia,expenses,clothing,-87.14,13333.81
buyer_5,Sara,,1994-03-12,ES75209517551006251525,TRX_N-00742-16705410,2023-09-20T21:43:53,Donostia,expenses,cash,-100.0,13233.81
buyer_5,Sara,,1994-03-12,ES75209517551006251525,TRX_N-00743-98460437,2023-09-21T14:13:24,Donostia,expenses,food,-103.79,13130.02
buyer_5,Sara,,1994-03-12,ES75209517551006251525,TRX_N-00744-88386513,2023-09-21T09:51:25,Getxo,expenses,transport,-74.5,13055.52
buyer_5,Sara,,1994-03-12,ES75209517551006251525,TRX_N-00745-01209500,2023-09-21T10:41:28,Donostia,expenses,cash,-100.0,12955.52
buyer_5,Sara,,1994-03-12,ES75209517551006251525,TRX_N-00746-17351312,2023-09-22T18:54:57,Iru√±a de Oca,expenses,leisure,-40.03,12915.49
buyer_5,Sara,,1994-03-12,ES75209517551006251525,TRX_N-00747-66754211,2023-09-22T14:50:25,Donostia,expenses,repairs,-47.27,12868.22
buyer_5,Sara,,1994-03-12,ES75209517551006251525,TRX_N-00748-89026273,2023-09-23T16:42:01,Donostia,expenses,gifts,-658.39,12209.83
buyer_5,Sara,,1994-03-12,ES75209517551006251525,TRX_N-00749-65907529,2023-09-24T17:29:24,Donostia,expenses,education,-54.92,12154.91
buyer_5,Sara,,1994-03-12,ES75209517551006251525,TRX_N-00750-14357905,2023-09-24T13:58:41,Donostia,expenses,repairs,-262.76,11892.15
buyer_5,Sara,,1994-03-12,ES75209517551006251525,TRX_N-00751-85388959,2023-09-27T19:40:01,Erandio,expenses,transport,-73.16,11818.99
buyer_5,Sara,,1994-03-12,ES75209517551006251525,TRX_N-00752-66210344,2023-09-30T20:21:32,Donostia,expenses,food,-83.07,11735.92
buyer_5,Sara,,1994-03-12,ES75209517551006251525,TRX_N-00753-38259700,2023-10-01T23:44:40,Donostia,incomes,salary,2420.36,14156.28
buyer_5,Sara,,1994-03-12,ES75209517551006251525,TRX_N-00754-36995478,2023-10-01T23:44:40,Donostia,incomes,salary_partner,2652.93,16809.21
buyer_5,Sara,,1994-03-12,ES75209517551006251525,TRX_N-00755-34454049,2023-10-01T23:44:40,Donostia,incomes,extra_income,234.39,17043.6
buyer_5,Sara,,1994-03-12,ES75209517551006251525,TRX_N-00756-01242358,2023-10-01T15:34:28,Donostia,expenses,healthcare,-180.26,16863.34
buyer_5,Sara,,1994-03-12,ES75209517551006251525,TRX_N-00757-15872619,2023-10-01T09:46:21,Donostia,expenses,education,-56.96,16806.38
buyer_5,Sara,,1994-03-12,ES75209517551006251525,TRX_N-00758-43172010,2023-10-02T03:48:26,Donostia,expenses,transport,-60.91,16745.47
buyer_5,Sara,,1994-03-12,ES75209517551006251525,TRX_N-00759-01805761,2023-10-02T16:10:42,Donostia,expenses,education,-58.45,16687.02
buyer_5,Sara,,1994-03-12,ES75209517551006251525,TRX_N-00760-43103399,2023-10-03T16:47:44,Donostia,expenses,food,-88.98,16598.04
buyer_5,Sara,,1994-03-12,ES75209517551006251525,TRX_N-00761-48839301,2023-10-04T09:37:22,Donostia,expenses,mortgage,-754.18,15843.86
buyer_5,Sara,,1994-03-12,ES75209517551006251525,TRX_N-00762-19062525,2023-10-04T10:58:14,Donostia,expenses,education,-60.02,15783.84
buyer_5,Sara,,1994-03-12,ES75209517551006251525,TRX_N-00763-50847433,2023-10-05T14:50:28,Donostia,expenses,gas,-86.89,15696.95
buyer_5,Sara,,1994-03-12,ES75209517551006251525,TRX_N-00764-97094693,2023-10-05T15:36:12,Donostia,expenses,internet,-42.0,15654.95
buyer_5,Sara,,1994-03-12,ES75209517551006251525,TRX_N-00765-14086336,2023-10-05T19:01:58,Donostia,expenses,transport,-48.22,15606.73
buyer_5,Sara,,1994-03-12,ES75209517551006251525,TRX_N-00766-89828187,2023-10-06T20:14:32,Donostia,expenses,water,-30.25,15576.48
buyer_5,Sara,,1994-03-12,ES75209517551006251525,TRX_N-00767-97732978,2023-10-06T14:43:13,Donostia,expenses,phone,-31.61,15544.87
buyer_5,Sara,,1994-03-12,ES75209517551006251525,TRX_N-00768-87631217,2023-10-07T09:18:34,Donostia,expenses,food,-69.55,15475.32
buyer_5,Sara,,1994-03-12,ES75209517551006251525,TRX_N-00769-72931867,2023-10-07T16:25:57,Donostia,expenses,cash,-100.0,15375.32
buyer_5,Sara,,1994-03-12,ES75209517551006251525,TRX_N-00770-25057145,2023-10-08T10:03:36,Donostia,expenses,electricity,-28.12,15347.2
buyer_5,Sara,,1994-03-12,ES75209517551006251525,TRX_N-00771-04319192,2023-10-08T17:28:36,Pasaia,expenses,travel,-1668.3,13678.9
buyer_5,Sara,,1994-03-12,ES75209517551006251525,TRX_N-00772-13797274,2023-10-09T12:39:22,Donostia,expenses,food,-80.66,13598.24
buyer_5,Sara,,1994-03-12,ES75209517551006251525,TRX_N-00773-76506676,2023-10-10T18:08:56,Donostia,expenses,appliances,-238.79,13359.45
buyer_5,Sara,,1994-03-12,ES75209517551006251525,TRX_N-00774-05809195,2023-10-12T14:53:24,Donostia,expenses,cash,-100.0,13259.45
buyer_5,Sara,,1994-03-12,ES75209517551006251525,TRX_N-00775-11386478,2023-10-13T11:06:15,Donostia,expenses,cash,-100.0,13159.45
buyer_5,Sara,,1994-03-12,ES75209517551006251525,TRX_N-00776-46204757,2023-10-14T21:35:54,Donostia,expenses,leisure,-24.68,13134.77
buyer_5,Sara,,1994-03-12,ES75209517551006251525,TRX_N-00777-51931143,2023-10-17T09:04:51,Donostia,expenses,leisure,-45.18,13089.59
buyer_5,Sara,,1994-03-12,ES75209517551006251525,TRX_N-00778-54907667,2023-10-17T19:25:17,Donostia,expenses,cash,-100.0,12989.59
buyer_5,Sara,,1994-03-12,ES75209517551006251525,TRX_N-00779-87222372,2023-10-17T09:55:12,Donostia,expenses,gifts,-220.87,12768.72
buyer_5,Sara,,1994-03-12,ES75209517551006251525,TRX_N-00780-35648189,2023-10-18T22:34:28,Donostia,expenses,repairs,-253.84,12514.88
buyer_5,Sara,,1994-03-12,ES75209517551006251525,TRX_N-00781-89832534,2023-10-19T20:42:21,Donostia,expenses,food,-105.88,12409.0
buyer_5,Sara,,1994-03-12,ES75209517551006251525,TRX_N-00782-84935599,2023-10-19T09:00:37,Donostia,expenses,cash,-100.0,12309.0
buyer_5,Sara,,1994-03-12,ES75209517551006251525,TRX_N-00783-37386854,2023-10-20T13:56:13,Donostia,expenses,food,-96.5,12212.5
buyer_5,Sara,,1994-03-12,ES75209517551006251525,TRX_N-00784-96673142,2023-10-21T12:08:54,Donostia,expenses,transport,-52.8,12159.7
buyer_5,Sara,,1994-03-12,ES75209517551006251525,TRX_N-00785-30980895,2023-10-21T17:04:50,Donostia,expenses,leisure,-43.3,12116.4
buyer_5,Sara,,1994-03-12,ES75209517551006251525,TRX_N-00786-66613571,2023-10-22T18:57:23,Donostia,expenses,food,-109.9,12006.5
buyer_5,Sara,,1994-03-12,ES75209517551006251525,TRX_N-00787-41183348,2023-10-22T14:12:57,Errenteria,expenses,cash,-100.0,11906.5
buyer_5,Sara,,1994-03-12,ES75209517551006251525,TRX_N-00788-87185427,2023-10-24T18:08:15,Eibar,expenses,clothing,-84.72,11821.78
buyer_5,Sara,,1994-03-12,ES75209517551006251525,TRX_N-00789-89869616,2023-10-26T22:01:10,Donostia,expenses,cash,-100.0,11721.78
buyer_5,Sara,,1994-03-12,ES75209517551006251525,TRX_N-00790-02326890,2023-10-28T22:48:23,Donostia,expenses,repairs,-32.56,11689.22
buyer_5,Sara,,1994-03-12,ES75209517551006251525,TRX_N-00791-46431849,2023-10-29T17:52:11,Donostia,expenses,food,-106.87,11582.35
buyer_5,Sara,,1994-03-12,ES75209517551006251525,TRX_N-00792-12638390,2023-11-01T09:39:25,Donostia,incomes,salary,2420.36,14002.71
buyer_5,Sara,,1994-03-12,ES75209517551006251525,TRX_N-00793-28188281,2023-11-01T09:39:25,Donostia,incomes,salary_partner,2652.93,16655.64
buyer_5,Sara,,1994-03-12,ES75209517551006251525,TRX_N-00794-78062245,2023-11-03T16:05:35,Donostia,expenses,gifts,-255.45,16400.19
buyer_5,Sara,,1994-03-12,ES75209517551006251525,TRX_N-00795-04648290,2023-11-04T15:30:15,Donostia,expenses,mortgage,-754.18,15646.01
buyer_5,Sara,,1994-03-12,ES75209517551006251525,TRX_N-00796-51057501,2023-11-05T18:24:14,Donostia,expenses,gas,-81.97,15564.04
buyer_5,Sara,,1994-03-12,ES75209517551006251525,TRX_N-00797-14034709,2023-11-05T11:16:12,Donostia,expenses,leisure,-34.73,15529.31
buyer_5,Sara,,1994-03-12,ES75209517551006251525,TRX_N-00798-24663724,2023-11-05T11:54:35,Donostia,expenses,repairs,-222.69,15306.62
buyer_5,Sara,,1994-03-12,ES75209517551006251525,TRX_N-00799-86910286,2023-11-06T00:41:52,Donostia,expenses,water,-44.33,15262.29
buyer_5,Sara,,1994-03-12,ES75209517551006251525,TRX_N-00800-62748974,2023-11-06T13:28:38,Donostia,expenses,appliances,-176.77,15085.52
buyer_5,Sara,,1994-03-12,ES75209517551006251525,TRX_N-00801-41600614,2023-11-06T12:40:55,Vitoria-Gasteiz,expenses,repairs,-143.85,14941.67
buyer_5,Sara,,1994-03-12,ES75209517551006251525,TRX_N-00802-74418514,2023-11-07T14:13:31,Donostia,expenses,phone,-30.63,14911.04
buyer_5,Sara,,1994-03-12,ES75209517551006251525,TRX_N-00803-27794142,2023-11-08T18:35:00,Donostia,expenses,electricity,-33.08,14877.96
buyer_5,Sara,,1994-03-12,ES75209517551006251525,TRX_N-00804-41031343,2023-11-08T09:19:29,Donostia,expenses,internet,-42.0,14835.96
buyer_5,Sara,,1994-03-12,ES75209517551006251525,TRX_N-00805-94390130,2023-11-08T12:29:53,Donostia,expenses,education,-63.44,14772.52
buyer_5,Sara,,1994-03-12,ES75209517551006251525,TRX_N-00806-25441096,2023-11-11T23:23:13,Donostia,expenses,repairs,-167.09,14605.43
buyer_5,Sara,,1994-03-12,ES75209517551006251525,TRX_N-00807-68558398,2023-11-12T08:02:32,Donostia,expenses,food,-77.82,14527.61
buyer_5,Sara,,1994-03-12,ES75209517551006251525,TRX_N-00808-74205353,2023-11-13T10:40:26,Donostia,expenses,food,-87.17,14440.44
buyer_5,Sara,,1994-03-12,ES75209517551006251525,TRX_N-00809-01840889,2023-11-13T15:16:41,Donostia,expenses,cash,-100.0,14340.44
buyer_5,Sara,,1994-03-12,ES75209517551006251525,TRX_N-00810-86022941,2023-11-16T08:19:50,Oy√≥n-Oion,expenses,gifts,-87.43,14253.01
buyer_5,Sara,,1994-03-12,ES75209517551006251525,TRX_N-00811-57122943,2023-11-19T13:46:44,Donostia,expenses,transport,-86.21,14166.8
buyer_5,Sara,,1994-03-12,ES75209517551006251525,TRX_N-00812-56814680,2023-11-19T08:39:26,Donostia,expenses,leisure,-82.59,14084.21
buyer_5,Sara,,1994-03-12,ES75209517551006251525,TRX_N-00813-03536691,2023-11-20T18:00:41,Donostia,expenses,food,-65.9,14018.31
buyer_5,Sara,,1994-03-12,ES75209517551006251525,TRX_N-00814-94813620,2023-11-21T14:54:09,Pasaia,expenses,cash,-100.0,13918.31
buyer_5,Sara,,1994-03-12,ES75209517551006251525,TRX_N-00815-22210580,2023-11-21T12:53:44,Irun,expenses,travel,-749.11,13169.2
buyer_5,Sara,,1994-03-12,ES75209517551006251525,TRX_N-00816-76256248,2023-11-22T19:11:45,Donostia,expenses,gifts,-547.41,12621.79
buyer_5,Sara,,1994-03-12,ES75209517551006251525,TRX_N-00817-74636195,2023-11-23T19:13:22,Donostia,expenses,food,-112.6,12509.19
buyer_5,Sara,,1994-03-12,ES75209517551006251525,TRX_N-00818-75641958,2023-11-23T15:56:59,Donostia,expenses,cash,-100.0,12409.19
buyer_5,Sara,,1994-03-12,ES75209517551006251525,TRX_N-00819-62150796,2023-11-24T12:03:18,Donostia,expenses,leisure,-39.25,12369.94
buyer_5,Sara,,1994-03-12,ES75209517551006251525,TRX_N-00820-06851706,2023-11-25T22:26:31,Donostia,expenses,clothing,-117.28,12252.66
buyer_5,Sara,,1994-03-12,ES75209517551006251525,TRX_N-00821-34134276,2023-11-26T18:26:19,Donostia,expenses,clothing,-73.78,12178.88
buyer_5,Sara,,1994-03-12,ES75209517551006251525,TRX_N-00822-39095625,2023-11-27T09:40:13,Donostia,expenses,food,-106.79,12072.09
buyer_5,Sara,,1994-03-12,ES75209517551006251525,TRX_N-00823-30882197,2023-11-27T13:52:46,Donostia,expenses,cash,-100.0,11972.09
buyer_5,Sara,,1994-03-12,ES75209517551006251525,TRX_N-00824-01892688,2023-11-28T16:46:50,Donostia,expenses,cash,-100.0,11872.09
buyer_5,Sara,,1994-03-12,ES75209517551006251525,TRX_N-00825-19958317,2023-12-01T18:51:50,Donostia,incomes,salary,2420.36,14292.45
buyer_5,Sara,,1994-03-12,ES75209517551006251525,TRX_N-00826-51072287,2023-12-01T18:51:50,Donostia,incomes,salary_partner,2652.93,16945.38
buyer_5,Sara,,1994-03-12,ES75209517551006251525,TRX_N-00827-21413535,2023-12-01T18:51:50,Donostia,incomes,salary_bonus,1922.2,18867.58
buyer_5,Sara,,1994-03-12,ES75209517551006251525,TRX_N-00828-60156725,2023-12-01T18:51:50,Donostia,incomes,salary_partner_bonus,1941.72,20809.3
buyer_5,Sara,,1994-03-12,ES75209517551006251525,TRX_N-00829-00943736,2023-12-01T03:41:37,Irun,expenses,education,-52.8,20756.5
buyer_5,Sara,,1994-03-12,ES75209517551006251525,TRX_N-00830-64510954,2023-12-02T05:23:11,Donostia,expenses,leisure,-27.84,20728.66
buyer_5,Sara,,1994-03-12,ES75209517551006251525,TRX_N-00831-76767086,2023-12-04T16:31:02,Donostia,expenses,mortgage,-754.18,19974.48
buyer_5,Sara,,1994-03-12,ES75209517551006251525,TRX_N-00832-70955571,2023-12-04T13:11:00,Donostia,expenses,leisure,-65.95,19908.53
buyer_5,Sara,,1994-03-12,ES75209517551006251525,TRX_N-00833-84579033,2023-12-06T09:21:12,Donostia,expenses,internet,-42.0,19866.53
buyer_5,Sara,,1994-03-12,ES75209517551006251525,TRX_N-00834-64287930,2023-12-06T14:51:42,Donostia,expenses,phone,-33.87,19832.66
buyer_5,Sara,,1994-03-12,ES75209517551006251525,TRX_N-00835-12026148,2023-12-06T12:49:08,Donostia,expenses,leisure,-55.79,19776.87
buyer_5,Sara,,1994-03-12,ES75209517551006251525,TRX_N-00836-45081968,2023-12-06T09:28:54,Hernani,expenses,appliances,-401.02,19375.85
buyer_5,Sara,,1994-03-12,ES75209517551006251525,TRX_N-00837-09395272,2023-12-07T18:14:31,Donostia,expenses,water,-33.16,19342.69
buyer_5,Sara,,1994-03-12,ES75209517551006251525,TRX_N-00838-15832340,2023-12-07T21:52:59,Zuia,expenses,food,-121.0,19221.69
buyer_5,Sara,,1994-03-12,ES75209517551006251525,TRX_N-00839-36317367,2023-12-07T11:18:29,Donostia,expenses,clothing,-56.58,19165.11
buyer_5,Sara,,1994-03-12,ES75209517551006251525,TRX_N-00840-41268578,2023-12-07T09:46:31,Donostia,expenses,appliances,-111.04,19054.07
buyer_5,Sara,,1994-03-12,ES75209517551006251525,TRX_N-00841-13045564,2023-12-07T17:53:48,Donostia,expenses,gifts,-708.54,18345.53
buyer_5,Sara,,1994-03-12,ES75209517551006251525,TRX_N-00842-23712134,2023-12-08T22:20:08,Donostia,expenses,electricity,-24.02,18321.51
buyer_5,Sara,,1994-03-12,ES75209517551006251525,TRX_N-00843-47788687,2023-12-08T10:58:18,Donostia,expenses,gas,-42.97,18278.54
buyer_5,Sara,,1994-03-12,ES75209517551006251525,TRX_N-00844-74343770,2023-12-08T19:07:12,Donostia,expenses,transport,-58.01,18220.53
buyer_5,Sara,,1994-03-12,ES75209517551006251525,TRX_N-00845-80571256,2023-12-10T20:35:16,Donostia,expenses,transport,-42.6,18177.93
buyer_5,Sara,,1994-03-12,ES75209517551006251525,TRX_N-00846-29430765,2023-12-10T23:22:31,Donostia,expenses,repairs,-181.22,17996.71
buyer_5,Sara,,1994-03-12,ES75209517551006251525,TRX_N-00847-31246293,2023-12-11T16:56:41,Donostia,expenses,leisure,-45.28,17951.43
buyer_5,Sara,,1994-03-12,ES75209517551006251525,TRX_N-00848-15259593,2023-12-11T23:21:40,Donostia,expenses,appliances,-232.71,17718.72
buyer_5,Sara,,1994-03-12,ES75209517551006251525,TRX_N-00849-59276739,2023-12-11T08:31:25,Donostia,expenses,repairs,-34.79,17683.93
buyer_5,Sara,,1994-03-12,ES75209517551006251525,TRX_N-00850-22403883,2023-12-13T11:21:00,Donostia,expenses,travel,-1058.36,16625.57
buyer_5,Sara,,1994-03-12,ES75209517551006251525,TRX_N-00851-39955115,2023-12-13T13:14:23,Donostia,expenses,gifts,-314.47,16311.1
buyer_5,Sara,,1994-03-12,ES75209517551006251525,TRX_N-00852-18263849,2023-12-14T15:26:52,Donostia,expenses,food,-122.85,16188.25
buyer_5,Sara,,1994-03-12,ES75209517551006251525,TRX_N-00853-82222121,2023-12-15T21:21:08,Getxo,expenses,cash,-100.0,16088.25
buyer_5,Sara,,1994-03-12,ES75209517551006251525,TRX_N-00854-17401292,2023-12-16T12:53:22,Donostia,expenses,transport,-67.26,16020.99
buyer_5,Sara,,1994-03-12,ES75209517551006251525,TRX_N-00855-83251572,2023-12-18T20:00:02,Donostia,expenses,clothing,-70.7,15950.29
buyer_5,Sara,,1994-03-12,ES75209517551006251525,TRX_N-00856-12562611,2023-12-18T13:33:59,Donostia,expenses,cash,-100.0,15850.29
buyer_5,Sara,,1994-03-12,ES75209517551006251525,TRX_N-00857-10486425,2023-12-20T09:43:11,Iru√±a de Oca,expenses,repairs,-68.48,15781.81
buyer_5,Sara,,1994-03-12,ES75209517551006251525,TRX_N-00858-03724733,2023-12-21T15:29:45,Donostia,expenses,cash,-100.0,15681.81
buyer_5,Sara,,1994-03-12,ES75209517551006251525,TRX_N-00859-48420487,2023-12-22T16:50:37,Donostia,expenses,transport,-64.04,15617.77
buyer_5,Sara,,1994-03-12,ES75209517551006251525,TRX_N-00860-70988738,2023-12-23T09:24:32,Labastida,expenses,leisure,-80.04,15537.73
buyer_5,Sara,,1994-03-12,ES75209517551006251525,TRX_N-00861-82359344,2023-12-24T16:59:51,Donostia,expenses,transport,-61.88,15475.85
buyer_5,Sara,,1994-03-12,ES75209517551006251525,TRX_N-00862-91990269,2023-12-24T12:52:39,Donostia,expenses,gifts,-149.5,15326.35
buyer_5,Sara,,1994-03-12,ES75209517551006251525,TRX_N-00863-88084413,2023-12-26T21:32:06,Donostia,expenses,cash,-100.0,15226.35
buyer_5,Sara,,1994-03-12,ES75209517551006251525,TRX_N-00864-60040160,2023-12-27T00:25:49,Donostia,expenses,food,-104.92,15121.43
buyer_5,Sara,,1994-03-12,ES75209517551006251525,TRX_N-00865-07075191,2023-12-27T22:26:29,Donostia,expenses,leisure,-71.12,15050.31
buyer_5,Sara,,1994-03-12,ES75209517551006251525,TRX_N-00866-90366408,2023-12-28T11:21:31,Donostia,expenses,transport,-87.81,14962.5
buyer_5,Sara,,1994-03-12,ES75209517551006251525,TRX_N-00867-86426638,2023-12-28T13:05:28,Donostia,expenses,cash,-100.0,14862.5
buyer_5,Sara,,1994-03-12,ES75209517551006251525,TRX_N-00868-14272818,2023-12-31T08:48:07,Vitoria-Gasteiz,expenses,leisure,-40.69,14821.81
buyer_5,Sara,,1994-03-12,ES75209517551006251525,TRX_N-00869-13185279,2024-01-01T18:56:08,Donostia,incomes,salary,2478.68,17300.49
buyer_5,Sara,,1994-03-12,ES75209517551006251525,TRX_N-00870-62643533,2024-01-01T18:56:08,Donostia,incomes,salary_partner,2716.85,20017.34
buyer_5,Sara,,1994-03-12,ES75209517551006251525,TRX_N-00871-52538168,2024-01-02T14:51:08,Donostia,expenses,leisure,-27.57,19989.77
buyer_5,Sara,,1994-03-12,ES75209517551006251525,TRX_N-00872-59879683,2024-01-02T20:01:31,Portugalete,expenses,travel,-1420.57,18569.2
buyer_5,Sara,,1994-03-12,ES75209517551006251525,TRX_N-00873-41127732,2024-01-04T21:08:12,Donostia,expenses,mortgage,-754.18,17815.02
buyer_5,Sara,,1994-03-12,ES75209517551006251525,TRX_N-00874-87295525,2024-01-05T15:52:14,Donostia,expenses,electricity,-39.25,17775.77
buyer_5,Sara,,1994-03-12,ES75209517551006251525,TRX_N-00875-88421214,2024-01-05T13:33:02,Donostia,expenses,internet,-42.0,17733.77
buyer_5,Sara,,1994-03-12,ES75209517551006251525,TRX_N-00876-88170281,2024-01-06T08:23:57,Donostia,expenses,gas,-111.46,17622.31
buyer_5,Sara,,1994-03-12,ES75209517551006251525,TRX_N-00877-08311001,2024-01-07T11:52:57,Donostia,expenses,water,-21.99,17600.32
buyer_5,Sara,,1994-03-12,ES75209517551006251525,TRX_N-00878-82863115,2024-01-07T20:06:45,Donostia,expenses,travel,-1751.22,15849.1
buyer_5,Sara,,1994-03-12,ES75209517551006251525,TRX_N-00879-50364481,2024-01-08T10:13:26,Donostia,expenses,phone,-44.97,15804.13
buyer_5,Sara,,1994-03-12,ES75209517551006251525,TRX_N-00880-60415618,2024-01-11T10:03:36,Donostia,expenses,cash,-100.0,15704.13
buyer_5,Sara,,1994-03-12,ES75209517551006251525,TRX_N-00881-17106173,2024-01-12T11:12:14,Donostia,expenses,cash,-100.0,15604.13
buyer_5,Sara,,1994-03-12,ES75209517551006251525,TRX_N-00882-89533124,2024-01-13T09:15:41,Donostia,expenses,leisure,-83.5,15520.63
buyer_5,Sara,,1994-03-12,ES75209517551006251525,TRX_N-00883-38184929,2024-01-13T17:43:42,Donostia,expenses,cash,-100.0,15420.63
buyer_5,Sara,,1994-03-12,ES75209517551006251525,TRX_N-00884-47265565,2024-01-14T20:33:10,Donostia,expenses,healthcare,-90.03,15330.6
buyer_5,Sara,,1994-03-12,ES75209517551006251525,TRX_N-00885-74928337,2024-01-15T18:25:29,Donostia,expenses,clothing,-64.77,15265.83
buyer_5,Sara,,1994-03-12,ES75209517551006251525,TRX_N-00886-69748719,2024-01-15T20:14:14,Bilbao,expenses,gifts,-359.96,14905.87
buyer_5,Sara,,1994-03-12,ES75209517551006251525,TRX_N-00887-02089674,2024-01-16T16:34:24,Sestao,expenses,food,-115.67,14790.2
buyer_5,Sara,,1994-03-12,ES75209517551006251525,TRX_N-00888-21508533,2024-01-16T02:32:27,Donostia,expenses,leisure,-63.36,14726.84
buyer_5,Sara,,1994-03-12,ES75209517551006251525,TRX_N-00889-99138665,2024-01-17T01:26:50,Donostia,expenses,leisure,-64.91,14661.93
buyer_5,Sara,,1994-03-12,ES75209517551006251525,TRX_N-00890-60160819,2024-01-18T11:52:49,Donostia,expenses,cash,-100.0,14561.93
buyer_5,Sara,,1994-03-12,ES75209517551006251525,TRX_N-00891-96375735,2024-01-21T19:32:33,Donostia,expenses,food,-118.62,14443.31
buyer_5,Sara,,1994-03-12,ES75209517551006251525,TRX_N-00892-35983022,2024-01-24T20:42:48,Donostia,expenses,transport,-80.42,14362.89
buyer_5,Sara,,1994-03-12,ES75209517551006251525,TRX_N-00893-36177926,2024-01-24T14:20:57,Donostia,expenses,clothing,-136.53,14226.36
buyer_5,Sara,,1994-03-12,ES75209517551006251525,TRX_N-00894-63531792,2024-01-26T04:28:06,Donostia,expenses,food,-90.47,14135.89
buyer_5,Sara,,1994-03-12,ES75209517551006251525,TRX_N-00895-16116610,2024-01-26T14:24:30,Donostia,expenses,cash,-100.0,14035.89
buyer_5,Sara,,1994-03-12,ES75209517551006251525,TRX_N-00896-16481670,2024-01-27T12:59:23,Donostia,expenses,leisure,-18.82,14017.07
buyer_5,Sara,,1994-03-12,ES75209517551006251525,TRX_N-00897-27850051,2024-01-28T12:27:51,Erandio,expenses,food,-106.74,13910.33
buyer_5,Sara,,1994-03-12,ES75209517551006251525,TRX_N-00898-97835110,2024-01-29T15:57:20,Arrasate,expenses,cash,-100.0,13810.33
buyer_5,Sara,,1994-03-12,ES75209517551006251525,TRX_N-00899-08533073,2024-01-30T15:30:05,Donostia,expenses,education,-59.19,13751.14
buyer_5,Sara,,1994-03-12,ES75209517551006251525,TRX_N-00900-81916224,2024-02-01T21:58:51,Donostia,incomes,salary,2478.68,16229.82
buyer_5,Sara,,1994-03-12,ES75209517551006251525,TRX_N-00901-91212833,2024-02-01T21:58:51,Donostia,incomes,salary_partner,2716.85,18946.67
buyer_5,Sara,,1994-03-12,ES75209517551006251525,TRX_N-00902-91545366,2024-02-01T21:58:51,Donostia,incomes,extra_income,234.39,19181.06
buyer_5,Sara,,1994-03-12,ES75209517551006251525,TRX_N-00903-73748964,2024-02-01T17:29:20,Donostia,expenses,repairs,-327.0,18854.06
buyer_5,Sara,,1994-03-12,ES75209517551006251525,TRX_N-00904-02119834,2024-02-02T22:23:26,Donostia,expenses,food,-102.91,18751.15
buyer_5,Sara,,1994-03-12,ES75209517551006251525,TRX_N-00905-21075527,2024-02-02T08:13:26,Donostia,expenses,cash,-100.0,18651.15
buyer_5,Sara,,1994-03-12,ES75209517551006251525,TRX_N-00906-13011150,2024-02-04T17:26:43,Donostia,expenses,mortgage,-754.18,17896.97
buyer_5,Sara,,1994-03-12,ES75209517551006251525,TRX_N-00907-39730739,2024-02-04T12:55:43,Donostia,expenses,healthcare,-125.2,17771.77
buyer_5,Sara,,1994-03-12,ES75209517551006251525,TRX_N-00908-40143767,2024-02-05T10:22:10,Donostia,expenses,water,-21.75,17750.02
buyer_5,Sara,,1994-03-12,ES75209517551006251525,TRX_N-00909-09729885,2024-02-05T08:53:07,Donostia,expenses,repairs,-258.6,17491.42
buyer_5,Sara,,1994-03-12,ES75209517551006251525,TRX_N-00910-13722198,2024-02-06T07:48:02,Donostia,expenses,electricity,-34.11,17457.31
buyer_5,Sara,,1994-03-12,ES75209517551006251525,TRX_N-00911-42985322,2024-02-06T20:42:38,Donostia,expenses,phone,-33.78,17423.53
buyer_5,Sara,,1994-03-12,ES75209517551006251525,TRX_N-00912-22476722,2024-02-06T20:18:18,Donostia,expenses,cash,-100.0,17323.53
buyer_5,Sara,,1994-03-12,ES75209517551006251525,TRX_N-00913-74967564,2024-02-07T18:01:38,Donostia,expenses,internet,-42.0,17281.53
buyer_5,Sara,,1994-03-12,ES75209517551006251525,TRX_N-00914-29315272,2024-02-07T08:31:54,Donostia,expenses,food,-79.52,17202.01
buyer_5,Sara,,1994-03-12,ES75209517551006251525,TRX_N-00915-91570000,2024-02-07T17:17:16,Donostia,expenses,cash,-100.0,17102.01
buyer_5,Sara,,1994-03-12,ES75209517551006251525,TRX_N-00916-11154709,2024-02-08T14:01:32,Donostia,expenses,gas,-70.01,17032.0
buyer_5,Sara,,1994-03-12,ES75209517551006251525,TRX_N-00917-33406817,2024-02-11T16:58:04,Donostia,expenses,food,-100.3,16931.7
buyer_5,Sara,,1994-03-12,ES75209517551006251525,TRX_N-00918-04641817,2024-02-11T14:42:50,Donostia,expenses,cash,-100.0,16831.7
buyer_5,Sara,,1994-03-12,ES75209517551006251525,TRX_N-00919-09058467,2024-02-12T16:29:18,Donostia,expenses,food,-124.33,16707.37
buyer_5,Sara,,1994-03-12,ES75209517551006251525,TRX_N-00920-19593280,2024-02-12T19:33:43,Donostia,expenses,clothing,-47.4,16659.97
buyer_5,Sara,,1994-03-12,ES75209517551006251525,TRX_N-00921-02920913,2024-02-12T11:29:33,Leioa,expenses,cash,-100.0,16559.97
buyer_5,Sara,,1994-03-12,ES75209517551006251525,TRX_N-00922-67897001,2024-02-13T08:39:57,Donostia,expenses,appliances,-242.99,16316.98
buyer_5,Sara,,1994-03-12,ES75209517551006251525,TRX_N-00923-60689197,2024-02-14T22:04:21,Donostia,expenses,food,-74.87,16242.11
buyer_5,Sara,,1994-03-12,ES75209517551006251525,TRX_N-00924-82693324,2024-02-14T12:27:16,Berango,expenses,cash,-100.0,16142.11
buyer_5,Sara,,1994-03-12,ES75209517551006251525,TRX_N-00925-12718082,2024-02-18T15:52:54,Donostia,expenses,cash,-100.0,16042.11
buyer_5,Sara,,1994-03-12,ES75209517551006251525,TRX_N-00926-14617436,2024-02-18T17:09:59,Donostia,expenses,repairs,-108.95,15933.16
buyer_5,Sara,,1994-03-12,ES75209517551006251525,TRX_N-00927-17899872,2024-02-19T23:03:09,Donostia,expenses,transport,-85.74,15847.42
buyer_5,Sara,,1994-03-12,ES75209517551006251525,TRX_N-00928-32979714,2024-02-20T10:33:15,Donostia,expenses,food,-63.49,15783.93
buyer_5,Sara,,1994-03-12,ES75209517551006251525,TRX_N-00929-64343628,2024-02-21T16:40:50,Donostia,expenses,cash,-100.0,15683.93
buyer_5,Sara,,1994-03-12,ES75209517551006251525,TRX_N-00930-33480360,2024-02-22T14:48:11,Barakaldo,expenses,transport,-86.02,15597.91
buyer_5,Sara,,1994-03-12,ES75209517551006251525,TRX_N-00931-71727615,2024-02-24T15:01:01,Portugalete,expenses,transport,-51.91,15546.0
buyer_5,Sara,,1994-03-12,ES75209517551006251525,TRX_N-00932-81319503,2024-02-24T19:14:56,Donostia,expenses,cash,-100.0,15446.0
buyer_5,Sara,,1994-03-12,ES75209517551006251525,TRX_N-00933-33285578,2024-02-26T15:22:42,Donostia,expenses,leisure,-39.53,15406.47
buyer_5,Sara,,1994-03-12,ES75209517551006251525,TRX_N-00934-10245636,2024-02-27T16:38:03,Donostia,expenses,cash,-100.0,15306.47
buyer_5,Sara,,1994-03-12,ES75209517551006251525,TRX_N-00935-86844117,2024-03-01T18:32:32,Donostia,incomes,salary,2478.68,17785.15
buyer_5,Sara,,1994-03-12,ES75209517551006251525,TRX_N-00936-10046519,2024-03-01T18:32:32,Donostia,incomes,salary_partner,2716.85,20502.0
buyer_5,Sara,,1994-03-12,ES75209517551006251525,TRX_N-00937-53703319,2024-03-02T14:09:26,Donostia,expenses,healthcare,-142.2,20359.8
buyer_5,Sara,,1994-03-12,ES75209517551006251525,TRX_N-00938-76817226,2024-03-02T08:38:14,Donostia,expenses,cash,-100.0,20259.8
buyer_5,Sara,,1994-03-12,ES75209517551006251525,TRX_N-00939-40807446,2024-03-04T12:27:38,Donostia,expenses,mortgage,-754.18,19505.62
buyer_5,Sara,,1994-03-12,ES75209517551006251525,TRX_N-00940-48530121,2024-03-04T09:23:26,Donostia,expenses,transport,-40.76,19464.86
buyer_5,Sara,,1994-03-12,ES75209517551006251525,TRX_N-00941-67685097,2024-03-05T09:22:37,Donostia,expenses,gas,-103.13,19361.73
buyer_5,Sara,,1994-03-12,ES75209517551006251525,TRX_N-00942-97298179,2024-03-05T09:39:55,Donostia,expenses,internet,-42.0,19319.73
buyer_5,Sara,,1994-03-12,ES75209517551006251525,TRX_N-00943-86130541,2024-03-05T08:30:56,Donostia,expenses,cash,-100.0,19219.73
buyer_5,Sara,,1994-03-12,ES75209517551006251525,TRX_N-00944-70744237,2024-03-06T14:43:33,Donostia,expenses,leisure,-53.87,19165.86
buyer_5,Sara,,1994-03-12,ES75209517551006251525,TRX_N-00945-96639780,2024-03-06T19:07:59,Donostia,expenses,cash,-100.0,19065.86
buyer_5,Sara,,1994-03-12,ES75209517551006251525,TRX_N-00946-05727108,2024-03-08T19:45:26,Donostia,expenses,electricity,-43.44,19022.42
buyer_5,Sara,,1994-03-12,ES75209517551006251525,TRX_N-00947-58417407,2024-03-08T18:26:42,Donostia,expenses,phone,-32.2,18990.22
buyer_5,Sara,,1994-03-12,ES75209517551006251525,TRX_N-00948-85940380,2024-03-08T10:06:26,Donostia,expenses,water,-31.31,18958.91
buyer_5,Sara,,1994-03-12,ES75209517551006251525,TRX_N-00949-47955905,2024-03-08T20:19:53,Pasaia,expenses,clothing,-45.11,18913.8
buyer_5,Sara,,1994-03-12,ES75209517551006251525,TRX_N-00950-84028784,2024-03-08T13:03:42,Donostia,expenses,education,-59.99,18853.81
buyer_5,Sara,,1994-03-12,ES75209517551006251525,TRX_N-00951-96484624,2024-03-10T19:36:04,Donostia,expenses,food,-85.82,18767.99
buyer_5,Sara,,1994-03-12,ES75209517551006251525,TRX_N-00952-76105392,2024-03-12T09:19:11,Donostia,expenses,repairs,-271.34,18496.65
buyer_5,Sara,,1994-03-12,ES75209517551006251525,TRX_N-00953-81677044,2024-03-13T11:54:34,Arrasate,expenses,leisure,-21.2,18475.45
buyer_5,Sara,,1994-03-12,ES75209517551006251525,TRX_N-00954-07139557,2024-03-15T15:07:41,Donostia,expenses,cash,-100.0,18375.45
buyer_5,Sara,,1994-03-12,ES75209517551006251525,TRX_N-00955-83648217,2024-03-16T08:30:35,Donostia,expenses,leisure,-23.71,18351.74
buyer_5,Sara,,1994-03-12,ES75209517551006251525,TRX_N-00956-32357629,2024-03-16T23:31:55,Llodio,expenses,cash,-100.0,18251.74
buyer_5,Sara,,1994-03-12,ES75209517551006251525,TRX_N-00957-37900852,2024-03-17T15:34:44,Errenteria,expenses,education,-73.79,18177.95
buyer_5,Sara,,1994-03-12,ES75209517551006251525,TRX_N-00958-86034189,2024-03-17T05:08:43,Eibar,expenses,cash,-100.0,18077.95
buyer_5,Sara,,1994-03-12,ES75209517551006251525,TRX_N-00959-38396550,2024-03-17T20:01:41,Donostia,expenses,gifts,-559.78,17518.17
buyer_5,Sara,,1994-03-12,ES75209517551006251525,TRX_N-00960-42456094,2024-03-18T15:57:08,Donostia,expenses,transport,-40.96,17477.21
buyer_5,Sara,,1994-03-12,ES75209517551006251525,TRX_N-00961-35498028,2024-03-18T08:55:18,Donostia,expenses,cash,-100.0,17377.21
buyer_5,Sara,,1994-03-12,ES75209517551006251525,TRX_N-00962-01101382,2024-03-21T20:23:39,Donostia,expenses,food,-111.8,17265.41
buyer_5,Sara,,1994-03-12,ES75209517551006251525,TRX_N-00963-50769987,2024-03-21T18:30:09,Bermeo,expenses,transport,-67.65,17197.76
buyer_5,Sara,,1994-03-12,ES75209517551006251525,TRX_N-00964-78725076,2024-03-21T19:45:42,Donostia,expenses,leisure,-71.45,17126.31
buyer_5,Sara,,1994-03-12,ES75209517551006251525,TRX_N-00965-57401385,2024-03-23T15:52:08,Donostia,expenses,leisure,-50.98,17075.33
buyer_5,Sara,,1994-03-12,ES75209517551006251525,TRX_N-00966-88344873,2024-03-23T19:57:52,Donostia,expenses,cash,-100.0,16975.33
buyer_5,Sara,,1994-03-12,ES75209517551006251525,TRX_N-00967-89749806,2024-03-26T12:07:03,Donostia,expenses,cash,-100.0,16875.33
buyer_5,Sara,,1994-03-12,ES75209517551006251525,TRX_N-00968-64177105,2024-03-26T19:45:15,Sopela,expenses,repairs,-299.67,16575.66
buyer_5,Sara,,1994-03-12,ES75209517551006251525,TRX_N-00969-52273960,2024-03-29T20:50:46,Donostia,expenses,transport,-63.37,16512.29
buyer_5,Sara,,1994-03-12,ES75209517551006251525,TRX_N-00970-87637004,2024-03-30T10:23:07,Donostia,expenses,education,-65.52,16446.77
buyer_5,Sara,,1994-03-12,ES75209517551006251525,TRX_N-00971-89200872,2024-03-31T19:35:00,Donostia,expenses,leisure,-46.05,16400.72
buyer_5,Sara,,1994-03-12,ES75209517551006251525,TRX_N-00972-22539957,2024-03-31T11:49:31,Donostia,expenses,cash,-100.0,16300.72
buyer_5,Sara,,1994-03-12,ES75209517551006251525,TRX_N-00973-56809587,2024-04-01T17:45:48,Donostia,incomes,salary,2478.68,18779.4
buyer_5,Sara,,1994-03-12,ES75209517551006251525,TRX_N-00974-39013277,2024-04-01T17:45:48,Donostia,incomes,salary_partner,2716.85,21496.25
buyer_5,Sara,,1994-03-12,ES75209517551006251525,TRX_N-00975-66208382,2024-04-01T18:41:21,Donostia,expenses,appliances,-361.11,21135.14
buyer_5,Sara,,1994-03-12,ES75209517551006251525,TRX_N-00976-30236110,2024-04-02T16:47:50,Sestao,expenses,leisure,-75.6,21059.54
buyer_5,Sara,,1994-03-12,ES75209517551006251525,TRX_N-00977-63533794,2024-04-04T17:42:40,Donostia,expenses,mortgage,-754.18,20305.36
buyer_5,Sara,,1994-03-12,ES75209517551006251525,TRX_N-00978-13079991,2024-04-04T18:20:22,Vitoria-Gasteiz,expenses,food,-70.28,20235.08
buyer_5,Sara,,1994-03-12,ES75209517551006251525,TRX_N-00979-48316106,2024-04-05T01:14:31,Donostia,expenses,internet,-42.0,20193.08
buyer_5,Sara,,1994-03-12,ES75209517551006251525,TRX_N-00980-59878899,2024-04-05T06:31:25,Donostia,expenses,gifts,-29.21,20163.87
buyer_5,Sara,,1994-03-12,ES75209517551006251525,TRX_N-00981-92085675,2024-04-06T23:14:00,Donostia,expenses,transport,-46.09,20117.78
buyer_5,Sara,,1994-03-12,ES75209517551006251525,TRX_N-00982-79753954,2024-04-06T16:17:40,Donostia,expenses,repairs,-265.06,19852.72
buyer_5,Sara,,1994-03-12,ES75209517551006251525,TRX_N-00983-13283387,2024-04-07T15:30:14,Donostia,expenses,electricity,-80.2,19772.52
buyer_5,Sara,,1994-03-12,ES75209517551006251525,TRX_N-00984-86074687,2024-04-08T10:17:41,Donostia,expenses,water,-34.44,19738.08
buyer_5,Sara,,1994-03-12,ES75209517551006251525,TRX_N-00985-17223679,2024-04-08T19:05:14,Donostia,expenses,gas,-50.96,19687.12
buyer_5,Sara,,1994-03-12,ES75209517551006251525,TRX_N-00986-47068799,2024-04-08T20:31:50,Donostia,expenses,phone,-42.22,19644.9
buyer_5,Sara,,1994-03-12,ES75209517551006251525,TRX_N-00987-20467126,2024-04-11T01:19:04,Donostia,expenses,transport,-46.13,19598.77
buyer_5,Sara,,1994-03-12,ES75209517551006251525,TRX_N-00988-38158742,2024-04-11T19:36:27,Donostia,expenses,repairs,-311.88,19286.89
buyer_5,Sara,,1994-03-12,ES75209517551006251525,TRX_N-00989-37228964,2024-04-13T16:10:35,Durango,expenses,repairs,-45.32,19241.57
buyer_5,Sara,,1994-03-12,ES75209517551006251525,TRX_N-00990-68414251,2024-04-14T09:18:41,Amurrio,expenses,food,-110.22,19131.35
buyer_5,Sara,,1994-03-12,ES75209517551006251525,TRX_N-00991-68052267,2024-04-15T19:58:30,Donostia,expenses,leisure,-34.0,19097.35
buyer_5,Sara,,1994-03-12,ES75209517551006251525,TRX_N-00992-62137688,2024-04-18T12:16:47,Donostia,expenses,food,-107.14,18990.21
buyer_5,Sara,,1994-03-12,ES75209517551006251525,TRX_N-00993-43026376,2024-04-18T21:31:58,Donostia,expenses,leisure,-58.72,18931.49
buyer_5,Sara,,1994-03-12,ES75209517551006251525,TRX_N-00994-10429081,2024-04-18T11:09:01,Andoain,expenses,cash,-100.0,18831.49
buyer_5,Sara,,1994-03-12,ES75209517551006251525,TRX_N-00995-06190338,2024-04-20T02:57:00,Donostia,expenses,food,-98.5,18732.99
buyer_5,Sara,,1994-03-12,ES75209517551006251525,TRX_N-00996-91692484,2024-04-20T23:44:01,Donostia,expenses,transport,-80.08,18652.91
buyer_5,Sara,,1994-03-12,ES75209517551006251525,TRX_N-00997-67512389,2024-04-21T15:50:11,Donostia,expenses,cash,-100.0,18552.91
buyer_5,Sara,,1994-03-12,ES75209517551006251525,TRX_N-00998-08235878,2024-04-22T18:43:11,Donostia,expenses,appliances,-88.62,18464.29
buyer_5,Sara,,1994-03-12,ES75209517551006251525,TRX_N-00999-94132817,2024-04-24T14:45:12,Donostia,expenses,gifts,-659.88,17804.41
buyer_5,Sara,,1994-03-12,ES75209517551006251525,TRX_N-01000-77875172,2024-04-25T08:49:44,Donostia,expenses,cash,-100.0,17704.41
buyer_5,Sara,,1994-03-12,ES75209517551006251525,TRX_N-01001-94377257,2024-04-28T22:49:00,Amurrio,expenses,food,-63.72,17640.69
buyer_5,Sara,,1994-03-12,ES75209517551006251525,TRX_N-01002-33491524,2024-04-29T08:11:43,Donostia,expenses,cash,-100.0,17540.69
buyer_5,Sara,,1994-03-12,ES75209517551006251525,TRX_N-01003-98199511,2024-05-01T18:32:31,Donostia,incomes,salary,2478.68,20019.37
buyer_5,Sara,,1994-03-12,ES75209517551006251525,TRX_N-01004-28536566,2024-05-01T18:32:31,Donostia,incomes,salary_partner,2716.85,22736.22
buyer_5,Sara,,1994-03-12,ES75209517551006251525,TRX_N-01005-60443818,2024-05-01T18:32:31,Donostia,incomes,extra_income,234.39,22970.61
buyer_5,Sara,,1994-03-12,ES75209517551006251525,TRX_N-01006-00165142,2024-05-01T06:31:11,Donostia,expenses,transport,-40.86,22929.75
buyer_5,Sara,,1994-03-12,ES75209517551006251525,TRX_N-01007-18549481,2024-05-02T08:36:41,Oy√≥n-Oion,expenses,transport,-74.46,22855.29
buyer_5,Sara,,1994-03-12,ES75209517551006251525,TRX_N-01008-13128786,2024-05-04T23:12:29,Donostia,expenses,mortgage,-754.18,22101.11
buyer_5,Sara,,1994-03-12,ES75209517551006251525,TRX_N-01009-80869373,2024-05-05T07:23:58,Donostia,expenses,water,-37.62,22063.49
buyer_5,Sara,,1994-03-12,ES75209517551006251525,TRX_N-01010-60501932,2024-05-05T01:14:34,Donostia,expenses,electricity,-77.92,21985.57
buyer_5,Sara,,1994-03-12,ES75209517551006251525,TRX_N-01011-90247284,2024-05-06T10:37:40,Hernani,expenses,transport,-82.44,21903.13
buyer_5,Sara,,1994-03-12,ES75209517551006251525,TRX_N-01012-17615341,2024-05-07T19:46:33,Donostia,expenses,phone,-33.67,21869.46
buyer_5,Sara,,1994-03-12,ES75209517551006251525,TRX_N-01013-00444481,2024-05-08T20:00:27,Donostia,expenses,gas,-57.42,21812.04
buyer_5,Sara,,1994-03-12,ES75209517551006251525,TRX_N-01014-61971972,2024-05-08T19:44:34,Donostia,expenses,internet,-42.0,21770.04
buyer_5,Sara,,1994-03-12,ES75209517551006251525,TRX_N-01015-90003536,2024-05-08T10:32:56,Donostia,expenses,food,-114.18,21655.86
buyer_5,Sara,,1994-03-12,ES75209517551006251525,TRX_N-01016-17268582,2024-05-08T14:33:29,Leioa,expenses,leisure,-28.09,21627.77
buyer_5,Sara,,1994-03-12,ES75209517551006251525,TRX_N-01017-76486584,2024-05-08T20:09:18,Basauri,expenses,appliances,-250.46,21377.31
buyer_5,Sara,,1994-03-12,ES75209517551006251525,TRX_N-01018-47623124,2024-05-11T14:13:38,Donostia,expenses,cash,-100.0,21277.31
buyer_5,Sara,,1994-03-12,ES75209517551006251525,TRX_N-01019-39216879,2024-05-13T22:33:22,Galdakao,expenses,leisure,-41.12,21236.19
buyer_5,Sara,,1994-03-12,ES75209517551006251525,TRX_N-01020-15789674,2024-05-14T03:48:18,Donostia,expenses,gifts,-531.98,20704.21
buyer_5,Sara,,1994-03-12,ES75209517551006251525,TRX_N-01021-72177523,2024-05-15T08:13:21,Berango,expenses,leisure,-66.4,20637.81
buyer_5,Sara,,1994-03-12,ES75209517551006251525,TRX_N-01022-75091284,2024-05-16T11:30:08,Donostia,expenses,repairs,-328.31,20309.5
buyer_5,Sara,,1994-03-12,ES75209517551006251525,TRX_N-01023-20157631,2024-05-17T12:22:27,Donostia,expenses,leisure,-41.93,20267.57
buyer_5,Sara,,1994-03-12,ES75209517551006251525,TRX_N-01024-42658140,2024-05-19T08:26:15,Donostia,expenses,leisure,-54.51,20213.06
buyer_5,Sara,,1994-03-12,ES75209517551006251525,TRX_N-01025-46994990,2024-05-19T18:02:11,Donostia,expenses,cash,-100.0,20113.06
buyer_5,Sara,,1994-03-12,ES75209517551006251525,TRX_N-01026-18556309,2024-05-20T12:18:58,Donostia,expenses,transport,-73.6,20039.46
buyer_5,Sara,,1994-03-12,ES75209517551006251525,TRX_N-01027-74823765,2024-05-22T16:07:49,Donostia,expenses,cash,-100.0,19939.46
buyer_5,Sara,,1994-03-12,ES75209517551006251525,TRX_N-01028-71982523,2024-05-23T07:00:48,Donostia,expenses,cash,-100.0,19839.46
buyer_5,Sara,,1994-03-12,ES75209517551006251525,TRX_N-01029-61111624,2024-05-24T15:42:02,Donostia,expenses,food,-92.67,19746.79
buyer_5,Sara,,1994-03-12,ES75209517551006251525,TRX_N-01030-44416922,2024-05-24T14:45:07,Donostia,expenses,leisure,-64.28,19682.51
buyer_5,Sara,,1994-03-12,ES75209517551006251525,TRX_N-01031-19629691,2024-05-25T12:17:21,Donostia,expenses,cash,-100.0,19582.51
buyer_5,Sara,,1994-03-12,ES75209517551006251525,TRX_N-01032-86192233,2024-05-26T06:40:17,Donostia,expenses,cash,-100.0,19482.51
buyer_5,Sara,,1994-03-12,ES75209517551006251525,TRX_N-01033-55724406,2024-05-28T12:23:49,Amurrio,expenses,cash,-100.0,19382.51
buyer_5,Sara,,1994-03-12,ES75209517551006251525,TRX_N-01034-08118022,2024-05-28T20:32:37,Donostia,expenses,repairs,-29.66,19352.85
buyer_5,Sara,,1994-03-12,ES75209517551006251525,TRX_N-01035-47746427,2024-05-30T16:00:58,Donostia,expenses,healthcare,-157.81,19195.04
buyer_5,Sara,,1994-03-12,ES75209517551006251525,TRX_N-01036-41128892,2024-06-01T22:26:49,Donostia,incomes,salary,2478.68,21673.72
buyer_5,Sara,,1994-03-12,ES75209517551006251525,TRX_N-01037-02555363,2024-06-01T22:26:49,Donostia,incomes,salary_partner,2716.85,24390.57
buyer_5,Sara,,1994-03-12,ES75209517551006251525,TRX_N-01038-22586250,2024-06-01T22:26:49,Donostia,incomes,salary_bonus,1893.67,26284.24
buyer_5,Sara,,1994-03-12,ES75209517551006251525,TRX_N-01039-20592994,2024-06-01T22:26:49,Donostia,incomes,salary_partner_bonus,2053.44,28337.68
buyer_5,Sara,,1994-03-12,ES75209517551006251525,TRX_N-01040-46216612,2024-06-01T21:35:45,Donostia,expenses,cash,-100.0,28237.68
buyer_5,Sara,,1994-03-12,ES75209517551006251525,TRX_N-01041-56293557,2024-06-01T14:17:56,Donostia,expenses,appliances,-314.68,27923.0
buyer_5,Sara,,1994-03-12,ES75209517551006251525,TRX_N-01042-32707538,2024-06-02T01:06:57,Donostia,expenses,transport,-51.73,27871.27
buyer_5,Sara,,1994-03-12,ES75209517551006251525,TRX_N-01043-54443160,2024-06-02T06:36:55,Donostia,expenses,cash,-100.0,27771.27
buyer_5,Sara,,1994-03-12,ES75209517551006251525,TRX_N-01044-79006433,2024-06-03T15:33:23,Donostia,expenses,transport,-78.06,27693.21
buyer_5,Sara,,1994-03-12,ES75209517551006251525,TRX_N-01045-29934360,2024-06-04T14:51:54,Donostia,expenses,mortgage,-754.18,26939.03
buyer_5,Sara,,1994-03-12,ES75209517551006251525,TRX_N-01046-91807593,2024-06-04T21:38:45,Donostia,expenses,leisure,-66.07,26872.96
buyer_5,Sara,,1994-03-12,ES75209517551006251525,TRX_N-01047-61338197,2024-06-05T19:45:54,Donostia,expenses,gas,-111.34,26761.62
buyer_5,Sara,,1994-03-12,ES75209517551006251525,TRX_N-01048-45044625,2024-06-05T19:41:03,Donostia,expenses,internet,-42.0,26719.62
buyer_5,Sara,,1994-03-12,ES75209517551006251525,TRX_N-01049-20517796,2024-06-06T19:09:17,Donostia,expenses,electricity,-75.41,26644.21
buyer_5,Sara,,1994-03-12,ES75209517551006251525,TRX_N-01050-39951806,2024-06-06T19:55:02,Donostia,expenses,phone,-38.11,26606.1
buyer_5,Sara,,1994-03-12,ES75209517551006251525,TRX_N-01051-01825576,2024-06-07T09:47:21,Donostia,expenses,leisure,-63.51,26542.59
buyer_5,Sara,,1994-03-12,ES75209517551006251525,TRX_N-01052-06806930,2024-06-08T20:36:19,Donostia,expenses,water,-31.87,26510.72
buyer_5,Sara,,1994-03-12,ES75209517551006251525,TRX_N-01053-55731669,2024-06-08T15:39:10,Zarautz,expenses,cash,-100.0,26410.72
buyer_5,Sara,,1994-03-12,ES75209517551006251525,TRX_N-01054-58845369,2024-06-09T08:29:21,Donostia,expenses,cash,-100.0,26310.72
buyer_5,Sara,,1994-03-12,ES75209517551006251525,TRX_N-01055-10692197,2024-06-09T17:55:59,Donostia,expenses,repairs,-299.17,26011.55
buyer_5,Sara,,1994-03-12,ES75209517551006251525,TRX_N-01056-26695708,2024-06-10T08:10:25,Arrasate,expenses,leisure,-55.44,25956.11
buyer_5,Sara,,1994-03-12,ES75209517551006251525,TRX_N-01057-33204048,2024-06-14T16:11:35,Donostia,expenses,leisure,-50.47,25905.64
buyer_5,Sara,,1994-03-12,ES75209517551006251525,TRX_N-01058-79659976,2024-06-14T14:50:58,Donostia,expenses,gifts,-305.31,25600.33
buyer_5,Sara,,1994-03-12,ES75209517551006251525,TRX_N-01059-34668435,2024-06-16T20:29:19,Donostia,expenses,leisure,-22.25,25578.08
buyer_5,Sara,,1994-03-12,ES75209517551006251525,TRX_N-01060-83077957,2024-06-17T14:56:10,Donostia,expenses,leisure,-44.55,25533.53
buyer_5,Sara,,1994-03-12,ES75209517551006251525,TRX_N-01061-64829574,2024-06-18T16:22:05,Donostia,expenses,food,-101.16,25432.37
buyer_5,Sara,,1994-03-12,ES75209517551006251525,TRX_N-01062-08399886,2024-06-18T08:17:17,Errenteria,expenses,gifts,-530.77,24901.6
buyer_5,Sara,,1994-03-12,ES75209517551006251525,TRX_N-01063-49358732,2024-06-19T09:30:15,Donostia,expenses,food,-104.89,24796.71
buyer_5,Sara,,1994-03-12,ES75209517551006251525,TRX_N-01064-27465557,2024-06-24T17:35:37,Donostia,expenses,transport,-64.85,24731.86
buyer_5,Sara,,1994-03-12,ES75209517551006251525,TRX_N-01065-35204985,2024-06-25T14:44:21,Donostia,expenses,leisure,-78.28,24653.58
buyer_5,Sara,,1994-03-12,ES75209517551006251525,TRX_N-01066-25616864,2024-06-27T20:33:38,Donostia,expenses,transport,-86.65,24566.93
buyer_5,Sara,,1994-03-12,ES75209517551006251525,TRX_N-01067-47622245,2024-06-27T11:51:56,Amurrio,expenses,leisure,-24.89,24542.04
buyer_5,Sara,,1994-03-12,ES75209517551006251525,TRX_N-01068-46695725,2024-06-28T14:50:39,Donostia,expenses,food,-124.19,24417.85
buyer_5,Sara,,1994-03-12,ES75209517551006251525,TRX_N-01069-73332381,2024-06-28T11:09:18,Donostia,expenses,leisure,-35.46,24382.39
buyer_5,Sara,,1994-03-12,ES75209517551006251525,TRX_N-01070-88850811,2024-07-01T12:24:09,Donostia,incomes,salary,2478.68,26861.07
buyer_5,Sara,,1994-03-12,ES75209517551006251525,TRX_N-01071-17846502,2024-07-01T12:24:09,Donostia,incomes,salary_partner,2716.85,29577.92
buyer_5,Sara,,1994-03-12,ES75209517551006251525,TRX_N-01072-07338738,2024-07-02T00:52:20,Pasaia,expenses,food,-92.71,29485.21
buyer_5,Sara,,1994-03-12,ES75209517551006251525,TRX_N-01073-83931144,2024-07-02T20:08:51,Donostia,expenses,cash,-100.0,29385.21
buyer_5,Sara,,1994-03-12,ES75209517551006251525,TRX_N-01074-90630857,2024-07-04T17:30:44,Donostia,expenses,mortgage,-754.18,28631.03
buyer_5,Sara,,1994-03-12,ES75209517551006251525,TRX_N-01075-74418988,2024-07-04T20:21:56,Donostia,expenses,leisure,-34.89,28596.14
buyer_5,Sara,,1994-03-12,ES75209517551006251525,TRX_N-01076-45687984,2024-07-04T07:40:43,Donostia,expenses,healthcare,-149.95,28446.19
buyer_5,Sara,,1994-03-12,ES75209517551006251525,TRX_N-01077-71895781,2024-07-05T20:22:00,Donostia,expenses,water,-26.04,28420.15
buyer_5,Sara,,1994-03-12,ES75209517551006251525,TRX_N-01078-88568136,2024-07-05T23:35:04,Donostia,expenses,gas,-42.08,28378.07
buyer_5,Sara,,1994-03-12,ES75209517551006251525,TRX_N-01079-91073077,2024-07-05T23:15:50,Donostia,expenses,cash,-100.0,28278.07
buyer_5,Sara,,1994-03-12,ES75209517551006251525,TRX_N-01080-34646157,2024-07-06T09:53:02,Donostia,expenses,electricity,-45.59,28232.48
buyer_5,Sara,,1994-03-12,ES75209517551006251525,TRX_N-01081-26749928,2024-07-07T11:06:32,Donostia,expenses,internet,-42.0,28190.48
buyer_5,Sara,,1994-03-12,ES75209517551006251525,TRX_N-01082-74564658,2024-07-08T11:10:03,Donostia,expenses,phone,-36.27,28154.21
buyer_5,Sara,,1994-03-12,ES75209517551006251525,TRX_N-01083-80790540,2024-07-12T18:17:31,Donostia,expenses,clothing,-156.12,27998.09
buyer_5,Sara,,1994-03-12,ES75209517551006251525,TRX_N-01084-36701451,2024-07-13T16:01:46,Donostia,expenses,leisure,-56.49,27941.6
buyer_5,Sara,,1994-03-12,ES75209517551006251525,TRX_N-01085-30103936,2024-07-13T20:52:28,Donostia,expenses,education,-54.88,27886.72
buyer_5,Sara,,1994-03-12,ES75209517551006251525,TRX_N-01086-00071234,2024-07-13T13:59:02,Donostia,expenses,cash,-100.0,27786.72
buyer_5,Sara,,1994-03-12,ES75209517551006251525,TRX_N-01087-29446089,2024-07-13T13:48:49,Donostia,expenses,repairs,-198.6,27588.12
buyer_5,Sara,,1994-03-12,ES75209517551006251525,TRX_N-01088-33660315,2024-07-14T10:10:05,Bilbao,expenses,cash,-100.0,27488.12
buyer_5,Sara,,1994-03-12,ES75209517551006251525,TRX_N-01089-74438689,2024-07-16T12:16:23,Donostia,expenses,repairs,-303.79,27184.33
buyer_5,Sara,,1994-03-12,ES75209517551006251525,TRX_N-01090-25702467,2024-07-18T10:33:36,Donostia,expenses,leisure,-60.77,27123.56
buyer_5,Sara,,1994-03-12,ES75209517551006251525,TRX_N-01091-07070316,2024-07-18T04:03:26,Donostia,expenses,healthcare,-47.95,27075.61
buyer_5,Sara,,1994-03-12,ES75209517551006251525,TRX_N-01092-17366581,2024-07-21T19:02:08,Donostia,expenses,clothing,-81.28,26994.33
buyer_5,Sara,,1994-03-12,ES75209517551006251525,TRX_N-01093-14461340,2024-07-22T18:03:43,Berango,expenses,food,-124.75,26869.58
buyer_5,Sara,,1994-03-12,ES75209517551006251525,TRX_N-01094-95453855,2024-07-22T11:45:26,Donostia,expenses,leisure,-27.76,26841.82
buyer_5,Sara,,1994-03-12,ES75209517551006251525,TRX_N-01095-37395347,2024-07-23T12:28:12,Donostia,expenses,food,-119.67,26722.15
buyer_5,Sara,,1994-03-12,ES75209517551006251525,TRX_N-01096-61342727,2024-07-26T23:41:30,Donostia,expenses,food,-64.26,26657.89
buyer_5,Sara,,1994-03-12,ES75209517551006251525,TRX_N-01097-19483863,2024-07-26T18:01:23,Donostia,expenses,cash,-100.0,26557.89
buyer_5,Sara,,1994-03-12,ES75209517551006251525,TRX_N-01098-71327788,2024-07-27T17:58:42,Donostia,expenses,healthcare,-185.27,26372.62
buyer_5,Sara,,1994-03-12,ES75209517551006251525,TRX_N-01099-38045658,2024-07-27T11:26:59,Donostia,expenses,cash,-100.0,26272.62
buyer_5,Sara,,1994-03-12,ES75209517551006251525,TRX_N-01100-64469349,2024-07-29T18:31:54,Donostia,expenses,transport,-64.22,26208.4
buyer_5,Sara,,1994-03-12,ES75209517551006251525,TRX_N-01101-30581061,2024-07-31T17:02:06,Donostia,expenses,food,-82.88,26125.52
buyer_5,Sara,,1994-03-12,ES75209517551006251525,TRX_N-01102-73568824,2024-08-01T10:53:55,Donostia,incomes,salary,2478.68,28604.2
buyer_5,Sara,,1994-03-12,ES75209517551006251525,TRX_N-01103-71241172,2024-08-01T10:53:55,Donostia,incomes,salary_partner,2716.85,31321.05
buyer_5,Sara,,1994-03-12,ES75209517551006251525,TRX_N-01104-68465574,2024-08-02T20:34:18,Donostia,expenses,clothing,-134.36,31186.69
buyer_5,Sara,,1994-03-12,ES75209517551006251525,TRX_N-01105-69809423,2024-08-02T19:53:59,Donostia,expenses,gifts,-96.78,31089.91
buyer_5,Sara,,1994-03-12,ES75209517551006251525,TRX_N-01106-06582795,2024-08-04T10:58:45,Donostia,expenses,mortgage,-754.18,30335.73
buyer_5,Sara,,1994-03-12,ES75209517551006251525,TRX_N-01107-76109281,2024-08-04T22:42:09,Donostia,expenses,cash,-100.0,30235.73
buyer_5,Sara,,1994-03-12,ES75209517551006251525,TRX_N-01108-23044456,2024-08-04T06:15:13,Donostia,expenses,gifts,-795.16,29440.57
buyer_5,Sara,,1994-03-12,ES75209517551006251525,TRX_N-01109-66790365,2024-08-05T14:47:50,Donostia,expenses,electricity,-77.0,29363.57
buyer_5,Sara,,1994-03-12,ES75209517551006251525,TRX_N-01110-37495244,2024-08-06T20:50:30,Donostia,expenses,water,-30.31,29333.26
buyer_5,Sara,,1994-03-12,ES75209517551006251525,TRX_N-01111-85170340,2024-08-08T21:40:34,Donostia,expenses,gas,-100.85,29232.41
buyer_5,Sara,,1994-03-12,ES75209517551006251525,TRX_N-01112-65479051,2024-08-08T09:49:39,Donostia,expenses,internet,-42.0,29190.41
buyer_5,Sara,,1994-03-12,ES75209517551006251525,TRX_N-01113-40172444,2024-08-08T17:44:07,Donostia,expenses,phone,-38.15,29152.26
buyer_5,Sara,,1994-03-12,ES75209517551006251525,TRX_N-01114-28583016,2024-08-08T10:03:49,Getxo,expenses,food,-90.49,29061.77
buyer_5,Sara,,1994-03-12,ES75209517551006251525,TRX_N-01115-70714931,2024-08-11T01:14:21,Bilbao,expenses,clothing,-110.08,28951.69
buyer_5,Sara,,1994-03-12,ES75209517551006251525,TRX_N-01116-58421259,2024-08-13T22:33:40,Donostia,expenses,gifts,-155.72,28795.97
buyer_5,Sara,,1994-03-12,ES75209517551006251525,TRX_N-01117-85440354,2024-08-14T19:17:36,Donostia,expenses,leisure,-28.44,28767.53
buyer_5,Sara,,1994-03-12,ES75209517551006251525,TRX_N-01118-00003262,2024-08-16T21:27:26,Elciego,expenses,food,-79.35,28688.18
buyer_5,Sara,,1994-03-12,ES75209517551006251525,TRX_N-01119-23058933,2024-08-17T20:54:21,Donostia,expenses,food,-100.66,28587.52
buyer_5,Sara,,1994-03-12,ES75209517551006251525,TRX_N-01120-03216726,2024-08-17T12:13:46,Donostia,expenses,leisure,-48.58,28538.94
buyer_5,Sara,,1994-03-12,ES75209517551006251525,TRX_N-01121-54382680,2024-08-17T18:18:17,Donostia,expenses,healthcare,-132.0,28406.94
buyer_5,Sara,,1994-03-12,ES75209517551006251525,TRX_N-01122-36498677,2024-08-17T11:32:41,Donostia,expenses,education,-76.75,28330.19
buyer_5,Sara,,1994-03-12,ES75209517551006251525,TRX_N-01123-62345685,2024-08-19T14:18:32,Donostia,expenses,education,-49.64,28280.55
buyer_5,Sara,,1994-03-12,ES75209517551006251525,TRX_N-01124-11720003,2024-08-20T14:22:47,Donostia,expenses,transport,-84.92,28195.63
buyer_5,Sara,,1994-03-12,ES75209517551006251525,TRX_N-01125-05101330,2024-08-20T15:49:16,Donostia,expenses,gifts,-164.33,28031.3
buyer_5,Sara,,1994-03-12,ES75209517551006251525,TRX_N-01126-59655809,2024-08-22T23:34:57,Donostia,expenses,food,-97.93,27933.37
buyer_5,Sara,,1994-03-12,ES75209517551006251525,TRX_N-01127-27394219,2024-08-23T10:48:02,Donostia,expenses,transport,-61.18,27872.19
buyer_5,Sara,,1994-03-12,ES75209517551006251525,TRX_N-01128-23370226,2024-08-23T17:30:00,Iru√±a de Oca,expenses,cash,-100.0,27772.19
buyer_5,Sara,,1994-03-12,ES75209517551006251525,TRX_N-01129-63048835,2024-08-24T11:27:36,Donostia,expenses,transport,-83.03,27689.16
buyer_5,Sara,,1994-03-12,ES75209517551006251525,TRX_N-01130-36335422,2024-08-26T11:19:56,Mungia,expenses,repairs,-107.43,27581.73
buyer_5,Sara,,1994-03-12,ES75209517551006251525,TRX_N-01131-08201113,2024-08-27T17:23:22,Donostia,expenses,repairs,-147.03,27434.7
buyer_5,Sara,,1994-03-12,ES75209517551006251525,TRX_N-01132-78170791,2024-08-28T10:12:25,Donostia,expenses,food,-81.88,27352.82
buyer_5,Sara,,1994-03-12,ES75209517551006251525,TRX_N-01133-12485960,2024-08-28T10:16:57,Llodio,expenses,leisure,-76.63,27276.19
buyer_5,Sara,,1994-03-12,ES75209517551006251525,TRX_N-01134-54587228,2024-08-29T03:13:11,Erandio,expenses,leisure,-48.64,27227.55
buyer_5,Sara,,1994-03-12,ES75209517551006251525,TRX_N-01135-90670867,2024-08-29T01:45:11,Donostia,expenses,gifts,-638.03,26589.52
buyer_5,Sara,,1994-03-12,ES75209517551006251525,TRX_N-01136-96609299,2024-08-31T01:52:12,Oy√≥n-Oion,expenses,repairs,-120.3,26469.22
buyer_5,Sara,,1994-03-12,ES75209517551006251525,TRX_N-01137-91037824,2024-09-01T09:14:21,Donostia,incomes,salary,2478.68,28947.9
buyer_5,Sara,,1994-03-12,ES75209517551006251525,TRX_N-01138-96008097,2024-09-01T09:14:21,Donostia,incomes,salary_partner,2716.85,31664.75
buyer_5,Sara,,1994-03-12,ES75209517551006251525,TRX_N-01139-52191552,2024-09-01T09:14:21,Donostia,incomes,extra_income,234.39,31899.14
buyer_5,Sara,,1994-03-12,ES75209517551006251525,TRX_N-01140-02983045,2024-09-01T12:09:38,Durango,expenses,leisure,-70.67,31828.47
buyer_5,Sara,,1994-03-12,ES75209517551006251525,TRX_N-01141-45997258,2024-09-02T15:01:01,Donostia,expenses,healthcare,-106.74,31721.73
buyer_5,Sara,,1994-03-12,ES75209517551006251525,TRX_N-01142-50093653,2024-09-02T20:04:46,Donostia,expenses,education,-74.13,31647.6
buyer_5,Sara,,1994-03-12,ES75209517551006251525,TRX_N-01143-36760333,2024-09-02T16:53:31,Arrasate,expenses,gifts,-61.48,31586.12
buyer_5,Sara,,1994-03-12,ES75209517551006251525,TRX_N-01144-40149824,2024-09-04T21:01:19,Donostia,expenses,mortgage,-754.18,30831.94
buyer_5,Sara,,1994-03-12,ES75209517551006251525,TRX_N-01145-57569455,2024-09-05T19:05:01,Donostia,expenses,gas,-104.54,30727.4
buyer_5,Sara,,1994-03-12,ES75209517551006251525,TRX_N-01146-18983778,2024-09-06T19:33:57,Donostia,expenses,internet,-42.0,30685.4
buyer_5,Sara,,1994-03-12,ES75209517551006251525,TRX_N-01147-96232285,2024-09-06T14:33:16,Donostia,expenses,food,-100.47,30584.93
buyer_5,Sara,,1994-03-12,ES75209517551006251525,TRX_N-01148-42889001,2024-09-06T23:34:17,Donostia,expenses,leisure,-51.88,30533.05
buyer_5,Sara,,1994-03-12,ES75209517551006251525,TRX_N-01149-19157634,2024-09-07T19:24:32,Donostia,expenses,electricity,-23.6,30509.45
buyer_5,Sara,,1994-03-12,ES75209517551006251525,TRX_N-01150-24306915,2024-09-07T16:19:10,Donostia,expenses,phone,-41.31,30468.14
buyer_5,Sara,,1994-03-12,ES75209517551006251525,TRX_N-01151-90767685,2024-09-08T17:31:46,Donostia,expenses,water,-38.45,30429.69
buyer_5,Sara,,1994-03-12,ES75209517551006251525,TRX_N-01152-48468164,2024-09-08T19:17:16,Donostia,expenses,cash,-100.0,30329.69
buyer_5,Sara,,1994-03-12,ES75209517551006251525,TRX_N-01153-82926123,2024-09-09T12:50:23,Donostia,expenses,cash,-100.0,30229.69
buyer_5,Sara,,1994-03-12,ES75209517551006251525,TRX_N-01154-52709011,2024-09-10T11:21:54,Donostia,expenses,food,-116.76,30112.93
buyer_5,Sara,,1994-03-12,ES75209517551006251525,TRX_N-01155-97232537,2024-09-10T13:06:48,Donostia,expenses,leisure,-80.3,30032.63
buyer_5,Sara,,1994-03-12,ES75209517551006251525,TRX_N-01156-59023287,2024-09-11T20:36:11,Donostia,expenses,transport,-79.24,29953.39
buyer_5,Sara,,1994-03-12,ES75209517551006251525,TRX_N-01157-54531647,2024-09-11T14:34:38,Donostia,expenses,cash,-100.0,29853.39
buyer_5,Sara,,1994-03-12,ES75209517551006251525,TRX_N-01158-10772526,2024-09-13T10:10:32,Donostia,expenses,food,-91.61,29761.78
buyer_5,Sara,,1994-03-12,ES75209517551006251525,TRX_N-01159-86188522,2024-09-13T14:25:27,Donostia,expenses,transport,-55.47,29706.31
buyer_5,Sara,,1994-03-12,ES75209517551006251525,TRX_N-01160-08196178,2024-09-15T17:20:39,Donostia,expenses,leisure,-80.38,29625.93
buyer_5,Sara,,1994-03-12,ES75209517551006251525,TRX_N-01161-18343453,2024-09-15T15:53:33,Donostia,expenses,cash,-100.0,29525.93
buyer_5,Sara,,1994-03-12,ES75209517551006251525,TRX_N-01162-44365513,2024-09-16T11:12:35,Donostia,expenses,cash,-100.0,29425.93
buyer_5,Sara,,1994-03-12,ES75209517551006251525,TRX_N-01163-12208099,2024-09-17T15:08:38,Donostia,expenses,food,-115.94,29309.99
buyer_5,Sara,,1994-03-12,ES75209517551006251525,TRX_N-01164-82013795,2024-09-17T12:36:57,Donostia,expenses,cash,-100.0,29209.99
buyer_5,Sara,,1994-03-12,ES75209517551006251525,TRX_N-01165-02804637,2024-09-17T16:54:54,Donostia,expenses,repairs,-51.24,29158.75
buyer_5,Sara,,1994-03-12,ES75209517551006251525,TRX_N-01166-08091714,2024-09-19T17:43:31,Donostia,expenses,gifts,-173.8,28984.95
buyer_5,Sara,,1994-03-12,ES75209517551006251525,TRX_N-01167-14348200,2024-09-20T12:15:35,Donostia,expenses,leisure,-33.18,28951.77
buyer_5,Sara,,1994-03-12,ES75209517551006251525,TRX_N-01168-24812473,2024-09-20T13:29:14,Donostia,expenses,cash,-100.0,28851.77
buyer_5,Sara,,1994-03-12,ES75209517551006251525,TRX_N-01169-36381926,2024-09-20T11:48:20,Donostia,expenses,gifts,-764.42,28087.35
buyer_5,Sara,,1994-03-12,ES75209517551006251525,TRX_N-01170-24865885,2024-09-21T21:20:23,Donostia,expenses,food,-67.02,28020.33
buyer_5,Sara,,1994-03-12,ES75209517551006251525,TRX_N-01171-87523954,2024-09-22T11:09:42,Donostia,expenses,leisure,-24.92,27995.41
buyer_5,Sara,,1994-03-12,ES75209517551006251525,TRX_N-01172-27078120,2024-09-25T10:54:48,Hondarribia,expenses,leisure,-65.08,27930.33
buyer_5,Sara,,1994-03-12,ES75209517551006251525,TRX_N-01173-97642402,2024-09-27T17:03:47,Donostia,expenses,cash,-100.0,27830.33
buyer_5,Sara,,1994-03-12,ES75209517551006251525,TRX_N-01174-00254148,2024-09-28T18:48:57,Donostia,expenses,appliances,-228.16,27602.17
buyer_5,Sara,,1994-03-12,ES75209517551006251525,TRX_N-01175-48029199,2024-09-29T12:23:16,Donostia,expenses,leisure,-47.82,27554.35
buyer_5,Sara,,1994-03-12,ES75209517551006251525,TRX_N-01176-22038821,2024-10-01T16:20:58,Donostia,incomes,salary,2478.68,30033.03
buyer_5,Sara,,1994-03-12,ES75209517551006251525,TRX_N-01177-25835315,2024-10-01T16:20:58,Donostia,incomes,salary_partner,2716.85,32749.88
buyer_5,Sara,,1994-03-12,ES75209517551006251525,TRX_N-01178-36051813,2024-10-01T17:11:31,Donostia,expenses,transport,-75.43,32674.45
buyer_5,Sara,,1994-03-12,ES75209517551006251525,TRX_N-01179-67296983,2024-10-02T11:28:56,Donostia,expenses,food,-72.34,32602.11
buyer_5,Sara,,1994-03-12,ES75209517551006251525,TRX_N-01180-26193172,2024-10-04T15:51:45,Donostia,expenses,mortgage,-754.18,31847.93
buyer_5,Sara,,1994-03-12,ES75209517551006251525,TRX_N-01181-22138989,2024-10-04T16:03:37,Donostia,expenses,gifts,-25.45,31822.48
buyer_5,Sara,,1994-03-12,ES75209517551006251525,TRX_N-01182-22416375,2024-10-06T13:33:03,Donostia,expenses,water,-42.79,31779.69
buyer_5,Sara,,1994-03-12,ES75209517551006251525,TRX_N-01183-97466942,2024-10-06T17:09:29,Donostia,expenses,electricity,-78.22,31701.47
buyer_5,Sara,,1994-03-12,ES75209517551006251525,TRX_N-01184-86019497,2024-10-07T14:36:05,Donostia,expenses,gas,-101.72,31599.75
buyer_5,Sara,,1994-03-12,ES75209517551006251525,TRX_N-01185-15610489,2024-10-08T13:39:15,Donostia,expenses,internet,-42.0,31557.75
buyer_5,Sara,,1994-03-12,ES75209517551006251525,TRX_N-01186-18546990,2024-10-08T08:09:08,Donostia,expenses,phone,-34.27,31523.48
buyer_5,Sara,,1994-03-12,ES75209517551006251525,TRX_N-01187-46983091,2024-10-08T20:43:08,Bilbao,expenses,leisure,-77.13,31446.35
buyer_5,Sara,,1994-03-12,ES75209517551006251525,TRX_N-01188-15755673,2024-10-08T20:22:58,Bermeo,expenses,cash,-100.0,31346.35
buyer_5,Sara,,1994-03-12,ES75209517551006251525,TRX_N-01189-10330308,2024-10-09T11:49:34,Galdakao,expenses,transport,-58.58,31287.77
buyer_5,Sara,,1994-03-12,ES75209517551006251525,TRX_N-01190-35447339,2024-10-09T13:07:35,Donostia,expenses,leisure,-61.67,31226.1
buyer_6,Manuel,,1979-02-14,ES88209530454618970832,TRX_N-00001-73024595,2022-01-01T19:12:55,Vitoria-Gasteiz,incomes,salary,2843.15,4490.08
buyer_6,Manuel,,1979-02-14,ES88209530454618970832,TRX_N-00002-58091331,2022-01-03T12:51:05,Vitoria-Gasteiz,expenses,transport,-50.11,4439.97
buyer_6,Manuel,,1979-02-14,ES88209530454618970832,TRX_N-00003-23112986,2022-01-03T04:49:54,Vitoria-Gasteiz,expenses,clothing,-45.7,4394.27
buyer_6,Manuel,,1979-02-14,ES88209530454618970832,TRX_N-00004-71110265,2022-01-04T16:36:30,Vitoria-Gasteiz,expenses,mortgage,-1089.47,3304.8
buyer_6,Manuel,,1979-02-14,ES88209530454618970832,TRX_N-00005-91076030,2022-01-05T09:00:38,Vitoria-Gasteiz,expenses,gas,-101.15,3203.65
buyer_6,Manuel,,1979-02-14,ES88209530454618970832,TRX_N-00006-42478776,2022-01-05T08:14:30,Vitoria-Gasteiz,expenses,food,-106.1,3097.55
buyer_6,Manuel,,1979-02-14,ES88209530454618970832,TRX_N-00007-82935588,2022-01-05T20:29:11,Vitoria-Gasteiz,expenses,leisure,-19.78,3077.77
buyer_6,Manuel,,1979-02-14,ES88209530454618970832,TRX_N-00008-58376661,2022-01-05T18:43:18,Vitoria-Gasteiz,expenses,appliances,-187.66,2890.11
buyer_6,Manuel,,1979-02-14,ES88209530454618970832,TRX_N-00009-73573932,2022-01-06T14:36:42,Vitoria-Gasteiz,expenses,phone,-43.67,2846.44
buyer_6,Manuel,,1979-02-14,ES88209530454618970832,TRX_N-00010-56294416,2022-01-07T11:37:46,Vitoria-Gasteiz,expenses,electricity,-33.28,2813.16
buyer_6,Manuel,,1979-02-14,ES88209530454618970832,TRX_N-00011-39530135,2022-01-07T21:05:43,Vitoria-Gasteiz,expenses,food,-103.5,2709.66
buyer_6,Manuel,,1979-02-14,ES88209530454618970832,TRX_N-00012-29464615,2022-01-07T10:52:14,Vitoria-Gasteiz,expenses,cash,-100.0,2609.66
buyer_6,Manuel,,1979-02-14,ES88209530454618970832,TRX_N-00013-83308175,2022-01-08T12:18:06,Vitoria-Gasteiz,expenses,water,-29.35,2580.31
buyer_6,Manuel,,1979-02-14,ES88209530454618970832,TRX_N-00014-22445276,2022-01-08T20:03:34,Vitoria-Gasteiz,expenses,internet,-42.0,2538.31
buyer_6,Manuel,,1979-02-14,ES88209530454618970832,TRX_N-00015-59970498,2022-01-09T16:42:10,Vitoria-Gasteiz,expenses,food,-62.8,2475.51
buyer_6,Manuel,,1979-02-14,ES88209530454618970832,TRX_N-00016-70288143,2022-01-13T16:57:24,Vitoria-Gasteiz,expenses,leisure,-42.78,2432.73
buyer_6,Manuel,,1979-02-14,ES88209530454618970832,TRX_N-00017-68864111,2022-01-14T12:32:33,Vitoria-Gasteiz,expenses,travel,-397.55,2035.18
buyer_6,Manuel,,1979-02-14,ES88209530454618970832,TRX_N-00018-57899755,2022-01-15T21:43:16,Vitoria-Gasteiz,expenses,food,-72.79,1962.39
buyer_6,Manuel,,1979-02-14,ES88209530454618970832,TRX_N-00019-76007128,2022-01-15T05:42:03,Vitoria-Gasteiz,expenses,leisure,-64.52,1897.87
buyer_6,Manuel,,1979-02-14,ES88209530454618970832,TRX_N-00020-00525573,2022-01-15T14:25:21,Vitoria-Gasteiz,expenses,cash,-100.0,1797.87
buyer_6,Manuel,,1979-02-14,ES88209530454618970832,TRX_N-00021-18388585,2022-01-16T13:15:42,Vitoria-Gasteiz,expenses,food,-68.73,1729.14
buyer_6,Manuel,,1979-02-14,ES88209530454618970832,TRX_N-00022-90945395,2022-01-21T09:33:43,Vitoria-Gasteiz,expenses,clothing,-94.2,1634.94
buyer_6,Manuel,,1979-02-14,ES88209530454618970832,TRX_N-00023-36894864,2022-01-24T16:18:17,Vitoria-Gasteiz,expenses,gifts,-267.9,1367.04
buyer_6,Manuel,,1979-02-14,ES88209530454618970832,TRX_N-00024-45132646,2022-01-25T02:02:38,Vitoria-Gasteiz,expenses,food,-113.95,1253.09
buyer_6,Manuel,,1979-02-14,ES88209530454618970832,TRX_N-00025-79556302,2022-01-26T03:13:48,Vitoria-Gasteiz,expenses,food,-81.26,1171.83
buyer_6,Manuel,,1979-02-14,ES88209530454618970832,TRX_N-00026-70513655,2022-01-26T08:59:24,Alegr√≠a-Dulantzi,expenses,cash,-100.0,1071.83
buyer_6,Manuel,,1979-02-14,ES88209530454618970832,TRX_N-00027-19952934,2022-01-27T12:19:01,Vitoria-Gasteiz,expenses,cash,-100.0,971.83
buyer_6,Manuel,,1979-02-14,ES88209530454618970832,TRX_N-00028-20710949,2022-01-30T14:10:55,Vitoria-Gasteiz,expenses,transport,-47.57,924.26
buyer_6,Manuel,,1979-02-14,ES88209530454618970832,TRX_N-00029-78002635,2022-01-31T19:03:33,Vitoria-Gasteiz,expenses,transport,-82.09,842.17
buyer_6,Manuel,,1979-02-14,ES88209530454618970832,TRX_N-00030-32480498,2022-01-31T20:42:28,Vitoria-Gasteiz,expenses,healthcare,-107.4,734.77
buyer_6,Manuel,,1979-02-14,ES88209530454618970832,TRX_N-00031-42548253,2022-02-01T02:58:08,Vitoria-Gasteiz,incomes,salary,2843.15,3577.92
buyer_6,Manuel,,1979-02-14,ES88209530454618970832,TRX_N-00032-85787932,2022-02-03T11:12:56,Vitoria-Gasteiz,expenses,education,-45.0,3532.92
buyer_6,Manuel,,1979-02-14,ES88209530454618970832,TRX_N-00033-26142675,2022-02-04T18:14:17,Vitoria-Gasteiz,expenses,mortgage,-1089.47,2443.45
buyer_6,Manuel,,1979-02-14,ES88209530454618970832,TRX_N-00034-70353567,2022-02-05T13:37:30,Vitoria-Gasteiz,expenses,water,-25.96,2417.49
buyer_6,Manuel,,1979-02-14,ES88209530454618970832,TRX_N-00035-03841815,2022-02-05T20:15:29,Vitoria-Gasteiz,expenses,phone,-35.04,2382.45
buyer_6,Manuel,,1979-02-14,ES88209530454618970832,TRX_N-00036-40681327,2022-02-05T11:26:48,Vitoria-Gasteiz,expenses,repairs,-129.24,2253.21
buyer_6,Manuel,,1979-02-14,ES88209530454618970832,TRX_N-00037-88953066,2022-02-06T11:46:57,Vitoria-Gasteiz,expenses,electricity,-41.24,2211.97
buyer_6,Manuel,,1979-02-14,ES88209530454618970832,TRX_N-00038-93437369,2022-02-06T13:42:06,Vitoria-Gasteiz,expenses,food,-115.34,2096.63
buyer_6,Manuel,,1979-02-14,ES88209530454618970832,TRX_N-00039-63162310,2022-02-06T12:31:48,Amurrio,expenses,leisure,-83.66,2012.97
buyer_6,Manuel,,1979-02-14,ES88209530454618970832,TRX_N-00040-92798060,2022-02-08T18:20:25,Vitoria-Gasteiz,expenses,gas,-75.41,1937.56
buyer_6,Manuel,,1979-02-14,ES88209530454618970832,TRX_N-00041-74015025,2022-02-08T00:33:00,Vitoria-Gasteiz,expenses,internet,-42.0,1895.56
buyer_6,Manuel,,1979-02-14,ES88209530454618970832,TRX_N-00042-23610053,2022-02-08T18:21:22,Vitoria-Gasteiz,expenses,healthcare,-39.52,1856.04
buyer_6,Manuel,,1979-02-14,ES88209530454618970832,TRX_N-00043-29384533,2022-02-09T12:35:18,Vitoria-Gasteiz,expenses,transport,-53.2,1802.84
buyer_6,Manuel,,1979-02-14,ES88209530454618970832,TRX_N-00044-33965481,2022-02-09T20:30:15,Hernani,expenses,clothing,-54.2,1748.64
buyer_6,Manuel,,1979-02-14,ES88209530454618970832,TRX_N-00045-41900273,2022-02-10T11:25:21,Vitoria-Gasteiz,expenses,food,-92.75,1655.89
buyer_6,Manuel,,1979-02-14,ES88209530454618970832,TRX_N-00046-73189002,2022-02-10T19:54:59,Eibar,expenses,cash,-100.0,1555.89
buyer_6,Manuel,,1979-02-14,ES88209530454618970832,TRX_N-00047-43485360,2022-02-11T15:44:41,Vitoria-Gasteiz,expenses,healthcare,-67.18,1488.71
buyer_6,Manuel,,1979-02-14,ES88209530454618970832,TRX_N-00048-68436339,2022-02-12T09:23:01,Vitoria-Gasteiz,expenses,leisure,-22.54,1466.17
buyer_6,Manuel,,1979-02-14,ES88209530454618970832,TRX_N-00049-45371855,2022-02-14T10:17:23,Vitoria-Gasteiz,expenses,leisure,-35.17,1431.0
buyer_6,Manuel,,1979-02-14,ES88209530454618970832,TRX_N-00050-62957147,2022-02-16T14:38:44,Vitoria-Gasteiz,expenses,transport,-44.84,1386.16
buyer_6,Manuel,,1979-02-14,ES88209530454618970832,TRX_N-00051-16119407,2022-02-18T03:53:32,Vitoria-Gasteiz,expenses,leisure,-60.66,1325.5
buyer_6,Manuel,,1979-02-14,ES88209530454618970832,TRX_N-00052-85785439,2022-02-20T23:00:13,Vitoria-Gasteiz,expenses,food,-90.64,1234.86
buyer_6,Manuel,,1979-02-14,ES88209530454618970832,TRX_N-00053-20240018,2022-02-20T20:45:33,Vitoria-Gasteiz,expenses,cash,-100.0,1134.86
buyer_6,Manuel,,1979-02-14,ES88209530454618970832,TRX_N-00054-04549211,2022-02-21T11:24:59,Vitoria-Gasteiz,expenses,food,-74.28,1060.58
buyer_6,Manuel,,1979-02-14,ES88209530454618970832,TRX_N-00055-95317900,2022-02-23T19:48:57,Vitoria-Gasteiz,expenses,food,-64.14,996.44
buyer_6,Manuel,,1979-02-14,ES88209530454618970832,TRX_N-00056-09956949,2022-02-25T14:55:55,Vitoria-Gasteiz,expenses,food,-110.8,885.64
buyer_6,Manuel,,1979-02-14,ES88209530454618970832,TRX_N-00057-88989971,2022-02-27T05:41:04,Vitoria-Gasteiz,expenses,cash,-100.0,785.64
buyer_6,Manuel,,1979-02-14,ES88209530454618970832,TRX_N-00058-50044337,2022-02-28T17:14:09,Labastida,expenses,gifts,-368.7,416.94
buyer_6,Manuel,,1979-02-14,ES88209530454618970832,TRX_N-00059-00748551,2022-03-01T18:45:47,Vitoria-Gasteiz,incomes,salary,2843.15,3260.09
buyer_6,Manuel,,1979-02-14,ES88209530454618970832,TRX_N-00060-19380622,2022-03-02T16:10:34,Vitoria-Gasteiz,expenses,leisure,-76.43,3183.66
buyer_6,Manuel,,1979-02-14,ES88209530454618970832,TRX_N-00061-30318122,2022-03-03T08:19:43,Vitoria-Gasteiz,expenses,cash,-100.0,3083.66
buyer_6,Manuel,,1979-02-14,ES88209530454618970832,TRX_N-00062-23182136,2022-03-04T07:54:55,Vitoria-Gasteiz,expenses,mortgage,-1089.47,1994.19
buyer_6,Manuel,,1979-02-14,ES88209530454618970832,TRX_N-00063-86827752,2022-03-04T12:29:26,Vitoria-Gasteiz,expenses,cash,-100.0,1894.19
buyer_6,Manuel,,1979-02-14,ES88209530454618970832,TRX_N-00064-83965629,2022-03-04T17:35:53,Vitoria-Gasteiz,expenses,travel,-1534.84,359.35
buyer_6,Manuel,,1979-02-14,ES88209530454618970832,TRX_N-00065-23514444,2022-03-05T00:31:02,Vitoria-Gasteiz,expenses,water,-31.23,328.12
buyer_6,Manuel,,1979-02-14,ES88209530454618970832,TRX_N-00066-68926831,2022-03-05T17:04:01,Vitoria-Gasteiz,expenses,food,-92.24,235.88
buyer_6,Manuel,,1979-02-14,ES88209530454618970832,TRX_N-00067-71263116,2022-03-05T06:46:23,Vitoria-Gasteiz,expenses,leisure,-63.48,172.4
buyer_6,Manuel,,1979-02-14,ES88209530454618970832,TRX_N-00068-79768313,2022-03-05T17:09:06,Vitoria-Gasteiz,expenses,healthcare,-120.97,51.43
buyer_6,Manuel,,1979-02-14,ES88209530454618970832,TRX_N-00069-09727576,2022-03-06T09:06:55,Vitoria-Gasteiz,expenses,phone,-39.37,12.06
buyer_6,Manuel,,1979-02-14,ES88209530454618970832,TRX_N-00070-01690422,2022-03-06T16:27:59,Irun,expenses,clothing,-142.78,-130.72
buyer_6,Manuel,,1979-02-14,ES88209530454618970832,TRX_N-00071-69578560,2022-03-07T21:45:20,Vitoria-Gasteiz,expenses,gas,-51.46,-182.18
buyer_6,Manuel,,1979-02-14,ES88209530454618970832,TRX_N-00072-23869681,2022-03-07T10:07:30,Vitoria-Gasteiz,expenses,internet,-42.0,-224.18
buyer_6,Manuel,,1979-02-14,ES88209530454618970832,TRX_N-00073-95085122,2022-03-07T09:30:52,Vitoria-Gasteiz,expenses,gifts,-67.25,-291.43
buyer_6,Manuel,,1979-02-14,ES88209530454618970832,TRX_N-00074-23742453,2022-03-08T19:02:06,Vitoria-Gasteiz,expenses,electricity,-74.45,-365.88
buyer_6,Manuel,,1979-02-14,ES88209530454618970832,TRX_N-00075-12617978,2022-03-08T18:20:42,Erandio,expenses,repairs,-55.71,-421.59
buyer_6,Manuel,,1979-02-14,ES88209530454618970832,TRX_N-00076-40525702,2022-03-09T11:01:04,Llodio,expenses,education,-42.71,-464.3
buyer_6,Manuel,,1979-02-14,ES88209530454618970832,TRX_N-00077-85656508,2022-03-09T10:12:11,Vitoria-Gasteiz,expenses,cash,-100.0,-564.3
buyer_6,Manuel,,1979-02-14,ES88209530454618970832,TRX_N-00078-59154033,2022-03-10T15:06:08,Donostia,expenses,appliances,-268.71,-833.01
buyer_6,Manuel,,1979-02-14,ES88209530454618970832,TRX_N-00079-88072284,2022-03-11T01:17:28,Barakaldo,expenses,leisure,-45.94,-878.95
buyer_6,Manuel,,1979-02-14,ES88209530454618970832,TRX_N-00080-91004266,2022-03-14T14:10:49,Vitoria-Gasteiz,expenses,transport,-55.64,-934.59
buyer_6,Manuel,,1979-02-14,ES88209530454618970832,TRX_N-00081-86205796,2022-03-15T09:12:48,Vitoria-Gasteiz,expenses,clothing,-133.24,-1067.83
buyer_6,Manuel,,1979-02-14,ES88209530454618970832,TRX_N-00082-71215103,2022-03-15T08:40:39,Vitoria-Gasteiz,expenses,repairs,-222.43,-1290.26
buyer_6,Manuel,,1979-02-14,ES88209530454618970832,TRX_N-00083-04446000,2022-03-16T00:28:47,Vitoria-Gasteiz,expenses,food,-88.11,-1378.37
buyer_6,Manuel,,1979-02-14,ES88209530454618970832,TRX_N-00084-14311584,2022-03-16T11:22:08,Vitoria-Gasteiz,expenses,transport,-89.09,-1467.46
buyer_6,Manuel,,1979-02-14,ES88209530454618970832,TRX_N-00085-41531420,2022-03-19T21:43:29,Vitoria-Gasteiz,expenses,food,-113.31,-1580.77
buyer_6,Manuel,,1979-02-14,ES88209530454618970832,TRX_N-00086-47598193,2022-03-21T12:29:02,Vitoria-Gasteiz,expenses,leisure,-23.6,-1604.37
buyer_6,Manuel,,1979-02-14,ES88209530454618970832,TRX_N-00087-50030574,2022-03-21T13:43:45,Hernani,expenses,gifts,-108.97,-1713.34
buyer_6,Manuel,,1979-02-14,ES88209530454618970832,TRX_N-00088-76774733,2022-03-24T11:45:36,Vitoria-Gasteiz,expenses,leisure,-81.44,-1794.78
buyer_6,Manuel,,1979-02-14,ES88209530454618970832,TRX_N-00089-74021816,2022-03-25T23:42:22,Vitoria-Gasteiz,expenses,transport,-43.02,-1837.8
buyer_6,Manuel,,1979-02-14,ES88209530454618970832,TRX_N-00090-65211634,2022-03-25T12:54:13,Vitoria-Gasteiz,expenses,healthcare,-160.07,-1997.87
buyer_6,Manuel,,1979-02-14,ES88209530454618970832,TRX_N-00091-83442548,2022-03-27T13:21:56,Lasarte-Oria,expenses,food,-62.39,-2060.26
buyer_6,Manuel,,1979-02-14,ES88209530454618970832,TRX_N-00092-06440907,2022-03-27T02:22:51,Bilbao,expenses,cash,-100.0,-2160.26
buyer_6,Manuel,,1979-02-14,ES88209530454618970832,TRX_N-00093-29942474,2022-03-28T10:06:14,Vitoria-Gasteiz,expenses,food,-64.0,-2224.26
buyer_6,Manuel,,1979-02-14,ES88209530454618970832,TRX_N-00094-34935368,2022-03-30T16:54:06,Vitoria-Gasteiz,expenses,cash,-100.0,-2324.26
buyer_6,Manuel,,1979-02-14,ES88209530454618970832,TRX_N-00095-82062908,2022-03-31T17:51:34,Vitoria-Gasteiz,expenses,cash,-100.0,-2424.26
buyer_6,Manuel,,1979-02-14,ES88209530454618970832,TRX_N-00096-20088172,2022-04-01T18:33:59,Vitoria-Gasteiz,incomes,salary,2843.15,418.89
buyer_6,Manuel,,1979-02-14,ES88209530454618970832,TRX_N-00097-34875308,2022-04-01T18:33:59,Vitoria-Gasteiz,incomes,extra_income,329.55,748.44
buyer_6,Manuel,,1979-02-14,ES88209530454618970832,TRX_N-00098-32873199,2022-04-01T23:06:55,Vitoria-Gasteiz,expenses,cash,-100.0,648.44
buyer_6,Manuel,,1979-02-14,ES88209530454618970832,TRX_N-00099-76799477,2022-04-02T08:18:19,Vitoria-Gasteiz,expenses,cash,-100.0,548.44
buyer_6,Manuel,,1979-02-14,ES88209530454618970832,TRX_N-00100-09908284,2022-04-04T16:55:21,Vitoria-Gasteiz,expenses,mortgage,-1089.47,-541.03
buyer_6,Manuel,,1979-02-14,ES88209530454618970832,TRX_N-00101-27250234,2022-04-04T17:19:36,Vitoria-Gasteiz,expenses,education,-56.47,-597.5
buyer_6,Manuel,,1979-02-14,ES88209530454618970832,TRX_N-00102-85595335,2022-04-05T14:07:45,Vitoria-Gasteiz,expenses,gas,-90.66,-688.16
buyer_6,Manuel,,1979-02-14,ES88209530454618970832,TRX_N-00103-00080370,2022-04-05T15:49:41,Vitoria-Gasteiz,expenses,cash,-100.0,-788.16
buyer_6,Manuel,,1979-02-14,ES88209530454618970832,TRX_N-00104-65985588,2022-04-05T02:37:14,Vitoria-Gasteiz,expenses,repairs,-284.64,-1072.8
buyer_6,Manuel,,1979-02-14,ES88209530454618970832,TRX_N-00105-21145115,2022-04-06T17:37:07,Vitoria-Gasteiz,expenses,internet,-42.0,-1114.8
buyer_6,Manuel,,1979-02-14,ES88209530454618970832,TRX_N-00106-31873280,2022-04-06T09:10:43,Llodio,expenses,food,-97.22,-1212.02
buyer_6,Manuel,,1979-02-14,ES88209530454618970832,TRX_N-00107-89081621,2022-04-07T13:02:05,Vitoria-Gasteiz,expenses,water,-22.96,-1234.98
buyer_6,Manuel,,1979-02-14,ES88209530454618970832,TRX_N-00108-38575437,2022-04-07T22:31:26,Vitoria-Gasteiz,expenses,cash,-100.0,-1334.98
buyer_6,Manuel,,1979-02-14,ES88209530454618970832,TRX_N-00109-49130608,2022-04-08T13:52:26,Vitoria-Gasteiz,expenses,electricity,-31.53,-1366.51
buyer_6,Manuel,,1979-02-14,ES88209530454618970832,TRX_N-00110-70040037,2022-04-08T12:57:55,Vitoria-Gasteiz,expenses,phone,-36.01,-1402.52
buyer_6,Manuel,,1979-02-14,ES88209530454618970832,TRX_N-00111-09552781,2022-04-09T04:38:29,Vitoria-Gasteiz,expenses,appliances,-358.86,-1761.38
buyer_6,Manuel,,1979-02-14,ES88209530454618970832,TRX_N-00112-01776980,2022-04-09T19:52:23,Vitoria-Gasteiz,expenses,gifts,-520.2,-2281.58
buyer_6,Manuel,,1979-02-14,ES88209530454618970832,TRX_N-00113-16214204,2022-04-12T22:24:30,Vitoria-Gasteiz,expenses,cash,-100.0,-2381.58
buyer_6,Manuel,,1979-02-14,ES88209530454618970832,TRX_N-00114-45968872,2022-04-15T17:01:34,Vitoria-Gasteiz,expenses,food,-79.53,-2461.11
buyer_6,Manuel,,1979-02-14,ES88209530454618970832,TRX_N-00115-52371778,2022-04-15T19:02:02,Zuia,expenses,clothing,-146.53,-2607.64
buyer_6,Manuel,,1979-02-14,ES88209530454618970832,TRX_N-00116-00244814,2022-04-15T01:52:59,Vitoria-Gasteiz,expenses,travel,-1009.4,-3617.04
buyer_6,Manuel,,1979-02-14,ES88209530454618970832,TRX_N-00117-27123061,2022-04-16T20:05:25,Vitoria-Gasteiz,expenses,food,-116.48,-3733.52
buyer_6,Manuel,,1979-02-14,ES88209530454618970832,TRX_N-00118-55971802,2022-04-18T22:12:12,Vitoria-Gasteiz,expenses,transport,-45.28,-3778.8
buyer_6,Manuel,,1979-02-14,ES88209530454618970832,TRX_N-00119-54046390,2022-04-19T20:13:24,Vitoria-Gasteiz,expenses,food,-88.66,-3867.46
buyer_6,Manuel,,1979-02-14,ES88209530454618970832,TRX_N-00120-68355380,2022-04-19T09:44:19,Vitoria-Gasteiz,expenses,healthcare,-115.97,-3983.43
buyer_6,Manuel,,1979-02-14,ES88209530454618970832,TRX_N-00121-55480523,2022-04-20T10:06:13,Andoain,expenses,food,-114.11,-4097.54
buyer_6,Manuel,,1979-02-14,ES88209530454618970832,TRX_N-00122-37924170,2022-04-22T20:39:00,Vitoria-Gasteiz,expenses,food,-95.14,-4192.68
buyer_6,Manuel,,1979-02-14,ES88209530454618970832,TRX_N-00123-16804374,2022-04-22T02:54:27,Vitoria-Gasteiz,expenses,education,-53.81,-4246.49
buyer_6,Manuel,,1979-02-14,ES88209530454618970832,TRX_N-00124-76501182,2022-04-22T17:08:52,Bermeo,expenses,cash,-100.0,-4346.49
buyer_6,Manuel,,1979-02-14,ES88209530454618970832,TRX_N-00125-87308954,2022-04-24T00:07:21,Vitoria-Gasteiz,expenses,food,-112.12,-4458.61
buyer_6,Manuel,,1979-02-14,ES88209530454618970832,TRX_N-00126-62826334,2022-04-25T15:28:50,Vitoria-Gasteiz,expenses,food,-112.35,-4570.96
buyer_6,Manuel,,1979-02-14,ES88209530454618970832,TRX_N-00127-59792392,2022-04-28T18:57:19,Vitoria-Gasteiz,expenses,food,-98.15,-4669.11
buyer_6,Manuel,,1979-02-14,ES88209530454618970832,TRX_N-00128-46551525,2022-04-28T18:34:48,Bermeo,expenses,transport,-83.38,-4752.49
buyer_6,Manuel,,1979-02-14,ES88209530454618970832,TRX_N-00129-29012340,2022-04-28T14:20:43,Elciego,expenses,repairs,-49.56,-4802.05
buyer_6,Manuel,,1979-02-14,ES88209530454618970832,TRX_N-00130-79124034,2022-04-29T09:49:27,Vitoria-Gasteiz,expenses,leisure,-38.81,-4840.86
buyer_6,Manuel,,1979-02-14,ES88209530454618970832,TRX_N-00131-96435418,2022-05-01T15:06:53,Vitoria-Gasteiz,incomes,salary,2843.15,-1997.71
buyer_6,Manuel,,1979-02-14,ES88209530454618970832,TRX_N-00132-19935712,2022-05-01T18:33:58,Vitoria-Gasteiz,expenses,leisure,-37.23,-2034.94
buyer_6,Manuel,,1979-02-14,ES88209530454618970832,TRX_N-00133-42985528,2022-05-01T15:33:34,Vitoria-Gasteiz,expenses,repairs,-66.39,-2101.33
buyer_6,Manuel,,1979-02-14,ES88209530454618970832,TRX_N-00134-71940803,2022-05-02T08:19:34,Vitoria-Gasteiz,expenses,leisure,-42.12,-2143.45
buyer_6,Manuel,,1979-02-14,ES88209530454618970832,TRX_N-00135-03276311,2022-05-03T16:56:23,Iru√±a de Oca,expenses,leisure,-64.12,-2207.57
buyer_6,Manuel,,1979-02-14,ES88209530454618970832,TRX_N-00136-95863672,2022-05-04T15:17:03,Vitoria-Gasteiz,expenses,mortgage,-1089.47,-3297.04
buyer_6,Manuel,,1979-02-14,ES88209530454618970832,TRX_N-00137-04780948,2022-05-05T16:08:44,Vitoria-Gasteiz,expenses,transport,-52.99,-3350.03
buyer_6,Manuel,,1979-02-14,ES88209530454618970832,TRX_N-00138-06317275,2022-05-05T13:21:54,Oy√≥n-Oion,expenses,leisure,-19.77,-3369.8
buyer_6,Manuel,,1979-02-14,ES88209530454618970832,TRX_N-00139-09358308,2022-05-06T12:15:23,Vitoria-Gasteiz,expenses,gifts,-673.55,-4043.35
buyer_6,Manuel,,1979-02-14,ES88209530454618970832,TRX_N-00140-37208178,2022-05-07T18:51:35,Vitoria-Gasteiz,expenses,water,-37.1,-4080.45
buyer_6,Manuel,,1979-02-14,ES88209530454618970832,TRX_N-00141-27462661,2022-05-08T10:19:35,Vitoria-Gasteiz,expenses,electricity,-41.11,-4121.56
buyer_6,Manuel,,1979-02-14,ES88209530454618970832,TRX_N-00142-91956547,2022-05-08T09:17:18,Vitoria-Gasteiz,expenses,gas,-114.03,-4235.59
buyer_6,Manuel,,1979-02-14,ES88209530454618970832,TRX_N-00143-42115104,2022-05-08T13:59:59,Vitoria-Gasteiz,expenses,internet,-42.0,-4277.59
buyer_6,Manuel,,1979-02-14,ES88209530454618970832,TRX_N-00144-22272881,2022-05-08T12:15:09,Vitoria-Gasteiz,expenses,phone,-38.99,-4316.58
buyer_6,Manuel,,1979-02-14,ES88209530454618970832,TRX_N-00145-07871535,2022-05-08T16:21:29,Vitoria-Gasteiz,expenses,transport,-84.42,-4401.0
buyer_6,Manuel,,1979-02-14,ES88209530454618970832,TRX_N-00146-00205888,2022-05-09T08:32:20,Vitoria-Gasteiz,expenses,food,-65.45,-4466.45
buyer_6,Manuel,,1979-02-14,ES88209530454618970832,TRX_N-00147-82809535,2022-05-09T16:23:43,Vitoria-Gasteiz,expenses,transport,-56.05,-4522.5
buyer_6,Manuel,,1979-02-14,ES88209530454618970832,TRX_N-00148-93880564,2022-05-11T09:18:04,Vitoria-Gasteiz,expenses,cash,-100.0,-4622.5
buyer_6,Manuel,,1979-02-14,ES88209530454618970832,TRX_N-00149-63602418,2022-05-13T13:00:11,Vitoria-Gasteiz,expenses,clothing,-157.81,-4780.31
buyer_6,Manuel,,1979-02-14,ES88209530454618970832,TRX_N-00150-36152703,2022-05-14T20:24:54,Vitoria-Gasteiz,expenses,education,-53.85,-4834.16
buyer_6,Manuel,,1979-02-14,ES88209530454618970832,TRX_N-00151-27251604,2022-05-15T12:08:48,Vitoria-Gasteiz,expenses,food,-113.38,-4947.54
buyer_6,Manuel,,1979-02-14,ES88209530454618970832,TRX_N-00152-16015040,2022-05-15T22:58:56,Bermeo,expenses,repairs,-255.3,-5202.84
buyer_6,Manuel,,1979-02-14,ES88209530454618970832,TRX_N-00153-10923846,2022-05-16T10:22:07,Vitoria-Gasteiz,expenses,repairs,-158.99,-5361.83
buyer_6,Manuel,,1979-02-14,ES88209530454618970832,TRX_N-00154-47572622,2022-05-16T13:35:29,Vitoria-Gasteiz,expenses,gifts,-540.26,-5902.09
buyer_6,Manuel,,1979-02-14,ES88209530454618970832,TRX_N-00155-45131886,2022-05-17T16:21:57,Vitoria-Gasteiz,expenses,cash,-100.0,-6002.09
buyer_6,Manuel,,1979-02-14,ES88209530454618970832,TRX_N-00156-24066655,2022-05-17T14:52:41,Vitoria-Gasteiz,expenses,gifts,-676.57,-6678.66
buyer_6,Manuel,,1979-02-14,ES88209530454618970832,TRX_N-00157-87472707,2022-05-19T18:33:02,Vitoria-Gasteiz,expenses,food,-70.07,-6748.73
buyer_6,Manuel,,1979-02-14,ES88209530454618970832,TRX_N-00158-66621982,2022-05-20T11:46:36,Vitoria-Gasteiz,expenses,food,-66.07,-6814.8
buyer_6,Manuel,,1979-02-14,ES88209530454618970832,TRX_N-00159-68004108,2022-05-23T19:54:28,Vitoria-Gasteiz,expenses,leisure,-72.99,-6887.79
buyer_6,Manuel,,1979-02-14,ES88209530454618970832,TRX_N-00160-01407766,2022-05-23T02:57:31,Salvatierra/Agurain,expenses,repairs,-159.07,-7046.86
buyer_6,Manuel,,1979-02-14,ES88209530454618970832,TRX_N-00161-19133794,2022-05-24T17:01:35,Vitoria-Gasteiz,expenses,healthcare,-93.0,-7139.86
buyer_6,Manuel,,1979-02-14,ES88209530454618970832,TRX_N-00162-98127347,2022-05-25T17:41:55,Vitoria-Gasteiz,expenses,leisure,-56.52,-7196.38
buyer_6,Manuel,,1979-02-14,ES88209530454618970832,TRX_N-00163-03087469,2022-05-25T15:28:35,Vitoria-Gasteiz,expenses,cash,-100.0,-7296.38
buyer_6,Manuel,,1979-02-14,ES88209530454618970832,TRX_N-00164-69379410,2022-05-26T18:40:02,Basauri,expenses,cash,-100.0,-7396.38
buyer_6,Manuel,,1979-02-14,ES88209530454618970832,TRX_N-00165-23073664,2022-05-27T14:33:32,Bermeo,expenses,leisure,-79.62,-7476.0
buyer_6,Manuel,,1979-02-14,ES88209530454618970832,TRX_N-00166-71196103,2022-05-27T12:21:04,Vitoria-Gasteiz,expenses,cash,-100.0,-7576.0
buyer_6,Manuel,,1979-02-14,ES88209530454618970832,TRX_N-00167-69800835,2022-05-30T08:54:20,Irun,expenses,food,-63.39,-7639.39
buyer_6,Manuel,,1979-02-14,ES88209530454618970832,TRX_N-00168-76295847,2022-05-30T09:13:42,Vitoria-Gasteiz,expenses,healthcare,-171.31,-7810.7
buyer_6,Manuel,,1979-02-14,ES88209530454618970832,TRX_N-00169-28077064,2022-05-31T09:01:02,Vitoria-Gasteiz,expenses,cash,-100.0,-7910.7
buyer_6,Manuel,,1979-02-14,ES88209530454618970832,TRX_N-00170-04363817,2022-05-31T17:49:45,Vitoria-Gasteiz,expenses,repairs,-181.95,-8092.65
buyer_6,Manuel,,1979-02-14,ES88209530454618970832,TRX_N-00171-88662248,2022-06-01T14:19:42,Vitoria-Gasteiz,incomes,salary,2843.15,-5249.5
buyer_6,Manuel,,1979-02-14,ES88209530454618970832,TRX_N-00172-57995685,2022-06-01T14:19:42,Vitoria-Gasteiz,incomes,salary_bonus,2062.9,-3186.6
buyer_6,Manuel,,1979-02-14,ES88209530454618970832,TRX_N-00173-63900686,2022-06-01T12:53:33,Vitoria-Gasteiz,expenses,leisure,-70.65,-3257.25
buyer_6,Manuel,,1979-02-14,ES88209530454618970832,TRX_N-00174-49536922,2022-06-01T17:03:04,Vitoria-Gasteiz,expenses,travel,-1603.11,-4860.36
buyer_6,Manuel,,1979-02-14,ES88209530454618970832,TRX_N-00175-15269401,2022-06-03T06:05:59,Vitoria-Gasteiz,expenses,cash,-100.0,-4960.36
buyer_6,Manuel,,1979-02-14,ES88209530454618970832,TRX_N-00176-48389025,2022-06-03T16:28:23,Durango,expenses,gifts,-512.65,-5473.01
buyer_6,Manuel,,1979-02-14,ES88209530454618970832,TRX_N-00177-27144547,2022-06-04T13:45:31,Vitoria-Gasteiz,expenses,mortgage,-1089.47,-6562.48
buyer_6,Manuel,,1979-02-14,ES88209530454618970832,TRX_N-00178-23485329,2022-06-05T19:06:56,Vitoria-Gasteiz,expenses,water,-35.98,-6598.46
buyer_6,Manuel,,1979-02-14,ES88209530454618970832,TRX_N-00179-42787759,2022-06-05T16:38:53,Vitoria-Gasteiz,expenses,gas,-98.52,-6696.98
buyer_6,Manuel,,1979-02-14,ES88209530454618970832,TRX_N-00180-86451661,2022-06-05T08:45:50,Bilbao,expenses,cash,-100.0,-6796.98
buyer_6,Manuel,,1979-02-14,ES88209530454618970832,TRX_N-00181-27744131,2022-06-05T18:34:55,Vitoria-Gasteiz,expenses,appliances,-97.8,-6894.78
buyer_6,Manuel,,1979-02-14,ES88209530454618970832,TRX_N-00182-71065371,2022-06-06T10:46:28,Vitoria-Gasteiz,expenses,internet,-42.0,-6936.78
buyer_6,Manuel,,1979-02-14,ES88209530454618970832,TRX_N-00183-74893193,2022-06-07T16:08:46,Vitoria-Gasteiz,expenses,food,-103.8,-7040.58
buyer_6,Manuel,,1979-02-14,ES88209530454618970832,TRX_N-00184-25221848,2022-06-08T18:43:54,Vitoria-Gasteiz,expenses,electricity,-88.59,-7129.17
buyer_6,Manuel,,1979-02-14,ES88209530454618970832,TRX_N-00185-14235300,2022-06-08T18:21:38,Vitoria-Gasteiz,expenses,phone,-42.81,-7171.98
buyer_6,Manuel,,1979-02-14,ES88209530454618970832,TRX_N-00186-75944533,2022-06-08T19:05:50,Durango,expenses,food,-82.54,-7254.52
buyer_6,Manuel,,1979-02-14,ES88209530454618970832,TRX_N-00187-23452154,2022-06-09T14:12:12,Vitoria-Gasteiz,expenses,food,-82.09,-7336.61
buyer_6,Manuel,,1979-02-14,ES88209530454618970832,TRX_N-00188-75154103,2022-06-12T18:37:48,Vitoria-Gasteiz,expenses,transport,-45.3,-7381.91
buyer_6,Manuel,,1979-02-14,ES88209530454618970832,TRX_N-00189-16192033,2022-06-13T12:56:10,Vitoria-Gasteiz,expenses,cash,-100.0,-7481.91
buyer_6,Manuel,,1979-02-14,ES88209530454618970832,TRX_N-00190-94723937,2022-06-13T20:59:54,Berango,expenses,repairs,-55.34,-7537.25
buyer_6,Manuel,,1979-02-14,ES88209530454618970832,TRX_N-00191-12920732,2022-06-14T18:07:05,Vitoria-Gasteiz,expenses,food,-116.33,-7653.58
buyer_6,Manuel,,1979-02-14,ES88209530454618970832,TRX_N-00192-91914963,2022-06-14T14:32:15,Vitoria-Gasteiz,expenses,transport,-42.71,-7696.29
buyer_6,Manuel,,1979-02-14,ES88209530454618970832,TRX_N-00193-26792070,2022-06-14T23:59:45,Vitoria-Gasteiz,expenses,cash,-100.0,-7796.29
buyer_6,Manuel,,1979-02-14,ES88209530454618970832,TRX_N-00194-37962686,2022-06-16T19:08:18,Vitoria-Gasteiz,expenses,gifts,-375.5,-8171.79
buyer_6,Manuel,,1979-02-14,ES88209530454618970832,TRX_N-00195-42005469,2022-06-17T13:27:22,Zarautz,expenses,education,-58.13,-8229.92
buyer_6,Manuel,,1979-02-14,ES88209530454618970832,TRX_N-00196-61002502,2022-06-18T20:30:13,Santurtzi,expenses,food,-112.53,-8342.45
buyer_6,Manuel,,1979-02-14,ES88209530454618970832,TRX_N-00197-31463685,2022-06-20T10:27:36,Vitoria-Gasteiz,expenses,leisure,-27.57,-8370.02
buyer_6,Manuel,,1979-02-14,ES88209530454618970832,TRX_N-00198-09795877,2022-06-22T12:16:01,Vitoria-Gasteiz,expenses,food,-71.01,-8441.03
buyer_6,Manuel,,1979-02-14,ES88209530454618970832,TRX_N-00199-55377039,2022-06-22T16:30:12,Vitoria-Gasteiz,expenses,healthcare,-149.67,-8590.7
buyer_6,Manuel,,1979-02-14,ES88209530454618970832,TRX_N-00200-72789876,2022-06-25T18:06:55,Vitoria-Gasteiz,expenses,transport,-78.41,-8669.11
buyer_6,Manuel,,1979-02-14,ES88209530454618970832,TRX_N-00201-87465508,2022-06-26T17:00:22,Vitoria-Gasteiz,expenses,leisure,-52.12,-8721.23
buyer_6,Manuel,,1979-02-14,ES88209530454618970832,TRX_N-00202-25823816,2022-06-27T09:49:25,Vitoria-Gasteiz,expenses,leisure,-55.49,-8776.72
buyer_6,Manuel,,1979-02-14,ES88209530454618970832,TRX_N-00203-08367542,2022-06-27T10:54:33,Vitoria-Gasteiz,expenses,repairs,-283.75,-9060.47
buyer_6,Manuel,,1979-02-14,ES88209530454618970832,TRX_N-00204-13218231,2022-07-01T15:47:06,Vitoria-Gasteiz,incomes,salary,2843.15,-6217.32
buyer_6,Manuel,,1979-02-14,ES88209530454618970832,TRX_N-00205-06586991,2022-07-01T15:47:06,Vitoria-Gasteiz,incomes,extra_income,329.55,-5887.77
buyer_6,Manuel,,1979-02-14,ES88209530454618970832,TRX_N-00206-26865549,2022-07-01T10:05:22,Vitoria-Gasteiz,expenses,healthcare,-136.3,-6024.07
buyer_6,Manuel,,1979-02-14,ES88209530454618970832,TRX_N-00207-50881351,2022-07-04T15:14:50,Vitoria-Gasteiz,expenses,mortgage,-1089.47,-7113.54
buyer_6,Manuel,,1979-02-14,ES88209530454618970832,TRX_N-00208-63082696,2022-07-04T19:37:12,Vitoria-Gasteiz,expenses,food,-86.8,-7200.34
buyer_6,Manuel,,1979-02-14,ES88209530454618970832,TRX_N-00209-05267142,2022-07-04T18:13:12,Vitoria-Gasteiz,expenses,cash,-100.0,-7300.34
buyer_6,Manuel,,1979-02-14,ES88209530454618970832,TRX_N-00210-21179223,2022-07-05T14:37:02,Vitoria-Gasteiz,expenses,gas,-106.5,-7406.84
buyer_6,Manuel,,1979-02-14,ES88209530454618970832,TRX_N-00211-42375031,2022-07-05T08:21:30,Vitoria-Gasteiz,expenses,food,-67.23,-7474.07
buyer_6,Manuel,,1979-02-14,ES88209530454618970832,TRX_N-00212-19341493,2022-07-06T14:04:49,Vitoria-Gasteiz,expenses,internet,-42.0,-7516.07
buyer_6,Manuel,,1979-02-14,ES88209530454618970832,TRX_N-00213-41035613,2022-07-07T10:20:07,Vitoria-Gasteiz,expenses,electricity,-49.37,-7565.44
buyer_6,Manuel,,1979-02-14,ES88209530454618970832,TRX_N-00214-27286363,2022-07-08T16:11:10,Vitoria-Gasteiz,expenses,water,-40.32,-7605.76
buyer_6,Manuel,,1979-02-14,ES88209530454618970832,TRX_N-00215-35132122,2022-07-08T15:04:38,Vitoria-Gasteiz,expenses,phone,-39.37,-7645.13
buyer_6,Manuel,,1979-02-14,ES88209530454618970832,TRX_N-00216-92663566,2022-07-08T20:33:58,Vitoria-Gasteiz,expenses,cash,-100.0,-7745.13
buyer_6,Manuel,,1979-02-14,ES88209530454618970832,TRX_N-00217-28115923,2022-07-09T09:44:38,Vitoria-Gasteiz,expenses,transport,-87.16,-7832.29
buyer_6,Manuel,,1979-02-14,ES88209530454618970832,TRX_N-00218-23548483,2022-07-12T12:04:48,Vitoria-Gasteiz,expenses,repairs,-127.16,-7959.45
buyer_6,Manuel,,1979-02-14,ES88209530454618970832,TRX_N-00219-47744244,2022-07-15T19:12:59,Vitoria-Gasteiz,expenses,education,-62.41,-8021.86
buyer_6,Manuel,,1979-02-14,ES88209530454618970832,TRX_N-00220-62636562,2022-07-16T15:53:52,Vitoria-Gasteiz,expenses,healthcare,-41.14,-8063.0
buyer_6,Manuel,,1979-02-14,ES88209530454618970832,TRX_N-00221-89768103,2022-07-19T15:04:08,Vitoria-Gasteiz,expenses,transport,-77.63,-8140.63
buyer_6,Manuel,,1979-02-14,ES88209530454618970832,TRX_N-00222-95335418,2022-07-21T20:08:49,Vitoria-Gasteiz,expenses,clothing,-114.55,-8255.18
buyer_6,Manuel,,1979-02-14,ES88209530454618970832,TRX_N-00223-29943720,2022-07-22T15:42:26,Vitoria-Gasteiz,expenses,leisure,-64.95,-8320.13
buyer_6,Manuel,,1979-02-14,ES88209530454618970832,TRX_N-00224-42580158,2022-07-23T10:00:37,Leioa,expenses,food,-122.38,-8442.51
buyer_6,Manuel,,1979-02-14,ES88209530454618970832,TRX_N-00225-48214945,2022-07-25T15:14:43,Vitoria-Gasteiz,expenses,food,-74.94,-8517.45
buyer_6,Manuel,,1979-02-14,ES88209530454618970832,TRX_N-00226-71886707,2022-07-27T18:30:23,Lasarte-Oria,expenses,cash,-100.0,-8617.45
buyer_6,Manuel,,1979-02-14,ES88209530454618970832,TRX_N-00227-38222779,2022-07-29T20:35:35,Vitoria-Gasteiz,expenses,gifts,-27.34,-8644.79
buyer_6,Manuel,,1979-02-14,ES88209530454618970832,TRX_N-00228-14819826,2022-07-30T12:12:27,Vitoria-Gasteiz,expenses,clothing,-112.43,-8757.22
buyer_6,Manuel,,1979-02-14,ES88209530454618970832,TRX_N-00229-96103718,2022-08-01T17:57:15,Vitoria-Gasteiz,incomes,salary,2843.15,-5914.07
buyer_6,Manuel,,1979-02-14,ES88209530454618970832,TRX_N-00230-02838481,2022-08-04T16:58:59,Vitoria-Gasteiz,expenses,mortgage,-1089.47,-7003.54
buyer_6,Manuel,,1979-02-14,ES88209530454618970832,TRX_N-00231-51441528,2022-08-05T14:11:05,Vitoria-Gasteiz,expenses,gas,-105.86,-7109.4
buyer_6,Manuel,,1979-02-14,ES88209530454618970832,TRX_N-00232-42666433,2022-08-05T21:35:19,Vitoria-Gasteiz,expenses,internet,-42.0,-7151.4
buyer_6,Manuel,,1979-02-14,ES88209530454618970832,TRX_N-00233-57556011,2022-08-05T15:53:10,Vitoria-Gasteiz,expenses,leisure,-34.41,-7185.81
buyer_6,Manuel,,1979-02-14,ES88209530454618970832,TRX_N-00234-41424074,2022-08-05T10:42:09,Vitoria-Gasteiz,expenses,clothing,-72.63,-7258.44
buyer_6,Manuel,,1979-02-14,ES88209530454618970832,TRX_N-00235-09284432,2022-08-06T13:01:26,Vitoria-Gasteiz,expenses,phone,-41.85,-7300.29
buyer_6,Manuel,,1979-02-14,ES88209530454618970832,TRX_N-00236-81229147,2022-08-07T16:16:26,Vitoria-Gasteiz,expenses,electricity,-83.56,-7383.85
buyer_6,Manuel,,1979-02-14,ES88209530454618970832,TRX_N-00237-65296881,2022-08-07T08:34:49,Hondarribia,expenses,transport,-85.52,-7469.37
buyer_6,Manuel,,1979-02-14,ES88209530454618970832,TRX_N-00238-82303634,2022-08-08T10:53:46,Vitoria-Gasteiz,expenses,water,-30.78,-7500.15
buyer_6,Manuel,,1979-02-14,ES88209530454618970832,TRX_N-00239-99764623,2022-08-08T11:00:57,Leioa,expenses,food,-120.33,-7620.48
buyer_6,Manuel,,1979-02-14,ES88209530454618970832,TRX_N-00240-21049485,2022-08-08T02:33:03,Lasarte-Oria,expenses,transport,-52.41,-7672.89
buyer_6,Manuel,,1979-02-14,ES88209530454618970832,TRX_N-00241-01966854,2022-08-09T19:54:55,Vitoria-Gasteiz,expenses,leisure,-53.08,-7725.97
buyer_6,Manuel,,1979-02-14,ES88209530454618970832,TRX_N-00242-20698940,2022-08-09T23:12:44,Vitoria-Gasteiz,expenses,cash,-100.0,-7825.97
buyer_6,Manuel,,1979-02-14,ES88209530454618970832,TRX_N-00243-76999602,2022-08-10T15:33:26,Vitoria-Gasteiz,expenses,food,-83.26,-7909.23
buyer_6,Manuel,,1979-02-14,ES88209530454618970832,TRX_N-00244-23359716,2022-08-11T08:57:55,Vitoria-Gasteiz,expenses,leisure,-57.43,-7966.66
buyer_6,Manuel,,1979-02-14,ES88209530454618970832,TRX_N-00245-83072238,2022-08-13T20:15:41,Vitoria-Gasteiz,expenses,gifts,-209.08,-8175.74
buyer_6,Manuel,,1979-02-14,ES88209530454618970832,TRX_N-00246-53445583,2022-08-14T19:07:16,Oy√≥n-Oion,expenses,gifts,-373.74,-8549.48
buyer_6,Manuel,,1979-02-14,ES88209530454618970832,TRX_N-00247-04488285,2022-08-16T08:47:51,Vitoria-Gasteiz,expenses,education,-77.44,-8626.92
buyer_6,Manuel,,1979-02-14,ES88209530454618970832,TRX_N-00248-11718346,2022-08-16T14:54:43,Vitoria-Gasteiz,expenses,cash,-100.0,-8726.92
buyer_6,Manuel,,1979-02-14,ES88209530454618970832,TRX_N-00249-06885517,2022-08-17T19:17:11,Vitoria-Gasteiz,expenses,healthcare,-188.22,-8915.14
buyer_6,Manuel,,1979-02-14,ES88209530454618970832,TRX_N-00250-16825234,2022-08-19T20:56:11,Vitoria-Gasteiz,expenses,repairs,-82.94,-8998.08
buyer_6,Manuel,,1979-02-14,ES88209530454618970832,TRX_N-00251-03806039,2022-08-20T08:00:20,Vitoria-Gasteiz,expenses,food,-65.71,-9063.79
buyer_6,Manuel,,1979-02-14,ES88209530454618970832,TRX_N-00252-42612098,2022-08-24T13:10:55,Vitoria-Gasteiz,expenses,cash,-100.0,-9163.79
buyer_6,Manuel,,1979-02-14,ES88209530454618970832,TRX_N-00253-11255407,2022-08-26T23:50:16,Vitoria-Gasteiz,expenses,education,-58.46,-9222.25
buyer_6,Manuel,,1979-02-14,ES88209530454618970832,TRX_N-00254-22552585,2022-08-28T08:59:17,Vitoria-Gasteiz,expenses,education,-56.99,-9279.24
buyer_6,Manuel,,1979-02-14,ES88209530454618970832,TRX_N-00255-05627122,2022-08-29T10:35:59,Vitoria-Gasteiz,expenses,transport,-77.64,-9356.88
buyer_6,Manuel,,1979-02-14,ES88209530454618970832,TRX_N-00256-46196047,2022-08-29T10:58:44,Vitoria-Gasteiz,expenses,repairs,-95.86,-9452.74
buyer_6,Manuel,,1979-02-14,ES88209530454618970832,TRX_N-00257-06934093,2022-08-30T18:26:08,Labastida,expenses,food,-88.57,-9541.31
buyer_6,Manuel,,1979-02-14,ES88209530454618970832,TRX_N-00258-47543308,2022-08-30T13:36:44,Vitoria-Gasteiz,expenses,transport,-66.45,-9607.76
buyer_6,Manuel,,1979-02-14,ES88209530454618970832,TRX_N-00259-93140584,2022-08-30T12:21:06,Vitoria-Gasteiz,expenses,cash,-100.0,-9707.76
buyer_6,Manuel,,1979-02-14,ES88209530454618970832,TRX_N-00260-98808300,2022-08-30T17:11:52,Arrasate,expenses,repairs,-309.22,-10016.98
buyer_6,Manuel,,1979-02-14,ES88209530454618970832,TRX_N-00261-96103012,2022-08-31T17:05:44,Hondarribia,expenses,healthcare,-88.31,-10105.29
buyer_6,Manuel,,1979-02-14,ES88209530454618970832,TRX_N-00262-82799011,2022-09-01T17:13:04,Vitoria-Gasteiz,incomes,salary,2843.15,-7262.14
buyer_6,Manuel,,1979-02-14,ES88209530454618970832,TRX_N-00263-59464862,2022-09-01T23:13:15,Vitoria-Gasteiz,expenses,food,-103.97,-7366.11
buyer_6,Manuel,,1979-02-14,ES88209530454618970832,TRX_N-00264-01734299,2022-09-04T14:32:08,Vitoria-Gasteiz,expenses,mortgage,-1089.47,-8455.58
buyer_6,Manuel,,1979-02-14,ES88209530454618970832,TRX_N-00265-00604500,2022-09-04T18:07:39,Vitoria-Gasteiz,expenses,clothing,-57.73,-8513.31
buyer_6,Manuel,,1979-02-14,ES88209530454618970832,TRX_N-00266-47468373,2022-09-04T11:54:28,Vitoria-Gasteiz,expenses,cash,-100.0,-8613.31
buyer_6,Manuel,,1979-02-14,ES88209530454618970832,TRX_N-00267-42361172,2022-09-05T11:07:50,Vitoria-Gasteiz,expenses,electricity,-48.09,-8661.4
buyer_6,Manuel,,1979-02-14,ES88209530454618970832,TRX_N-00268-24384559,2022-09-06T16:29:46,Vitoria-Gasteiz,expenses,phone,-31.56,-8692.96
buyer_6,Manuel,,1979-02-14,ES88209530454618970832,TRX_N-00269-43670669,2022-09-06T13:39:34,Vitoria-Gasteiz,expenses,food,-73.17,-8766.13
buyer_6,Manuel,,1979-02-14,ES88209530454618970832,TRX_N-00270-90946369,2022-09-07T22:32:57,Andoain,expenses,food,-83.96,-8850.09
buyer_6,Manuel,,1979-02-14,ES88209530454618970832,TRX_N-00271-63612709,2022-09-08T15:53:34,Vitoria-Gasteiz,expenses,water,-33.97,-8884.06
buyer_6,Manuel,,1979-02-14,ES88209530454618970832,TRX_N-00272-52875998,2022-09-08T18:29:12,Vitoria-Gasteiz,expenses,gas,-42.13,-8926.19
buyer_6,Manuel,,1979-02-14,ES88209530454618970832,TRX_N-00273-86958193,2022-09-08T21:23:06,Vitoria-Gasteiz,expenses,internet,-42.0,-8968.19
buyer_6,Manuel,,1979-02-14,ES88209530454618970832,TRX_N-00274-19643163,2022-09-08T13:26:38,Berango,expenses,repairs,-250.0,-9218.19
buyer_6,Manuel,,1979-02-14,ES88209530454618970832,TRX_N-00275-52704316,2022-09-09T15:36:57,Vitoria-Gasteiz,expenses,food,-66.35,-9284.54
buyer_6,Manuel,,1979-02-14,ES88209530454618970832,TRX_N-00276-66999407,2022-09-09T23:20:37,Vitoria-Gasteiz,expenses,transport,-72.45,-9356.99
buyer_6,Manuel,,1979-02-14,ES88209530454618970832,TRX_N-00277-70805501,2022-09-09T18:04:19,Vitoria-Gasteiz,expenses,cash,-100.0,-9456.99
buyer_6,Manuel,,1979-02-14,ES88209530454618970832,TRX_N-00278-92301291,2022-09-10T14:56:02,Vitoria-Gasteiz,expenses,food,-68.13,-9525.12
buyer_6,Manuel,,1979-02-14,ES88209530454618970832,TRX_N-00279-25541220,2022-09-12T19:39:42,Vitoria-Gasteiz,expenses,transport,-42.89,-9568.01
buyer_6,Manuel,,1979-02-14,ES88209530454618970832,TRX_N-00280-76726327,2022-09-15T12:43:45,Vitoria-Gasteiz,expenses,food,-112.17,-9680.18
buyer_6,Manuel,,1979-02-14,ES88209530454618970832,TRX_N-00281-39831411,2022-09-15T10:18:09,Vitoria-Gasteiz,expenses,transport,-62.03,-9742.21
buyer_6,Manuel,,1979-02-14,ES88209530454618970832,TRX_N-00282-44484530,2022-09-16T20:40:06,Vitoria-Gasteiz,expenses,clothing,-139.32,-9881.53
buyer_6,Manuel,,1979-02-14,ES88209530454618970832,TRX_N-00283-96496966,2022-09-18T14:39:33,Vitoria-Gasteiz,expenses,leisure,-27.49,-9909.02
buyer_6,Manuel,,1979-02-14,ES88209530454618970832,TRX_N-00284-65003210,2022-09-19T19:58:39,Vitoria-Gasteiz,expenses,food,-64.87,-9973.89
buyer_6,Manuel,,1979-02-14,ES88209530454618970832,TRX_N-00285-44938808,2022-09-20T05:09:36,Vitoria-Gasteiz,expenses,clothing,-61.59,-10035.48
buyer_6,Manuel,,1979-02-14,ES88209530454618970832,TRX_N-00286-55534555,2022-09-21T09:05:39,Vitoria-Gasteiz,expenses,transport,-87.1,-10122.58
buyer_6,Manuel,,1979-02-14,ES88209530454618970832,TRX_N-00287-35136927,2022-09-23T12:41:06,Irun,expenses,cash,-100.0,-10222.58
buyer_6,Manuel,,1979-02-14,ES88209530454618970832,TRX_N-00288-40675901,2022-09-27T22:27:08,Vitoria-Gasteiz,expenses,transport,-79.63,-10302.21
buyer_6,Manuel,,1979-02-14,ES88209530454618970832,TRX_N-00289-32551010,2022-09-29T21:37:12,Berango,expenses,food,-93.48,-10395.69
buyer_6,Manuel,,1979-02-14,ES88209530454618970832,TRX_N-00290-37813127,2022-10-01T21:43:21,Vitoria-Gasteiz,incomes,salary,2843.15,-7552.54
buyer_6,Manuel,,1979-02-14,ES88209530454618970832,TRX_N-00291-98365203,2022-10-01T21:43:21,Vitoria-Gasteiz,incomes,extra_income,329.55,-7222.99
buyer_6,Manuel,,1979-02-14,ES88209530454618970832,TRX_N-00292-39939491,2022-10-02T13:14:24,Vitoria-Gasteiz,expenses,food,-73.87,-7296.86
buyer_6,Manuel,,1979-02-14,ES88209530454618970832,TRX_N-00293-48822700,2022-10-04T08:36:29,Vitoria-Gasteiz,expenses,mortgage,-1089.47,-8386.33
buyer_6,Manuel,,1979-02-14,ES88209530454618970832,TRX_N-00294-83797348,2022-10-05T22:25:21,Vitoria-Gasteiz,expenses,internet,-42.0,-8428.33
buyer_6,Manuel,,1979-02-14,ES88209530454618970832,TRX_N-00295-10956597,2022-10-05T14:39:40,Vitoria-Gasteiz,expenses,phone,-42.58,-8470.91
buyer_6,Manuel,,1979-02-14,ES88209530454618970832,TRX_N-00296-24180084,2022-10-05T20:50:35,Vitoria-Gasteiz,expenses,food,-83.6,-8554.51
buyer_6,Manuel,,1979-02-14,ES88209530454618970832,TRX_N-00297-95716801,2022-10-06T12:36:48,Vitoria-Gasteiz,expenses,electricity,-64.32,-8618.83
buyer_6,Manuel,,1979-02-14,ES88209530454618970832,TRX_N-00298-69305166,2022-10-06T10:18:36,Vitoria-Gasteiz,expenses,gas,-42.84,-8661.67
buyer_6,Manuel,,1979-02-14,ES88209530454618970832,TRX_N-00299-10966084,2022-10-07T16:29:57,Vitoria-Gasteiz,expenses,food,-84.49,-8746.16
buyer_6,Manuel,,1979-02-14,ES88209530454618970832,TRX_N-00300-00386154,2022-10-07T17:18:37,Vitoria-Gasteiz,expenses,leisure,-36.79,-8782.95
buyer_6,Manuel,,1979-02-14,ES88209530454618970832,TRX_N-00301-17225556,2022-10-07T15:40:57,Vitoria-Gasteiz,expenses,cash,-100.0,-8882.95
buyer_6,Manuel,,1979-02-14,ES88209530454618970832,TRX_N-00302-12958578,2022-10-08T05:12:35,Vitoria-Gasteiz,expenses,water,-26.19,-8909.14
buyer_6,Manuel,,1979-02-14,ES88209530454618970832,TRX_N-00303-49209202,2022-10-09T13:21:11,Donostia,expenses,clothing,-46.78,-8955.92
buyer_6,Manuel,,1979-02-14,ES88209530454618970832,TRX_N-00304-01531096,2022-10-10T15:14:34,Vitoria-Gasteiz,expenses,repairs,-194.47,-9150.39
buyer_6,Manuel,,1979-02-14,ES88209530454618970832,TRX_N-00305-05626687,2022-10-11T19:49:45,Vitoria-Gasteiz,expenses,leisure,-66.03,-9216.42
buyer_6,Manuel,,1979-02-14,ES88209530454618970832,TRX_N-00306-95557743,2022-10-12T18:51:14,Vitoria-Gasteiz,expenses,transport,-55.66,-9272.08
buyer_6,Manuel,,1979-02-14,ES88209530454618970832,TRX_N-00307-70369625,2022-10-12T13:55:26,Vitoria-Gasteiz,expenses,leisure,-21.27,-9293.35
buyer_6,Manuel,,1979-02-14,ES88209530454618970832,TRX_N-00308-42336287,2022-10-14T09:50:09,Vitoria-Gasteiz,expenses,food,-72.85,-9366.2
buyer_6,Manuel,,1979-02-14,ES88209530454618970832,TRX_N-00309-92292023,2022-10-14T19:49:18,Vitoria-Gasteiz,expenses,transport,-49.22,-9415.42
buyer_6,Manuel,,1979-02-14,ES88209530454618970832,TRX_N-00310-68859602,2022-10-15T13:46:35,Vitoria-Gasteiz,expenses,food,-94.26,-9509.68
buyer_6,Manuel,,1979-02-14,ES88209530454618970832,TRX_N-00311-80388336,2022-10-16T20:53:44,Vitoria-Gasteiz,expenses,healthcare,-116.83,-9626.51
buyer_6,Manuel,,1979-02-14,ES88209530454618970832,TRX_N-00312-25886116,2022-10-17T13:33:37,Vitoria-Gasteiz,expenses,transport,-50.34,-9676.85
buyer_6,Manuel,,1979-02-14,ES88209530454618970832,TRX_N-00313-15786745,2022-10-17T16:32:33,Vitoria-Gasteiz,expenses,appliances,-276.57,-9953.42
buyer_6,Manuel,,1979-02-14,ES88209530454618970832,TRX_N-00314-78015806,2022-10-18T11:40:33,Andoain,expenses,cash,-100.0,-10053.42
buyer_6,Manuel,,1979-02-14,ES88209530454618970832,TRX_N-00315-48038548,2022-10-18T09:53:24,Vitoria-Gasteiz,expenses,appliances,-137.14,-10190.56
buyer_6,Manuel,,1979-02-14,ES88209530454618970832,TRX_N-00316-99311835,2022-10-19T06:39:29,Galdakao,expenses,cash,-100.0,-10290.56
buyer_6,Manuel,,1979-02-14,ES88209530454618970832,TRX_N-00317-24240954,2022-10-20T14:31:19,Vitoria-Gasteiz,expenses,food,-104.12,-10394.68
buyer_6,Manuel,,1979-02-14,ES88209530454618970832,TRX_N-00318-38431234,2022-10-22T21:13:01,Zarautz,expenses,repairs,-59.95,-10454.63
buyer_6,Manuel,,1979-02-14,ES88209530454618970832,TRX_N-00319-32963761,2022-10-24T14:27:09,Vitoria-Gasteiz,expenses,leisure,-51.92,-10506.55
buyer_6,Manuel,,1979-02-14,ES88209530454618970832,TRX_N-00320-81491473,2022-10-25T08:07:00,Iru√±a de Oca,expenses,repairs,-30.44,-10536.99
buyer_6,Manuel,,1979-02-14,ES88209530454618970832,TRX_N-00321-80693451,2022-10-26T22:22:27,Barakaldo,expenses,food,-62.66,-10599.65
buyer_6,Manuel,,1979-02-14,ES88209530454618970832,TRX_N-00322-50202530,2022-10-26T09:50:12,Vitoria-Gasteiz,expenses,clothing,-144.94,-10744.59
buyer_6,Manuel,,1979-02-14,ES88209530454618970832,TRX_N-00323-03585869,2022-10-27T23:18:57,Vitoria-Gasteiz,expenses,cash,-100.0,-10844.59
buyer_6,Manuel,,1979-02-14,ES88209530454618970832,TRX_N-00324-77909649,2022-10-28T16:35:48,Leioa,expenses,education,-50.52,-10895.11
buyer_6,Manuel,,1979-02-14,ES88209530454618970832,TRX_N-00325-76243848,2022-10-28T14:01:34,Vitoria-Gasteiz,expenses,travel,-842.42,-11737.53
buyer_6,Manuel,,1979-02-14,ES88209530454618970832,TRX_N-00326-71246660,2022-10-29T18:48:36,Donostia,expenses,food,-71.54,-11809.07
buyer_6,Manuel,,1979-02-14,ES88209530454618970832,TRX_N-00327-65318153,2022-10-31T19:54:33,Vitoria-Gasteiz,expenses,food,-69.27,-11878.34
buyer_6,Manuel,,1979-02-14,ES88209530454618970832,TRX_N-00328-97828412,2022-11-01T08:29:08,Vitoria-Gasteiz,incomes,salary,2843.15,-9035.19
buyer_6,Manuel,,1979-02-14,ES88209530454618970832,TRX_N-00329-25495357,2022-11-01T08:23:11,Vitoria-Gasteiz,expenses,appliances,-379.47,-9414.66
buyer_6,Manuel,,1979-02-14,ES88209530454618970832,TRX_N-00330-80786220,2022-11-04T14:29:54,Vitoria-Gasteiz,expenses,mortgage,-1089.47,-10504.13
buyer_6,Manuel,,1979-02-14,ES88209530454618970832,TRX_N-00331-49866049,2022-11-06T23:27:42,Vitoria-Gasteiz,expenses,gas,-109.7,-10613.83
buyer_6,Manuel,,1979-02-14,ES88209530454618970832,TRX_N-00332-40615579,2022-11-07T02:37:08,Vitoria-Gasteiz,expenses,water,-42.36,-10656.19
buyer_6,Manuel,,1979-02-14,ES88209530454618970832,TRX_N-00333-45269819,2022-11-07T08:10:27,Vitoria-Gasteiz,expenses,phone,-30.57,-10686.76
buyer_6,Manuel,,1979-02-14,ES88209530454618970832,TRX_N-00334-26598784,2022-11-07T09:20:01,Vitoria-Gasteiz,expenses,transport,-61.05,-10747.81
buyer_6,Manuel,,1979-02-14,ES88209530454618970832,TRX_N-00335-74227720,2022-11-07T14:56:06,Vitoria-Gasteiz,expenses,gifts,-730.04,-11477.85
buyer_6,Manuel,,1979-02-14,ES88209530454618970832,TRX_N-00336-33269761,2022-11-08T09:34:44,Vitoria-Gasteiz,expenses,electricity,-46.21,-11524.06
buyer_6,Manuel,,1979-02-14,ES88209530454618970832,TRX_N-00337-01564724,2022-11-08T22:22:51,Vitoria-Gasteiz,expenses,internet,-42.0,-11566.06
buyer_6,Manuel,,1979-02-14,ES88209530454618970832,TRX_N-00338-19321730,2022-11-08T12:25:11,Vitoria-Gasteiz,expenses,food,-94.37,-11660.43
buyer_6,Manuel,,1979-02-14,ES88209530454618970832,TRX_N-00339-79932457,2022-11-08T17:13:02,Vitoria-Gasteiz,expenses,transport,-89.48,-11749.91
buyer_6,Manuel,,1979-02-14,ES88209530454618970832,TRX_N-00340-95857743,2022-11-09T21:35:28,Vitoria-Gasteiz,expenses,clothing,-118.13,-11868.04
buyer_6,Manuel,,1979-02-14,ES88209530454618970832,TRX_N-00341-12471118,2022-11-09T13:38:57,Pasaia,expenses,education,-43.86,-11911.9
buyer_6,Manuel,,1979-02-14,ES88209530454618970832,TRX_N-00342-30638095,2022-11-10T13:42:23,Vitoria-Gasteiz,expenses,food,-74.59,-11986.49
buyer_6,Manuel,,1979-02-14,ES88209530454618970832,TRX_N-00343-18059051,2022-11-12T12:21:24,Vitoria-Gasteiz,expenses,repairs,-321.35,-12307.84
buyer_6,Manuel,,1979-02-14,ES88209530454618970832,TRX_N-00344-60753352,2022-11-14T11:57:28,Vitoria-Gasteiz,expenses,food,-88.17,-12396.01
buyer_6,Manuel,,1979-02-14,ES88209530454618970832,TRX_N-00345-84312549,2022-11-14T15:59:07,Vitoria-Gasteiz,expenses,education,-68.81,-12464.82
buyer_6,Manuel,,1979-02-14,ES88209530454618970832,TRX_N-00346-12321390,2022-11-14T19:11:18,Vitoria-Gasteiz,expenses,repairs,-155.49,-12620.31
buyer_6,Manuel,,1979-02-14,ES88209530454618970832,TRX_N-00347-90616316,2022-11-15T11:04:19,Vitoria-Gasteiz,expenses,food,-107.84,-12728.15
buyer_6,Manuel,,1979-02-14,ES88209530454618970832,TRX_N-00348-27741483,2022-11-15T14:10:13,Vitoria-Gasteiz,expenses,cash,-100.0,-12828.15
buyer_6,Manuel,,1979-02-14,ES88209530454618970832,TRX_N-00349-63446573,2022-11-15T16:32:13,Vitoria-Gasteiz,expenses,repairs,-53.32,-12881.47
buyer_6,Manuel,,1979-02-14,ES88209530454618970832,TRX_N-00350-99633547,2022-11-16T11:55:14,Vitoria-Gasteiz,expenses,food,-103.81,-12985.28
buyer_6,Manuel,,1979-02-14,ES88209530454618970832,TRX_N-00351-55420700,2022-11-17T12:17:12,Vitoria-Gasteiz,expenses,transport,-82.02,-13067.3
buyer_6,Manuel,,1979-02-14,ES88209530454618970832,TRX_N-00352-71502452,2022-11-19T12:58:46,Vitoria-Gasteiz,expenses,leisure,-73.55,-13140.85
buyer_6,Manuel,,1979-02-14,ES88209530454618970832,TRX_N-00353-41482373,2022-11-19T12:27:04,Vitoria-Gasteiz,expenses,education,-64.73,-13205.58
buyer_6,Manuel,,1979-02-14,ES88209530454618970832,TRX_N-00354-08503664,2022-11-20T18:28:12,Vitoria-Gasteiz,expenses,transport,-77.77,-13283.35
buyer_6,Manuel,,1979-02-14,ES88209530454618970832,TRX_N-00355-99384311,2022-11-20T20:35:21,Vitoria-Gasteiz,expenses,cash,-100.0,-13383.35
buyer_6,Manuel,,1979-02-14,ES88209530454618970832,TRX_N-00356-32574453,2022-11-21T12:32:06,Vitoria-Gasteiz,expenses,education,-66.4,-13449.75
buyer_6,Manuel,,1979-02-14,ES88209530454618970832,TRX_N-00357-78967505,2022-11-22T03:03:12,Vitoria-Gasteiz,expenses,transport,-81.0,-13530.75
buyer_6,Manuel,,1979-02-14,ES88209530454618970832,TRX_N-00358-71509910,2022-11-28T12:50:18,Vitoria-Gasteiz,expenses,education,-70.08,-13600.83
buyer_6,Manuel,,1979-02-14,ES88209530454618970832,TRX_N-00359-56609287,2022-11-29T19:51:47,Vitoria-Gasteiz,expenses,clothing,-159.87,-13760.7
buyer_6,Manuel,,1979-02-14,ES88209530454618970832,TRX_N-00360-70840309,2022-12-01T12:35:38,Vitoria-Gasteiz,incomes,salary,2843.15,-10917.55
buyer_6,Manuel,,1979-02-14,ES88209530454618970832,TRX_N-00361-05226588,2022-12-01T12:35:38,Vitoria-Gasteiz,incomes,salary_bonus,2148.11,-8769.44
buyer_6,Manuel,,1979-02-14,ES88209530454618970832,TRX_N-00362-54018531,2022-12-01T10:02:31,Vitoria-Gasteiz,expenses,transport,-78.35,-8847.79
buyer_6,Manuel,,1979-02-14,ES88209530454618970832,TRX_N-00363-05984419,2022-12-02T18:00:55,Vitoria-Gasteiz,expenses,transport,-68.71,-8916.5
buyer_6,Manuel,,1979-02-14,ES88209530454618970832,TRX_N-00364-80854674,2022-12-04T11:45:08,Vitoria-Gasteiz,expenses,mortgage,-1089.47,-10005.97
buyer_6,Manuel,,1979-02-14,ES88209530454618970832,TRX_N-00365-97817744,2022-12-04T18:14:22,Vitoria-Gasteiz,expenses,clothing,-62.62,-10068.59
buyer_6,Manuel,,1979-02-14,ES88209530454618970832,TRX_N-00366-10009650,2022-12-04T08:48:46,Vitoria-Gasteiz,expenses,gifts,-667.29,-10735.88
buyer_6,Manuel,,1979-02-14,ES88209530454618970832,TRX_N-00367-42780704,2022-12-05T18:44:56,Vitoria-Gasteiz,expenses,appliances,-366.84,-11102.72
buyer_6,Manuel,,1979-02-14,ES88209530454618970832,TRX_N-00368-90763504,2022-12-07T16:20:14,Vitoria-Gasteiz,expenses,water,-34.57,-11137.29
buyer_6,Manuel,,1979-02-14,ES88209530454618970832,TRX_N-00369-05283981,2022-12-07T15:34:53,Vitoria-Gasteiz,expenses,electricity,-36.67,-11173.96
buyer_6,Manuel,,1979-02-14,ES88209530454618970832,TRX_N-00370-01752009,2022-12-07T18:34:47,Vitoria-Gasteiz,expenses,phone,-33.33,-11207.29
buyer_6,Manuel,,1979-02-14,ES88209530454618970832,TRX_N-00371-86231397,2022-12-07T10:39:58,Arrasate,expenses,leisure,-41.85,-11249.14
buyer_6,Manuel,,1979-02-14,ES88209530454618970832,TRX_N-00372-48982730,2022-12-08T08:47:29,Vitoria-Gasteiz,expenses,gas,-98.4,-11347.54
buyer_6,Manuel,,1979-02-14,ES88209530454618970832,TRX_N-00373-00012158,2022-12-08T16:06:01,Vitoria-Gasteiz,expenses,internet,-42.0,-11389.54
buyer_6,Manuel,,1979-02-14,ES88209530454618970832,TRX_N-00374-16043470,2022-12-09T08:48:40,Vitoria-Gasteiz,expenses,cash,-100.0,-11489.54
buyer_6,Manuel,,1979-02-14,ES88209530454618970832,TRX_N-00375-71042458,2022-12-10T08:37:08,Vitoria-Gasteiz,expenses,repairs,-91.53,-11581.07
buyer_6,Manuel,,1979-02-14,ES88209530454618970832,TRX_N-00376-37206076,2022-12-11T22:40:05,Vitoria-Gasteiz,expenses,food,-71.82,-11652.89
buyer_6,Manuel,,1979-02-14,ES88209530454618970832,TRX_N-00377-22961015,2022-12-11T17:49:19,Vitoria-Gasteiz,expenses,leisure,-70.85,-11723.74
buyer_6,Manuel,,1979-02-14,ES88209530454618970832,TRX_N-00378-53244856,2022-12-11T10:14:08,Vitoria-Gasteiz,expenses,education,-70.73,-11794.47
buyer_6,Manuel,,1979-02-14,ES88209530454618970832,TRX_N-00379-68160050,2022-12-13T16:11:52,Vitoria-Gasteiz,expenses,clothing,-73.01,-11867.48
buyer_6,Manuel,,1979-02-14,ES88209530454618970832,TRX_N-00380-55764268,2022-12-13T13:49:25,Vitoria-Gasteiz,expenses,appliances,-136.29,-12003.77
buyer_6,Manuel,,1979-02-14,ES88209530454618970832,TRX_N-00381-40879675,2022-12-17T16:57:35,Leioa,expenses,transport,-57.16,-12060.93
buyer_6,Manuel,,1979-02-14,ES88209530454618970832,TRX_N-00382-12996167,2022-12-17T15:35:05,Vitoria-Gasteiz,expenses,clothing,-80.31,-12141.24
buyer_6,Manuel,,1979-02-14,ES88209530454618970832,TRX_N-00383-85015772,2022-12-18T08:31:21,Vitoria-Gasteiz,expenses,repairs,-136.76,-12278.0
buyer_6,Manuel,,1979-02-14,ES88209530454618970832,TRX_N-00384-32332175,2022-12-18T21:54:05,Vitoria-Gasteiz,expenses,gifts,-374.18,-12652.18
buyer_6,Manuel,,1979-02-14,ES88209530454618970832,TRX_N-00385-22162490,2022-12-19T08:11:05,Vitoria-Gasteiz,expenses,leisure,-31.6,-12683.78
buyer_6,Manuel,,1979-02-14,ES88209530454618970832,TRX_N-00386-70316630,2022-12-21T10:38:14,Vitoria-Gasteiz,expenses,cash,-100.0,-12783.78
buyer_6,Manuel,,1979-02-14,ES88209530454618970832,TRX_N-00387-00699379,2022-12-23T16:00:50,Vitoria-Gasteiz,expenses,gifts,-250.69,-13034.47
buyer_6,Manuel,,1979-02-14,ES88209530454618970832,TRX_N-00388-70301032,2022-12-24T10:19:45,Labastida,expenses,cash,-100.0,-13134.47
buyer_6,Manuel,,1979-02-14,ES88209530454618970832,TRX_N-00389-67127388,2022-12-25T18:08:06,Vitoria-Gasteiz,expenses,leisure,-52.43,-13186.9
buyer_6,Manuel,,1979-02-14,ES88209530454618970832,TRX_N-00390-16435120,2022-12-27T10:01:28,Durango,expenses,appliances,-414.29,-13601.19
buyer_6,Manuel,,1979-02-14,ES88209530454618970832,TRX_N-00391-40401563,2022-12-29T13:38:32,Vitoria-Gasteiz,expenses,food,-60.06,-13661.25
buyer_6,Manuel,,1979-02-14,ES88209530454618970832,TRX_N-00392-77946885,2022-12-29T13:41:03,Vitoria-Gasteiz,expenses,cash,-100.0,-13761.25
buyer_6,Manuel,,1979-02-14,ES88209530454618970832,TRX_N-00393-98650720,2022-12-31T19:55:20,Vitoria-Gasteiz,expenses,education,-75.39,-13836.64
buyer_6,Manuel,,1979-02-14,ES88209530454618970832,TRX_N-00394-89171314,2022-12-31T09:14:39,Vitoria-Gasteiz,expenses,repairs,-171.52,-14008.16
buyer_6,Manuel,,1979-02-14,ES88209530454618970832,TRX_N-00395-76771781,2023-01-01T10:57:40,Vitoria-Gasteiz,incomes,salary,2934.25,-11073.91
buyer_6,Manuel,,1979-02-14,ES88209530454618970832,TRX_N-00396-96529926,2023-01-01T10:57:40,Vitoria-Gasteiz,incomes,extra_income,329.55,-10744.36
buyer_6,Manuel,,1979-02-14,ES88209530454618970832,TRX_N-00397-64902439,2023-01-04T16:38:58,Vitoria-Gasteiz,expenses,mortgage,-1089.47,-11833.83
buyer_6,Manuel,,1979-02-14,ES88209530454618970832,TRX_N-00398-71463807,2023-01-04T03:09:13,Vitoria-Gasteiz,expenses,cash,-100.0,-11933.83
buyer_6,Manuel,,1979-02-14,ES88209530454618970832,TRX_N-00399-41894878,2023-01-05T12:37:57,Vitoria-Gasteiz,expenses,water,-35.95,-11969.78
buyer_6,Manuel,,1979-02-14,ES88209530454618970832,TRX_N-00400-71925620,2023-01-05T17:30:05,Vitoria-Gasteiz,expenses,gas,-97.97,-12067.75
buyer_6,Manuel,,1979-02-14,ES88209530454618970832,TRX_N-00401-66373136,2023-01-05T06:37:49,Vitoria-Gasteiz,expenses,healthcare,-156.89,-12224.64
buyer_6,Manuel,,1979-02-14,ES88209530454618970832,TRX_N-00402-05204604,2023-01-06T11:59:29,Vitoria-Gasteiz,expenses,internet,-42.0,-12266.64
buyer_6,Manuel,,1979-02-14,ES88209530454618970832,TRX_N-00403-09711663,2023-01-06T22:14:33,Vitoria-Gasteiz,expenses,phone,-30.45,-12297.09
buyer_6,Manuel,,1979-02-14,ES88209530454618970832,TRX_N-00404-27851217,2023-01-08T20:38:45,Vitoria-Gasteiz,expenses,electricity,-21.93,-12319.02
buyer_6,Manuel,,1979-02-14,ES88209530454618970832,TRX_N-00405-27921561,2023-01-10T08:59:20,Vitoria-Gasteiz,expenses,education,-74.24,-12393.26
buyer_6,Manuel,,1979-02-14,ES88209530454618970832,TRX_N-00406-70703137,2023-01-11T17:19:49,Vitoria-Gasteiz,expenses,cash,-100.0,-12493.26
buyer_6,Manuel,,1979-02-14,ES88209530454618970832,TRX_N-00407-06744935,2023-01-13T13:06:55,Vitoria-Gasteiz,expenses,education,-78.08,-12571.34
buyer_6,Manuel,,1979-02-14,ES88209530454618970832,TRX_N-00408-21501345,2023-01-14T22:45:50,Bilbao,expenses,food,-123.39,-12694.73
buyer_6,Manuel,,1979-02-14,ES88209530454618970832,TRX_N-00409-71839179,2023-01-14T19:37:00,Vitoria-Gasteiz,expenses,leisure,-79.11,-12773.84
buyer_6,Manuel,,1979-02-14,ES88209530454618970832,TRX_N-00410-12906980,2023-01-15T23:08:46,Vitoria-Gasteiz,expenses,food,-124.93,-12898.77
buyer_6,Manuel,,1979-02-14,ES88209530454618970832,TRX_N-00411-91520476,2023-01-16T09:02:16,Alegr√≠a-Dulantzi,expenses,leisure,-62.41,-12961.18
buyer_6,Manuel,,1979-02-14,ES88209530454618970832,TRX_N-00412-05767463,2023-01-18T20:41:45,Vitoria-Gasteiz,expenses,cash,-100.0,-13061.18
buyer_6,Manuel,,1979-02-14,ES88209530454618970832,TRX_N-00413-47881961,2023-01-19T14:46:49,Vitoria-Gasteiz,expenses,food,-65.09,-13126.27
buyer_6,Manuel,,1979-02-14,ES88209530454618970832,TRX_N-00414-01219364,2023-01-19T08:17:36,Amurrio,expenses,cash,-100.0,-13226.27
buyer_6,Manuel,,1979-02-14,ES88209530454618970832,TRX_N-00415-86413743,2023-01-21T08:38:26,Bermeo,expenses,leisure,-81.2,-13307.47
buyer_6,Manuel,,1979-02-14,ES88209530454618970832,TRX_N-00416-15272676,2023-01-23T11:48:09,Vitoria-Gasteiz,expenses,food,-65.63,-13373.1
buyer_6,Manuel,,1979-02-14,ES88209530454618970832,TRX_N-00417-05169190,2023-01-24T13:29:42,Erandio,expenses,transport,-43.2,-13416.3
buyer_6,Manuel,,1979-02-14,ES88209530454618970832,TRX_N-00418-57916656,2023-01-25T14:06:05,Zarautz,expenses,education,-50.68,-13466.98
buyer_6,Manuel,,1979-02-14,ES88209530454618970832,TRX_N-00419-21599632,2023-01-25T19:38:47,Vitoria-Gasteiz,expenses,appliances,-191.93,-13658.91
buyer_6,Manuel,,1979-02-14,ES88209530454618970832,TRX_N-00420-65508137,2023-01-29T13:38:05,Vitoria-Gasteiz,expenses,transport,-64.86,-13723.77
buyer_6,Manuel,,1979-02-14,ES88209530454618970832,TRX_N-00421-95950561,2023-01-29T12:42:37,Vitoria-Gasteiz,expenses,leisure,-21.12,-13744.89
buyer_6,Manuel,,1979-02-14,ES88209530454618970832,TRX_N-00422-67109127,2023-01-30T17:28:19,Berango,expenses,transport,-60.73,-13805.62
buyer_6,Manuel,,1979-02-14,ES88209530454618970832,TRX_N-00423-37430549,2023-01-30T19:13:28,Donostia,expenses,repairs,-256.23,-14061.85
buyer_6,Manuel,,1979-02-14,ES88209530454618970832,TRX_N-00424-22163068,2023-01-31T18:49:15,Vitoria-Gasteiz,expenses,clothing,-153.81,-14215.66
buyer_6,Manuel,,1979-02-14,ES88209530454618970832,TRX_N-00425-43460700,2023-01-31T19:55:08,Vitoria-Gasteiz,expenses,travel,-920.83,-15136.49
buyer_6,Manuel,,1979-02-14,ES88209530454618970832,TRX_N-00426-00354553,2023-02-01T08:54:12,Vitoria-Gasteiz,incomes,salary,2934.25,-12202.24
buyer_6,Manuel,,1979-02-14,ES88209530454618970832,TRX_N-00427-06785034,2023-02-02T18:05:43,Vitoria-Gasteiz,expenses,food,-100.71,-12302.95
buyer_6,Manuel,,1979-02-14,ES88209530454618970832,TRX_N-00428-64593373,2023-02-02T18:32:54,Vitoria-Gasteiz,expenses,cash,-100.0,-12402.95
buyer_6,Manuel,,1979-02-14,ES88209530454618970832,TRX_N-00429-58943856,2023-02-02T18:22:39,Vitoria-Gasteiz,expenses,gifts,-776.67,-13179.62
buyer_6,Manuel,,1979-02-14,ES88209530454618970832,TRX_N-00430-61139694,2023-02-03T19:21:13,Vitoria-Gasteiz,expenses,food,-115.5,-13295.12
buyer_6,Manuel,,1979-02-14,ES88209530454618970832,TRX_N-00431-41972771,2023-02-04T22:56:11,Vitoria-Gasteiz,expenses,mortgage,-1089.47,-14384.59
buyer_6,Manuel,,1979-02-14,ES88209530454618970832,TRX_N-00432-28045592,2023-02-04T16:09:17,Vitoria-Gasteiz,expenses,leisure,-37.81,-14422.4
buyer_6,Manuel,,1979-02-14,ES88209530454618970832,TRX_N-00433-58253346,2023-02-04T10:12:47,Vitoria-Gasteiz,expenses,education,-51.93,-14474.33
buyer_6,Manuel,,1979-02-14,ES88209530454618970832,TRX_N-00434-62066710,2023-02-04T10:31:22,Vitoria-Gasteiz,expenses,cash,-100.0,-14574.33
buyer_6,Manuel,,1979-02-14,ES88209530454618970832,TRX_N-00435-66881402,2023-02-04T14:32:15,Vitoria-Gasteiz,expenses,repairs,-134.56,-14708.89
buyer_6,Manuel,,1979-02-14,ES88209530454618970832,TRX_N-00436-38835029,2023-02-05T19:12:57,Vitoria-Gasteiz,expenses,internet,-42.0,-14750.89
buyer_6,Manuel,,1979-02-14,ES88209530454618970832,TRX_N-00437-14008742,2023-02-05T17:49:50,Vitoria-Gasteiz,expenses,cash,-100.0,-14850.89
buyer_6,Manuel,,1979-02-14,ES88209530454618970832,TRX_N-00438-69390251,2023-02-06T20:48:36,Vitoria-Gasteiz,expenses,water,-41.49,-14892.38
buyer_6,Manuel,,1979-02-14,ES88209530454618970832,TRX_N-00439-42341201,2023-02-06T16:01:20,Vitoria-Gasteiz,expenses,phone,-37.65,-14930.03
buyer_6,Manuel,,1979-02-14,ES88209530454618970832,TRX_N-00440-97330336,2023-02-07T09:13:22,Vitoria-Gasteiz,expenses,electricity,-69.65,-14999.68
buyer_6,Manuel,,1979-02-14,ES88209530454618970832,TRX_N-00441-36946213,2023-02-07T19:28:26,Vitoria-Gasteiz,expenses,gas,-44.17,-15043.85
buyer_6,Manuel,,1979-02-14,ES88209530454618970832,TRX_N-00442-80085614,2023-02-07T17:41:18,Vitoria-Gasteiz,expenses,transport,-48.74,-15092.59
buyer_6,Manuel,,1979-02-14,ES88209530454618970832,TRX_N-00443-60350489,2023-02-09T22:47:11,Vitoria-Gasteiz,expenses,cash,-100.0,-15192.59
buyer_6,Manuel,,1979-02-14,ES88209530454618970832,TRX_N-00444-61057421,2023-02-12T09:28:26,Vitoria-Gasteiz,expenses,transport,-70.96,-15263.55
buyer_6,Manuel,,1979-02-14,ES88209530454618970832,TRX_N-00445-02078056,2023-02-12T21:41:01,Vitoria-Gasteiz,expenses,leisure,-75.27,-15338.82
buyer_6,Manuel,,1979-02-14,ES88209530454618970832,TRX_N-00446-63489592,2023-02-12T13:19:39,Vitoria-Gasteiz,expenses,cash,-100.0,-15438.82
buyer_6,Manuel,,1979-02-14,ES88209530454618970832,TRX_N-00447-21768184,2023-02-13T19:05:17,Vitoria-Gasteiz,expenses,cash,-100.0,-15538.82
buyer_6,Manuel,,1979-02-14,ES88209530454618970832,TRX_N-00448-67695392,2023-02-13T12:16:48,Vitoria-Gasteiz,expenses,gifts,-560.41,-16099.23
buyer_6,Manuel,,1979-02-14,ES88209530454618970832,TRX_N-00449-33821281,2023-02-15T16:02:34,Vitoria-Gasteiz,expenses,healthcare,-162.32,-16261.55
buyer_6,Manuel,,1979-02-14,ES88209530454618970832,TRX_N-00450-99315944,2023-02-15T13:43:16,Vitoria-Gasteiz,expenses,education,-59.81,-16321.36
buyer_6,Manuel,,1979-02-14,ES88209530454618970832,TRX_N-00451-92262808,2023-02-16T12:09:24,Vitoria-Gasteiz,expenses,education,-60.33,-16381.69
buyer_6,Manuel,,1979-02-14,ES88209530454618970832,TRX_N-00452-63457089,2023-02-17T15:31:19,Vitoria-Gasteiz,expenses,leisure,-57.06,-16438.75
buyer_6,Manuel,,1979-02-14,ES88209530454618970832,TRX_N-00453-07154987,2023-02-19T18:31:24,Vitoria-Gasteiz,expenses,cash,-100.0,-16538.75
buyer_6,Manuel,,1979-02-14,ES88209530454618970832,TRX_N-00454-39911867,2023-02-20T08:46:42,Vitoria-Gasteiz,expenses,leisure,-60.05,-16598.8
buyer_6,Manuel,,1979-02-14,ES88209530454618970832,TRX_N-00455-72429693,2023-02-25T17:39:02,Vitoria-Gasteiz,expenses,food,-110.85,-16709.65
buyer_6,Manuel,,1979-02-14,ES88209530454618970832,TRX_N-00456-83943948,2023-02-25T11:41:27,Bilbao,expenses,cash,-100.0,-16809.65
buyer_6,Manuel,,1979-02-14,ES88209530454618970832,TRX_N-00457-56741506,2023-02-26T09:03:57,Leioa,expenses,food,-70.61,-16880.26
buyer_6,Manuel,,1979-02-14,ES88209530454618970832,TRX_N-00458-24502443,2023-02-27T12:26:25,Vitoria-Gasteiz,expenses,food,-60.2,-16940.46
buyer_6,Manuel,,1979-02-14,ES88209530454618970832,TRX_N-00459-78577138,2023-03-01T20:36:04,Vitoria-Gasteiz,incomes,salary,2934.25,-14006.21
buyer_6,Manuel,,1979-02-14,ES88209530454618970832,TRX_N-00460-54291332,2023-03-01T11:57:42,Vitoria-Gasteiz,expenses,food,-116.81,-14123.02
buyer_6,Manuel,,1979-02-14,ES88209530454618970832,TRX_N-00461-23575963,2023-03-02T13:59:34,Portugalete,expenses,food,-75.02,-14198.04
buyer_6,Manuel,,1979-02-14,ES88209530454618970832,TRX_N-00462-40513858,2023-03-02T08:45:47,Vitoria-Gasteiz,expenses,leisure,-21.95,-14219.99
buyer_6,Manuel,,1979-02-14,ES88209530454618970832,TRX_N-00463-56728572,2023-03-04T09:20:23,Vitoria-Gasteiz,expenses,mortgage,-1089.47,-15309.46
buyer_6,Manuel,,1979-02-14,ES88209530454618970832,TRX_N-00464-70263088,2023-03-04T16:48:58,Vitoria-Gasteiz,expenses,transport,-45.71,-15355.17
buyer_6,Manuel,,1979-02-14,ES88209530454618970832,TRX_N-00465-23004762,2023-03-05T09:19:59,Basauri,expenses,clothing,-118.56,-15473.73
buyer_6,Manuel,,1979-02-14,ES88209530454618970832,TRX_N-00466-74482213,2023-03-05T09:25:58,Vitoria-Gasteiz,expenses,appliances,-211.69,-15685.42
buyer_6,Manuel,,1979-02-14,ES88209530454618970832,TRX_N-00467-34305128,2023-03-06T19:54:16,Vitoria-Gasteiz,expenses,phone,-43.79,-15729.21
buyer_6,Manuel,,1979-02-14,ES88209530454618970832,TRX_N-00468-37085522,2023-03-06T14:10:44,Vitoria-Gasteiz,expenses,education,-67.26,-15796.47
buyer_6,Manuel,,1979-02-14,ES88209530454618970832,TRX_N-00469-02345379,2023-03-07T17:11:28,Vitoria-Gasteiz,expenses,water,-30.3,-15826.77
buyer_6,Manuel,,1979-02-14,ES88209530454618970832,TRX_N-00470-50469023,2023-03-07T11:00:36,Vitoria-Gasteiz,expenses,cash,-100.0,-15926.77
buyer_6,Manuel,,1979-02-14,ES88209530454618970832,TRX_N-00471-29843878,2023-03-07T17:19:39,Vitoria-Gasteiz,expenses,repairs,-58.4,-15985.17
buyer_6,Manuel,,1979-02-14,ES88209530454618970832,TRX_N-00472-66587438,2023-03-08T12:44:49,Vitoria-Gasteiz,expenses,electricity,-68.07,-16053.24
buyer_6,Manuel,,1979-02-14,ES88209530454618970832,TRX_N-00473-17198509,2023-03-08T19:16:56,Vitoria-Gasteiz,expenses,gas,-109.83,-16163.07
buyer_6,Manuel,,1979-02-14,ES88209530454618970832,TRX_N-00474-95785566,2023-03-08T22:58:16,Vitoria-Gasteiz,expenses,internet,-42.0,-16205.07
buyer_6,Manuel,,1979-02-14,ES88209530454618970832,TRX_N-00475-26990667,2023-03-08T11:31:19,Vitoria-Gasteiz,expenses,cash,-100.0,-16305.07
buyer_6,Manuel,,1979-02-14,ES88209530454618970832,TRX_N-00476-11730702,2023-03-10T16:15:11,Vitoria-Gasteiz,expenses,cash,-100.0,-16405.07
buyer_6,Manuel,,1979-02-14,ES88209530454618970832,TRX_N-00477-14466766,2023-03-12T16:35:55,Vitoria-Gasteiz,expenses,cash,-100.0,-16505.07
buyer_6,Manuel,,1979-02-14,ES88209530454618970832,TRX_N-00478-53595804,2023-03-14T09:23:53,Vitoria-Gasteiz,expenses,cash,-100.0,-16605.07
buyer_6,Manuel,,1979-02-14,ES88209530454618970832,TRX_N-00479-67984290,2023-03-18T16:39:01,Vitoria-Gasteiz,expenses,food,-114.94,-16720.01
buyer_6,Manuel,,1979-02-14,ES88209530454618970832,TRX_N-00480-46918328,2023-03-21T16:28:46,Vitoria-Gasteiz,expenses,food,-105.66,-16825.67
buyer_6,Manuel,,1979-02-14,ES88209530454618970832,TRX_N-00481-14521932,2023-03-22T23:07:01,Vitoria-Gasteiz,expenses,gifts,-254.31,-17079.98
buyer_6,Manuel,,1979-02-14,ES88209530454618970832,TRX_N-00482-52657117,2023-03-23T09:47:08,Vitoria-Gasteiz,expenses,transport,-68.65,-17148.63
buyer_6,Manuel,,1979-02-14,ES88209530454618970832,TRX_N-00483-45404139,2023-03-25T10:12:52,Vitoria-Gasteiz,expenses,cash,-100.0,-17248.63
buyer_6,Manuel,,1979-02-14,ES88209530454618970832,TRX_N-00484-03449828,2023-03-27T19:02:11,Vitoria-Gasteiz,expenses,education,-59.8,-17308.43
buyer_6,Manuel,,1979-02-14,ES88209530454618970832,TRX_N-00485-43660237,2023-03-29T19:48:52,Vitoria-Gasteiz,expenses,food,-104.01,-17412.44
buyer_6,Manuel,,1979-02-14,ES88209530454618970832,TRX_N-00486-76330162,2023-03-29T15:50:17,Vitoria-Gasteiz,expenses,clothing,-79.36,-17491.8
buyer_6,Manuel,,1979-02-14,ES88209530454618970832,TRX_N-00487-14034332,2023-03-30T16:16:12,Vitoria-Gasteiz,expenses,cash,-100.0,-17591.8
buyer_6,Manuel,,1979-02-14,ES88209530454618970832,TRX_N-00488-20464502,2023-03-31T00:13:43,Donostia,expenses,cash,-100.0,-17691.8
buyer_6,Manuel,,1979-02-14,ES88209530454618970832,TRX_N-00489-17559360,2023-03-31T03:36:57,Vitoria-Gasteiz,expenses,appliances,-398.18,-18089.98
buyer_6,Manuel,,1979-02-14,ES88209530454618970832,TRX_N-00490-44080061,2023-04-01T01:28:10,Vitoria-Gasteiz,incomes,salary,2934.25,-15155.73
buyer_6,Manuel,,1979-02-14,ES88209530454618970832,TRX_N-00491-78705055,2023-04-01T01:28:10,Vitoria-Gasteiz,incomes,extra_income,329.55,-14826.18
buyer_6,Manuel,,1979-02-14,ES88209530454618970832,TRX_N-00492-01343702,2023-04-01T13:08:39,Vitoria-Gasteiz,expenses,cash,-100.0,-14926.18
buyer_6,Manuel,,1979-02-14,ES88209530454618970832,TRX_N-00493-12763193,2023-04-02T13:46:55,Vitoria-Gasteiz,expenses,transport,-78.59,-15004.77
buyer_6,Manuel,,1979-02-14,ES88209530454618970832,TRX_N-00494-37030609,2023-04-02T20:54:51,Vitoria-Gasteiz,expenses,education,-74.26,-15079.03
buyer_6,Manuel,,1979-02-14,ES88209530454618970832,TRX_N-00495-47593323,2023-04-02T08:34:52,Vitoria-Gasteiz,expenses,cash,-100.0,-15179.03
buyer_6,Manuel,,1979-02-14,ES88209530454618970832,TRX_N-00496-34264337,2023-04-03T15:52:59,Vitoria-Gasteiz,expenses,transport,-75.21,-15254.24
buyer_6,Manuel,,1979-02-14,ES88209530454618970832,TRX_N-00497-19488432,2023-04-03T09:45:56,Galdakao,expenses,gifts,-36.51,-15290.75
buyer_6,Manuel,,1979-02-14,ES88209530454618970832,TRX_N-00498-20463781,2023-04-04T16:53:13,Vitoria-Gasteiz,expenses,mortgage,-1089.47,-16380.22
buyer_6,Manuel,,1979-02-14,ES88209530454618970832,TRX_N-00499-22945998,2023-04-04T18:27:58,Vitoria-Gasteiz,expenses,food,-104.74,-16484.96
buyer_6,Manuel,,1979-02-14,ES88209530454618970832,TRX_N-00500-17944807,2023-04-04T16:06:47,Vitoria-Gasteiz,expenses,cash,-100.0,-16584.96
buyer_6,Manuel,,1979-02-14,ES88209530454618970832,TRX_N-00501-89889815,2023-04-05T15:07:55,Vitoria-Gasteiz,expenses,internet,-42.0,-16626.96
buyer_6,Manuel,,1979-02-14,ES88209530454618970832,TRX_N-00502-03156700,2023-04-05T15:41:30,Vitoria-Gasteiz,expenses,phone,-43.76,-16670.72
buyer_6,Manuel,,1979-02-14,ES88209530454618970832,TRX_N-00503-58135660,2023-04-06T00:08:19,Vitoria-Gasteiz,expenses,water,-22.11,-16692.83
buyer_6,Manuel,,1979-02-14,ES88209530454618970832,TRX_N-00504-45015969,2023-04-06T09:06:39,Portugalete,expenses,food,-109.88,-16802.71
buyer_6,Manuel,,1979-02-14,ES88209530454618970832,TRX_N-00505-50814263,2023-04-06T20:49:02,Vitoria-Gasteiz,expenses,leisure,-79.03,-16881.74
buyer_6,Manuel,,1979-02-14,ES88209530454618970832,TRX_N-00506-61944015,2023-04-07T05:15:02,Vitoria-Gasteiz,expenses,electricity,-48.18,-16929.92
buyer_6,Manuel,,1979-02-14,ES88209530454618970832,TRX_N-00507-03718241,2023-04-08T20:41:27,Vitoria-Gasteiz,expenses,gas,-67.23,-16997.15
buyer_6,Manuel,,1979-02-14,ES88209530454618970832,TRX_N-00508-15782854,2023-04-08T11:26:19,Vitoria-Gasteiz,expenses,healthcare,-146.45,-17143.6
buyer_6,Manuel,,1979-02-14,ES88209530454618970832,TRX_N-00509-21133173,2023-04-10T11:57:57,Vitoria-Gasteiz,expenses,healthcare,-187.46,-17331.06
buyer_6,Manuel,,1979-02-14,ES88209530454618970832,TRX_N-00510-24422115,2023-04-10T19:01:37,Vitoria-Gasteiz,expenses,gifts,-683.0,-18014.06
buyer_6,Manuel,,1979-02-14,ES88209530454618970832,TRX_N-00511-59435471,2023-04-11T12:17:38,Vitoria-Gasteiz,expenses,appliances,-94.0,-18108.06
buyer_6,Manuel,,1979-02-14,ES88209530454618970832,TRX_N-00512-03298466,2023-04-12T12:24:30,Vitoria-Gasteiz,expenses,clothing,-56.83,-18164.89
buyer_6,Manuel,,1979-02-14,ES88209530454618970832,TRX_N-00513-40935811,2023-04-12T11:00:35,Vitoria-Gasteiz,expenses,education,-43.79,-18208.68
buyer_6,Manuel,,1979-02-14,ES88209530454618970832,TRX_N-00514-01679820,2023-04-13T09:09:34,Vitoria-Gasteiz,expenses,clothing,-89.67,-18298.35
buyer_6,Manuel,,1979-02-14,ES88209530454618970832,TRX_N-00515-50012141,2023-04-17T15:09:26,Andoain,expenses,cash,-100.0,-18398.35
buyer_6,Manuel,,1979-02-14,ES88209530454618970832,TRX_N-00516-17023012,2023-04-19T20:16:27,Vitoria-Gasteiz,expenses,cash,-100.0,-18498.35
buyer_6,Manuel,,1979-02-14,ES88209530454618970832,TRX_N-00517-66863160,2023-04-19T16:34:02,Amurrio,expenses,travel,-1041.19,-19539.54
buyer_6,Manuel,,1979-02-14,ES88209530454618970832,TRX_N-00518-60353136,2023-04-20T19:50:08,Vitoria-Gasteiz,expenses,clothing,-60.56,-19600.1
buyer_6,Manuel,,1979-02-14,ES88209530454618970832,TRX_N-00519-12253246,2023-04-20T12:57:51,Vitoria-Gasteiz,expenses,cash,-100.0,-19700.1
buyer_6,Manuel,,1979-02-14,ES88209530454618970832,TRX_N-00520-14803542,2023-04-21T22:52:13,Andoain,expenses,repairs,-265.38,-19965.48
buyer_6,Manuel,,1979-02-14,ES88209530454618970832,TRX_N-00521-27409000,2023-04-25T15:50:13,Mungia,expenses,food,-121.41,-20086.89
buyer_6,Manuel,,1979-02-14,ES88209530454618970832,TRX_N-00522-84492823,2023-04-25T10:44:49,Vitoria-Gasteiz,expenses,transport,-54.66,-20141.55
buyer_6,Manuel,,1979-02-14,ES88209530454618970832,TRX_N-00523-86850124,2023-04-26T12:38:08,Vitoria-Gasteiz,expenses,gifts,-647.11,-20788.66
buyer_6,Manuel,,1979-02-14,ES88209530454618970832,TRX_N-00524-22258145,2023-04-28T21:54:06,Vitoria-Gasteiz,expenses,cash,-100.0,-20888.66
buyer_6,Manuel,,1979-02-14,ES88209530454618970832,TRX_N-00525-03946233,2023-05-01T13:30:12,Vitoria-Gasteiz,incomes,salary,2934.25,-17954.41
buyer_6,Manuel,,1979-02-14,ES88209530454618970832,TRX_N-00526-83105558,2023-05-01T17:49:47,Vitoria-Gasteiz,expenses,cash,-100.0,-18054.41
buyer_6,Manuel,,1979-02-14,ES88209530454618970832,TRX_N-00527-94647980,2023-05-02T12:29:15,Vitoria-Gasteiz,expenses,food,-124.6,-18179.01
buyer_6,Manuel,,1979-02-14,ES88209530454618970832,TRX_N-00528-03652991,2023-05-02T12:03:43,Vitoria-Gasteiz,expenses,cash,-100.0,-18279.01
buyer_6,Manuel,,1979-02-14,ES88209530454618970832,TRX_N-00529-28844091,2023-05-02T09:24:26,Vitoria-Gasteiz,expenses,travel,-863.52,-19142.53
buyer_6,Manuel,,1979-02-14,ES88209530454618970832,TRX_N-00530-46396165,2023-05-02T15:47:12,Errenteria,expenses,repairs,-36.0,-19178.53
buyer_6,Manuel,,1979-02-14,ES88209530454618970832,TRX_N-00531-04731524,2023-05-03T10:41:51,Eibar,expenses,repairs,-255.95,-19434.48
buyer_6,Manuel,,1979-02-14,ES88209530454618970832,TRX_N-00532-09020749,2023-05-04T18:54:08,Vitoria-Gasteiz,expenses,mortgage,-1089.47,-20523.95
buyer_6,Manuel,,1979-02-14,ES88209530454618970832,TRX_N-00533-05077459,2023-05-05T18:52:43,Vitoria-Gasteiz,expenses,water,-38.02,-20561.97
buyer_6,Manuel,,1979-02-14,ES88209530454618970832,TRX_N-00534-22973795,2023-05-05T11:12:34,Vitoria-Gasteiz,expenses,gas,-56.54,-20618.51
buyer_6,Manuel,,1979-02-14,ES88209530454618970832,TRX_N-00535-99816972,2023-05-05T08:51:24,Vitoria-Gasteiz,expenses,internet,-42.0,-20660.51
buyer_6,Manuel,,1979-02-14,ES88209530454618970832,TRX_N-00536-38380345,2023-05-05T12:21:38,Vitoria-Gasteiz,expenses,transport,-59.22,-20719.73
buyer_6,Manuel,,1979-02-14,ES88209530454618970832,TRX_N-00537-39280108,2023-05-05T17:39:58,Vitoria-Gasteiz,expenses,leisure,-71.39,-20791.12
buyer_6,Manuel,,1979-02-14,ES88209530454618970832,TRX_N-00538-23846665,2023-05-06T14:57:50,Vitoria-Gasteiz,expenses,transport,-87.6,-20878.72
buyer_6,Manuel,,1979-02-14,ES88209530454618970832,TRX_N-00539-29348655,2023-05-06T18:33:49,Vitoria-Gasteiz,expenses,clothing,-138.0,-21016.72
buyer_6,Manuel,,1979-02-14,ES88209530454618970832,TRX_N-00540-04039331,2023-05-07T19:31:20,Vitoria-Gasteiz,expenses,electricity,-87.82,-21104.54
buyer_6,Manuel,,1979-02-14,ES88209530454618970832,TRX_N-00541-07133670,2023-05-07T08:04:54,Sestao,expenses,cash,-100.0,-21204.54
buyer_6,Manuel,,1979-02-14,ES88209530454618970832,TRX_N-00542-68994349,2023-05-07T20:47:10,Vitoria-Gasteiz,expenses,appliances,-378.95,-21583.49
buyer_6,Manuel,,1979-02-14,ES88209530454618970832,TRX_N-00543-36547180,2023-05-08T14:12:05,Vitoria-Gasteiz,expenses,phone,-30.4,-21613.89
buyer_6,Manuel,,1979-02-14,ES88209530454618970832,TRX_N-00544-86083781,2023-05-08T08:34:29,Vitoria-Gasteiz,expenses,healthcare,-180.86,-21794.75
buyer_6,Manuel,,1979-02-14,ES88209530454618970832,TRX_N-00545-63881737,2023-05-09T07:57:42,Vitoria-Gasteiz,expenses,cash,-100.0,-21894.75
buyer_6,Manuel,,1979-02-14,ES88209530454618970832,TRX_N-00546-49552592,2023-05-10T12:39:09,Vitoria-Gasteiz,expenses,cash,-100.0,-21994.75
buyer_6,Manuel,,1979-02-14,ES88209530454618970832,TRX_N-00547-46474990,2023-05-10T17:03:55,Vitoria-Gasteiz,expenses,gifts,-145.09,-22139.84
buyer_6,Manuel,,1979-02-14,ES88209530454618970832,TRX_N-00548-35311572,2023-05-12T14:34:03,Barakaldo,expenses,cash,-100.0,-22239.84
buyer_6,Manuel,,1979-02-14,ES88209530454618970832,TRX_N-00549-75277978,2023-05-15T13:46:43,Vitoria-Gasteiz,expenses,cash,-100.0,-22339.84
buyer_6,Manuel,,1979-02-14,ES88209530454618970832,TRX_N-00550-73255484,2023-05-15T19:51:24,Vitoria-Gasteiz,expenses,gifts,-246.19,-22586.03
buyer_6,Manuel,,1979-02-14,ES88209530454618970832,TRX_N-00551-82484561,2023-05-16T20:07:48,Vitoria-Gasteiz,expenses,food,-69.26,-22655.29
buyer_6,Manuel,,1979-02-14,ES88209530454618970832,TRX_N-00552-34192863,2023-05-18T07:18:05,Vitoria-Gasteiz,expenses,repairs,-331.16,-22986.45
buyer_6,Manuel,,1979-02-14,ES88209530454618970832,TRX_N-00553-70191191,2023-05-19T13:32:41,Vitoria-Gasteiz,expenses,gifts,-90.95,-23077.4
buyer_6,Manuel,,1979-02-14,ES88209530454618970832,TRX_N-00554-15797664,2023-05-20T10:53:24,Vitoria-Gasteiz,expenses,cash,-100.0,-23177.4
buyer_6,Manuel,,1979-02-14,ES88209530454618970832,TRX_N-00555-22150868,2023-05-21T18:33:56,Vitoria-Gasteiz,expenses,transport,-79.33,-23256.73
buyer_6,Manuel,,1979-02-14,ES88209530454618970832,TRX_N-00556-37104688,2023-05-22T22:44:25,Vitoria-Gasteiz,expenses,leisure,-79.71,-23336.44
buyer_6,Manuel,,1979-02-14,ES88209530454618970832,TRX_N-00557-29912656,2023-05-23T11:49:48,Vitoria-Gasteiz,expenses,education,-67.46,-23403.9
buyer_6,Manuel,,1979-02-14,ES88209530454618970832,TRX_N-00558-92620802,2023-05-24T11:31:14,Vitoria-Gasteiz,expenses,leisure,-50.77,-23454.67
buyer_6,Manuel,,1979-02-14,ES88209530454618970832,TRX_N-00559-72341005,2023-05-24T14:22:54,Vitoria-Gasteiz,expenses,gifts,-726.24,-24180.91
buyer_6,Manuel,,1979-02-14,ES88209530454618970832,TRX_N-00560-42808629,2023-05-26T19:37:08,Vitoria-Gasteiz,expenses,repairs,-145.73,-24326.64
buyer_6,Manuel,,1979-02-14,ES88209530454618970832,TRX_N-00561-57799467,2023-05-27T22:23:19,Vitoria-Gasteiz,expenses,transport,-86.98,-24413.62
buyer_6,Manuel,,1979-02-14,ES88209530454618970832,TRX_N-00562-65176397,2023-05-27T20:00:43,Vitoria-Gasteiz,expenses,repairs,-64.72,-24478.34
buyer_6,Manuel,,1979-02-14,ES88209530454618970832,TRX_N-00563-80600861,2023-05-29T08:01:31,Hernani,expenses,cash,-100.0,-24578.34
buyer_6,Manuel,,1979-02-14,ES88209530454618970832,TRX_N-00564-53477567,2023-05-30T08:56:12,Zuia,expenses,leisure,-60.01,-24638.35
buyer_6,Manuel,,1979-02-14,ES88209530454618970832,TRX_N-00565-05427752,2023-05-30T11:36:32,Vitoria-Gasteiz,expenses,cash,-100.0,-24738.35
buyer_6,Manuel,,1979-02-14,ES88209530454618970832,TRX_N-00566-48907242,2023-05-31T12:06:48,Vitoria-Gasteiz,expenses,transport,-86.65,-24825.0
buyer_6,Manuel,,1979-02-14,ES88209530454618970832,TRX_N-00567-98338000,2023-05-31T21:12:22,Vitoria-Gasteiz,expenses,gifts,-185.09,-25010.09
buyer_6,Manuel,,1979-02-14,ES88209530454618970832,TRX_N-00568-91822223,2023-06-01T08:16:49,Vitoria-Gasteiz,incomes,salary,2934.25,-22075.84
buyer_6,Manuel,,1979-02-14,ES88209530454618970832,TRX_N-00569-57562982,2023-06-01T08:16:49,Vitoria-Gasteiz,incomes,salary_bonus,2088.86,-19986.98
buyer_6,Manuel,,1979-02-14,ES88209530454618970832,TRX_N-00570-20123583,2023-06-01T12:20:01,Vitoria-Gasteiz,expenses,transport,-44.65,-20031.63
buyer_6,Manuel,,1979-02-14,ES88209530454618970832,TRX_N-00571-50252531,2023-06-01T18:30:09,Salvatierra/Agurain,expenses,education,-46.09,-20077.72
buyer_6,Manuel,,1979-02-14,ES88209530454618970832,TRX_N-00572-77008446,2023-06-01T15:44:19,Vitoria-Gasteiz,expenses,repairs,-115.52,-20193.24
buyer_6,Manuel,,1979-02-14,ES88209530454618970832,TRX_N-00573-70589273,2023-06-02T14:53:44,Barakaldo,expenses,cash,-100.0,-20293.24
buyer_6,Manuel,,1979-02-14,ES88209530454618970832,TRX_N-00574-26012290,2023-06-03T03:06:39,Vitoria-Gasteiz,expenses,transport,-50.51,-20343.75
buyer_6,Manuel,,1979-02-14,ES88209530454618970832,TRX_N-00575-99034867,2023-06-04T20:48:21,Vitoria-Gasteiz,expenses,mortgage,-1089.47,-21433.22
buyer_6,Manuel,,1979-02-14,ES88209530454618970832,TRX_N-00576-09647458,2023-06-04T19:34:26,Vitoria-Gasteiz,expenses,clothing,-63.45,-21496.67
buyer_6,Manuel,,1979-02-14,ES88209530454618970832,TRX_N-00577-35769193,2023-06-05T22:29:18,Vitoria-Gasteiz,expenses,electricity,-73.3,-21569.97
buyer_6,Manuel,,1979-02-14,ES88209530454618970832,TRX_N-00578-51223421,2023-06-05T14:09:37,Vitoria-Gasteiz,expenses,gas,-34.78,-21604.75
buyer_6,Manuel,,1979-02-14,ES88209530454618970832,TRX_N-00579-12434686,2023-06-05T02:52:54,Vitoria-Gasteiz,expenses,leisure,-83.01,-21687.76
buyer_6,Manuel,,1979-02-14,ES88209530454618970832,TRX_N-00580-53596176,2023-06-05T22:39:12,Eibar,expenses,cash,-100.0,-21787.76
buyer_6,Manuel,,1979-02-14,ES88209530454618970832,TRX_N-00581-08343825,2023-06-06T16:20:02,Vitoria-Gasteiz,expenses,internet,-42.0,-21829.76
buyer_6,Manuel,,1979-02-14,ES88209530454618970832,TRX_N-00582-55711827,2023-06-07T11:29:11,Vitoria-Gasteiz,expenses,phone,-39.95,-21869.71
buyer_6,Manuel,,1979-02-14,ES88209530454618970832,TRX_N-00583-77581739,2023-06-07T09:46:07,Vitoria-Gasteiz,expenses,appliances,-220.56,-22090.27
buyer_6,Manuel,,1979-02-14,ES88209530454618970832,TRX_N-00584-71753834,2023-06-08T15:22:57,Vitoria-Gasteiz,expenses,water,-33.02,-22123.29
buyer_6,Manuel,,1979-02-14,ES88209530454618970832,TRX_N-00585-89848646,2023-06-08T20:07:42,Vitoria-Gasteiz,expenses,leisure,-46.43,-22169.72
buyer_6,Manuel,,1979-02-14,ES88209530454618970832,TRX_N-00586-66782924,2023-06-13T06:23:40,Vitoria-Gasteiz,expenses,food,-100.09,-22269.81
buyer_6,Manuel,,1979-02-14,ES88209530454618970832,TRX_N-00587-15629175,2023-06-13T03:56:49,Vitoria-Gasteiz,expenses,repairs,-41.5,-22311.31
buyer_6,Manuel,,1979-02-14,ES88209530454618970832,TRX_N-00588-33946471,2023-06-17T19:41:53,Vitoria-Gasteiz,expenses,cash,-100.0,-22411.31
buyer_6,Manuel,,1979-02-14,ES88209530454618970832,TRX_N-00589-54799988,2023-06-18T14:07:37,Vitoria-Gasteiz,expenses,gifts,-669.08,-23080.39
buyer_6,Manuel,,1979-02-14,ES88209530454618970832,TRX_N-00590-91885786,2023-06-19T21:05:13,Vitoria-Gasteiz,expenses,cash,-100.0,-23180.39
buyer_6,Manuel,,1979-02-14,ES88209530454618970832,TRX_N-00591-27442039,2023-06-20T22:14:09,Vitoria-Gasteiz,expenses,cash,-100.0,-23280.39
buyer_6,Manuel,,1979-02-14,ES88209530454618970832,TRX_N-00592-54061140,2023-06-20T13:51:42,Vitoria-Gasteiz,expenses,repairs,-309.57,-23589.96
buyer_6,Manuel,,1979-02-14,ES88209530454618970832,TRX_N-00593-76515578,2023-06-21T18:26:04,Vitoria-Gasteiz,expenses,cash,-100.0,-23689.96
buyer_6,Manuel,,1979-02-14,ES88209530454618970832,TRX_N-00594-18008205,2023-06-22T14:05:13,Vitoria-Gasteiz,expenses,leisure,-43.14,-23733.1
buyer_6,Manuel,,1979-02-14,ES88209530454618970832,TRX_N-00595-47393812,2023-06-23T09:21:27,Vitoria-Gasteiz,expenses,repairs,-278.29,-24011.39
buyer_6,Manuel,,1979-02-14,ES88209530454618970832,TRX_N-00596-91760065,2023-06-25T11:17:34,Vitoria-Gasteiz,expenses,repairs,-292.74,-24304.13
buyer_6,Manuel,,1979-02-14,ES88209530454618970832,TRX_N-00597-09131191,2023-06-26T09:43:15,Basauri,expenses,healthcare,-114.55,-24418.68
buyer_6,Manuel,,1979-02-14,ES88209530454618970832,TRX_N-00598-60008897,2023-06-26T12:43:36,Labastida,expenses,cash,-100.0,-24518.68
buyer_6,Manuel,,1979-02-14,ES88209530454618970832,TRX_N-00599-22929783,2023-06-28T11:46:34,Vitoria-Gasteiz,expenses,cash,-100.0,-24618.68
buyer_6,Manuel,,1979-02-14,ES88209530454618970832,TRX_N-00600-03273933,2023-06-29T10:29:32,Vitoria-Gasteiz,expenses,leisure,-79.47,-24698.15
buyer_6,Manuel,,1979-02-14,ES88209530454618970832,TRX_N-00601-14879875,2023-06-29T16:32:00,Zuia,expenses,travel,-994.84,-25692.99
buyer_6,Manuel,,1979-02-14,ES88209530454618970832,TRX_N-00602-93290449,2023-07-01T12:03:25,Vitoria-Gasteiz,incomes,salary,2934.25,-22758.74
buyer_6,Manuel,,1979-02-14,ES88209530454618970832,TRX_N-00603-01392886,2023-07-01T12:03:25,Vitoria-Gasteiz,incomes,extra_income,329.55,-22429.19
buyer_6,Manuel,,1979-02-14,ES88209530454618970832,TRX_N-00604-94826133,2023-07-01T15:26:09,Vitoria-Gasteiz,expenses,education,-74.38,-22503.57
buyer_6,Manuel,,1979-02-14,ES88209530454618970832,TRX_N-00605-78403300,2023-07-04T19:24:41,Vitoria-Gasteiz,expenses,mortgage,-1089.47,-23593.04
buyer_6,Manuel,,1979-02-14,ES88209530454618970832,TRX_N-00606-95120358,2023-07-04T10:48:58,Vitoria-Gasteiz,expenses,transport,-87.65,-23680.69
buyer_6,Manuel,,1979-02-14,ES88209530454618970832,TRX_N-00607-64525131,2023-07-05T22:29:04,Vitoria-Gasteiz,expenses,gas,-58.6,-23739.29
buyer_6,Manuel,,1979-02-14,ES88209530454618970832,TRX_N-00608-55669735,2023-07-05T15:16:54,Vitoria-Gasteiz,expenses,education,-66.25,-23805.54
buyer_6,Manuel,,1979-02-14,ES88209530454618970832,TRX_N-00609-54315270,2023-07-06T19:39:55,Vitoria-Gasteiz,expenses,cash,-100.0,-23905.54
buyer_6,Manuel,,1979-02-14,ES88209530454618970832,TRX_N-00610-32055747,2023-07-07T13:58:34,Vitoria-Gasteiz,expenses,water,-40.03,-23945.57
buyer_6,Manuel,,1979-02-14,ES88209530454618970832,TRX_N-00611-85664591,2023-07-07T20:02:59,Vitoria-Gasteiz,expenses,internet,-42.0,-23987.57
buyer_6,Manuel,,1979-02-14,ES88209530454618970832,TRX_N-00612-36414489,2023-07-07T15:55:40,Vitoria-Gasteiz,expenses,phone,-38.45,-24026.02
buyer_6,Manuel,,1979-02-14,ES88209530454618970832,TRX_N-00613-74182871,2023-07-08T13:41:03,Vitoria-Gasteiz,expenses,electricity,-50.73,-24076.75
buyer_6,Manuel,,1979-02-14,ES88209530454618970832,TRX_N-00614-91225257,2023-07-08T18:29:03,Vitoria-Gasteiz,expenses,gifts,-597.7,-24674.45
buyer_6,Manuel,,1979-02-14,ES88209530454618970832,TRX_N-00615-65373591,2023-07-09T13:36:44,Vitoria-Gasteiz,expenses,healthcare,-184.48,-24858.93
buyer_6,Manuel,,1979-02-14,ES88209530454618970832,TRX_N-00616-81098647,2023-07-10T11:34:13,Vitoria-Gasteiz,expenses,leisure,-44.96,-24903.89
buyer_6,Manuel,,1979-02-14,ES88209530454618970832,TRX_N-00617-17141925,2023-07-11T18:41:08,Barakaldo,expenses,food,-70.15,-24974.04
buyer_6,Manuel,,1979-02-14,ES88209530454618970832,TRX_N-00618-39125390,2023-07-12T13:48:47,Vitoria-Gasteiz,expenses,transport,-57.13,-25031.17
buyer_6,Manuel,,1979-02-14,ES88209530454618970832,TRX_N-00619-93043582,2023-07-13T18:20:24,Vitoria-Gasteiz,expenses,leisure,-33.19,-25064.36
buyer_6,Manuel,,1979-02-14,ES88209530454618970832,TRX_N-00620-91994303,2023-07-14T10:33:25,Vitoria-Gasteiz,expenses,food,-103.07,-25167.43
buyer_6,Manuel,,1979-02-14,ES88209530454618970832,TRX_N-00621-88424931,2023-07-14T23:04:05,Vitoria-Gasteiz,expenses,repairs,-130.34,-25297.77
buyer_6,Manuel,,1979-02-14,ES88209530454618970832,TRX_N-00622-76209601,2023-07-15T15:04:08,Vitoria-Gasteiz,expenses,leisure,-34.62,-25332.39
buyer_6,Manuel,,1979-02-14,ES88209530454618970832,TRX_N-00623-25497306,2023-07-16T12:59:54,Vitoria-Gasteiz,expenses,transport,-81.53,-25413.92
buyer_6,Manuel,,1979-02-14,ES88209530454618970832,TRX_N-00624-48964339,2023-07-17T09:15:50,Vitoria-Gasteiz,expenses,food,-119.07,-25532.99
buyer_6,Manuel,,1979-02-14,ES88209530454618970832,TRX_N-00625-82205866,2023-07-18T22:20:29,Portugalete,expenses,food,-68.82,-25601.81
buyer_6,Manuel,,1979-02-14,ES88209530454618970832,TRX_N-00626-49651421,2023-07-18T09:56:37,Galdakao,expenses,education,-73.18,-25674.99
buyer_6,Manuel,,1979-02-14,ES88209530454618970832,TRX_N-00627-98176623,2023-07-24T19:26:40,Durango,expenses,food,-65.12,-25740.11
buyer_6,Manuel,,1979-02-14,ES88209530454618970832,TRX_N-00628-18547148,2023-07-24T12:51:16,Lasarte-Oria,expenses,leisure,-29.9,-25770.01
buyer_6,Manuel,,1979-02-14,ES88209530454618970832,TRX_N-00629-54563606,2023-07-25T15:48:07,Vitoria-Gasteiz,expenses,cash,-100.0,-25870.01
buyer_6,Manuel,,1979-02-14,ES88209530454618970832,TRX_N-00630-35180213,2023-08-01T10:00:45,Vitoria-Gasteiz,incomes,salary,2934.25,-22935.76
buyer_6,Manuel,,1979-02-14,ES88209530454618970832,TRX_N-00631-43520140,2023-08-01T02:40:33,Errenteria,expenses,cash,-100.0,-23035.76
buyer_6,Manuel,,1979-02-14,ES88209530454618970832,TRX_N-00632-92523091,2023-08-01T21:03:04,Bermeo,expenses,repairs,-305.68,-23341.44
buyer_6,Manuel,,1979-02-14,ES88209530454618970832,TRX_N-00633-57127036,2023-08-02T01:16:14,Vitoria-Gasteiz,expenses,repairs,-171.59,-23513.03
buyer_6,Manuel,,1979-02-14,ES88209530454618970832,TRX_N-00634-77964116,2023-08-04T11:56:15,Vitoria-Gasteiz,expenses,mortgage,-1089.47,-24602.5
buyer_6,Manuel,,1979-02-14,ES88209530454618970832,TRX_N-00635-95194884,2023-08-04T12:03:54,Errenteria,expenses,clothing,-154.51,-24757.01
buyer_6,Manuel,,1979-02-14,ES88209530454618970832,TRX_N-00636-31532274,2023-08-05T23:50:07,Vitoria-Gasteiz,expenses,internet,-42.0,-24799.01
buyer_6,Manuel,,1979-02-14,ES88209530454618970832,TRX_N-00637-49948746,2023-08-05T14:58:42,Vitoria-Gasteiz,expenses,phone,-40.37,-24839.38
buyer_6,Manuel,,1979-02-14,ES88209530454618970832,TRX_N-00638-23038956,2023-08-05T17:06:05,Vitoria-Gasteiz,expenses,food,-85.96,-24925.34
buyer_6,Manuel,,1979-02-14,ES88209530454618970832,TRX_N-00639-27795260,2023-08-05T13:06:57,Vitoria-Gasteiz,expenses,travel,-668.28,-25593.62
buyer_6,Manuel,,1979-02-14,ES88209530454618970832,TRX_N-00640-04829882,2023-08-05T17:31:58,Vitoria-Gasteiz,expenses,gifts,-171.34,-25764.96
buyer_6,Manuel,,1979-02-14,ES88209530454618970832,TRX_N-00641-17502285,2023-08-06T14:06:59,Vitoria-Gasteiz,expenses,water,-26.53,-25791.49
buyer_6,Manuel,,1979-02-14,ES88209530454618970832,TRX_N-00642-04523521,2023-08-06T19:27:06,Vitoria-Gasteiz,expenses,food,-97.59,-25889.08
buyer_6,Manuel,,1979-02-14,ES88209530454618970832,TRX_N-00643-97835238,2023-08-07T14:13:40,Vitoria-Gasteiz,expenses,leisure,-69.83,-25958.91
buyer_6,Manuel,,1979-02-14,ES88209530454618970832,TRX_N-00644-80729129,2023-08-07T16:09:38,Vitoria-Gasteiz,expenses,gifts,-629.01,-26587.92
buyer_6,Manuel,,1979-02-14,ES88209530454618970832,TRX_N-00645-64906743,2023-08-08T19:09:41,Vitoria-Gasteiz,expenses,electricity,-84.05,-26671.97
buyer_6,Manuel,,1979-02-14,ES88209530454618970832,TRX_N-00646-33328677,2023-08-08T00:47:14,Vitoria-Gasteiz,expenses,gas,-40.84,-26712.81
buyer_6,Manuel,,1979-02-14,ES88209530454618970832,TRX_N-00647-30982403,2023-08-08T11:40:31,Berango,expenses,leisure,-47.91,-26760.72
buyer_6,Manuel,,1979-02-14,ES88209530454618970832,TRX_N-00648-91252140,2023-08-08T16:40:57,Vitoria-Gasteiz,expenses,travel,-804.09,-27564.81
buyer_6,Manuel,,1979-02-14,ES88209530454618970832,TRX_N-00649-82346604,2023-08-08T20:59:54,Vitoria-Gasteiz,expenses,repairs,-160.29,-27725.1
buyer_6,Manuel,,1979-02-14,ES88209530454618970832,TRX_N-00650-08686557,2023-08-09T01:18:14,Vitoria-Gasteiz,expenses,leisure,-71.94,-27797.04
buyer_6,Manuel,,1979-02-14,ES88209530454618970832,TRX_N-00651-06126389,2023-08-09T10:32:22,Vitoria-Gasteiz,expenses,healthcare,-187.1,-27984.14
buyer_6,Manuel,,1979-02-14,ES88209530454618970832,TRX_N-00652-80062231,2023-08-13T02:58:37,Vitoria-Gasteiz,expenses,healthcare,-117.85,-28101.99
buyer_6,Manuel,,1979-02-14,ES88209530454618970832,TRX_N-00653-45504372,2023-08-14T21:03:31,Vitoria-Gasteiz,expenses,food,-68.9,-28170.89
buyer_6,Manuel,,1979-02-14,ES88209530454618970832,TRX_N-00654-42807031,2023-08-14T12:52:49,Vitoria-Gasteiz,expenses,education,-49.7,-28220.59
buyer_6,Manuel,,1979-02-14,ES88209530454618970832,TRX_N-00655-57934450,2023-08-15T11:50:46,Vitoria-Gasteiz,expenses,leisure,-60.14,-28280.73
buyer_6,Manuel,,1979-02-14,ES88209530454618970832,TRX_N-00656-29562726,2023-08-16T23:28:24,Vitoria-Gasteiz,expenses,transport,-59.15,-28339.88
buyer_6,Manuel,,1979-02-14,ES88209530454618970832,TRX_N-00657-02503272,2023-08-16T05:56:53,Vitoria-Gasteiz,expenses,repairs,-312.88,-28652.76
buyer_6,Manuel,,1979-02-14,ES88209530454618970832,TRX_N-00658-40964827,2023-08-17T20:29:51,Vitoria-Gasteiz,expenses,healthcare,-102.02,-28754.78
buyer_6,Manuel,,1979-02-14,ES88209530454618970832,TRX_N-00659-01216674,2023-08-17T14:18:46,Vitoria-Gasteiz,expenses,appliances,-161.0,-28915.78
buyer_6,Manuel,,1979-02-14,ES88209530454618970832,TRX_N-00660-68449561,2023-08-18T13:05:53,Portugalete,expenses,food,-92.77,-29008.55
buyer_6,Manuel,,1979-02-14,ES88209530454618970832,TRX_N-00661-01022974,2023-08-20T11:26:33,Donostia,expenses,food,-101.12,-29109.67
buyer_6,Manuel,,1979-02-14,ES88209530454618970832,TRX_N-00662-75794501,2023-08-20T16:50:22,Vitoria-Gasteiz,expenses,appliances,-231.88,-29341.55
buyer_6,Manuel,,1979-02-14,ES88209530454618970832,TRX_N-00663-44579266,2023-08-21T23:08:02,Vitoria-Gasteiz,expenses,food,-73.49,-29415.04
buyer_6,Manuel,,1979-02-14,ES88209530454618970832,TRX_N-00664-97602581,2023-08-23T22:51:07,Vitoria-Gasteiz,expenses,food,-65.33,-29480.37
buyer_6,Manuel,,1979-02-14,ES88209530454618970832,TRX_N-00665-67187074,2023-08-23T19:58:12,Vitoria-Gasteiz,expenses,leisure,-40.58,-29520.95
buyer_6,Manuel,,1979-02-14,ES88209530454618970832,TRX_N-00666-86424377,2023-08-25T23:31:30,Vitoria-Gasteiz,expenses,cash,-100.0,-29620.95
buyer_6,Manuel,,1979-02-14,ES88209530454618970832,TRX_N-00667-05828162,2023-08-26T10:27:13,Vitoria-Gasteiz,expenses,food,-83.77,-29704.72
buyer_6,Manuel,,1979-02-14,ES88209530454618970832,TRX_N-00668-82887884,2023-08-26T13:05:18,Vitoria-Gasteiz,expenses,clothing,-84.54,-29789.26
buyer_6,Manuel,,1979-02-14,ES88209530454618970832,TRX_N-00669-54365679,2023-08-27T15:16:35,Vitoria-Gasteiz,expenses,leisure,-33.78,-29823.04
buyer_6,Manuel,,1979-02-14,ES88209530454618970832,TRX_N-00670-64125554,2023-08-30T19:28:03,Vitoria-Gasteiz,expenses,cash,-100.0,-29923.04
buyer_6,Manuel,,1979-02-14,ES88209530454618970832,TRX_N-00671-97509238,2023-08-31T11:25:07,Vitoria-Gasteiz,expenses,food,-121.15,-30044.19
buyer_6,Manuel,,1979-02-14,ES88209530454618970832,TRX_N-00672-49955684,2023-08-31T03:20:10,Vitoria-Gasteiz,expenses,cash,-100.0,-30144.19
buyer_6,Manuel,,1979-02-14,ES88209530454618970832,TRX_N-00673-82532349,2023-09-01T12:24:53,Vitoria-Gasteiz,incomes,salary,2934.25,-27209.94
buyer_6,Manuel,,1979-02-14,ES88209530454618970832,TRX_N-00674-72748290,2023-09-01T17:37:29,Vitoria-Gasteiz,expenses,leisure,-22.44,-27232.38
buyer_6,Manuel,,1979-02-14,ES88209530454618970832,TRX_N-00675-11594912,2023-09-02T08:18:46,Barakaldo,expenses,appliances,-278.71,-27511.09
buyer_6,Manuel,,1979-02-14,ES88209530454618970832,TRX_N-00676-70032412,2023-09-04T19:34:34,Vitoria-Gasteiz,expenses,mortgage,-1089.47,-28600.56
buyer_6,Manuel,,1979-02-14,ES88209530454618970832,TRX_N-00677-07027528,2023-09-04T15:13:59,Vitoria-Gasteiz,expenses,transport,-86.32,-28686.88
buyer_6,Manuel,,1979-02-14,ES88209530454618970832,TRX_N-00678-16308201,2023-09-05T20:46:47,Vitoria-Gasteiz,expenses,electricity,-62.32,-28749.2
buyer_6,Manuel,,1979-02-14,ES88209530454618970832,TRX_N-00679-80984650,2023-09-05T15:47:28,Vitoria-Gasteiz,expenses,transport,-47.04,-28796.24
buyer_6,Manuel,,1979-02-14,ES88209530454618970832,TRX_N-00680-13807647,2023-09-05T14:19:23,Vitoria-Gasteiz,expenses,gifts,-185.06,-28981.3
buyer_6,Manuel,,1979-02-14,ES88209530454618970832,TRX_N-00681-04520288,2023-09-06T14:58:47,Vitoria-Gasteiz,expenses,food,-70.2,-29051.5
buyer_6,Manuel,,1979-02-14,ES88209530454618970832,TRX_N-00682-16918190,2023-09-06T08:40:20,Vitoria-Gasteiz,expenses,cash,-100.0,-29151.5
buyer_6,Manuel,,1979-02-14,ES88209530454618970832,TRX_N-00683-30145099,2023-09-07T08:31:13,Vitoria-Gasteiz,expenses,leisure,-46.74,-29198.24
buyer_6,Manuel,,1979-02-14,ES88209530454618970832,TRX_N-00684-66256007,2023-09-08T14:48:24,Vitoria-Gasteiz,expenses,water,-44.17,-29242.41
buyer_6,Manuel,,1979-02-14,ES88209530454618970832,TRX_N-00685-26771493,2023-09-08T18:29:32,Vitoria-Gasteiz,expenses,gas,-32.66,-29275.07
buyer_6,Manuel,,1979-02-14,ES88209530454618970832,TRX_N-00686-12698778,2023-09-08T16:25:21,Vitoria-Gasteiz,expenses,internet,-42.0,-29317.07
buyer_6,Manuel,,1979-02-14,ES88209530454618970832,TRX_N-00687-22978178,2023-09-08T19:49:29,Vitoria-Gasteiz,expenses,phone,-43.72,-29360.79
buyer_6,Manuel,,1979-02-14,ES88209530454618970832,TRX_N-00688-55356657,2023-09-09T18:24:34,Vitoria-Gasteiz,expenses,food,-121.23,-29482.02
buyer_6,Manuel,,1979-02-14,ES88209530454618970832,TRX_N-00689-12317822,2023-09-14T19:56:24,Vitoria-Gasteiz,expenses,food,-111.54,-29593.56
buyer_6,Manuel,,1979-02-14,ES88209530454618970832,TRX_N-00690-78569725,2023-09-14T15:11:45,Vitoria-Gasteiz,expenses,leisure,-51.63,-29645.19
buyer_6,Manuel,,1979-02-14,ES88209530454618970832,TRX_N-00691-46227448,2023-09-15T08:56:54,Vitoria-Gasteiz,expenses,education,-46.26,-29691.45
buyer_6,Manuel,,1979-02-14,ES88209530454618970832,TRX_N-00692-79464478,2023-09-15T11:34:22,Galdakao,expenses,travel,-820.74,-30512.19
buyer_6,Manuel,,1979-02-14,ES88209530454618970832,TRX_N-00693-06477582,2023-09-17T11:45:51,Vitoria-Gasteiz,expenses,cash,-100.0,-30612.19
buyer_6,Manuel,,1979-02-14,ES88209530454618970832,TRX_N-00694-75724110,2023-09-19T21:23:17,Vitoria-Gasteiz,expenses,leisure,-47.75,-30659.94
buyer_6,Manuel,,1979-02-14,ES88209530454618970832,TRX_N-00695-86828539,2023-09-22T04:15:28,Vitoria-Gasteiz,expenses,food,-87.17,-30747.11
buyer_6,Manuel,,1979-02-14,ES88209530454618970832,TRX_N-00696-53278578,2023-09-22T16:51:48,Vitoria-Gasteiz,expenses,cash,-100.0,-30847.11
buyer_6,Manuel,,1979-02-14,ES88209530454618970832,TRX_N-00697-87147033,2023-09-26T14:07:22,Vitoria-Gasteiz,expenses,food,-107.06,-30954.17
buyer_6,Manuel,,1979-02-14,ES88209530454618970832,TRX_N-00698-16841996,2023-09-27T20:22:57,Vitoria-Gasteiz,expenses,leisure,-61.45,-31015.62
buyer_6,Manuel,,1979-02-14,ES88209530454618970832,TRX_N-00699-30420889,2023-09-30T09:26:26,Vitoria-Gasteiz,expenses,food,-87.79,-31103.41
buyer_6,Manuel,,1979-02-14,ES88209530454618970832,TRX_N-00700-85065590,2023-09-30T09:59:13,Vitoria-Gasteiz,expenses,transport,-56.31,-31159.72
buyer_6,Manuel,,1979-02-14,ES88209530454618970832,TRX_N-00701-48984112,2023-10-01T16:39:42,Vitoria-Gasteiz,incomes,salary,2934.25,-28225.47
buyer_6,Manuel,,1979-02-14,ES88209530454618970832,TRX_N-00702-95125445,2023-10-03T12:58:27,Labastida,expenses,transport,-60.75,-28286.22
buyer_6,Manuel,,1979-02-14,ES88209530454618970832,TRX_N-00703-30754233,2023-10-04T14:03:43,Vitoria-Gasteiz,expenses,mortgage,-1089.47,-29375.69
buyer_6,Manuel,,1979-02-14,ES88209530454618970832,TRX_N-00704-01306696,2023-10-04T11:33:08,Vitoria-Gasteiz,expenses,clothing,-64.7,-29440.39
buyer_6,Manuel,,1979-02-14,ES88209530454618970832,TRX_N-00705-90417665,2023-10-05T20:26:36,Vitoria-Gasteiz,expenses,water,-30.27,-29470.66
buyer_6,Manuel,,1979-02-14,ES88209530454618970832,TRX_N-00706-28269220,2023-10-05T08:03:17,Vitoria-Gasteiz,expenses,leisure,-33.34,-29504.0
buyer_6,Manuel,,1979-02-14,ES88209530454618970832,TRX_N-00707-65925718,2023-10-05T10:42:40,Vitoria-Gasteiz,expenses,clothing,-82.7,-29586.7
buyer_6,Manuel,,1979-02-14,ES88209530454618970832,TRX_N-00708-28309070,2023-10-06T16:52:53,Vitoria-Gasteiz,expenses,gas,-93.9,-29680.6
buyer_6,Manuel,,1979-02-14,ES88209530454618970832,TRX_N-00709-65574907,2023-10-07T19:02:01,Vitoria-Gasteiz,expenses,electricity,-76.24,-29756.84
buyer_6,Manuel,,1979-02-14,ES88209530454618970832,TRX_N-00710-28299439,2023-10-07T13:56:30,Vitoria-Gasteiz,expenses,phone,-33.52,-29790.36
buyer_6,Manuel,,1979-02-14,ES88209530454618970832,TRX_N-00711-39663804,2023-10-08T20:52:44,Vitoria-Gasteiz,expenses,internet,-42.0,-29832.36
buyer_6,Manuel,,1979-02-14,ES88209530454618970832,TRX_N-00712-02831324,2023-10-10T14:54:09,Vitoria-Gasteiz,expenses,cash,-100.0,-29932.36
buyer_6,Manuel,,1979-02-14,ES88209530454618970832,TRX_N-00713-40748613,2023-10-12T13:58:29,Vitoria-Gasteiz,expenses,healthcare,-178.18,-30110.54
buyer_6,Manuel,,1979-02-14,ES88209530454618970832,TRX_N-00714-66310062,2023-10-16T16:33:58,Vitoria-Gasteiz,expenses,transport,-41.7,-30152.24
buyer_6,Manuel,,1979-02-14,ES88209530454618970832,TRX_N-00715-13086787,2023-10-16T14:26:10,Vitoria-Gasteiz,expenses,cash,-100.0,-30252.24
buyer_6,Manuel,,1979-02-14,ES88209530454618970832,TRX_N-00716-77016835,2023-10-17T10:20:36,Vitoria-Gasteiz,expenses,leisure,-64.78,-30317.02
buyer_6,Manuel,,1979-02-14,ES88209530454618970832,TRX_N-00717-31326355,2023-10-18T23:13:45,Vitoria-Gasteiz,expenses,transport,-58.05,-30375.07
buyer_6,Manuel,,1979-02-14,ES88209530454618970832,TRX_N-00718-83304322,2023-10-21T09:38:36,Vitoria-Gasteiz,expenses,food,-77.15,-30452.22
buyer_6,Manuel,,1979-02-14,ES88209530454618970832,TRX_N-00719-72288552,2023-10-21T18:04:14,Vitoria-Gasteiz,expenses,transport,-63.9,-30516.12
buyer_6,Manuel,,1979-02-14,ES88209530454618970832,TRX_N-00720-43699480,2023-10-22T17:12:17,Vitoria-Gasteiz,expenses,leisure,-19.9,-30536.02
buyer_6,Manuel,,1979-02-14,ES88209530454618970832,TRX_N-00721-95867304,2023-10-23T17:19:24,Vitoria-Gasteiz,expenses,repairs,-243.36,-30779.38
buyer_6,Manuel,,1979-02-14,ES88209530454618970832,TRX_N-00722-35432060,2023-10-25T20:31:21,Vitoria-Gasteiz,expenses,leisure,-76.08,-30855.46
buyer_6,Manuel,,1979-02-14,ES88209530454618970832,TRX_N-00723-42018189,2023-10-25T13:34:31,Vitoria-Gasteiz,expenses,repairs,-275.7,-31131.16
buyer_6,Manuel,,1979-02-14,ES88209530454618970832,TRX_N-00724-55023877,2023-10-29T12:26:35,Vitoria-Gasteiz,expenses,food,-74.36,-31205.52
buyer_6,Manuel,,1979-02-14,ES88209530454618970832,TRX_N-00725-60254359,2023-10-31T03:29:05,Vitoria-Gasteiz,expenses,transport,-79.77,-31285.29
buyer_6,Manuel,,1979-02-14,ES88209530454618970832,TRX_N-00726-92822108,2023-11-01T17:51:42,Vitoria-Gasteiz,incomes,salary,2934.25,-28351.04
buyer_6,Manuel,,1979-02-14,ES88209530454618970832,TRX_N-00727-84644331,2023-11-01T17:51:42,Vitoria-Gasteiz,incomes,extra_income,329.55,-28021.49
buyer_6,Manuel,,1979-02-14,ES88209530454618970832,TRX_N-00728-63161263,2023-11-02T17:21:57,Vitoria-Gasteiz,expenses,food,-95.21,-28116.7
buyer_6,Manuel,,1979-02-14,ES88209530454618970832,TRX_N-00729-67691465,2023-11-03T20:51:58,Irun,expenses,education,-60.27,-28176.97
buyer_6,Manuel,,1979-02-14,ES88209530454618970832,TRX_N-00730-89433973,2023-11-04T16:56:56,Vitoria-Gasteiz,expenses,mortgage,-1089.47,-29266.44
buyer_6,Manuel,,1979-02-14,ES88209530454618970832,TRX_N-00731-24812278,2023-11-04T10:25:41,Zuia,expenses,education,-61.73,-29328.17
buyer_6,Manuel,,1979-02-14,ES88209530454618970832,TRX_N-00732-33277721,2023-11-04T13:48:49,Hondarribia,expenses,cash,-100.0,-29428.17
buyer_6,Manuel,,1979-02-14,ES88209530454618970832,TRX_N-00733-55994529,2023-11-05T02:26:11,Vitoria-Gasteiz,expenses,water,-22.74,-29450.91
buyer_6,Manuel,,1979-02-14,ES88209530454618970832,TRX_N-00734-42810821,2023-11-06T13:58:53,Vitoria-Gasteiz,expenses,gas,-110.4,-29561.31
buyer_6,Manuel,,1979-02-14,ES88209530454618970832,TRX_N-00735-83256096,2023-11-06T13:55:03,Vitoria-Gasteiz,expenses,food,-113.62,-29674.93
buyer_6,Manuel,,1979-02-14,ES88209530454618970832,TRX_N-00736-39276417,2023-11-08T19:06:56,Vitoria-Gasteiz,expenses,electricity,-57.2,-29732.13
buyer_6,Manuel,,1979-02-14,ES88209530454618970832,TRX_N-00737-90848795,2023-11-08T09:08:57,Vitoria-Gasteiz,expenses,internet,-42.0,-29774.13
buyer_6,Manuel,,1979-02-14,ES88209530454618970832,TRX_N-00738-12086612,2023-11-08T17:14:19,Vitoria-Gasteiz,expenses,phone,-31.88,-29806.01
buyer_6,Manuel,,1979-02-14,ES88209530454618970832,TRX_N-00739-81000658,2023-11-08T10:42:11,Vitoria-Gasteiz,expenses,clothing,-53.54,-29859.55
buyer_6,Manuel,,1979-02-14,ES88209530454618970832,TRX_N-00740-39327280,2023-11-08T14:47:20,Vitoria-Gasteiz,expenses,gifts,-303.88,-30163.43
buyer_6,Manuel,,1979-02-14,ES88209530454618970832,TRX_N-00741-06292884,2023-11-09T13:44:54,Vitoria-Gasteiz,expenses,cash,-100.0,-30263.43
buyer_6,Manuel,,1979-02-14,ES88209530454618970832,TRX_N-00742-18121660,2023-11-09T14:05:09,Vitoria-Gasteiz,expenses,repairs,-99.57,-30363.0
buyer_6,Manuel,,1979-02-14,ES88209530454618970832,TRX_N-00743-86429568,2023-11-09T14:49:43,Sestao,expenses,gifts,-252.29,-30615.29
buyer_6,Manuel,,1979-02-14,ES88209530454618970832,TRX_N-00744-68323005,2023-11-10T16:04:06,Vitoria-Gasteiz,expenses,clothing,-62.86,-30678.15
buyer_6,Manuel,,1979-02-14,ES88209530454618970832,TRX_N-00745-55992093,2023-11-11T15:10:03,Zarautz,expenses,food,-94.74,-30772.89
buyer_6,Manuel,,1979-02-14,ES88209530454618970832,TRX_N-00746-98855727,2023-11-12T06:11:11,Vitoria-Gasteiz,expenses,leisure,-53.27,-30826.16
buyer_6,Manuel,,1979-02-14,ES88209530454618970832,TRX_N-00747-02247106,2023-11-12T16:43:58,Hernani,expenses,clothing,-81.69,-30907.85
buyer_6,Manuel,,1979-02-14,ES88209530454618970832,TRX_N-00748-52576042,2023-11-15T14:34:31,Lasarte-Oria,expenses,food,-109.59,-31017.44
buyer_6,Manuel,,1979-02-14,ES88209530454618970832,TRX_N-00749-39233852,2023-11-16T04:09:49,Vitoria-Gasteiz,expenses,food,-80.27,-31097.71
buyer_6,Manuel,,1979-02-14,ES88209530454618970832,TRX_N-00750-54384328,2023-11-16T17:04:54,Barakaldo,expenses,cash,-100.0,-31197.71
buyer_6,Manuel,,1979-02-14,ES88209530454618970832,TRX_N-00751-71874037,2023-11-17T10:26:20,Vitoria-Gasteiz,expenses,cash,-100.0,-31297.71
buyer_6,Manuel,,1979-02-14,ES88209530454618970832,TRX_N-00752-03957610,2023-11-18T16:24:13,Vitoria-Gasteiz,expenses,transport,-49.46,-31347.17
buyer_6,Manuel,,1979-02-14,ES88209530454618970832,TRX_N-00753-39261619,2023-11-20T20:32:12,Vitoria-Gasteiz,expenses,leisure,-81.19,-31428.36
buyer_6,Manuel,,1979-02-14,ES88209530454618970832,TRX_N-00754-38390812,2023-11-21T11:34:17,Vitoria-Gasteiz,expenses,cash,-100.0,-31528.36
buyer_6,Manuel,,1979-02-14,ES88209530454618970832,TRX_N-00755-55421391,2023-11-22T22:10:48,Vitoria-Gasteiz,expenses,food,-62.85,-31591.21
buyer_6,Manuel,,1979-02-14,ES88209530454618970832,TRX_N-00756-76657006,2023-11-22T19:25:56,Vitoria-Gasteiz,expenses,leisure,-44.23,-31635.44
buyer_6,Manuel,,1979-02-14,ES88209530454618970832,TRX_N-00757-63060353,2023-11-23T04:19:58,Irun,expenses,food,-117.56,-31753.0
buyer_6,Manuel,,1979-02-14,ES88209530454618970832,TRX_N-00758-84115559,2023-11-24T14:01:30,Vitoria-Gasteiz,expenses,travel,-1355.26,-33108.26
buyer_6,Manuel,,1979-02-14,ES88209530454618970832,TRX_N-00759-18568361,2023-11-26T12:11:39,Bilbao,expenses,gifts,-630.87,-33739.13
buyer_6,Manuel,,1979-02-14,ES88209530454618970832,TRX_N-00760-28161706,2023-11-27T08:39:26,Mungia,expenses,repairs,-190.44,-33929.57
buyer_6,Manuel,,1979-02-14,ES88209530454618970832,TRX_N-00761-52753498,2023-11-29T07:25:42,Vitoria-Gasteiz,expenses,food,-104.4,-34033.97
buyer_6,Manuel,,1979-02-14,ES88209530454618970832,TRX_N-00762-30829811,2023-11-29T14:34:06,Vitoria-Gasteiz,expenses,leisure,-26.77,-34060.74
buyer_6,Manuel,,1979-02-14,ES88209530454618970832,TRX_N-00763-04302398,2023-11-30T16:16:04,Vitoria-Gasteiz,expenses,cash,-100.0,-34160.74
buyer_6,Manuel,,1979-02-14,ES88209530454618970832,TRX_N-00764-91668095,2023-12-01T19:10:21,Vitoria-Gasteiz,incomes,salary,2934.25,-31226.49
buyer_6,Manuel,,1979-02-14,ES88209530454618970832,TRX_N-00765-03729186,2023-12-01T19:10:21,Vitoria-Gasteiz,incomes,salary_bonus,2314.17,-28912.32
buyer_6,Manuel,,1979-02-14,ES88209530454618970832,TRX_N-00766-78097961,2023-12-03T13:23:46,Vitoria-Gasteiz,expenses,leisure,-26.77,-28939.09
buyer_6,Manuel,,1979-02-14,ES88209530454618970832,TRX_N-00767-22071088,2023-12-03T08:17:08,Vitoria-Gasteiz,expenses,clothing,-110.44,-29049.53
buyer_6,Manuel,,1979-02-14,ES88209530454618970832,TRX_N-00768-33686686,2023-12-03T11:34:22,Vitoria-Gasteiz,expenses,appliances,-131.62,-29181.15
buyer_6,Manuel,,1979-02-14,ES88209530454618970832,TRX_N-00769-79436878,2023-12-04T00:22:25,Vitoria-Gasteiz,expenses,mortgage,-1089.47,-30270.62
buyer_6,Manuel,,1979-02-14,ES88209530454618970832,TRX_N-00770-15042469,2023-12-04T15:40:52,Vitoria-Gasteiz,expenses,appliances,-118.91,-30389.53
buyer_6,Manuel,,1979-02-14,ES88209530454618970832,TRX_N-00771-10325789,2023-12-05T08:20:19,Vitoria-Gasteiz,expenses,gas,-79.3,-30468.83
buyer_6,Manuel,,1979-02-14,ES88209530454618970832,TRX_N-00772-64755041,2023-12-06T11:21:08,Vitoria-Gasteiz,expenses,electricity,-37.0,-30505.83
buyer_6,Manuel,,1979-02-14,ES88209530454618970832,TRX_N-00773-35652486,2023-12-08T19:36:13,Vitoria-Gasteiz,expenses,phone,-41.07,-30546.9
buyer_6,Manuel,,1979-02-14,ES88209530454618970832,TRX_N-00774-95446624,2023-12-08T13:26:05,Vitoria-Gasteiz,expenses,water,-29.54,-30576.44
buyer_6,Manuel,,1979-02-14,ES88209530454618970832,TRX_N-00775-05986201,2023-12-08T06:49:26,Vitoria-Gasteiz,expenses,internet,-42.0,-30618.44
buyer_6,Manuel,,1979-02-14,ES88209530454618970832,TRX_N-00776-20083953,2023-12-08T18:07:43,Hernani,expenses,food,-105.52,-30723.96
buyer_6,Manuel,,1979-02-14,ES88209530454618970832,TRX_N-00777-04303776,2023-12-09T08:38:37,Vitoria-Gasteiz,expenses,food,-95.84,-30819.8
buyer_6,Manuel,,1979-02-14,ES88209530454618970832,TRX_N-00778-58279850,2023-12-09T12:57:34,Vitoria-Gasteiz,expenses,healthcare,-189.94,-31009.74
buyer_6,Manuel,,1979-02-14,ES88209530454618970832,TRX_N-00779-32228982,2023-12-10T16:17:06,Vitoria-Gasteiz,expenses,leisure,-74.02,-31083.76
buyer_6,Manuel,,1979-02-14,ES88209530454618970832,TRX_N-00780-50379427,2023-12-11T18:27:23,Zuia,expenses,education,-67.53,-31151.29
buyer_6,Manuel,,1979-02-14,ES88209530454618970832,TRX_N-00781-75356525,2023-12-11T19:46:43,Vitoria-Gasteiz,expenses,cash,-100.0,-31251.29
buyer_6,Manuel,,1979-02-14,ES88209530454618970832,TRX_N-00782-41932304,2023-12-13T11:14:00,Vitoria-Gasteiz,expenses,appliances,-176.15,-31427.44
buyer_6,Manuel,,1979-02-14,ES88209530454618970832,TRX_N-00783-95207226,2023-12-13T10:04:20,Vitoria-Gasteiz,expenses,gifts,-552.1,-31979.54
buyer_6,Manuel,,1979-02-14,ES88209530454618970832,TRX_N-00784-88529160,2023-12-14T19:19:24,Vitoria-Gasteiz,expenses,cash,-100.0,-32079.54
buyer_6,Manuel,,1979-02-14,ES88209530454618970832,TRX_N-00785-84694787,2023-12-15T19:17:07,Vitoria-Gasteiz,expenses,leisure,-36.04,-32115.58
buyer_6,Manuel,,1979-02-14,ES88209530454618970832,TRX_N-00786-26246492,2023-12-16T09:37:04,Vitoria-Gasteiz,expenses,food,-79.59,-32195.17
buyer_6,Manuel,,1979-02-14,ES88209530454618970832,TRX_N-00787-42942697,2023-12-16T15:38:53,Vitoria-Gasteiz,expenses,cash,-100.0,-32295.17
buyer_6,Manuel,,1979-02-14,ES88209530454618970832,TRX_N-00788-92517211,2023-12-17T13:02:41,Vitoria-Gasteiz,expenses,repairs,-273.49,-32568.66
buyer_6,Manuel,,1979-02-14,ES88209530454618970832,TRX_N-00789-79597367,2023-12-18T13:08:21,Vitoria-Gasteiz,expenses,cash,-100.0,-32668.66
buyer_6,Manuel,,1979-02-14,ES88209530454618970832,TRX_N-00790-56562473,2023-12-19T14:56:58,Vitoria-Gasteiz,expenses,food,-69.38,-32738.04
buyer_6,Manuel,,1979-02-14,ES88209530454618970832,TRX_N-00791-76779718,2023-12-19T10:56:35,Getxo,expenses,transport,-58.6,-32796.64
buyer_6,Manuel,,1979-02-14,ES88209530454618970832,TRX_N-00792-68952602,2023-12-19T12:44:01,Vitoria-Gasteiz,expenses,education,-70.77,-32867.41
buyer_6,Manuel,,1979-02-14,ES88209530454618970832,TRX_N-00793-16716315,2023-12-19T18:17:15,Vitoria-Gasteiz,expenses,cash,-100.0,-32967.41
buyer_6,Manuel,,1979-02-14,ES88209530454618970832,TRX_N-00794-55623638,2023-12-20T00:36:10,Vitoria-Gasteiz,expenses,gifts,-613.05,-33580.46
buyer_6,Manuel,,1979-02-14,ES88209530454618970832,TRX_N-00795-92900086,2023-12-21T11:48:17,Vitoria-Gasteiz,expenses,transport,-47.35,-33627.81
buyer_6,Manuel,,1979-02-14,ES88209530454618970832,TRX_N-00796-54870801,2023-12-22T22:16:57,Vitoria-Gasteiz,expenses,food,-80.19,-33708.0
buyer_6,Manuel,,1979-02-14,ES88209530454618970832,TRX_N-00797-48684828,2023-12-24T13:21:06,Vitoria-Gasteiz,expenses,cash,-100.0,-33808.0
buyer_6,Manuel,,1979-02-14,ES88209530454618970832,TRX_N-00798-39971447,2023-12-25T11:38:50,Vitoria-Gasteiz,expenses,healthcare,-183.84,-33991.84
buyer_6,Manuel,,1979-02-14,ES88209530454618970832,TRX_N-00799-97339241,2023-12-25T18:31:36,Vitoria-Gasteiz,expenses,repairs,-124.53,-34116.37
buyer_6,Manuel,,1979-02-14,ES88209530454618970832,TRX_N-00800-48229461,2023-12-27T13:26:31,Vitoria-Gasteiz,expenses,food,-61.65,-34178.02
buyer_6,Manuel,,1979-02-14,ES88209530454618970832,TRX_N-00801-25068087,2023-12-31T19:39:56,Vitoria-Gasteiz,expenses,leisure,-57.06,-34235.08
buyer_6,Manuel,,1979-02-14,ES88209530454618970832,TRX_N-00802-67192663,2024-01-01T10:51:21,Vitoria-Gasteiz,incomes,salary,3014.96,-31220.12
buyer_6,Manuel,,1979-02-14,ES88209530454618970832,TRX_N-00803-73112353,2024-01-01T20:34:21,Vitoria-Gasteiz,expenses,cash,-100.0,-31320.12
buyer_6,Manuel,,1979-02-14,ES88209530454618970832,TRX_N-00804-28439267,2024-01-01T10:21:19,Sestao,expenses,repairs,-58.25,-31378.37
buyer_6,Manuel,,1979-02-14,ES88209530454618970832,TRX_N-00805-07306040,2024-01-04T11:03:26,Vitoria-Gasteiz,expenses,mortgage,-1089.47,-32467.84
buyer_6,Manuel,,1979-02-14,ES88209530454618970832,TRX_N-00806-78563959,2024-01-04T04:02:17,Vitoria-Gasteiz,expenses,clothing,-66.83,-32534.67
buyer_6,Manuel,,1979-02-14,ES88209530454618970832,TRX_N-00807-60790500,2024-01-06T09:02:20,Vitoria-Gasteiz,expenses,water,-35.08,-32569.75
buyer_6,Manuel,,1979-02-14,ES88209530454618970832,TRX_N-00808-12515084,2024-01-06T13:46:09,Vitoria-Gasteiz,expenses,phone,-44.09,-32613.84
buyer_6,Manuel,,1979-02-14,ES88209530454618970832,TRX_N-00809-85126272,2024-01-08T10:41:25,Vitoria-Gasteiz,expenses,electricity,-85.3,-32699.14
buyer_6,Manuel,,1979-02-14,ES88209530454618970832,TRX_N-00810-68928879,2024-01-08T18:16:03,Vitoria-Gasteiz,expenses,gas,-101.58,-32800.72
buyer_6,Manuel,,1979-02-14,ES88209530454618970832,TRX_N-00811-13588022,2024-01-08T20:51:02,Vitoria-Gasteiz,expenses,internet,-42.0,-32842.72
buyer_6,Manuel,,1979-02-14,ES88209530454618970832,TRX_N-00812-82923995,2024-01-10T09:37:16,Vitoria-Gasteiz,expenses,repairs,-54.72,-32897.44
buyer_6,Manuel,,1979-02-14,ES88209530454618970832,TRX_N-00813-44138132,2024-01-10T12:56:09,Vitoria-Gasteiz,expenses,gifts,-127.82,-33025.26
buyer_6,Manuel,,1979-02-14,ES88209530454618970832,TRX_N-00814-12641276,2024-01-11T09:19:50,Vitoria-Gasteiz,expenses,healthcare,-180.05,-33205.31
buyer_6,Manuel,,1979-02-14,ES88209530454618970832,TRX_N-00815-14251214,2024-01-13T22:15:17,Vitoria-Gasteiz,expenses,repairs,-308.16,-33513.47
buyer_6,Manuel,,1979-02-14,ES88209530454618970832,TRX_N-00816-23240750,2024-01-13T15:05:39,Vitoria-Gasteiz,expenses,gifts,-811.46,-34324.93
buyer_6,Manuel,,1979-02-14,ES88209530454618970832,TRX_N-00817-89547362,2024-01-14T18:56:55,Vitoria-Gasteiz,expenses,food,-103.5,-34428.43
buyer_6,Manuel,,1979-02-14,ES88209530454618970832,TRX_N-00818-74880579,2024-01-15T14:03:14,Vitoria-Gasteiz,expenses,cash,-100.0,-34528.43
buyer_6,Manuel,,1979-02-14,ES88209530454618970832,TRX_N-00819-78256278,2024-01-17T09:50:27,Elciego,expenses,food,-63.73,-34592.16
buyer_6,Manuel,,1979-02-14,ES88209530454618970832,TRX_N-00820-75622878,2024-01-19T21:43:54,Vitoria-Gasteiz,expenses,education,-51.42,-34643.58
buyer_6,Manuel,,1979-02-14,ES88209530454618970832,TRX_N-00821-81966513,2024-01-20T18:04:17,Vitoria-Gasteiz,expenses,cash,-100.0,-34743.58
buyer_6,Manuel,,1979-02-14,ES88209530454618970832,TRX_N-00822-38626673,2024-01-21T20:12:42,Vitoria-Gasteiz,expenses,food,-106.5,-34850.08
buyer_6,Manuel,,1979-02-14,ES88209530454618970832,TRX_N-00823-75828259,2024-01-22T15:28:36,Vitoria-Gasteiz,expenses,cash,-100.0,-34950.08
buyer_6,Manuel,,1979-02-14,ES88209530454618970832,TRX_N-00824-97231861,2024-01-24T21:33:16,Vitoria-Gasteiz,expenses,food,-67.36,-35017.44
buyer_6,Manuel,,1979-02-14,ES88209530454618970832,TRX_N-00825-00877221,2024-01-25T13:51:22,Bermeo,expenses,cash,-100.0,-35117.44
buyer_6,Manuel,,1979-02-14,ES88209530454618970832,TRX_N-00826-12657553,2024-01-26T10:26:30,Vitoria-Gasteiz,expenses,travel,-462.38,-35579.82
buyer_6,Manuel,,1979-02-14,ES88209530454618970832,TRX_N-00827-41179190,2024-01-27T09:28:30,Vitoria-Gasteiz,expenses,leisure,-36.51,-35616.33
buyer_6,Manuel,,1979-02-14,ES88209530454618970832,TRX_N-00828-81862378,2024-01-28T12:34:52,Vitoria-Gasteiz,expenses,healthcare,-134.09,-35750.42
buyer_6,Manuel,,1979-02-14,ES88209530454618970832,TRX_N-00829-95220771,2024-01-29T11:25:48,Vitoria-Gasteiz,expenses,clothing,-159.66,-35910.08
buyer_6,Manuel,,1979-02-14,ES88209530454618970832,TRX_N-00830-33103175,2024-01-29T18:20:03,Vitoria-Gasteiz,expenses,cash,-100.0,-36010.08
buyer_6,Manuel,,1979-02-14,ES88209530454618970832,TRX_N-00831-43231922,2024-01-30T21:40:18,Vitoria-Gasteiz,expenses,food,-89.57,-36099.65
buyer_6,Manuel,,1979-02-14,ES88209530454618970832,TRX_N-00832-18869491,2024-01-31T10:21:46,Vitoria-Gasteiz,expenses,food,-87.39,-36187.04
buyer_6,Manuel,,1979-02-14,ES88209530454618970832,TRX_N-00833-75334204,2024-01-31T09:24:56,Oy√≥n-Oion,expenses,leisure,-18.54,-36205.58
buyer_6,Manuel,,1979-02-14,ES88209530454618970832,TRX_N-00834-57758760,2024-02-01T17:44:25,Vitoria-Gasteiz,incomes,salary,3014.96,-33190.62
buyer_6,Manuel,,1979-02-14,ES88209530454618970832,TRX_N-00835-32308403,2024-02-01T11:19:27,Vitoria-Gasteiz,expenses,cash,-100.0,-33290.62
buyer_6,Manuel,,1979-02-14,ES88209530454618970832,TRX_N-00836-87369019,2024-02-04T17:49:14,Vitoria-Gasteiz,expenses,mortgage,-1089.47,-34380.09
buyer_6,Manuel,,1979-02-14,ES88209530454618970832,TRX_N-00837-90084673,2024-02-04T17:38:00,Vitoria-Gasteiz,expenses,healthcare,-147.89,-34527.98
buyer_6,Manuel,,1979-02-14,ES88209530454618970832,TRX_N-00838-26109458,2024-02-04T17:17:29,Mungia,expenses,cash,-100.0,-34627.98
buyer_6,Manuel,,1979-02-14,ES88209530454618970832,TRX_N-00839-17119012,2024-02-04T13:28:52,Vitoria-Gasteiz,expenses,gifts,-590.08,-35218.06
buyer_6,Manuel,,1979-02-14,ES88209530454618970832,TRX_N-00840-45264300,2024-02-05T08:35:38,Vitoria-Gasteiz,expenses,phone,-30.83,-35248.89
buyer_6,Manuel,,1979-02-14,ES88209530454618970832,TRX_N-00841-27685624,2024-02-05T09:56:21,Vitoria-Gasteiz,expenses,food,-108.08,-35356.97
buyer_6,Manuel,,1979-02-14,ES88209530454618970832,TRX_N-00842-24217819,2024-02-08T10:40:34,Vitoria-Gasteiz,expenses,electricity,-36.41,-35393.38
buyer_6,Manuel,,1979-02-14,ES88209530454618970832,TRX_N-00843-44936933,2024-02-08T08:52:09,Vitoria-Gasteiz,expenses,internet,-42.0,-35435.38
buyer_6,Manuel,,1979-02-14,ES88209530454618970832,TRX_N-00844-77615718,2024-02-08T11:46:30,Vitoria-Gasteiz,expenses,water,-29.12,-35464.5
buyer_6,Manuel,,1979-02-14,ES88209530454618970832,TRX_N-00845-07192010,2024-02-08T11:26:38,Vitoria-Gasteiz,expenses,gas,-70.89,-35535.39
buyer_6,Manuel,,1979-02-14,ES88209530454618970832,TRX_N-00846-69774566,2024-02-08T17:10:51,Vitoria-Gasteiz,expenses,cash,-100.0,-35635.39
buyer_6,Manuel,,1979-02-14,ES88209530454618970832,TRX_N-00847-44911625,2024-02-09T09:29:19,Vitoria-Gasteiz,expenses,leisure,-44.05,-35679.44
buyer_6,Manuel,,1979-02-14,ES88209530454618970832,TRX_N-00848-95332634,2024-02-11T16:38:41,Berango,expenses,leisure,-77.28,-35756.72
buyer_6,Manuel,,1979-02-14,ES88209530454618970832,TRX_N-00849-37349155,2024-02-12T17:01:02,Vitoria-Gasteiz,expenses,transport,-50.66,-35807.38
buyer_6,Manuel,,1979-02-14,ES88209530454618970832,TRX_N-00850-62213962,2024-02-12T13:30:07,Vitoria-Gasteiz,expenses,education,-67.84,-35875.22
buyer_6,Manuel,,1979-02-14,ES88209530454618970832,TRX_N-00851-98374840,2024-02-14T15:15:30,Vitoria-Gasteiz,expenses,food,-123.68,-35998.9
buyer_6,Manuel,,1979-02-14,ES88209530454618970832,TRX_N-00852-02697677,2024-02-14T12:20:32,Vitoria-Gasteiz,expenses,transport,-41.57,-36040.47
buyer_6,Manuel,,1979-02-14,ES88209530454618970832,TRX_N-00853-30780052,2024-02-14T13:17:13,Vitoria-Gasteiz,expenses,cash,-100.0,-36140.47
buyer_6,Manuel,,1979-02-14,ES88209530454618970832,TRX_N-00854-34405856,2024-02-14T10:55:26,Vitoria-Gasteiz,expenses,travel,-954.41,-37094.88
buyer_6,Manuel,,1979-02-14,ES88209530454618970832,TRX_N-00855-95034338,2024-02-16T10:26:24,Vitoria-Gasteiz,expenses,food,-98.97,-37193.85
buyer_6,Manuel,,1979-02-14,ES88209530454618970832,TRX_N-00856-09861156,2024-02-16T13:14:22,Vitoria-Gasteiz,expenses,leisure,-81.66,-37275.51
buyer_6,Manuel,,1979-02-14,ES88209530454618970832,TRX_N-00857-08692688,2024-02-16T17:39:25,Vitoria-Gasteiz,expenses,repairs,-125.27,-37400.78
buyer_6,Manuel,,1979-02-14,ES88209530454618970832,TRX_N-00858-76346307,2024-02-17T11:32:28,Vitoria-Gasteiz,expenses,repairs,-78.08,-37478.86
buyer_6,Manuel,,1979-02-14,ES88209530454618970832,TRX_N-00859-15662034,2024-02-22T09:13:48,Vitoria-Gasteiz,expenses,clothing,-128.57,-37607.43
buyer_6,Manuel,,1979-02-14,ES88209530454618970832,TRX_N-00860-61040344,2024-02-23T20:17:42,Lasarte-Oria,expenses,repairs,-147.71,-37755.14
buyer_6,Manuel,,1979-02-14,ES88209530454618970832,TRX_N-00861-75936719,2024-02-24T18:42:23,Vitoria-Gasteiz,expenses,food,-82.58,-37837.72
buyer_6,Manuel,,1979-02-14,ES88209530454618970832,TRX_N-00862-54254173,2024-02-24T16:04:52,Vitoria-Gasteiz,expenses,cash,-100.0,-37937.72
buyer_6,Manuel,,1979-02-14,ES88209530454618970832,TRX_N-00863-54710887,2024-02-24T16:43:15,Vitoria-Gasteiz,expenses,appliances,-326.31,-38264.03
buyer_6,Manuel,,1979-02-14,ES88209530454618970832,TRX_N-00864-65499923,2024-02-25T23:56:25,Vitoria-Gasteiz,expenses,food,-120.3,-38384.33
buyer_6,Manuel,,1979-02-14,ES88209530454618970832,TRX_N-00865-83421620,2024-02-26T11:46:24,Vitoria-Gasteiz,expenses,leisure,-49.43,-38433.76
buyer_6,Manuel,,1979-02-14,ES88209530454618970832,TRX_N-00866-03093230,2024-02-28T08:39:57,Vitoria-Gasteiz,expenses,transport,-77.82,-38511.58
buyer_6,Manuel,,1979-02-14,ES88209530454618970832,TRX_N-00867-30734899,2024-02-28T14:12:40,Leioa,expenses,leisure,-66.42,-38578.0
buyer_6,Manuel,,1979-02-14,ES88209530454618970832,TRX_N-00868-16071442,2024-02-29T15:55:42,Vitoria-Gasteiz,expenses,cash,-100.0,-38678.0
buyer_6,Manuel,,1979-02-14,ES88209530454618970832,TRX_N-00869-68241843,2024-03-01T11:47:35,Vitoria-Gasteiz,incomes,salary,3014.96,-35663.04
buyer_6,Manuel,,1979-02-14,ES88209530454618970832,TRX_N-00870-52543070,2024-03-01T11:47:35,Vitoria-Gasteiz,incomes,extra_income,329.55,-35333.49
buyer_6,Manuel,,1979-02-14,ES88209530454618970832,TRX_N-00871-54078452,2024-03-03T16:26:25,Vitoria-Gasteiz,expenses,transport,-87.42,-35420.91
buyer_6,Manuel,,1979-02-14,ES88209530454618970832,TRX_N-00872-12379697,2024-03-03T11:15:50,Vitoria-Gasteiz,expenses,cash,-100.0,-35520.91
buyer_6,Manuel,,1979-02-14,ES88209530454618970832,TRX_N-00873-25333423,2024-03-04T12:22:44,Vitoria-Gasteiz,expenses,mortgage,-1089.47,-36610.38
buyer_6,Manuel,,1979-02-14,ES88209530454618970832,TRX_N-00874-50276316,2024-03-04T09:29:48,Vitoria-Gasteiz,expenses,cash,-100.0,-36710.38
buyer_6,Manuel,,1979-02-14,ES88209530454618970832,TRX_N-00875-34548516,2024-03-04T15:40:43,Vitoria-Gasteiz,expenses,repairs,-224.91,-36935.29
buyer_6,Manuel,,1979-02-14,ES88209530454618970832,TRX_N-00876-33181853,2024-03-05T01:43:10,Vitoria-Gasteiz,expenses,water,-37.06,-36972.35
buyer_6,Manuel,,1979-02-14,ES88209530454618970832,TRX_N-00877-99173182,2024-03-05T03:16:24,Vitoria-Gasteiz,expenses,food,-65.05,-37037.4
buyer_6,Manuel,,1979-02-14,ES88209530454618970832,TRX_N-00878-04148966,2024-03-06T17:54:07,Vitoria-Gasteiz,expenses,electricity,-74.12,-37111.52
buyer_6,Manuel,,1979-02-14,ES88209530454618970832,TRX_N-00879-25199572,2024-03-07T16:11:12,Vitoria-Gasteiz,expenses,internet,-42.0,-37153.52
buyer_6,Manuel,,1979-02-14,ES88209530454618970832,TRX_N-00880-02060030,2024-03-07T14:16:26,Vitoria-Gasteiz,expenses,leisure,-51.53,-37205.05
buyer_6,Manuel,,1979-02-14,ES88209530454618970832,TRX_N-00881-80357931,2024-03-08T15:57:00,Vitoria-Gasteiz,expenses,phone,-33.22,-37238.27
buyer_6,Manuel,,1979-02-14,ES88209530454618970832,TRX_N-00882-49653203,2024-03-08T08:08:44,Vitoria-Gasteiz,expenses,gas,-97.86,-37336.13
buyer_6,Manuel,,1979-02-14,ES88209530454618970832,TRX_N-00883-39250880,2024-03-08T19:53:51,Vitoria-Gasteiz,expenses,transport,-72.35,-37408.48
buyer_6,Manuel,,1979-02-14,ES88209530454618970832,TRX_N-00884-76550989,2024-03-08T22:11:39,Elciego,expenses,cash,-100.0,-37508.48
buyer_6,Manuel,,1979-02-14,ES88209530454618970832,TRX_N-00885-69340607,2024-03-11T17:11:13,Vitoria-Gasteiz,expenses,transport,-49.85,-37558.33
buyer_6,Manuel,,1979-02-14,ES88209530454618970832,TRX_N-00886-53529267,2024-03-15T00:09:32,Hernani,expenses,transport,-62.44,-37620.77
buyer_6,Manuel,,1979-02-14,ES88209530454618970832,TRX_N-00887-70233266,2024-03-16T18:34:31,Zarautz,expenses,repairs,-98.99,-37719.76
buyer_6,Manuel,,1979-02-14,ES88209530454618970832,TRX_N-00888-45247997,2024-03-21T12:08:34,Vitoria-Gasteiz,expenses,leisure,-37.2,-37756.96
buyer_6,Manuel,,1979-02-14,ES88209530454618970832,TRX_N-00889-80294972,2024-03-21T15:07:12,Vitoria-Gasteiz,expenses,cash,-100.0,-37856.96
buyer_6,Manuel,,1979-02-14,ES88209530454618970832,TRX_N-00890-87568852,2024-03-21T15:56:19,Vitoria-Gasteiz,expenses,appliances,-315.65,-38172.61
buyer_6,Manuel,,1979-02-14,ES88209530454618970832,TRX_N-00891-26146732,2024-03-22T17:22:53,Vitoria-Gasteiz,expenses,cash,-100.0,-38272.61
buyer_6,Manuel,,1979-02-14,ES88209530454618970832,TRX_N-00892-06704867,2024-03-23T10:01:35,Vitoria-Gasteiz,expenses,food,-64.91,-38337.52
buyer_6,Manuel,,1979-02-14,ES88209530454618970832,TRX_N-00893-50814195,2024-03-23T08:57:01,Sopela,expenses,leisure,-30.26,-38367.78
buyer_6,Manuel,,1979-02-14,ES88209530454618970832,TRX_N-00894-68630477,2024-03-23T20:58:17,Pasaia,expenses,cash,-100.0,-38467.78
buyer_6,Manuel,,1979-02-14,ES88209530454618970832,TRX_N-00895-43028750,2024-03-23T15:49:59,Vitoria-Gasteiz,expenses,repairs,-125.9,-38593.68
buyer_6,Manuel,,1979-02-14,ES88209530454618970832,TRX_N-00896-29555527,2024-03-26T10:24:52,Vitoria-Gasteiz,expenses,food,-73.03,-38666.71
buyer_6,Manuel,,1979-02-14,ES88209530454618970832,TRX_N-00897-03362874,2024-03-26T09:26:52,Iru√±a de Oca,expenses,leisure,-18.58,-38685.29
buyer_6,Manuel,,1979-02-14,ES88209530454618970832,TRX_N-00898-00878943,2024-03-27T08:46:28,Iru√±a de Oca,expenses,education,-75.45,-38760.74
buyer_6,Manuel,,1979-02-14,ES88209530454618970832,TRX_N-00899-72312654,2024-03-28T09:04:01,Hernani,expenses,leisure,-19.2,-38779.94
buyer_6,Manuel,,1979-02-14,ES88209530454618970832,TRX_N-00900-95714514,2024-04-01T06:39:55,Vitoria-Gasteiz,incomes,salary,3014.96,-35764.98
buyer_6,Manuel,,1979-02-14,ES88209530454618970832,TRX_N-00901-67166187,2024-04-02T22:03:59,Vitoria-Gasteiz,expenses,repairs,-251.45,-36016.43
buyer_6,Manuel,,1979-02-14,ES88209530454618970832,TRX_N-00902-86587312,2024-04-04T18:25:28,Vitoria-Gasteiz,expenses,mortgage,-1089.47,-37105.9
buyer_6,Manuel,,1979-02-14,ES88209530454618970832,TRX_N-00903-84160207,2024-04-04T20:27:38,Vitoria-Gasteiz,expenses,cash,-100.0,-37205.9
buyer_6,Manuel,,1979-02-14,ES88209530454618970832,TRX_N-00904-96095737,2024-04-05T18:13:25,Vitoria-Gasteiz,expenses,internet,-42.0,-37247.9
buyer_6,Manuel,,1979-02-14,ES88209530454618970832,TRX_N-00905-03981816,2024-04-06T10:13:36,Alegr√≠a-Dulantzi,expenses,repairs,-241.34,-37489.24
buyer_6,Manuel,,1979-02-14,ES88209530454618970832,TRX_N-00906-45339661,2024-04-07T13:30:40,Vitoria-Gasteiz,expenses,electricity,-63.5,-37552.74
buyer_6,Manuel,,1979-02-14,ES88209530454618970832,TRX_N-00907-37147802,2024-04-07T12:24:27,Vitoria-Gasteiz,expenses,transport,-82.59,-37635.33
buyer_6,Manuel,,1979-02-14,ES88209530454618970832,TRX_N-00908-07630577,2024-04-08T14:47:12,Vitoria-Gasteiz,expenses,phone,-34.58,-37669.91
buyer_6,Manuel,,1979-02-14,ES88209530454618970832,TRX_N-00909-30770934,2024-04-08T02:06:18,Vitoria-Gasteiz,expenses,water,-44.23,-37714.14
buyer_6,Manuel,,1979-02-14,ES88209530454618970832,TRX_N-00910-11769230,2024-04-08T12:50:55,Vitoria-Gasteiz,expenses,gas,-59.15,-37773.29
buyer_6,Manuel,,1979-02-14,ES88209530454618970832,TRX_N-00911-76280451,2024-04-12T23:09:16,Vitoria-Gasteiz,expenses,leisure,-63.6,-37836.89
buyer_6,Manuel,,1979-02-14,ES88209530454618970832,TRX_N-00912-13958939,2024-04-13T10:21:26,Vitoria-Gasteiz,expenses,gifts,-412.25,-38249.14
buyer_6,Manuel,,1979-02-14,ES88209530454618970832,TRX_N-00913-36280637,2024-04-15T01:12:39,Salvatierra/Agurain,expenses,transport,-61.44,-38310.58
buyer_6,Manuel,,1979-02-14,ES88209530454618970832,TRX_N-00914-67250449,2024-04-16T06:36:03,Vitoria-Gasteiz,expenses,food,-104.11,-38414.69
buyer_6,Manuel,,1979-02-14,ES88209530454618970832,TRX_N-00915-98591885,2024-04-18T21:53:03,Vitoria-Gasteiz,expenses,cash,-100.0,-38514.69
buyer_6,Manuel,,1979-02-14,ES88209530454618970832,TRX_N-00916-16592335,2024-04-19T09:50:15,Vitoria-Gasteiz,expenses,repairs,-200.62,-38715.31
buyer_6,Manuel,,1979-02-14,ES88209530454618970832,TRX_N-00917-46769749,2024-04-21T09:05:28,Vitoria-Gasteiz,expenses,repairs,-317.42,-39032.73
buyer_6,Manuel,,1979-02-14,ES88209530454618970832,TRX_N-00918-43093366,2024-04-23T15:16:06,Vitoria-Gasteiz,expenses,leisure,-64.65,-39097.38
buyer_6,Manuel,,1979-02-14,ES88209530454618970832,TRX_N-00919-50831713,2024-04-24T12:51:37,Vitoria-Gasteiz,expenses,cash,-100.0,-39197.38
buyer_6,Manuel,,1979-02-14,ES88209530454618970832,TRX_N-00920-39863344,2024-04-25T08:31:45,Leioa,expenses,transport,-66.64,-39264.02
buyer_6,Manuel,,1979-02-14,ES88209530454618970832,TRX_N-00921-99577813,2024-04-25T18:19:34,Vitoria-Gasteiz,expenses,cash,-100.0,-39364.02
buyer_6,Manuel,,1979-02-14,ES88209530454618970832,TRX_N-00922-21001896,2024-04-26T19:01:52,Vitoria-Gasteiz,expenses,gifts,-666.88,-40030.9
buyer_6,Manuel,,1979-02-14,ES88209530454618970832,TRX_N-00923-28220779,2024-04-29T03:30:12,Vitoria-Gasteiz,expenses,food,-91.59,-40122.49
buyer_6,Manuel,,1979-02-14,ES88209530454618970832,TRX_N-00924-17048129,2024-04-29T20:02:38,Vitoria-Gasteiz,expenses,transport,-63.3,-40185.79
buyer_6,Manuel,,1979-02-14,ES88209530454618970832,TRX_N-00925-93160777,2024-04-30T20:36:36,Vitoria-Gasteiz,expenses,education,-76.3,-40262.09
buyer_6,Manuel,,1979-02-14,ES88209530454618970832,TRX_N-00926-88953432,2024-05-01T09:12:09,Vitoria-Gasteiz,incomes,salary,3014.96,-37247.13
buyer_6,Manuel,,1979-02-14,ES88209530454618970832,TRX_N-00927-37991786,2024-05-01T10:02:44,Irun,expenses,food,-116.86,-37363.99
buyer_6,Manuel,,1979-02-14,ES88209530454618970832,TRX_N-00928-04330907,2024-05-02T15:02:37,Vitoria-Gasteiz,expenses,leisure,-20.33,-37384.32
buyer_6,Manuel,,1979-02-14,ES88209530454618970832,TRX_N-00929-46975512,2024-05-04T22:05:40,Vitoria-Gasteiz,expenses,mortgage,-1089.47,-38473.79
buyer_6,Manuel,,1979-02-14,ES88209530454618970832,TRX_N-00930-40557873,2024-05-04T13:40:46,Vitoria-Gasteiz,expenses,transport,-63.34,-38537.13
buyer_6,Manuel,,1979-02-14,ES88209530454618970832,TRX_N-00931-54807763,2024-05-04T14:07:06,Vitoria-Gasteiz,expenses,education,-67.5,-38604.63
buyer_6,Manuel,,1979-02-14,ES88209530454618970832,TRX_N-00932-42669558,2024-05-05T19:09:34,Vitoria-Gasteiz,expenses,internet,-42.0,-38646.63
buyer_6,Manuel,,1979-02-14,ES88209530454618970832,TRX_N-00933-26395955,2024-05-05T17:06:24,Vitoria-Gasteiz,expenses,appliances,-137.45,-38784.08
buyer_6,Manuel,,1979-02-14,ES88209530454618970832,TRX_N-00934-70722448,2024-05-06T14:25:24,Vitoria-Gasteiz,expenses,transport,-55.67,-38839.75
buyer_6,Manuel,,1979-02-14,ES88209530454618970832,TRX_N-00935-57426253,2024-05-06T11:57:47,Vitoria-Gasteiz,expenses,healthcare,-186.83,-39026.58
buyer_6,Manuel,,1979-02-14,ES88209530454618970832,TRX_N-00936-41308208,2024-05-07T09:25:12,Vitoria-Gasteiz,expenses,phone,-35.64,-39062.22
buyer_6,Manuel,,1979-02-14,ES88209530454618970832,TRX_N-00937-22816600,2024-05-07T20:06:00,Vitoria-Gasteiz,expenses,education,-65.95,-39128.17
buyer_6,Manuel,,1979-02-14,ES88209530454618970832,TRX_N-00938-93937297,2024-05-08T08:36:58,Vitoria-Gasteiz,expenses,electricity,-65.55,-39193.72
buyer_6,Manuel,,1979-02-14,ES88209530454618970832,TRX_N-00939-01289859,2024-05-08T14:57:36,Vitoria-Gasteiz,expenses,water,-35.69,-39229.41
buyer_6,Manuel,,1979-02-14,ES88209530454618970832,TRX_N-00940-04189068,2024-05-08T14:31:39,Vitoria-Gasteiz,expenses,gas,-65.8,-39295.21
buyer_6,Manuel,,1979-02-14,ES88209530454618970832,TRX_N-00941-86888333,2024-05-09T23:20:17,Oy√≥n-Oion,expenses,education,-60.49,-39355.7
buyer_6,Manuel,,1979-02-14,ES88209530454618970832,TRX_N-00942-50508540,2024-05-10T09:49:35,Vitoria-Gasteiz,expenses,gifts,-657.08,-40012.78
buyer_6,Manuel,,1979-02-14,ES88209530454618970832,TRX_N-00943-67098967,2024-05-11T15:35:09,Arrasate,expenses,food,-81.68,-40094.46
buyer_6,Manuel,,1979-02-14,ES88209530454618970832,TRX_N-00944-73283149,2024-05-13T08:31:33,Vitoria-Gasteiz,expenses,cash,-100.0,-40194.46
buyer_6,Manuel,,1979-02-14,ES88209530454618970832,TRX_N-00945-81285599,2024-05-14T04:13:54,Vitoria-Gasteiz,expenses,food,-83.49,-40277.95
buyer_6,Manuel,,1979-02-14,ES88209530454618970832,TRX_N-00946-98751071,2024-05-14T14:56:51,Vitoria-Gasteiz,expenses,leisure,-67.47,-40345.42
buyer_6,Manuel,,1979-02-14,ES88209530454618970832,TRX_N-00947-00466533,2024-05-15T11:23:35,Vitoria-Gasteiz,expenses,cash,-100.0,-40445.42
buyer_6,Manuel,,1979-02-14,ES88209530454618970832,TRX_N-00948-64967594,2024-05-16T01:50:18,Vitoria-Gasteiz,expenses,education,-58.07,-40503.49
buyer_6,Manuel,,1979-02-14,ES88209530454618970832,TRX_N-00949-51129015,2024-05-17T13:43:03,Vitoria-Gasteiz,expenses,cash,-100.0,-40603.49
buyer_6,Manuel,,1979-02-14,ES88209530454618970832,TRX_N-00950-59600617,2024-05-19T14:54:32,Vitoria-Gasteiz,expenses,repairs,-50.0,-40653.49
buyer_6,Manuel,,1979-02-14,ES88209530454618970832,TRX_N-00951-67403896,2024-05-20T10:01:39,Vitoria-Gasteiz,expenses,leisure,-41.42,-40694.91
buyer_6,Manuel,,1979-02-14,ES88209530454618970832,TRX_N-00952-90072467,2024-05-20T14:58:24,Vitoria-Gasteiz,expenses,gifts,-452.13,-41147.04
buyer_6,Manuel,,1979-02-14,ES88209530454618970832,TRX_N-00953-51299956,2024-05-22T13:46:05,Vitoria-Gasteiz,expenses,leisure,-41.22,-41188.26
buyer_6,Manuel,,1979-02-14,ES88209530454618970832,TRX_N-00954-85482925,2024-05-22T10:35:44,Vitoria-Gasteiz,expenses,clothing,-87.84,-41276.1
buyer_6,Manuel,,1979-02-14,ES88209530454618970832,TRX_N-00955-13916430,2024-05-23T07:35:20,Vitoria-Gasteiz,expenses,appliances,-251.57,-41527.67
buyer_6,Manuel,,1979-02-14,ES88209530454618970832,TRX_N-00956-00604313,2024-05-24T19:53:19,Vitoria-Gasteiz,expenses,leisure,-60.26,-41587.93
buyer_6,Manuel,,1979-02-14,ES88209530454618970832,TRX_N-00957-44303019,2024-05-24T15:00:31,Vitoria-Gasteiz,expenses,clothing,-117.59,-41705.52
buyer_6,Manuel,,1979-02-14,ES88209530454618970832,TRX_N-00958-48670990,2024-05-26T14:24:23,Portugalete,expenses,transport,-76.1,-41781.62
buyer_6,Manuel,,1979-02-14,ES88209530454618970832,TRX_N-00959-71107529,2024-05-27T12:09:56,Vitoria-Gasteiz,expenses,leisure,-61.83,-41843.45
buyer_6,Manuel,,1979-02-14,ES88209530454618970832,TRX_N-00960-77260221,2024-05-29T20:50:12,Vitoria-Gasteiz,expenses,repairs,-288.39,-42131.84
buyer_6,Manuel,,1979-02-14,ES88209530454618970832,TRX_N-00961-22266325,2024-05-30T14:19:35,Vitoria-Gasteiz,expenses,appliances,-395.44,-42527.28
buyer_6,Manuel,,1979-02-14,ES88209530454618970832,TRX_N-00962-63802318,2024-05-31T19:52:25,Vitoria-Gasteiz,expenses,food,-92.19,-42619.47
buyer_6,Manuel,,1979-02-14,ES88209530454618970832,TRX_N-00963-79504500,2024-05-31T02:57:05,Vitoria-Gasteiz,expenses,leisure,-77.2,-42696.67
buyer_6,Manuel,,1979-02-14,ES88209530454618970832,TRX_N-00964-48615510,2024-06-01T18:11:17,Vitoria-Gasteiz,incomes,salary,3014.96,-39681.71
buyer_6,Manuel,,1979-02-14,ES88209530454618970832,TRX_N-00965-15146278,2024-06-01T18:11:17,Vitoria-Gasteiz,incomes,salary_bonus,2190.7,-37491.01
buyer_6,Manuel,,1979-02-14,ES88209530454618970832,TRX_N-00966-56000419,2024-06-01T11:34:47,Hernani,expenses,food,-108.41,-37599.42
buyer_6,Manuel,,1979-02-14,ES88209530454618970832,TRX_N-00967-22444298,2024-06-04T17:41:15,Vitoria-Gasteiz,expenses,mortgage,-1089.47,-38688.89
buyer_6,Manuel,,1979-02-14,ES88209530454618970832,TRX_N-00968-03565389,2024-06-05T20:41:27,Vitoria-Gasteiz,expenses,leisure,-50.19,-38739.08
buyer_6,Manuel,,1979-02-14,ES88209530454618970832,TRX_N-00969-52937416,2024-06-05T10:51:22,Vitoria-Gasteiz,expenses,appliances,-209.32,-38948.4
buyer_6,Manuel,,1979-02-14,ES88209530454618970832,TRX_N-00970-26419045,2024-06-06T10:03:50,Vitoria-Gasteiz,expenses,phone,-35.28,-38983.68
buyer_6,Manuel,,1979-02-14,ES88209530454618970832,TRX_N-00971-57000313,2024-06-06T20:46:56,Vitoria-Gasteiz,expenses,transport,-59.31,-39042.99
buyer_6,Manuel,,1979-02-14,ES88209530454618970832,TRX_N-00972-93014576,2024-06-07T18:27:46,Vitoria-Gasteiz,expenses,transport,-40.18,-39083.17
buyer_6,Manuel,,1979-02-14,ES88209530454618970832,TRX_N-00973-48296941,2024-06-07T15:25:19,Berango,expenses,clothing,-144.43,-39227.6
buyer_6,Manuel,,1979-02-14,ES88209530454618970832,TRX_N-00974-78813189,2024-06-08T12:08:32,Vitoria-Gasteiz,expenses,electricity,-59.22,-39286.82
buyer_6,Manuel,,1979-02-14,ES88209530454618970832,TRX_N-00975-67990865,2024-06-08T19:11:22,Vitoria-Gasteiz,expenses,internet,-42.0,-39328.82
buyer_6,Manuel,,1979-02-14,ES88209530454618970832,TRX_N-00976-93154641,2024-06-08T20:38:07,Vitoria-Gasteiz,expenses,water,-42.06,-39370.88
buyer_6,Manuel,,1979-02-14,ES88209530454618970832,TRX_N-00977-67736336,2024-06-08T12:45:31,Vitoria-Gasteiz,expenses,gas,-92.82,-39463.7
buyer_6,Manuel,,1979-02-14,ES88209530454618970832,TRX_N-00978-95132099,2024-06-08T16:53:33,Vitoria-Gasteiz,expenses,food,-114.24,-39577.94
buyer_6,Manuel,,1979-02-14,ES88209530454618970832,TRX_N-00979-85951284,2024-06-09T18:16:25,Llodio,expenses,travel,-1391.71,-40969.65
buyer_6,Manuel,,1979-02-14,ES88209530454618970832,TRX_N-00980-09393361,2024-06-14T03:09:15,Santurtzi,expenses,repairs,-324.19,-41293.84
buyer_6,Manuel,,1979-02-14,ES88209530454618970832,TRX_N-00981-25090413,2024-06-15T09:54:04,Vitoria-Gasteiz,expenses,food,-66.29,-41360.13
buyer_6,Manuel,,1979-02-14,ES88209530454618970832,TRX_N-00982-97206860,2024-06-15T16:49:53,Vitoria-Gasteiz,expenses,transport,-51.82,-41411.95
buyer_6,Manuel,,1979-02-14,ES88209530454618970832,TRX_N-00983-61724840,2024-06-15T18:28:20,Vitoria-Gasteiz,expenses,leisure,-75.59,-41487.54
buyer_6,Manuel,,1979-02-14,ES88209530454618970832,TRX_N-00984-07705328,2024-06-15T13:51:57,Vitoria-Gasteiz,expenses,repairs,-62.0,-41549.54
buyer_6,Manuel,,1979-02-14,ES88209530454618970832,TRX_N-00985-98418872,2024-06-18T13:28:14,Vitoria-Gasteiz,expenses,leisure,-64.17,-41613.71
buyer_6,Manuel,,1979-02-14,ES88209530454618970832,TRX_N-00986-26795839,2024-06-19T19:03:09,Vitoria-Gasteiz,expenses,leisure,-53.46,-41667.17
buyer_6,Manuel,,1979-02-14,ES88209530454618970832,TRX_N-00987-20672349,2024-06-20T12:29:41,Santurtzi,expenses,cash,-100.0,-41767.17
buyer_6,Manuel,,1979-02-14,ES88209530454618970832,TRX_N-00988-46768355,2024-06-22T11:13:03,Vitoria-Gasteiz,expenses,clothing,-62.01,-41829.18
buyer_6,Manuel,,1979-02-14,ES88209530454618970832,TRX_N-00989-11648549,2024-06-24T18:18:09,Vitoria-Gasteiz,expenses,cash,-100.0,-41929.18
buyer_6,Manuel,,1979-02-14,ES88209530454618970832,TRX_N-00990-45649676,2024-06-25T22:36:17,Berango,expenses,transport,-56.45,-41985.63
buyer_6,Manuel,,1979-02-14,ES88209530454618970832,TRX_N-00991-50790711,2024-06-25T16:18:57,Vitoria-Gasteiz,expenses,clothing,-107.59,-42093.22
buyer_6,Manuel,,1979-02-14,ES88209530454618970832,TRX_N-00992-05838038,2024-06-28T19:26:31,Vitoria-Gasteiz,expenses,food,-121.53,-42214.75
buyer_6,Manuel,,1979-02-14,ES88209530454618970832,TRX_N-00993-43241104,2024-06-28T18:52:20,Vitoria-Gasteiz,expenses,leisure,-37.03,-42251.78
buyer_6,Manuel,,1979-02-14,ES88209530454618970832,TRX_N-00994-97426524,2024-06-30T16:24:07,Vitoria-Gasteiz,expenses,healthcare,-142.57,-42394.35
buyer_6,Manuel,,1979-02-14,ES88209530454618970832,TRX_N-00995-92409009,2024-07-01T20:04:37,Vitoria-Gasteiz,incomes,salary,3014.96,-39379.39
buyer_6,Manuel,,1979-02-14,ES88209530454618970832,TRX_N-00996-73450801,2024-07-01T20:04:37,Vitoria-Gasteiz,incomes,extra_income,329.55,-39049.84
buyer_6,Manuel,,1979-02-14,ES88209530454618970832,TRX_N-00997-01634902,2024-07-04T19:32:27,Vitoria-Gasteiz,expenses,mortgage,-1089.47,-40139.31
buyer_6,Manuel,,1979-02-14,ES88209530454618970832,TRX_N-00998-23807847,2024-07-04T14:04:15,Bermeo,expenses,cash,-100.0,-40239.31
buyer_6,Manuel,,1979-02-14,ES88209530454618970832,TRX_N-00999-69188821,2024-07-05T09:13:11,Vitoria-Gasteiz,expenses,gas,-73.65,-40312.96
buyer_6,Manuel,,1979-02-14,ES88209530454618970832,TRX_N-01000-89014817,2024-07-05T08:44:11,Vitoria-Gasteiz,expenses,phone,-44.11,-40357.07
buyer_6,Manuel,,1979-02-14,ES88209530454618970832,TRX_N-01001-55953425,2024-07-05T10:14:22,Vitoria-Gasteiz,expenses,leisure,-76.48,-40433.55
buyer_6,Manuel,,1979-02-14,ES88209530454618970832,TRX_N-01002-87181416,2024-07-05T16:11:21,Vitoria-Gasteiz,expenses,repairs,-134.2,-40567.75
buyer_6,Manuel,,1979-02-14,ES88209530454618970832,TRX_N-01003-63926632,2024-07-06T10:00:51,Vitoria-Gasteiz,expenses,water,-20.88,-40588.63
buyer_6,Manuel,,1979-02-14,ES88209530454618970832,TRX_N-01004-98177210,2024-07-07T18:43:27,Vitoria-Gasteiz,expenses,internet,-42.0,-40630.63
buyer_6,Manuel,,1979-02-14,ES88209530454618970832,TRX_N-01005-38169748,2024-07-07T16:29:03,Vitoria-Gasteiz,expenses,transport,-44.86,-40675.49
buyer_6,Manuel,,1979-02-14,ES88209530454618970832,TRX_N-01006-25398533,2024-07-07T19:06:46,Vitoria-Gasteiz,expenses,appliances,-330.64,-41006.13
buyer_6,Manuel,,1979-02-14,ES88209530454618970832,TRX_N-01007-80845183,2024-07-08T10:12:18,Vitoria-Gasteiz,expenses,electricity,-74.8,-41080.93
buyer_6,Manuel,,1979-02-14,ES88209530454618970832,TRX_N-01008-81818250,2024-07-09T13:19:50,Vitoria-Gasteiz,expenses,leisure,-69.86,-41150.79
buyer_6,Manuel,,1979-02-14,ES88209530454618970832,TRX_N-01009-21322847,2024-07-09T15:21:22,Vitoria-Gasteiz,expenses,repairs,-177.12,-41327.91
buyer_6,Manuel,,1979-02-14,ES88209530454618970832,TRX_N-01010-43129682,2024-07-15T09:08:38,Vitoria-Gasteiz,expenses,transport,-52.18,-41380.09
buyer_6,Manuel,,1979-02-14,ES88209530454618970832,TRX_N-01011-36674091,2024-07-15T16:45:42,Vitoria-Gasteiz,expenses,cash,-100.0,-41480.09
buyer_6,Manuel,,1979-02-14,ES88209530454618970832,TRX_N-01012-89163620,2024-07-16T13:54:35,Errenteria,expenses,education,-70.93,-41551.02
buyer_6,Manuel,,1979-02-14,ES88209530454618970832,TRX_N-01013-75301235,2024-07-19T14:45:45,Vitoria-Gasteiz,expenses,clothing,-130.09,-41681.11
buyer_6,Manuel,,1979-02-14,ES88209530454618970832,TRX_N-01014-16374508,2024-07-20T10:57:22,Basauri,expenses,clothing,-126.38,-41807.49
buyer_6,Manuel,,1979-02-14,ES88209530454618970832,TRX_N-01015-62048908,2024-07-21T15:55:34,Vitoria-Gasteiz,expenses,food,-62.41,-41869.9
buyer_6,Manuel,,1979-02-14,ES88209530454618970832,TRX_N-01016-94995755,2024-07-21T13:25:43,Vitoria-Gasteiz,expenses,transport,-50.87,-41920.77
buyer_6,Manuel,,1979-02-14,ES88209530454618970832,TRX_N-01017-71443438,2024-07-22T19:05:38,Vitoria-Gasteiz,expenses,transport,-59.71,-41980.48
buyer_6,Manuel,,1979-02-14,ES88209530454618970832,TRX_N-01018-73060602,2024-07-24T11:02:03,Vitoria-Gasteiz,expenses,cash,-100.0,-42080.48
buyer_6,Manuel,,1979-02-14,ES88209530454618970832,TRX_N-01019-24529770,2024-07-25T13:35:24,Vitoria-Gasteiz,expenses,transport,-80.6,-42161.08
buyer_6,Manuel,,1979-02-14,ES88209530454618970832,TRX_N-01020-81175211,2024-07-25T18:39:31,Vitoria-Gasteiz,expenses,cash,-100.0,-42261.08
buyer_6,Manuel,,1979-02-14,ES88209530454618970832,TRX_N-01021-97737434,2024-07-30T09:56:15,Vitoria-Gasteiz,expenses,food,-113.84,-42374.92
buyer_6,Manuel,,1979-02-14,ES88209530454618970832,TRX_N-01022-07150801,2024-07-30T19:28:13,Vitoria-Gasteiz,expenses,cash,-100.0,-42474.92
buyer_6,Manuel,,1979-02-14,ES88209530454618970832,TRX_N-01023-09568635,2024-08-01T11:56:49,Vitoria-Gasteiz,incomes,salary,3014.96,-39459.96
buyer_6,Manuel,,1979-02-14,ES88209530454618970832,TRX_N-01024-40679458,2024-08-03T01:46:31,Labastida,expenses,clothing,-119.54,-39579.5
buyer_6,Manuel,,1979-02-14,ES88209530454618970832,TRX_N-01025-25601292,2024-08-04T20:28:30,Vitoria-Gasteiz,expenses,mortgage,-1089.47,-40668.97
buyer_6,Manuel,,1979-02-14,ES88209530454618970832,TRX_N-01026-42068120,2024-08-04T07:55:50,Vitoria-Gasteiz,expenses,leisure,-34.48,-40703.45
buyer_6,Manuel,,1979-02-14,ES88209530454618970832,TRX_N-01027-73132949,2024-08-05T16:29:57,Vitoria-Gasteiz,expenses,gas,-43.68,-40747.13
buyer_6,Manuel,,1979-02-14,ES88209530454618970832,TRX_N-01028-32604208,2024-08-05T00:12:22,Vitoria-Gasteiz,expenses,travel,-1765.78,-42512.91
buyer_6,Manuel,,1979-02-14,ES88209530454618970832,TRX_N-01029-43651637,2024-08-06T20:26:21,Vitoria-Gasteiz,expenses,internet,-42.0,-42554.91
buyer_6,Manuel,,1979-02-14,ES88209530454618970832,TRX_N-01030-04151978,2024-08-06T16:09:11,Vitoria-Gasteiz,expenses,phone,-37.76,-42592.67
buyer_6,Manuel,,1979-02-14,ES88209530454618970832,TRX_N-01031-83544454,2024-08-07T16:23:21,Vitoria-Gasteiz,expenses,leisure,-38.7,-42631.37
buyer_6,Manuel,,1979-02-14,ES88209530454618970832,TRX_N-01032-98636827,2024-08-08T20:40:17,Vitoria-Gasteiz,expenses,water,-34.16,-42665.53
buyer_6,Manuel,,1979-02-14,ES88209530454618970832,TRX_N-01033-83567885,2024-08-08T01:54:30,Vitoria-Gasteiz,expenses,electricity,-43.85,-42709.38
buyer_6,Manuel,,1979-02-14,ES88209530454618970832,TRX_N-01034-28206494,2024-08-08T08:11:40,Basauri,expenses,leisure,-60.51,-42769.89
buyer_6,Manuel,,1979-02-14,ES88209530454618970832,TRX_N-01035-40739075,2024-08-10T18:24:13,Vitoria-Gasteiz,expenses,food,-77.34,-42847.23
buyer_6,Manuel,,1979-02-14,ES88209530454618970832,TRX_N-01036-86100141,2024-08-10T17:29:09,Vitoria-Gasteiz,expenses,cash,-100.0,-42947.23
buyer_6,Manuel,,1979-02-14,ES88209530454618970832,TRX_N-01037-22542739,2024-08-11T18:59:05,Vitoria-Gasteiz,expenses,food,-121.9,-43069.13
buyer_6,Manuel,,1979-02-14,ES88209530454618970832,TRX_N-01038-13777876,2024-08-12T20:22:37,Vitoria-Gasteiz,expenses,food,-95.92,-43165.05
buyer_6,Manuel,,1979-02-14,ES88209530454618970832,TRX_N-01039-97865852,2024-08-14T20:18:56,Vitoria-Gasteiz,expenses,transport,-52.1,-43217.15
buyer_6,Manuel,,1979-02-14,ES88209530454618970832,TRX_N-01040-34468941,2024-08-14T09:31:23,Vitoria-Gasteiz,expenses,leisure,-83.37,-43300.52
buyer_6,Manuel,,1979-02-14,ES88209530454618970832,TRX_N-01041-53213616,2024-08-16T08:29:56,Vitoria-Gasteiz,expenses,repairs,-112.08,-43412.6
buyer_6,Manuel,,1979-02-14,ES88209530454618970832,TRX_N-01042-01679447,2024-08-20T08:09:21,Vitoria-Gasteiz,expenses,food,-77.85,-43490.45
buyer_6,Manuel,,1979-02-14,ES88209530454618970832,TRX_N-01043-03384592,2024-08-20T16:42:45,Vitoria-Gasteiz,expenses,transport,-81.98,-43572.43
buyer_6,Manuel,,1979-02-14,ES88209530454618970832,TRX_N-01044-25333376,2024-08-20T20:37:26,Vitoria-Gasteiz,expenses,clothing,-103.0,-43675.43
buyer_6,Manuel,,1979-02-14,ES88209530454618970832,TRX_N-01045-69191104,2024-08-20T13:50:37,Donostia,expenses,cash,-100.0,-43775.43
buyer_6,Manuel,,1979-02-14,ES88209530454618970832,TRX_N-01046-49588980,2024-08-22T11:15:37,Vitoria-Gasteiz,expenses,repairs,-219.51,-43994.94
buyer_6,Manuel,,1979-02-14,ES88209530454618970832,TRX_N-01047-47959945,2024-08-22T04:23:01,Vitoria-Gasteiz,expenses,gifts,-792.14,-44787.08
buyer_6,Manuel,,1979-02-14,ES88209530454618970832,TRX_N-01048-74368304,2024-08-23T17:39:14,Vitoria-Gasteiz,expenses,food,-84.03,-44871.11
buyer_6,Manuel,,1979-02-14,ES88209530454618970832,TRX_N-01049-30409673,2024-08-23T08:14:58,Vitoria-Gasteiz,expenses,transport,-67.5,-44938.61
buyer_6,Manuel,,1979-02-14,ES88209530454618970832,TRX_N-01050-69488777,2024-08-23T17:11:22,Vitoria-Gasteiz,expenses,appliances,-200.63,-45139.24
buyer_6,Manuel,,1979-02-14,ES88209530454618970832,TRX_N-01051-61926653,2024-08-24T13:41:17,Vitoria-Gasteiz,expenses,cash,-100.0,-45239.24
buyer_6,Manuel,,1979-02-14,ES88209530454618970832,TRX_N-01052-39207980,2024-08-26T13:55:17,Getxo,expenses,food,-119.19,-45358.43
buyer_6,Manuel,,1979-02-14,ES88209530454618970832,TRX_N-01053-38225004,2024-08-26T20:03:03,Vitoria-Gasteiz,expenses,transport,-84.14,-45442.57
buyer_6,Manuel,,1979-02-14,ES88209530454618970832,TRX_N-01054-05784285,2024-08-27T09:08:58,Erandio,expenses,food,-91.25,-45533.82
buyer_6,Manuel,,1979-02-14,ES88209530454618970832,TRX_N-01055-53315318,2024-08-27T16:46:29,Vitoria-Gasteiz,expenses,cash,-100.0,-45633.82
buyer_6,Manuel,,1979-02-14,ES88209530454618970832,TRX_N-01056-89241203,2024-08-28T12:50:52,Vitoria-Gasteiz,expenses,leisure,-83.37,-45717.19
buyer_6,Manuel,,1979-02-14,ES88209530454618970832,TRX_N-01057-00623692,2024-08-29T18:30:16,Vitoria-Gasteiz,expenses,transport,-54.54,-45771.73
buyer_6,Manuel,,1979-02-14,ES88209530454618970832,TRX_N-01058-10441154,2024-08-30T15:46:31,Errenteria,expenses,food,-76.09,-45847.82
buyer_6,Manuel,,1979-02-14,ES88209530454618970832,TRX_N-01059-80178390,2024-08-30T12:40:36,Vitoria-Gasteiz,expenses,transport,-77.82,-45925.64
buyer_6,Manuel,,1979-02-14,ES88209530454618970832,TRX_N-01060-64478224,2024-09-01T15:40:19,Vitoria-Gasteiz,incomes,salary,3014.96,-42910.68
buyer_6,Manuel,,1979-02-14,ES88209530454618970832,TRX_N-01061-91828678,2024-09-01T09:39:21,Barakaldo,expenses,transport,-48.42,-42959.1
buyer_6,Manuel,,1979-02-14,ES88209530454618970832,TRX_N-01062-05559695,2024-09-02T00:41:14,Vitoria-Gasteiz,expenses,food,-119.55,-43078.65
buyer_6,Manuel,,1979-02-14,ES88209530454618970832,TRX_N-01063-06948205,2024-09-03T23:42:44,Vitoria-Gasteiz,expenses,education,-73.67,-43152.32
buyer_6,Manuel,,1979-02-14,ES88209530454618970832,TRX_N-01064-43997294,2024-09-03T12:37:07,Vitoria-Gasteiz,expenses,cash,-100.0,-43252.32
buyer_6,Manuel,,1979-02-14,ES88209530454618970832,TRX_N-01065-01542775,2024-09-04T11:12:17,Vitoria-Gasteiz,expenses,mortgage,-1089.47,-44341.79
buyer_6,Manuel,,1979-02-14,ES88209530454618970832,TRX_N-01066-60483880,2024-09-04T16:23:22,Vitoria-Gasteiz,expenses,clothing,-60.42,-44402.21
buyer_6,Manuel,,1979-02-14,ES88209530454618970832,TRX_N-01067-91430067,2024-09-05T08:06:05,Vitoria-Gasteiz,expenses,electricity,-42.36,-44444.57
buyer_6,Manuel,,1979-02-14,ES88209530454618970832,TRX_N-01068-75103074,2024-09-05T09:56:50,Vitoria-Gasteiz,expenses,healthcare,-38.64,-44483.21
buyer_6,Manuel,,1979-02-14,ES88209530454618970832,TRX_N-01069-12218701,2024-09-06T12:07:33,Vitoria-Gasteiz,expenses,water,-44.43,-44527.64
buyer_6,Manuel,,1979-02-14,ES88209530454618970832,TRX_N-01070-52845780,2024-09-06T19:42:24,Vitoria-Gasteiz,expenses,cash,-100.0,-44627.64
buyer_6,Manuel,,1979-02-14,ES88209530454618970832,TRX_N-01071-82777972,2024-09-07T09:45:37,Vitoria-Gasteiz,expenses,gas,-104.51,-44732.15
buyer_6,Manuel,,1979-02-14,ES88209530454618970832,TRX_N-01072-68586193,2024-09-08T20:06:58,Vitoria-Gasteiz,expenses,phone,-35.97,-44768.12
buyer_6,Manuel,,1979-02-14,ES88209530454618970832,TRX_N-01073-70158185,2024-09-08T04:15:23,Vitoria-Gasteiz,expenses,internet,-42.0,-44810.12
buyer_6,Manuel,,1979-02-14,ES88209530454618970832,TRX_N-01074-34846120,2024-09-08T17:07:02,Vitoria-Gasteiz,expenses,food,-80.16,-44890.28
buyer_6,Manuel,,1979-02-14,ES88209530454618970832,TRX_N-01075-29643492,2024-09-08T09:38:23,Vitoria-Gasteiz,expenses,transport,-42.32,-44932.6
buyer_6,Manuel,,1979-02-14,ES88209530454618970832,TRX_N-01076-47985092,2024-09-09T10:51:19,Vitoria-Gasteiz,expenses,food,-119.9,-45052.5
buyer_6,Manuel,,1979-02-14,ES88209530454618970832,TRX_N-01077-42552838,2024-09-09T14:07:01,Vitoria-Gasteiz,expenses,transport,-76.25,-45128.75
buyer_6,Manuel,,1979-02-14,ES88209530454618970832,TRX_N-01078-12006345,2024-09-12T12:11:41,Vitoria-Gasteiz,expenses,clothing,-147.48,-45276.23
buyer_6,Manuel,,1979-02-14,ES88209530454618970832,TRX_N-01079-32847094,2024-09-17T12:26:25,Vitoria-Gasteiz,expenses,leisure,-34.44,-45310.67
buyer_6,Manuel,,1979-02-14,ES88209530454618970832,TRX_N-01080-31021986,2024-09-18T15:41:08,Vitoria-Gasteiz,expenses,leisure,-53.35,-45364.02
buyer_6,Manuel,,1979-02-14,ES88209530454618970832,TRX_N-01081-45756982,2024-09-23T14:53:54,Vitoria-Gasteiz,expenses,appliances,-143.51,-45507.53
buyer_6,Manuel,,1979-02-14,ES88209530454618970832,TRX_N-01082-45780215,2024-09-25T06:47:08,Vitoria-Gasteiz,expenses,leisure,-75.77,-45583.3
buyer_6,Manuel,,1979-02-14,ES88209530454618970832,TRX_N-01083-21444710,2024-09-26T18:39:39,Vitoria-Gasteiz,expenses,cash,-100.0,-45683.3
buyer_6,Manuel,,1979-02-14,ES88209530454618970832,TRX_N-01084-06519669,2024-09-29T17:02:37,Andoain,expenses,clothing,-46.22,-45729.52
buyer_6,Manuel,,1979-02-14,ES88209530454618970832,TRX_N-01085-46765228,2024-10-01T19:16:26,Vitoria-Gasteiz,incomes,salary,3014.96,-42714.56
buyer_6,Manuel,,1979-02-14,ES88209530454618970832,TRX_N-01086-51293391,2024-10-02T23:11:26,Vitoria-Gasteiz,expenses,transport,-74.11,-42788.67
buyer_6,Manuel,,1979-02-14,ES88209530454618970832,TRX_N-01087-18300932,2024-10-03T14:35:23,Pasaia,expenses,transport,-81.5,-42870.17
buyer_6,Manuel,,1979-02-14,ES88209530454618970832,TRX_N-01088-09408337,2024-10-03T06:36:31,Vitoria-Gasteiz,expenses,cash,-100.0,-42970.17
buyer_6,Manuel,,1979-02-14,ES88209530454618970832,TRX_N-01089-57924120,2024-10-04T20:29:29,Vitoria-Gasteiz,expenses,mortgage,-1089.47,-44059.64
buyer_6,Manuel,,1979-02-14,ES88209530454618970832,TRX_N-01090-70273704,2024-10-06T22:47:20,Vitoria-Gasteiz,expenses,electricity,-54.04,-44113.68
buyer_6,Manuel,,1979-02-14,ES88209530454618970832,TRX_N-01091-77815529,2024-10-06T19:22:01,Vitoria-Gasteiz,expenses,gas,-110.71,-44224.39
buyer_6,Manuel,,1979-02-14,ES88209530454618970832,TRX_N-01092-05071892,2024-10-06T11:49:48,Vitoria-Gasteiz,expenses,leisure,-73.82,-44298.21
buyer_6,Manuel,,1979-02-14,ES88209530454618970832,TRX_N-01093-03030013,2024-10-06T18:48:01,Vitoria-Gasteiz,expenses,repairs,-331.66,-44629.87
buyer_6,Manuel,,1979-02-14,ES88209530454618970832,TRX_N-01094-47175517,2024-10-07T15:05:52,Vitoria-Gasteiz,expenses,internet,-42.0,-44671.87
buyer_6,Manuel,,1979-02-14,ES88209530454618970832,TRX_N-01095-85019979,2024-10-07T16:55:43,Santurtzi,expenses,food,-67.99,-44739.86
buyer_6,Manuel,,1979-02-14,ES88209530454618970832,TRX_N-01096-03307095,2024-10-07T12:53:19,Irun,expenses,education,-57.51,-44797.37
buyer_6,Manuel,,1979-02-14,ES88209530454618970832,TRX_N-01097-09581368,2024-10-07T11:15:50,Portugalete,expenses,cash,-100.0,-44897.37
buyer_6,Manuel,,1979-02-14,ES88209530454618970832,TRX_N-01098-02857260,2024-10-08T20:25:21,Vitoria-Gasteiz,expenses,water,-40.5,-44937.87
buyer_6,Manuel,,1979-02-14,ES88209530454618970832,TRX_N-01099-92139443,2024-10-08T18:25:09,Vitoria-Gasteiz,expenses,phone,-36.86,-44974.73
buyer_6,Manuel,,1979-02-14,ES88209530454618970832,TRX_N-01100-49490849,2024-10-09T00:37:40,Vitoria-Gasteiz,expenses,cash,-100.0,-45074.73
buyer_7,Mar√≠a,,1968-12-31,ES68209528285169439268,TRX_N-00001-39674256,2022-01-01T14:15:17,Portugalete,incomes,salary,1272.95,8310.97
buyer_7,Mar√≠a,,1968-12-31,ES68209528285169439268,TRX_N-00002-76464516,2022-01-01T08:34:15,Portugalete,expenses,food,-100.1,8210.87
buyer_7,Mar√≠a,,1968-12-31,ES68209528285169439268,TRX_N-00003-33112166,2022-01-04T11:55:19,Portugalete,expenses,mortgage,-764.17,7446.7
buyer_7,Mar√≠a,,1968-12-31,ES68209528285169439268,TRX_N-00004-79755811,2022-01-05T20:07:21,Portugalete,expenses,electricity,-73.91,7372.79
buyer_7,Mar√≠a,,1968-12-31,ES68209528285169439268,TRX_N-00005-89971428,2022-01-05T19:17:13,Portugalete,expenses,gas,-80.58,7292.21
buyer_7,Mar√≠a,,1968-12-31,ES68209528285169439268,TRX_N-00006-19698372,2022-01-06T20:54:18,Portugalete,expenses,water,-42.62,7249.59
buyer_7,Mar√≠a,,1968-12-31,ES68209528285169439268,TRX_N-00007-07326817,2022-01-06T14:43:50,Portugalete,expenses,food,-83.48,7166.11
buyer_7,Mar√≠a,,1968-12-31,ES68209528285169439268,TRX_N-00008-85566146,2022-01-06T14:34:22,Portugalete,expenses,repairs,-148.23,7017.88
buyer_7,Mar√≠a,,1968-12-31,ES68209528285169439268,TRX_N-00009-97363008,2022-01-07T11:57:26,Portugalete,expenses,transport,-65.97,6951.91
buyer_7,Mar√≠a,,1968-12-31,ES68209528285169439268,TRX_N-00010-43984969,2022-01-08T15:16:32,Portugalete,expenses,internet,-42.0,6909.91
buyer_7,Mar√≠a,,1968-12-31,ES68209528285169439268,TRX_N-00011-50054499,2022-01-08T13:47:18,Portugalete,expenses,phone,-34.48,6875.43
buyer_7,Mar√≠a,,1968-12-31,ES68209528285169439268,TRX_N-00012-23406109,2022-01-08T17:29:56,Portugalete,expenses,healthcare,-103.77,6771.66
buyer_7,Mar√≠a,,1968-12-31,ES68209528285169439268,TRX_N-00013-87708187,2022-01-08T09:51:48,Portugalete,expenses,gifts,-92.07,6679.59
buyer_7,Mar√≠a,,1968-12-31,ES68209528285169439268,TRX_N-00014-16353338,2022-01-09T18:21:29,Portugalete,expenses,food,-119.77,6559.82
buyer_7,Mar√≠a,,1968-12-31,ES68209528285169439268,TRX_N-00015-55877523,2022-01-11T12:43:25,Portugalete,expenses,cash,-100.0,6459.82
buyer_7,Mar√≠a,,1968-12-31,ES68209528285169439268,TRX_N-00016-23184836,2022-01-11T21:11:45,Portugalete,expenses,repairs,-219.47,6240.35
buyer_7,Mar√≠a,,1968-12-31,ES68209528285169439268,TRX_N-00017-88382561,2022-01-12T15:06:01,Portugalete,expenses,food,-124.1,6116.25
buyer_7,Mar√≠a,,1968-12-31,ES68209528285169439268,TRX_N-00018-96742071,2022-01-12T17:22:43,Barakaldo,expenses,transport,-61.06,6055.19
buyer_7,Mar√≠a,,1968-12-31,ES68209528285169439268,TRX_N-00019-75177473,2022-01-12T11:20:38,Portugalete,expenses,gifts,-707.94,5347.25
buyer_7,Mar√≠a,,1968-12-31,ES68209528285169439268,TRX_N-00020-76038928,2022-01-13T10:30:40,Portugalete,expenses,food,-96.21,5251.04
buyer_7,Mar√≠a,,1968-12-31,ES68209528285169439268,TRX_N-00021-06247486,2022-01-13T09:55:27,Portugalete,expenses,cash,-100.0,5151.04
buyer_7,Mar√≠a,,1968-12-31,ES68209528285169439268,TRX_N-00022-71167071,2022-01-14T11:46:31,Portugalete,expenses,leisure,-50.42,5100.62
buyer_7,Mar√≠a,,1968-12-31,ES68209528285169439268,TRX_N-00023-13174526,2022-01-14T18:26:25,Portugalete,expenses,gifts,-77.97,5022.65
buyer_7,Mar√≠a,,1968-12-31,ES68209528285169439268,TRX_N-00024-07102174,2022-01-18T18:05:17,Amurrio,expenses,food,-94.75,4927.9
buyer_7,Mar√≠a,,1968-12-31,ES68209528285169439268,TRX_N-00025-27134512,2022-01-20T11:36:31,Portugalete,expenses,food,-68.49,4859.41
buyer_7,Mar√≠a,,1968-12-31,ES68209528285169439268,TRX_N-00026-79780385,2022-01-25T20:44:36,Portugalete,expenses,transport,-43.99,4815.42
buyer_7,Mar√≠a,,1968-12-31,ES68209528285169439268,TRX_N-00027-90686941,2022-01-25T13:00:47,Portugalete,expenses,clothing,-147.79,4667.63
buyer_7,Mar√≠a,,1968-12-31,ES68209528285169439268,TRX_N-00028-66830602,2022-01-25T21:43:26,Portugalete,expenses,children,-175.53,4492.1
buyer_7,Mar√≠a,,1968-12-31,ES68209528285169439268,TRX_N-00029-64981397,2022-01-28T11:25:27,Portugalete,expenses,cash,-100.0,4392.1
buyer_7,Mar√≠a,,1968-12-31,ES68209528285169439268,TRX_N-00030-79951946,2022-02-01T21:24:07,Portugalete,incomes,salary,1272.95,5665.05
buyer_7,Mar√≠a,,1968-12-31,ES68209528285169439268,TRX_N-00031-61289244,2022-02-01T15:31:39,Portugalete,expenses,repairs,-27.94,5637.11
buyer_7,Mar√≠a,,1968-12-31,ES68209528285169439268,TRX_N-00032-53275153,2022-02-04T09:58:34,Portugalete,expenses,mortgage,-764.17,4872.94
buyer_7,Mar√≠a,,1968-12-31,ES68209528285169439268,TRX_N-00033-81683582,2022-02-04T13:57:53,Portugalete,expenses,food,-71.32,4801.62
buyer_7,Mar√≠a,,1968-12-31,ES68209528285169439268,TRX_N-00034-94302930,2022-02-04T17:51:02,Portugalete,expenses,transport,-72.74,4728.88
buyer_7,Mar√≠a,,1968-12-31,ES68209528285169439268,TRX_N-00035-19656266,2022-02-05T07:12:04,Portugalete,expenses,electricity,-34.99,4693.89
buyer_7,Mar√≠a,,1968-12-31,ES68209528285169439268,TRX_N-00036-12915792,2022-02-05T16:10:11,Portugalete,expenses,leisure,-47.06,4646.83
buyer_7,Mar√≠a,,1968-12-31,ES68209528285169439268,TRX_N-00037-57480269,2022-02-07T20:23:39,Portugalete,expenses,cash,-100.0,4546.83
buyer_7,Mar√≠a,,1968-12-31,ES68209528285169439268,TRX_N-00038-91279226,2022-02-08T13:45:42,Portugalete,expenses,phone,-35.9,4510.93
buyer_7,Mar√≠a,,1968-12-31,ES68209528285169439268,TRX_N-00039-25158736,2022-02-08T20:52:09,Portugalete,expenses,water,-39.85,4471.08
buyer_7,Mar√≠a,,1968-12-31,ES68209528285169439268,TRX_N-00040-84496966,2022-02-08T16:00:16,Portugalete,expenses,gas,-53.76,4417.32
buyer_7,Mar√≠a,,1968-12-31,ES68209528285169439268,TRX_N-00041-31608487,2022-02-08T19:59:20,Portugalete,expenses,internet,-42.0,4375.32
buyer_7,Mar√≠a,,1968-12-31,ES68209528285169439268,TRX_N-00042-60319013,2022-02-08T16:16:42,Eibar,expenses,food,-75.56,4299.76
buyer_7,Mar√≠a,,1968-12-31,ES68209528285169439268,TRX_N-00043-41108407,2022-02-08T11:08:11,Eibar,expenses,transport,-70.17,4229.59
buyer_7,Mar√≠a,,1968-12-31,ES68209528285169439268,TRX_N-00044-99418179,2022-02-09T00:38:13,Andoain,expenses,healthcare,-172.75,4056.84
buyer_7,Mar√≠a,,1968-12-31,ES68209528285169439268,TRX_N-00045-72302331,2022-02-09T15:31:41,Portugalete,expenses,cash,-100.0,3956.84
buyer_7,Mar√≠a,,1968-12-31,ES68209528285169439268,TRX_N-00046-46692810,2022-02-10T16:44:57,Portugalete,expenses,transport,-77.87,3878.97
buyer_7,Mar√≠a,,1968-12-31,ES68209528285169439268,TRX_N-00047-85601003,2022-02-10T17:28:39,Portugalete,expenses,children,-194.58,3684.39
buyer_7,Mar√≠a,,1968-12-31,ES68209528285169439268,TRX_N-00048-26139470,2022-02-13T18:34:14,Portugalete,expenses,cash,-100.0,3584.39
buyer_7,Mar√≠a,,1968-12-31,ES68209528285169439268,TRX_N-00049-90354839,2022-02-15T19:47:56,Portugalete,expenses,cash,-100.0,3484.39
buyer_7,Mar√≠a,,1968-12-31,ES68209528285169439268,TRX_N-00050-84617414,2022-02-16T23:47:42,Portugalete,expenses,cash,-100.0,3384.39
buyer_7,Mar√≠a,,1968-12-31,ES68209528285169439268,TRX_N-00051-79193238,2022-02-16T17:04:27,Portugalete,expenses,gifts,-282.52,3101.87
buyer_7,Mar√≠a,,1968-12-31,ES68209528285169439268,TRX_N-00052-35144173,2022-02-17T09:56:59,Portugalete,expenses,leisure,-27.08,3074.79
buyer_7,Mar√≠a,,1968-12-31,ES68209528285169439268,TRX_N-00053-39829847,2022-02-18T08:27:53,Portugalete,expenses,leisure,-70.71,3004.08
buyer_7,Mar√≠a,,1968-12-31,ES68209528285169439268,TRX_N-00054-70275245,2022-02-18T01:13:37,Portugalete,expenses,clothing,-50.01,2954.07
buyer_7,Mar√≠a,,1968-12-31,ES68209528285169439268,TRX_N-00055-65515131,2022-02-18T14:20:24,Portugalete,expenses,cash,-100.0,2854.07
buyer_7,Mar√≠a,,1968-12-31,ES68209528285169439268,TRX_N-00056-50563360,2022-02-19T08:00:15,Portugalete,expenses,gifts,-343.6,2510.47
buyer_7,Mar√≠a,,1968-12-31,ES68209528285169439268,TRX_N-00057-67596801,2022-02-20T16:05:23,Arrasate,expenses,repairs,-211.14,2299.33
buyer_7,Mar√≠a,,1968-12-31,ES68209528285169439268,TRX_N-00058-56027331,2022-02-22T16:05:41,Portugalete,expenses,gifts,-436.28,1863.05
buyer_7,Mar√≠a,,1968-12-31,ES68209528285169439268,TRX_N-00059-90727110,2022-02-26T16:51:17,Portugalete,expenses,healthcare,-50.03,1813.02
buyer_7,Mar√≠a,,1968-12-31,ES68209528285169439268,TRX_N-00060-00576890,2022-02-26T19:30:43,Portugalete,expenses,cash,-100.0,1713.02
buyer_7,Mar√≠a,,1968-12-31,ES68209528285169439268,TRX_N-00061-36477286,2022-02-26T20:16:15,Portugalete,expenses,repairs,-207.84,1505.18
buyer_7,Mar√≠a,,1968-12-31,ES68209528285169439268,TRX_N-00062-37650261,2022-02-26T12:45:15,Portugalete,expenses,gifts,-374.16,1131.02
buyer_7,Mar√≠a,,1968-12-31,ES68209528285169439268,TRX_N-00063-67008048,2022-02-28T13:50:07,Portugalete,expenses,food,-96.12,1034.9
buyer_7,Mar√≠a,,1968-12-31,ES68209528285169439268,TRX_N-00064-64072900,2022-02-28T16:31:30,Portugalete,expenses,transport,-86.57,948.33
buyer_7,Mar√≠a,,1968-12-31,ES68209528285169439268,TRX_N-00065-37830211,2022-03-01T10:26:18,Portugalete,incomes,salary,1272.95,2221.28
buyer_7,Mar√≠a,,1968-12-31,ES68209528285169439268,TRX_N-00066-46601109,2022-03-01T19:18:42,Portugalete,expenses,transport,-67.49,2153.79
buyer_7,Mar√≠a,,1968-12-31,ES68209528285169439268,TRX_N-00067-44541747,2022-03-04T18:26:31,Portugalete,expenses,mortgage,-764.17,1389.62
buyer_7,Mar√≠a,,1968-12-31,ES68209528285169439268,TRX_N-00068-85314362,2022-03-04T12:17:29,Llodio,expenses,leisure,-22.52,1367.1
buyer_7,Mar√≠a,,1968-12-31,ES68209528285169439268,TRX_N-00069-30197710,2022-03-05T17:42:28,Portugalete,expenses,electricity,-61.12,1305.98
buyer_7,Mar√≠a,,1968-12-31,ES68209528285169439268,TRX_N-00070-81659003,2022-03-05T10:24:40,Portugalete,expenses,internet,-42.0,1263.98
buyer_7,Mar√≠a,,1968-12-31,ES68209528285169439268,TRX_N-00071-69927724,2022-03-05T16:51:08,Portugalete,expenses,phone,-40.13,1223.85
buyer_7,Mar√≠a,,1968-12-31,ES68209528285169439268,TRX_N-00072-16775385,2022-03-06T15:24:31,Portugalete,expenses,food,-71.97,1151.88
buyer_7,Mar√≠a,,1968-12-31,ES68209528285169439268,TRX_N-00073-26686027,2022-03-06T11:09:13,Portugalete,expenses,transport,-68.92,1082.96
buyer_7,Mar√≠a,,1968-12-31,ES68209528285169439268,TRX_N-00074-85833230,2022-03-07T11:01:56,Portugalete,expenses,gas,-76.01,1006.95
buyer_7,Mar√≠a,,1968-12-31,ES68209528285169439268,TRX_N-00075-80922528,2022-03-07T11:44:09,Salvatierra/Agurain,expenses,food,-101.75,905.2
buyer_7,Mar√≠a,,1968-12-31,ES68209528285169439268,TRX_N-00076-03982072,2022-03-07T20:07:29,Portugalete,expenses,clothing,-127.23,777.97
buyer_7,Mar√≠a,,1968-12-31,ES68209528285169439268,TRX_N-00077-21432245,2022-03-07T06:44:09,Portugalete,expenses,education,-45.25,732.72
buyer_7,Mar√≠a,,1968-12-31,ES68209528285169439268,TRX_N-00078-00965198,2022-03-08T09:54:50,Portugalete,expenses,water,-39.84,692.88
buyer_7,Mar√≠a,,1968-12-31,ES68209528285169439268,TRX_N-00079-93462600,2022-03-08T23:55:28,Portugalete,expenses,food,-112.68,580.2
buyer_7,Mar√≠a,,1968-12-31,ES68209528285169439268,TRX_N-00080-92173863,2022-03-12T21:35:46,Portugalete,expenses,food,-99.62,480.58
buyer_7,Mar√≠a,,1968-12-31,ES68209528285169439268,TRX_N-00081-79634279,2022-03-13T20:50:16,Portugalete,expenses,cash,-100.0,380.58
buyer_7,Mar√≠a,,1968-12-31,ES68209528285169439268,TRX_N-00082-76199954,2022-03-16T12:38:24,Portugalete,expenses,transport,-74.0,306.58
buyer_7,Mar√≠a,,1968-12-31,ES68209528285169439268,TRX_N-00083-39492458,2022-03-20T00:29:37,Portugalete,expenses,food,-79.92,226.66
buyer_7,Mar√≠a,,1968-12-31,ES68209528285169439268,TRX_N-00084-07408360,2022-03-22T10:48:33,Portugalete,expenses,food,-92.7,133.96
buyer_7,Mar√≠a,,1968-12-31,ES68209528285169439268,TRX_N-00085-01413122,2022-03-22T19:01:46,Iru√±a de Oca,expenses,education,-69.71,64.25
buyer_7,Mar√≠a,,1968-12-31,ES68209528285169439268,TRX_N-00086-07586514,2022-03-22T20:02:02,Erandio,expenses,repairs,-83.89,-19.64
buyer_7,Mar√≠a,,1968-12-31,ES68209528285169439268,TRX_N-00087-36310805,2022-03-23T11:50:17,Portugalete,expenses,food,-122.29,-141.93
buyer_7,Mar√≠a,,1968-12-31,ES68209528285169439268,TRX_N-00088-84648560,2022-03-25T15:00:23,Portugalete,expenses,leisure,-32.35,-174.28
buyer_7,Mar√≠a,,1968-12-31,ES68209528285169439268,TRX_N-00089-16979693,2022-03-26T13:34:53,Portugalete,expenses,food,-108.74,-283.02
buyer_7,Mar√≠a,,1968-12-31,ES68209528285169439268,TRX_N-00090-26289921,2022-03-29T15:17:11,Portugalete,expenses,transport,-87.79,-370.81
buyer_7,Mar√≠a,,1968-12-31,ES68209528285169439268,TRX_N-00091-57389700,2022-03-29T14:38:27,Portugalete,expenses,cash,-100.0,-470.81
buyer_7,Mar√≠a,,1968-12-31,ES68209528285169439268,TRX_N-00092-82262321,2022-03-30T09:58:32,Portugalete,expenses,food,-71.42,-542.23
buyer_7,Mar√≠a,,1968-12-31,ES68209528285169439268,TRX_N-00093-01155116,2022-03-30T03:17:05,Portugalete,expenses,leisure,-30.06,-572.29
buyer_7,Mar√≠a,,1968-12-31,ES68209528285169439268,TRX_N-00094-74804356,2022-03-31T15:57:14,Eibar,expenses,gifts,-573.82,-1146.11
buyer_7,Mar√≠a,,1968-12-31,ES68209528285169439268,TRX_N-00095-60994242,2022-04-01T13:37:43,Portugalete,incomes,salary,1272.95,126.84
buyer_7,Mar√≠a,,1968-12-31,ES68209528285169439268,TRX_N-00096-42485880,2022-04-01T13:37:43,Portugalete,incomes,extra_income,186.42,313.26
buyer_7,Mar√≠a,,1968-12-31,ES68209528285169439268,TRX_N-00097-14566780,2022-04-01T11:32:41,Portugalete,expenses,leisure,-36.5,276.76
buyer_7,Mar√≠a,,1968-12-31,ES68209528285169439268,TRX_N-00098-90794389,2022-04-01T08:07:55,Portugalete,expenses,cash,-100.0,176.76
buyer_7,Mar√≠a,,1968-12-31,ES68209528285169439268,TRX_N-00099-39129911,2022-04-04T20:27:34,Portugalete,expenses,mortgage,-764.17,-587.41
buyer_7,Mar√≠a,,1968-12-31,ES68209528285169439268,TRX_N-00100-20561118,2022-04-04T17:31:41,Portugalete,expenses,leisure,-83.12,-670.53
buyer_7,Mar√≠a,,1968-12-31,ES68209528285169439268,TRX_N-00101-93317311,2022-04-04T11:24:06,Portugalete,expenses,cash,-100.0,-770.53
buyer_7,Mar√≠a,,1968-12-31,ES68209528285169439268,TRX_N-00102-07982151,2022-04-05T22:55:40,Zuia,expenses,transport,-89.43,-859.96
buyer_7,Mar√≠a,,1968-12-31,ES68209528285169439268,TRX_N-00103-02373989,2022-04-07T20:28:32,Portugalete,expenses,gas,-59.56,-919.52
buyer_7,Mar√≠a,,1968-12-31,ES68209528285169439268,TRX_N-00104-18095699,2022-04-08T17:20:13,Portugalete,expenses,water,-43.03,-962.55
buyer_7,Mar√≠a,,1968-12-31,ES68209528285169439268,TRX_N-00105-15272952,2022-04-08T10:30:43,Portugalete,expenses,electricity,-79.99,-1042.54
buyer_7,Mar√≠a,,1968-12-31,ES68209528285169439268,TRX_N-00106-38061439,2022-04-08T19:07:50,Portugalete,expenses,internet,-42.0,-1084.54
buyer_7,Mar√≠a,,1968-12-31,ES68209528285169439268,TRX_N-00107-03264529,2022-04-08T12:49:17,Portugalete,expenses,phone,-41.47,-1126.01
buyer_7,Mar√≠a,,1968-12-31,ES68209528285169439268,TRX_N-00108-91120502,2022-04-12T13:08:25,Portugalete,expenses,transport,-79.41,-1205.42
buyer_7,Mar√≠a,,1968-12-31,ES68209528285169439268,TRX_N-00109-08827837,2022-04-12T13:44:54,Portugalete,expenses,repairs,-27.08,-1232.5
buyer_7,Mar√≠a,,1968-12-31,ES68209528285169439268,TRX_N-00110-77569652,2022-04-12T15:28:55,Eibar,expenses,gifts,-117.68,-1350.18
buyer_7,Mar√≠a,,1968-12-31,ES68209528285169439268,TRX_N-00111-88622012,2022-04-13T10:50:55,Portugalete,expenses,leisure,-57.7,-1407.88
buyer_7,Mar√≠a,,1968-12-31,ES68209528285169439268,TRX_N-00112-66431432,2022-04-13T10:56:45,Portugalete,expenses,education,-54.27,-1462.15
buyer_7,Mar√≠a,,1968-12-31,ES68209528285169439268,TRX_N-00113-02963892,2022-04-15T16:58:03,Portugalete,expenses,food,-67.31,-1529.46
buyer_7,Mar√≠a,,1968-12-31,ES68209528285169439268,TRX_N-00114-59332346,2022-04-16T16:24:11,Portugalete,expenses,leisure,-76.39,-1605.85
buyer_7,Mar√≠a,,1968-12-31,ES68209528285169439268,TRX_N-00115-25058110,2022-04-16T13:56:29,Sestao,expenses,travel,-1898.0,-3503.85
buyer_7,Mar√≠a,,1968-12-31,ES68209528285169439268,TRX_N-00116-44829928,2022-04-18T14:24:56,Portugalete,expenses,food,-81.0,-3584.85
buyer_7,Mar√≠a,,1968-12-31,ES68209528285169439268,TRX_N-00117-83663618,2022-04-19T14:38:03,Portugalete,expenses,children,-500.73,-4085.58
buyer_7,Mar√≠a,,1968-12-31,ES68209528285169439268,TRX_N-00118-39033279,2022-04-20T13:48:00,Portugalete,expenses,cash,-100.0,-4185.58
buyer_7,Mar√≠a,,1968-12-31,ES68209528285169439268,TRX_N-00119-57591264,2022-04-22T17:13:25,Portugalete,expenses,children,-159.77,-4345.35
buyer_7,Mar√≠a,,1968-12-31,ES68209528285169439268,TRX_N-00120-46696677,2022-04-23T17:54:16,Portugalete,expenses,leisure,-42.51,-4387.86
buyer_7,Mar√≠a,,1968-12-31,ES68209528285169439268,TRX_N-00121-07966107,2022-04-24T10:59:06,Portugalete,expenses,transport,-60.26,-4448.12
buyer_7,Mar√≠a,,1968-12-31,ES68209528285169439268,TRX_N-00122-36571321,2022-04-26T12:37:29,Portugalete,expenses,food,-66.02,-4514.14
buyer_7,Mar√≠a,,1968-12-31,ES68209528285169439268,TRX_N-00123-83801960,2022-04-27T09:09:21,Portugalete,expenses,clothing,-118.2,-4632.34
buyer_7,Mar√≠a,,1968-12-31,ES68209528285169439268,TRX_N-00124-86437743,2022-04-27T06:43:20,Portugalete,expenses,cash,-100.0,-4732.34
buyer_7,Mar√≠a,,1968-12-31,ES68209528285169439268,TRX_N-00125-88070116,2022-04-28T10:46:37,Portugalete,expenses,education,-51.57,-4783.91
buyer_7,Mar√≠a,,1968-12-31,ES68209528285169439268,TRX_N-00126-34317212,2022-04-29T14:24:39,Portugalete,expenses,gifts,-171.96,-4955.87
buyer_7,Mar√≠a,,1968-12-31,ES68209528285169439268,TRX_N-00127-78917920,2022-05-01T18:15:05,Portugalete,incomes,salary,1272.95,-3682.92
buyer_7,Mar√≠a,,1968-12-31,ES68209528285169439268,TRX_N-00128-35757476,2022-05-01T03:14:47,Portugalete,expenses,transport,-46.59,-3729.51
buyer_7,Mar√≠a,,1968-12-31,ES68209528285169439268,TRX_N-00129-98998771,2022-05-01T17:20:00,Portugalete,expenses,gifts,-603.55,-4333.06
buyer_7,Mar√≠a,,1968-12-31,ES68209528285169439268,TRX_N-00130-61518179,2022-05-03T12:53:59,Portugalete,expenses,food,-114.19,-4447.25
buyer_7,Mar√≠a,,1968-12-31,ES68209528285169439268,TRX_N-00131-22378738,2022-05-03T15:04:24,Portugalete,expenses,gifts,-788.82,-5236.07
buyer_7,Mar√≠a,,1968-12-31,ES68209528285169439268,TRX_N-00132-32073632,2022-05-04T14:04:24,Portugalete,expenses,mortgage,-764.17,-6000.24
buyer_7,Mar√≠a,,1968-12-31,ES68209528285169439268,TRX_N-00133-90214266,2022-05-04T14:50:24,Portugalete,expenses,gifts,-197.86,-6198.1
buyer_7,Mar√≠a,,1968-12-31,ES68209528285169439268,TRX_N-00134-89142322,2022-05-05T17:08:38,Portugalete,expenses,phone,-36.78,-6234.88
buyer_7,Mar√≠a,,1968-12-31,ES68209528285169439268,TRX_N-00135-62510507,2022-05-06T09:23:21,Portugalete,expenses,electricity,-45.54,-6280.42
buyer_7,Mar√≠a,,1968-12-31,ES68209528285169439268,TRX_N-00136-41452887,2022-05-06T18:53:57,Portugalete,expenses,food,-116.12,-6396.54
buyer_7,Mar√≠a,,1968-12-31,ES68209528285169439268,TRX_N-00137-98999590,2022-05-07T11:24:28,Portugalete,expenses,water,-43.05,-6439.59
buyer_7,Mar√≠a,,1968-12-31,ES68209528285169439268,TRX_N-00138-98435257,2022-05-08T18:41:24,Portugalete,expenses,gas,-114.93,-6554.52
buyer_7,Mar√≠a,,1968-12-31,ES68209528285169439268,TRX_N-00139-29801475,2022-05-08T16:55:47,Portugalete,expenses,internet,-42.0,-6596.52
buyer_7,Mar√≠a,,1968-12-31,ES68209528285169439268,TRX_N-00140-61397103,2022-05-09T17:23:04,Portugalete,expenses,transport,-69.0,-6665.52
buyer_7,Mar√≠a,,1968-12-31,ES68209528285169439268,TRX_N-00141-59262319,2022-05-09T12:18:04,Portugalete,expenses,cash,-100.0,-6765.52
buyer_7,Mar√≠a,,1968-12-31,ES68209528285169439268,TRX_N-00142-69609330,2022-05-11T19:00:03,Portugalete,expenses,food,-78.4,-6843.92
buyer_7,Mar√≠a,,1968-12-31,ES68209528285169439268,TRX_N-00143-07580939,2022-05-11T08:54:25,Portugalete,expenses,transport,-55.4,-6899.32
buyer_7,Mar√≠a,,1968-12-31,ES68209528285169439268,TRX_N-00144-88395818,2022-05-13T03:25:33,Portugalete,expenses,cash,-100.0,-6999.32
buyer_7,Mar√≠a,,1968-12-31,ES68209528285169439268,TRX_N-00145-18705737,2022-05-14T14:04:37,Portugalete,expenses,cash,-100.0,-7099.32
buyer_7,Mar√≠a,,1968-12-31,ES68209528285169439268,TRX_N-00146-19449787,2022-05-19T19:13:22,Portugalete,expenses,education,-61.44,-7160.76
buyer_7,Mar√≠a,,1968-12-31,ES68209528285169439268,TRX_N-00147-83284769,2022-05-20T19:27:21,Portugalete,expenses,clothing,-116.95,-7277.71
buyer_7,Mar√≠a,,1968-12-31,ES68209528285169439268,TRX_N-00148-35632719,2022-05-20T11:31:05,Portugalete,expenses,gifts,-344.7,-7622.41
buyer_7,Mar√≠a,,1968-12-31,ES68209528285169439268,TRX_N-00149-38066281,2022-05-23T18:44:37,Portugalete,expenses,leisure,-35.86,-7658.27
buyer_7,Mar√≠a,,1968-12-31,ES68209528285169439268,TRX_N-00150-30768271,2022-05-23T12:24:06,Sestao,expenses,cash,-100.0,-7758.27
buyer_7,Mar√≠a,,1968-12-31,ES68209528285169439268,TRX_N-00151-34327182,2022-05-24T01:08:03,Portugalete,expenses,food,-100.97,-7859.24
buyer_7,Mar√≠a,,1968-12-31,ES68209528285169439268,TRX_N-00152-38987977,2022-05-24T17:59:25,Galdakao,expenses,cash,-100.0,-7959.24
buyer_7,Mar√≠a,,1968-12-31,ES68209528285169439268,TRX_N-00153-26205370,2022-05-25T12:06:07,Portugalete,expenses,food,-60.04,-8019.28
buyer_7,Mar√≠a,,1968-12-31,ES68209528285169439268,TRX_N-00154-72930962,2022-05-28T09:06:11,Portugalete,expenses,leisure,-56.25,-8075.53
buyer_7,Mar√≠a,,1968-12-31,ES68209528285169439268,TRX_N-00155-09153771,2022-05-29T08:43:01,Portugalete,expenses,education,-45.25,-8120.78
buyer_7,Mar√≠a,,1968-12-31,ES68209528285169439268,TRX_N-00156-86345081,2022-05-29T10:03:17,Eibar,expenses,repairs,-268.01,-8388.79
buyer_7,Mar√≠a,,1968-12-31,ES68209528285169439268,TRX_N-00157-52299775,2022-05-30T16:11:54,Portugalete,expenses,leisure,-31.23,-8420.02
buyer_7,Mar√≠a,,1968-12-31,ES68209528285169439268,TRX_N-00158-45255453,2022-05-30T19:27:51,Portugalete,expenses,cash,-100.0,-8520.02
buyer_7,Mar√≠a,,1968-12-31,ES68209528285169439268,TRX_N-00159-64269535,2022-05-30T12:59:01,Portugalete,expenses,gifts,-601.94,-9121.96
buyer_7,Mar√≠a,,1968-12-31,ES68209528285169439268,TRX_N-00160-38860308,2022-05-31T13:35:53,Portugalete,expenses,repairs,-151.68,-9273.64
buyer_7,Mar√≠a,,1968-12-31,ES68209528285169439268,TRX_N-00161-83532866,2022-06-01T10:32:21,Portugalete,incomes,salary,1272.95,-8000.69
buyer_7,Mar√≠a,,1968-12-31,ES68209528285169439268,TRX_N-00162-37503576,2022-06-01T10:32:21,Portugalete,incomes,salary_bonus,913.5,-7087.19
buyer_7,Mar√≠a,,1968-12-31,ES68209528285169439268,TRX_N-00163-65491683,2022-06-02T12:13:02,Portugalete,expenses,transport,-51.65,-7138.84
buyer_7,Mar√≠a,,1968-12-31,ES68209528285169439268,TRX_N-00164-84762012,2022-06-02T09:20:25,Portugalete,expenses,cash,-100.0,-7238.84
buyer_7,Mar√≠a,,1968-12-31,ES68209528285169439268,TRX_N-00165-17080320,2022-06-03T12:04:10,Portugalete,expenses,cash,-100.0,-7338.84
buyer_7,Mar√≠a,,1968-12-31,ES68209528285169439268,TRX_N-00166-80134103,2022-06-04T18:53:09,Portugalete,expenses,mortgage,-764.17,-8103.01
buyer_7,Mar√≠a,,1968-12-31,ES68209528285169439268,TRX_N-00167-76110862,2022-06-04T11:57:39,Portugalete,expenses,gifts,-722.53,-8825.54
buyer_7,Mar√≠a,,1968-12-31,ES68209528285169439268,TRX_N-00168-29197939,2022-06-05T10:32:49,Portugalete,expenses,gas,-46.82,-8872.36
buyer_7,Mar√≠a,,1968-12-31,ES68209528285169439268,TRX_N-00169-84054195,2022-06-05T16:35:32,Portugalete,expenses,cash,-100.0,-8972.36
buyer_7,Mar√≠a,,1968-12-31,ES68209528285169439268,TRX_N-00170-15229964,2022-06-07T14:51:15,Portugalete,expenses,food,-111.72,-9084.08
buyer_7,Mar√≠a,,1968-12-31,ES68209528285169439268,TRX_N-00171-30980818,2022-06-07T09:54:47,Portugalete,expenses,leisure,-59.57,-9143.65
buyer_7,Mar√≠a,,1968-12-31,ES68209528285169439268,TRX_N-00172-17841759,2022-06-08T08:23:04,Portugalete,expenses,phone,-31.75,-9175.4
buyer_7,Mar√≠a,,1968-12-31,ES68209528285169439268,TRX_N-00173-23663818,2022-06-08T18:35:14,Portugalete,expenses,water,-30.56,-9205.96
buyer_7,Mar√≠a,,1968-12-31,ES68209528285169439268,TRX_N-00174-04695794,2022-06-08T08:13:57,Portugalete,expenses,electricity,-26.11,-9232.07
buyer_7,Mar√≠a,,1968-12-31,ES68209528285169439268,TRX_N-00175-82972387,2022-06-08T16:10:39,Portugalete,expenses,internet,-42.0,-9274.07
buyer_7,Mar√≠a,,1968-12-31,ES68209528285169439268,TRX_N-00176-11064111,2022-06-09T13:16:38,Portugalete,expenses,transport,-41.38,-9315.45
buyer_7,Mar√≠a,,1968-12-31,ES68209528285169439268,TRX_N-00177-08885615,2022-06-09T17:54:43,Labastida,expenses,leisure,-80.43,-9395.88
buyer_7,Mar√≠a,,1968-12-31,ES68209528285169439268,TRX_N-00178-98506287,2022-06-10T19:28:36,Portugalete,expenses,cash,-100.0,-9495.88
buyer_7,Mar√≠a,,1968-12-31,ES68209528285169439268,TRX_N-00179-22192341,2022-06-11T16:25:09,Portugalete,expenses,cash,-100.0,-9595.88
buyer_7,Mar√≠a,,1968-12-31,ES68209528285169439268,TRX_N-00180-23797766,2022-06-12T19:16:39,Durango,expenses,leisure,-82.6,-9678.48
buyer_7,Mar√≠a,,1968-12-31,ES68209528285169439268,TRX_N-00181-15787594,2022-06-12T17:56:37,Portugalete,expenses,cash,-100.0,-9778.48
buyer_7,Mar√≠a,,1968-12-31,ES68209528285169439268,TRX_N-00182-12263419,2022-06-13T08:14:04,Portugalete,expenses,education,-61.04,-9839.52
buyer_7,Mar√≠a,,1968-12-31,ES68209528285169439268,TRX_N-00183-09051641,2022-06-13T23:02:31,Labastida,expenses,cash,-100.0,-9939.52
buyer_7,Mar√≠a,,1968-12-31,ES68209528285169439268,TRX_N-00184-48818524,2022-06-13T08:21:59,Portugalete,expenses,gifts,-467.52,-10407.04
buyer_7,Mar√≠a,,1968-12-31,ES68209528285169439268,TRX_N-00185-19381883,2022-06-15T19:00:14,Portugalete,expenses,leisure,-55.88,-10462.92
buyer_7,Mar√≠a,,1968-12-31,ES68209528285169439268,TRX_N-00186-14484461,2022-06-16T17:58:06,Portugalete,expenses,leisure,-19.75,-10482.67
buyer_7,Mar√≠a,,1968-12-31,ES68209528285169439268,TRX_N-00187-19937422,2022-06-16T11:13:49,Alegr√≠a-Dulantzi,expenses,clothing,-100.17,-10582.84
buyer_7,Mar√≠a,,1968-12-31,ES68209528285169439268,TRX_N-00188-15785990,2022-06-17T18:57:34,Irun,expenses,cash,-100.0,-10682.84
buyer_7,Mar√≠a,,1968-12-31,ES68209528285169439268,TRX_N-00189-79153727,2022-06-17T10:47:31,Portugalete,expenses,appliances,-378.67,-11061.51
buyer_7,Mar√≠a,,1968-12-31,ES68209528285169439268,TRX_N-00190-60781932,2022-06-18T13:29:40,Portugalete,expenses,food,-121.42,-11182.93
buyer_7,Mar√≠a,,1968-12-31,ES68209528285169439268,TRX_N-00191-89981607,2022-06-18T11:45:12,Portugalete,expenses,leisure,-33.63,-11216.56
buyer_7,Mar√≠a,,1968-12-31,ES68209528285169439268,TRX_N-00192-23625004,2022-06-19T11:51:32,Portugalete,expenses,cash,-100.0,-11316.56
buyer_7,Mar√≠a,,1968-12-31,ES68209528285169439268,TRX_N-00193-00124729,2022-06-20T19:09:27,Portugalete,expenses,cash,-100.0,-11416.56
buyer_7,Mar√≠a,,1968-12-31,ES68209528285169439268,TRX_N-00194-15132282,2022-06-20T19:37:49,Portugalete,expenses,repairs,-331.33,-11747.89
buyer_7,Mar√≠a,,1968-12-31,ES68209528285169439268,TRX_N-00195-04744760,2022-06-21T20:27:33,Galdakao,expenses,leisure,-19.15,-11767.04
buyer_7,Mar√≠a,,1968-12-31,ES68209528285169439268,TRX_N-00196-56005550,2022-06-21T15:36:30,Portugalete,expenses,cash,-100.0,-11867.04
buyer_7,Mar√≠a,,1968-12-31,ES68209528285169439268,TRX_N-00197-05993025,2022-06-23T17:38:16,Portugalete,expenses,cash,-100.0,-11967.04
buyer_7,Mar√≠a,,1968-12-31,ES68209528285169439268,TRX_N-00198-66081096,2022-06-24T11:28:57,Portugalete,expenses,food,-73.75,-12040.79
buyer_7,Mar√≠a,,1968-12-31,ES68209528285169439268,TRX_N-00199-42322680,2022-06-25T10:39:57,Portugalete,expenses,clothing,-137.82,-12178.61
buyer_7,Mar√≠a,,1968-12-31,ES68209528285169439268,TRX_N-00200-21264894,2022-06-28T04:09:40,Portugalete,expenses,food,-91.8,-12270.41
buyer_7,Mar√≠a,,1968-12-31,ES68209528285169439268,TRX_N-00201-49135204,2022-06-28T12:32:35,Portugalete,expenses,leisure,-80.43,-12350.84
buyer_7,Mar√≠a,,1968-12-31,ES68209528285169439268,TRX_N-00202-19473682,2022-06-28T12:31:32,Portugalete,expenses,travel,-1628.85,-13979.69
buyer_7,Mar√≠a,,1968-12-31,ES68209528285169439268,TRX_N-00203-22413434,2022-06-28T16:04:23,Portugalete,expenses,appliances,-387.6,-14367.29
buyer_7,Mar√≠a,,1968-12-31,ES68209528285169439268,TRX_N-00204-65505302,2022-06-29T11:14:24,Galdakao,expenses,cash,-100.0,-14467.29
buyer_7,Mar√≠a,,1968-12-31,ES68209528285169439268,TRX_N-00205-91374245,2022-06-30T19:19:31,Portugalete,expenses,food,-67.33,-14534.62
buyer_7,Mar√≠a,,1968-12-31,ES68209528285169439268,TRX_N-00206-05678218,2022-06-30T13:56:11,Portugalete,expenses,transport,-87.39,-14622.01
buyer_7,Mar√≠a,,1968-12-31,ES68209528285169439268,TRX_N-00207-98242331,2022-06-30T18:42:10,Portugalete,expenses,education,-77.19,-14699.2
buyer_7,Mar√≠a,,1968-12-31,ES68209528285169439268,TRX_N-00208-52035726,2022-06-30T20:06:29,Portugalete,expenses,repairs,-71.49,-14770.69
buyer_7,Mar√≠a,,1968-12-31,ES68209528285169439268,TRX_N-00209-28292134,2022-07-01T09:55:59,Portugalete,incomes,salary,1272.95,-13497.74
buyer_7,Mar√≠a,,1968-12-31,ES68209528285169439268,TRX_N-00210-24263923,2022-07-01T09:55:59,Portugalete,incomes,extra_income,186.42,-13311.32
buyer_7,Mar√≠a,,1968-12-31,ES68209528285169439268,TRX_N-00211-14719754,2022-07-01T14:43:00,Portugalete,expenses,repairs,-49.35,-13360.67
buyer_7,Mar√≠a,,1968-12-31,ES68209528285169439268,TRX_N-00212-17381262,2022-07-02T21:27:44,Portugalete,expenses,gifts,-140.98,-13501.65
buyer_7,Mar√≠a,,1968-12-31,ES68209528285169439268,TRX_N-00213-03102652,2022-07-04T20:24:43,Portugalete,expenses,mortgage,-764.17,-14265.82
buyer_7,Mar√≠a,,1968-12-31,ES68209528285169439268,TRX_N-00214-20610612,2022-07-04T03:14:10,Portugalete,expenses,repairs,-227.17,-14492.99
buyer_7,Mar√≠a,,1968-12-31,ES68209528285169439268,TRX_N-00215-88772655,2022-07-04T09:32:18,Portugalete,expenses,children,-561.96,-15054.95
buyer_7,Mar√≠a,,1968-12-31,ES68209528285169439268,TRX_N-00216-52013377,2022-07-05T13:52:22,Portugalete,expenses,gas,-72.03,-15126.98
buyer_7,Mar√≠a,,1968-12-31,ES68209528285169439268,TRX_N-00217-16027504,2022-07-05T09:36:26,Portugalete,expenses,leisure,-78.07,-15205.05
buyer_7,Mar√≠a,,1968-12-31,ES68209528285169439268,TRX_N-00218-77331649,2022-07-06T10:36:38,Portugalete,expenses,electricity,-79.25,-15284.3
buyer_7,Mar√≠a,,1968-12-31,ES68209528285169439268,TRX_N-00219-43264698,2022-07-06T07:05:41,Portugalete,expenses,internet,-42.0,-15326.3
buyer_7,Mar√≠a,,1968-12-31,ES68209528285169439268,TRX_N-00220-97679122,2022-07-06T08:33:20,Portugalete,expenses,food,-113.74,-15440.04
buyer_7,Mar√≠a,,1968-12-31,ES68209528285169439268,TRX_N-00221-42496371,2022-07-06T10:39:48,Portugalete,expenses,clothing,-69.65,-15509.69
buyer_7,Mar√≠a,,1968-12-31,ES68209528285169439268,TRX_N-00222-75273328,2022-07-06T14:20:08,Portugalete,expenses,repairs,-138.2,-15647.89
buyer_7,Mar√≠a,,1968-12-31,ES68209528285169439268,TRX_N-00223-79433143,2022-07-07T17:39:05,Portugalete,expenses,water,-40.03,-15687.92
buyer_7,Mar√≠a,,1968-12-31,ES68209528285169439268,TRX_N-00224-39904513,2022-07-08T07:39:56,Portugalete,expenses,phone,-40.13,-15728.05
buyer_7,Mar√≠a,,1968-12-31,ES68209528285169439268,TRX_N-00225-94859613,2022-07-08T21:30:48,Portugalete,expenses,food,-112.9,-15840.95
buyer_7,Mar√≠a,,1968-12-31,ES68209528285169439268,TRX_N-00226-10465698,2022-07-08T21:33:20,Portugalete,expenses,education,-64.76,-15905.71
buyer_7,Mar√≠a,,1968-12-31,ES68209528285169439268,TRX_N-00227-62483071,2022-07-10T20:14:58,Portugalete,expenses,food,-124.41,-16030.12
buyer_7,Mar√≠a,,1968-12-31,ES68209528285169439268,TRX_N-00228-33580506,2022-07-10T11:24:26,Portugalete,expenses,gifts,-337.88,-16368.0
buyer_7,Mar√≠a,,1968-12-31,ES68209528285169439268,TRX_N-00229-53683938,2022-07-11T09:16:28,Barakaldo,expenses,transport,-50.26,-16418.26
buyer_7,Mar√≠a,,1968-12-31,ES68209528285169439268,TRX_N-00230-00313064,2022-07-12T13:52:47,Portugalete,expenses,food,-96.69,-16514.95
buyer_7,Mar√≠a,,1968-12-31,ES68209528285169439268,TRX_N-00231-44724406,2022-07-12T20:11:59,Irun,expenses,transport,-88.72,-16603.67
buyer_7,Mar√≠a,,1968-12-31,ES68209528285169439268,TRX_N-00232-00413473,2022-07-13T18:40:06,Portugalete,expenses,clothing,-80.04,-16683.71
buyer_7,Mar√≠a,,1968-12-31,ES68209528285169439268,TRX_N-00233-80110484,2022-07-13T20:46:16,Portugalete,expenses,healthcare,-96.3,-16780.01
buyer_7,Mar√≠a,,1968-12-31,ES68209528285169439268,TRX_N-00234-61324512,2022-07-13T11:15:06,Portugalete,expenses,cash,-100.0,-16880.01
buyer_7,Mar√≠a,,1968-12-31,ES68209528285169439268,TRX_N-00235-48827013,2022-07-13T10:51:14,Portugalete,expenses,repairs,-147.55,-17027.56
buyer_7,Mar√≠a,,1968-12-31,ES68209528285169439268,TRX_N-00236-11168524,2022-07-14T22:54:58,Portugalete,expenses,clothing,-159.95,-17187.51
buyer_7,Mar√≠a,,1968-12-31,ES68209528285169439268,TRX_N-00237-35142810,2022-07-15T12:58:34,Portugalete,expenses,cash,-100.0,-17287.51
buyer_7,Mar√≠a,,1968-12-31,ES68209528285169439268,TRX_N-00238-52932211,2022-07-16T14:27:15,Portugalete,expenses,appliances,-194.45,-17481.96
buyer_7,Mar√≠a,,1968-12-31,ES68209528285169439268,TRX_N-00239-61286822,2022-07-17T10:29:47,Portugalete,expenses,appliances,-229.57,-17711.53
buyer_7,Mar√≠a,,1968-12-31,ES68209528285169439268,TRX_N-00240-42963011,2022-07-17T12:12:49,Portugalete,expenses,gifts,-633.53,-18345.06
buyer_7,Mar√≠a,,1968-12-31,ES68209528285169439268,TRX_N-00241-77797243,2022-07-18T10:07:22,Portugalete,expenses,leisure,-40.54,-18385.6
buyer_7,Mar√≠a,,1968-12-31,ES68209528285169439268,TRX_N-00242-77909862,2022-07-20T14:10:48,Portugalete,expenses,education,-63.02,-18448.62
buyer_7,Mar√≠a,,1968-12-31,ES68209528285169439268,TRX_N-00243-77068361,2022-07-20T17:18:22,Portugalete,expenses,cash,-100.0,-18548.62
buyer_7,Mar√≠a,,1968-12-31,ES68209528285169439268,TRX_N-00244-59956011,2022-07-21T18:07:38,Portugalete,expenses,gifts,-536.93,-19085.55
buyer_7,Mar√≠a,,1968-12-31,ES68209528285169439268,TRX_N-00245-90464273,2022-07-23T12:55:52,Portugalete,expenses,repairs,-270.6,-19356.15
buyer_7,Mar√≠a,,1968-12-31,ES68209528285169439268,TRX_N-00246-11200219,2022-07-26T05:40:55,Portugalete,expenses,repairs,-217.83,-19573.98
buyer_7,Mar√≠a,,1968-12-31,ES68209528285169439268,TRX_N-00247-36886217,2022-07-28T18:39:43,Zarautz,expenses,clothing,-93.17,-19667.15
buyer_7,Mar√≠a,,1968-12-31,ES68209528285169439268,TRX_N-00248-83204726,2022-07-30T12:34:14,Portugalete,expenses,repairs,-41.83,-19708.98
buyer_7,Mar√≠a,,1968-12-31,ES68209528285169439268,TRX_N-00249-28783721,2022-07-31T12:15:39,Portugalete,expenses,food,-93.43,-19802.41
buyer_7,Mar√≠a,,1968-12-31,ES68209528285169439268,TRX_N-00250-82281659,2022-07-31T17:11:16,Portugalete,expenses,healthcare,-167.01,-19969.42
buyer_7,Mar√≠a,,1968-12-31,ES68209528285169439268,TRX_N-00251-55831429,2022-08-01T11:37:14,Portugalete,incomes,salary,1272.95,-18696.47
buyer_7,Mar√≠a,,1968-12-31,ES68209528285169439268,TRX_N-00252-74677719,2022-08-01T15:17:01,Portugalete,expenses,repairs,-252.8,-18949.27
buyer_7,Mar√≠a,,1968-12-31,ES68209528285169439268,TRX_N-00253-34239737,2022-08-04T12:27:11,Portugalete,expenses,mortgage,-764.17,-19713.44
buyer_7,Mar√≠a,,1968-12-31,ES68209528285169439268,TRX_N-00254-15140527,2022-08-04T17:04:28,Alegr√≠a-Dulantzi,expenses,gifts,-251.84,-19965.28
buyer_7,Mar√≠a,,1968-12-31,ES68209528285169439268,TRX_N-00255-27811458,2022-08-05T12:05:27,Portugalete,expenses,water,-38.36,-20003.64
buyer_7,Mar√≠a,,1968-12-31,ES68209528285169439268,TRX_N-00256-15110659,2022-08-06T08:51:36,Portugalete,expenses,phone,-36.45,-20040.09
buyer_7,Mar√≠a,,1968-12-31,ES68209528285169439268,TRX_N-00257-17847027,2022-08-06T07:35:22,Andoain,expenses,leisure,-42.95,-20083.04
buyer_7,Mar√≠a,,1968-12-31,ES68209528285169439268,TRX_N-00258-21253670,2022-08-07T10:11:08,Portugalete,expenses,electricity,-61.06,-20144.1
buyer_7,Mar√≠a,,1968-12-31,ES68209528285169439268,TRX_N-00259-52812788,2022-08-07T17:26:16,Portugalete,expenses,food,-79.15,-20223.25
buyer_7,Mar√≠a,,1968-12-31,ES68209528285169439268,TRX_N-00260-79413696,2022-08-07T09:33:25,Portugalete,expenses,appliances,-86.65,-20309.9
buyer_7,Mar√≠a,,1968-12-31,ES68209528285169439268,TRX_N-00261-78865731,2022-08-07T19:47:16,Portugalete,expenses,repairs,-194.88,-20504.78
buyer_7,Mar√≠a,,1968-12-31,ES68209528285169439268,TRX_N-00262-50351349,2022-08-08T16:38:51,Portugalete,expenses,gas,-44.16,-20548.94
buyer_7,Mar√≠a,,1968-12-31,ES68209528285169439268,TRX_N-00263-47255103,2022-08-08T23:53:32,Portugalete,expenses,internet,-42.0,-20590.94
buyer_7,Mar√≠a,,1968-12-31,ES68209528285169439268,TRX_N-00264-57707841,2022-08-10T12:06:02,Portugalete,expenses,transport,-51.74,-20642.68
buyer_7,Mar√≠a,,1968-12-31,ES68209528285169439268,TRX_N-00265-22423606,2022-08-12T19:01:43,Mungia,expenses,leisure,-70.71,-20713.39
buyer_7,Mar√≠a,,1968-12-31,ES68209528285169439268,TRX_N-00266-63765531,2022-08-12T13:10:20,Portugalete,expenses,clothing,-144.58,-20857.97
buyer_7,Mar√≠a,,1968-12-31,ES68209528285169439268,TRX_N-00267-44590442,2022-08-13T05:20:56,Portugalete,expenses,food,-64.98,-20922.95
buyer_7,Mar√≠a,,1968-12-31,ES68209528285169439268,TRX_N-00268-36040806,2022-08-13T10:13:42,Portugalete,expenses,cash,-100.0,-21022.95
buyer_7,Mar√≠a,,1968-12-31,ES68209528285169439268,TRX_N-00269-81749716,2022-08-14T08:39:08,Leioa,expenses,leisure,-39.4,-21062.35
buyer_7,Mar√≠a,,1968-12-31,ES68209528285169439268,TRX_N-00270-17062153,2022-08-14T10:52:55,Iru√±a de Oca,expenses,gifts,-371.23,-21433.58
buyer_7,Mar√≠a,,1968-12-31,ES68209528285169439268,TRX_N-00271-78989237,2022-08-15T17:11:59,Erandio,expenses,gifts,-822.57,-22256.15
buyer_7,Mar√≠a,,1968-12-31,ES68209528285169439268,TRX_N-00272-29641444,2022-08-16T15:40:11,Portugalete,expenses,gifts,-252.97,-22509.12
buyer_7,Mar√≠a,,1968-12-31,ES68209528285169439268,TRX_N-00273-56715209,2022-08-17T15:40:12,Portugalete,expenses,healthcare,-46.44,-22555.56
buyer_7,Mar√≠a,,1968-12-31,ES68209528285169439268,TRX_N-00274-87686300,2022-08-18T21:53:34,Portugalete,expenses,transport,-86.64,-22642.2
buyer_7,Mar√≠a,,1968-12-31,ES68209528285169439268,TRX_N-00275-99770709,2022-08-20T23:13:53,Portugalete,expenses,cash,-100.0,-22742.2
buyer_7,Mar√≠a,,1968-12-31,ES68209528285169439268,TRX_N-00276-66928208,2022-08-22T13:09:24,Irun,expenses,leisure,-25.45,-22767.65
buyer_7,Mar√≠a,,1968-12-31,ES68209528285169439268,TRX_N-00277-18663094,2022-08-23T17:00:49,Portugalete,expenses,leisure,-77.34,-22844.99
buyer_7,Mar√≠a,,1968-12-31,ES68209528285169439268,TRX_N-00278-28293789,2022-08-26T16:24:03,Portugalete,expenses,transport,-87.81,-22932.8
buyer_7,Mar√≠a,,1968-12-31,ES68209528285169439268,TRX_N-00279-41719436,2022-08-27T13:13:23,Zuia,expenses,education,-76.82,-23009.62
buyer_7,Mar√≠a,,1968-12-31,ES68209528285169439268,TRX_N-00280-20343025,2022-08-28T11:32:57,Portugalete,expenses,cash,-100.0,-23109.62
buyer_7,Mar√≠a,,1968-12-31,ES68209528285169439268,TRX_N-00281-11833088,2022-08-29T15:28:57,Portugalete,expenses,food,-122.76,-23232.38
buyer_7,Mar√≠a,,1968-12-31,ES68209528285169439268,TRX_N-00282-17988113,2022-09-01T09:05:02,Portugalete,incomes,salary,1272.95,-21959.43
buyer_7,Mar√≠a,,1968-12-31,ES68209528285169439268,TRX_N-00283-79577687,2022-09-01T17:24:40,Lasarte-Oria,expenses,food,-61.22,-22020.65
buyer_7,Mar√≠a,,1968-12-31,ES68209528285169439268,TRX_N-00284-07934864,2022-09-01T16:51:24,Portugalete,expenses,transport,-57.96,-22078.61
buyer_7,Mar√≠a,,1968-12-31,ES68209528285169439268,TRX_N-00285-85034454,2022-09-01T19:44:45,Portugalete,expenses,leisure,-82.89,-22161.5
buyer_7,Mar√≠a,,1968-12-31,ES68209528285169439268,TRX_N-00286-73010831,2022-09-02T18:12:31,Portugalete,expenses,leisure,-40.57,-22202.07
buyer_7,Mar√≠a,,1968-12-31,ES68209528285169439268,TRX_N-00287-80653514,2022-09-04T21:43:38,Portugalete,expenses,mortgage,-764.17,-22966.24
buyer_7,Mar√≠a,,1968-12-31,ES68209528285169439268,TRX_N-00288-79944477,2022-09-04T11:26:36,Portugalete,expenses,food,-96.66,-23062.9
buyer_7,Mar√≠a,,1968-12-31,ES68209528285169439268,TRX_N-00289-61826832,2022-09-05T14:09:44,Portugalete,expenses,internet,-42.0,-23104.9
buyer_7,Mar√≠a,,1968-12-31,ES68209528285169439268,TRX_N-00290-72761270,2022-09-05T14:51:51,Portugalete,expenses,food,-70.88,-23175.78
buyer_7,Mar√≠a,,1968-12-31,ES68209528285169439268,TRX_N-00291-79532391,2022-09-06T20:57:59,Portugalete,expenses,food,-122.87,-23298.65
buyer_7,Mar√≠a,,1968-12-31,ES68209528285169439268,TRX_N-00292-73571083,2022-09-07T09:05:49,Portugalete,expenses,food,-87.45,-23386.1
buyer_7,Mar√≠a,,1968-12-31,ES68209528285169439268,TRX_N-00293-65998748,2022-09-07T09:38:40,Portugalete,expenses,repairs,-179.93,-23566.03
buyer_7,Mar√≠a,,1968-12-31,ES68209528285169439268,TRX_N-00294-05001321,2022-09-08T22:48:05,Portugalete,expenses,electricity,-71.83,-23637.86
buyer_7,Mar√≠a,,1968-12-31,ES68209528285169439268,TRX_N-00295-15168247,2022-09-08T22:46:12,Portugalete,expenses,water,-37.22,-23675.08
buyer_7,Mar√≠a,,1968-12-31,ES68209528285169439268,TRX_N-00296-35343042,2022-09-08T14:35:08,Portugalete,expenses,gas,-42.45,-23717.53
buyer_7,Mar√≠a,,1968-12-31,ES68209528285169439268,TRX_N-00297-27870629,2022-09-08T11:50:11,Portugalete,expenses,phone,-44.1,-23761.63
buyer_7,Mar√≠a,,1968-12-31,ES68209528285169439268,TRX_N-00298-02635060,2022-09-08T09:18:11,Zuia,expenses,gifts,-769.82,-24531.45
buyer_7,Mar√≠a,,1968-12-31,ES68209528285169439268,TRX_N-00299-98185597,2022-09-11T19:28:21,Portugalete,expenses,cash,-100.0,-24631.45
buyer_7,Mar√≠a,,1968-12-31,ES68209528285169439268,TRX_N-00300-37948692,2022-09-12T05:46:13,Portugalete,expenses,cash,-100.0,-24731.45
buyer_7,Mar√≠a,,1968-12-31,ES68209528285169439268,TRX_N-00301-96723482,2022-09-14T05:54:12,Portugalete,expenses,transport,-61.28,-24792.73
buyer_7,Mar√≠a,,1968-12-31,ES68209528285169439268,TRX_N-00302-47000322,2022-09-15T10:03:22,Portugalete,expenses,cash,-100.0,-24892.73
buyer_7,Mar√≠a,,1968-12-31,ES68209528285169439268,TRX_N-00303-32394767,2022-09-16T14:45:35,Portugalete,expenses,clothing,-147.23,-25039.96
buyer_7,Mar√≠a,,1968-12-31,ES68209528285169439268,TRX_N-00304-87483261,2022-09-17T13:36:19,Portugalete,expenses,transport,-89.89,-25129.85
buyer_7,Mar√≠a,,1968-12-31,ES68209528285169439268,TRX_N-00305-10087130,2022-09-17T13:46:26,Portugalete,expenses,children,-181.87,-25311.72
buyer_7,Mar√≠a,,1968-12-31,ES68209528285169439268,TRX_N-00306-73847813,2022-09-18T12:20:47,Portugalete,expenses,transport,-41.39,-25353.11
buyer_7,Mar√≠a,,1968-12-31,ES68209528285169439268,TRX_N-00307-40067545,2022-09-18T13:54:14,Portugalete,expenses,cash,-100.0,-25453.11
buyer_7,Mar√≠a,,1968-12-31,ES68209528285169439268,TRX_N-00308-21124933,2022-09-20T03:13:48,Sestao,expenses,food,-106.54,-25559.65
buyer_7,Mar√≠a,,1968-12-31,ES68209528285169439268,TRX_N-00309-89516540,2022-09-21T20:08:49,Portugalete,expenses,food,-77.57,-25637.22
buyer_7,Mar√≠a,,1968-12-31,ES68209528285169439268,TRX_N-00310-78099691,2022-09-24T19:30:23,Amurrio,expenses,leisure,-68.45,-25705.67
buyer_7,Mar√≠a,,1968-12-31,ES68209528285169439268,TRX_N-00311-09477264,2022-09-26T12:15:43,Portugalete,expenses,food,-82.89,-25788.56
buyer_7,Mar√≠a,,1968-12-31,ES68209528285169439268,TRX_N-00312-54863337,2022-09-29T14:18:46,Portugalete,expenses,food,-84.38,-25872.94
buyer_7,Mar√≠a,,1968-12-31,ES68209528285169439268,TRX_N-00313-11908269,2022-09-29T12:42:45,Portugalete,expenses,transport,-41.97,-25914.91
buyer_7,Mar√≠a,,1968-12-31,ES68209528285169439268,TRX_N-00314-60029012,2022-09-29T18:25:51,Portugalete,expenses,clothing,-150.13,-26065.04
buyer_7,Mar√≠a,,1968-12-31,ES68209528285169439268,TRX_N-00315-43030176,2022-10-01T20:40:13,Portugalete,incomes,salary,1272.95,-24792.09
buyer_7,Mar√≠a,,1968-12-31,ES68209528285169439268,TRX_N-00316-51486737,2022-10-02T19:47:46,Portugalete,expenses,leisure,-26.24,-24818.33
buyer_7,Mar√≠a,,1968-12-31,ES68209528285169439268,TRX_N-00317-43077653,2022-10-03T09:46:46,Portugalete,expenses,food,-93.64,-24911.97
buyer_7,Mar√≠a,,1968-12-31,ES68209528285169439268,TRX_N-00318-61267347,2022-10-04T05:09:47,Portugalete,expenses,mortgage,-764.17,-25676.14
buyer_7,Mar√≠a,,1968-12-31,ES68209528285169439268,TRX_N-00319-46299128,2022-10-05T03:49:49,Portugalete,expenses,electricity,-37.05,-25713.19
buyer_7,Mar√≠a,,1968-12-31,ES68209528285169439268,TRX_N-00320-32058633,2022-10-05T20:01:40,Portugalete,expenses,phone,-39.43,-25752.62
buyer_7,Mar√≠a,,1968-12-31,ES68209528285169439268,TRX_N-00321-30367744,2022-10-06T14:52:11,Portugalete,expenses,internet,-42.0,-25794.62
buyer_7,Mar√≠a,,1968-12-31,ES68209528285169439268,TRX_N-00322-19949823,2022-10-06T11:20:21,Portugalete,expenses,food,-105.97,-25900.59
buyer_7,Mar√≠a,,1968-12-31,ES68209528285169439268,TRX_N-00323-38812760,2022-10-07T05:18:57,Portugalete,expenses,food,-102.31,-26002.9
buyer_7,Mar√≠a,,1968-12-31,ES68209528285169439268,TRX_N-00324-15222488,2022-10-08T15:49:07,Portugalete,expenses,water,-38.48,-26041.38
buyer_7,Mar√≠a,,1968-12-31,ES68209528285169439268,TRX_N-00325-17788534,2022-10-08T15:31:23,Portugalete,expenses,gas,-74.22,-26115.6
buyer_7,Mar√≠a,,1968-12-31,ES68209528285169439268,TRX_N-00326-04554396,2022-10-08T18:03:06,Portugalete,expenses,cash,-100.0,-26215.6
buyer_7,Mar√≠a,,1968-12-31,ES68209528285169439268,TRX_N-00327-54757668,2022-10-10T13:10:55,Portugalete,expenses,food,-93.55,-26309.15
buyer_7,Mar√≠a,,1968-12-31,ES68209528285169439268,TRX_N-00328-45658558,2022-10-11T19:41:10,Bilbao,expenses,food,-113.17,-26422.32
buyer_7,Mar√≠a,,1968-12-31,ES68209528285169439268,TRX_N-00329-97215993,2022-10-11T19:41:00,Portugalete,expenses,healthcare,-92.58,-26514.9
buyer_7,Mar√≠a,,1968-12-31,ES68209528285169439268,TRX_N-00330-17842520,2022-10-15T21:55:15,Portugalete,expenses,clothing,-92.12,-26607.02
buyer_7,Mar√≠a,,1968-12-31,ES68209528285169439268,TRX_N-00331-98513131,2022-10-15T08:52:30,Bermeo,expenses,repairs,-47.67,-26654.69
buyer_7,Mar√≠a,,1968-12-31,ES68209528285169439268,TRX_N-00332-97626220,2022-10-17T12:04:51,Labastida,expenses,transport,-79.96,-26734.65
buyer_7,Mar√≠a,,1968-12-31,ES68209528285169439268,TRX_N-00333-20075283,2022-10-18T20:03:41,Portugalete,expenses,children,-437.27,-27171.92
buyer_7,Mar√≠a,,1968-12-31,ES68209528285169439268,TRX_N-00334-23657672,2022-10-19T20:49:46,Portugalete,expenses,food,-118.08,-27290.0
buyer_7,Mar√≠a,,1968-12-31,ES68209528285169439268,TRX_N-00335-63288438,2022-10-19T20:04:29,Portugalete,expenses,gifts,-409.7,-27699.7
buyer_7,Mar√≠a,,1968-12-31,ES68209528285169439268,TRX_N-00336-19525026,2022-10-20T01:12:40,Portugalete,expenses,food,-68.94,-27768.64
buyer_7,Mar√≠a,,1968-12-31,ES68209528285169439268,TRX_N-00337-16394536,2022-10-21T12:10:24,Portugalete,expenses,gifts,-298.45,-28067.09
buyer_7,Mar√≠a,,1968-12-31,ES68209528285169439268,TRX_N-00338-84112433,2022-10-23T09:55:36,Portugalete,expenses,repairs,-30.67,-28097.76
buyer_7,Mar√≠a,,1968-12-31,ES68209528285169439268,TRX_N-00339-19340458,2022-10-24T16:40:49,Elciego,expenses,leisure,-40.07,-28137.83
buyer_7,Mar√≠a,,1968-12-31,ES68209528285169439268,TRX_N-00340-99526363,2022-10-28T17:24:56,Portugalete,expenses,food,-121.97,-28259.8
buyer_7,Mar√≠a,,1968-12-31,ES68209528285169439268,TRX_N-00341-63641970,2022-10-29T08:47:33,Portugalete,expenses,transport,-44.93,-28304.73
buyer_7,Mar√≠a,,1968-12-31,ES68209528285169439268,TRX_N-00342-45960063,2022-10-31T22:07:55,Basauri,expenses,repairs,-267.12,-28571.85
buyer_7,Mar√≠a,,1968-12-31,ES68209528285169439268,TRX_N-00343-43415640,2022-10-31T10:15:18,Portugalete,expenses,children,-370.86,-28942.71
buyer_7,Mar√≠a,,1968-12-31,ES68209528285169439268,TRX_N-00344-72649122,2022-11-01T19:45:48,Portugalete,incomes,salary,1272.95,-27669.76
buyer_7,Mar√≠a,,1968-12-31,ES68209528285169439268,TRX_N-00345-25180378,2022-11-01T19:45:48,Portugalete,incomes,extra_income,186.42,-27483.34
buyer_7,Mar√≠a,,1968-12-31,ES68209528285169439268,TRX_N-00346-56335473,2022-11-01T20:20:48,Portugalete,expenses,travel,-670.65,-28153.99
buyer_7,Mar√≠a,,1968-12-31,ES68209528285169439268,TRX_N-00347-64857488,2022-11-01T11:48:58,Portugalete,expenses,children,-277.21,-28431.2
buyer_7,Mar√≠a,,1968-12-31,ES68209528285169439268,TRX_N-00348-78727469,2022-11-02T17:57:04,Portugalete,expenses,leisure,-32.0,-28463.2
buyer_7,Mar√≠a,,1968-12-31,ES68209528285169439268,TRX_N-00349-91012723,2022-11-03T14:57:12,Portugalete,expenses,food,-76.86,-28540.06
buyer_7,Mar√≠a,,1968-12-31,ES68209528285169439268,TRX_N-00350-61950172,2022-11-04T20:08:38,Portugalete,expenses,mortgage,-764.17,-29304.23
buyer_7,Mar√≠a,,1968-12-31,ES68209528285169439268,TRX_N-00351-45414214,2022-11-04T12:01:26,Vitoria-Gasteiz,expenses,leisure,-60.67,-29364.9
buyer_7,Mar√≠a,,1968-12-31,ES68209528285169439268,TRX_N-00352-32964587,2022-11-05T20:20:28,Portugalete,expenses,electricity,-85.71,-29450.61
buyer_7,Mar√≠a,,1968-12-31,ES68209528285169439268,TRX_N-00353-94217143,2022-11-05T20:13:52,Portugalete,expenses,internet,-42.0,-29492.61
buyer_7,Mar√≠a,,1968-12-31,ES68209528285169439268,TRX_N-00354-34890575,2022-11-05T11:41:36,Portugalete,expenses,food,-93.18,-29585.79
buyer_7,Mar√≠a,,1968-12-31,ES68209528285169439268,TRX_N-00355-77210762,2022-11-06T19:34:12,Portugalete,expenses,water,-31.11,-29616.9
buyer_7,Mar√≠a,,1968-12-31,ES68209528285169439268,TRX_N-00356-54884622,2022-11-06T19:29:08,Leioa,expenses,food,-89.24,-29706.14
buyer_7,Mar√≠a,,1968-12-31,ES68209528285169439268,TRX_N-00357-43389047,2022-11-07T20:02:19,Portugalete,expenses,food,-121.64,-29827.78
buyer_7,Mar√≠a,,1968-12-31,ES68209528285169439268,TRX_N-00358-20245523,2022-11-07T09:29:46,Portugalete,expenses,appliances,-363.2,-30190.98
buyer_7,Mar√≠a,,1968-12-31,ES68209528285169439268,TRX_N-00359-59973568,2022-11-08T22:45:30,Portugalete,expenses,gas,-91.09,-30282.07
buyer_7,Mar√≠a,,1968-12-31,ES68209528285169439268,TRX_N-00360-74589964,2022-11-08T09:28:58,Portugalete,expenses,phone,-42.34,-30324.41
buyer_7,Mar√≠a,,1968-12-31,ES68209528285169439268,TRX_N-00361-77704043,2022-11-08T08:10:56,Portugalete,expenses,food,-77.88,-30402.29
buyer_7,Mar√≠a,,1968-12-31,ES68209528285169439268,TRX_N-00362-46324087,2022-11-09T10:47:45,Portugalete,expenses,travel,-527.15,-30929.44
buyer_7,Mar√≠a,,1968-12-31,ES68209528285169439268,TRX_N-00363-38374587,2022-11-10T00:05:30,Portugalete,expenses,leisure,-57.37,-30986.81
buyer_7,Mar√≠a,,1968-12-31,ES68209528285169439268,TRX_N-00364-55849991,2022-11-10T10:55:07,Portugalete,expenses,repairs,-142.55,-31129.36
buyer_7,Mar√≠a,,1968-12-31,ES68209528285169439268,TRX_N-00365-46918832,2022-11-11T20:41:19,Portugalete,expenses,transport,-60.77,-31190.13
buyer_7,Mar√≠a,,1968-12-31,ES68209528285169439268,TRX_N-00366-53495005,2022-11-13T14:56:40,Portugalete,expenses,cash,-100.0,-31290.13
buyer_7,Mar√≠a,,1968-12-31,ES68209528285169439268,TRX_N-00367-18425757,2022-11-13T16:33:00,Getxo,expenses,repairs,-218.15,-31508.28
buyer_7,Mar√≠a,,1968-12-31,ES68209528285169439268,TRX_N-00368-53110612,2022-11-15T10:28:20,Zarautz,expenses,cash,-100.0,-31608.28
buyer_7,Mar√≠a,,1968-12-31,ES68209528285169439268,TRX_N-00369-36032132,2022-11-16T12:57:44,Portugalete,expenses,food,-100.89,-31709.17
buyer_7,Mar√≠a,,1968-12-31,ES68209528285169439268,TRX_N-00370-28885673,2022-11-16T04:16:01,Portugalete,expenses,leisure,-52.43,-31761.6
buyer_7,Mar√≠a,,1968-12-31,ES68209528285169439268,TRX_N-00371-73521751,2022-11-18T19:13:10,Portugalete,expenses,cash,-100.0,-31861.6
buyer_7,Mar√≠a,,1968-12-31,ES68209528285169439268,TRX_N-00372-59217802,2022-11-19T23:03:46,Portugalete,expenses,education,-51.83,-31913.43
buyer_7,Mar√≠a,,1968-12-31,ES68209528285169439268,TRX_N-00373-40401784,2022-11-19T14:21:02,Portugalete,expenses,cash,-100.0,-32013.43
buyer_7,Mar√≠a,,1968-12-31,ES68209528285169439268,TRX_N-00374-39008945,2022-11-20T09:46:37,Portugalete,expenses,education,-64.6,-32078.03
buyer_7,Mar√≠a,,1968-12-31,ES68209528285169439268,TRX_N-00375-57562310,2022-11-20T23:44:18,Portugalete,expenses,cash,-100.0,-32178.03
buyer_7,Mar√≠a,,1968-12-31,ES68209528285169439268,TRX_N-00376-78528662,2022-11-21T20:08:28,Portugalete,expenses,healthcare,-64.17,-32242.2
buyer_7,Mar√≠a,,1968-12-31,ES68209528285169439268,TRX_N-00377-00141393,2022-11-21T11:25:48,Portugalete,expenses,cash,-100.0,-32342.2
buyer_7,Mar√≠a,,1968-12-31,ES68209528285169439268,TRX_N-00378-54958316,2022-11-22T11:45:01,Portugalete,expenses,food,-74.07,-32416.27
buyer_7,Mar√≠a,,1968-12-31,ES68209528285169439268,TRX_N-00379-31093939,2022-11-23T18:20:06,Portugalete,expenses,food,-80.16,-32496.43
buyer_7,Mar√≠a,,1968-12-31,ES68209528285169439268,TRX_N-00380-97531871,2022-11-23T09:58:27,Portugalete,expenses,transport,-71.53,-32567.96
buyer_7,Mar√≠a,,1968-12-31,ES68209528285169439268,TRX_N-00381-75807221,2022-11-23T23:15:35,Portugalete,expenses,appliances,-391.94,-32959.9
buyer_7,Mar√≠a,,1968-12-31,ES68209528285169439268,TRX_N-00382-83519851,2022-11-26T21:05:30,Portugalete,expenses,leisure,-59.7,-33019.6
buyer_7,Mar√≠a,,1968-12-31,ES68209528285169439268,TRX_N-00383-66998987,2022-11-27T09:43:58,Portugalete,expenses,transport,-79.32,-33098.92
buyer_7,Mar√≠a,,1968-12-31,ES68209528285169439268,TRX_N-00384-55405629,2022-11-28T20:13:36,Andoain,expenses,cash,-100.0,-33198.92
buyer_7,Mar√≠a,,1968-12-31,ES68209528285169439268,TRX_N-00385-81606700,2022-11-29T05:14:27,Portugalete,expenses,transport,-64.47,-33263.39
buyer_7,Mar√≠a,,1968-12-31,ES68209528285169439268,TRX_N-00386-97089764,2022-11-30T19:59:27,Portugalete,expenses,clothing,-107.15,-33370.54
buyer_7,Mar√≠a,,1968-12-31,ES68209528285169439268,TRX_N-00387-27222824,2022-11-30T13:14:36,Portugalete,expenses,education,-64.55,-33435.09
buyer_7,Mar√≠a,,1968-12-31,ES68209528285169439268,TRX_N-00388-32068023,2022-12-01T06:06:22,Portugalete,incomes,salary,1272.95,-32162.14
buyer_7,Mar√≠a,,1968-12-31,ES68209528285169439268,TRX_N-00389-09697718,2022-12-01T06:06:22,Portugalete,incomes,salary_bonus,1002.3,-31159.84
buyer_7,Mar√≠a,,1968-12-31,ES68209528285169439268,TRX_N-00390-10990048,2022-12-01T08:19:49,Portugalete,expenses,leisure,-33.77,-31193.61
buyer_7,Mar√≠a,,1968-12-31,ES68209528285169439268,TRX_N-00391-91272329,2022-12-01T03:04:23,Portugalete,expenses,healthcare,-119.02,-31312.63
buyer_7,Mar√≠a,,1968-12-31,ES68209528285169439268,TRX_N-00392-59251078,2022-12-02T21:43:02,Portugalete,expenses,education,-77.48,-31390.11
buyer_7,Mar√≠a,,1968-12-31,ES68209528285169439268,TRX_N-00393-17194023,2022-12-04T15:07:04,Portugalete,expenses,mortgage,-764.17,-32154.28
buyer_7,Mar√≠a,,1968-12-31,ES68209528285169439268,TRX_N-00394-97362981,2022-12-04T10:27:57,Portugalete,expenses,food,-111.74,-32266.02
buyer_7,Mar√≠a,,1968-12-31,ES68209528285169439268,TRX_N-00395-93124289,2022-12-04T16:29:28,Donostia,expenses,appliances,-109.18,-32375.2
buyer_7,Mar√≠a,,1968-12-31,ES68209528285169439268,TRX_N-00396-75674064,2022-12-04T09:11:47,Portugalete,expenses,repairs,-156.8,-32532.0
buyer_7,Mar√≠a,,1968-12-31,ES68209528285169439268,TRX_N-00397-04727012,2022-12-05T11:18:52,Portugalete,expenses,appliances,-161.71,-32693.71
buyer_7,Mar√≠a,,1968-12-31,ES68209528285169439268,TRX_N-00398-66274826,2022-12-06T21:30:22,Portugalete,expenses,water,-31.43,-32725.14
buyer_7,Mar√≠a,,1968-12-31,ES68209528285169439268,TRX_N-00399-20405984,2022-12-06T13:25:49,Portugalete,expenses,phone,-33.14,-32758.28
buyer_7,Mar√≠a,,1968-12-31,ES68209528285169439268,TRX_N-00400-76004800,2022-12-06T16:09:27,Portugalete,expenses,transport,-44.23,-32802.51
buyer_7,Mar√≠a,,1968-12-31,ES68209528285169439268,TRX_N-00401-06115545,2022-12-07T13:24:07,Portugalete,expenses,internet,-42.0,-32844.51
buyer_7,Mar√≠a,,1968-12-31,ES68209528285169439268,TRX_N-00402-47134706,2022-12-08T19:44:23,Portugalete,expenses,gas,-114.62,-32959.13
buyer_7,Mar√≠a,,1968-12-31,ES68209528285169439268,TRX_N-00403-95663483,2022-12-08T09:15:44,Portugalete,expenses,electricity,-27.7,-32986.83
buyer_7,Mar√≠a,,1968-12-31,ES68209528285169439268,TRX_N-00404-32628906,2022-12-08T18:06:06,Portugalete,expenses,cash,-100.0,-33086.83
buyer_7,Mar√≠a,,1968-12-31,ES68209528285169439268,TRX_N-00405-94237373,2022-12-08T09:50:38,Portugalete,expenses,repairs,-118.61,-33205.44
buyer_7,Mar√≠a,,1968-12-31,ES68209528285169439268,TRX_N-00406-50865302,2022-12-09T13:34:57,Portugalete,expenses,leisure,-73.12,-33278.56
buyer_7,Mar√≠a,,1968-12-31,ES68209528285169439268,TRX_N-00407-48515995,2022-12-10T15:01:54,Portugalete,expenses,leisure,-49.54,-33328.1
buyer_7,Mar√≠a,,1968-12-31,ES68209528285169439268,TRX_N-00408-92197177,2022-12-11T13:33:53,Portugalete,expenses,repairs,-105.26,-33433.36
buyer_7,Mar√≠a,,1968-12-31,ES68209528285169439268,TRX_N-00409-92614872,2022-12-17T15:53:38,Portugalete,expenses,food,-95.17,-33528.53
buyer_7,Mar√≠a,,1968-12-31,ES68209528285169439268,TRX_N-00410-24171956,2022-12-17T13:57:20,Portugalete,expenses,cash,-100.0,-33628.53
buyer_7,Mar√≠a,,1968-12-31,ES68209528285169439268,TRX_N-00411-92423185,2022-12-21T16:04:57,Portugalete,expenses,education,-64.89,-33693.42
buyer_7,Mar√≠a,,1968-12-31,ES68209528285169439268,TRX_N-00412-46620275,2022-12-22T18:24:13,Portugalete,expenses,leisure,-78.27,-33771.69
buyer_7,Mar√≠a,,1968-12-31,ES68209528285169439268,TRX_N-00413-09528858,2022-12-24T09:48:39,Portugalete,expenses,leisure,-71.63,-33843.32
buyer_7,Mar√≠a,,1968-12-31,ES68209528285169439268,TRX_N-00414-12899422,2022-12-24T17:25:46,Portugalete,expenses,gifts,-52.73,-33896.05
buyer_7,Mar√≠a,,1968-12-31,ES68209528285169439268,TRX_N-00415-51096928,2022-12-25T20:45:31,Portugalete,expenses,food,-97.42,-33993.47
buyer_7,Mar√≠a,,1968-12-31,ES68209528285169439268,TRX_N-00416-88892665,2022-12-27T11:12:25,Portugalete,expenses,clothing,-142.2,-34135.67
buyer_7,Mar√≠a,,1968-12-31,ES68209528285169439268,TRX_N-00417-04870945,2022-12-28T19:11:48,Hernani,expenses,cash,-100.0,-34235.67
buyer_7,Mar√≠a,,1968-12-31,ES68209528285169439268,TRX_N-00418-77905975,2022-12-29T09:08:57,Portugalete,expenses,leisure,-35.09,-34270.76
buyer_7,Mar√≠a,,1968-12-31,ES68209528285169439268,TRX_N-00419-84177620,2022-12-31T20:34:20,Llodio,expenses,education,-63.08,-34333.84
buyer_7,Mar√≠a,,1968-12-31,ES68209528285169439268,TRX_N-00420-03996029,2023-01-01T10:52:45,Portugalete,incomes,salary,1321.01,-33012.83
buyer_7,Mar√≠a,,1968-12-31,ES68209528285169439268,TRX_N-00421-74549986,2023-01-04T11:55:08,Portugalete,expenses,mortgage,-764.17,-33777.0
buyer_7,Mar√≠a,,1968-12-31,ES68209528285169439268,TRX_N-00422-41919479,2023-01-04T08:55:14,Portugalete,expenses,leisure,-67.96,-33844.96
buyer_7,Mar√≠a,,1968-12-31,ES68209528285169439268,TRX_N-00423-01887627,2023-01-05T19:57:38,Portugalete,expenses,water,-35.76,-33880.72
buyer_7,Mar√≠a,,1968-12-31,ES68209528285169439268,TRX_N-00424-07555586,2023-01-05T11:06:21,Portugalete,expenses,internet,-42.0,-33922.72
buyer_7,Mar√≠a,,1968-12-31,ES68209528285169439268,TRX_N-00425-54166218,2023-01-06T14:50:34,Portugalete,expenses,gas,-108.21,-34030.93
buyer_7,Mar√≠a,,1968-12-31,ES68209528285169439268,TRX_N-00426-78063372,2023-01-06T18:57:30,Portugalete,expenses,phone,-35.29,-34066.22
buyer_7,Mar√≠a,,1968-12-31,ES68209528285169439268,TRX_N-00427-73498204,2023-01-07T20:13:45,Portugalete,expenses,electricity,-67.29,-34133.51
buyer_7,Mar√≠a,,1968-12-31,ES68209528285169439268,TRX_N-00428-56481394,2023-01-08T17:02:00,Santurtzi,expenses,transport,-50.73,-34184.24
buyer_7,Mar√≠a,,1968-12-31,ES68209528285169439268,TRX_N-00429-24482034,2023-01-08T18:01:49,Zuia,expenses,clothing,-123.02,-34307.26
buyer_7,Mar√≠a,,1968-12-31,ES68209528285169439268,TRX_N-00430-37273663,2023-01-09T11:31:30,Portugalete,expenses,clothing,-52.2,-34359.46
buyer_7,Mar√≠a,,1968-12-31,ES68209528285169439268,TRX_N-00431-22081284,2023-01-10T18:27:13,Iru√±a de Oca,expenses,food,-111.68,-34471.14
buyer_7,Mar√≠a,,1968-12-31,ES68209528285169439268,TRX_N-00432-76622838,2023-01-10T16:18:27,Portugalete,expenses,children,-507.83,-34978.97
buyer_7,Mar√≠a,,1968-12-31,ES68209528285169439268,TRX_N-00433-68342477,2023-01-11T16:51:51,Portugalete,expenses,transport,-79.07,-35058.04
buyer_7,Mar√≠a,,1968-12-31,ES68209528285169439268,TRX_N-00434-36107321,2023-01-11T23:52:37,Llodio,expenses,appliances,-307.71,-35365.75
buyer_7,Mar√≠a,,1968-12-31,ES68209528285169439268,TRX_N-00435-19924747,2023-01-13T08:33:28,Errenteria,expenses,cash,-100.0,-35465.75
buyer_7,Mar√≠a,,1968-12-31,ES68209528285169439268,TRX_N-00436-67568169,2023-01-15T12:10:09,Portugalete,expenses,cash,-100.0,-35565.75
buyer_7,Mar√≠a,,1968-12-31,ES68209528285169439268,TRX_N-00437-07293884,2023-01-18T16:57:41,Portugalete,expenses,education,-42.75,-35608.5
buyer_7,Mar√≠a,,1968-12-31,ES68209528285169439268,TRX_N-00438-53002343,2023-01-18T11:45:32,Portugalete,expenses,cash,-100.0,-35708.5
buyer_7,Mar√≠a,,1968-12-31,ES68209528285169439268,TRX_N-00439-98416411,2023-01-20T23:51:18,Pasaia,expenses,gifts,-487.81,-36196.31
buyer_7,Mar√≠a,,1968-12-31,ES68209528285169439268,TRX_N-00440-94675967,2023-01-21T12:33:53,Portugalete,expenses,cash,-100.0,-36296.31
buyer_7,Mar√≠a,,1968-12-31,ES68209528285169439268,TRX_N-00441-84027401,2023-01-22T12:04:58,Durango,expenses,transport,-77.63,-36373.94
buyer_7,Mar√≠a,,1968-12-31,ES68209528285169439268,TRX_N-00442-24261550,2023-01-22T12:38:58,Portugalete,expenses,healthcare,-94.09,-36468.03
buyer_7,Mar√≠a,,1968-12-31,ES68209528285169439268,TRX_N-00443-99028058,2023-01-23T15:28:40,Portugalete,expenses,transport,-45.53,-36513.56
buyer_7,Mar√≠a,,1968-12-31,ES68209528285169439268,TRX_N-00444-85170730,2023-01-23T18:43:12,Portugalete,expenses,leisure,-23.85,-36537.41
buyer_7,Mar√≠a,,1968-12-31,ES68209528285169439268,TRX_N-00445-41835415,2023-01-23T10:48:08,Portugalete,expenses,appliances,-407.74,-36945.15
buyer_7,Mar√≠a,,1968-12-31,ES68209528285169439268,TRX_N-00446-62256329,2023-01-24T00:52:01,Portugalete,expenses,appliances,-399.19,-37344.34
buyer_7,Mar√≠a,,1968-12-31,ES68209528285169439268,TRX_N-00447-77277944,2023-01-26T18:22:51,Portugalete,expenses,food,-121.38,-37465.72
buyer_7,Mar√≠a,,1968-12-31,ES68209528285169439268,TRX_N-00448-94008077,2023-01-26T18:11:26,Portugalete,expenses,repairs,-55.6,-37521.32
buyer_7,Mar√≠a,,1968-12-31,ES68209528285169439268,TRX_N-00449-10796462,2023-01-28T11:13:13,Portugalete,expenses,leisure,-73.45,-37594.77
buyer_7,Mar√≠a,,1968-12-31,ES68209528285169439268,TRX_N-00450-69982585,2023-01-28T15:45:18,Portugalete,expenses,clothing,-81.41,-37676.18
buyer_7,Mar√≠a,,1968-12-31,ES68209528285169439268,TRX_N-00451-47766445,2023-01-28T18:48:46,Portugalete,expenses,cash,-100.0,-37776.18
buyer_7,Mar√≠a,,1968-12-31,ES68209528285169439268,TRX_N-00452-61594516,2023-01-31T08:03:04,Portugalete,expenses,leisure,-35.17,-37811.35
buyer_7,Mar√≠a,,1968-12-31,ES68209528285169439268,TRX_N-00453-90012506,2023-02-01T13:31:10,Portugalete,incomes,salary,1321.01,-36490.34
buyer_7,Mar√≠a,,1968-12-31,ES68209528285169439268,TRX_N-00454-96556953,2023-02-02T17:47:57,Portugalete,expenses,gifts,-515.09,-37005.43
buyer_7,Mar√≠a,,1968-12-31,ES68209528285169439268,TRX_N-00455-76211302,2023-02-04T11:51:59,Portugalete,expenses,mortgage,-764.17,-37769.6
buyer_7,Mar√≠a,,1968-12-31,ES68209528285169439268,TRX_N-00456-63365381,2023-02-05T16:55:26,Portugalete,expenses,phone,-35.49,-37805.09
buyer_7,Mar√≠a,,1968-12-31,ES68209528285169439268,TRX_N-00457-89580975,2023-02-06T20:07:56,Portugalete,expenses,water,-30.5,-37835.59
buyer_7,Mar√≠a,,1968-12-31,ES68209528285169439268,TRX_N-00458-43854160,2023-02-06T15:19:20,Portugalete,expenses,cash,-100.0,-37935.59
buyer_7,Mar√≠a,,1968-12-31,ES68209528285169439268,TRX_N-00459-23738808,2023-02-07T20:25:31,Santurtzi,expenses,food,-94.35,-38029.94
buyer_7,Mar√≠a,,1968-12-31,ES68209528285169439268,TRX_N-00460-21439444,2023-02-07T11:13:51,Errenteria,expenses,transport,-84.07,-38114.01
buyer_7,Mar√≠a,,1968-12-31,ES68209528285169439268,TRX_N-00461-73166786,2023-02-07T17:13:46,Portugalete,expenses,healthcare,-65.4,-38179.41
buyer_7,Mar√≠a,,1968-12-31,ES68209528285169439268,TRX_N-00462-70067236,2023-02-07T13:02:48,Portugalete,expenses,cash,-100.0,-38279.41
buyer_7,Mar√≠a,,1968-12-31,ES68209528285169439268,TRX_N-00463-65417973,2023-02-08T19:37:42,Portugalete,expenses,electricity,-76.81,-38356.22
buyer_7,Mar√≠a,,1968-12-31,ES68209528285169439268,TRX_N-00464-07783119,2023-02-08T21:15:33,Portugalete,expenses,gas,-43.66,-38399.88
buyer_7,Mar√≠a,,1968-12-31,ES68209528285169439268,TRX_N-00465-51481830,2023-02-08T17:47:07,Portugalete,expenses,internet,-42.0,-38441.88
buyer_7,Mar√≠a,,1968-12-31,ES68209528285169439268,TRX_N-00466-73051786,2023-02-08T17:54:36,Portugalete,expenses,cash,-100.0,-38541.88
buyer_7,Mar√≠a,,1968-12-31,ES68209528285169439268,TRX_N-00467-96234028,2023-02-09T09:47:26,Sopela,expenses,transport,-88.7,-38630.58
buyer_7,Mar√≠a,,1968-12-31,ES68209528285169439268,TRX_N-00468-01246986,2023-02-09T16:39:53,Labastida,expenses,leisure,-62.78,-38693.36
buyer_7,Mar√≠a,,1968-12-31,ES68209528285169439268,TRX_N-00469-03497839,2023-02-09T19:03:58,Portugalete,expenses,repairs,-281.36,-38974.72
buyer_7,Mar√≠a,,1968-12-31,ES68209528285169439268,TRX_N-00470-29507053,2023-02-09T17:34:16,Portugalete,expenses,children,-432.56,-39407.28
buyer_7,Mar√≠a,,1968-12-31,ES68209528285169439268,TRX_N-00471-44411481,2023-02-10T18:22:40,Portugalete,expenses,clothing,-136.78,-39544.06
buyer_7,Mar√≠a,,1968-12-31,ES68209528285169439268,TRX_N-00472-05156805,2023-02-10T03:30:10,Portugalete,expenses,cash,-100.0,-39644.06
buyer_7,Mar√≠a,,1968-12-31,ES68209528285169439268,TRX_N-00473-68008327,2023-02-10T11:55:44,Portugalete,expenses,children,-563.47,-40207.53
buyer_7,Mar√≠a,,1968-12-31,ES68209528285169439268,TRX_N-00474-48580669,2023-02-11T16:28:35,Portugalete,expenses,food,-103.54,-40311.07
buyer_7,Mar√≠a,,1968-12-31,ES68209528285169439268,TRX_N-00475-14613525,2023-02-11T10:33:11,Portugalete,expenses,transport,-85.56,-40396.63
buyer_7,Mar√≠a,,1968-12-31,ES68209528285169439268,TRX_N-00476-54611783,2023-02-12T13:01:45,Portugalete,expenses,leisure,-72.36,-40468.99
buyer_7,Mar√≠a,,1968-12-31,ES68209528285169439268,TRX_N-00477-11567626,2023-02-12T11:49:27,Portugalete,expenses,cash,-100.0,-40568.99
buyer_7,Mar√≠a,,1968-12-31,ES68209528285169439268,TRX_N-00478-60124466,2023-02-14T09:46:54,Bilbao,expenses,leisure,-52.43,-40621.42
buyer_7,Mar√≠a,,1968-12-31,ES68209528285169439268,TRX_N-00479-61235742,2023-02-14T09:12:48,Portugalete,expenses,clothing,-127.16,-40748.58
buyer_7,Mar√≠a,,1968-12-31,ES68209528285169439268,TRX_N-00480-90593190,2023-02-15T18:20:37,Portugalete,expenses,food,-91.87,-40840.45
buyer_7,Mar√≠a,,1968-12-31,ES68209528285169439268,TRX_N-00481-54752034,2023-02-17T21:08:21,Portugalete,expenses,cash,-100.0,-40940.45
buyer_7,Mar√≠a,,1968-12-31,ES68209528285169439268,TRX_N-00482-88083578,2023-02-19T17:26:23,Portugalete,expenses,leisure,-32.44,-40972.89
buyer_7,Mar√≠a,,1968-12-31,ES68209528285169439268,TRX_N-00483-34503419,2023-02-24T10:06:31,Portugalete,expenses,cash,-100.0,-41072.89
buyer_7,Mar√≠a,,1968-12-31,ES68209528285169439268,TRX_N-00484-13532644,2023-03-01T17:27:14,Portugalete,incomes,salary,1321.01,-39751.88
buyer_7,Mar√≠a,,1968-12-31,ES68209528285169439268,TRX_N-00485-88935292,2023-03-01T17:27:14,Portugalete,incomes,extra_income,186.42,-39565.46
buyer_7,Mar√≠a,,1968-12-31,ES68209528285169439268,TRX_N-00486-86801811,2023-03-02T08:01:24,Portugalete,expenses,leisure,-45.74,-39611.2
buyer_7,Mar√≠a,,1968-12-31,ES68209528285169439268,TRX_N-00487-58665468,2023-03-04T18:59:04,Portugalete,expenses,mortgage,-764.17,-40375.37
buyer_7,Mar√≠a,,1968-12-31,ES68209528285169439268,TRX_N-00488-21787552,2023-03-04T19:24:11,Irun,expenses,food,-112.81,-40488.18
buyer_7,Mar√≠a,,1968-12-31,ES68209528285169439268,TRX_N-00489-24987063,2023-03-05T13:22:08,Portugalete,expenses,phone,-31.82,-40520.0
buyer_7,Mar√≠a,,1968-12-31,ES68209528285169439268,TRX_N-00490-53548442,2023-03-05T20:53:28,Portugalete,expenses,transport,-53.23,-40573.23
buyer_7,Mar√≠a,,1968-12-31,ES68209528285169439268,TRX_N-00491-86562808,2023-03-05T00:48:06,Arrasate,expenses,healthcare,-119.89,-40693.12
buyer_7,Mar√≠a,,1968-12-31,ES68209528285169439268,TRX_N-00492-87899663,2023-03-06T11:31:36,Portugalete,expenses,water,-20.7,-40713.82
buyer_7,Mar√≠a,,1968-12-31,ES68209528285169439268,TRX_N-00493-63430571,2023-03-06T19:49:29,Portugalete,expenses,children,-270.69,-40984.51
buyer_7,Mar√≠a,,1968-12-31,ES68209528285169439268,TRX_N-00494-25544114,2023-03-07T08:56:04,Portugalete,expenses,food,-65.96,-41050.47
buyer_7,Mar√≠a,,1968-12-31,ES68209528285169439268,TRX_N-00495-84485647,2023-03-08T10:50:11,Portugalete,expenses,electricity,-29.19,-41079.66
buyer_7,Mar√≠a,,1968-12-31,ES68209528285169439268,TRX_N-00496-03734875,2023-03-08T14:13:29,Portugalete,expenses,internet,-42.0,-41121.66
buyer_7,Mar√≠a,,1968-12-31,ES68209528285169439268,TRX_N-00497-51094004,2023-03-08T13:54:31,Portugalete,expenses,gas,-101.12,-41222.78
buyer_7,Mar√≠a,,1968-12-31,ES68209528285169439268,TRX_N-00498-40869355,2023-03-08T23:31:50,Berango,expenses,transport,-61.26,-41284.04
buyer_7,Mar√≠a,,1968-12-31,ES68209528285169439268,TRX_N-00499-59735882,2023-03-11T19:10:59,Portugalete,expenses,repairs,-311.0,-41595.04
buyer_7,Mar√≠a,,1968-12-31,ES68209528285169439268,TRX_N-00500-33454212,2023-03-12T10:06:20,Sopela,expenses,clothing,-58.69,-41653.73
buyer_7,Mar√≠a,,1968-12-31,ES68209528285169439268,TRX_N-00501-30660171,2023-03-13T16:45:35,Portugalete,expenses,transport,-50.93,-41704.66
buyer_7,Mar√≠a,,1968-12-31,ES68209528285169439268,TRX_N-00502-53368372,2023-03-13T19:27:07,Portugalete,expenses,cash,-100.0,-41804.66
buyer_7,Mar√≠a,,1968-12-31,ES68209528285169439268,TRX_N-00503-32296327,2023-03-15T13:25:18,Portugalete,expenses,healthcare,-78.39,-41883.05
buyer_7,Mar√≠a,,1968-12-31,ES68209528285169439268,TRX_N-00504-91805306,2023-03-18T13:52:33,Sopela,expenses,food,-78.29,-41961.34
buyer_7,Mar√≠a,,1968-12-31,ES68209528285169439268,TRX_N-00505-67540703,2023-03-18T15:03:07,Donostia,expenses,clothing,-111.15,-42072.49
buyer_7,Mar√≠a,,1968-12-31,ES68209528285169439268,TRX_N-00506-52198166,2023-03-19T19:00:27,Portugalete,expenses,gifts,-541.07,-42613.56
buyer_7,Mar√≠a,,1968-12-31,ES68209528285169439268,TRX_N-00507-60773981,2023-03-21T18:29:05,Irun,expenses,gifts,-529.16,-43142.72
buyer_7,Mar√≠a,,1968-12-31,ES68209528285169439268,TRX_N-00508-38198307,2023-03-22T20:56:38,Portugalete,expenses,food,-79.67,-43222.39
buyer_7,Mar√≠a,,1968-12-31,ES68209528285169439268,TRX_N-00509-87782750,2023-03-27T11:13:25,Portugalete,expenses,food,-85.82,-43308.21
buyer_7,Mar√≠a,,1968-12-31,ES68209528285169439268,TRX_N-00510-82130820,2023-03-29T17:28:36,Oy√≥n-Oion,expenses,cash,-100.0,-43408.21
buyer_7,Mar√≠a,,1968-12-31,ES68209528285169439268,TRX_N-00511-01870141,2023-04-01T20:56:47,Portugalete,incomes,salary,1321.01,-42087.2
buyer_7,Mar√≠a,,1968-12-31,ES68209528285169439268,TRX_N-00512-68536011,2023-04-01T12:23:03,Portugalete,expenses,leisure,-55.03,-42142.23
buyer_7,Mar√≠a,,1968-12-31,ES68209528285169439268,TRX_N-00513-27893625,2023-04-02T19:24:20,Portugalete,expenses,leisure,-63.03,-42205.26
buyer_7,Mar√≠a,,1968-12-31,ES68209528285169439268,TRX_N-00514-12849181,2023-04-04T10:41:42,Portugalete,expenses,mortgage,-764.17,-42969.43
buyer_7,Mar√≠a,,1968-12-31,ES68209528285169439268,TRX_N-00515-63617903,2023-04-04T16:45:37,Errenteria,expenses,cash,-100.0,-43069.43
buyer_7,Mar√≠a,,1968-12-31,ES68209528285169439268,TRX_N-00516-58207390,2023-04-04T23:43:16,Portugalete,expenses,repairs,-237.89,-43307.32
buyer_7,Mar√≠a,,1968-12-31,ES68209528285169439268,TRX_N-00517-99883612,2023-04-05T19:47:53,Portugalete,expenses,gas,-48.61,-43355.93
buyer_7,Mar√≠a,,1968-12-31,ES68209528285169439268,TRX_N-00518-80251018,2023-04-05T02:23:40,Portugalete,expenses,phone,-42.14,-43398.07
buyer_7,Mar√≠a,,1968-12-31,ES68209528285169439268,TRX_N-00519-43585898,2023-04-07T15:08:01,Portugalete,expenses,food,-74.49,-43472.56
buyer_7,Mar√≠a,,1968-12-31,ES68209528285169439268,TRX_N-00520-24541348,2023-04-07T19:18:29,Portugalete,expenses,cash,-100.0,-43572.56
buyer_7,Mar√≠a,,1968-12-31,ES68209528285169439268,TRX_N-00521-34186937,2023-04-08T16:03:40,Portugalete,expenses,water,-23.47,-43596.03
buyer_7,Mar√≠a,,1968-12-31,ES68209528285169439268,TRX_N-00522-62983619,2023-04-08T19:02:08,Portugalete,expenses,electricity,-33.42,-43629.45
buyer_7,Mar√≠a,,1968-12-31,ES68209528285169439268,TRX_N-00523-16354735,2023-04-08T09:11:15,Portugalete,expenses,internet,-42.0,-43671.45
buyer_7,Mar√≠a,,1968-12-31,ES68209528285169439268,TRX_N-00524-89373341,2023-04-08T08:16:16,Portugalete,expenses,children,-634.04,-44305.49
buyer_7,Mar√≠a,,1968-12-31,ES68209528285169439268,TRX_N-00525-90436297,2023-04-09T09:35:43,Portugalete,expenses,food,-60.04,-44365.53
buyer_7,Mar√≠a,,1968-12-31,ES68209528285169439268,TRX_N-00526-83893155,2023-04-10T17:40:10,Portugalete,expenses,cash,-100.0,-44465.53
buyer_7,Mar√≠a,,1968-12-31,ES68209528285169439268,TRX_N-00527-13098057,2023-04-12T10:30:46,Portugalete,expenses,cash,-100.0,-44565.53
buyer_7,Mar√≠a,,1968-12-31,ES68209528285169439268,TRX_N-00528-98817385,2023-04-14T11:36:09,Galdakao,expenses,food,-110.31,-44675.84
buyer_7,Mar√≠a,,1968-12-31,ES68209528285169439268,TRX_N-00529-17280145,2023-04-14T13:30:29,Portugalete,expenses,appliances,-404.94,-45080.78
buyer_7,Mar√≠a,,1968-12-31,ES68209528285169439268,TRX_N-00530-76145726,2023-04-17T10:05:07,Portugalete,expenses,clothing,-81.06,-45161.84
buyer_7,Mar√≠a,,1968-12-31,ES68209528285169439268,TRX_N-00531-87038329,2023-04-17T00:45:10,Portugalete,expenses,healthcare,-49.14,-45210.98
buyer_7,Mar√≠a,,1968-12-31,ES68209528285169439268,TRX_N-00532-90281759,2023-04-18T19:20:30,Portugalete,expenses,children,-496.83,-45707.81
buyer_7,Mar√≠a,,1968-12-31,ES68209528285169439268,TRX_N-00533-97662867,2023-04-19T11:09:32,Santurtzi,expenses,cash,-100.0,-45807.81
buyer_7,Mar√≠a,,1968-12-31,ES68209528285169439268,TRX_N-00534-49827436,2023-04-20T10:26:35,Portugalete,expenses,leisure,-83.2,-45891.01
buyer_7,Mar√≠a,,1968-12-31,ES68209528285169439268,TRX_N-00535-38824542,2023-04-22T08:52:29,Portugalete,expenses,gifts,-579.71,-46470.72
buyer_7,Mar√≠a,,1968-12-31,ES68209528285169439268,TRX_N-00536-38064969,2023-04-23T18:14:28,Portugalete,expenses,cash,-100.0,-46570.72
buyer_7,Mar√≠a,,1968-12-31,ES68209528285169439268,TRX_N-00537-16970064,2023-04-25T18:32:17,Portugalete,expenses,leisure,-37.87,-46608.59
buyer_7,Mar√≠a,,1968-12-31,ES68209528285169439268,TRX_N-00538-40354590,2023-04-25T20:15:52,Getxo,expenses,education,-61.45,-46670.04
buyer_7,Mar√≠a,,1968-12-31,ES68209528285169439268,TRX_N-00539-02660005,2023-04-25T15:21:53,Portugalete,expenses,cash,-100.0,-46770.04
buyer_7,Mar√≠a,,1968-12-31,ES68209528285169439268,TRX_N-00540-68932606,2023-04-25T08:58:49,Portugalete,expenses,children,-173.42,-46943.46
buyer_7,Mar√≠a,,1968-12-31,ES68209528285169439268,TRX_N-00541-93766793,2023-04-27T08:20:32,Portugalete,expenses,food,-97.89,-47041.35
buyer_7,Mar√≠a,,1968-12-31,ES68209528285169439268,TRX_N-00542-77376470,2023-04-28T19:36:47,Irun,expenses,food,-65.63,-47106.98
buyer_7,Mar√≠a,,1968-12-31,ES68209528285169439268,TRX_N-00543-03947154,2023-04-29T14:56:27,Portugalete,expenses,food,-83.79,-47190.77
buyer_7,Mar√≠a,,1968-12-31,ES68209528285169439268,TRX_N-00544-53075778,2023-04-29T18:07:13,Portugalete,expenses,cash,-100.0,-47290.77
buyer_7,Mar√≠a,,1968-12-31,ES68209528285169439268,TRX_N-00545-96123343,2023-04-30T12:30:08,Portugalete,expenses,transport,-64.82,-47355.59
buyer_7,Mar√≠a,,1968-12-31,ES68209528285169439268,TRX_N-00546-52391181,2023-04-30T14:05:33,Portugalete,expenses,cash,-100.0,-47455.59
buyer_7,Mar√≠a,,1968-12-31,ES68209528285169439268,TRX_N-00547-50884940,2023-05-01T14:32:52,Portugalete,incomes,salary,1321.01,-46134.58
buyer_7,Mar√≠a,,1968-12-31,ES68209528285169439268,TRX_N-00548-13645344,2023-05-04T17:34:47,Portugalete,expenses,mortgage,-764.17,-46898.75
buyer_7,Mar√≠a,,1968-12-31,ES68209528285169439268,TRX_N-00549-89179745,2023-05-05T18:28:15,Lasarte-Oria,expenses,transport,-53.01,-46951.76
buyer_7,Mar√≠a,,1968-12-31,ES68209528285169439268,TRX_N-00550-91526587,2023-05-06T09:19:20,Portugalete,expenses,gas,-52.42,-47004.18
buyer_7,Mar√≠a,,1968-12-31,ES68209528285169439268,TRX_N-00551-27716385,2023-05-06T20:33:47,Durango,expenses,transport,-50.77,-47054.95
buyer_7,Mar√≠a,,1968-12-31,ES68209528285169439268,TRX_N-00552-65111956,2023-05-07T12:26:51,Portugalete,expenses,internet,-42.0,-47096.95
buyer_7,Mar√≠a,,1968-12-31,ES68209528285169439268,TRX_N-00553-91698631,2023-05-07T14:39:33,Portugalete,expenses,repairs,-308.16,-47405.11
buyer_7,Mar√≠a,,1968-12-31,ES68209528285169439268,TRX_N-00554-41441216,2023-05-08T10:37:37,Portugalete,expenses,water,-20.75,-47425.86
buyer_7,Mar√≠a,,1968-12-31,ES68209528285169439268,TRX_N-00555-20028876,2023-05-08T21:33:34,Portugalete,expenses,electricity,-50.58,-47476.44
buyer_7,Mar√≠a,,1968-12-31,ES68209528285169439268,TRX_N-00556-77768322,2023-05-08T11:16:04,Portugalete,expenses,phone,-41.94,-47518.38
buyer_7,Mar√≠a,,1968-12-31,ES68209528285169439268,TRX_N-00557-51321276,2023-05-08T14:30:15,Portugalete,expenses,food,-73.66,-47592.04
buyer_7,Mar√≠a,,1968-12-31,ES68209528285169439268,TRX_N-00558-82978069,2023-05-08T14:52:15,Portugalete,expenses,leisure,-82.83,-47674.87
buyer_7,Mar√≠a,,1968-12-31,ES68209528285169439268,TRX_N-00559-62860590,2023-05-09T08:57:13,Portugalete,expenses,clothing,-59.48,-47734.35
buyer_7,Mar√≠a,,1968-12-31,ES68209528285169439268,TRX_N-00560-68097706,2023-05-09T14:44:20,Leioa,expenses,cash,-100.0,-47834.35
buyer_7,Mar√≠a,,1968-12-31,ES68209528285169439268,TRX_N-00561-03605600,2023-05-12T22:22:59,Portugalete,expenses,transport,-53.55,-47887.9
buyer_7,Mar√≠a,,1968-12-31,ES68209528285169439268,TRX_N-00562-10202942,2023-05-12T15:34:35,Irun,expenses,appliances,-281.51,-48169.41
buyer_7,Mar√≠a,,1968-12-31,ES68209528285169439268,TRX_N-00563-64121665,2023-05-13T15:34:33,Portugalete,expenses,transport,-62.46,-48231.87
buyer_7,Mar√≠a,,1968-12-31,ES68209528285169439268,TRX_N-00564-07550587,2023-05-14T21:53:23,Portugalete,expenses,food,-101.37,-48333.24
buyer_7,Mar√≠a,,1968-12-31,ES68209528285169439268,TRX_N-00565-01742466,2023-05-14T11:20:42,Portugalete,expenses,cash,-100.0,-48433.24
buyer_7,Mar√≠a,,1968-12-31,ES68209528285169439268,TRX_N-00566-04683531,2023-05-15T13:24:18,Portugalete,expenses,repairs,-262.59,-48695.83
buyer_7,Mar√≠a,,1968-12-31,ES68209528285169439268,TRX_N-00567-11866183,2023-05-17T14:09:26,Portugalete,expenses,food,-124.56,-48820.39
buyer_7,Mar√≠a,,1968-12-31,ES68209528285169439268,TRX_N-00568-48612784,2023-05-17T11:45:37,Pasaia,expenses,transport,-64.17,-48884.56
buyer_7,Mar√≠a,,1968-12-31,ES68209528285169439268,TRX_N-00569-23044764,2023-05-17T15:56:54,Portugalete,expenses,clothing,-117.93,-49002.49
buyer_7,Mar√≠a,,1968-12-31,ES68209528285169439268,TRX_N-00570-03737448,2023-05-18T12:44:48,Portugalete,expenses,gifts,-394.74,-49397.23
buyer_7,Mar√≠a,,1968-12-31,ES68209528285169439268,TRX_N-00571-57714091,2023-05-19T15:25:27,Portugalete,expenses,cash,-100.0,-49497.23
buyer_7,Mar√≠a,,1968-12-31,ES68209528285169439268,TRX_N-00572-26364614,2023-05-20T12:31:06,Portugalete,expenses,food,-93.72,-49590.95
buyer_7,Mar√≠a,,1968-12-31,ES68209528285169439268,TRX_N-00573-94078412,2023-05-21T05:11:20,Zuia,expenses,food,-111.39,-49702.34
buyer_7,Mar√≠a,,1968-12-31,ES68209528285169439268,TRX_N-00574-76460034,2023-05-23T18:55:58,Santurtzi,expenses,food,-96.08,-49798.42
buyer_7,Mar√≠a,,1968-12-31,ES68209528285169439268,TRX_N-00575-76674390,2023-05-23T03:57:47,Portugalete,expenses,healthcare,-131.84,-49930.26
buyer_7,Mar√≠a,,1968-12-31,ES68209528285169439268,TRX_N-00576-37781768,2023-05-23T03:11:20,Portugalete,expenses,travel,-444.33,-50374.59
buyer_7,Mar√≠a,,1968-12-31,ES68209528285169439268,TRX_N-00577-85258500,2023-05-23T14:42:25,Portugalete,expenses,repairs,-68.56,-50443.15
buyer_7,Mar√≠a,,1968-12-31,ES68209528285169439268,TRX_N-00578-41041769,2023-05-25T12:02:10,Donostia,expenses,transport,-41.72,-50484.87
buyer_7,Mar√≠a,,1968-12-31,ES68209528285169439268,TRX_N-00579-14976210,2023-05-25T20:20:35,Oy√≥n-Oion,expenses,leisure,-74.12,-50558.99
buyer_7,Mar√≠a,,1968-12-31,ES68209528285169439268,TRX_N-00580-44966332,2023-05-25T08:44:46,Durango,expenses,cash,-100.0,-50658.99
buyer_7,Mar√≠a,,1968-12-31,ES68209528285169439268,TRX_N-00581-69164964,2023-05-25T13:49:10,Portugalete,expenses,repairs,-91.2,-50750.19
buyer_7,Mar√≠a,,1968-12-31,ES68209528285169439268,TRX_N-00582-13261707,2023-05-27T17:09:49,Zarautz,expenses,repairs,-285.99,-51036.18
buyer_7,Mar√≠a,,1968-12-31,ES68209528285169439268,TRX_N-00583-84203216,2023-05-28T12:30:13,Irun,expenses,food,-111.84,-51148.02
buyer_7,Mar√≠a,,1968-12-31,ES68209528285169439268,TRX_N-00584-01056530,2023-05-29T20:13:01,Portugalete,expenses,leisure,-84.83,-51232.85
buyer_7,Mar√≠a,,1968-12-31,ES68209528285169439268,TRX_N-00585-78064470,2023-05-29T04:25:36,Portugalete,expenses,cash,-100.0,-51332.85
buyer_7,Mar√≠a,,1968-12-31,ES68209528285169439268,TRX_N-00586-99288938,2023-05-30T01:37:39,Portugalete,expenses,leisure,-34.36,-51367.21
buyer_7,Mar√≠a,,1968-12-31,ES68209528285169439268,TRX_N-00587-12923710,2023-06-01T21:49:48,Portugalete,incomes,salary,1321.01,-50046.2
buyer_7,Mar√≠a,,1968-12-31,ES68209528285169439268,TRX_N-00588-78003411,2023-06-01T21:49:48,Portugalete,incomes,extra_income,186.42,-49859.78
buyer_7,Mar√≠a,,1968-12-31,ES68209528285169439268,TRX_N-00589-15419149,2023-06-01T21:49:48,Portugalete,incomes,salary_bonus,940.87,-48918.91
buyer_7,Mar√≠a,,1968-12-31,ES68209528285169439268,TRX_N-00590-95197005,2023-06-01T18:18:08,Portugalete,expenses,cash,-100.0,-49018.91
buyer_7,Mar√≠a,,1968-12-31,ES68209528285169439268,TRX_N-00591-29329003,2023-06-03T15:33:05,Portugalete,expenses,education,-63.39,-49082.3
buyer_7,Mar√≠a,,1968-12-31,ES68209528285169439268,TRX_N-00592-27183218,2023-06-03T12:47:20,Portugalete,expenses,cash,-100.0,-49182.3
buyer_7,Mar√≠a,,1968-12-31,ES68209528285169439268,TRX_N-00593-07280319,2023-06-04T09:43:10,Portugalete,expenses,mortgage,-764.17,-49946.47
buyer_7,Mar√≠a,,1968-12-31,ES68209528285169439268,TRX_N-00594-18647419,2023-06-05T14:25:16,Portugalete,expenses,phone,-40.04,-49986.51
buyer_7,Mar√≠a,,1968-12-31,ES68209528285169439268,TRX_N-00595-62465316,2023-06-05T20:03:23,Portugalete,expenses,appliances,-390.45,-50376.96
buyer_7,Mar√≠a,,1968-12-31,ES68209528285169439268,TRX_N-00596-94510171,2023-06-06T19:04:18,Bermeo,expenses,transport,-71.42,-50448.38
buyer_7,Mar√≠a,,1968-12-31,ES68209528285169439268,TRX_N-00597-09795242,2023-06-06T18:08:40,Portugalete,expenses,leisure,-22.97,-50471.35
buyer_7,Mar√≠a,,1968-12-31,ES68209528285169439268,TRX_N-00598-63484842,2023-06-07T13:01:09,Portugalete,expenses,gas,-110.27,-50581.62
buyer_7,Mar√≠a,,1968-12-31,ES68209528285169439268,TRX_N-00599-52101341,2023-06-07T18:39:18,Santurtzi,expenses,food,-72.16,-50653.78
buyer_7,Mar√≠a,,1968-12-31,ES68209528285169439268,TRX_N-00600-71652789,2023-06-07T16:29:46,Hondarribia,expenses,clothing,-108.52,-50762.3
buyer_7,Mar√≠a,,1968-12-31,ES68209528285169439268,TRX_N-00601-92506133,2023-06-08T11:07:10,Portugalete,expenses,internet,-42.0,-50804.3
buyer_7,Mar√≠a,,1968-12-31,ES68209528285169439268,TRX_N-00602-42998412,2023-06-08T23:55:12,Portugalete,expenses,water,-20.74,-50825.04
buyer_7,Mar√≠a,,1968-12-31,ES68209528285169439268,TRX_N-00603-72969568,2023-06-08T02:01:07,Portugalete,expenses,electricity,-69.6,-50894.64
buyer_7,Mar√≠a,,1968-12-31,ES68209528285169439268,TRX_N-00604-58353946,2023-06-09T20:05:36,Portugalete,expenses,leisure,-64.96,-50959.6
buyer_7,Mar√≠a,,1968-12-31,ES68209528285169439268,TRX_N-00605-87352221,2023-06-11T22:57:54,Portugalete,expenses,gifts,-43.68,-51003.28
buyer_7,Mar√≠a,,1968-12-31,ES68209528285169439268,TRX_N-00606-75335848,2023-06-16T20:56:51,Portugalete,expenses,cash,-100.0,-51103.28
buyer_7,Mar√≠a,,1968-12-31,ES68209528285169439268,TRX_N-00607-75231744,2023-06-17T12:40:15,Portugalete,expenses,cash,-100.0,-51203.28
buyer_7,Mar√≠a,,1968-12-31,ES68209528285169439268,TRX_N-00608-12372864,2023-06-20T16:03:20,Portugalete,expenses,repairs,-47.29,-51250.57
buyer_7,Mar√≠a,,1968-12-31,ES68209528285169439268,TRX_N-00609-52146067,2023-06-22T01:33:13,Portugalete,expenses,children,-544.49,-51795.06
buyer_7,Mar√≠a,,1968-12-31,ES68209528285169439268,TRX_N-00610-42834736,2023-06-23T09:39:18,Portugalete,expenses,food,-97.76,-51892.82
buyer_7,Mar√≠a,,1968-12-31,ES68209528285169439268,TRX_N-00611-14854428,2023-06-23T15:28:13,Durango,expenses,repairs,-178.03,-52070.85
buyer_7,Mar√≠a,,1968-12-31,ES68209528285169439268,TRX_N-00612-29287141,2023-06-24T19:03:10,Galdakao,expenses,clothing,-142.65,-52213.5
buyer_7,Mar√≠a,,1968-12-31,ES68209528285169439268,TRX_N-00613-53509586,2023-06-26T19:44:08,Zarautz,expenses,gifts,-587.2,-52800.7
buyer_7,Mar√≠a,,1968-12-31,ES68209528285169439268,TRX_N-00614-51800889,2023-06-27T20:34:23,Portugalete,expenses,food,-96.65,-52897.35
buyer_7,Mar√≠a,,1968-12-31,ES68209528285169439268,TRX_N-00615-49675714,2023-06-27T17:06:45,Portugalete,expenses,clothing,-131.85,-53029.2
buyer_7,Mar√≠a,,1968-12-31,ES68209528285169439268,TRX_N-00616-44608859,2023-06-27T14:31:02,Portugalete,expenses,cash,-100.0,-53129.2
buyer_7,Mar√≠a,,1968-12-31,ES68209528285169439268,TRX_N-00617-85796074,2023-06-28T20:36:53,Portugalete,expenses,travel,-1605.04,-54734.24
buyer_7,Mar√≠a,,1968-12-31,ES68209528285169439268,TRX_N-00618-77665615,2023-06-30T10:24:14,Portugalete,expenses,leisure,-31.13,-54765.37
buyer_7,Mar√≠a,,1968-12-31,ES68209528285169439268,TRX_N-00619-74708835,2023-06-30T23:06:37,Portugalete,expenses,travel,-1412.97,-56178.34
buyer_7,Mar√≠a,,1968-12-31,ES68209528285169439268,TRX_N-00620-55171334,2023-07-01T13:00:30,Portugalete,incomes,salary,1321.01,-54857.33
buyer_7,Mar√≠a,,1968-12-31,ES68209528285169439268,TRX_N-00621-17579562,2023-07-04T15:39:47,Portugalete,expenses,mortgage,-764.17,-55621.5
buyer_7,Mar√≠a,,1968-12-31,ES68209528285169439268,TRX_N-00622-64927457,2023-07-05T18:36:18,Portugalete,expenses,water,-37.41,-55658.91
buyer_7,Mar√≠a,,1968-12-31,ES68209528285169439268,TRX_N-00623-99764128,2023-07-05T08:02:17,Portugalete,expenses,phone,-30.79,-55689.7
buyer_7,Mar√≠a,,1968-12-31,ES68209528285169439268,TRX_N-00624-51954012,2023-07-06T09:39:02,Portugalete,expenses,electricity,-24.29,-55713.99
buyer_7,Mar√≠a,,1968-12-31,ES68209528285169439268,TRX_N-00625-00277243,2023-07-06T16:03:21,Portugalete,expenses,gas,-60.11,-55774.1
buyer_7,Mar√≠a,,1968-12-31,ES68209528285169439268,TRX_N-00626-50931683,2023-07-06T04:31:01,Portugalete,expenses,transport,-65.98,-55840.08
buyer_7,Mar√≠a,,1968-12-31,ES68209528285169439268,TRX_N-00627-04406406,2023-07-06T12:21:46,Portugalete,expenses,leisure,-56.96,-55897.04
buyer_7,Mar√≠a,,1968-12-31,ES68209528285169439268,TRX_N-00628-65508783,2023-07-07T12:28:22,Portugalete,expenses,internet,-42.0,-55939.04
buyer_7,Mar√≠a,,1968-12-31,ES68209528285169439268,TRX_N-00629-75113292,2023-07-07T16:16:47,Portugalete,expenses,leisure,-73.11,-56012.15
buyer_7,Mar√≠a,,1968-12-31,ES68209528285169439268,TRX_N-00630-41707087,2023-07-07T14:58:23,Portugalete,expenses,education,-69.1,-56081.25
buyer_7,Mar√≠a,,1968-12-31,ES68209528285169439268,TRX_N-00631-18624291,2023-07-07T00:00:51,Portugalete,expenses,cash,-100.0,-56181.25
buyer_7,Mar√≠a,,1968-12-31,ES68209528285169439268,TRX_N-00632-96782898,2023-07-08T11:17:19,Portugalete,expenses,gifts,-162.89,-56344.14
buyer_7,Mar√≠a,,1968-12-31,ES68209528285169439268,TRX_N-00633-01672440,2023-07-09T05:35:40,Barakaldo,expenses,leisure,-82.87,-56427.01
buyer_7,Mar√≠a,,1968-12-31,ES68209528285169439268,TRX_N-00634-43215602,2023-07-09T19:21:03,Portugalete,expenses,education,-56.7,-56483.71
buyer_7,Mar√≠a,,1968-12-31,ES68209528285169439268,TRX_N-00635-32686119,2023-07-10T08:04:09,Portugalete,expenses,leisure,-44.84,-56528.55
buyer_7,Mar√≠a,,1968-12-31,ES68209528285169439268,TRX_N-00636-68488785,2023-07-12T08:33:48,Portugalete,expenses,food,-84.94,-56613.49
buyer_7,Mar√≠a,,1968-12-31,ES68209528285169439268,TRX_N-00637-63996072,2023-07-13T05:53:42,Llodio,expenses,repairs,-33.16,-56646.65
buyer_7,Mar√≠a,,1968-12-31,ES68209528285169439268,TRX_N-00638-69776582,2023-07-14T20:42:31,Durango,expenses,cash,-100.0,-56746.65
buyer_7,Mar√≠a,,1968-12-31,ES68209528285169439268,TRX_N-00639-46601972,2023-07-16T08:05:00,Portugalete,expenses,food,-123.45,-56870.1
buyer_7,Mar√≠a,,1968-12-31,ES68209528285169439268,TRX_N-00640-74295633,2023-07-16T00:03:11,Portugalete,expenses,transport,-80.56,-56950.66
buyer_7,Mar√≠a,,1968-12-31,ES68209528285169439268,TRX_N-00641-55750264,2023-07-19T15:07:47,Portugalete,expenses,repairs,-51.0,-57001.66
buyer_7,Mar√≠a,,1968-12-31,ES68209528285169439268,TRX_N-00642-80038670,2023-07-20T23:50:52,Durango,expenses,cash,-100.0,-57101.66
buyer_7,Mar√≠a,,1968-12-31,ES68209528285169439268,TRX_N-00643-27419862,2023-07-21T09:57:07,Portugalete,expenses,transport,-85.2,-57186.86
buyer_7,Mar√≠a,,1968-12-31,ES68209528285169439268,TRX_N-00644-85402823,2023-07-21T18:18:57,Portugalete,expenses,clothing,-123.51,-57310.37
buyer_7,Mar√≠a,,1968-12-31,ES68209528285169439268,TRX_N-00645-32841117,2023-07-24T12:23:40,Barakaldo,expenses,cash,-100.0,-57410.37
buyer_7,Mar√≠a,,1968-12-31,ES68209528285169439268,TRX_N-00646-41541944,2023-07-24T11:25:11,Portugalete,expenses,gifts,-264.18,-57674.55
buyer_7,Mar√≠a,,1968-12-31,ES68209528285169439268,TRX_N-00647-75557441,2023-07-26T19:55:20,Portugalete,expenses,food,-118.98,-57793.53
buyer_7,Mar√≠a,,1968-12-31,ES68209528285169439268,TRX_N-00648-35058798,2023-07-29T18:18:16,Portugalete,expenses,children,-406.61,-58200.14
buyer_7,Mar√≠a,,1968-12-31,ES68209528285169439268,TRX_N-00649-36451606,2023-07-30T15:19:16,Portugalete,expenses,food,-95.71,-58295.85
buyer_7,Mar√≠a,,1968-12-31,ES68209528285169439268,TRX_N-00650-67805768,2023-07-30T10:43:37,Portugalete,expenses,cash,-100.0,-58395.85
buyer_7,Mar√≠a,,1968-12-31,ES68209528285169439268,TRX_N-00651-27581446,2023-07-31T10:29:37,Portugalete,expenses,transport,-56.39,-58452.24
buyer_7,Mar√≠a,,1968-12-31,ES68209528285169439268,TRX_N-00652-22297330,2023-08-01T19:26:29,Portugalete,incomes,salary,1321.01,-57131.23
buyer_7,Mar√≠a,,1968-12-31,ES68209528285169439268,TRX_N-00653-42648511,2023-08-03T17:24:48,Portugalete,expenses,clothing,-117.02,-57248.25
buyer_7,Mar√≠a,,1968-12-31,ES68209528285169439268,TRX_N-00654-60316289,2023-08-04T18:46:16,Portugalete,expenses,mortgage,-764.17,-58012.42
buyer_7,Mar√≠a,,1968-12-31,ES68209528285169439268,TRX_N-00655-88140025,2023-08-04T23:50:58,Portugalete,expenses,food,-104.81,-58117.23
buyer_7,Mar√≠a,,1968-12-31,ES68209528285169439268,TRX_N-00656-37170395,2023-08-04T10:12:14,Portugalete,expenses,transport,-58.57,-58175.8
buyer_7,Mar√≠a,,1968-12-31,ES68209528285169439268,TRX_N-00657-32391247,2023-08-05T13:52:26,Portugalete,expenses,gas,-49.28,-58225.08
buyer_7,Mar√≠a,,1968-12-31,ES68209528285169439268,TRX_N-00658-08511599,2023-08-05T16:32:30,Portugalete,expenses,leisure,-40.48,-58265.56
buyer_7,Mar√≠a,,1968-12-31,ES68209528285169439268,TRX_N-00659-69019591,2023-08-06T11:05:05,Portugalete,expenses,food,-87.03,-58352.59
buyer_7,Mar√≠a,,1968-12-31,ES68209528285169439268,TRX_N-00660-25683575,2023-08-07T17:52:43,Portugalete,expenses,electricity,-27.12,-58379.71
buyer_7,Mar√≠a,,1968-12-31,ES68209528285169439268,TRX_N-00661-70355258,2023-08-07T09:51:39,Portugalete,expenses,internet,-42.0,-58421.71
buyer_7,Mar√≠a,,1968-12-31,ES68209528285169439268,TRX_N-00662-50590776,2023-08-07T21:09:07,Portugalete,expenses,cash,-100.0,-58521.71
buyer_7,Mar√≠a,,1968-12-31,ES68209528285169439268,TRX_N-00663-54193184,2023-08-08T20:05:37,Portugalete,expenses,water,-23.49,-58545.2
buyer_7,Mar√≠a,,1968-12-31,ES68209528285169439268,TRX_N-00664-73935662,2023-08-08T08:14:51,Portugalete,expenses,phone,-36.01,-58581.21
buyer_7,Mar√≠a,,1968-12-31,ES68209528285169439268,TRX_N-00665-59912955,2023-08-10T07:19:50,Portugalete,expenses,cash,-100.0,-58681.21
buyer_7,Mar√≠a,,1968-12-31,ES68209528285169439268,TRX_N-00666-82065789,2023-08-11T12:21:08,Portugalete,expenses,transport,-78.04,-58759.25
buyer_7,Mar√≠a,,1968-12-31,ES68209528285169439268,TRX_N-00667-50012518,2023-08-11T15:51:38,Portugalete,expenses,repairs,-30.48,-58789.73
buyer_7,Mar√≠a,,1968-12-31,ES68209528285169439268,TRX_N-00668-49996456,2023-08-11T20:37:50,Portugalete,expenses,children,-664.4,-59454.13
buyer_7,Mar√≠a,,1968-12-31,ES68209528285169439268,TRX_N-00669-94754952,2023-08-12T07:33:31,Hernani,expenses,food,-113.47,-59567.6
buyer_7,Mar√≠a,,1968-12-31,ES68209528285169439268,TRX_N-00670-75196950,2023-08-12T16:14:56,Portugalete,expenses,repairs,-330.84,-59898.44
buyer_7,Mar√≠a,,1968-12-31,ES68209528285169439268,TRX_N-00671-33819280,2023-08-13T11:35:34,Portugalete,expenses,repairs,-248.38,-60146.82
buyer_7,Mar√≠a,,1968-12-31,ES68209528285169439268,TRX_N-00672-49355261,2023-08-14T12:40:10,Leioa,expenses,transport,-44.67,-60191.49
buyer_7,Mar√≠a,,1968-12-31,ES68209528285169439268,TRX_N-00673-04544986,2023-08-15T11:40:12,Portugalete,expenses,transport,-72.99,-60264.48
buyer_7,Mar√≠a,,1968-12-31,ES68209528285169439268,TRX_N-00674-25443008,2023-08-15T14:15:39,Portugalete,expenses,children,-283.97,-60548.45
buyer_7,Mar√≠a,,1968-12-31,ES68209528285169439268,TRX_N-00675-14151673,2023-08-16T17:25:50,Portugalete,expenses,clothing,-100.19,-60648.64
buyer_7,Mar√≠a,,1968-12-31,ES68209528285169439268,TRX_N-00676-45070259,2023-08-17T20:23:06,Portugalete,expenses,cash,-100.0,-60748.64
buyer_7,Mar√≠a,,1968-12-31,ES68209528285169439268,TRX_N-00677-01587819,2023-08-18T11:04:57,Hondarribia,expenses,education,-52.5,-60801.14
buyer_7,Mar√≠a,,1968-12-31,ES68209528285169439268,TRX_N-00678-97178913,2023-08-20T13:14:57,Portugalete,expenses,cash,-100.0,-60901.14
buyer_7,Mar√≠a,,1968-12-31,ES68209528285169439268,TRX_N-00679-37378351,2023-08-21T12:52:07,Portugalete,expenses,cash,-100.0,-61001.14
buyer_7,Mar√≠a,,1968-12-31,ES68209528285169439268,TRX_N-00680-62774257,2023-08-22T09:59:25,Leioa,expenses,food,-67.74,-61068.88
buyer_7,Mar√≠a,,1968-12-31,ES68209528285169439268,TRX_N-00681-37672821,2023-08-23T14:57:31,Portugalete,expenses,cash,-100.0,-61168.88
buyer_7,Mar√≠a,,1968-12-31,ES68209528285169439268,TRX_N-00682-95450968,2023-08-24T10:42:13,Portugalete,expenses,food,-114.17,-61283.05
buyer_7,Mar√≠a,,1968-12-31,ES68209528285169439268,TRX_N-00683-21432419,2023-08-24T11:07:03,Portugalete,expenses,leisure,-25.83,-61308.88
buyer_7,Mar√≠a,,1968-12-31,ES68209528285169439268,TRX_N-00684-60258086,2023-08-25T10:13:00,Errenteria,expenses,travel,-1739.07,-63047.95
buyer_7,Mar√≠a,,1968-12-31,ES68209528285169439268,TRX_N-00685-88399853,2023-08-26T17:55:26,Salvatierra/Agurain,expenses,cash,-100.0,-63147.95
buyer_7,Mar√≠a,,1968-12-31,ES68209528285169439268,TRX_N-00686-19419484,2023-08-26T15:26:05,Portugalete,expenses,appliances,-134.86,-63282.81
buyer_7,Mar√≠a,,1968-12-31,ES68209528285169439268,TRX_N-00687-42976721,2023-08-26T21:16:27,Portugalete,expenses,repairs,-219.23,-63502.04
buyer_7,Mar√≠a,,1968-12-31,ES68209528285169439268,TRX_N-00688-37471354,2023-08-27T14:13:03,Portugalete,expenses,food,-109.0,-63611.04
buyer_7,Mar√≠a,,1968-12-31,ES68209528285169439268,TRX_N-00689-54900831,2023-08-27T19:38:53,Portugalete,expenses,transport,-89.75,-63700.79
buyer_7,Mar√≠a,,1968-12-31,ES68209528285169439268,TRX_N-00690-17556495,2023-08-29T15:38:14,Portugalete,expenses,clothing,-60.73,-63761.52
buyer_7,Mar√≠a,,1968-12-31,ES68209528285169439268,TRX_N-00691-75720794,2023-08-30T08:30:07,Portugalete,expenses,healthcare,-124.35,-63885.87
buyer_7,Mar√≠a,,1968-12-31,ES68209528285169439268,TRX_N-00692-34864226,2023-08-30T18:13:51,Salvatierra/Agurain,expenses,cash,-100.0,-63985.87
buyer_7,Mar√≠a,,1968-12-31,ES68209528285169439268,TRX_N-00693-02971360,2023-08-30T11:14:06,Bilbao,expenses,repairs,-221.81,-64207.68
buyer_7,Mar√≠a,,1968-12-31,ES68209528285169439268,TRX_N-00694-51256591,2023-09-01T18:59:20,Portugalete,incomes,salary,1321.01,-62886.67
buyer_7,Mar√≠a,,1968-12-31,ES68209528285169439268,TRX_N-00695-93730613,2023-09-01T12:14:02,Portugalete,expenses,transport,-75.53,-62962.2
buyer_7,Mar√≠a,,1968-12-31,ES68209528285169439268,TRX_N-00696-10051051,2023-09-02T17:36:27,Leioa,expenses,education,-59.43,-63021.63
buyer_7,Mar√≠a,,1968-12-31,ES68209528285169439268,TRX_N-00697-52101457,2023-09-04T01:30:52,Portugalete,expenses,mortgage,-764.17,-63785.8
buyer_7,Mar√≠a,,1968-12-31,ES68209528285169439268,TRX_N-00698-10397121,2023-09-05T04:50:25,Errenteria,expenses,repairs,-263.68,-64049.48
buyer_7,Mar√≠a,,1968-12-31,ES68209528285169439268,TRX_N-00699-35767970,2023-09-06T05:46:24,Portugalete,expenses,electricity,-45.17,-64094.65
buyer_7,Mar√≠a,,1968-12-31,ES68209528285169439268,TRX_N-00700-58251097,2023-09-06T06:45:34,Portugalete,expenses,gas,-75.76,-64170.41
buyer_7,Mar√≠a,,1968-12-31,ES68209528285169439268,TRX_N-00701-74871562,2023-09-06T23:48:40,Portugalete,expenses,food,-83.27,-64253.68
buyer_7,Mar√≠a,,1968-12-31,ES68209528285169439268,TRX_N-00702-24377148,2023-09-06T19:31:25,Zarautz,expenses,transport,-61.79,-64315.47
buyer_7,Mar√≠a,,1968-12-31,ES68209528285169439268,TRX_N-00703-02067692,2023-09-07T20:24:59,Portugalete,expenses,water,-26.25,-64341.72
buyer_7,Mar√≠a,,1968-12-31,ES68209528285169439268,TRX_N-00704-60843992,2023-09-07T09:45:02,Portugalete,expenses,transport,-64.69,-64406.41
buyer_7,Mar√≠a,,1968-12-31,ES68209528285169439268,TRX_N-00705-73400073,2023-09-08T20:51:25,Portugalete,expenses,internet,-42.0,-64448.41
buyer_7,Mar√≠a,,1968-12-31,ES68209528285169439268,TRX_N-00706-71452793,2023-09-08T20:22:35,Portugalete,expenses,phone,-31.01,-64479.42
buyer_7,Mar√≠a,,1968-12-31,ES68209528285169439268,TRX_N-00707-53133827,2023-09-09T12:37:35,Andoain,expenses,food,-62.37,-64541.79
buyer_7,Mar√≠a,,1968-12-31,ES68209528285169439268,TRX_N-00708-28199318,2023-09-12T14:40:30,Portugalete,expenses,cash,-100.0,-64641.79
buyer_7,Mar√≠a,,1968-12-31,ES68209528285169439268,TRX_N-00709-46800082,2023-09-13T18:15:39,Portugalete,expenses,food,-116.2,-64757.99
buyer_7,Mar√≠a,,1968-12-31,ES68209528285169439268,TRX_N-00710-08153848,2023-09-15T08:33:30,Portugalete,expenses,repairs,-87.41,-64845.4
buyer_7,Mar√≠a,,1968-12-31,ES68209528285169439268,TRX_N-00711-74787456,2023-09-16T11:29:44,Portugalete,expenses,cash,-100.0,-64945.4
buyer_7,Mar√≠a,,1968-12-31,ES68209528285169439268,TRX_N-00712-26016596,2023-09-16T11:17:02,Portugalete,expenses,children,-343.62,-65289.02
buyer_7,Mar√≠a,,1968-12-31,ES68209528285169439268,TRX_N-00713-99478968,2023-09-17T08:24:10,Portugalete,expenses,cash,-100.0,-65389.02
buyer_7,Mar√≠a,,1968-12-31,ES68209528285169439268,TRX_N-00714-72482633,2023-09-19T19:27:43,Portugalete,expenses,cash,-100.0,-65489.02
buyer_7,Mar√≠a,,1968-12-31,ES68209528285169439268,TRX_N-00715-89736067,2023-09-21T14:48:59,Portugalete,expenses,repairs,-176.51,-65665.53
buyer_7,Mar√≠a,,1968-12-31,ES68209528285169439268,TRX_N-00716-40633429,2023-09-22T09:19:04,Portugalete,expenses,cash,-100.0,-65765.53
buyer_7,Mar√≠a,,1968-12-31,ES68209528285169439268,TRX_N-00717-81955022,2023-09-25T18:53:11,Elciego,expenses,travel,-781.73,-66547.26
buyer_7,Mar√≠a,,1968-12-31,ES68209528285169439268,TRX_N-00718-06237721,2023-09-26T10:09:55,Llodio,expenses,food,-81.37,-66628.63
buyer_7,Mar√≠a,,1968-12-31,ES68209528285169439268,TRX_N-00719-26885935,2023-09-26T08:07:47,Portugalete,expenses,clothing,-126.44,-66755.07
buyer_7,Mar√≠a,,1968-12-31,ES68209528285169439268,TRX_N-00720-03289153,2023-09-28T18:38:34,Bilbao,expenses,food,-105.97,-66861.04
buyer_7,Mar√≠a,,1968-12-31,ES68209528285169439268,TRX_N-00721-62169594,2023-09-28T14:24:11,Portugalete,expenses,clothing,-124.08,-66985.12
buyer_7,Mar√≠a,,1968-12-31,ES68209528285169439268,TRX_N-00722-23885690,2023-09-30T18:14:11,Portugalete,expenses,transport,-42.75,-67027.87
buyer_7,Mar√≠a,,1968-12-31,ES68209528285169439268,TRX_N-00723-54444300,2023-09-30T16:42:04,Portugalete,expenses,clothing,-77.91,-67105.78
buyer_7,Mar√≠a,,1968-12-31,ES68209528285169439268,TRX_N-00724-88402382,2023-10-01T14:46:05,Portugalete,incomes,salary,1321.01,-65784.77
buyer_7,Mar√≠a,,1968-12-31,ES68209528285169439268,TRX_N-00725-90853039,2023-10-01T14:46:05,Portugalete,incomes,extra_income,186.42,-65598.35
buyer_7,Mar√≠a,,1968-12-31,ES68209528285169439268,TRX_N-00726-47632538,2023-10-01T16:59:53,Bermeo,expenses,education,-44.45,-65642.8
buyer_7,Mar√≠a,,1968-12-31,ES68209528285169439268,TRX_N-00727-37012226,2023-10-01T12:55:58,Portugalete,expenses,children,-453.83,-66096.63
buyer_7,Mar√≠a,,1968-12-31,ES68209528285169439268,TRX_N-00728-06856425,2023-10-02T17:21:25,Portugalete,expenses,transport,-45.51,-66142.14
buyer_7,Mar√≠a,,1968-12-31,ES68209528285169439268,TRX_N-00729-60565571,2023-10-02T11:09:36,Erandio,expenses,gifts,-73.23,-66215.37
buyer_7,Mar√≠a,,1968-12-31,ES68209528285169439268,TRX_N-00730-60662030,2023-10-04T02:50:08,Portugalete,expenses,mortgage,-764.17,-66979.54
buyer_7,Mar√≠a,,1968-12-31,ES68209528285169439268,TRX_N-00731-04100518,2023-10-04T20:50:06,Portugalete,expenses,food,-78.92,-67058.46
buyer_7,Mar√≠a,,1968-12-31,ES68209528285169439268,TRX_N-00732-87362921,2023-10-04T09:32:28,Portugalete,expenses,cash,-100.0,-67158.46
buyer_7,Mar√≠a,,1968-12-31,ES68209528285169439268,TRX_N-00733-14013505,2023-10-04T20:11:14,Portugalete,expenses,repairs,-124.25,-67282.71
buyer_7,Mar√≠a,,1968-12-31,ES68209528285169439268,TRX_N-00734-37715430,2023-10-05T13:18:00,Portugalete,expenses,electricity,-83.19,-67365.9
buyer_7,Mar√≠a,,1968-12-31,ES68209528285169439268,TRX_N-00735-08541393,2023-10-05T16:02:34,Portugalete,expenses,gas,-78.25,-67444.15
buyer_7,Mar√≠a,,1968-12-31,ES68209528285169439268,TRX_N-00736-93200144,2023-10-05T19:18:29,Portugalete,expenses,phone,-32.15,-67476.3
buyer_7,Mar√≠a,,1968-12-31,ES68209528285169439268,TRX_N-00737-64329603,2023-10-06T19:35:55,Portugalete,expenses,repairs,-28.72,-67505.02
buyer_7,Mar√≠a,,1968-12-31,ES68209528285169439268,TRX_N-00738-97350720,2023-10-08T13:42:10,Portugalete,expenses,internet,-42.0,-67547.02
buyer_7,Mar√≠a,,1968-12-31,ES68209528285169439268,TRX_N-00739-46237271,2023-10-08T20:04:34,Portugalete,expenses,water,-32.75,-67579.77
buyer_7,Mar√≠a,,1968-12-31,ES68209528285169439268,TRX_N-00740-40438586,2023-10-08T12:51:02,Portugalete,expenses,food,-78.93,-67658.7
buyer_7,Mar√≠a,,1968-12-31,ES68209528285169439268,TRX_N-00741-66898595,2023-10-11T20:11:12,Portugalete,expenses,leisure,-53.98,-67712.68
buyer_7,Mar√≠a,,1968-12-31,ES68209528285169439268,TRX_N-00742-95171998,2023-10-11T13:22:47,Portugalete,expenses,children,-384.88,-68097.56
buyer_7,Mar√≠a,,1968-12-31,ES68209528285169439268,TRX_N-00743-13482259,2023-10-12T19:14:29,Portugalete,expenses,food,-76.2,-68173.76
buyer_7,Mar√≠a,,1968-12-31,ES68209528285169439268,TRX_N-00744-58866580,2023-10-12T11:03:58,Getxo,expenses,transport,-56.15,-68229.91
buyer_7,Mar√≠a,,1968-12-31,ES68209528285169439268,TRX_N-00745-63274144,2023-10-12T21:43:52,Portugalete,expenses,children,-676.08,-68905.99
buyer_7,Mar√≠a,,1968-12-31,ES68209528285169439268,TRX_N-00746-44385213,2023-10-15T13:37:42,Portugalete,expenses,cash,-100.0,-69005.99
buyer_7,Mar√≠a,,1968-12-31,ES68209528285169439268,TRX_N-00747-24861299,2023-10-16T22:47:09,Portugalete,expenses,cash,-100.0,-69105.99
buyer_7,Mar√≠a,,1968-12-31,ES68209528285169439268,TRX_N-00748-39248035,2023-10-18T02:16:26,Zuia,expenses,leisure,-64.73,-69170.72
buyer_7,Mar√≠a,,1968-12-31,ES68209528285169439268,TRX_N-00749-26720241,2023-10-18T12:46:33,Portugalete,expenses,cash,-100.0,-69270.72
buyer_7,Mar√≠a,,1968-12-31,ES68209528285169439268,TRX_N-00750-30596335,2023-10-18T11:07:18,Portugalete,expenses,children,-170.22,-69440.94
buyer_7,Mar√≠a,,1968-12-31,ES68209528285169439268,TRX_N-00751-47190363,2023-10-20T09:34:43,Portugalete,expenses,transport,-56.31,-69497.25
buyer_7,Mar√≠a,,1968-12-31,ES68209528285169439268,TRX_N-00752-46597131,2023-10-20T16:27:41,Portugalete,expenses,children,-416.94,-69914.19
buyer_7,Mar√≠a,,1968-12-31,ES68209528285169439268,TRX_N-00753-36672290,2023-10-22T19:44:43,Portugalete,expenses,cash,-100.0,-70014.19
buyer_7,Mar√≠a,,1968-12-31,ES68209528285169439268,TRX_N-00754-19552351,2023-10-23T13:46:23,Portugalete,expenses,gifts,-163.97,-70178.16
buyer_7,Mar√≠a,,1968-12-31,ES68209528285169439268,TRX_N-00755-76618770,2023-10-24T11:53:37,Portugalete,expenses,children,-179.35,-70357.51
buyer_7,Mar√≠a,,1968-12-31,ES68209528285169439268,TRX_N-00756-06584117,2023-10-25T03:11:18,Portugalete,expenses,leisure,-39.32,-70396.83
buyer_7,Mar√≠a,,1968-12-31,ES68209528285169439268,TRX_N-00757-85282776,2023-10-26T19:00:24,Portugalete,expenses,food,-73.77,-70470.6
buyer_7,Mar√≠a,,1968-12-31,ES68209528285169439268,TRX_N-00758-82561125,2023-10-26T11:47:43,Portugalete,expenses,clothing,-105.66,-70576.26
buyer_7,Mar√≠a,,1968-12-31,ES68209528285169439268,TRX_N-00759-52053192,2023-10-26T15:55:49,Portugalete,expenses,repairs,-104.98,-70681.24
buyer_7,Mar√≠a,,1968-12-31,ES68209528285169439268,TRX_N-00760-25068527,2023-10-27T18:52:45,Portugalete,expenses,appliances,-259.2,-70940.44
buyer_7,Mar√≠a,,1968-12-31,ES68209528285169439268,TRX_N-00761-99446362,2023-10-31T11:42:00,Portugalete,expenses,children,-681.17,-71621.61
buyer_7,Mar√≠a,,1968-12-31,ES68209528285169439268,TRX_N-00762-33635671,2023-11-01T13:15:42,Portugalete,incomes,salary,1321.01,-70300.6
buyer_7,Mar√≠a,,1968-12-31,ES68209528285169439268,TRX_N-00763-22911279,2023-11-01T09:35:22,Portugalete,expenses,leisure,-75.45,-70376.05
buyer_7,Mar√≠a,,1968-12-31,ES68209528285169439268,TRX_N-00764-36333123,2023-11-04T08:02:53,Portugalete,expenses,mortgage,-764.17,-71140.22
buyer_7,Mar√≠a,,1968-12-31,ES68209528285169439268,TRX_N-00765-32501690,2023-11-05T04:23:46,Portugalete,expenses,water,-31.18,-71171.4
buyer_7,Mar√≠a,,1968-12-31,ES68209528285169439268,TRX_N-00766-86278808,2023-11-05T19:45:10,Portugalete,expenses,food,-101.16,-71272.56
buyer_7,Mar√≠a,,1968-12-31,ES68209528285169439268,TRX_N-00767-16871432,2023-11-05T09:20:16,Portugalete,expenses,children,-629.98,-71902.54
buyer_7,Mar√≠a,,1968-12-31,ES68209528285169439268,TRX_N-00768-62733176,2023-11-06T12:16:53,Portugalete,expenses,electricity,-60.22,-71962.76
buyer_7,Mar√≠a,,1968-12-31,ES68209528285169439268,TRX_N-00769-72403852,2023-11-07T15:16:50,Portugalete,expenses,gas,-105.37,-72068.13
buyer_7,Mar√≠a,,1968-12-31,ES68209528285169439268,TRX_N-00770-18760611,2023-11-07T13:53:45,Portugalete,expenses,internet,-42.0,-72110.13
buyer_7,Mar√≠a,,1968-12-31,ES68209528285169439268,TRX_N-00771-56716757,2023-11-07T05:59:19,Portugalete,expenses,phone,-34.05,-72144.18
buyer_7,Mar√≠a,,1968-12-31,ES68209528285169439268,TRX_N-00772-30039161,2023-11-09T12:53:55,Portugalete,expenses,food,-87.17,-72231.35
buyer_7,Mar√≠a,,1968-12-31,ES68209528285169439268,TRX_N-00773-49752737,2023-11-09T03:01:18,Portugalete,expenses,cash,-100.0,-72331.35
buyer_7,Mar√≠a,,1968-12-31,ES68209528285169439268,TRX_N-00774-47260252,2023-11-11T10:57:09,Portugalete,expenses,cash,-100.0,-72431.35
buyer_7,Mar√≠a,,1968-12-31,ES68209528285169439268,TRX_N-00775-05786316,2023-11-13T18:36:42,Portugalete,expenses,cash,-100.0,-72531.35
buyer_7,Mar√≠a,,1968-12-31,ES68209528285169439268,TRX_N-00776-88125424,2023-11-16T09:04:16,Portugalete,expenses,cash,-100.0,-72631.35
buyer_7,Mar√≠a,,1968-12-31,ES68209528285169439268,TRX_N-00777-05900752,2023-11-17T10:34:22,Portugalete,expenses,food,-107.61,-72738.96
buyer_7,Mar√≠a,,1968-12-31,ES68209528285169439268,TRX_N-00778-41131355,2023-11-18T18:29:22,Portugalete,expenses,cash,-100.0,-72838.96
buyer_7,Mar√≠a,,1968-12-31,ES68209528285169439268,TRX_N-00779-90566255,2023-11-19T09:45:12,Elciego,expenses,appliances,-189.18,-73028.14
buyer_7,Mar√≠a,,1968-12-31,ES68209528285169439268,TRX_N-00780-05975175,2023-11-20T15:26:30,Portugalete,expenses,education,-58.99,-73087.13
buyer_7,Mar√≠a,,1968-12-31,ES68209528285169439268,TRX_N-00781-30505150,2023-11-20T17:06:37,Portugalete,expenses,repairs,-47.74,-73134.87
buyer_7,Mar√≠a,,1968-12-31,ES68209528285169439268,TRX_N-00782-38103293,2023-11-21T18:26:13,Portugalete,expenses,cash,-100.0,-73234.87
buyer_7,Mar√≠a,,1968-12-31,ES68209528285169439268,TRX_N-00783-29275923,2023-11-21T13:21:01,Bermeo,expenses,gifts,-219.3,-73454.17
buyer_7,Mar√≠a,,1968-12-31,ES68209528285169439268,TRX_N-00784-01106905,2023-11-22T19:26:02,Errenteria,expenses,education,-62.2,-73516.37
buyer_7,Mar√≠a,,1968-12-31,ES68209528285169439268,TRX_N-00785-89856198,2023-11-25T10:41:31,Zarautz,expenses,cash,-100.0,-73616.37
buyer_7,Mar√≠a,,1968-12-31,ES68209528285169439268,TRX_N-00786-91349783,2023-11-26T12:26:02,Portugalete,expenses,food,-94.96,-73711.33
buyer_7,Mar√≠a,,1968-12-31,ES68209528285169439268,TRX_N-00787-50981756,2023-11-27T08:02:24,Vitoria-Gasteiz,expenses,cash,-100.0,-73811.33
buyer_7,Mar√≠a,,1968-12-31,ES68209528285169439268,TRX_N-00788-31287528,2023-11-28T20:49:46,Portugalete,expenses,repairs,-63.18,-73874.51
buyer_7,Mar√≠a,,1968-12-31,ES68209528285169439268,TRX_N-00789-43648547,2023-11-30T13:37:57,Portugalete,expenses,clothing,-133.85,-74008.36
buyer_7,Mar√≠a,,1968-12-31,ES68209528285169439268,TRX_N-00790-68170844,2023-11-30T08:57:29,Iru√±a de Oca,expenses,repairs,-302.23,-74310.59
buyer_7,Mar√≠a,,1968-12-31,ES68209528285169439268,TRX_N-00791-74921696,2023-12-01T08:09:01,Portugalete,incomes,salary,1321.01,-72989.58
buyer_7,Mar√≠a,,1968-12-31,ES68209528285169439268,TRX_N-00792-37522332,2023-12-01T08:09:01,Portugalete,incomes,salary_bonus,1022.67,-71966.91
buyer_7,Mar√≠a,,1968-12-31,ES68209528285169439268,TRX_N-00793-03270410,2023-12-02T20:34:46,Portugalete,expenses,food,-98.88,-72065.79
buyer_7,Mar√≠a,,1968-12-31,ES68209528285169439268,TRX_N-00794-67567007,2023-12-04T16:29:54,Portugalete,expenses,mortgage,-764.17,-72829.96
buyer_7,Mar√≠a,,1968-12-31,ES68209528285169439268,TRX_N-00795-01749384,2023-12-04T10:25:32,Portugalete,expenses,cash,-100.0,-72929.96
buyer_7,Mar√≠a,,1968-12-31,ES68209528285169439268,TRX_N-00796-97870164,2023-12-05T20:04:15,Portugalete,expenses,phone,-41.44,-72971.4
buyer_7,Mar√≠a,,1968-12-31,ES68209528285169439268,TRX_N-00797-75723673,2023-12-07T13:56:35,Portugalete,expenses,electricity,-90.0,-73061.4
buyer_7,Mar√≠a,,1968-12-31,ES68209528285169439268,TRX_N-00798-45547391,2023-12-07T05:58:27,Portugalete,expenses,gas,-79.89,-73141.29
buyer_7,Mar√≠a,,1968-12-31,ES68209528285169439268,TRX_N-00799-46575728,2023-12-07T11:21:02,Portugalete,expenses,leisure,-23.61,-73164.9
buyer_7,Mar√≠a,,1968-12-31,ES68209528285169439268,TRX_N-00800-46891634,2023-12-08T22:39:43,Portugalete,expenses,water,-35.38,-73200.28
buyer_7,Mar√≠a,,1968-12-31,ES68209528285169439268,TRX_N-00801-65443977,2023-12-08T23:08:18,Portugalete,expenses,internet,-42.0,-73242.28
buyer_7,Mar√≠a,,1968-12-31,ES68209528285169439268,TRX_N-00802-65831794,2023-12-09T10:16:03,Portugalete,expenses,repairs,-34.73,-73277.01
buyer_7,Mar√≠a,,1968-12-31,ES68209528285169439268,TRX_N-00803-18347467,2023-12-10T12:15:36,Portugalete,expenses,leisure,-32.7,-73309.71
buyer_7,Mar√≠a,,1968-12-31,ES68209528285169439268,TRX_N-00804-70349971,2023-12-11T20:21:05,Portugalete,expenses,food,-119.04,-73428.75
buyer_7,Mar√≠a,,1968-12-31,ES68209528285169439268,TRX_N-00805-93827510,2023-12-13T08:05:49,Portugalete,expenses,leisure,-29.47,-73458.22
buyer_7,Mar√≠a,,1968-12-31,ES68209528285169439268,TRX_N-00806-68650120,2023-12-14T18:25:10,Portugalete,expenses,cash,-100.0,-73558.22
buyer_7,Mar√≠a,,1968-12-31,ES68209528285169439268,TRX_N-00807-25677242,2023-12-15T12:17:07,Portugalete,expenses,leisure,-58.53,-73616.75
buyer_7,Mar√≠a,,1968-12-31,ES68209528285169439268,TRX_N-00808-96511089,2023-12-15T09:55:12,Portugalete,expenses,cash,-100.0,-73716.75
buyer_7,Mar√≠a,,1968-12-31,ES68209528285169439268,TRX_N-00809-39984536,2023-12-18T10:02:06,Portugalete,expenses,leisure,-59.35,-73776.1
buyer_7,Mar√≠a,,1968-12-31,ES68209528285169439268,TRX_N-00810-57553661,2023-12-19T16:51:01,Portugalete,expenses,food,-83.4,-73859.5
buyer_7,Mar√≠a,,1968-12-31,ES68209528285169439268,TRX_N-00811-88076137,2023-12-21T11:49:20,Portugalete,expenses,cash,-100.0,-73959.5
buyer_7,Mar√≠a,,1968-12-31,ES68209528285169439268,TRX_N-00812-37964811,2023-12-22T06:46:25,Portugalete,expenses,transport,-54.36,-74013.86
buyer_7,Mar√≠a,,1968-12-31,ES68209528285169439268,TRX_N-00813-43037356,2023-12-22T18:44:56,Portugalete,expenses,leisure,-78.39,-74092.25
buyer_7,Mar√≠a,,1968-12-31,ES68209528285169439268,TRX_N-00814-52045100,2023-12-22T18:30:51,Portugalete,expenses,clothing,-129.06,-74221.31
buyer_7,Mar√≠a,,1968-12-31,ES68209528285169439268,TRX_N-00815-87837940,2023-12-22T19:15:19,Portugalete,expenses,cash,-100.0,-74321.31
buyer_7,Mar√≠a,,1968-12-31,ES68209528285169439268,TRX_N-00816-01242485,2023-12-23T10:16:01,Portugalete,expenses,car,-285.01,-74606.32
buyer_7,Mar√≠a,,1968-12-31,ES68209528285169439268,TRX_N-00817-09254788,2023-12-24T17:26:06,Portugalete,expenses,food,-65.0,-74671.32
buyer_7,Mar√≠a,,1968-12-31,ES68209528285169439268,TRX_N-00818-70153052,2023-12-27T12:13:34,Portugalete,expenses,cash,-100.0,-74771.32
buyer_7,Mar√≠a,,1968-12-31,ES68209528285169439268,TRX_N-00819-17201493,2023-12-27T04:04:40,Portugalete,expenses,children,-530.63,-75301.95
buyer_7,Mar√≠a,,1968-12-31,ES68209528285169439268,TRX_N-00820-34780958,2023-12-28T10:02:41,Portugalete,expenses,leisure,-49.38,-75351.33
buyer_7,Mar√≠a,,1968-12-31,ES68209528285169439268,TRX_N-00821-58871747,2023-12-28T00:58:49,Portugalete,expenses,repairs,-149.79,-75501.12
buyer_7,Mar√≠a,,1968-12-31,ES68209528285169439268,TRX_N-00822-78449113,2023-12-29T14:30:40,Portugalete,expenses,gifts,-234.92,-75736.04
buyer_7,Mar√≠a,,1968-12-31,ES68209528285169439268,TRX_N-00823-79652981,2023-12-30T15:14:44,Portugalete,expenses,cash,-100.0,-75836.04
buyer_7,Mar√≠a,,1968-12-31,ES68209528285169439268,TRX_N-00824-05126240,2023-12-31T18:13:12,Portugalete,expenses,food,-106.14,-75942.18
buyer_7,Mar√≠a,,1968-12-31,ES68209528285169439268,TRX_N-00825-12950855,2024-01-01T05:58:07,Portugalete,incomes,salary,1371.41,-74570.77
buyer_7,Mar√≠a,,1968-12-31,ES68209528285169439268,TRX_N-00826-22132452,2024-01-03T16:19:43,Portugalete,expenses,cash,-100.0,-74670.77
buyer_7,Mar√≠a,,1968-12-31,ES68209528285169439268,TRX_N-00827-37137405,2024-01-04T18:18:04,Portugalete,expenses,mortgage,-764.17,-75434.94
buyer_7,Mar√≠a,,1968-12-31,ES68209528285169439268,TRX_N-00828-53385293,2024-01-04T10:22:59,Portugalete,expenses,food,-75.6,-75510.54
buyer_7,Mar√≠a,,1968-12-31,ES68209528285169439268,TRX_N-00829-08500459,2024-01-04T10:27:32,Portugalete,expenses,leisure,-54.28,-75564.82
buyer_7,Mar√≠a,,1968-12-31,ES68209528285169439268,TRX_N-00830-54818777,2024-01-05T15:27:09,Sopela,expenses,food,-95.46,-75660.28
buyer_7,Mar√≠a,,1968-12-31,ES68209528285169439268,TRX_N-00831-70169333,2024-01-06T19:02:00,Portugalete,expenses,electricity,-40.37,-75700.65
buyer_7,Mar√≠a,,1968-12-31,ES68209528285169439268,TRX_N-00832-19648144,2024-01-06T03:19:55,Portugalete,expenses,phone,-32.0,-75732.65
buyer_7,Mar√≠a,,1968-12-31,ES68209528285169439268,TRX_N-00833-66741709,2024-01-06T19:06:38,Portugalete,expenses,food,-71.07,-75803.72
buyer_7,Mar√≠a,,1968-12-31,ES68209528285169439268,TRX_N-00834-17330015,2024-01-06T08:39:03,Portugalete,expenses,transport,-66.23,-75869.95
buyer_7,Mar√≠a,,1968-12-31,ES68209528285169439268,TRX_N-00835-68555032,2024-01-07T08:49:36,Portugalete,expenses,water,-42.75,-75912.7
buyer_7,Mar√≠a,,1968-12-31,ES68209528285169439268,TRX_N-00836-05309977,2024-01-07T00:57:42,Portugalete,expenses,gas,-49.28,-75961.98
buyer_7,Mar√≠a,,1968-12-31,ES68209528285169439268,TRX_N-00837-82540363,2024-01-07T23:24:15,Portugalete,expenses,leisure,-31.84,-75993.82
buyer_7,Mar√≠a,,1968-12-31,ES68209528285169439268,TRX_N-00838-27978407,2024-01-08T16:40:52,Portugalete,expenses,internet,-42.0,-76035.82
buyer_7,Mar√≠a,,1968-12-31,ES68209528285169439268,TRX_N-00839-24088561,2024-01-08T18:02:58,Getxo,expenses,food,-95.47,-76131.29
buyer_7,Mar√≠a,,1968-12-31,ES68209528285169439268,TRX_N-00840-77746410,2024-01-09T20:06:19,Berango,expenses,transport,-56.08,-76187.37
buyer_7,Mar√≠a,,1968-12-31,ES68209528285169439268,TRX_N-00841-40768468,2024-01-09T11:06:38,Portugalete,expenses,education,-68.63,-76256.0
buyer_7,Mar√≠a,,1968-12-31,ES68209528285169439268,TRX_N-00842-74338674,2024-01-09T17:15:50,Portugalete,expenses,cash,-100.0,-76356.0
buyer_7,Mar√≠a,,1968-12-31,ES68209528285169439268,TRX_N-00843-91146726,2024-01-10T10:01:34,Portugalete,expenses,cash,-100.0,-76456.0
buyer_7,Mar√≠a,,1968-12-31,ES68209528285169439268,TRX_N-00844-36072944,2024-01-10T10:19:50,Portugalete,expenses,car,-120.9,-76576.9
buyer_7,Mar√≠a,,1968-12-31,ES68209528285169439268,TRX_N-00845-36458156,2024-01-11T13:01:54,Alegr√≠a-Dulantzi,expenses,food,-115.7,-76692.6
buyer_7,Mar√≠a,,1968-12-31,ES68209528285169439268,TRX_N-00846-17358639,2024-01-12T14:54:32,Eibar,expenses,food,-122.01,-76814.61
buyer_7,Mar√≠a,,1968-12-31,ES68209528285169439268,TRX_N-00847-52196482,2024-01-15T14:20:10,Portugalete,expenses,transport,-70.03,-76884.64
buyer_7,Mar√≠a,,1968-12-31,ES68209528285169439268,TRX_N-00848-48411186,2024-01-15T15:33:57,Portugalete,expenses,cash,-100.0,-76984.64
buyer_7,Mar√≠a,,1968-12-31,ES68209528285169439268,TRX_N-00849-72545095,2024-01-17T07:38:21,Portugalete,expenses,food,-77.82,-77062.46
buyer_7,Mar√≠a,,1968-12-31,ES68209528285169439268,TRX_N-00850-72118052,2024-01-17T15:00:59,Portugalete,expenses,appliances,-297.49,-77359.95
buyer_7,Mar√≠a,,1968-12-31,ES68209528285169439268,TRX_N-00851-55600837,2024-01-21T19:29:08,Portugalete,expenses,clothing,-74.42,-77434.37
buyer_7,Mar√≠a,,1968-12-31,ES68209528285169439268,TRX_N-00852-80028909,2024-01-21T19:54:29,Portugalete,expenses,cash,-100.0,-77534.37
buyer_7,Mar√≠a,,1968-12-31,ES68209528285169439268,TRX_N-00853-81041366,2024-01-22T19:51:23,Portugalete,expenses,food,-67.54,-77601.91
buyer_7,Mar√≠a,,1968-12-31,ES68209528285169439268,TRX_N-00854-88804289,2024-01-22T05:52:44,Portugalete,expenses,children,-715.68,-78317.59
buyer_7,Mar√≠a,,1968-12-31,ES68209528285169439268,TRX_N-00855-33461431,2024-01-23T18:36:12,Sopela,expenses,transport,-76.39,-78393.98
buyer_7,Mar√≠a,,1968-12-31,ES68209528285169439268,TRX_N-00856-87321895,2024-01-23T22:55:57,Portugalete,expenses,children,-494.26,-78888.24
buyer_7,Mar√≠a,,1968-12-31,ES68209528285169439268,TRX_N-00857-72017505,2024-01-24T19:44:34,Bilbao,expenses,cash,-100.0,-78988.24
buyer_7,Mar√≠a,,1968-12-31,ES68209528285169439268,TRX_N-00858-52455039,2024-01-24T08:31:44,Portugalete,expenses,children,-634.32,-79622.56
buyer_7,Mar√≠a,,1968-12-31,ES68209528285169439268,TRX_N-00859-74126167,2024-01-28T11:16:49,Portugalete,expenses,leisure,-34.18,-79656.74
buyer_7,Mar√≠a,,1968-12-31,ES68209528285169439268,TRX_N-00860-55083713,2024-01-29T22:04:06,Portugalete,expenses,transport,-66.03,-79722.77
buyer_7,Mar√≠a,,1968-12-31,ES68209528285169439268,TRX_N-00861-82981654,2024-01-30T13:15:50,Portugalete,expenses,food,-69.07,-79791.84
buyer_7,Mar√≠a,,1968-12-31,ES68209528285169439268,TRX_N-00862-08366528,2024-01-30T08:39:07,Portugalete,expenses,leisure,-50.46,-79842.3
buyer_7,Mar√≠a,,1968-12-31,ES68209528285169439268,TRX_N-00863-51154272,2024-01-31T13:06:14,Labastida,expenses,food,-100.13,-79942.43
buyer_7,Mar√≠a,,1968-12-31,ES68209528285169439268,TRX_N-00864-71529153,2024-02-01T13:17:45,Portugalete,incomes,salary,1371.41,-78571.02
buyer_7,Mar√≠a,,1968-12-31,ES68209528285169439268,TRX_N-00865-53092959,2024-02-01T13:17:45,Portugalete,incomes,extra_income,186.42,-78384.6
buyer_7,Mar√≠a,,1968-12-31,ES68209528285169439268,TRX_N-00866-85748829,2024-02-01T08:38:48,Portugalete,expenses,food,-65.84,-78450.44
buyer_7,Mar√≠a,,1968-12-31,ES68209528285169439268,TRX_N-00867-71737046,2024-02-02T14:28:48,Portugalete,expenses,children,-367.2,-78817.64
buyer_7,Mar√≠a,,1968-12-31,ES68209528285169439268,TRX_N-00868-04105303,2024-02-04T14:48:07,Portugalete,expenses,mortgage,-764.17,-79581.81
buyer_7,Mar√≠a,,1968-12-31,ES68209528285169439268,TRX_N-00869-48876809,2024-02-04T11:41:14,Erandio,expenses,clothing,-135.62,-79717.43
buyer_7,Mar√≠a,,1968-12-31,ES68209528285169439268,TRX_N-00870-38743343,2024-02-04T13:57:04,Portugalete,expenses,travel,-1562.42,-81279.85
buyer_7,Mar√≠a,,1968-12-31,ES68209528285169439268,TRX_N-00871-67677018,2024-02-04T12:58:04,Portugalete,expenses,children,-239.98,-81519.83
buyer_7,Mar√≠a,,1968-12-31,ES68209528285169439268,TRX_N-00872-48624351,2024-02-05T20:11:44,Portugalete,expenses,clothing,-46.55,-81566.38
buyer_7,Mar√≠a,,1968-12-31,ES68209528285169439268,TRX_N-00873-50681521,2024-02-05T11:58:46,Llodio,expenses,cash,-100.0,-81666.38
buyer_7,Mar√≠a,,1968-12-31,ES68209528285169439268,TRX_N-00874-34649301,2024-02-06T21:04:46,Portugalete,expenses,gas,-104.17,-81770.55
buyer_7,Mar√≠a,,1968-12-31,ES68209528285169439268,TRX_N-00875-68359175,2024-02-06T10:42:20,Portugalete,expenses,internet,-42.0,-81812.55
buyer_7,Mar√≠a,,1968-12-31,ES68209528285169439268,TRX_N-00876-40028849,2024-02-08T07:29:02,Portugalete,expenses,water,-35.06,-81847.61
buyer_7,Mar√≠a,,1968-12-31,ES68209528285169439268,TRX_N-00877-59716066,2024-02-08T20:52:24,Portugalete,expenses,electricity,-57.35,-81904.96
buyer_7,Mar√≠a,,1968-12-31,ES68209528285169439268,TRX_N-00878-09844820,2024-02-08T08:57:07,Portugalete,expenses,phone,-32.0,-81936.96
buyer_7,Mar√≠a,,1968-12-31,ES68209528285169439268,TRX_N-00879-28831726,2024-02-10T12:39:41,Durango,expenses,cash,-100.0,-82036.96
buyer_7,Mar√≠a,,1968-12-31,ES68209528285169439268,TRX_N-00880-80359338,2024-02-11T13:46:16,Portugalete,expenses,leisure,-57.43,-82094.39
buyer_7,Mar√≠a,,1968-12-31,ES68209528285169439268,TRX_N-00881-57294324,2024-02-13T17:45:55,Portugalete,expenses,leisure,-68.86,-82163.25
buyer_7,Mar√≠a,,1968-12-31,ES68209528285169439268,TRX_N-00882-08455592,2024-02-13T14:57:23,Portugalete,expenses,repairs,-104.39,-82267.64
buyer_7,Mar√≠a,,1968-12-31,ES68209528285169439268,TRX_N-00883-21668224,2024-02-15T19:21:44,Portugalete,expenses,gifts,-31.95,-82299.59
buyer_7,Mar√≠a,,1968-12-31,ES68209528285169439268,TRX_N-00884-03695338,2024-02-16T16:50:44,Portugalete,expenses,leisure,-42.06,-82341.65
buyer_7,Mar√≠a,,1968-12-31,ES68209528285169439268,TRX_N-00885-28066218,2024-02-17T10:34:20,Portugalete,expenses,transport,-63.39,-82405.04
buyer_7,Mar√≠a,,1968-12-31,ES68209528285169439268,TRX_N-00886-49829197,2024-02-17T15:02:13,Portugalete,expenses,cash,-100.0,-82505.04
buyer_7,Mar√≠a,,1968-12-31,ES68209528285169439268,TRX_N-00887-62867196,2024-02-20T18:29:29,Portugalete,expenses,food,-79.07,-82584.11
buyer_7,Mar√≠a,,1968-12-31,ES68209528285169439268,TRX_N-00888-16528059,2024-02-20T10:15:43,Alegr√≠a-Dulantzi,expenses,repairs,-188.87,-82772.98
buyer_7,Mar√≠a,,1968-12-31,ES68209528285169439268,TRX_N-00889-19059084,2024-02-21T23:13:10,Portugalete,expenses,cash,-100.0,-82872.98
buyer_7,Mar√≠a,,1968-12-31,ES68209528285169439268,TRX_N-00890-98909567,2024-02-26T20:52:43,Durango,expenses,appliances,-75.24,-82948.22
buyer_7,Mar√≠a,,1968-12-31,ES68209528285169439268,TRX_N-00891-24388475,2024-02-28T12:35:09,Iru√±a de Oca,expenses,food,-68.25,-83016.47
buyer_7,Mar√≠a,,1968-12-31,ES68209528285169439268,TRX_N-00892-88509311,2024-03-01T17:59:27,Portugalete,incomes,salary,1371.41,-81645.06
buyer_7,Mar√≠a,,1968-12-31,ES68209528285169439268,TRX_N-00893-41983790,2024-03-01T15:36:47,Portugalete,expenses,leisure,-83.41,-81728.47
buyer_7,Mar√≠a,,1968-12-31,ES68209528285169439268,TRX_N-00894-72148161,2024-03-01T11:12:46,Portugalete,expenses,repairs,-287.03,-82015.5
buyer_7,Mar√≠a,,1968-12-31,ES68209528285169439268,TRX_N-00895-06297511,2024-03-04T22:08:20,Portugalete,expenses,mortgage,-764.17,-82779.67
buyer_7,Mar√≠a,,1968-12-31,ES68209528285169439268,TRX_N-00896-22132093,2024-03-04T10:48:50,Portugalete,expenses,leisure,-69.87,-82849.54
buyer_7,Mar√≠a,,1968-12-31,ES68209528285169439268,TRX_N-00897-49767336,2024-03-04T19:48:39,Portugalete,expenses,gifts,-151.66,-83001.2
buyer_7,Mar√≠a,,1968-12-31,ES68209528285169439268,TRX_N-00898-06563047,2024-03-05T22:58:50,Portugalete,expenses,phone,-35.62,-83036.82
buyer_7,Mar√≠a,,1968-12-31,ES68209528285169439268,TRX_N-00899-98564086,2024-03-06T23:18:34,Portugalete,expenses,transport,-57.77,-83094.59
buyer_7,Mar√≠a,,1968-12-31,ES68209528285169439268,TRX_N-00900-61570378,2024-03-06T09:30:04,Portugalete,expenses,repairs,-131.44,-83226.03
buyer_7,Mar√≠a,,1968-12-31,ES68209528285169439268,TRX_N-00901-91158441,2024-03-08T12:34:54,Portugalete,expenses,water,-37.93,-83263.96
buyer_7,Mar√≠a,,1968-12-31,ES68209528285169439268,TRX_N-00902-17395360,2024-03-08T21:07:58,Portugalete,expenses,electricity,-61.88,-83325.84
buyer_7,Mar√≠a,,1968-12-31,ES68209528285169439268,TRX_N-00903-46570672,2024-03-08T09:50:12,Portugalete,expenses,gas,-49.6,-83375.44
buyer_7,Mar√≠a,,1968-12-31,ES68209528285169439268,TRX_N-00904-88955510,2024-03-08T17:14:21,Portugalete,expenses,internet,-42.0,-83417.44
buyer_7,Mar√≠a,,1968-12-31,ES68209528285169439268,TRX_N-00905-32173648,2024-03-10T12:39:48,Portugalete,expenses,cash,-100.0,-83517.44
buyer_7,Mar√≠a,,1968-12-31,ES68209528285169439268,TRX_N-00906-45024283,2024-03-13T16:41:30,Portugalete,expenses,food,-113.85,-83631.29
buyer_7,Mar√≠a,,1968-12-31,ES68209528285169439268,TRX_N-00907-90874880,2024-03-14T16:23:05,Elciego,expenses,food,-86.41,-83717.7
buyer_7,Mar√≠a,,1968-12-31,ES68209528285169439268,TRX_N-00908-30351657,2024-03-15T13:27:02,Portugalete,expenses,food,-68.76,-83786.46
buyer_7,Mar√≠a,,1968-12-31,ES68209528285169439268,TRX_N-00909-66517592,2024-03-16T00:23:44,Portugalete,expenses,leisure,-50.61,-83837.07
buyer_7,Mar√≠a,,1968-12-31,ES68209528285169439268,TRX_N-00910-09689789,2024-03-16T19:25:22,Portugalete,expenses,cash,-100.0,-83937.07
buyer_7,Mar√≠a,,1968-12-31,ES68209528285169439268,TRX_N-00911-82862673,2024-03-16T15:51:09,Portugalete,expenses,repairs,-135.85,-84072.92
buyer_7,Mar√≠a,,1968-12-31,ES68209528285169439268,TRX_N-00912-88316024,2024-03-17T12:59:48,Portugalete,expenses,education,-71.8,-84144.72
buyer_7,Mar√≠a,,1968-12-31,ES68209528285169439268,TRX_N-00913-14060778,2024-03-18T14:13:20,Portugalete,expenses,cash,-100.0,-84244.72
buyer_7,Mar√≠a,,1968-12-31,ES68209528285169439268,TRX_N-00914-92082886,2024-03-19T13:59:46,Portugalete,expenses,food,-86.7,-84331.42
buyer_7,Mar√≠a,,1968-12-31,ES68209528285169439268,TRX_N-00915-66163263,2024-03-20T09:10:30,Portugalete,expenses,leisure,-80.31,-84411.73
buyer_7,Mar√≠a,,1968-12-31,ES68209528285169439268,TRX_N-00916-51457373,2024-03-20T19:08:59,Arrasate,expenses,clothing,-152.64,-84564.37
buyer_7,Mar√≠a,,1968-12-31,ES68209528285169439268,TRX_N-00917-20437608,2024-03-23T14:36:52,Portugalete,expenses,leisure,-56.42,-84620.79
buyer_7,Mar√≠a,,1968-12-31,ES68209528285169439268,TRX_N-00918-92347713,2024-03-24T18:45:08,Portugalete,expenses,gifts,-95.15,-84715.94
buyer_7,Mar√≠a,,1968-12-31,ES68209528285169439268,TRX_N-00919-25712490,2024-03-25T16:45:48,Portugalete,expenses,gifts,-310.65,-85026.59
buyer_7,Mar√≠a,,1968-12-31,ES68209528285169439268,TRX_N-00920-15102578,2024-03-27T19:42:31,Elciego,expenses,education,-73.78,-85100.37
buyer_7,Mar√≠a,,1968-12-31,ES68209528285169439268,TRX_N-00921-57893428,2024-03-30T15:54:58,Portugalete,expenses,healthcare,-123.89,-85224.26
buyer_7,Mar√≠a,,1968-12-31,ES68209528285169439268,TRX_N-00922-70449141,2024-03-31T09:44:02,Portugalete,expenses,leisure,-83.74,-85308.0
buyer_7,Mar√≠a,,1968-12-31,ES68209528285169439268,TRX_N-00923-18342660,2024-04-01T20:59:27,Portugalete,incomes,salary,1371.41,-83936.59
buyer_7,Mar√≠a,,1968-12-31,ES68209528285169439268,TRX_N-00924-95756679,2024-04-01T15:50:17,Portugalete,expenses,education,-55.15,-83991.74
buyer_7,Mar√≠a,,1968-12-31,ES68209528285169439268,TRX_N-00925-63574164,2024-04-01T19:25:32,Portugalete,expenses,cash,-100.0,-84091.74
buyer_7,Mar√≠a,,1968-12-31,ES68209528285169439268,TRX_N-00926-36189622,2024-04-01T18:24:05,Portugalete,expenses,repairs,-177.5,-84269.24
buyer_7,Mar√≠a,,1968-12-31,ES68209528285169439268,TRX_N-00927-17509158,2024-04-03T10:37:37,Portugalete,expenses,leisure,-52.78,-84322.02
buyer_7,Mar√≠a,,1968-12-31,ES68209528285169439268,TRX_N-00928-21505918,2024-04-04T19:01:37,Portugalete,expenses,mortgage,-764.17,-85086.19
buyer_7,Mar√≠a,,1968-12-31,ES68209528285169439268,TRX_N-00929-66913258,2024-04-05T15:03:00,Portugalete,expenses,water,-26.78,-85112.97
buyer_7,Mar√≠a,,1968-12-31,ES68209528285169439268,TRX_N-00930-53202836,2024-04-05T16:08:43,Portugalete,expenses,phone,-36.54,-85149.51
buyer_7,Mar√≠a,,1968-12-31,ES68209528285169439268,TRX_N-00931-48526092,2024-04-05T18:27:34,Portugalete,expenses,transport,-69.19,-85218.7
buyer_7,Mar√≠a,,1968-12-31,ES68209528285169439268,TRX_N-00932-36385753,2024-04-06T10:53:13,Portugalete,expenses,electricity,-51.25,-85269.95
buyer_7,Mar√≠a,,1968-12-31,ES68209528285169439268,TRX_N-00933-05625375,2024-04-06T15:15:01,Portugalete,expenses,leisure,-74.95,-85344.9
buyer_7,Mar√≠a,,1968-12-31,ES68209528285169439268,TRX_N-00934-77773062,2024-04-08T09:19:39,Portugalete,expenses,gas,-87.79,-85432.69
buyer_7,Mar√≠a,,1968-12-31,ES68209528285169439268,TRX_N-00935-38638332,2024-04-08T16:45:52,Portugalete,expenses,internet,-42.0,-85474.69
buyer_7,Mar√≠a,,1968-12-31,ES68209528285169439268,TRX_N-00936-94355899,2024-04-09T16:16:04,Portugalete,expenses,cash,-100.0,-85574.69
buyer_7,Mar√≠a,,1968-12-31,ES68209528285169439268,TRX_N-00937-40308576,2024-04-10T09:50:24,Portugalete,expenses,cash,-100.0,-85674.69
buyer_7,Mar√≠a,,1968-12-31,ES68209528285169439268,TRX_N-00938-19816658,2024-04-10T20:44:46,Bermeo,expenses,repairs,-32.72,-85707.41
buyer_7,Mar√≠a,,1968-12-31,ES68209528285169439268,TRX_N-00939-64922736,2024-04-12T19:47:38,Portugalete,expenses,clothing,-56.21,-85763.62
buyer_7,Mar√≠a,,1968-12-31,ES68209528285169439268,TRX_N-00940-43983701,2024-04-16T11:09:09,Portugalete,expenses,food,-68.85,-85832.47
buyer_7,Mar√≠a,,1968-12-31,ES68209528285169439268,TRX_N-00941-72546511,2024-04-16T08:15:01,Portugalete,expenses,leisure,-58.38,-85890.85
buyer_7,Mar√≠a,,1968-12-31,ES68209528285169439268,TRX_N-00942-13551362,2024-04-18T19:28:32,Portugalete,expenses,food,-71.8,-85962.65
buyer_7,Mar√≠a,,1968-12-31,ES68209528285169439268,TRX_N-00943-98170805,2024-04-19T06:07:48,Portugalete,expenses,transport,-85.37,-86048.02
buyer_7,Mar√≠a,,1968-12-31,ES68209528285169439268,TRX_N-00944-24249100,2024-04-20T14:56:52,Salvatierra/Agurain,expenses,leisure,-39.13,-86087.15
buyer_7,Mar√≠a,,1968-12-31,ES68209528285169439268,TRX_N-00945-51606173,2024-04-20T20:07:42,Portugalete,expenses,cash,-100.0,-86187.15
buyer_7,Mar√≠a,,1968-12-31,ES68209528285169439268,TRX_N-00946-16354996,2024-04-22T17:48:14,Portugalete,expenses,food,-113.09,-86300.24
buyer_7,Mar√≠a,,1968-12-31,ES68209528285169439268,TRX_N-00947-56789868,2024-04-22T16:20:26,Portugalete,expenses,transport,-70.93,-86371.17
buyer_7,Mar√≠a,,1968-12-31,ES68209528285169439268,TRX_N-00948-45169181,2024-04-24T17:53:30,Llodio,expenses,cash,-100.0,-86471.17
buyer_7,Mar√≠a,,1968-12-31,ES68209528285169439268,TRX_N-00949-50881855,2024-04-25T09:20:04,Alegr√≠a-Dulantzi,expenses,leisure,-42.07,-86513.24
buyer_7,Mar√≠a,,1968-12-31,ES68209528285169439268,TRX_N-00950-94122450,2024-04-26T22:25:59,Portugalete,expenses,cash,-100.0,-86613.24
buyer_7,Mar√≠a,,1968-12-31,ES68209528285169439268,TRX_N-00951-61245405,2024-04-28T20:54:03,Portugalete,expenses,transport,-79.01,-86692.25
buyer_7,Mar√≠a,,1968-12-31,ES68209528285169439268,TRX_N-00952-63684180,2024-04-29T07:09:10,Portugalete,expenses,food,-89.69,-86781.94
buyer_7,Mar√≠a,,1968-12-31,ES68209528285169439268,TRX_N-00953-64554281,2024-05-01T09:33:45,Portugalete,incomes,salary,1371.41,-85410.53
buyer_7,Mar√≠a,,1968-12-31,ES68209528285169439268,TRX_N-00954-87663211,2024-05-02T12:57:39,Portugalete,expenses,leisure,-25.49,-85436.02
buyer_7,Mar√≠a,,1968-12-31,ES68209528285169439268,TRX_N-00955-98354489,2024-05-03T18:21:22,Portugalete,expenses,transport,-44.37,-85480.39
buyer_7,Mar√≠a,,1968-12-31,ES68209528285169439268,TRX_N-00956-12118217,2024-05-03T14:32:10,Sopela,expenses,cash,-100.0,-85580.39
buyer_7,Mar√≠a,,1968-12-31,ES68209528285169439268,TRX_N-00957-92345196,2024-05-03T23:50:39,Andoain,expenses,gifts,-55.25,-85635.64
buyer_7,Mar√≠a,,1968-12-31,ES68209528285169439268,TRX_N-00958-00672057,2024-05-04T11:16:37,Portugalete,expenses,mortgage,-764.17,-86399.81
buyer_7,Mar√≠a,,1968-12-31,ES68209528285169439268,TRX_N-00959-52435701,2024-05-04T08:44:23,Portugalete,expenses,healthcare,-165.3,-86565.11
buyer_7,Mar√≠a,,1968-12-31,ES68209528285169439268,TRX_N-00960-25530731,2024-05-05T18:42:59,Mungia,expenses,food,-103.41,-86668.52
buyer_7,Mar√≠a,,1968-12-31,ES68209528285169439268,TRX_N-00961-87871889,2024-05-05T15:22:24,Portugalete,expenses,leisure,-43.51,-86712.03
buyer_7,Mar√≠a,,1968-12-31,ES68209528285169439268,TRX_N-00962-61318869,2024-05-06T10:48:10,Portugalete,expenses,gas,-53.21,-86765.24
buyer_7,Mar√≠a,,1968-12-31,ES68209528285169439268,TRX_N-00963-16705697,2024-05-07T08:30:37,Portugalete,expenses,water,-33.78,-86799.02
buyer_7,Mar√≠a,,1968-12-31,ES68209528285169439268,TRX_N-00964-07465182,2024-05-07T18:43:58,Portugalete,expenses,transport,-55.75,-86854.77
buyer_7,Mar√≠a,,1968-12-31,ES68209528285169439268,TRX_N-00965-02019090,2024-05-07T17:13:54,Zuia,expenses,cash,-100.0,-86954.77
buyer_7,Mar√≠a,,1968-12-31,ES68209528285169439268,TRX_N-00966-08030545,2024-05-07T12:12:24,Portugalete,expenses,repairs,-229.24,-87184.01
buyer_7,Mar√≠a,,1968-12-31,ES68209528285169439268,TRX_N-00967-53072937,2024-05-08T08:26:29,Portugalete,expenses,phone,-37.57,-87221.58
buyer_7,Mar√≠a,,1968-12-31,ES68209528285169439268,TRX_N-00968-52792651,2024-05-08T18:34:35,Portugalete,expenses,electricity,-81.14,-87302.72
buyer_7,Mar√≠a,,1968-12-31,ES68209528285169439268,TRX_N-00969-81226460,2024-05-08T19:16:24,Portugalete,expenses,internet,-42.0,-87344.72
buyer_7,Mar√≠a,,1968-12-31,ES68209528285169439268,TRX_N-00970-36478055,2024-05-10T12:15:14,Portugalete,expenses,leisure,-53.74,-87398.46
buyer_7,Mar√≠a,,1968-12-31,ES68209528285169439268,TRX_N-00971-74553811,2024-05-10T08:18:48,Portugalete,expenses,healthcare,-115.87,-87514.33
buyer_7,Mar√≠a,,1968-12-31,ES68209528285169439268,TRX_N-00972-72119669,2024-05-11T14:30:29,Portugalete,expenses,leisure,-77.16,-87591.49
buyer_7,Mar√≠a,,1968-12-31,ES68209528285169439268,TRX_N-00973-46085775,2024-05-12T15:33:12,Portugalete,expenses,gifts,-734.3,-88325.79
buyer_7,Mar√≠a,,1968-12-31,ES68209528285169439268,TRX_N-00974-42996830,2024-05-12T18:13:07,Portugalete,expenses,car,-274.67,-88600.46
buyer_7,Mar√≠a,,1968-12-31,ES68209528285169439268,TRX_N-00975-53824792,2024-05-13T08:46:14,Portugalete,expenses,food,-75.07,-88675.53
buyer_7,Mar√≠a,,1968-12-31,ES68209528285169439268,TRX_N-00976-59087709,2024-05-14T01:09:45,Portugalete,expenses,cash,-100.0,-88775.53
buyer_7,Mar√≠a,,1968-12-31,ES68209528285169439268,TRX_N-00977-74038631,2024-05-15T05:15:49,Portugalete,expenses,food,-109.84,-88885.37
buyer_7,Mar√≠a,,1968-12-31,ES68209528285169439268,TRX_N-00978-86160852,2024-05-15T08:15:03,Berango,expenses,leisure,-65.17,-88950.54
buyer_7,Mar√≠a,,1968-12-31,ES68209528285169439268,TRX_N-00979-77372384,2024-05-17T12:01:59,Portugalete,expenses,food,-103.82,-89054.36
buyer_7,Mar√≠a,,1968-12-31,ES68209528285169439268,TRX_N-00980-78111646,2024-05-18T19:01:12,Portugalete,expenses,education,-61.47,-89115.83
buyer_7,Mar√≠a,,1968-12-31,ES68209528285169439268,TRX_N-00981-97408289,2024-05-19T14:32:59,Portugalete,expenses,food,-113.06,-89228.89
buyer_7,Mar√≠a,,1968-12-31,ES68209528285169439268,TRX_N-00982-16068547,2024-05-19T12:50:04,Portugalete,expenses,repairs,-268.72,-89497.61
buyer_7,Mar√≠a,,1968-12-31,ES68209528285169439268,TRX_N-00983-47727619,2024-05-21T17:25:34,Portugalete,expenses,cash,-100.0,-89597.61
buyer_7,Mar√≠a,,1968-12-31,ES68209528285169439268,TRX_N-00984-93655826,2024-05-22T08:48:14,Portugalete,expenses,cash,-100.0,-89697.61
buyer_7,Mar√≠a,,1968-12-31,ES68209528285169439268,TRX_N-00985-43242235,2024-05-22T20:08:02,Sopela,expenses,gifts,-66.88,-89764.49
buyer_7,Mar√≠a,,1968-12-31,ES68209528285169439268,TRX_N-00986-72818163,2024-05-23T20:55:50,Santurtzi,expenses,gifts,-462.54,-90227.03
buyer_7,Mar√≠a,,1968-12-31,ES68209528285169439268,TRX_N-00987-95906711,2024-05-25T14:16:06,Portugalete,expenses,healthcare,-149.47,-90376.5
buyer_7,Mar√≠a,,1968-12-31,ES68209528285169439268,TRX_N-00988-33854391,2024-05-26T21:23:14,Portugalete,expenses,leisure,-53.58,-90430.08
buyer_7,Mar√≠a,,1968-12-31,ES68209528285169439268,TRX_N-00989-50719748,2024-05-26T07:59:31,Portugalete,expenses,cash,-100.0,-90530.08
buyer_7,Mar√≠a,,1968-12-31,ES68209528285169439268,TRX_N-00990-25174776,2024-05-26T17:33:01,Portugalete,expenses,children,-148.85,-90678.93
buyer_7,Mar√≠a,,1968-12-31,ES68209528285169439268,TRX_N-00991-64379557,2024-05-27T17:14:01,Portugalete,expenses,cash,-100.0,-90778.93
buyer_7,Mar√≠a,,1968-12-31,ES68209528285169439268,TRX_N-00992-20425290,2024-05-28T11:43:20,Portugalete,expenses,transport,-81.77,-90860.7
buyer_7,Mar√≠a,,1968-12-31,ES68209528285169439268,TRX_N-00993-52599672,2024-05-29T09:31:53,Portugalete,expenses,leisure,-79.92,-90940.62
buyer_7,Mar√≠a,,1968-12-31,ES68209528285169439268,TRX_N-00994-65560722,2024-05-30T20:06:45,Oy√≥n-Oion,expenses,cash,-100.0,-91040.62
buyer_7,Mar√≠a,,1968-12-31,ES68209528285169439268,TRX_N-00995-58105375,2024-05-31T23:36:31,Portugalete,expenses,cash,-100.0,-91140.62
buyer_7,Mar√≠a,,1968-12-31,ES68209528285169439268,TRX_N-00996-45205212,2024-06-01T12:05:44,Portugalete,incomes,salary,1371.41,-89769.21
buyer_7,Mar√≠a,,1968-12-31,ES68209528285169439268,TRX_N-00997-11612811,2024-06-01T12:05:44,Portugalete,incomes,extra_income,186.42,-89582.79
buyer_7,Mar√≠a,,1968-12-31,ES68209528285169439268,TRX_N-00998-20762699,2024-06-01T12:05:44,Portugalete,incomes,salary_bonus,1008.82,-88573.97
buyer_7,Mar√≠a,,1968-12-31,ES68209528285169439268,TRX_N-00999-66534636,2024-06-01T10:01:58,Portugalete,expenses,transport,-88.15,-88662.12
buyer_7,Mar√≠a,,1968-12-31,ES68209528285169439268,TRX_N-01000-31966931,2024-06-03T09:17:20,Portugalete,expenses,leisure,-25.07,-88687.19
buyer_7,Mar√≠a,,1968-12-31,ES68209528285169439268,TRX_N-01001-29248449,2024-06-04T09:22:27,Portugalete,expenses,mortgage,-764.17,-89451.36
buyer_7,Mar√≠a,,1968-12-31,ES68209528285169439268,TRX_N-01002-71206390,2024-06-04T23:35:54,Portugalete,expenses,clothing,-123.6,-89574.96
buyer_7,Mar√≠a,,1968-12-31,ES68209528285169439268,TRX_N-01003-35130962,2024-06-04T02:41:59,Portugalete,expenses,gifts,-216.9,-89791.86
buyer_7,Mar√≠a,,1968-12-31,ES68209528285169439268,TRX_N-01004-41213178,2024-06-05T12:06:58,Portugalete,expenses,water,-25.66,-89817.52
buyer_7,Mar√≠a,,1968-12-31,ES68209528285169439268,TRX_N-01005-37349850,2024-06-05T16:03:00,Portugalete,expenses,phone,-38.36,-89855.88
buyer_7,Mar√≠a,,1968-12-31,ES68209528285169439268,TRX_N-01006-48973820,2024-06-06T17:21:53,Portugalete,expenses,electricity,-51.36,-89907.24
buyer_7,Mar√≠a,,1968-12-31,ES68209528285169439268,TRX_N-01007-78385198,2024-06-07T20:46:45,Portugalete,expenses,gas,-45.15,-89952.39
buyer_7,Mar√≠a,,1968-12-31,ES68209528285169439268,TRX_N-01008-83650810,2024-06-07T15:14:12,Portugalete,expenses,internet,-42.0,-89994.39
buyer_7,Mar√≠a,,1968-12-31,ES68209528285169439268,TRX_N-01009-60925454,2024-06-07T05:59:02,Llodio,expenses,cash,-100.0,-90094.39
buyer_7,Mar√≠a,,1968-12-31,ES68209528285169439268,TRX_N-01010-99174485,2024-06-08T12:19:20,Portugalete,expenses,food,-120.82,-90215.21
buyer_7,Mar√≠a,,1968-12-31,ES68209528285169439268,TRX_N-01011-53716736,2024-06-08T20:19:07,Portugalete,expenses,children,-406.07,-90621.28
buyer_7,Mar√≠a,,1968-12-31,ES68209528285169439268,TRX_N-01012-90037123,2024-06-09T18:40:28,Portugalete,expenses,travel,-748.87,-91370.15
buyer_7,Mar√≠a,,1968-12-31,ES68209528285169439268,TRX_N-01013-62177592,2024-06-11T00:02:39,Portugalete,expenses,education,-52.01,-91422.16
buyer_7,Mar√≠a,,1968-12-31,ES68209528285169439268,TRX_N-01014-36157151,2024-06-12T20:09:35,Portugalete,expenses,repairs,-260.29,-91682.45
buyer_7,Mar√≠a,,1968-12-31,ES68209528285169439268,TRX_N-01015-29141527,2024-06-13T18:46:03,Portugalete,expenses,repairs,-94.34,-91776.79
buyer_7,Mar√≠a,,1968-12-31,ES68209528285169439268,TRX_N-01016-23424788,2024-06-16T20:07:12,Portugalete,expenses,repairs,-173.87,-91950.66
buyer_7,Mar√≠a,,1968-12-31,ES68209528285169439268,TRX_N-01017-60591164,2024-06-21T20:58:22,Portugalete,expenses,gifts,-499.34,-92450.0
buyer_7,Mar√≠a,,1968-12-31,ES68209528285169439268,TRX_N-01018-39378035,2024-06-23T08:51:56,Sestao,expenses,cash,-100.0,-92550.0
buyer_7,Mar√≠a,,1968-12-31,ES68209528285169439268,TRX_N-01019-56950767,2024-06-25T15:18:13,Leioa,expenses,education,-70.04,-92620.04
buyer_7,Mar√≠a,,1968-12-31,ES68209528285169439268,TRX_N-01020-25620377,2024-06-25T21:57:34,Portugalete,expenses,children,-218.92,-92838.96
buyer_7,Mar√≠a,,1968-12-31,ES68209528285169439268,TRX_N-01021-48392540,2024-07-01T18:11:24,Portugalete,incomes,salary,1371.41,-91467.55
buyer_7,Mar√≠a,,1968-12-31,ES68209528285169439268,TRX_N-01022-08866207,2024-07-01T09:35:03,Portugalete,expenses,food,-80.49,-91548.04
buyer_7,Mar√≠a,,1968-12-31,ES68209528285169439268,TRX_N-01023-09405604,2024-07-01T14:47:03,Portugalete,expenses,transport,-87.76,-91635.8
buyer_7,Mar√≠a,,1968-12-31,ES68209528285169439268,TRX_N-01024-14789434,2024-07-02T08:56:57,Portugalete,expenses,food,-82.44,-91718.24
buyer_7,Mar√≠a,,1968-12-31,ES68209528285169439268,TRX_N-01025-62473620,2024-07-03T08:47:58,Portugalete,expenses,food,-110.23,-91828.47
buyer_7,Mar√≠a,,1968-12-31,ES68209528285169439268,TRX_N-01026-86595330,2024-07-04T22:17:01,Portugalete,expenses,mortgage,-764.17,-92592.64
buyer_7,Mar√≠a,,1968-12-31,ES68209528285169439268,TRX_N-01027-68264737,2024-07-06T14:37:01,Portugalete,expenses,electricity,-81.75,-92674.39
buyer_7,Mar√≠a,,1968-12-31,ES68209528285169439268,TRX_N-01028-00935541,2024-07-06T10:56:28,Portugalete,expenses,internet,-42.0,-92716.39
buyer_7,Mar√≠a,,1968-12-31,ES68209528285169439268,TRX_N-01029-65638812,2024-07-07T09:44:02,Portugalete,expenses,gas,-92.75,-92809.14
buyer_7,Mar√≠a,,1968-12-31,ES68209528285169439268,TRX_N-01030-90305110,2024-07-07T22:50:56,Portugalete,expenses,transport,-51.79,-92860.93
buyer_7,Mar√≠a,,1968-12-31,ES68209528285169439268,TRX_N-01031-59455687,2024-07-08T10:48:56,Portugalete,expenses,water,-35.62,-92896.55
buyer_7,Mar√≠a,,1968-12-31,ES68209528285169439268,TRX_N-01032-20711372,2024-07-08T07:02:49,Portugalete,expenses,phone,-39.09,-92935.64
buyer_7,Mar√≠a,,1968-12-31,ES68209528285169439268,TRX_N-01033-81077796,2024-07-08T10:50:02,Portugalete,expenses,food,-63.08,-92998.72
buyer_7,Mar√≠a,,1968-12-31,ES68209528285169439268,TRX_N-01034-66218336,2024-07-10T09:35:36,Portugalete,expenses,clothing,-94.86,-93093.58
buyer_7,Mar√≠a,,1968-12-31,ES68209528285169439268,TRX_N-01035-67595730,2024-07-11T14:52:49,Bermeo,expenses,food,-104.08,-93197.66
buyer_7,Mar√≠a,,1968-12-31,ES68209528285169439268,TRX_N-01036-54508286,2024-07-11T16:19:48,Portugalete,expenses,repairs,-54.54,-93252.2
buyer_7,Mar√≠a,,1968-12-31,ES68209528285169439268,TRX_N-01037-71712774,2024-07-12T19:08:44,Portugalete,expenses,repairs,-316.93,-93569.13
buyer_7,Mar√≠a,,1968-12-31,ES68209528285169439268,TRX_N-01038-31089636,2024-07-12T13:35:51,Portugalete,expenses,car,-306.8,-93875.93
buyer_7,Mar√≠a,,1968-12-31,ES68209528285169439268,TRX_N-01039-55899095,2024-07-13T21:49:06,Donostia,expenses,transport,-62.08,-93938.01
buyer_7,Mar√≠a,,1968-12-31,ES68209528285169439268,TRX_N-01040-16809968,2024-07-13T04:53:15,Portugalete,expenses,clothing,-79.29,-94017.3
buyer_7,Mar√≠a,,1968-12-31,ES68209528285169439268,TRX_N-01041-12570413,2024-07-16T07:27:44,Portugalete,expenses,cash,-100.0,-94117.3
buyer_7,Mar√≠a,,1968-12-31,ES68209528285169439268,TRX_N-01042-26094560,2024-07-18T07:42:35,Portugalete,expenses,cash,-100.0,-94217.3
buyer_7,Mar√≠a,,1968-12-31,ES68209528285169439268,TRX_N-01043-29295018,2024-07-20T09:02:29,Portugalete,expenses,clothing,-158.32,-94375.62
buyer_7,Mar√≠a,,1968-12-31,ES68209528285169439268,TRX_N-01044-43326735,2024-07-20T09:39:24,Portugalete,expenses,cash,-100.0,-94475.62
buyer_7,Mar√≠a,,1968-12-31,ES68209528285169439268,TRX_N-01045-28709317,2024-07-21T20:04:28,Portugalete,expenses,clothing,-116.22,-94591.84
buyer_7,Mar√≠a,,1968-12-31,ES68209528285169439268,TRX_N-01046-56596524,2024-07-22T18:07:48,Portugalete,expenses,repairs,-326.95,-94918.79
buyer_7,Mar√≠a,,1968-12-31,ES68209528285169439268,TRX_N-01047-85457463,2024-07-26T10:12:31,Portugalete,expenses,food,-81.8,-95000.59
buyer_7,Mar√≠a,,1968-12-31,ES68209528285169439268,TRX_N-01048-01195101,2024-07-26T12:57:50,Portugalete,expenses,leisure,-40.8,-95041.39
buyer_7,Mar√≠a,,1968-12-31,ES68209528285169439268,TRX_N-01049-32377300,2024-07-27T17:44:31,Santurtzi,expenses,leisure,-59.99,-95101.38
buyer_7,Mar√≠a,,1968-12-31,ES68209528285169439268,TRX_N-01050-42715113,2024-07-28T11:52:34,Portugalete,expenses,food,-106.67,-95208.05
buyer_7,Mar√≠a,,1968-12-31,ES68209528285169439268,TRX_N-01051-22079894,2024-08-01T20:11:24,Portugalete,incomes,salary,1371.41,-93836.64
buyer_7,Mar√≠a,,1968-12-31,ES68209528285169439268,TRX_N-01052-65232629,2024-08-01T12:31:11,Portugalete,expenses,cash,-100.0,-93936.64
buyer_7,Mar√≠a,,1968-12-31,ES68209528285169439268,TRX_N-01053-54886103,2024-08-01T03:30:04,Portugalete,expenses,repairs,-166.57,-94103.21
buyer_7,Mar√≠a,,1968-12-31,ES68209528285169439268,TRX_N-01054-89519630,2024-08-03T09:51:10,Portugalete,expenses,transport,-52.26,-94155.47
buyer_7,Mar√≠a,,1968-12-31,ES68209528285169439268,TRX_N-01055-87965383,2024-08-03T17:15:16,Portugalete,expenses,cash,-100.0,-94255.47
buyer_7,Mar√≠a,,1968-12-31,ES68209528285169439268,TRX_N-01056-67134272,2024-08-04T11:37:57,Portugalete,expenses,mortgage,-764.17,-95019.64
buyer_7,Mar√≠a,,1968-12-31,ES68209528285169439268,TRX_N-01057-66253798,2024-08-05T18:02:48,Portugalete,expenses,gas,-62.93,-95082.57
buyer_7,Mar√≠a,,1968-12-31,ES68209528285169439268,TRX_N-01058-00331330,2024-08-05T16:27:14,Portugalete,expenses,internet,-42.0,-95124.57
buyer_7,Mar√≠a,,1968-12-31,ES68209528285169439268,TRX_N-01059-50137915,2024-08-05T13:00:57,Portugalete,expenses,leisure,-31.14,-95155.71
buyer_7,Mar√≠a,,1968-12-31,ES68209528285169439268,TRX_N-01060-83990143,2024-08-05T09:44:39,Zarautz,expenses,cash,-100.0,-95255.71
buyer_7,Mar√≠a,,1968-12-31,ES68209528285169439268,TRX_N-01061-15400394,2024-08-06T10:35:15,Portugalete,expenses,water,-44.58,-95300.29
buyer_7,Mar√≠a,,1968-12-31,ES68209528285169439268,TRX_N-01062-45465456,2024-08-07T17:36:45,Portugalete,expenses,leisure,-81.08,-95381.37
buyer_7,Mar√≠a,,1968-12-31,ES68209528285169439268,TRX_N-01063-21072673,2024-08-07T14:18:32,Portugalete,expenses,cash,-100.0,-95481.37
buyer_7,Mar√≠a,,1968-12-31,ES68209528285169439268,TRX_N-01064-18253738,2024-08-08T20:12:33,Portugalete,expenses,electricity,-38.04,-95519.41
buyer_7,Mar√≠a,,1968-12-31,ES68209528285169439268,TRX_N-01065-05733848,2024-08-08T09:04:39,Portugalete,expenses,phone,-41.59,-95561.0
buyer_7,Mar√≠a,,1968-12-31,ES68209528285169439268,TRX_N-01066-40693735,2024-08-09T07:18:40,Berango,expenses,transport,-51.95,-95612.95
buyer_7,Mar√≠a,,1968-12-31,ES68209528285169439268,TRX_N-01067-90302561,2024-08-09T11:14:32,Portugalete,expenses,leisure,-38.74,-95651.69
buyer_7,Mar√≠a,,1968-12-31,ES68209528285169439268,TRX_N-01068-53654695,2024-08-10T09:38:27,Portugalete,expenses,cash,-100.0,-95751.69
buyer_7,Mar√≠a,,1968-12-31,ES68209528285169439268,TRX_N-01069-31801124,2024-08-13T18:58:55,Barakaldo,expenses,cash,-100.0,-95851.69
buyer_7,Mar√≠a,,1968-12-31,ES68209528285169439268,TRX_N-01070-15128595,2024-08-13T13:23:12,Portugalete,expenses,repairs,-134.56,-95986.25
buyer_7,Mar√≠a,,1968-12-31,ES68209528285169439268,TRX_N-01071-58649299,2024-08-14T17:03:18,Portugalete,expenses,transport,-75.57,-96061.82
buyer_7,Mar√≠a,,1968-12-31,ES68209528285169439268,TRX_N-01072-11636020,2024-08-14T08:07:32,Portugalete,expenses,cash,-100.0,-96161.82
buyer_7,Mar√≠a,,1968-12-31,ES68209528285169439268,TRX_N-01073-16814221,2024-08-16T19:48:03,Portugalete,expenses,leisure,-33.66,-96195.48
buyer_7,Mar√≠a,,1968-12-31,ES68209528285169439268,TRX_N-01074-85679689,2024-08-16T14:42:39,Portugalete,expenses,cash,-100.0,-96295.48
buyer_7,Mar√≠a,,1968-12-31,ES68209528285169439268,TRX_N-01075-68589761,2024-08-17T20:50:21,Portugalete,expenses,clothing,-49.26,-96344.74
buyer_7,Mar√≠a,,1968-12-31,ES68209528285169439268,TRX_N-01076-43533902,2024-08-17T11:11:29,Portugalete,expenses,children,-167.52,-96512.26
buyer_7,Mar√≠a,,1968-12-31,ES68209528285169439268,TRX_N-01077-19791600,2024-08-18T13:40:38,Andoain,expenses,food,-112.35,-96624.61
buyer_7,Mar√≠a,,1968-12-31,ES68209528285169439268,TRX_N-01078-32037619,2024-08-20T15:09:55,Portugalete,expenses,car,-136.2,-96760.81
buyer_7,Mar√≠a,,1968-12-31,ES68209528285169439268,TRX_N-01079-16772802,2024-08-21T14:36:49,Portugalete,expenses,leisure,-63.59,-96824.4
buyer_7,Mar√≠a,,1968-12-31,ES68209528285169439268,TRX_N-01080-91895613,2024-08-22T00:16:06,Portugalete,expenses,food,-122.56,-96946.96
buyer_7,Mar√≠a,,1968-12-31,ES68209528285169439268,TRX_N-01081-64816655,2024-08-23T18:26:44,Portugalete,expenses,food,-115.08,-97062.04
buyer_7,Mar√≠a,,1968-12-31,ES68209528285169439268,TRX_N-01082-78032049,2024-08-28T16:27:51,Portugalete,expenses,cash,-100.0,-97162.04
buyer_7,Mar√≠a,,1968-12-31,ES68209528285169439268,TRX_N-01083-13884013,2024-08-28T16:09:34,Portugalete,expenses,gifts,-193.47,-97355.51
buyer_7,Mar√≠a,,1968-12-31,ES68209528285169439268,TRX_N-01084-12042649,2024-08-29T10:42:25,Portugalete,expenses,leisure,-34.09,-97389.6
buyer_7,Mar√≠a,,1968-12-31,ES68209528285169439268,TRX_N-01085-73509127,2024-08-30T09:38:06,Portugalete,expenses,cash,-100.0,-97489.6
buyer_7,Mar√≠a,,1968-12-31,ES68209528285169439268,TRX_N-01086-51354766,2024-08-31T18:22:20,Portugalete,expenses,food,-73.65,-97563.25
buyer_7,Mar√≠a,,1968-12-31,ES68209528285169439268,TRX_N-01087-98761951,2024-09-01T16:51:26,Portugalete,incomes,salary,1371.41,-96191.84
buyer_7,Mar√≠a,,1968-12-31,ES68209528285169439268,TRX_N-01088-58020979,2024-09-01T13:17:26,Portugalete,expenses,gifts,-232.73,-96424.57
buyer_7,Mar√≠a,,1968-12-31,ES68209528285169439268,TRX_N-01089-62619960,2024-09-03T14:21:31,Portugalete,expenses,transport,-48.64,-96473.21
buyer_7,Mar√≠a,,1968-12-31,ES68209528285169439268,TRX_N-01090-83299371,2024-09-04T11:45:15,Portugalete,expenses,mortgage,-764.17,-97237.38
buyer_7,Mar√≠a,,1968-12-31,ES68209528285169439268,TRX_N-01091-61358742,2024-09-04T20:55:33,Portugalete,expenses,repairs,-173.01,-97410.39
buyer_7,Mar√≠a,,1968-12-31,ES68209528285169439268,TRX_N-01092-02705815,2024-09-05T11:36:22,Oy√≥n-Oion,expenses,leisure,-35.14,-97445.53
buyer_7,Mar√≠a,,1968-12-31,ES68209528285169439268,TRX_N-01093-92685998,2024-09-05T08:19:35,Portugalete,expenses,cash,-100.0,-97545.53
buyer_7,Mar√≠a,,1968-12-31,ES68209528285169439268,TRX_N-01094-55924294,2024-09-06T07:34:15,Portugalete,expenses,electricity,-37.78,-97583.31
buyer_7,Mar√≠a,,1968-12-31,ES68209528285169439268,TRX_N-01095-33483698,2024-09-06T08:46:14,Portugalete,expenses,gas,-35.46,-97618.77
buyer_7,Mar√≠a,,1968-12-31,ES68209528285169439268,TRX_N-01096-49205561,2024-09-06T11:09:26,Erandio,expenses,food,-87.87,-97706.64
buyer_7,Mar√≠a,,1968-12-31,ES68209528285169439268,TRX_N-01097-57572088,2024-09-07T14:59:27,Portugalete,expenses,internet,-42.0,-97748.64
buyer_7,Mar√≠a,,1968-12-31,ES68209528285169439268,TRX_N-01098-88557465,2024-09-07T07:17:34,Portugalete,expenses,food,-65.04,-97813.68
buyer_7,Mar√≠a,,1968-12-31,ES68209528285169439268,TRX_N-01099-21388502,2024-09-07T11:13:56,Portugalete,expenses,cash,-100.0,-97913.68
buyer_7,Mar√≠a,,1968-12-31,ES68209528285169439268,TRX_N-01100-10482986,2024-09-08T17:27:24,Portugalete,expenses,water,-29.1,-97942.78
buyer_7,Mar√≠a,,1968-12-31,ES68209528285169439268,TRX_N-01101-55539062,2024-09-08T08:40:11,Portugalete,expenses,phone,-34.73,-97977.51
buyer_7,Mar√≠a,,1968-12-31,ES68209528285169439268,TRX_N-01102-06094083,2024-09-10T12:17:58,Portugalete,expenses,healthcare,-188.27,-98165.78
buyer_7,Mar√≠a,,1968-12-31,ES68209528285169439268,TRX_N-01103-56144490,2024-09-12T09:34:06,Portugalete,expenses,clothing,-122.49,-98288.27
buyer_7,Mar√≠a,,1968-12-31,ES68209528285169439268,TRX_N-01104-62746751,2024-09-12T15:33:47,Portugalete,expenses,education,-45.06,-98333.33
buyer_7,Mar√≠a,,1968-12-31,ES68209528285169439268,TRX_N-01105-07180398,2024-09-14T23:10:24,Portugalete,expenses,leisure,-65.21,-98398.54
buyer_7,Mar√≠a,,1968-12-31,ES68209528285169439268,TRX_N-01106-96889955,2024-09-14T10:40:02,Portugalete,expenses,cash,-100.0,-98498.54
buyer_7,Mar√≠a,,1968-12-31,ES68209528285169439268,TRX_N-01107-48084062,2024-09-14T17:43:34,Portugalete,expenses,gifts,-643.0,-99141.54
buyer_7,Mar√≠a,,1968-12-31,ES68209528285169439268,TRX_N-01108-31478366,2024-09-16T18:13:03,Portugalete,expenses,food,-85.21,-99226.75
buyer_7,Mar√≠a,,1968-12-31,ES68209528285169439268,TRX_N-01109-47612386,2024-09-16T18:48:25,Portugalete,expenses,transport,-75.18,-99301.93
buyer_7,Mar√≠a,,1968-12-31,ES68209528285169439268,TRX_N-01110-63603814,2024-09-18T20:05:48,Labastida,expenses,cash,-100.0,-99401.93
buyer_7,Mar√≠a,,1968-12-31,ES68209528285169439268,TRX_N-01111-45663150,2024-09-20T17:27:49,Portugalete,expenses,cash,-100.0,-99501.93
buyer_7,Mar√≠a,,1968-12-31,ES68209528285169439268,TRX_N-01112-10118791,2024-09-21T15:37:42,Portugalete,expenses,transport,-69.72,-99571.65
buyer_7,Mar√≠a,,1968-12-31,ES68209528285169439268,TRX_N-01113-07478207,2024-09-22T18:36:45,Portugalete,expenses,gifts,-76.74,-99648.39
buyer_7,Mar√≠a,,1968-12-31,ES68209528285169439268,TRX_N-01114-22380215,2024-09-24T20:02:50,Portugalete,expenses,cash,-100.0,-99748.39
buyer_7,Mar√≠a,,1968-12-31,ES68209528285169439268,TRX_N-01115-36549263,2024-09-25T12:33:46,Portugalete,expenses,leisure,-43.04,-99791.43
buyer_7,Mar√≠a,,1968-12-31,ES68209528285169439268,TRX_N-01116-21681626,2024-09-26T18:58:07,Portugalete,expenses,transport,-49.94,-99841.37
buyer_7,Mar√≠a,,1968-12-31,ES68209528285169439268,TRX_N-01117-91576604,2024-09-27T17:11:43,Portugalete,expenses,transport,-64.84,-99906.21
buyer_7,Mar√≠a,,1968-12-31,ES68209528285169439268,TRX_N-01118-59213883,2024-09-27T08:05:44,Portugalete,expenses,leisure,-66.01,-99972.22
buyer_7,Mar√≠a,,1968-12-31,ES68209528285169439268,TRX_N-01119-60480466,2024-09-27T10:23:42,Portugalete,expenses,education,-69.0,-100041.22
buyer_7,Mar√≠a,,1968-12-31,ES68209528285169439268,TRX_N-01120-72918794,2024-09-27T19:02:40,Elciego,expenses,cash,-100.0,-100141.22
buyer_7,Mar√≠a,,1968-12-31,ES68209528285169439268,TRX_N-01121-85996307,2024-09-28T18:00:23,Leioa,expenses,food,-85.87,-100227.09
buyer_7,Mar√≠a,,1968-12-31,ES68209528285169439268,TRX_N-01122-72934247,2024-09-28T08:40:58,Lasarte-Oria,expenses,repairs,-53.0,-100280.09
buyer_7,Mar√≠a,,1968-12-31,ES68209528285169439268,TRX_N-01123-99427760,2024-10-01T13:34:32,Portugalete,incomes,salary,1371.41,-98908.68
buyer_7,Mar√≠a,,1968-12-31,ES68209528285169439268,TRX_N-01124-84020284,2024-10-01T13:34:32,Portugalete,incomes,extra_income,186.42,-98722.26
buyer_7,Mar√≠a,,1968-12-31,ES68209528285169439268,TRX_N-01125-16096445,2024-10-03T11:53:58,Portugalete,expenses,repairs,-161.17,-98883.43
buyer_7,Mar√≠a,,1968-12-31,ES68209528285169439268,TRX_N-01126-80408308,2024-10-04T08:51:17,Portugalete,expenses,mortgage,-764.17,-99647.6
buyer_7,Mar√≠a,,1968-12-31,ES68209528285169439268,TRX_N-01127-73629979,2024-10-04T18:13:43,Portugalete,expenses,education,-57.57,-99705.17
buyer_7,Mar√≠a,,1968-12-31,ES68209528285169439268,TRX_N-01128-33565132,2024-10-04T22:03:21,Portugalete,expenses,repairs,-277.79,-99982.96
buyer_7,Mar√≠a,,1968-12-31,ES68209528285169439268,TRX_N-01129-71581513,2024-10-06T13:17:39,Portugalete,expenses,transport,-56.12,-100039.08
buyer_7,Mar√≠a,,1968-12-31,ES68209528285169439268,TRX_N-01130-51192521,2024-10-06T16:47:04,Portugalete,expenses,cash,-100.0,-100139.08
buyer_7,Mar√≠a,,1968-12-31,ES68209528285169439268,TRX_N-01131-24858833,2024-10-06T15:54:10,Amurrio,expenses,gifts,-252.53,-100391.61
buyer_7,Mar√≠a,,1968-12-31,ES68209528285169439268,TRX_N-01132-31384077,2024-10-07T01:17:59,Portugalete,expenses,water,-35.55,-100427.16
buyer_7,Mar√≠a,,1968-12-31,ES68209528285169439268,TRX_N-01133-61419854,2024-10-07T20:00:17,Portugalete,expenses,phone,-39.64,-100466.8
buyer_7,Mar√≠a,,1968-12-31,ES68209528285169439268,TRX_N-01134-43461860,2024-10-07T18:24:31,Portugalete,expenses,cash,-100.0,-100566.8
buyer_7,Mar√≠a,,1968-12-31,ES68209528285169439268,TRX_N-01135-87287783,2024-10-08T19:13:28,Portugalete,expenses,electricity,-65.82,-100632.62
buyer_7,Mar√≠a,,1968-12-31,ES68209528285169439268,TRX_N-01136-01475219,2024-10-08T04:08:35,Portugalete,expenses,gas,-50.1,-100682.72
buyer_7,Mar√≠a,,1968-12-31,ES68209528285169439268,TRX_N-01137-78112069,2024-10-08T17:17:34,Portugalete,expenses,internet,-42.0,-100724.72
buyer_8,Antonio,,1979-04-04,ES75209555999983843558,TRX_N-00001-15057616,2022-01-01T15:27:53,Labastida,incomes,salary,3710.47,5068.03
buyer_8,Antonio,,1979-04-04,ES75209555999983843558,TRX_N-00002-34420143,2022-01-01T21:39:10,Labastida,expenses,transport,-76.44,4991.59
buyer_8,Antonio,,1979-04-04,ES75209555999983843558,TRX_N-00003-40984271,2022-01-01T19:24:17,Oy√≥n-Oion,expenses,leisure,-21.4,4970.19
buyer_8,Antonio,,1979-04-04,ES75209555999983843558,TRX_N-00004-99240490,2022-01-02T14:53:55,Hondarribia,expenses,food,-104.44,4865.75
buyer_8,Antonio,,1979-04-04,ES75209555999983843558,TRX_N-00005-78361507,2022-01-02T19:10:56,Labastida,expenses,cash,-100.0,4765.75
buyer_8,Antonio,,1979-04-04,ES75209555999983843558,TRX_N-00006-62303609,2022-01-03T16:56:52,Labastida,expenses,food,-110.65,4655.1
buyer_8,Antonio,,1979-04-04,ES75209555999983843558,TRX_N-00007-61555169,2022-01-03T12:53:03,Labastida,expenses,leisure,-23.83,4631.27
buyer_8,Antonio,,1979-04-04,ES75209555999983843558,TRX_N-00008-36584141,2022-01-04T16:35:52,Labastida,expenses,mortgage,-775.96,3855.31
buyer_8,Antonio,,1979-04-04,ES75209555999983843558,TRX_N-00009-21943215,2022-01-05T11:34:47,Labastida,expenses,water,-44.94,3810.37
buyer_8,Antonio,,1979-04-04,ES75209555999983843558,TRX_N-00010-32537719,2022-01-05T19:40:18,Labastida,expenses,electricity,-78.0,3732.37
buyer_8,Antonio,,1979-04-04,ES75209555999983843558,TRX_N-00011-38387279,2022-01-05T17:39:55,Labastida,expenses,gas,-82.06,3650.31
buyer_8,Antonio,,1979-04-04,ES75209555999983843558,TRX_N-00012-15695842,2022-01-05T14:34:54,Labastida,expenses,transport,-47.17,3603.14
buyer_8,Antonio,,1979-04-04,ES75209555999983843558,TRX_N-00013-78796803,2022-01-05T12:46:15,Santurtzi,expenses,leisure,-82.46,3520.68
buyer_8,Antonio,,1979-04-04,ES75209555999983843558,TRX_N-00014-51582789,2022-01-05T13:12:10,Labastida,expenses,gifts,-494.45,3026.23
buyer_8,Antonio,,1979-04-04,ES75209555999983843558,TRX_N-00015-17845669,2022-01-06T08:39:35,Labastida,expenses,phone,-38.22,2988.01
buyer_8,Antonio,,1979-04-04,ES75209555999983843558,TRX_N-00016-32916716,2022-01-07T07:36:38,Labastida,expenses,transport,-46.65,2941.36
buyer_8,Antonio,,1979-04-04,ES75209555999983843558,TRX_N-00017-51433386,2022-01-08T11:15:37,Labastida,expenses,internet,-42.0,2899.36
buyer_8,Antonio,,1979-04-04,ES75209555999983843558,TRX_N-00018-27614552,2022-01-12T08:03:59,Labastida,expenses,transport,-88.4,2810.96
buyer_8,Antonio,,1979-04-04,ES75209555999983843558,TRX_N-00019-08651368,2022-01-15T05:01:06,Labastida,expenses,leisure,-37.49,2773.47
buyer_8,Antonio,,1979-04-04,ES75209555999983843558,TRX_N-00020-31770537,2022-01-15T15:59:58,Sestao,expenses,education,-70.16,2703.31
buyer_8,Antonio,,1979-04-04,ES75209555999983843558,TRX_N-00021-44691028,2022-01-15T06:29:28,Labastida,expenses,repairs,-137.12,2566.19
buyer_8,Antonio,,1979-04-04,ES75209555999983843558,TRX_N-00022-97150546,2022-01-16T19:22:52,Labastida,expenses,food,-103.42,2462.77
buyer_8,Antonio,,1979-04-04,ES75209555999983843558,TRX_N-00023-27618703,2022-01-16T13:03:45,Labastida,expenses,travel,-882.18,1580.59
buyer_8,Antonio,,1979-04-04,ES75209555999983843558,TRX_N-00024-15787539,2022-01-16T16:57:48,Labastida,expenses,car,-208.09,1372.5
buyer_8,Antonio,,1979-04-04,ES75209555999983843558,TRX_N-00025-54031918,2022-01-17T19:57:38,Labastida,expenses,cash,-100.0,1272.5
buyer_8,Antonio,,1979-04-04,ES75209555999983843558,TRX_N-00026-75096662,2022-01-21T16:45:29,Labastida,expenses,food,-68.99,1203.51
buyer_8,Antonio,,1979-04-04,ES75209555999983843558,TRX_N-00027-23311292,2022-01-21T12:30:10,Labastida,expenses,cash,-100.0,1103.51
buyer_8,Antonio,,1979-04-04,ES75209555999983843558,TRX_N-00028-28120515,2022-01-23T12:08:09,Labastida,expenses,cash,-100.0,1003.51
buyer_8,Antonio,,1979-04-04,ES75209555999983843558,TRX_N-00029-26811390,2022-01-24T13:54:14,Labastida,expenses,food,-104.38,899.13
buyer_8,Antonio,,1979-04-04,ES75209555999983843558,TRX_N-00030-23169486,2022-01-25T03:36:39,Zuia,expenses,cash,-100.0,799.13
buyer_8,Antonio,,1979-04-04,ES75209555999983843558,TRX_N-00031-79106769,2022-01-28T20:12:23,Labastida,expenses,transport,-72.67,726.46
buyer_8,Antonio,,1979-04-04,ES75209555999983843558,TRX_N-00032-03378773,2022-01-28T15:33:08,Labastida,expenses,leisure,-42.66,683.8
buyer_8,Antonio,,1979-04-04,ES75209555999983843558,TRX_N-00033-45702768,2022-01-29T10:45:43,Leioa,expenses,leisure,-42.86,640.94
buyer_8,Antonio,,1979-04-04,ES75209555999983843558,TRX_N-00034-36738931,2022-01-29T09:59:56,Labastida,expenses,cash,-100.0,540.94
buyer_8,Antonio,,1979-04-04,ES75209555999983843558,TRX_N-00035-49407117,2022-01-30T11:59:33,Labastida,expenses,cash,-100.0,440.94
buyer_8,Antonio,,1979-04-04,ES75209555999983843558,TRX_N-00036-02216804,2022-01-31T09:36:23,Labastida,expenses,transport,-40.23,400.71
buyer_8,Antonio,,1979-04-04,ES75209555999983843558,TRX_N-00037-52692162,2022-01-31T19:24:04,Labastida,expenses,clothing,-114.03,286.68
buyer_8,Antonio,,1979-04-04,ES75209555999983843558,TRX_N-00038-70339331,2022-02-01T06:10:41,Labastida,incomes,salary,3710.47,3997.15
buyer_8,Antonio,,1979-04-04,ES75209555999983843558,TRX_N-00039-15381508,2022-02-03T11:41:16,Labastida,expenses,food,-105.35,3891.8
buyer_8,Antonio,,1979-04-04,ES75209555999983843558,TRX_N-00040-94608582,2022-02-04T00:01:28,Labastida,expenses,mortgage,-775.96,3115.84
buyer_8,Antonio,,1979-04-04,ES75209555999983843558,TRX_N-00041-52050478,2022-02-05T09:12:31,Labastida,expenses,electricity,-65.65,3050.19
buyer_8,Antonio,,1979-04-04,ES75209555999983843558,TRX_N-00042-72767055,2022-02-06T08:58:15,Labastida,expenses,leisure,-31.75,3018.44
buyer_8,Antonio,,1979-04-04,ES75209555999983843558,TRX_N-00043-15492447,2022-02-07T17:20:56,Labastida,expenses,internet,-42.0,2976.44
buyer_8,Antonio,,1979-04-04,ES75209555999983843558,TRX_N-00044-57501482,2022-02-08T18:18:18,Labastida,expenses,phone,-35.88,2940.56
buyer_8,Antonio,,1979-04-04,ES75209555999983843558,TRX_N-00045-60147084,2022-02-08T12:09:56,Labastida,expenses,water,-23.72,2916.84
buyer_8,Antonio,,1979-04-04,ES75209555999983843558,TRX_N-00046-76590195,2022-02-08T12:05:02,Labastida,expenses,gas,-73.72,2843.12
buyer_8,Antonio,,1979-04-04,ES75209555999983843558,TRX_N-00047-00216618,2022-02-08T10:12:33,Portugalete,expenses,gifts,-115.5,2727.62
buyer_8,Antonio,,1979-04-04,ES75209555999983843558,TRX_N-00048-05797911,2022-02-11T11:40:31,Labastida,expenses,cash,-100.0,2627.62
buyer_8,Antonio,,1979-04-04,ES75209555999983843558,TRX_N-00049-09613813,2022-02-12T16:05:16,Labastida,expenses,leisure,-19.02,2608.6
buyer_8,Antonio,,1979-04-04,ES75209555999983843558,TRX_N-00050-10094132,2022-02-13T17:06:58,Labastida,expenses,repairs,-285.23,2323.37
buyer_8,Antonio,,1979-04-04,ES75209555999983843558,TRX_N-00051-33216277,2022-02-14T18:11:11,Labastida,expenses,cash,-100.0,2223.37
buyer_8,Antonio,,1979-04-04,ES75209555999983843558,TRX_N-00052-99700944,2022-02-15T12:00:59,Labastida,expenses,transport,-67.83,2155.54
buyer_8,Antonio,,1979-04-04,ES75209555999983843558,TRX_N-00053-91886548,2022-02-16T08:57:34,Erandio,expenses,food,-106.0,2049.54
buyer_8,Antonio,,1979-04-04,ES75209555999983843558,TRX_N-00054-11614073,2022-02-18T12:02:58,Labastida,expenses,appliances,-273.19,1776.35
buyer_8,Antonio,,1979-04-04,ES75209555999983843558,TRX_N-00055-08469459,2022-02-21T02:46:21,Labastida,expenses,cash,-100.0,1676.35
buyer_8,Antonio,,1979-04-04,ES75209555999983843558,TRX_N-00056-10560405,2022-02-23T12:12:30,Labastida,expenses,leisure,-82.67,1593.68
buyer_8,Antonio,,1979-04-04,ES75209555999983843558,TRX_N-00057-04071955,2022-02-24T08:18:57,Sopela,expenses,food,-66.97,1526.71
buyer_8,Antonio,,1979-04-04,ES75209555999983843558,TRX_N-00058-75641530,2022-02-24T14:40:45,Labastida,expenses,clothing,-99.67,1427.04
buyer_8,Antonio,,1979-04-04,ES75209555999983843558,TRX_N-00059-12079352,2022-02-25T10:21:43,Labastida,expenses,appliances,-245.0,1182.04
buyer_8,Antonio,,1979-04-04,ES75209555999983843558,TRX_N-00060-90325923,2022-02-27T05:08:18,Sopela,expenses,clothing,-99.44,1082.6
buyer_8,Antonio,,1979-04-04,ES75209555999983843558,TRX_N-00061-39979125,2022-03-01T09:30:10,Labastida,incomes,salary,3710.47,4793.07
buyer_8,Antonio,,1979-04-04,ES75209555999983843558,TRX_N-00062-70560030,2022-03-01T09:30:10,Labastida,incomes,extra_income,614.38,5407.45
buyer_8,Antonio,,1979-04-04,ES75209555999983843558,TRX_N-00063-13538450,2022-03-01T20:14:44,Labastida,expenses,transport,-58.21,5349.24
buyer_8,Antonio,,1979-04-04,ES75209555999983843558,TRX_N-00064-59364968,2022-03-04T13:17:30,Labastida,expenses,mortgage,-775.96,4573.28
buyer_8,Antonio,,1979-04-04,ES75209555999983843558,TRX_N-00065-64084527,2022-03-04T08:24:07,Berango,expenses,food,-120.35,4452.93
buyer_8,Antonio,,1979-04-04,ES75209555999983843558,TRX_N-00066-43979663,2022-03-05T12:28:08,Labastida,expenses,electricity,-46.97,4405.96
buyer_8,Antonio,,1979-04-04,ES75209555999983843558,TRX_N-00067-02355000,2022-03-05T13:49:30,Labastida,expenses,internet,-42.0,4363.96
buyer_8,Antonio,,1979-04-04,ES75209555999983843558,TRX_N-00068-07912357,2022-03-05T03:14:57,Labastida,expenses,appliances,-88.77,4275.19
buyer_8,Antonio,,1979-04-04,ES75209555999983843558,TRX_N-00069-47232643,2022-03-05T13:03:40,Labastida,expenses,repairs,-222.68,4052.51
buyer_8,Antonio,,1979-04-04,ES75209555999983843558,TRX_N-00070-99549912,2022-03-06T13:43:14,Labastida,expenses,gas,-80.97,3971.54
buyer_8,Antonio,,1979-04-04,ES75209555999983843558,TRX_N-00071-18811742,2022-03-06T08:01:16,Labastida,expenses,leisure,-73.18,3898.36
buyer_8,Antonio,,1979-04-04,ES75209555999983843558,TRX_N-00072-51954080,2022-03-08T23:43:37,Labastida,expenses,water,-44.68,3853.68
buyer_8,Antonio,,1979-04-04,ES75209555999983843558,TRX_N-00073-37024044,2022-03-08T11:05:40,Labastida,expenses,phone,-43.52,3810.16
buyer_8,Antonio,,1979-04-04,ES75209555999983843558,TRX_N-00074-66839863,2022-03-08T09:00:56,Labastida,expenses,healthcare,-149.68,3660.48
buyer_8,Antonio,,1979-04-04,ES75209555999983843558,TRX_N-00075-61092150,2022-03-08T13:59:58,Labastida,expenses,education,-72.48,3588.0
buyer_8,Antonio,,1979-04-04,ES75209555999983843558,TRX_N-00076-51618292,2022-03-08T08:03:44,Labastida,expenses,appliances,-141.12,3446.88
buyer_8,Antonio,,1979-04-04,ES75209555999983843558,TRX_N-00077-95216763,2022-03-09T10:56:15,Labastida,expenses,travel,-980.68,2466.2
buyer_8,Antonio,,1979-04-04,ES75209555999983843558,TRX_N-00078-08066397,2022-03-12T19:33:25,Labastida,expenses,repairs,-173.12,2293.08
buyer_8,Antonio,,1979-04-04,ES75209555999983843558,TRX_N-00079-81530195,2022-03-13T16:25:26,Labastida,expenses,repairs,-208.49,2084.59
buyer_8,Antonio,,1979-04-04,ES75209555999983843558,TRX_N-00080-65363729,2022-03-13T08:48:37,Labastida,expenses,gifts,-159.96,1924.63
buyer_8,Antonio,,1979-04-04,ES75209555999983843558,TRX_N-00081-55201664,2022-03-15T08:21:59,Labastida,expenses,food,-104.14,1820.49
buyer_8,Antonio,,1979-04-04,ES75209555999983843558,TRX_N-00082-25379157,2022-03-15T18:01:19,Labastida,expenses,travel,-629.8,1190.69
buyer_8,Antonio,,1979-04-04,ES75209555999983843558,TRX_N-00083-64892686,2022-03-16T17:05:40,Labastida,expenses,leisure,-80.49,1110.2
buyer_8,Antonio,,1979-04-04,ES75209555999983843558,TRX_N-00084-86343742,2022-03-16T19:20:39,Labastida,expenses,healthcare,-131.88,978.32
buyer_8,Antonio,,1979-04-04,ES75209555999983843558,TRX_N-00085-99398273,2022-03-18T10:32:34,Labastida,expenses,food,-89.29,889.03
buyer_8,Antonio,,1979-04-04,ES75209555999983843558,TRX_N-00086-15391368,2022-03-20T04:29:59,Irun,expenses,cash,-100.0,789.03
buyer_8,Antonio,,1979-04-04,ES75209555999983843558,TRX_N-00087-58210525,2022-03-20T11:51:06,Labastida,expenses,appliances,-334.99,454.04
buyer_8,Antonio,,1979-04-04,ES75209555999983843558,TRX_N-00088-66967135,2022-03-21T08:53:31,Labastida,expenses,cash,-100.0,354.04
buyer_8,Antonio,,1979-04-04,ES75209555999983843558,TRX_N-00089-55942627,2022-03-23T07:16:08,Labastida,expenses,food,-80.45,273.59
buyer_8,Antonio,,1979-04-04,ES75209555999983843558,TRX_N-00090-71666861,2022-03-23T12:08:45,Labastida,expenses,leisure,-58.0,215.59
buyer_8,Antonio,,1979-04-04,ES75209555999983843558,TRX_N-00091-14341917,2022-03-23T16:41:19,Labastida,expenses,repairs,-277.44,-61.85
buyer_8,Antonio,,1979-04-04,ES75209555999983843558,TRX_N-00092-98778504,2022-03-24T08:33:20,Labastida,expenses,food,-124.66,-186.51
buyer_8,Antonio,,1979-04-04,ES75209555999983843558,TRX_N-00093-09099168,2022-03-24T12:52:41,Amurrio,expenses,repairs,-198.17,-384.68
buyer_8,Antonio,,1979-04-04,ES75209555999983843558,TRX_N-00094-82850783,2022-03-26T16:36:02,Labastida,expenses,transport,-46.76,-431.44
buyer_8,Antonio,,1979-04-04,ES75209555999983843558,TRX_N-00095-40120338,2022-03-26T16:50:20,Labastida,expenses,cash,-100.0,-531.44
buyer_8,Antonio,,1979-04-04,ES75209555999983843558,TRX_N-00096-71107160,2022-03-28T07:10:11,Labastida,expenses,healthcare,-72.86,-604.3
buyer_8,Antonio,,1979-04-04,ES75209555999983843558,TRX_N-00097-23127193,2022-03-28T10:26:40,Labastida,expenses,cash,-100.0,-704.3
buyer_8,Antonio,,1979-04-04,ES75209555999983843558,TRX_N-00098-63962585,2022-03-30T18:29:03,Labastida,expenses,cash,-100.0,-804.3
buyer_8,Antonio,,1979-04-04,ES75209555999983843558,TRX_N-00099-78511654,2022-04-01T08:58:57,Labastida,incomes,salary,3710.47,2906.17
buyer_8,Antonio,,1979-04-04,ES75209555999983843558,TRX_N-00100-19071536,2022-04-01T18:50:50,Erandio,expenses,food,-92.43,2813.74
buyer_8,Antonio,,1979-04-04,ES75209555999983843558,TRX_N-00101-30470911,2022-04-01T12:16:04,Santurtzi,expenses,leisure,-61.35,2752.39
buyer_8,Antonio,,1979-04-04,ES75209555999983843558,TRX_N-00102-13045415,2022-04-02T22:35:59,Zuia,expenses,food,-70.99,2681.4
buyer_8,Antonio,,1979-04-04,ES75209555999983843558,TRX_N-00103-01307340,2022-04-02T18:10:17,Labastida,expenses,leisure,-42.45,2638.95
buyer_8,Antonio,,1979-04-04,ES75209555999983843558,TRX_N-00104-51919020,2022-04-03T13:03:48,Labastida,expenses,transport,-43.63,2595.32
buyer_8,Antonio,,1979-04-04,ES75209555999983843558,TRX_N-00105-05809320,2022-04-04T13:11:05,Labastida,expenses,mortgage,-775.96,1819.36
buyer_8,Antonio,,1979-04-04,ES75209555999983843558,TRX_N-00106-88080063,2022-04-05T20:42:54,Labastida,expenses,repairs,-323.52,1495.84
buyer_8,Antonio,,1979-04-04,ES75209555999983843558,TRX_N-00107-47052828,2022-04-06T15:44:42,Labastida,expenses,internet,-42.0,1453.84
buyer_8,Antonio,,1979-04-04,ES75209555999983843558,TRX_N-00108-76993295,2022-04-07T18:46:14,Labastida,expenses,water,-23.85,1429.99
buyer_8,Antonio,,1979-04-04,ES75209555999983843558,TRX_N-00109-32505862,2022-04-07T14:57:12,Labastida,expenses,food,-80.61,1349.38
buyer_8,Antonio,,1979-04-04,ES75209555999983843558,TRX_N-00110-86190273,2022-04-07T09:25:01,Labastida,expenses,leisure,-21.47,1327.91
buyer_8,Antonio,,1979-04-04,ES75209555999983843558,TRX_N-00111-47597839,2022-04-08T10:39:22,Labastida,expenses,phone,-39.96,1287.95
buyer_8,Antonio,,1979-04-04,ES75209555999983843558,TRX_N-00112-49142092,2022-04-08T19:50:23,Labastida,expenses,electricity,-20.68,1267.27
buyer_8,Antonio,,1979-04-04,ES75209555999983843558,TRX_N-00113-83412507,2022-04-08T15:10:36,Labastida,expenses,gas,-83.69,1183.58
buyer_8,Antonio,,1979-04-04,ES75209555999983843558,TRX_N-00114-28478206,2022-04-08T12:21:44,Bermeo,expenses,food,-85.53,1098.05
buyer_8,Antonio,,1979-04-04,ES75209555999983843558,TRX_N-00115-43127255,2022-04-09T23:56:50,Labastida,expenses,cash,-100.0,998.05
buyer_8,Antonio,,1979-04-04,ES75209555999983843558,TRX_N-00116-51788165,2022-04-10T23:42:03,Labastida,expenses,gifts,-348.4,649.65
buyer_8,Antonio,,1979-04-04,ES75209555999983843558,TRX_N-00117-82010633,2022-04-11T12:31:47,Labastida,expenses,food,-70.77,578.88
buyer_8,Antonio,,1979-04-04,ES75209555999983843558,TRX_N-00118-72905553,2022-04-11T11:18:23,Labastida,expenses,repairs,-133.09,445.79
buyer_8,Antonio,,1979-04-04,ES75209555999983843558,TRX_N-00119-79705688,2022-04-12T10:37:20,Labastida,expenses,cash,-100.0,345.79
buyer_8,Antonio,,1979-04-04,ES75209555999983843558,TRX_N-00120-57974990,2022-04-13T21:33:29,Labastida,expenses,food,-105.33,240.46
buyer_8,Antonio,,1979-04-04,ES75209555999983843558,TRX_N-00121-76195887,2022-04-14T08:25:23,Labastida,expenses,food,-87.79,152.67
buyer_8,Antonio,,1979-04-04,ES75209555999983843558,TRX_N-00122-90966512,2022-04-14T10:47:39,Labastida,expenses,leisure,-45.51,107.16
buyer_8,Antonio,,1979-04-04,ES75209555999983843558,TRX_N-00123-38823448,2022-04-15T17:49:55,Labastida,expenses,education,-44.93,62.23
buyer_8,Antonio,,1979-04-04,ES75209555999983843558,TRX_N-00124-86160459,2022-04-16T08:34:16,Labastida,expenses,clothing,-91.83,-29.6
buyer_8,Antonio,,1979-04-04,ES75209555999983843558,TRX_N-00125-37334858,2022-04-17T11:38:59,Labastida,expenses,transport,-78.53,-108.13
buyer_8,Antonio,,1979-04-04,ES75209555999983843558,TRX_N-00126-52758571,2022-04-17T13:43:47,Labastida,expenses,cash,-100.0,-208.13
buyer_8,Antonio,,1979-04-04,ES75209555999983843558,TRX_N-00127-01287837,2022-04-19T17:30:50,Labastida,expenses,repairs,-33.67,-241.8
buyer_8,Antonio,,1979-04-04,ES75209555999983843558,TRX_N-00128-17427510,2022-04-19T15:37:14,Labastida,expenses,gifts,-781.96,-1023.76
buyer_8,Antonio,,1979-04-04,ES75209555999983843558,TRX_N-00129-31570296,2022-04-21T09:18:34,Labastida,expenses,food,-112.05,-1135.81
buyer_8,Antonio,,1979-04-04,ES75209555999983843558,TRX_N-00130-71259867,2022-04-21T19:00:01,Labastida,expenses,gifts,-175.2,-1311.01
buyer_8,Antonio,,1979-04-04,ES75209555999983843558,TRX_N-00131-92993735,2022-04-22T18:25:43,Labastida,expenses,repairs,-195.43,-1506.44
buyer_8,Antonio,,1979-04-04,ES75209555999983843558,TRX_N-00132-65323781,2022-04-25T17:29:23,Labastida,expenses,leisure,-20.06,-1526.5
buyer_8,Antonio,,1979-04-04,ES75209555999983843558,TRX_N-00133-45222425,2022-04-26T08:14:40,Labastida,expenses,leisure,-71.11,-1597.61
buyer_8,Antonio,,1979-04-04,ES75209555999983843558,TRX_N-00134-11745260,2022-04-27T15:15:01,Labastida,expenses,transport,-72.92,-1670.53
buyer_8,Antonio,,1979-04-04,ES75209555999983843558,TRX_N-00135-16692900,2022-04-28T11:10:28,Labastida,expenses,clothing,-136.27,-1806.8
buyer_8,Antonio,,1979-04-04,ES75209555999983843558,TRX_N-00136-72249659,2022-04-29T20:00:53,Hernani,expenses,food,-69.47,-1876.27
buyer_8,Antonio,,1979-04-04,ES75209555999983843558,TRX_N-00137-57676204,2022-04-29T19:31:05,Labastida,expenses,healthcare,-162.46,-2038.73
buyer_8,Antonio,,1979-04-04,ES75209555999983843558,TRX_N-00138-69943576,2022-05-01T04:04:36,Labastida,incomes,salary,3710.47,1671.74
buyer_8,Antonio,,1979-04-04,ES75209555999983843558,TRX_N-00139-14202629,2022-05-01T13:36:09,Pasaia,expenses,food,-82.72,1589.02
buyer_8,Antonio,,1979-04-04,ES75209555999983843558,TRX_N-00140-80473073,2022-05-01T19:51:43,Labastida,expenses,gifts,-179.52,1409.5
buyer_8,Antonio,,1979-04-04,ES75209555999983843558,TRX_N-00141-59506889,2022-05-03T08:54:29,Amurrio,expenses,food,-117.04,1292.46
buyer_8,Antonio,,1979-04-04,ES75209555999983843558,TRX_N-00142-92923093,2022-05-03T17:17:37,Erandio,expenses,cash,-100.0,1192.46
buyer_8,Antonio,,1979-04-04,ES75209555999983843558,TRX_N-00143-49920301,2022-05-04T16:25:30,Labastida,expenses,mortgage,-775.96,416.5
buyer_8,Antonio,,1979-04-04,ES75209555999983843558,TRX_N-00144-26988871,2022-05-06T11:54:52,Labastida,expenses,phone,-32.5,384.0
buyer_8,Antonio,,1979-04-04,ES75209555999983843558,TRX_N-00145-59172354,2022-05-06T23:35:36,Labastida,expenses,healthcare,-54.96,329.04
buyer_8,Antonio,,1979-04-04,ES75209555999983843558,TRX_N-00146-41506603,2022-05-06T20:18:24,Labastida,expenses,gifts,-549.21,-220.17
buyer_8,Antonio,,1979-04-04,ES75209555999983843558,TRX_N-00147-52892346,2022-05-07T14:08:04,Labastida,expenses,electricity,-51.75,-271.92
buyer_8,Antonio,,1979-04-04,ES75209555999983843558,TRX_N-00148-69157855,2022-05-07T20:19:46,Labastida,expenses,gas,-43.64,-315.56
buyer_8,Antonio,,1979-04-04,ES75209555999983843558,TRX_N-00149-33441079,2022-05-07T20:08:28,Labastida,expenses,transport,-83.63,-399.19
buyer_8,Antonio,,1979-04-04,ES75209555999983843558,TRX_N-00150-55702869,2022-05-08T23:52:16,Labastida,expenses,water,-30.02,-429.21
buyer_8,Antonio,,1979-04-04,ES75209555999983843558,TRX_N-00151-76954380,2022-05-08T20:57:33,Labastida,expenses,internet,-42.0,-471.21
buyer_8,Antonio,,1979-04-04,ES75209555999983843558,TRX_N-00152-21143179,2022-05-08T21:19:47,Iru√±a de Oca,expenses,cash,-100.0,-571.21
buyer_8,Antonio,,1979-04-04,ES75209555999983843558,TRX_N-00153-01635392,2022-05-09T22:16:53,Labastida,expenses,leisure,-36.79,-608.0
buyer_8,Antonio,,1979-04-04,ES75209555999983843558,TRX_N-00154-26980085,2022-05-11T19:47:09,Labastida,expenses,food,-101.59,-709.59
buyer_8,Antonio,,1979-04-04,ES75209555999983843558,TRX_N-00155-47402623,2022-05-11T08:50:13,Labastida,expenses,cash,-100.0,-809.59
buyer_8,Antonio,,1979-04-04,ES75209555999983843558,TRX_N-00156-68262089,2022-05-14T05:05:39,Labastida,expenses,food,-113.4,-922.99
buyer_8,Antonio,,1979-04-04,ES75209555999983843558,TRX_N-00157-40780455,2022-05-14T12:33:40,Labastida,expenses,cash,-100.0,-1022.99
buyer_8,Antonio,,1979-04-04,ES75209555999983843558,TRX_N-00158-28770868,2022-05-15T14:04:43,Labastida,expenses,food,-74.54,-1097.53
buyer_8,Antonio,,1979-04-04,ES75209555999983843558,TRX_N-00159-06523486,2022-05-15T15:14:58,Labastida,expenses,repairs,-265.79,-1363.32
buyer_8,Antonio,,1979-04-04,ES75209555999983843558,TRX_N-00160-45796669,2022-05-15T07:20:43,Santurtzi,expenses,gifts,-160.06,-1523.38
buyer_8,Antonio,,1979-04-04,ES75209555999983843558,TRX_N-00161-26911710,2022-05-17T08:01:05,Labastida,expenses,leisure,-75.15,-1598.53
buyer_8,Antonio,,1979-04-04,ES75209555999983843558,TRX_N-00162-28755560,2022-05-18T12:31:45,Labastida,expenses,cash,-100.0,-1698.53
buyer_8,Antonio,,1979-04-04,ES75209555999983843558,TRX_N-00163-08690208,2022-05-18T19:26:49,Labastida,expenses,repairs,-279.19,-1977.72
buyer_8,Antonio,,1979-04-04,ES75209555999983843558,TRX_N-00164-44388221,2022-05-19T02:47:35,Labastida,expenses,food,-121.84,-2099.56
buyer_8,Antonio,,1979-04-04,ES75209555999983843558,TRX_N-00165-84834299,2022-05-20T15:58:21,Labastida,expenses,cash,-100.0,-2199.56
buyer_8,Antonio,,1979-04-04,ES75209555999983843558,TRX_N-00166-95629965,2022-05-22T20:54:06,Hernani,expenses,appliances,-392.03,-2591.59
buyer_8,Antonio,,1979-04-04,ES75209555999983843558,TRX_N-00167-84866856,2022-05-23T22:43:16,Labastida,expenses,education,-42.61,-2634.2
buyer_8,Antonio,,1979-04-04,ES75209555999983843558,TRX_N-00168-48930016,2022-05-25T20:17:58,Labastida,expenses,education,-61.97,-2696.17
buyer_8,Antonio,,1979-04-04,ES75209555999983843558,TRX_N-00169-14518063,2022-05-25T20:46:53,Labastida,expenses,cash,-100.0,-2796.17
buyer_8,Antonio,,1979-04-04,ES75209555999983843558,TRX_N-00170-40186580,2022-05-25T11:20:29,Eibar,expenses,repairs,-247.74,-3043.91
buyer_8,Antonio,,1979-04-04,ES75209555999983843558,TRX_N-00171-72714186,2022-05-26T16:39:56,Labastida,expenses,repairs,-53.13,-3097.04
buyer_8,Antonio,,1979-04-04,ES75209555999983843558,TRX_N-00172-76957491,2022-05-27T10:29:22,Labastida,expenses,clothing,-109.01,-3206.05
buyer_8,Antonio,,1979-04-04,ES75209555999983843558,TRX_N-00173-96581747,2022-05-28T19:33:08,Labastida,expenses,transport,-43.18,-3249.23
buyer_8,Antonio,,1979-04-04,ES75209555999983843558,TRX_N-00174-53182281,2022-05-28T18:08:29,Amurrio,expenses,travel,-1567.14,-4816.37
buyer_8,Antonio,,1979-04-04,ES75209555999983843558,TRX_N-00175-20758690,2022-05-29T11:28:07,Labastida,expenses,leisure,-37.54,-4853.91
buyer_8,Antonio,,1979-04-04,ES75209555999983843558,TRX_N-00176-74245377,2022-05-30T09:23:55,Labastida,expenses,food,-64.14,-4918.05
buyer_8,Antonio,,1979-04-04,ES75209555999983843558,TRX_N-00177-16044721,2022-05-30T11:35:46,Labastida,expenses,cash,-100.0,-5018.05
buyer_8,Antonio,,1979-04-04,ES75209555999983843558,TRX_N-00178-80597457,2022-05-31T16:05:32,Labastida,expenses,cash,-100.0,-5118.05
buyer_8,Antonio,,1979-04-04,ES75209555999983843558,TRX_N-00179-65817527,2022-06-01T15:33:18,Labastida,incomes,salary,3710.47,-1407.58
buyer_8,Antonio,,1979-04-04,ES75209555999983843558,TRX_N-00180-25302345,2022-06-01T15:33:18,Labastida,incomes,salary_bonus,2851.12,1443.54
buyer_8,Antonio,,1979-04-04,ES75209555999983843558,TRX_N-00181-87280176,2022-06-02T22:59:52,Labastida,expenses,leisure,-18.54,1425.0
buyer_8,Antonio,,1979-04-04,ES75209555999983843558,TRX_N-00182-00569697,2022-06-02T13:30:22,Labastida,expenses,cash,-100.0,1325.0
buyer_8,Antonio,,1979-04-04,ES75209555999983843558,TRX_N-00183-09096866,2022-06-02T15:43:12,Zarautz,expenses,appliances,-131.78,1193.22
buyer_8,Antonio,,1979-04-04,ES75209555999983843558,TRX_N-00184-47462555,2022-06-04T18:08:51,Labastida,expenses,mortgage,-775.96,417.26
buyer_8,Antonio,,1979-04-04,ES75209555999983843558,TRX_N-00185-98888234,2022-06-05T14:46:54,Labastida,expenses,internet,-42.0,375.26
buyer_8,Antonio,,1979-04-04,ES75209555999983843558,TRX_N-00186-86067739,2022-06-06T10:41:33,Labastida,expenses,electricity,-45.2,330.06
buyer_8,Antonio,,1979-04-04,ES75209555999983843558,TRX_N-00187-20049405,2022-06-06T12:42:34,Labastida,expenses,transport,-66.4,263.66
buyer_8,Antonio,,1979-04-04,ES75209555999983843558,TRX_N-00188-54527092,2022-06-06T07:47:50,Labastida,expenses,cash,-100.0,163.66
buyer_8,Antonio,,1979-04-04,ES75209555999983843558,TRX_N-00189-88824174,2022-06-07T17:50:10,Labastida,expenses,water,-27.93,135.73
buyer_8,Antonio,,1979-04-04,ES75209555999983843558,TRX_N-00190-92985019,2022-06-07T15:55:46,Labastida,expenses,gas,-101.75,33.98
buyer_8,Antonio,,1979-04-04,ES75209555999983843558,TRX_N-00191-15625537,2022-06-07T18:45:55,Labastida,expenses,phone,-33.98,0.0
buyer_8,Antonio,,1979-04-04,ES75209555999983843558,TRX_N-00192-17742486,2022-06-07T14:19:29,Labastida,expenses,transport,-54.46,-54.46
buyer_8,Antonio,,1979-04-04,ES75209555999983843558,TRX_N-00193-65263856,2022-06-07T16:49:08,Labastida,expenses,clothing,-74.37,-128.83
buyer_8,Antonio,,1979-04-04,ES75209555999983843558,TRX_N-00194-29574653,2022-06-08T11:22:02,Leioa,expenses,clothing,-74.74,-203.57
buyer_8,Antonio,,1979-04-04,ES75209555999983843558,TRX_N-00195-39088896,2022-06-09T16:12:25,Labastida,expenses,food,-75.18,-278.75
buyer_8,Antonio,,1979-04-04,ES75209555999983843558,TRX_N-00196-41895976,2022-06-09T11:05:39,Labastida,expenses,leisure,-23.65,-302.4
buyer_8,Antonio,,1979-04-04,ES75209555999983843558,TRX_N-00197-97716461,2022-06-14T08:25:19,Llodio,expenses,gifts,-132.31,-434.71
buyer_8,Antonio,,1979-04-04,ES75209555999983843558,TRX_N-00198-91859791,2022-06-15T13:48:26,Labastida,expenses,leisure,-52.56,-487.27
buyer_8,Antonio,,1979-04-04,ES75209555999983843558,TRX_N-00199-72023806,2022-06-15T22:28:44,Andoain,expenses,cash,-100.0,-587.27
buyer_8,Antonio,,1979-04-04,ES75209555999983843558,TRX_N-00200-83016037,2022-06-17T18:30:00,Alegr√≠a-Dulantzi,expenses,cash,-100.0,-687.27
buyer_8,Antonio,,1979-04-04,ES75209555999983843558,TRX_N-00201-18576672,2022-06-18T20:55:21,Amurrio,expenses,leisure,-53.88,-741.15
buyer_8,Antonio,,1979-04-04,ES75209555999983843558,TRX_N-00202-07631617,2022-06-18T09:10:04,Labastida,expenses,clothing,-93.51,-834.66
buyer_8,Antonio,,1979-04-04,ES75209555999983843558,TRX_N-00203-95916589,2022-06-21T04:54:43,Labastida,expenses,food,-122.4,-957.06
buyer_8,Antonio,,1979-04-04,ES75209555999983843558,TRX_N-00204-17878982,2022-06-21T23:49:38,Labastida,expenses,transport,-45.65,-1002.71
buyer_8,Antonio,,1979-04-04,ES75209555999983843558,TRX_N-00205-03986032,2022-06-22T14:27:01,Labastida,expenses,gifts,-366.82,-1369.53
buyer_8,Antonio,,1979-04-04,ES75209555999983843558,TRX_N-00206-15375662,2022-06-24T22:05:51,Labastida,expenses,leisure,-65.77,-1435.3
buyer_8,Antonio,,1979-04-04,ES75209555999983843558,TRX_N-00207-01776006,2022-06-25T17:03:34,Iru√±a de Oca,expenses,cash,-100.0,-1535.3
buyer_8,Antonio,,1979-04-04,ES75209555999983843558,TRX_N-00208-20982072,2022-06-26T09:56:02,Labastida,expenses,food,-85.68,-1620.98
buyer_8,Antonio,,1979-04-04,ES75209555999983843558,TRX_N-00209-06956593,2022-06-26T19:06:40,Labastida,expenses,cash,-100.0,-1720.98
buyer_8,Antonio,,1979-04-04,ES75209555999983843558,TRX_N-00210-24658228,2022-06-27T23:56:00,Labastida,expenses,food,-85.27,-1806.25
buyer_8,Antonio,,1979-04-04,ES75209555999983843558,TRX_N-00211-30796103,2022-06-28T19:52:13,Labastida,expenses,leisure,-63.11,-1869.36
buyer_8,Antonio,,1979-04-04,ES75209555999983843558,TRX_N-00212-59793755,2022-06-29T02:59:18,Labastida,expenses,gifts,-341.15,-2210.51
buyer_8,Antonio,,1979-04-04,ES75209555999983843558,TRX_N-00213-88246337,2022-07-01T08:35:17,Labastida,incomes,salary,3710.47,1499.96
buyer_8,Antonio,,1979-04-04,ES75209555999983843558,TRX_N-00214-81732148,2022-07-01T08:35:17,Labastida,incomes,extra_income,614.38,2114.34
buyer_8,Antonio,,1979-04-04,ES75209555999983843558,TRX_N-00215-49413028,2022-07-02T16:12:35,Labastida,expenses,travel,-1195.49,918.85
buyer_8,Antonio,,1979-04-04,ES75209555999983843558,TRX_N-00216-18200770,2022-07-02T09:32:26,Labastida,expenses,repairs,-45.8,873.05
buyer_8,Antonio,,1979-04-04,ES75209555999983843558,TRX_N-00217-04534794,2022-07-04T18:29:00,Labastida,expenses,mortgage,-775.96,97.09
buyer_8,Antonio,,1979-04-04,ES75209555999983843558,TRX_N-00218-03952200,2022-07-04T14:17:42,Labastida,expenses,gifts,-267.51,-170.42
buyer_8,Antonio,,1979-04-04,ES75209555999983843558,TRX_N-00219-62091067,2022-07-05T13:38:33,Labastida,expenses,gas,-110.81,-281.23
buyer_8,Antonio,,1979-04-04,ES75209555999983843558,TRX_N-00220-24555149,2022-07-06T17:24:13,Labastida,expenses,electricity,-89.3,-370.53
buyer_8,Antonio,,1979-04-04,ES75209555999983843558,TRX_N-00221-65741368,2022-07-06T10:57:37,Labastida,expenses,phone,-31.77,-402.3
buyer_8,Antonio,,1979-04-04,ES75209555999983843558,TRX_N-00222-17230996,2022-07-06T15:37:41,Labastida,expenses,food,-83.28,-485.58
buyer_8,Antonio,,1979-04-04,ES75209555999983843558,TRX_N-00223-62066371,2022-07-06T16:51:11,Labastida,expenses,repairs,-202.13,-687.71
buyer_8,Antonio,,1979-04-04,ES75209555999983843558,TRX_N-00224-21400670,2022-07-07T11:00:25,Labastida,expenses,water,-39.2,-726.91
buyer_8,Antonio,,1979-04-04,ES75209555999983843558,TRX_N-00225-36349646,2022-07-07T17:13:21,Labastida,expenses,internet,-42.0,-768.91
buyer_8,Antonio,,1979-04-04,ES75209555999983843558,TRX_N-00226-64689594,2022-07-07T22:06:43,Labastida,expenses,food,-82.84,-851.75
buyer_8,Antonio,,1979-04-04,ES75209555999983843558,TRX_N-00227-14727418,2022-07-07T11:56:05,Labastida,expenses,clothing,-153.41,-1005.16
buyer_8,Antonio,,1979-04-04,ES75209555999983843558,TRX_N-00228-10091756,2022-07-07T11:36:31,Labastida,expenses,cash,-100.0,-1105.16
buyer_8,Antonio,,1979-04-04,ES75209555999983843558,TRX_N-00229-50257675,2022-07-08T19:06:03,Labastida,expenses,food,-92.6,-1197.76
buyer_8,Antonio,,1979-04-04,ES75209555999983843558,TRX_N-00230-99820357,2022-07-09T01:38:50,Lasarte-Oria,expenses,cash,-100.0,-1297.76
buyer_8,Antonio,,1979-04-04,ES75209555999983843558,TRX_N-00231-98667353,2022-07-10T11:26:09,Labastida,expenses,clothing,-73.92,-1371.68
buyer_8,Antonio,,1979-04-04,ES75209555999983843558,TRX_N-00232-81621260,2022-07-13T12:34:09,Hondarribia,expenses,transport,-50.19,-1421.87
buyer_8,Antonio,,1979-04-04,ES75209555999983843558,TRX_N-00233-01347585,2022-07-13T16:49:03,Labastida,expenses,cash,-100.0,-1521.87
buyer_8,Antonio,,1979-04-04,ES75209555999983843558,TRX_N-00234-74893848,2022-07-14T22:00:45,Labastida,expenses,transport,-41.01,-1562.88
buyer_8,Antonio,,1979-04-04,ES75209555999983843558,TRX_N-00235-20257871,2022-07-14T10:38:55,Labastida,expenses,healthcare,-45.99,-1608.87
buyer_8,Antonio,,1979-04-04,ES75209555999983843558,TRX_N-00236-51371864,2022-07-16T12:44:50,Labastida,expenses,food,-64.85,-1673.72
buyer_8,Antonio,,1979-04-04,ES75209555999983843558,TRX_N-00237-93238657,2022-07-17T10:26:05,Labastida,expenses,leisure,-75.4,-1749.12
buyer_8,Antonio,,1979-04-04,ES75209555999983843558,TRX_N-00238-30150328,2022-07-17T10:33:21,Labastida,expenses,clothing,-55.76,-1804.88
buyer_8,Antonio,,1979-04-04,ES75209555999983843558,TRX_N-00239-26927770,2022-07-18T08:27:02,Labastida,expenses,leisure,-23.86,-1828.74
buyer_8,Antonio,,1979-04-04,ES75209555999983843558,TRX_N-00240-44370054,2022-07-19T11:02:41,Labastida,expenses,cash,-100.0,-1928.74
buyer_8,Antonio,,1979-04-04,ES75209555999983843558,TRX_N-00241-82565255,2022-07-20T14:32:05,Labastida,expenses,food,-122.64,-2051.38
buyer_8,Antonio,,1979-04-04,ES75209555999983843558,TRX_N-00242-57204001,2022-07-21T17:49:47,Labastida,expenses,food,-68.33,-2119.71
buyer_8,Antonio,,1979-04-04,ES75209555999983843558,TRX_N-00243-44984723,2022-07-24T11:40:41,Labastida,expenses,repairs,-39.5,-2159.21
buyer_8,Antonio,,1979-04-04,ES75209555999983843558,TRX_N-00244-14041239,2022-07-25T12:48:51,Alegr√≠a-Dulantzi,expenses,education,-52.41,-2211.62
buyer_8,Antonio,,1979-04-04,ES75209555999983843558,TRX_N-00245-99879614,2022-07-26T19:55:44,Labastida,expenses,gifts,-313.69,-2525.31
buyer_8,Antonio,,1979-04-04,ES75209555999983843558,TRX_N-00246-66791793,2022-07-27T18:33:22,Labastida,expenses,transport,-75.7,-2601.01
buyer_8,Antonio,,1979-04-04,ES75209555999983843558,TRX_N-00247-27012182,2022-07-28T19:18:04,Andoain,expenses,gifts,-504.86,-3105.87
buyer_8,Antonio,,1979-04-04,ES75209555999983843558,TRX_N-00248-94080979,2022-07-31T08:02:45,Labastida,expenses,leisure,-53.55,-3159.42
buyer_8,Antonio,,1979-04-04,ES75209555999983843558,TRX_N-00249-17498225,2022-07-31T08:30:02,Labastida,expenses,cash,-100.0,-3259.42
buyer_8,Antonio,,1979-04-04,ES75209555999983843558,TRX_N-00250-64994671,2022-08-01T19:36:22,Labastida,incomes,salary,3710.47,451.05
buyer_8,Antonio,,1979-04-04,ES75209555999983843558,TRX_N-00251-14982781,2022-08-01T08:18:07,Labastida,expenses,transport,-70.35,380.7
buyer_8,Antonio,,1979-04-04,ES75209555999983843558,TRX_N-00252-08236192,2022-08-02T18:13:33,Labastida,expenses,cash,-100.0,280.7
buyer_8,Antonio,,1979-04-04,ES75209555999983843558,TRX_N-00253-49689980,2022-08-03T08:18:58,Labastida,expenses,repairs,-124.0,156.7
buyer_8,Antonio,,1979-04-04,ES75209555999983843558,TRX_N-00254-51181994,2022-08-04T20:20:30,Labastida,expenses,mortgage,-775.96,-619.26
buyer_8,Antonio,,1979-04-04,ES75209555999983843558,TRX_N-00255-67698201,2022-08-04T09:57:58,Labastida,expenses,leisure,-26.17,-645.43
buyer_8,Antonio,,1979-04-04,ES75209555999983843558,TRX_N-00256-61534063,2022-08-04T13:29:29,Salvatierra/Agurain,expenses,cash,-100.0,-745.43
buyer_8,Antonio,,1979-04-04,ES75209555999983843558,TRX_N-00257-77511820,2022-08-05T11:20:35,Labastida,expenses,electricity,-76.62,-822.05
buyer_8,Antonio,,1979-04-04,ES75209555999983843558,TRX_N-00258-97339141,2022-08-05T16:53:09,Labastida,expenses,gas,-81.49,-903.54
buyer_8,Antonio,,1979-04-04,ES75209555999983843558,TRX_N-00259-49276817,2022-08-05T12:36:58,Labastida,expenses,phone,-40.51,-944.05
buyer_8,Antonio,,1979-04-04,ES75209555999983843558,TRX_N-00260-24925897,2022-08-05T15:08:28,Hernani,expenses,leisure,-23.27,-967.32
buyer_8,Antonio,,1979-04-04,ES75209555999983843558,TRX_N-00261-52147172,2022-08-07T11:26:34,Labastida,expenses,water,-29.23,-996.55
buyer_8,Antonio,,1979-04-04,ES75209555999983843558,TRX_N-00262-24141228,2022-08-07T16:07:21,Labastida,expenses,clothing,-101.49,-1098.04
buyer_8,Antonio,,1979-04-04,ES75209555999983843558,TRX_N-00263-25618300,2022-08-08T12:21:05,Labastida,expenses,internet,-42.0,-1140.04
buyer_8,Antonio,,1979-04-04,ES75209555999983843558,TRX_N-00264-26231685,2022-08-08T08:05:01,Labastida,expenses,cash,-100.0,-1240.04
buyer_8,Antonio,,1979-04-04,ES75209555999983843558,TRX_N-00265-39936640,2022-08-09T16:04:18,Labastida,expenses,education,-64.09,-1304.13
buyer_8,Antonio,,1979-04-04,ES75209555999983843558,TRX_N-00266-14096285,2022-08-09T14:59:42,Labastida,expenses,cash,-100.0,-1404.13
buyer_8,Antonio,,1979-04-04,ES75209555999983843558,TRX_N-00267-74582533,2022-08-10T18:40:03,Labastida,expenses,transport,-50.06,-1454.19
buyer_8,Antonio,,1979-04-04,ES75209555999983843558,TRX_N-00268-73199760,2022-08-10T20:34:48,Andoain,expenses,cash,-100.0,-1554.19
buyer_8,Antonio,,1979-04-04,ES75209555999983843558,TRX_N-00269-30196454,2022-08-11T19:53:29,Labastida,expenses,food,-100.53,-1654.72
buyer_8,Antonio,,1979-04-04,ES75209555999983843558,TRX_N-00270-81210190,2022-08-13T11:55:58,Labastida,expenses,transport,-84.58,-1739.3
buyer_8,Antonio,,1979-04-04,ES75209555999983843558,TRX_N-00271-01171045,2022-08-13T06:09:13,Labastida,expenses,appliances,-373.31,-2112.61
buyer_8,Antonio,,1979-04-04,ES75209555999983843558,TRX_N-00272-10036433,2022-08-21T13:45:51,Labastida,expenses,education,-78.15,-2190.76
buyer_8,Antonio,,1979-04-04,ES75209555999983843558,TRX_N-00273-57680192,2022-08-22T17:20:52,Labastida,expenses,leisure,-56.65,-2247.41
buyer_8,Antonio,,1979-04-04,ES75209555999983843558,TRX_N-00274-04171191,2022-08-22T16:14:41,Labastida,expenses,cash,-100.0,-2347.41
buyer_8,Antonio,,1979-04-04,ES75209555999983843558,TRX_N-00275-85496321,2022-08-24T09:39:04,Labastida,expenses,cash,-100.0,-2447.41
buyer_8,Antonio,,1979-04-04,ES75209555999983843558,TRX_N-00276-33579181,2022-08-26T05:42:57,Labastida,expenses,clothing,-106.01,-2553.42
buyer_8,Antonio,,1979-04-04,ES75209555999983843558,TRX_N-00277-61880777,2022-08-27T10:22:58,Labastida,expenses,food,-100.04,-2653.46
buyer_8,Antonio,,1979-04-04,ES75209555999983843558,TRX_N-00278-38305282,2022-08-28T13:07:42,Leioa,expenses,repairs,-147.21,-2800.67
buyer_8,Antonio,,1979-04-04,ES75209555999983843558,TRX_N-00279-38296031,2022-08-29T12:48:45,Labastida,expenses,food,-68.54,-2869.21
buyer_8,Antonio,,1979-04-04,ES75209555999983843558,TRX_N-00280-55688906,2022-08-31T13:56:04,Zarautz,expenses,cash,-100.0,-2969.21
buyer_8,Antonio,,1979-04-04,ES75209555999983843558,TRX_N-00281-86668220,2022-09-01T13:37:36,Labastida,incomes,salary,3710.47,741.26
buyer_8,Antonio,,1979-04-04,ES75209555999983843558,TRX_N-00282-63674948,2022-09-03T15:11:39,Labastida,expenses,cash,-100.0,641.26
buyer_8,Antonio,,1979-04-04,ES75209555999983843558,TRX_N-00283-76497125,2022-09-04T17:37:49,Labastida,expenses,mortgage,-775.96,-134.7
buyer_8,Antonio,,1979-04-04,ES75209555999983843558,TRX_N-00284-08274526,2022-09-05T22:58:37,Labastida,expenses,gas,-67.87,-202.57
buyer_8,Antonio,,1979-04-04,ES75209555999983843558,TRX_N-00285-73568735,2022-09-06T17:00:19,Labastida,expenses,electricity,-71.36,-273.93
buyer_8,Antonio,,1979-04-04,ES75209555999983843558,TRX_N-00286-25428298,2022-09-08T22:16:43,Labastida,expenses,internet,-42.0,-315.93
buyer_8,Antonio,,1979-04-04,ES75209555999983843558,TRX_N-00287-88296926,2022-09-08T12:43:03,Labastida,expenses,water,-30.73,-346.66
buyer_8,Antonio,,1979-04-04,ES75209555999983843558,TRX_N-00288-97556108,2022-09-08T16:53:01,Labastida,expenses,phone,-41.97,-388.63
buyer_8,Antonio,,1979-04-04,ES75209555999983843558,TRX_N-00289-87887770,2022-09-10T11:36:09,Hernani,expenses,food,-66.93,-455.56
buyer_8,Antonio,,1979-04-04,ES75209555999983843558,TRX_N-00290-87947138,2022-09-10T12:39:39,Labastida,expenses,cash,-100.0,-555.56
buyer_8,Antonio,,1979-04-04,ES75209555999983843558,TRX_N-00291-42415116,2022-09-13T16:25:27,Vitoria-Gasteiz,expenses,food,-105.14,-660.7
buyer_8,Antonio,,1979-04-04,ES75209555999983843558,TRX_N-00292-61396875,2022-09-14T22:54:43,Labastida,expenses,leisure,-46.81,-707.51
buyer_8,Antonio,,1979-04-04,ES75209555999983843558,TRX_N-00293-97396850,2022-09-15T16:14:00,Labastida,expenses,gifts,-702.82,-1410.33
buyer_8,Antonio,,1979-04-04,ES75209555999983843558,TRX_N-00294-69775542,2022-09-16T20:09:40,Labastida,expenses,food,-85.75,-1496.08
buyer_8,Antonio,,1979-04-04,ES75209555999983843558,TRX_N-00295-04716636,2022-09-16T23:31:28,Errenteria,expenses,cash,-100.0,-1596.08
buyer_8,Antonio,,1979-04-04,ES75209555999983843558,TRX_N-00296-42433461,2022-09-16T19:47:13,Errenteria,expenses,gifts,-510.66,-2106.74
buyer_8,Antonio,,1979-04-04,ES75209555999983843558,TRX_N-00297-01947470,2022-09-17T12:00:38,Labastida,expenses,food,-94.04,-2200.78
buyer_8,Antonio,,1979-04-04,ES75209555999983843558,TRX_N-00298-83277541,2022-09-17T17:36:12,Labastida,expenses,repairs,-265.02,-2465.8
buyer_8,Antonio,,1979-04-04,ES75209555999983843558,TRX_N-00299-27112919,2022-09-18T15:47:06,Labastida,expenses,healthcare,-177.79,-2643.59
buyer_8,Antonio,,1979-04-04,ES75209555999983843558,TRX_N-00300-19543034,2022-09-19T01:49:33,Labastida,expenses,cash,-100.0,-2743.59
buyer_8,Antonio,,1979-04-04,ES75209555999983843558,TRX_N-00301-99528781,2022-09-20T08:16:56,Hondarribia,expenses,cash,-100.0,-2843.59
buyer_8,Antonio,,1979-04-04,ES75209555999983843558,TRX_N-00302-68081980,2022-09-23T04:47:43,Labastida,expenses,cash,-100.0,-2943.59
buyer_8,Antonio,,1979-04-04,ES75209555999983843558,TRX_N-00303-68374108,2022-09-24T20:04:24,Eibar,expenses,food,-89.67,-3033.26
buyer_8,Antonio,,1979-04-04,ES75209555999983843558,TRX_N-00304-11403770,2022-09-25T18:54:57,Erandio,expenses,food,-86.1,-3119.36
buyer_8,Antonio,,1979-04-04,ES75209555999983843558,TRX_N-00305-23332825,2022-09-25T23:03:51,Labastida,expenses,repairs,-82.38,-3201.74
buyer_8,Antonio,,1979-04-04,ES75209555999983843558,TRX_N-00306-24186764,2022-09-27T21:54:06,Labastida,expenses,repairs,-176.19,-3377.93
buyer_8,Antonio,,1979-04-04,ES75209555999983843558,TRX_N-00307-70720093,2022-09-29T20:31:50,Labastida,expenses,food,-103.43,-3481.36
buyer_8,Antonio,,1979-04-04,ES75209555999983843558,TRX_N-00308-69142980,2022-10-01T15:20:44,Labastida,incomes,salary,3710.47,229.11
buyer_8,Antonio,,1979-04-04,ES75209555999983843558,TRX_N-00309-02178216,2022-10-01T15:20:44,Labastida,incomes,extra_income,614.38,843.49
buyer_8,Antonio,,1979-04-04,ES75209555999983843558,TRX_N-00310-53654354,2022-10-01T08:03:22,Andoain,expenses,food,-73.79,769.7
buyer_8,Antonio,,1979-04-04,ES75209555999983843558,TRX_N-00311-97299408,2022-10-01T22:38:04,Labastida,expenses,cash,-100.0,669.7
buyer_8,Antonio,,1979-04-04,ES75209555999983843558,TRX_N-00312-25263706,2022-10-01T16:04:53,Santurtzi,expenses,gifts,-290.68,379.02
buyer_8,Antonio,,1979-04-04,ES75209555999983843558,TRX_N-00313-42369595,2022-10-03T18:51:10,Labastida,expenses,appliances,-212.26,166.76
buyer_8,Antonio,,1979-04-04,ES75209555999983843558,TRX_N-00314-26119895,2022-10-04T20:30:04,Labastida,expenses,mortgage,-775.96,-609.2
buyer_8,Antonio,,1979-04-04,ES75209555999983843558,TRX_N-00315-88082186,2022-10-04T04:51:53,Labastida,expenses,appliances,-369.93,-979.13
buyer_8,Antonio,,1979-04-04,ES75209555999983843558,TRX_N-00316-65617891,2022-10-05T04:19:53,Labastida,expenses,leisure,-78.92,-1058.05
buyer_8,Antonio,,1979-04-04,ES75209555999983843558,TRX_N-00317-16491390,2022-10-06T12:28:19,Labastida,expenses,leisure,-53.0,-1111.05
buyer_8,Antonio,,1979-04-04,ES75209555999983843558,TRX_N-00318-99306375,2022-10-07T09:35:32,Labastida,expenses,gas,-49.16,-1160.21
buyer_8,Antonio,,1979-04-04,ES75209555999983843558,TRX_N-00319-12185110,2022-10-07T17:44:54,Labastida,expenses,cash,-100.0,-1260.21
buyer_8,Antonio,,1979-04-04,ES75209555999983843558,TRX_N-00320-00129120,2022-10-08T10:43:29,Labastida,expenses,internet,-42.0,-1302.21
buyer_8,Antonio,,1979-04-04,ES75209555999983843558,TRX_N-00321-82663389,2022-10-08T18:16:23,Labastida,expenses,water,-32.03,-1334.24
buyer_8,Antonio,,1979-04-04,ES75209555999983843558,TRX_N-00322-78979162,2022-10-08T12:33:15,Labastida,expenses,electricity,-50.14,-1384.38
buyer_8,Antonio,,1979-04-04,ES75209555999983843558,TRX_N-00323-93609132,2022-10-08T13:22:40,Labastida,expenses,phone,-37.56,-1421.94
buyer_8,Antonio,,1979-04-04,ES75209555999983843558,TRX_N-00324-30829522,2022-10-08T12:52:51,Hernani,expenses,food,-120.05,-1541.99
buyer_8,Antonio,,1979-04-04,ES75209555999983843558,TRX_N-00325-71654641,2022-10-08T10:05:34,Labastida,expenses,transport,-45.56,-1587.55
buyer_8,Antonio,,1979-04-04,ES75209555999983843558,TRX_N-00326-36602067,2022-10-08T17:21:25,Labastida,expenses,cash,-100.0,-1687.55
buyer_8,Antonio,,1979-04-04,ES75209555999983843558,TRX_N-00327-59456858,2022-10-08T20:51:23,Labastida,expenses,repairs,-307.37,-1994.92
buyer_8,Antonio,,1979-04-04,ES75209555999983843558,TRX_N-00328-14711968,2022-10-09T14:37:09,Leioa,expenses,food,-79.87,-2074.79
buyer_8,Antonio,,1979-04-04,ES75209555999983843558,TRX_N-00329-51901933,2022-10-09T19:05:57,Labastida,expenses,gifts,-51.37,-2126.16
buyer_8,Antonio,,1979-04-04,ES75209555999983843558,TRX_N-00330-07472431,2022-10-12T18:14:21,Zarautz,expenses,gifts,-167.22,-2293.38
buyer_8,Antonio,,1979-04-04,ES75209555999983843558,TRX_N-00331-70705875,2022-10-14T18:59:09,Labastida,expenses,cash,-100.0,-2393.38
buyer_8,Antonio,,1979-04-04,ES75209555999983843558,TRX_N-00332-81215829,2022-10-15T19:45:37,Labastida,expenses,food,-105.9,-2499.28
buyer_8,Antonio,,1979-04-04,ES75209555999983843558,TRX_N-00333-75984034,2022-10-15T02:49:40,Labastida,expenses,leisure,-74.07,-2573.35
buyer_8,Antonio,,1979-04-04,ES75209555999983843558,TRX_N-00334-85962030,2022-10-15T17:13:39,Labastida,expenses,appliances,-418.02,-2991.37
buyer_8,Antonio,,1979-04-04,ES75209555999983843558,TRX_N-00335-17821496,2022-10-16T15:30:12,Labastida,expenses,education,-42.33,-3033.7
buyer_8,Antonio,,1979-04-04,ES75209555999983843558,TRX_N-00336-39225157,2022-10-16T01:14:59,Labastida,expenses,travel,-1789.78,-4823.48
buyer_8,Antonio,,1979-04-04,ES75209555999983843558,TRX_N-00337-53381292,2022-10-17T14:52:03,Labastida,expenses,leisure,-64.38,-4887.86
buyer_8,Antonio,,1979-04-04,ES75209555999983843558,TRX_N-00338-18252960,2022-10-17T09:31:32,Labastida,expenses,repairs,-202.38,-5090.24
buyer_8,Antonio,,1979-04-04,ES75209555999983843558,TRX_N-00339-89784716,2022-10-17T20:00:39,Labastida,expenses,gifts,-493.72,-5583.96
buyer_8,Antonio,,1979-04-04,ES75209555999983843558,TRX_N-00340-66698143,2022-10-18T16:31:53,Labastida,expenses,repairs,-330.15,-5914.11
buyer_8,Antonio,,1979-04-04,ES75209555999983843558,TRX_N-00341-08675786,2022-10-19T17:32:55,Irun,expenses,leisure,-31.83,-5945.94
buyer_8,Antonio,,1979-04-04,ES75209555999983843558,TRX_N-00342-91062303,2022-10-21T14:11:23,Labastida,expenses,food,-62.17,-6008.11
buyer_8,Antonio,,1979-04-04,ES75209555999983843558,TRX_N-00343-05297229,2022-10-21T13:30:03,Labastida,expenses,leisure,-78.87,-6086.98
buyer_8,Antonio,,1979-04-04,ES75209555999983843558,TRX_N-00344-20934814,2022-10-21T14:25:37,Labastida,expenses,repairs,-314.86,-6401.84
buyer_8,Antonio,,1979-04-04,ES75209555999983843558,TRX_N-00345-98456147,2022-10-23T20:26:19,Labastida,expenses,food,-92.36,-6494.2
buyer_8,Antonio,,1979-04-04,ES75209555999983843558,TRX_N-00346-14197728,2022-10-23T20:03:44,Labastida,expenses,transport,-62.73,-6556.93
buyer_8,Antonio,,1979-04-04,ES75209555999983843558,TRX_N-00347-73839935,2022-10-23T22:42:51,Labastida,expenses,leisure,-41.14,-6598.07
buyer_8,Antonio,,1979-04-04,ES75209555999983843558,TRX_N-00348-70308345,2022-10-25T15:44:05,Labastida,expenses,healthcare,-174.7,-6772.77
buyer_8,Antonio,,1979-04-04,ES75209555999983843558,TRX_N-00349-97898837,2022-10-25T16:44:01,Labastida,expenses,cash,-100.0,-6872.77
buyer_8,Antonio,,1979-04-04,ES75209555999983843558,TRX_N-00350-40626104,2022-10-27T19:58:00,Labastida,expenses,transport,-57.58,-6930.35
buyer_8,Antonio,,1979-04-04,ES75209555999983843558,TRX_N-00351-01938115,2022-10-29T21:06:52,Labastida,expenses,leisure,-20.24,-6950.59
buyer_8,Antonio,,1979-04-04,ES75209555999983843558,TRX_N-00352-65371720,2022-10-29T18:47:10,Labastida,expenses,cash,-100.0,-7050.59
buyer_8,Antonio,,1979-04-04,ES75209555999983843558,TRX_N-00353-86539113,2022-10-30T16:42:27,Labastida,expenses,food,-119.85,-7170.44
buyer_8,Antonio,,1979-04-04,ES75209555999983843558,TRX_N-00354-79519988,2022-10-30T13:05:15,Labastida,expenses,repairs,-279.81,-7450.25
buyer_8,Antonio,,1979-04-04,ES75209555999983843558,TRX_N-00355-53670091,2022-10-31T15:58:48,Labastida,expenses,food,-92.23,-7542.48
buyer_8,Antonio,,1979-04-04,ES75209555999983843558,TRX_N-00356-70913411,2022-11-01T09:36:26,Labastida,incomes,salary,3710.47,-3832.01
buyer_8,Antonio,,1979-04-04,ES75209555999983843558,TRX_N-00357-20118459,2022-11-04T12:02:11,Labastida,expenses,mortgage,-775.96,-4607.97
buyer_8,Antonio,,1979-04-04,ES75209555999983843558,TRX_N-00358-56883522,2022-11-05T13:38:08,Labastida,expenses,phone,-34.59,-4642.56
buyer_8,Antonio,,1979-04-04,ES75209555999983843558,TRX_N-00359-11998463,2022-11-05T19:21:18,Lasarte-Oria,expenses,food,-83.45,-4726.01
buyer_8,Antonio,,1979-04-04,ES75209555999983843558,TRX_N-00360-60548984,2022-11-05T09:02:35,Labastida,expenses,repairs,-307.1,-5033.11
buyer_8,Antonio,,1979-04-04,ES75209555999983843558,TRX_N-00361-30506988,2022-11-06T02:45:02,Labastida,expenses,water,-34.13,-5067.24
buyer_8,Antonio,,1979-04-04,ES75209555999983843558,TRX_N-00362-10154355,2022-11-06T18:46:26,Labastida,expenses,gas,-94.37,-5161.61
buyer_8,Antonio,,1979-04-04,ES75209555999983843558,TRX_N-00363-00902257,2022-11-06T13:30:18,Labastida,expenses,internet,-42.0,-5203.61
buyer_8,Antonio,,1979-04-04,ES75209555999983843558,TRX_N-00364-60804365,2022-11-07T04:56:48,Labastida,expenses,cash,-100.0,-5303.61
buyer_8,Antonio,,1979-04-04,ES75209555999983843558,TRX_N-00365-63127340,2022-11-08T09:29:42,Labastida,expenses,electricity,-43.12,-5346.73
buyer_8,Antonio,,1979-04-04,ES75209555999983843558,TRX_N-00366-30949187,2022-11-10T21:41:14,Labastida,expenses,food,-89.38,-5436.11
buyer_8,Antonio,,1979-04-04,ES75209555999983843558,TRX_N-00367-41009673,2022-11-12T16:15:29,Labastida,expenses,leisure,-49.72,-5485.83
buyer_8,Antonio,,1979-04-04,ES75209555999983843558,TRX_N-00368-76267108,2022-11-13T11:36:35,Labastida,expenses,food,-92.94,-5578.77
buyer_8,Antonio,,1979-04-04,ES75209555999983843558,TRX_N-00369-71126768,2022-11-14T10:32:57,Labastida,expenses,appliances,-245.7,-5824.47
buyer_8,Antonio,,1979-04-04,ES75209555999983843558,TRX_N-00370-91158539,2022-11-16T19:10:29,Labastida,expenses,food,-84.86,-5909.33
buyer_8,Antonio,,1979-04-04,ES75209555999983843558,TRX_N-00371-16779098,2022-11-17T12:36:36,Labastida,expenses,food,-124.72,-6034.05
buyer_8,Antonio,,1979-04-04,ES75209555999983843558,TRX_N-00372-58793889,2022-11-19T15:53:51,Labastida,expenses,leisure,-23.74,-6057.79
buyer_8,Antonio,,1979-04-04,ES75209555999983843558,TRX_N-00373-03470254,2022-11-21T16:10:51,Arrasate,expenses,repairs,-120.83,-6178.62
buyer_8,Antonio,,1979-04-04,ES75209555999983843558,TRX_N-00374-88388013,2022-11-22T17:05:25,Labastida,expenses,transport,-78.99,-6257.61
buyer_8,Antonio,,1979-04-04,ES75209555999983843558,TRX_N-00375-34717211,2022-11-25T13:02:23,Labastida,expenses,gifts,-520.16,-6777.77
buyer_8,Antonio,,1979-04-04,ES75209555999983843558,TRX_N-00376-79659255,2022-11-27T10:50:23,Labastida,expenses,repairs,-319.21,-7096.98
buyer_8,Antonio,,1979-04-04,ES75209555999983843558,TRX_N-00377-45661521,2022-11-28T18:40:39,Labastida,expenses,education,-53.39,-7150.37
buyer_8,Antonio,,1979-04-04,ES75209555999983843558,TRX_N-00378-92362181,2022-11-29T18:12:21,Labastida,expenses,transport,-58.75,-7209.12
buyer_8,Antonio,,1979-04-04,ES75209555999983843558,TRX_N-00379-99286977,2022-11-30T10:24:48,Labastida,expenses,food,-70.81,-7279.93
buyer_8,Antonio,,1979-04-04,ES75209555999983843558,TRX_N-00380-64376497,2022-12-01T08:05:51,Labastida,incomes,salary,3710.47,-3569.46
buyer_8,Antonio,,1979-04-04,ES75209555999983843558,TRX_N-00381-88094351,2022-12-01T08:05:51,Labastida,incomes,salary_bonus,2835.25,-734.21
buyer_8,Antonio,,1979-04-04,ES75209555999983843558,TRX_N-00382-96652340,2022-12-01T21:08:58,Labastida,expenses,cash,-100.0,-834.21
buyer_8,Antonio,,1979-04-04,ES75209555999983843558,TRX_N-00383-96680050,2022-12-01T05:31:01,Oy√≥n-Oion,expenses,repairs,-197.31,-1031.52
buyer_8,Antonio,,1979-04-04,ES75209555999983843558,TRX_N-00384-96962353,2022-12-04T19:29:17,Labastida,expenses,mortgage,-775.96,-1807.48
buyer_8,Antonio,,1979-04-04,ES75209555999983843558,TRX_N-00385-57020638,2022-12-04T11:58:42,Labastida,expenses,repairs,-58.07,-1865.55
buyer_8,Antonio,,1979-04-04,ES75209555999983843558,TRX_N-00386-96166904,2022-12-05T11:29:30,Labastida,expenses,gas,-46.63,-1912.18
buyer_8,Antonio,,1979-04-04,ES75209555999983843558,TRX_N-00387-89981887,2022-12-06T12:16:05,Labastida,expenses,electricity,-46.08,-1958.26
buyer_8,Antonio,,1979-04-04,ES75209555999983843558,TRX_N-00388-02358376,2022-12-07T14:55:40,Labastida,expenses,water,-20.95,-1979.21
buyer_8,Antonio,,1979-04-04,ES75209555999983843558,TRX_N-00389-56924680,2022-12-07T19:38:47,Labastida,expenses,food,-78.59,-2057.8
buyer_8,Antonio,,1979-04-04,ES75209555999983843558,TRX_N-00390-61594251,2022-12-08T02:15:19,Labastida,expenses,internet,-42.0,-2099.8
buyer_8,Antonio,,1979-04-04,ES75209555999983843558,TRX_N-00391-19765328,2022-12-08T17:32:16,Labastida,expenses,phone,-41.51,-2141.31
buyer_8,Antonio,,1979-04-04,ES75209555999983843558,TRX_N-00392-46045364,2022-12-08T16:59:34,Labastida,expenses,education,-58.35,-2199.66
buyer_8,Antonio,,1979-04-04,ES75209555999983843558,TRX_N-00393-51189963,2022-12-10T19:31:51,Mungia,expenses,gifts,-516.02,-2715.68
buyer_8,Antonio,,1979-04-04,ES75209555999983843558,TRX_N-00394-82622511,2022-12-11T20:21:16,Labastida,expenses,cash,-100.0,-2815.68
buyer_8,Antonio,,1979-04-04,ES75209555999983843558,TRX_N-00395-50608431,2022-12-11T11:07:15,Sopela,expenses,repairs,-166.05,-2981.73
buyer_8,Antonio,,1979-04-04,ES75209555999983843558,TRX_N-00396-90667522,2022-12-12T21:41:11,Labastida,expenses,food,-111.54,-3093.27
buyer_8,Antonio,,1979-04-04,ES75209555999983843558,TRX_N-00397-82868913,2022-12-12T09:34:58,Labastida,expenses,cash,-100.0,-3193.27
buyer_8,Antonio,,1979-04-04,ES75209555999983843558,TRX_N-00398-91334183,2022-12-14T14:55:02,Labastida,expenses,education,-65.57,-3258.84
buyer_8,Antonio,,1979-04-04,ES75209555999983843558,TRX_N-00399-28417757,2022-12-16T09:22:58,Labastida,expenses,cash,-100.0,-3358.84
buyer_8,Antonio,,1979-04-04,ES75209555999983843558,TRX_N-00400-30499210,2022-12-17T04:39:02,Labastida,expenses,food,-99.62,-3458.46
buyer_8,Antonio,,1979-04-04,ES75209555999983843558,TRX_N-00401-53853448,2022-12-17T16:03:13,Labastida,expenses,healthcare,-153.71,-3612.17
buyer_8,Antonio,,1979-04-04,ES75209555999983843558,TRX_N-00402-33159968,2022-12-17T15:06:29,Labastida,expenses,repairs,-60.78,-3672.95
buyer_8,Antonio,,1979-04-04,ES75209555999983843558,TRX_N-00403-76939723,2022-12-18T21:17:19,Labastida,expenses,clothing,-124.81,-3797.76
buyer_8,Antonio,,1979-04-04,ES75209555999983843558,TRX_N-00404-52950662,2022-12-19T20:08:24,Labastida,expenses,clothing,-88.96,-3886.72
buyer_8,Antonio,,1979-04-04,ES75209555999983843558,TRX_N-00405-21485558,2022-12-20T11:34:41,Labastida,expenses,clothing,-113.9,-4000.62
buyer_8,Antonio,,1979-04-04,ES75209555999983843558,TRX_N-00406-71572218,2022-12-20T21:38:08,Labastida,expenses,cash,-100.0,-4100.62
buyer_8,Antonio,,1979-04-04,ES75209555999983843558,TRX_N-00407-64023612,2022-12-21T18:16:01,Labastida,expenses,food,-77.96,-4178.58
buyer_8,Antonio,,1979-04-04,ES75209555999983843558,TRX_N-00408-73758697,2022-12-21T00:35:09,Labastida,expenses,leisure,-48.22,-4226.8
buyer_8,Antonio,,1979-04-04,ES75209555999983843558,TRX_N-00409-42367029,2022-12-22T15:32:25,Labastida,expenses,food,-74.96,-4301.76
buyer_8,Antonio,,1979-04-04,ES75209555999983843558,TRX_N-00410-86699724,2022-12-25T17:56:21,Arrasate,expenses,transport,-67.15,-4368.91
buyer_8,Antonio,,1979-04-04,ES75209555999983843558,TRX_N-00411-25324151,2022-12-25T17:03:33,Labastida,expenses,education,-72.11,-4441.02
buyer_8,Antonio,,1979-04-04,ES75209555999983843558,TRX_N-00412-96316835,2022-12-25T13:58:41,Labastida,expenses,cash,-100.0,-4541.02
buyer_8,Antonio,,1979-04-04,ES75209555999983843558,TRX_N-00413-96324611,2022-12-26T15:29:46,Labastida,expenses,repairs,-67.65,-4608.67
buyer_8,Antonio,,1979-04-04,ES75209555999983843558,TRX_N-00414-04288254,2022-12-27T23:58:24,Labastida,expenses,clothing,-75.01,-4683.68
buyer_8,Antonio,,1979-04-04,ES75209555999983843558,TRX_N-00415-59480828,2022-12-27T09:00:27,Labastida,expenses,cash,-100.0,-4783.68
buyer_8,Antonio,,1979-04-04,ES75209555999983843558,TRX_N-00416-43491293,2022-12-30T23:50:05,Labastida,expenses,cash,-100.0,-4883.68
buyer_8,Antonio,,1979-04-04,ES75209555999983843558,TRX_N-00417-70797735,2022-12-30T20:57:06,Labastida,expenses,repairs,-45.44,-4929.12
buyer_8,Antonio,,1979-04-04,ES75209555999983843558,TRX_N-00418-05599041,2023-01-01T15:51:51,Labastida,incomes,salary,3834.17,-1094.95
buyer_8,Antonio,,1979-04-04,ES75209555999983843558,TRX_N-00419-47900706,2023-01-01T08:51:49,Labastida,expenses,food,-103.99,-1198.94
buyer_8,Antonio,,1979-04-04,ES75209555999983843558,TRX_N-00420-04469997,2023-01-01T20:26:43,Labastida,expenses,repairs,-76.96,-1275.9
buyer_8,Antonio,,1979-04-04,ES75209555999983843558,TRX_N-00421-51205294,2023-01-04T10:55:33,Labastida,expenses,mortgage,-775.96,-2051.86
buyer_8,Antonio,,1979-04-04,ES75209555999983843558,TRX_N-00422-62311652,2023-01-04T04:08:23,Labastida,expenses,gifts,-477.33,-2529.19
buyer_8,Antonio,,1979-04-04,ES75209555999983843558,TRX_N-00423-33617050,2023-01-05T17:56:31,Labastida,expenses,phone,-42.88,-2572.07
buyer_8,Antonio,,1979-04-04,ES75209555999983843558,TRX_N-00424-17092234,2023-01-05T16:16:48,Mungia,expenses,cash,-100.0,-2672.07
buyer_8,Antonio,,1979-04-04,ES75209555999983843558,TRX_N-00425-53199723,2023-01-06T18:04:29,Labastida,expenses,water,-34.25,-2706.32
buyer_8,Antonio,,1979-04-04,ES75209555999983843558,TRX_N-00426-11094586,2023-01-06T23:46:31,Galdakao,expenses,leisure,-19.77,-2726.09
buyer_8,Antonio,,1979-04-04,ES75209555999983843558,TRX_N-00427-36142679,2023-01-07T17:59:18,Labastida,expenses,electricity,-23.83,-2749.92
buyer_8,Antonio,,1979-04-04,ES75209555999983843558,TRX_N-00428-13420781,2023-01-07T15:41:20,Labastida,expenses,food,-70.85,-2820.77
buyer_8,Antonio,,1979-04-04,ES75209555999983843558,TRX_N-00429-79760216,2023-01-08T20:20:19,Labastida,expenses,internet,-42.0,-2862.77
buyer_8,Antonio,,1979-04-04,ES75209555999983843558,TRX_N-00430-86661837,2023-01-08T12:00:55,Labastida,expenses,gas,-105.77,-2968.54
buyer_8,Antonio,,1979-04-04,ES75209555999983843558,TRX_N-00431-90441361,2023-01-10T11:01:52,Labastida,expenses,food,-98.93,-3067.47
buyer_8,Antonio,,1979-04-04,ES75209555999983843558,TRX_N-00432-95257711,2023-01-11T12:36:23,Labastida,expenses,clothing,-117.17,-3184.64
buyer_8,Antonio,,1979-04-04,ES75209555999983843558,TRX_N-00433-99138828,2023-01-13T17:12:52,Labastida,expenses,transport,-57.26,-3241.9
buyer_8,Antonio,,1979-04-04,ES75209555999983843558,TRX_N-00434-79841371,2023-01-13T09:58:28,Labastida,expenses,clothing,-141.15,-3383.05
buyer_8,Antonio,,1979-04-04,ES75209555999983843558,TRX_N-00435-25768250,2023-01-14T22:19:09,Labastida,expenses,food,-101.33,-3484.38
buyer_8,Antonio,,1979-04-04,ES75209555999983843558,TRX_N-00436-47454103,2023-01-17T14:01:39,Labastida,expenses,food,-121.51,-3605.89
buyer_8,Antonio,,1979-04-04,ES75209555999983843558,TRX_N-00437-29435761,2023-01-17T16:45:47,Labastida,expenses,gifts,-636.47,-4242.36
buyer_8,Antonio,,1979-04-04,ES75209555999983843558,TRX_N-00438-76536464,2023-01-20T07:53:17,Labastida,expenses,gifts,-681.64,-4924.0
buyer_8,Antonio,,1979-04-04,ES75209555999983843558,TRX_N-00439-91745235,2023-01-22T09:31:16,Labastida,expenses,education,-71.89,-4995.89
buyer_8,Antonio,,1979-04-04,ES75209555999983843558,TRX_N-00440-82638917,2023-01-23T15:31:14,Labastida,expenses,leisure,-45.61,-5041.5
buyer_8,Antonio,,1979-04-04,ES75209555999983843558,TRX_N-00441-00711285,2023-01-23T15:44:50,Eibar,expenses,cash,-100.0,-5141.5
buyer_8,Antonio,,1979-04-04,ES75209555999983843558,TRX_N-00442-43927364,2023-01-24T04:17:32,Labastida,expenses,food,-83.81,-5225.31
buyer_8,Antonio,,1979-04-04,ES75209555999983843558,TRX_N-00443-50428086,2023-01-27T16:14:43,Labastida,expenses,transport,-45.05,-5270.36
buyer_8,Antonio,,1979-04-04,ES75209555999983843558,TRX_N-00444-22959404,2023-01-27T01:07:58,Labastida,expenses,cash,-100.0,-5370.36
buyer_8,Antonio,,1979-04-04,ES75209555999983843558,TRX_N-00445-09884382,2023-01-28T12:00:29,Arrasate,expenses,leisure,-29.96,-5400.32
buyer_8,Antonio,,1979-04-04,ES75209555999983843558,TRX_N-00446-05149969,2023-01-29T17:47:14,Labastida,expenses,cash,-100.0,-5500.32
buyer_8,Antonio,,1979-04-04,ES75209555999983843558,TRX_N-00447-22621447,2023-01-30T14:19:01,Erandio,expenses,food,-113.18,-5613.5
buyer_8,Antonio,,1979-04-04,ES75209555999983843558,TRX_N-00448-45166397,2023-02-01T05:10:14,Labastida,incomes,salary,3834.17,-1779.33
buyer_8,Antonio,,1979-04-04,ES75209555999983843558,TRX_N-00449-34926564,2023-02-01T05:10:14,Labastida,incomes,extra_income,614.38,-1164.95
buyer_8,Antonio,,1979-04-04,ES75209555999983843558,TRX_N-00450-02907816,2023-02-01T08:00:28,Labastida,expenses,food,-70.1,-1235.05
buyer_8,Antonio,,1979-04-04,ES75209555999983843558,TRX_N-00451-23824240,2023-02-01T12:54:48,Barakaldo,expenses,cash,-100.0,-1335.05
buyer_8,Antonio,,1979-04-04,ES75209555999983843558,TRX_N-00452-36873216,2023-02-02T18:20:45,Labastida,expenses,clothing,-96.99,-1432.04
buyer_8,Antonio,,1979-04-04,ES75209555999983843558,TRX_N-00453-70865909,2023-02-03T01:13:08,Labastida,expenses,gifts,-31.78,-1463.82
buyer_8,Antonio,,1979-04-04,ES75209555999983843558,TRX_N-00454-40431461,2023-02-04T19:34:22,Labastida,expenses,mortgage,-775.96,-2239.78
buyer_8,Antonio,,1979-04-04,ES75209555999983843558,TRX_N-00455-53551571,2023-02-05T08:05:41,Labastida,expenses,water,-39.71,-2279.49
buyer_8,Antonio,,1979-04-04,ES75209555999983843558,TRX_N-00456-69879623,2023-02-05T11:35:15,Labastida,expenses,internet,-42.0,-2321.49
buyer_8,Antonio,,1979-04-04,ES75209555999983843558,TRX_N-00457-04428168,2023-02-05T13:41:28,Labastida,expenses,food,-82.52,-2404.01
buyer_8,Antonio,,1979-04-04,ES75209555999983843558,TRX_N-00458-91321824,2023-02-05T16:41:28,Labastida,expenses,repairs,-242.01,-2646.02
buyer_8,Antonio,,1979-04-04,ES75209555999983843558,TRX_N-00459-27108499,2023-02-06T16:51:01,Labastida,expenses,gas,-51.94,-2697.96
buyer_8,Antonio,,1979-04-04,ES75209555999983843558,TRX_N-00460-81909236,2023-02-07T10:04:08,Labastida,expenses,food,-72.42,-2770.38
buyer_8,Antonio,,1979-04-04,ES75209555999983843558,TRX_N-00461-89241072,2023-02-07T17:56:36,Labastida,expenses,appliances,-164.94,-2935.32
buyer_8,Antonio,,1979-04-04,ES75209555999983843558,TRX_N-00462-48048679,2023-02-08T18:32:41,Labastida,expenses,electricity,-66.12,-3001.44
buyer_8,Antonio,,1979-04-04,ES75209555999983843558,TRX_N-00463-45659304,2023-02-08T13:10:32,Labastida,expenses,phone,-34.2,-3035.64
buyer_8,Antonio,,1979-04-04,ES75209555999983843558,TRX_N-00464-95229107,2023-02-08T09:54:16,Iru√±a de Oca,expenses,appliances,-189.87,-3225.51
buyer_8,Antonio,,1979-04-04,ES75209555999983843558,TRX_N-00465-59804605,2023-02-09T22:28:27,Labastida,expenses,cash,-100.0,-3325.51
buyer_8,Antonio,,1979-04-04,ES75209555999983843558,TRX_N-00466-03526227,2023-02-10T14:30:45,Labastida,expenses,cash,-100.0,-3425.51
buyer_8,Antonio,,1979-04-04,ES75209555999983843558,TRX_N-00467-97031653,2023-02-11T09:24:02,Labastida,expenses,cash,-100.0,-3525.51
buyer_8,Antonio,,1979-04-04,ES75209555999983843558,TRX_N-00468-38524720,2023-02-12T00:08:14,Labastida,expenses,transport,-72.29,-3597.8
buyer_8,Antonio,,1979-04-04,ES75209555999983843558,TRX_N-00469-87824887,2023-02-13T04:35:56,Labastida,expenses,education,-70.29,-3668.09
buyer_8,Antonio,,1979-04-04,ES75209555999983843558,TRX_N-00470-62817566,2023-02-14T09:12:08,Zuia,expenses,food,-119.5,-3787.59
buyer_8,Antonio,,1979-04-04,ES75209555999983843558,TRX_N-00471-32163607,2023-02-14T13:55:16,Labastida,expenses,cash,-100.0,-3887.59
buyer_8,Antonio,,1979-04-04,ES75209555999983843558,TRX_N-00472-28177030,2023-02-15T18:45:46,Labastida,expenses,food,-82.94,-3970.53
buyer_8,Antonio,,1979-04-04,ES75209555999983843558,TRX_N-00473-53138628,2023-02-18T04:08:19,Vitoria-Gasteiz,expenses,food,-79.97,-4050.5
buyer_8,Antonio,,1979-04-04,ES75209555999983843558,TRX_N-00474-41363477,2023-02-19T08:00:38,Labastida,expenses,clothing,-67.94,-4118.44
buyer_8,Antonio,,1979-04-04,ES75209555999983843558,TRX_N-00475-17705604,2023-02-19T18:54:29,Labastida,expenses,gifts,-53.94,-4172.38
buyer_8,Antonio,,1979-04-04,ES75209555999983843558,TRX_N-00476-84222083,2023-02-21T16:05:15,Labastida,expenses,transport,-45.2,-4217.58
buyer_8,Antonio,,1979-04-04,ES75209555999983843558,TRX_N-00477-26519687,2023-02-22T19:35:24,Labastida,expenses,transport,-82.8,-4300.38
buyer_8,Antonio,,1979-04-04,ES75209555999983843558,TRX_N-00478-85487526,2023-02-23T11:52:02,Labastida,expenses,transport,-49.79,-4350.17
buyer_8,Antonio,,1979-04-04,ES75209555999983843558,TRX_N-00479-84976715,2023-02-24T09:24:26,Labastida,expenses,transport,-51.65,-4401.82
buyer_8,Antonio,,1979-04-04,ES75209555999983843558,TRX_N-00480-15666448,2023-02-25T23:57:37,Hondarribia,expenses,cash,-100.0,-4501.82
buyer_8,Antonio,,1979-04-04,ES75209555999983843558,TRX_N-00481-36356162,2023-02-26T09:14:55,Labastida,expenses,leisure,-36.05,-4537.87
buyer_8,Antonio,,1979-04-04,ES75209555999983843558,TRX_N-00482-38864203,2023-02-26T13:57:31,Labastida,expenses,education,-43.79,-4581.66
buyer_8,Antonio,,1979-04-04,ES75209555999983843558,TRX_N-00483-92036841,2023-03-01T13:49:40,Labastida,incomes,salary,3834.17,-747.49
buyer_8,Antonio,,1979-04-04,ES75209555999983843558,TRX_N-00484-79375526,2023-03-02T16:41:01,Basauri,expenses,leisure,-74.02,-821.51
buyer_8,Antonio,,1979-04-04,ES75209555999983843558,TRX_N-00485-83684893,2023-03-04T11:31:29,Labastida,expenses,mortgage,-775.96,-1597.47
buyer_8,Antonio,,1979-04-04,ES75209555999983843558,TRX_N-00486-11923238,2023-03-05T16:00:15,Labastida,expenses,electricity,-76.44,-1673.91
buyer_8,Antonio,,1979-04-04,ES75209555999983843558,TRX_N-00487-15765357,2023-03-05T16:05:33,Labastida,expenses,clothing,-156.68,-1830.59
buyer_8,Antonio,,1979-04-04,ES75209555999983843558,TRX_N-00488-74512114,2023-03-06T06:12:33,Labastida,expenses,water,-36.82,-1867.41
buyer_8,Antonio,,1979-04-04,ES75209555999983843558,TRX_N-00489-24580655,2023-03-06T08:52:30,Labastida,expenses,internet,-42.0,-1909.41
buyer_8,Antonio,,1979-04-04,ES75209555999983843558,TRX_N-00490-85696260,2023-03-06T01:20:24,Labastida,expenses,repairs,-285.0,-2194.41
buyer_8,Antonio,,1979-04-04,ES75209555999983843558,TRX_N-00491-37659256,2023-03-07T16:29:56,Labastida,expenses,phone,-32.36,-2226.77
buyer_8,Antonio,,1979-04-04,ES75209555999983843558,TRX_N-00492-87597326,2023-03-07T20:15:06,Lasarte-Oria,expenses,leisure,-40.91,-2267.68
buyer_8,Antonio,,1979-04-04,ES75209555999983843558,TRX_N-00493-04560860,2023-03-08T05:47:44,Labastida,expenses,gas,-103.38,-2371.06
buyer_8,Antonio,,1979-04-04,ES75209555999983843558,TRX_N-00494-86574080,2023-03-08T18:48:40,Labastida,expenses,transport,-43.71,-2414.77
buyer_8,Antonio,,1979-04-04,ES75209555999983843558,TRX_N-00495-75073319,2023-03-08T13:48:08,Labastida,expenses,appliances,-250.88,-2665.65
buyer_8,Antonio,,1979-04-04,ES75209555999983843558,TRX_N-00496-70576572,2023-03-09T23:11:30,Labastida,expenses,food,-100.49,-2766.14
buyer_8,Antonio,,1979-04-04,ES75209555999983843558,TRX_N-00497-98888889,2023-03-09T08:30:53,Labastida,expenses,transport,-52.24,-2818.38
buyer_8,Antonio,,1979-04-04,ES75209555999983843558,TRX_N-00498-37116393,2023-03-12T18:35:24,Labastida,expenses,food,-98.93,-2917.31
buyer_8,Antonio,,1979-04-04,ES75209555999983843558,TRX_N-00499-86080834,2023-03-13T12:09:40,Labastida,expenses,food,-105.85,-3023.16
buyer_8,Antonio,,1979-04-04,ES75209555999983843558,TRX_N-00500-97960973,2023-03-14T20:49:31,Barakaldo,expenses,cash,-100.0,-3123.16
buyer_8,Antonio,,1979-04-04,ES75209555999983843558,TRX_N-00501-21493081,2023-03-15T16:04:05,Labastida,expenses,transport,-62.9,-3186.06
buyer_8,Antonio,,1979-04-04,ES75209555999983843558,TRX_N-00502-64914111,2023-03-16T23:42:01,Labastida,expenses,food,-113.23,-3299.29
buyer_8,Antonio,,1979-04-04,ES75209555999983843558,TRX_N-00503-48065889,2023-03-16T14:25:44,Labastida,expenses,transport,-66.41,-3365.7
buyer_8,Antonio,,1979-04-04,ES75209555999983843558,TRX_N-00504-45005374,2023-03-17T19:01:39,Labastida,expenses,food,-81.26,-3446.96
buyer_8,Antonio,,1979-04-04,ES75209555999983843558,TRX_N-00505-43949841,2023-03-17T20:52:24,Labastida,expenses,education,-42.07,-3489.03
buyer_8,Antonio,,1979-04-04,ES75209555999983843558,TRX_N-00506-68491490,2023-03-22T08:14:49,Labastida,expenses,education,-59.73,-3548.76
buyer_8,Antonio,,1979-04-04,ES75209555999983843558,TRX_N-00507-86513630,2023-03-23T11:13:41,Labastida,expenses,cash,-100.0,-3648.76
buyer_8,Antonio,,1979-04-04,ES75209555999983843558,TRX_N-00508-91508452,2023-03-25T15:06:37,Labastida,expenses,leisure,-82.16,-3730.92
buyer_8,Antonio,,1979-04-04,ES75209555999983843558,TRX_N-00509-42834118,2023-03-27T10:08:55,Labastida,expenses,cash,-100.0,-3830.92
buyer_8,Antonio,,1979-04-04,ES75209555999983843558,TRX_N-00510-59146778,2023-03-29T05:48:12,Amurrio,expenses,leisure,-73.92,-3904.84
buyer_8,Antonio,,1979-04-04,ES75209555999983843558,TRX_N-00511-12581775,2023-03-31T16:54:31,Labastida,expenses,transport,-67.73,-3972.57
buyer_8,Antonio,,1979-04-04,ES75209555999983843558,TRX_N-00512-42899364,2023-04-01T09:25:43,Labastida,incomes,salary,3834.17,-138.4
buyer_8,Antonio,,1979-04-04,ES75209555999983843558,TRX_N-00513-84376739,2023-04-04T11:58:50,Labastida,expenses,mortgage,-775.96,-914.36
buyer_8,Antonio,,1979-04-04,ES75209555999983843558,TRX_N-00514-65180280,2023-04-04T20:34:44,Labastida,expenses,transport,-86.97,-1001.33
buyer_8,Antonio,,1979-04-04,ES75209555999983843558,TRX_N-00515-80684118,2023-04-05T15:12:48,Labastida,expenses,water,-38.1,-1039.43
buyer_8,Antonio,,1979-04-04,ES75209555999983843558,TRX_N-00516-10762567,2023-04-05T09:49:39,Labastida,expenses,phone,-35.47,-1074.9
buyer_8,Antonio,,1979-04-04,ES75209555999983843558,TRX_N-00517-71048980,2023-04-06T10:24:19,Labastida,expenses,gas,-54.77,-1129.67
buyer_8,Antonio,,1979-04-04,ES75209555999983843558,TRX_N-00518-92682880,2023-04-06T05:31:05,Labastida,expenses,education,-76.18,-1205.85
buyer_8,Antonio,,1979-04-04,ES75209555999983843558,TRX_N-00519-13612886,2023-04-06T08:07:43,Labastida,expenses,cash,-100.0,-1305.85
buyer_8,Antonio,,1979-04-04,ES75209555999983843558,TRX_N-00520-55857251,2023-04-07T09:24:20,Labastida,expenses,electricity,-46.24,-1352.09
buyer_8,Antonio,,1979-04-04,ES75209555999983843558,TRX_N-00521-85376569,2023-04-08T16:20:24,Labastida,expenses,internet,-42.0,-1394.09
buyer_8,Antonio,,1979-04-04,ES75209555999983843558,TRX_N-00522-99371472,2023-04-08T17:27:25,Labastida,expenses,cash,-100.0,-1494.09
buyer_8,Antonio,,1979-04-04,ES75209555999983843558,TRX_N-00523-07417021,2023-04-08T21:07:27,Iru√±a de Oca,expenses,repairs,-213.73,-1707.82
buyer_8,Antonio,,1979-04-04,ES75209555999983843558,TRX_N-00524-25879939,2023-04-09T18:42:59,Labastida,expenses,cash,-100.0,-1807.82
buyer_8,Antonio,,1979-04-04,ES75209555999983843558,TRX_N-00525-36918607,2023-04-10T22:45:43,Labastida,expenses,gifts,-481.83,-2289.65
buyer_8,Antonio,,1979-04-04,ES75209555999983843558,TRX_N-00526-34832436,2023-04-11T20:02:17,Labastida,expenses,food,-66.81,-2356.46
buyer_8,Antonio,,1979-04-04,ES75209555999983843558,TRX_N-00527-95501391,2023-04-11T12:50:55,Labastida,expenses,leisure,-41.69,-2398.15
buyer_8,Antonio,,1979-04-04,ES75209555999983843558,TRX_N-00528-60690482,2023-04-11T14:19:45,Labastida,expenses,cash,-100.0,-2498.15
buyer_8,Antonio,,1979-04-04,ES75209555999983843558,TRX_N-00529-60075284,2023-04-12T07:12:00,Iru√±a de Oca,expenses,food,-88.58,-2586.73
buyer_8,Antonio,,1979-04-04,ES75209555999983843558,TRX_N-00530-43200015,2023-04-13T19:30:04,Labastida,expenses,cash,-100.0,-2686.73
buyer_8,Antonio,,1979-04-04,ES75209555999983843558,TRX_N-00531-96838341,2023-04-13T13:23:29,Bilbao,expenses,gifts,-388.63,-3075.36
buyer_8,Antonio,,1979-04-04,ES75209555999983843558,TRX_N-00532-81517051,2023-04-14T13:37:18,Santurtzi,expenses,transport,-73.2,-3148.56
buyer_8,Antonio,,1979-04-04,ES75209555999983843558,TRX_N-00533-43342475,2023-04-14T13:51:08,Labastida,expenses,repairs,-313.11,-3461.67
buyer_8,Antonio,,1979-04-04,ES75209555999983843558,TRX_N-00534-80570408,2023-04-19T20:54:08,Labastida,expenses,healthcare,-51.74,-3513.41
buyer_8,Antonio,,1979-04-04,ES75209555999983843558,TRX_N-00535-21758440,2023-04-19T08:22:53,Labastida,expenses,cash,-100.0,-3613.41
buyer_8,Antonio,,1979-04-04,ES75209555999983843558,TRX_N-00536-42145945,2023-04-21T20:43:38,Labastida,expenses,leisure,-55.53,-3668.94
buyer_8,Antonio,,1979-04-04,ES75209555999983843558,TRX_N-00537-77834923,2023-04-21T08:40:14,Hernani,expenses,healthcare,-39.28,-3708.22
buyer_8,Antonio,,1979-04-04,ES75209555999983843558,TRX_N-00538-70229241,2023-04-23T17:32:12,Hernani,expenses,food,-66.79,-3775.01
buyer_8,Antonio,,1979-04-04,ES75209555999983843558,TRX_N-00539-65841779,2023-04-25T11:41:12,Labastida,expenses,food,-82.5,-3857.51
buyer_8,Antonio,,1979-04-04,ES75209555999983843558,TRX_N-00540-95711887,2023-04-26T04:44:07,Labastida,expenses,cash,-100.0,-3957.51
buyer_8,Antonio,,1979-04-04,ES75209555999983843558,TRX_N-00541-27079615,2023-04-26T09:44:50,Labastida,expenses,car,-203.31,-4160.82
buyer_8,Antonio,,1979-04-04,ES75209555999983843558,TRX_N-00542-82035464,2023-05-01T17:28:07,Labastida,incomes,salary,3834.17,-326.65
buyer_8,Antonio,,1979-04-04,ES75209555999983843558,TRX_N-00543-52624012,2023-05-01T17:28:07,Labastida,incomes,extra_income,614.38,287.73
buyer_8,Antonio,,1979-04-04,ES75209555999983843558,TRX_N-00544-11580203,2023-05-01T16:12:39,Labastida,expenses,transport,-87.33,200.4
buyer_8,Antonio,,1979-04-04,ES75209555999983843558,TRX_N-00545-86894099,2023-05-04T18:41:03,Labastida,expenses,mortgage,-775.96,-575.56
buyer_8,Antonio,,1979-04-04,ES75209555999983843558,TRX_N-00546-14396022,2023-05-05T21:18:29,Labastida,expenses,phone,-32.9,-608.46
buyer_8,Antonio,,1979-04-04,ES75209555999983843558,TRX_N-00547-26477446,2023-05-06T13:34:43,Labastida,expenses,gas,-40.61,-649.07
buyer_8,Antonio,,1979-04-04,ES75209555999983843558,TRX_N-00548-49128821,2023-05-06T19:06:30,Labastida,expenses,internet,-42.0,-691.07
buyer_8,Antonio,,1979-04-04,ES75209555999983843558,TRX_N-00549-10116257,2023-05-06T09:37:35,Labastida,expenses,food,-86.92,-777.99
buyer_8,Antonio,,1979-04-04,ES75209555999983843558,TRX_N-00550-68807687,2023-05-06T16:22:51,Labastida,expenses,leisure,-72.08,-850.07
buyer_8,Antonio,,1979-04-04,ES75209555999983843558,TRX_N-00551-93431015,2023-05-07T08:56:36,Labastida,expenses,electricity,-69.17,-919.24
buyer_8,Antonio,,1979-04-04,ES75209555999983843558,TRX_N-00552-88719909,2023-05-08T11:14:24,Labastida,expenses,water,-21.39,-940.63
buyer_8,Antonio,,1979-04-04,ES75209555999983843558,TRX_N-00553-16836664,2023-05-08T17:53:38,Labastida,expenses,food,-119.74,-1060.37
buyer_8,Antonio,,1979-04-04,ES75209555999983843558,TRX_N-00554-20065817,2023-05-08T17:56:01,Labastida,expenses,cash,-100.0,-1160.37
buyer_8,Antonio,,1979-04-04,ES75209555999983843558,TRX_N-00555-15488967,2023-05-09T00:01:01,Labastida,expenses,repairs,-326.62,-1486.99
buyer_8,Antonio,,1979-04-04,ES75209555999983843558,TRX_N-00556-55818963,2023-05-11T20:59:19,Labastida,expenses,food,-107.27,-1594.26
buyer_8,Antonio,,1979-04-04,ES75209555999983843558,TRX_N-00557-86664660,2023-05-11T11:49:38,Labastida,expenses,cash,-100.0,-1694.26
buyer_8,Antonio,,1979-04-04,ES75209555999983843558,TRX_N-00558-21836279,2023-05-13T10:36:48,Labastida,expenses,cash,-100.0,-1794.26
buyer_8,Antonio,,1979-04-04,ES75209555999983843558,TRX_N-00559-04763327,2023-05-17T12:33:41,Sestao,expenses,transport,-77.41,-1871.67
buyer_8,Antonio,,1979-04-04,ES75209555999983843558,TRX_N-00560-18423906,2023-05-17T18:45:55,Sopela,expenses,leisure,-18.98,-1890.65
buyer_8,Antonio,,1979-04-04,ES75209555999983843558,TRX_N-00561-08216555,2023-05-18T19:10:29,Labastida,expenses,cash,-100.0,-1990.65
buyer_8,Antonio,,1979-04-04,ES75209555999983843558,TRX_N-00562-32859479,2023-05-22T22:17:59,Labastida,expenses,leisure,-52.26,-2042.91
buyer_8,Antonio,,1979-04-04,ES75209555999983843558,TRX_N-00563-60658735,2023-05-22T11:32:22,Zarautz,expenses,gifts,-244.24,-2287.15
buyer_8,Antonio,,1979-04-04,ES75209555999983843558,TRX_N-00564-35506727,2023-05-23T18:31:42,Labastida,expenses,leisure,-49.7,-2336.85
buyer_8,Antonio,,1979-04-04,ES75209555999983843558,TRX_N-00565-60532819,2023-05-24T01:55:37,Basauri,expenses,cash,-100.0,-2436.85
buyer_8,Antonio,,1979-04-04,ES75209555999983843558,TRX_N-00566-61329606,2023-05-24T15:21:46,Oy√≥n-Oion,expenses,gifts,-83.86,-2520.71
buyer_8,Antonio,,1979-04-04,ES75209555999983843558,TRX_N-00567-31298854,2023-05-25T12:59:18,Iru√±a de Oca,expenses,transport,-44.46,-2565.17
buyer_8,Antonio,,1979-04-04,ES75209555999983843558,TRX_N-00568-26409512,2023-05-27T19:29:45,Labastida,expenses,healthcare,-107.19,-2672.36
buyer_8,Antonio,,1979-04-04,ES75209555999983843558,TRX_N-00569-30235389,2023-05-29T10:31:48,Donostia,expenses,food,-103.11,-2775.47
buyer_8,Antonio,,1979-04-04,ES75209555999983843558,TRX_N-00570-88877219,2023-05-29T12:05:44,Labastida,expenses,clothing,-80.18,-2855.65
buyer_8,Antonio,,1979-04-04,ES75209555999983843558,TRX_N-00571-61513167,2023-05-29T15:11:40,Labastida,expenses,education,-54.26,-2909.91
buyer_8,Antonio,,1979-04-04,ES75209555999983843558,TRX_N-00572-56953183,2023-05-30T08:50:28,Labastida,expenses,leisure,-55.34,-2965.25
buyer_8,Antonio,,1979-04-04,ES75209555999983843558,TRX_N-00573-96211327,2023-05-31T13:53:19,Labastida,expenses,food,-91.65,-3056.9
buyer_8,Antonio,,1979-04-04,ES75209555999983843558,TRX_N-00574-58029312,2023-06-01T16:21:35,Labastida,incomes,salary,3834.17,777.27
buyer_8,Antonio,,1979-04-04,ES75209555999983843558,TRX_N-00575-47530670,2023-06-01T16:21:35,Labastida,incomes,salary_bonus,2736.45,3513.72
buyer_8,Antonio,,1979-04-04,ES75209555999983843558,TRX_N-00576-47677361,2023-06-01T16:03:34,Donostia,expenses,education,-60.21,3453.51
buyer_8,Antonio,,1979-04-04,ES75209555999983843558,TRX_N-00577-85257279,2023-06-01T17:31:19,Labastida,expenses,appliances,-337.14,3116.37
buyer_8,Antonio,,1979-04-04,ES75209555999983843558,TRX_N-00578-08749165,2023-06-02T14:54:10,Labastida,expenses,cash,-100.0,3016.37
buyer_8,Antonio,,1979-04-04,ES75209555999983843558,TRX_N-00579-72798003,2023-06-03T15:33:52,Labastida,expenses,food,-74.82,2941.55
buyer_8,Antonio,,1979-04-04,ES75209555999983843558,TRX_N-00580-13586500,2023-06-03T09:48:37,Labastida,expenses,cash,-100.0,2841.55
buyer_8,Antonio,,1979-04-04,ES75209555999983843558,TRX_N-00581-85321871,2023-06-04T09:27:30,Labastida,expenses,mortgage,-775.96,2065.59
buyer_8,Antonio,,1979-04-04,ES75209555999983843558,TRX_N-00582-82170394,2023-06-04T08:29:23,Labastida,expenses,food,-95.03,1970.56
buyer_8,Antonio,,1979-04-04,ES75209555999983843558,TRX_N-00583-59139507,2023-06-05T10:12:36,Labastida,expenses,internet,-42.0,1928.56
buyer_8,Antonio,,1979-04-04,ES75209555999983843558,TRX_N-00584-57484377,2023-06-06T15:36:25,Labastida,expenses,gas,-43.05,1885.51
buyer_8,Antonio,,1979-04-04,ES75209555999983843558,TRX_N-00585-85231770,2023-06-06T10:18:52,Labastida,expenses,phone,-37.48,1848.03
buyer_8,Antonio,,1979-04-04,ES75209555999983843558,TRX_N-00586-27503177,2023-06-06T08:10:06,Labastida,expenses,food,-78.13,1769.9
buyer_8,Antonio,,1979-04-04,ES75209555999983843558,TRX_N-00587-30896203,2023-06-06T18:42:53,Labastida,expenses,transport,-47.46,1722.44
buyer_8,Antonio,,1979-04-04,ES75209555999983843558,TRX_N-00588-59232384,2023-06-06T01:33:06,Getxo,expenses,leisure,-73.97,1648.47
buyer_8,Antonio,,1979-04-04,ES75209555999983843558,TRX_N-00589-83207623,2023-06-08T15:42:35,Labastida,expenses,water,-38.19,1610.28
buyer_8,Antonio,,1979-04-04,ES75209555999983843558,TRX_N-00590-14470928,2023-06-08T15:59:58,Labastida,expenses,electricity,-71.08,1539.2
buyer_8,Antonio,,1979-04-04,ES75209555999983843558,TRX_N-00591-11126678,2023-06-09T14:05:40,Labastida,expenses,travel,-1874.24,-335.04
buyer_8,Antonio,,1979-04-04,ES75209555999983843558,TRX_N-00592-55921937,2023-06-12T20:47:51,Labastida,expenses,repairs,-158.34,-493.38
buyer_8,Antonio,,1979-04-04,ES75209555999983843558,TRX_N-00593-71463666,2023-06-12T15:52:58,Getxo,expenses,gifts,-809.77,-1303.15
buyer_8,Antonio,,1979-04-04,ES75209555999983843558,TRX_N-00594-73260666,2023-06-13T17:24:11,Labastida,expenses,food,-112.85,-1416.0
buyer_8,Antonio,,1979-04-04,ES75209555999983843558,TRX_N-00595-20276752,2023-06-14T13:25:47,Labastida,expenses,food,-99.94,-1515.94
buyer_8,Antonio,,1979-04-04,ES75209555999983843558,TRX_N-00596-74259271,2023-06-14T16:27:14,Labastida,expenses,cash,-100.0,-1615.94
buyer_8,Antonio,,1979-04-04,ES75209555999983843558,TRX_N-00597-45948231,2023-06-17T09:08:23,Labastida,expenses,food,-107.73,-1723.67
buyer_8,Antonio,,1979-04-04,ES75209555999983843558,TRX_N-00598-15275670,2023-06-17T09:48:32,Labastida,expenses,appliances,-256.65,-1980.32
buyer_8,Antonio,,1979-04-04,ES75209555999983843558,TRX_N-00599-65890314,2023-06-22T14:23:34,Labastida,expenses,food,-85.92,-2066.24
buyer_8,Antonio,,1979-04-04,ES75209555999983843558,TRX_N-00600-83583119,2023-06-23T16:05:50,Labastida,expenses,leisure,-74.3,-2140.54
buyer_8,Antonio,,1979-04-04,ES75209555999983843558,TRX_N-00601-92915358,2023-06-24T10:00:03,Labastida,expenses,education,-55.06,-2195.6
buyer_8,Antonio,,1979-04-04,ES75209555999983843558,TRX_N-00602-84603967,2023-06-25T20:12:28,Labastida,expenses,cash,-100.0,-2295.6
buyer_8,Antonio,,1979-04-04,ES75209555999983843558,TRX_N-00603-89097403,2023-06-29T16:43:29,Labastida,expenses,food,-81.05,-2376.65
buyer_8,Antonio,,1979-04-04,ES75209555999983843558,TRX_N-00604-83880255,2023-06-29T08:41:59,Durango,expenses,cash,-100.0,-2476.65
buyer_8,Antonio,,1979-04-04,ES75209555999983843558,TRX_N-00605-51494660,2023-06-29T23:38:28,Labastida,expenses,repairs,-282.18,-2758.83
buyer_8,Antonio,,1979-04-04,ES75209555999983843558,TRX_N-00606-76003124,2023-06-30T11:53:01,Labastida,expenses,leisure,-66.69,-2825.52
buyer_8,Antonio,,1979-04-04,ES75209555999983843558,TRX_N-00607-37362673,2023-07-01T15:49:07,Labastida,incomes,salary,3834.17,1008.65
buyer_8,Antonio,,1979-04-04,ES75209555999983843558,TRX_N-00608-40936187,2023-07-03T13:36:12,Labastida,expenses,cash,-100.0,908.65
buyer_8,Antonio,,1979-04-04,ES75209555999983843558,TRX_N-00609-78483826,2023-07-04T12:55:43,Labastida,expenses,mortgage,-775.96,132.69
buyer_8,Antonio,,1979-04-04,ES75209555999983843558,TRX_N-00610-69537680,2023-07-04T16:12:55,Labastida,expenses,education,-44.08,88.61
buyer_8,Antonio,,1979-04-04,ES75209555999983843558,TRX_N-00611-23363639,2023-07-05T19:05:56,Labastida,expenses,education,-63.31,25.3
buyer_8,Antonio,,1979-04-04,ES75209555999983843558,TRX_N-00612-87388671,2023-07-06T10:39:58,Labastida,expenses,gas,-86.3,-61.0
buyer_8,Antonio,,1979-04-04,ES75209555999983843558,TRX_N-00613-08653337,2023-07-06T18:56:42,Labastida,expenses,food,-92.94,-153.94
buyer_8,Antonio,,1979-04-04,ES75209555999983843558,TRX_N-00614-29420113,2023-07-07T22:53:49,Labastida,expenses,electricity,-88.02,-241.96
buyer_8,Antonio,,1979-04-04,ES75209555999983843558,TRX_N-00615-63481143,2023-07-07T20:38:33,Labastida,expenses,internet,-42.0,-283.96
buyer_8,Antonio,,1979-04-04,ES75209555999983843558,TRX_N-00616-58679420,2023-07-08T20:12:29,Labastida,expenses,phone,-36.24,-320.2
buyer_8,Antonio,,1979-04-04,ES75209555999983843558,TRX_N-00617-09260838,2023-07-08T20:59:56,Labastida,expenses,water,-31.35,-351.55
buyer_8,Antonio,,1979-04-04,ES75209555999983843558,TRX_N-00618-63271312,2023-07-10T23:10:00,Labastida,expenses,food,-93.46,-445.01
buyer_8,Antonio,,1979-04-04,ES75209555999983843558,TRX_N-00619-43207591,2023-07-10T19:44:19,Eibar,expenses,cash,-100.0,-545.01
buyer_8,Antonio,,1979-04-04,ES75209555999983843558,TRX_N-00620-18604183,2023-07-11T13:16:03,Labastida,expenses,transport,-52.36,-597.37
buyer_8,Antonio,,1979-04-04,ES75209555999983843558,TRX_N-00621-19001209,2023-07-13T16:22:54,Labastida,expenses,leisure,-31.06,-628.43
buyer_8,Antonio,,1979-04-04,ES75209555999983843558,TRX_N-00622-90975929,2023-07-16T09:17:57,Labastida,expenses,leisure,-56.62,-685.05
buyer_8,Antonio,,1979-04-04,ES75209555999983843558,TRX_N-00623-07453571,2023-07-16T20:24:12,Barakaldo,expenses,cash,-100.0,-785.05
buyer_8,Antonio,,1979-04-04,ES75209555999983843558,TRX_N-00624-56031259,2023-07-17T20:04:54,Labastida,expenses,transport,-61.77,-846.82
buyer_8,Antonio,,1979-04-04,ES75209555999983843558,TRX_N-00625-64100729,2023-07-18T20:33:53,Labastida,expenses,repairs,-136.82,-983.64
buyer_8,Antonio,,1979-04-04,ES75209555999983843558,TRX_N-00626-69904852,2023-07-21T16:53:21,Labastida,expenses,food,-120.7,-1104.34
buyer_8,Antonio,,1979-04-04,ES75209555999983843558,TRX_N-00627-98679515,2023-07-21T08:34:43,Labastida,expenses,leisure,-27.21,-1131.55
buyer_8,Antonio,,1979-04-04,ES75209555999983843558,TRX_N-00628-73003926,2023-07-22T08:07:21,Labastida,expenses,repairs,-29.68,-1161.23
buyer_8,Antonio,,1979-04-04,ES75209555999983843558,TRX_N-00629-31633221,2023-07-23T19:38:09,Labastida,expenses,cash,-100.0,-1261.23
buyer_8,Antonio,,1979-04-04,ES75209555999983843558,TRX_N-00630-52058046,2023-07-23T13:02:05,Labastida,expenses,gifts,-624.91,-1886.14
buyer_8,Antonio,,1979-04-04,ES75209555999983843558,TRX_N-00631-93348564,2023-07-24T06:20:39,Labastida,expenses,clothing,-101.3,-1987.44
buyer_8,Antonio,,1979-04-04,ES75209555999983843558,TRX_N-00632-86156524,2023-07-26T11:08:43,Labastida,expenses,food,-63.5,-2050.94
buyer_8,Antonio,,1979-04-04,ES75209555999983843558,TRX_N-00633-61829941,2023-07-26T17:28:52,Labastida,expenses,gifts,-585.5,-2636.44
buyer_8,Antonio,,1979-04-04,ES75209555999983843558,TRX_N-00634-19905872,2023-07-27T20:45:32,Labastida,expenses,transport,-64.16,-2700.6
buyer_8,Antonio,,1979-04-04,ES75209555999983843558,TRX_N-00635-54735289,2023-07-28T05:23:40,Labastida,expenses,food,-79.22,-2779.82
buyer_8,Antonio,,1979-04-04,ES75209555999983843558,TRX_N-00636-18032886,2023-07-29T07:19:30,Labastida,expenses,food,-77.19,-2857.01
buyer_8,Antonio,,1979-04-04,ES75209555999983843558,TRX_N-00637-86958648,2023-07-29T08:57:54,Labastida,expenses,appliances,-139.9,-2996.91
buyer_8,Antonio,,1979-04-04,ES75209555999983843558,TRX_N-00638-64248338,2023-07-31T18:56:19,Erandio,expenses,leisure,-26.11,-3023.02
buyer_8,Antonio,,1979-04-04,ES75209555999983843558,TRX_N-00639-00978437,2023-08-01T11:09:28,Labastida,incomes,salary,3834.17,811.15
buyer_8,Antonio,,1979-04-04,ES75209555999983843558,TRX_N-00640-02880289,2023-08-01T11:09:28,Labastida,incomes,extra_income,614.38,1425.53
buyer_8,Antonio,,1979-04-04,ES75209555999983843558,TRX_N-00641-81829760,2023-08-01T03:47:11,Labastida,expenses,food,-62.76,1362.77
buyer_8,Antonio,,1979-04-04,ES75209555999983843558,TRX_N-00642-27972320,2023-08-01T09:04:48,Labastida,expenses,clothing,-98.16,1264.61
buyer_8,Antonio,,1979-04-04,ES75209555999983843558,TRX_N-00643-76722644,2023-08-01T18:33:08,Andoain,expenses,education,-42.16,1222.45
buyer_8,Antonio,,1979-04-04,ES75209555999983843558,TRX_N-00644-67911680,2023-08-02T18:39:25,Labastida,expenses,clothing,-115.68,1106.77
buyer_8,Antonio,,1979-04-04,ES75209555999983843558,TRX_N-00645-10677007,2023-08-03T12:21:14,Labastida,expenses,food,-108.91,997.86
buyer_8,Antonio,,1979-04-04,ES75209555999983843558,TRX_N-00646-50632962,2023-08-04T12:18:44,Labastida,expenses,mortgage,-775.96,221.9
buyer_8,Antonio,,1979-04-04,ES75209555999983843558,TRX_N-00647-01234511,2023-08-05T01:15:29,Labastida,expenses,internet,-42.0,179.9
buyer_8,Antonio,,1979-04-04,ES75209555999983843558,TRX_N-00648-84523526,2023-08-05T19:52:07,Labastida,expenses,leisure,-54.49,125.41
buyer_8,Antonio,,1979-04-04,ES75209555999983843558,TRX_N-00649-60335072,2023-08-05T12:24:35,Labastida,expenses,cash,-100.0,25.41
buyer_8,Antonio,,1979-04-04,ES75209555999983843558,TRX_N-00650-29705108,2023-08-05T19:36:41,Sopela,expenses,appliances,-407.62,-382.21
buyer_8,Antonio,,1979-04-04,ES75209555999983843558,TRX_N-00651-01374562,2023-08-06T10:13:18,Labastida,expenses,phone,-41.2,-423.41
buyer_8,Antonio,,1979-04-04,ES75209555999983843558,TRX_N-00652-34860552,2023-08-07T11:56:02,Labastida,expenses,water,-20.03,-443.44
buyer_8,Antonio,,1979-04-04,ES75209555999983843558,TRX_N-00653-93125373,2023-08-08T16:51:50,Labastida,expenses,electricity,-67.93,-511.37
buyer_8,Antonio,,1979-04-04,ES75209555999983843558,TRX_N-00654-82489681,2023-08-08T18:31:21,Labastida,expenses,gas,-39.66,-551.03
buyer_8,Antonio,,1979-04-04,ES75209555999983843558,TRX_N-00655-52681023,2023-08-09T19:46:53,Labastida,expenses,cash,-100.0,-651.03
buyer_8,Antonio,,1979-04-04,ES75209555999983843558,TRX_N-00656-20024572,2023-08-09T00:34:59,Labastida,expenses,repairs,-78.81,-729.84
buyer_8,Antonio,,1979-04-04,ES75209555999983843558,TRX_N-00657-70869096,2023-08-12T21:01:02,Zuia,expenses,leisure,-75.98,-805.82
buyer_8,Antonio,,1979-04-04,ES75209555999983843558,TRX_N-00658-50842121,2023-08-14T12:34:18,Bermeo,expenses,transport,-69.59,-875.41
buyer_8,Antonio,,1979-04-04,ES75209555999983843558,TRX_N-00659-93055303,2023-08-15T12:53:10,Labastida,expenses,transport,-47.63,-923.04
buyer_8,Antonio,,1979-04-04,ES75209555999983843558,TRX_N-00660-95661830,2023-08-16T18:29:36,Labastida,expenses,food,-121.53,-1044.57
buyer_8,Antonio,,1979-04-04,ES75209555999983843558,TRX_N-00661-12301051,2023-08-16T12:35:24,Labastida,expenses,gifts,-730.64,-1775.21
buyer_8,Antonio,,1979-04-04,ES75209555999983843558,TRX_N-00662-94642930,2023-08-17T14:51:41,Labastida,expenses,cash,-100.0,-1875.21
buyer_8,Antonio,,1979-04-04,ES75209555999983843558,TRX_N-00663-71027493,2023-08-18T22:52:08,Labastida,expenses,cash,-100.0,-1975.21
buyer_8,Antonio,,1979-04-04,ES75209555999983843558,TRX_N-00664-51621365,2023-08-19T20:05:18,Labastida,expenses,transport,-41.02,-2016.23
buyer_8,Antonio,,1979-04-04,ES75209555999983843558,TRX_N-00665-54227977,2023-08-25T11:01:40,Labastida,expenses,cash,-100.0,-2116.23
buyer_8,Antonio,,1979-04-04,ES75209555999983843558,TRX_N-00666-87900036,2023-08-26T17:29:23,Labastida,expenses,cash,-100.0,-2216.23
buyer_8,Antonio,,1979-04-04,ES75209555999983843558,TRX_N-00667-47388992,2023-08-28T14:55:57,Labastida,expenses,appliances,-186.49,-2402.72
buyer_8,Antonio,,1979-04-04,ES75209555999983843558,TRX_N-00668-21027420,2023-08-29T21:02:36,Zarautz,expenses,food,-66.2,-2468.92
buyer_8,Antonio,,1979-04-04,ES75209555999983843558,TRX_N-00669-25688097,2023-08-30T09:37:23,Labastida,expenses,cash,-100.0,-2568.92
buyer_8,Antonio,,1979-04-04,ES75209555999983843558,TRX_N-00670-44499805,2023-08-31T00:01:16,Labastida,expenses,transport,-42.0,-2610.92
buyer_8,Antonio,,1979-04-04,ES75209555999983843558,TRX_N-00671-91239947,2023-08-31T15:08:28,Labastida,expenses,cash,-100.0,-2710.92
buyer_8,Antonio,,1979-04-04,ES75209555999983843558,TRX_N-00672-72569294,2023-09-01T10:04:59,Labastida,incomes,salary,3834.17,1123.25
buyer_8,Antonio,,1979-04-04,ES75209555999983843558,TRX_N-00673-45542733,2023-09-01T02:50:36,Labastida,expenses,transport,-50.33,1072.92
buyer_8,Antonio,,1979-04-04,ES75209555999983843558,TRX_N-00674-86710565,2023-09-01T03:35:27,Labastida,expenses,healthcare,-86.72,986.2
buyer_8,Antonio,,1979-04-04,ES75209555999983843558,TRX_N-00675-54529668,2023-09-03T13:34:01,Labastida,expenses,leisure,-46.42,939.78
buyer_8,Antonio,,1979-04-04,ES75209555999983843558,TRX_N-00676-27235406,2023-09-04T18:17:28,Labastida,expenses,mortgage,-775.96,163.82
buyer_8,Antonio,,1979-04-04,ES75209555999983843558,TRX_N-00677-06687719,2023-09-04T13:00:19,Labastida,expenses,food,-94.16,69.66
buyer_8,Antonio,,1979-04-04,ES75209555999983843558,TRX_N-00678-58394940,2023-09-04T08:13:11,Labastida,expenses,cash,-100.0,-30.34
buyer_8,Antonio,,1979-04-04,ES75209555999983843558,TRX_N-00679-70181501,2023-09-05T23:23:36,Labastida,expenses,phone,-37.46,-67.8
buyer_8,Antonio,,1979-04-04,ES75209555999983843558,TRX_N-00680-96787797,2023-09-06T09:39:49,Labastida,expenses,appliances,-363.07,-430.87
buyer_8,Antonio,,1979-04-04,ES75209555999983843558,TRX_N-00681-43359513,2023-09-07T11:43:33,Labastida,expenses,water,-24.48,-455.35
buyer_8,Antonio,,1979-04-04,ES75209555999983843558,TRX_N-00682-36284479,2023-09-07T11:41:27,Labastida,expenses,internet,-42.0,-497.35
buyer_8,Antonio,,1979-04-04,ES75209555999983843558,TRX_N-00683-62892184,2023-09-07T12:35:18,Labastida,expenses,education,-47.09,-544.44
buyer_8,Antonio,,1979-04-04,ES75209555999983843558,TRX_N-00684-46203794,2023-09-08T10:04:17,Labastida,expenses,electricity,-89.43,-633.87
buyer_8,Antonio,,1979-04-04,ES75209555999983843558,TRX_N-00685-62121169,2023-09-08T15:40:35,Labastida,expenses,gas,-70.35,-704.22
buyer_8,Antonio,,1979-04-04,ES75209555999983843558,TRX_N-00686-41668062,2023-09-09T02:25:59,Zuia,expenses,food,-109.77,-813.99
buyer_8,Antonio,,1979-04-04,ES75209555999983843558,TRX_N-00687-89673190,2023-09-09T18:15:39,Labastida,expenses,leisure,-60.46,-874.45
buyer_8,Antonio,,1979-04-04,ES75209555999983843558,TRX_N-00688-36548057,2023-09-09T18:16:58,Labastida,expenses,education,-45.95,-920.4
buyer_8,Antonio,,1979-04-04,ES75209555999983843558,TRX_N-00689-53730831,2023-09-09T17:16:27,Labastida,expenses,repairs,-150.72,-1071.12
buyer_8,Antonio,,1979-04-04,ES75209555999983843558,TRX_N-00690-05482308,2023-09-11T23:20:39,Labastida,expenses,transport,-58.68,-1129.8
buyer_8,Antonio,,1979-04-04,ES75209555999983843558,TRX_N-00691-93996449,2023-09-13T10:24:37,Labastida,expenses,repairs,-197.7,-1327.5
buyer_8,Antonio,,1979-04-04,ES75209555999983843558,TRX_N-00692-71890559,2023-09-14T22:43:59,Alegr√≠a-Dulantzi,expenses,food,-81.49,-1408.99
buyer_8,Antonio,,1979-04-04,ES75209555999983843558,TRX_N-00693-56252421,2023-09-17T20:14:35,Labastida,expenses,food,-68.62,-1477.61
buyer_8,Antonio,,1979-04-04,ES75209555999983843558,TRX_N-00694-45282184,2023-09-18T13:51:51,Getxo,expenses,cash,-100.0,-1577.61
buyer_8,Antonio,,1979-04-04,ES75209555999983843558,TRX_N-00695-08685449,2023-09-20T17:52:49,Elciego,expenses,food,-83.29,-1660.9
buyer_8,Antonio,,1979-04-04,ES75209555999983843558,TRX_N-00696-50226690,2023-09-20T22:08:30,Labastida,expenses,cash,-100.0,-1760.9
buyer_8,Antonio,,1979-04-04,ES75209555999983843558,TRX_N-00697-54098583,2023-09-21T04:21:09,Barakaldo,expenses,leisure,-81.15,-1842.05
buyer_8,Antonio,,1979-04-04,ES75209555999983843558,TRX_N-00698-44719365,2023-09-22T20:10:09,Labastida,expenses,education,-48.69,-1890.74
buyer_8,Antonio,,1979-04-04,ES75209555999983843558,TRX_N-00699-51808888,2023-09-23T10:49:11,Labastida,expenses,cash,-100.0,-1990.74
buyer_8,Antonio,,1979-04-04,ES75209555999983843558,TRX_N-00700-32420257,2023-09-24T05:32:14,Labastida,expenses,transport,-85.15,-2075.89
buyer_8,Antonio,,1979-04-04,ES75209555999983843558,TRX_N-00701-66750967,2023-09-25T12:58:56,Labastida,expenses,leisure,-75.13,-2151.02
buyer_8,Antonio,,1979-04-04,ES75209555999983843558,TRX_N-00702-31504529,2023-09-26T19:18:05,Labastida,expenses,food,-64.67,-2215.69
buyer_8,Antonio,,1979-04-04,ES75209555999983843558,TRX_N-00703-64327952,2023-09-27T14:40:13,Labastida,expenses,clothing,-156.32,-2372.01
buyer_8,Antonio,,1979-04-04,ES75209555999983843558,TRX_N-00704-39457370,2023-09-30T15:22:47,Labastida,expenses,leisure,-20.35,-2392.36
buyer_8,Antonio,,1979-04-04,ES75209555999983843558,TRX_N-00705-17160906,2023-10-01T11:41:47,Labastida,incomes,salary,3834.17,1441.81
buyer_8,Antonio,,1979-04-04,ES75209555999983843558,TRX_N-00706-82912532,2023-10-02T17:37:17,Irun,expenses,repairs,-172.99,1268.82
buyer_8,Antonio,,1979-04-04,ES75209555999983843558,TRX_N-00707-90784453,2023-10-04T17:15:42,Labastida,expenses,mortgage,-775.96,492.86
buyer_8,Antonio,,1979-04-04,ES75209555999983843558,TRX_N-00708-28610052,2023-10-04T13:51:21,Labastida,expenses,cash,-100.0,392.86
buyer_8,Antonio,,1979-04-04,ES75209555999983843558,TRX_N-00709-40532385,2023-10-06T11:04:39,Labastida,expenses,water,-44.36,348.5
buyer_8,Antonio,,1979-04-04,ES75209555999983843558,TRX_N-00710-23819978,2023-10-06T16:31:23,Labastida,expenses,internet,-42.0,306.5
buyer_8,Antonio,,1979-04-04,ES75209555999983843558,TRX_N-00711-57612342,2023-10-06T17:02:39,Labastida,expenses,phone,-43.63,262.87
buyer_8,Antonio,,1979-04-04,ES75209555999983843558,TRX_N-00712-25220700,2023-10-06T15:16:14,Basauri,expenses,cash,-100.0,162.87
buyer_8,Antonio,,1979-04-04,ES75209555999983843558,TRX_N-00713-97569421,2023-10-07T20:04:18,Labastida,expenses,electricity,-39.87,123.0
buyer_8,Antonio,,1979-04-04,ES75209555999983843558,TRX_N-00714-43757335,2023-10-07T16:47:37,Labastida,expenses,gas,-68.29,54.71
buyer_8,Antonio,,1979-04-04,ES75209555999983843558,TRX_N-00715-88609661,2023-10-08T08:06:44,Labastida,expenses,education,-71.73,-17.02
buyer_8,Antonio,,1979-04-04,ES75209555999983843558,TRX_N-00716-03217982,2023-10-09T18:11:30,Labastida,expenses,leisure,-82.95,-99.97
buyer_8,Antonio,,1979-04-04,ES75209555999983843558,TRX_N-00717-05108862,2023-10-11T18:17:40,Santurtzi,expenses,clothing,-144.93,-244.9
buyer_8,Antonio,,1979-04-04,ES75209555999983843558,TRX_N-00718-60788267,2023-10-11T23:56:24,Labastida,expenses,education,-57.85,-302.75
buyer_8,Antonio,,1979-04-04,ES75209555999983843558,TRX_N-00719-41458742,2023-10-13T13:18:26,Labastida,expenses,food,-63.78,-366.53
buyer_8,Antonio,,1979-04-04,ES75209555999983843558,TRX_N-00720-81395677,2023-10-13T18:07:29,Labastida,expenses,transport,-70.42,-436.95
buyer_8,Antonio,,1979-04-04,ES75209555999983843558,TRX_N-00721-41409846,2023-10-15T16:09:22,Andoain,expenses,transport,-65.87,-502.82
buyer_8,Antonio,,1979-04-04,ES75209555999983843558,TRX_N-00722-51560976,2023-10-15T21:14:30,Labastida,expenses,repairs,-330.93,-833.75
buyer_8,Antonio,,1979-04-04,ES75209555999983843558,TRX_N-00723-17734981,2023-10-16T16:47:04,Labastida,expenses,cash,-100.0,-933.75
buyer_8,Antonio,,1979-04-04,ES75209555999983843558,TRX_N-00724-88834579,2023-10-16T17:35:59,Labastida,expenses,gifts,-74.01,-1007.76
buyer_8,Antonio,,1979-04-04,ES75209555999983843558,TRX_N-00725-44387729,2023-10-17T12:35:30,Labastida,expenses,car,-173.94,-1181.7
buyer_8,Antonio,,1979-04-04,ES75209555999983843558,TRX_N-00726-31009425,2023-10-18T10:56:16,Labastida,expenses,cash,-100.0,-1281.7
buyer_8,Antonio,,1979-04-04,ES75209555999983843558,TRX_N-00727-51521734,2023-10-20T16:40:11,Labastida,expenses,education,-65.55,-1347.25
buyer_8,Antonio,,1979-04-04,ES75209555999983843558,TRX_N-00728-25777331,2023-10-20T08:58:58,Labastida,expenses,car,-161.8,-1509.05
buyer_8,Antonio,,1979-04-04,ES75209555999983843558,TRX_N-00729-30698413,2023-10-21T14:18:06,Labastida,expenses,food,-101.51,-1610.56
buyer_8,Antonio,,1979-04-04,ES75209555999983843558,TRX_N-00730-12945037,2023-10-21T20:22:47,Labastida,expenses,transport,-66.4,-1676.96
buyer_8,Antonio,,1979-04-04,ES75209555999983843558,TRX_N-00731-27451737,2023-10-21T17:04:27,Amurrio,expenses,leisure,-64.0,-1740.96
buyer_8,Antonio,,1979-04-04,ES75209555999983843558,TRX_N-00732-72766029,2023-10-21T12:07:15,Labastida,expenses,healthcare,-136.11,-1877.07
buyer_8,Antonio,,1979-04-04,ES75209555999983843558,TRX_N-00733-15667000,2023-10-25T15:33:53,Labastida,expenses,food,-98.18,-1975.25
buyer_8,Antonio,,1979-04-04,ES75209555999983843558,TRX_N-00734-63782338,2023-10-25T10:57:01,Labastida,expenses,clothing,-136.28,-2111.53
buyer_8,Antonio,,1979-04-04,ES75209555999983843558,TRX_N-00735-01522805,2023-10-25T13:31:52,Labastida,expenses,cash,-100.0,-2211.53
buyer_8,Antonio,,1979-04-04,ES75209555999983843558,TRX_N-00736-07437017,2023-10-29T10:12:32,Bilbao,expenses,transport,-80.99,-2292.52
buyer_8,Antonio,,1979-04-04,ES75209555999983843558,TRX_N-00737-59511102,2023-10-30T10:24:36,Berango,expenses,transport,-52.94,-2345.46
buyer_8,Antonio,,1979-04-04,ES75209555999983843558,TRX_N-00738-81796753,2023-10-31T22:51:53,Labastida,expenses,cash,-100.0,-2445.46
buyer_8,Antonio,,1979-04-04,ES75209555999983843558,TRX_N-00739-54101686,2023-11-01T23:00:01,Labastida,incomes,salary,3834.17,1388.71
buyer_8,Antonio,,1979-04-04,ES75209555999983843558,TRX_N-00740-94647246,2023-11-03T16:29:41,Labastida,expenses,food,-109.87,1278.84
buyer_8,Antonio,,1979-04-04,ES75209555999983843558,TRX_N-00741-89431414,2023-11-04T14:40:26,Labastida,expenses,mortgage,-775.96,502.88
buyer_8,Antonio,,1979-04-04,ES75209555999983843558,TRX_N-00742-84472013,2023-11-04T13:29:15,Labastida,expenses,food,-110.66,392.22
buyer_8,Antonio,,1979-04-04,ES75209555999983843558,TRX_N-00743-71054870,2023-11-04T09:01:21,Labastida,expenses,cash,-100.0,292.22
buyer_8,Antonio,,1979-04-04,ES75209555999983843558,TRX_N-00744-23668830,2023-11-05T08:49:47,Labastida,expenses,gas,-68.45,223.77
buyer_8,Antonio,,1979-04-04,ES75209555999983843558,TRX_N-00745-20735891,2023-11-05T09:11:02,Labastida,expenses,phone,-35.61,188.16
buyer_8,Antonio,,1979-04-04,ES75209555999983843558,TRX_N-00746-96626929,2023-11-05T23:41:22,Labastida,expenses,education,-42.24,145.92
buyer_8,Antonio,,1979-04-04,ES75209555999983843558,TRX_N-00747-41140638,2023-11-07T13:11:01,Labastida,expenses,internet,-42.0,103.92
buyer_8,Antonio,,1979-04-04,ES75209555999983843558,TRX_N-00748-53358664,2023-11-07T16:49:19,Labastida,expenses,leisure,-49.69,54.23
buyer_8,Antonio,,1979-04-04,ES75209555999983843558,TRX_N-00749-05135066,2023-11-07T11:08:37,Labastida,expenses,cash,-100.0,-45.77
buyer_8,Antonio,,1979-04-04,ES75209555999983843558,TRX_N-00750-45640175,2023-11-08T13:46:47,Labastida,expenses,water,-21.63,-67.4
buyer_8,Antonio,,1979-04-04,ES75209555999983843558,TRX_N-00751-32148686,2023-11-08T20:04:18,Labastida,expenses,electricity,-66.73,-134.13
buyer_8,Antonio,,1979-04-04,ES75209555999983843558,TRX_N-00752-85725218,2023-11-08T20:30:05,Irun,expenses,education,-44.22,-178.35
buyer_8,Antonio,,1979-04-04,ES75209555999983843558,TRX_N-00753-96026956,2023-11-08T14:59:21,Eibar,expenses,cash,-100.0,-278.35
buyer_8,Antonio,,1979-04-04,ES75209555999983843558,TRX_N-00754-59626889,2023-11-09T17:06:10,Labastida,expenses,clothing,-138.04,-416.39
buyer_8,Antonio,,1979-04-04,ES75209555999983843558,TRX_N-00755-03369203,2023-11-11T08:20:17,Labastida,expenses,food,-123.52,-539.91
buyer_8,Antonio,,1979-04-04,ES75209555999983843558,TRX_N-00756-48498467,2023-11-12T08:02:41,Labastida,expenses,cash,-100.0,-639.91
buyer_8,Antonio,,1979-04-04,ES75209555999983843558,TRX_N-00757-49960331,2023-11-14T08:36:30,Labastida,expenses,food,-67.27,-707.18
buyer_8,Antonio,,1979-04-04,ES75209555999983843558,TRX_N-00758-35435695,2023-11-17T08:55:41,Labastida,expenses,leisure,-76.61,-783.79
buyer_8,Antonio,,1979-04-04,ES75209555999983843558,TRX_N-00759-02381361,2023-11-17T14:20:21,Labastida,expenses,cash,-100.0,-883.79
buyer_8,Antonio,,1979-04-04,ES75209555999983843558,TRX_N-00760-33872588,2023-11-18T22:28:50,Labastida,expenses,leisure,-77.31,-961.1
buyer_8,Antonio,,1979-04-04,ES75209555999983843558,TRX_N-00761-96574663,2023-11-18T16:13:19,Labastida,expenses,healthcare,-188.89,-1149.99
buyer_8,Antonio,,1979-04-04,ES75209555999983843558,TRX_N-00762-73340481,2023-11-20T18:31:28,Andoain,expenses,repairs,-100.97,-1250.96
buyer_8,Antonio,,1979-04-04,ES75209555999983843558,TRX_N-00763-87972923,2023-11-21T22:08:58,Labastida,expenses,leisure,-41.33,-1292.29
buyer_8,Antonio,,1979-04-04,ES75209555999983843558,TRX_N-00764-40035314,2023-11-21T14:06:17,Labastida,expenses,clothing,-77.19,-1369.48
buyer_8,Antonio,,1979-04-04,ES75209555999983843558,TRX_N-00765-52622438,2023-11-22T18:08:49,Labastida,expenses,food,-83.44,-1452.92
buyer_8,Antonio,,1979-04-04,ES75209555999983843558,TRX_N-00766-04457196,2023-11-23T10:20:41,Errenteria,expenses,food,-117.18,-1570.1
buyer_8,Antonio,,1979-04-04,ES75209555999983843558,TRX_N-00767-70449713,2023-11-25T20:09:53,Labastida,expenses,cash,-100.0,-1670.1
buyer_8,Antonio,,1979-04-04,ES75209555999983843558,TRX_N-00768-98697137,2023-11-26T13:56:24,Portugalete,expenses,cash,-100.0,-1770.1
buyer_8,Antonio,,1979-04-04,ES75209555999983843558,TRX_N-00769-29490201,2023-11-27T10:46:02,Labastida,expenses,leisure,-62.7,-1832.8
buyer_8,Antonio,,1979-04-04,ES75209555999983843558,TRX_N-00770-47472404,2023-11-27T13:22:05,Labastida,expenses,cash,-100.0,-1932.8
buyer_8,Antonio,,1979-04-04,ES75209555999983843558,TRX_N-00771-39950835,2023-11-28T13:48:26,Labastida,expenses,food,-100.97,-2033.77
buyer_8,Antonio,,1979-04-04,ES75209555999983843558,TRX_N-00772-57002697,2023-11-28T20:40:44,Labastida,expenses,cash,-100.0,-2133.77
buyer_8,Antonio,,1979-04-04,ES75209555999983843558,TRX_N-00773-40678591,2023-11-29T15:44:52,Labastida,expenses,food,-121.4,-2255.17
buyer_8,Antonio,,1979-04-04,ES75209555999983843558,TRX_N-00774-50460615,2023-11-30T20:32:40,Labastida,expenses,leisure,-61.92,-2317.09
buyer_8,Antonio,,1979-04-04,ES75209555999983843558,TRX_N-00775-25772751,2023-12-01T10:16:17,Labastida,incomes,salary,3834.17,1517.08
buyer_8,Antonio,,1979-04-04,ES75209555999983843558,TRX_N-00776-33351841,2023-12-01T10:16:17,Labastida,incomes,extra_income,614.38,2131.46
buyer_8,Antonio,,1979-04-04,ES75209555999983843558,TRX_N-00777-08654899,2023-12-01T10:16:17,Labastida,incomes,salary_bonus,2875.82,5007.28
buyer_8,Antonio,,1979-04-04,ES75209555999983843558,TRX_N-00778-28127301,2023-12-02T04:40:30,Labastida,expenses,cash,-100.0,4907.28
buyer_8,Antonio,,1979-04-04,ES75209555999983843558,TRX_N-00779-21200752,2023-12-04T14:27:37,Labastida,expenses,mortgage,-775.96,4131.32
buyer_8,Antonio,,1979-04-04,ES75209555999983843558,TRX_N-00780-70417432,2023-12-05T17:20:25,Labastida,expenses,gas,-114.2,4017.12
buyer_8,Antonio,,1979-04-04,ES75209555999983843558,TRX_N-00781-68439643,2023-12-06T17:51:28,Labastida,expenses,internet,-42.0,3975.12
buyer_8,Antonio,,1979-04-04,ES75209555999983843558,TRX_N-00782-52726348,2023-12-06T12:55:18,Labastida,expenses,phone,-44.65,3930.47
buyer_8,Antonio,,1979-04-04,ES75209555999983843558,TRX_N-00783-18943226,2023-12-06T16:58:18,Labastida,expenses,repairs,-237.7,3692.77
buyer_8,Antonio,,1979-04-04,ES75209555999983843558,TRX_N-00784-16240152,2023-12-07T17:41:27,Labastida,expenses,clothing,-61.06,3631.71
buyer_8,Antonio,,1979-04-04,ES75209555999983843558,TRX_N-00785-45400272,2023-12-07T19:27:53,Labastida,expenses,healthcare,-77.66,3554.05
buyer_8,Antonio,,1979-04-04,ES75209555999983843558,TRX_N-00786-66415682,2023-12-08T12:56:48,Labastida,expenses,electricity,-71.55,3482.5
buyer_8,Antonio,,1979-04-04,ES75209555999983843558,TRX_N-00787-84158515,2023-12-08T15:01:50,Labastida,expenses,water,-28.47,3454.03
buyer_8,Antonio,,1979-04-04,ES75209555999983843558,TRX_N-00788-61113314,2023-12-08T14:55:58,Zuia,expenses,gifts,-68.95,3385.08
buyer_8,Antonio,,1979-04-04,ES75209555999983843558,TRX_N-00789-22541218,2023-12-11T14:40:52,Labastida,expenses,appliances,-304.31,3080.77
buyer_8,Antonio,,1979-04-04,ES75209555999983843558,TRX_N-00790-52241583,2023-12-12T09:10:23,Labastida,expenses,food,-93.05,2987.72
buyer_8,Antonio,,1979-04-04,ES75209555999983843558,TRX_N-00791-50343502,2023-12-13T20:38:23,Mungia,expenses,leisure,-21.21,2966.51
buyer_8,Antonio,,1979-04-04,ES75209555999983843558,TRX_N-00792-64322651,2023-12-16T20:12:01,Labastida,expenses,leisure,-64.06,2902.45
buyer_8,Antonio,,1979-04-04,ES75209555999983843558,TRX_N-00793-51135553,2023-12-17T18:02:57,Labastida,expenses,food,-104.02,2798.43
buyer_8,Antonio,,1979-04-04,ES75209555999983843558,TRX_N-00794-45107430,2023-12-17T06:45:15,Pasaia,expenses,repairs,-309.4,2489.03
buyer_8,Antonio,,1979-04-04,ES75209555999983843558,TRX_N-00795-16608819,2023-12-19T18:49:40,Galdakao,expenses,education,-63.16,2425.87
buyer_8,Antonio,,1979-04-04,ES75209555999983843558,TRX_N-00796-62103589,2023-12-19T11:07:08,Labastida,expenses,repairs,-177.45,2248.42
buyer_8,Antonio,,1979-04-04,ES75209555999983843558,TRX_N-00797-57254010,2023-12-21T15:09:41,Labastida,expenses,food,-69.82,2178.6
buyer_8,Antonio,,1979-04-04,ES75209555999983843558,TRX_N-00798-95119586,2023-12-23T13:37:08,Labastida,expenses,cash,-100.0,2078.6
buyer_8,Antonio,,1979-04-04,ES75209555999983843558,TRX_N-00799-69343894,2023-12-24T14:35:42,Labastida,expenses,leisure,-80.74,1997.86
buyer_8,Antonio,,1979-04-04,ES75209555999983843558,TRX_N-00800-79896047,2023-12-24T11:41:57,Labastida,expenses,cash,-100.0,1897.86
buyer_8,Antonio,,1979-04-04,ES75209555999983843558,TRX_N-00801-35507092,2023-12-25T18:32:02,Labastida,expenses,clothing,-149.21,1748.65
buyer_8,Antonio,,1979-04-04,ES75209555999983843558,TRX_N-00802-75913886,2023-12-26T19:06:17,Labastida,expenses,gifts,-498.62,1250.03
buyer_8,Antonio,,1979-04-04,ES75209555999983843558,TRX_N-00803-00766871,2023-12-27T09:39:34,Labastida,expenses,repairs,-293.06,956.97
buyer_8,Antonio,,1979-04-04,ES75209555999983843558,TRX_N-00804-78510032,2023-12-30T16:19:35,Labastida,expenses,leisure,-32.06,924.91
buyer_8,Antonio,,1979-04-04,ES75209555999983843558,TRX_N-00805-03874451,2023-12-30T10:59:35,Labastida,expenses,clothing,-102.2,822.71
buyer_8,Antonio,,1979-04-04,ES75209555999983843558,TRX_N-00806-56678718,2023-12-31T15:41:35,Labastida,expenses,leisure,-65.04,757.67
buyer_8,Antonio,,1979-04-04,ES75209555999983843558,TRX_N-00807-95041017,2024-01-01T06:42:42,Labastida,incomes,salary,3944.27,4701.94
buyer_8,Antonio,,1979-04-04,ES75209555999983843558,TRX_N-00808-23250821,2024-01-02T18:06:14,Vitoria-Gasteiz,expenses,food,-72.84,4629.1
buyer_8,Antonio,,1979-04-04,ES75209555999983843558,TRX_N-00809-84371656,2024-01-04T17:14:03,Labastida,expenses,mortgage,-775.96,3853.14
buyer_8,Antonio,,1979-04-04,ES75209555999983843558,TRX_N-00810-41303964,2024-01-04T09:52:12,Labastida,expenses,cash,-100.0,3753.14
buyer_8,Antonio,,1979-04-04,ES75209555999983843558,TRX_N-00811-73180527,2024-01-05T17:20:23,Labastida,expenses,food,-109.3,3643.84
buyer_8,Antonio,,1979-04-04,ES75209555999983843558,TRX_N-00812-75322203,2024-01-05T16:48:05,Labastida,expenses,cash,-100.0,3543.84
buyer_8,Antonio,,1979-04-04,ES75209555999983843558,TRX_N-00813-93198397,2024-01-06T16:44:42,Labastida,expenses,internet,-42.0,3501.84
buyer_8,Antonio,,1979-04-04,ES75209555999983843558,TRX_N-00814-72031203,2024-01-06T14:08:16,Labastida,expenses,transport,-78.2,3423.64
buyer_8,Antonio,,1979-04-04,ES75209555999983843558,TRX_N-00815-21546721,2024-01-06T00:05:19,Labastida,expenses,leisure,-71.88,3351.76
buyer_8,Antonio,,1979-04-04,ES75209555999983843558,TRX_N-00816-59654316,2024-01-07T13:43:42,Labastida,expenses,water,-31.65,3320.11
buyer_8,Antonio,,1979-04-04,ES75209555999983843558,TRX_N-00817-80363322,2024-01-07T14:07:54,Labastida,expenses,appliances,-135.74,3184.37
buyer_8,Antonio,,1979-04-04,ES75209555999983843558,TRX_N-00818-29086752,2024-01-08T12:06:11,Labastida,expenses,electricity,-87.72,3096.65
buyer_8,Antonio,,1979-04-04,ES75209555999983843558,TRX_N-00819-54467625,2024-01-08T19:59:08,Labastida,expenses,gas,-68.2,3028.45
buyer_8,Antonio,,1979-04-04,ES75209555999983843558,TRX_N-00820-52206352,2024-01-08T09:10:04,Labastida,expenses,phone,-40.08,2988.37
buyer_8,Antonio,,1979-04-04,ES75209555999983843558,TRX_N-00821-30827194,2024-01-11T20:50:43,Labastida,expenses,leisure,-45.25,2943.12
buyer_8,Antonio,,1979-04-04,ES75209555999983843558,TRX_N-00822-60518627,2024-01-11T13:06:49,Labastida,expenses,appliances,-395.74,2547.38
buyer_8,Antonio,,1979-04-04,ES75209555999983843558,TRX_N-00823-62689266,2024-01-12T17:27:00,Labastida,expenses,healthcare,-186.28,2361.1
buyer_8,Antonio,,1979-04-04,ES75209555999983843558,TRX_N-00824-89737353,2024-01-12T11:39:09,Labastida,expenses,cash,-100.0,2261.1
buyer_8,Antonio,,1979-04-04,ES75209555999983843558,TRX_N-00825-00878471,2024-01-12T11:54:11,Labastida,expenses,repairs,-145.26,2115.84
buyer_8,Antonio,,1979-04-04,ES75209555999983843558,TRX_N-00826-62464312,2024-01-13T17:07:16,Labastida,expenses,clothing,-64.33,2051.51
buyer_8,Antonio,,1979-04-04,ES75209555999983843558,TRX_N-00827-84350899,2024-01-16T12:18:45,Labastida,expenses,healthcare,-103.67,1947.84
buyer_8,Antonio,,1979-04-04,ES75209555999983843558,TRX_N-00828-41701678,2024-01-17T18:22:39,Elciego,expenses,leisure,-51.11,1896.73
buyer_8,Antonio,,1979-04-04,ES75209555999983843558,TRX_N-00829-64286550,2024-01-18T21:41:57,Labastida,expenses,cash,-100.0,1796.73
buyer_8,Antonio,,1979-04-04,ES75209555999983843558,TRX_N-00830-56635551,2024-01-20T17:51:52,Labastida,expenses,cash,-100.0,1696.73
buyer_8,Antonio,,1979-04-04,ES75209555999983843558,TRX_N-00831-02414567,2024-01-21T22:28:33,Labastida,expenses,cash,-100.0,1596.73
buyer_8,Antonio,,1979-04-04,ES75209555999983843558,TRX_N-00832-36858483,2024-01-22T09:33:55,Alegr√≠a-Dulantzi,expenses,travel,-1168.26,428.47
buyer_8,Antonio,,1979-04-04,ES75209555999983843558,TRX_N-00833-05630200,2024-01-23T07:42:47,Labastida,expenses,food,-87.28,341.19
buyer_8,Antonio,,1979-04-04,ES75209555999983843558,TRX_N-00834-81412274,2024-01-24T21:01:20,Labastida,expenses,repairs,-81.47,259.72
buyer_8,Antonio,,1979-04-04,ES75209555999983843558,TRX_N-00835-03427889,2024-01-25T01:25:52,Labastida,expenses,transport,-41.32,218.4
buyer_8,Antonio,,1979-04-04,ES75209555999983843558,TRX_N-00836-53393827,2024-01-25T16:10:06,Labastida,expenses,cash,-100.0,118.4
buyer_8,Antonio,,1979-04-04,ES75209555999983843558,TRX_N-00837-70638563,2024-01-26T11:17:54,Labastida,expenses,food,-112.89,5.51
buyer_8,Antonio,,1979-04-04,ES75209555999983843558,TRX_N-00838-87332926,2024-01-27T20:13:17,Labastida,expenses,appliances,-127.18,-121.67
buyer_8,Antonio,,1979-04-04,ES75209555999983843558,TRX_N-00839-18504363,2024-01-30T22:58:52,Labastida,expenses,leisure,-34.22,-155.89
buyer_8,Antonio,,1979-04-04,ES75209555999983843558,TRX_N-00840-70277554,2024-02-01T14:13:17,Labastida,incomes,salary,3944.27,3788.38
buyer_8,Antonio,,1979-04-04,ES75209555999983843558,TRX_N-00841-76436500,2024-02-04T08:49:34,Labastida,expenses,mortgage,-775.96,3012.42
buyer_8,Antonio,,1979-04-04,ES75209555999983843558,TRX_N-00842-65937963,2024-02-04T11:26:33,Labastida,expenses,education,-49.39,2963.03
buyer_8,Antonio,,1979-04-04,ES75209555999983843558,TRX_N-00843-62467840,2024-02-04T14:07:14,Labastida,expenses,cash,-100.0,2863.03
buyer_8,Antonio,,1979-04-04,ES75209555999983843558,TRX_N-00844-76780893,2024-02-05T15:55:25,Labastida,expenses,internet,-42.0,2821.03
buyer_8,Antonio,,1979-04-04,ES75209555999983843558,TRX_N-00845-79970507,2024-02-06T12:46:17,Labastida,expenses,water,-27.84,2793.19
buyer_8,Antonio,,1979-04-04,ES75209555999983843558,TRX_N-00846-26170687,2024-02-06T15:56:00,Labastida,expenses,phone,-35.76,2757.43
buyer_8,Antonio,,1979-04-04,ES75209555999983843558,TRX_N-00847-95664251,2024-02-06T13:47:37,Labastida,expenses,food,-73.78,2683.65
buyer_8,Antonio,,1979-04-04,ES75209555999983843558,TRX_N-00848-69537469,2024-02-07T22:11:54,Labastida,expenses,leisure,-61.85,2621.8
buyer_8,Antonio,,1979-04-04,ES75209555999983843558,TRX_N-00849-15969718,2024-02-08T07:34:01,Labastida,expenses,electricity,-73.24,2548.56
buyer_8,Antonio,,1979-04-04,ES75209555999983843558,TRX_N-00850-48191656,2024-02-08T06:17:56,Labastida,expenses,gas,-61.86,2486.7
buyer_8,Antonio,,1979-04-04,ES75209555999983843558,TRX_N-00851-52448301,2024-02-08T12:50:20,Labastida,expenses,repairs,-254.34,2232.36
buyer_8,Antonio,,1979-04-04,ES75209555999983843558,TRX_N-00852-26182623,2024-02-09T13:21:30,Labastida,expenses,food,-67.69,2164.67
buyer_8,Antonio,,1979-04-04,ES75209555999983843558,TRX_N-00853-04971010,2024-02-10T20:05:52,Labastida,expenses,leisure,-45.06,2119.61
buyer_8,Antonio,,1979-04-04,ES75209555999983843558,TRX_N-00854-44135848,2024-02-12T14:52:58,Labastida,expenses,leisure,-32.34,2087.27
buyer_8,Antonio,,1979-04-04,ES75209555999983843558,TRX_N-00855-34327468,2024-02-14T09:05:20,Labastida,expenses,transport,-48.02,2039.25
buyer_8,Antonio,,1979-04-04,ES75209555999983843558,TRX_N-00856-95907478,2024-02-15T20:37:19,Labastida,expenses,food,-78.39,1960.86
buyer_8,Antonio,,1979-04-04,ES75209555999983843558,TRX_N-00857-52641758,2024-02-15T11:36:08,Labastida,expenses,transport,-60.38,1900.48
buyer_8,Antonio,,1979-04-04,ES75209555999983843558,TRX_N-00858-95382657,2024-02-16T01:37:01,Labastida,expenses,repairs,-91.13,1809.35
buyer_8,Antonio,,1979-04-04,ES75209555999983843558,TRX_N-00859-42968227,2024-02-18T14:14:56,Labastida,expenses,food,-86.68,1722.67
buyer_8,Antonio,,1979-04-04,ES75209555999983843558,TRX_N-00860-56291357,2024-02-18T19:51:17,Labastida,expenses,cash,-100.0,1622.67
buyer_8,Antonio,,1979-04-04,ES75209555999983843558,TRX_N-00861-40695685,2024-02-19T23:57:43,Labastida,expenses,cash,-100.0,1522.67
buyer_8,Antonio,,1979-04-04,ES75209555999983843558,TRX_N-00862-26013451,2024-02-20T20:21:36,Labastida,expenses,repairs,-194.09,1328.58
buyer_8,Antonio,,1979-04-04,ES75209555999983843558,TRX_N-00863-51256428,2024-02-21T09:04:00,Labastida,expenses,leisure,-34.18,1294.4
buyer_8,Antonio,,1979-04-04,ES75209555999983843558,TRX_N-00864-17018738,2024-02-21T13:22:05,Labastida,expenses,cash,-100.0,1194.4
buyer_8,Antonio,,1979-04-04,ES75209555999983843558,TRX_N-00865-19030213,2024-02-23T15:25:36,Labastida,expenses,leisure,-26.89,1167.51
buyer_8,Antonio,,1979-04-04,ES75209555999983843558,TRX_N-00866-86541738,2024-02-23T17:37:03,Labastida,expenses,clothing,-148.03,1019.48
buyer_8,Antonio,,1979-04-04,ES75209555999983843558,TRX_N-00867-80910104,2024-02-23T18:06:48,Getxo,expenses,cash,-100.0,919.48
buyer_8,Antonio,,1979-04-04,ES75209555999983843558,TRX_N-00868-54530225,2024-02-23T16:38:11,Labastida,expenses,gifts,-774.52,144.96
buyer_8,Antonio,,1979-04-04,ES75209555999983843558,TRX_N-00869-34031224,2024-02-25T01:07:59,Labastida,expenses,transport,-61.11,83.85
buyer_8,Antonio,,1979-04-04,ES75209555999983843558,TRX_N-00870-57461920,2024-02-25T15:49:25,Pasaia,expenses,cash,-100.0,-16.15
buyer_8,Antonio,,1979-04-04,ES75209555999983843558,TRX_N-00871-08214517,2024-02-26T13:46:06,Labastida,expenses,gifts,-843.25,-859.4
buyer_8,Antonio,,1979-04-04,ES75209555999983843558,TRX_N-00872-46433009,2024-02-27T19:29:17,Salvatierra/Agurain,expenses,leisure,-80.11,-939.51
buyer_8,Antonio,,1979-04-04,ES75209555999983843558,TRX_N-00873-59163497,2024-02-27T19:41:34,Labastida,expenses,cash,-100.0,-1039.51
buyer_8,Antonio,,1979-04-04,ES75209555999983843558,TRX_N-00874-85130029,2024-02-27T11:57:52,Amurrio,expenses,repairs,-74.91,-1114.42
buyer_8,Antonio,,1979-04-04,ES75209555999983843558,TRX_N-00875-51205712,2024-03-01T12:46:45,Labastida,incomes,salary,3944.27,2829.85
buyer_8,Antonio,,1979-04-04,ES75209555999983843558,TRX_N-00876-35555270,2024-03-01T09:53:07,Labastida,expenses,appliances,-142.65,2687.2
buyer_8,Antonio,,1979-04-04,ES75209555999983843558,TRX_N-00877-62387073,2024-03-03T18:07:56,Bermeo,expenses,transport,-69.23,2617.97
buyer_8,Antonio,,1979-04-04,ES75209555999983843558,TRX_N-00878-07326976,2024-03-03T13:27:56,Labastida,expenses,clothing,-154.64,2463.33
buyer_8,Antonio,,1979-04-04,ES75209555999983843558,TRX_N-00879-40564185,2024-03-04T13:28:02,Labastida,expenses,mortgage,-775.96,1687.37
buyer_8,Antonio,,1979-04-04,ES75209555999983843558,TRX_N-00880-70324403,2024-03-05T12:34:00,Labastida,expenses,gas,-88.08,1599.29
buyer_8,Antonio,,1979-04-04,ES75209555999983843558,TRX_N-00881-03140642,2024-03-05T13:39:54,Labastida,expenses,healthcare,-179.84,1419.45
buyer_8,Antonio,,1979-04-04,ES75209555999983843558,TRX_N-00882-93743305,2024-03-06T19:31:23,Labastida,expenses,water,-25.46,1393.99
buyer_8,Antonio,,1979-04-04,ES75209555999983843558,TRX_N-00883-39692598,2024-03-06T15:53:41,Labastida,expenses,leisure,-39.05,1354.94
buyer_8,Antonio,,1979-04-04,ES75209555999983843558,TRX_N-00884-45960672,2024-03-08T08:42:02,Labastida,expenses,electricity,-47.93,1307.01
buyer_8,Antonio,,1979-04-04,ES75209555999983843558,TRX_N-00885-45351770,2024-03-08T12:05:23,Labastida,expenses,internet,-42.0,1265.01
buyer_8,Antonio,,1979-04-04,ES75209555999983843558,TRX_N-00886-11288254,2024-03-08T16:58:53,Labastida,expenses,phone,-44.62,1220.39
buyer_8,Antonio,,1979-04-04,ES75209555999983843558,TRX_N-00887-21460545,2024-03-08T20:08:17,Labastida,expenses,clothing,-130.51,1089.88
buyer_8,Antonio,,1979-04-04,ES75209555999983843558,TRX_N-00888-34852360,2024-03-09T15:48:07,Labastida,expenses,leisure,-61.6,1028.28
buyer_8,Antonio,,1979-04-04,ES75209555999983843558,TRX_N-00889-58003748,2024-03-09T18:38:14,Labastida,expenses,repairs,-170.53,857.75
buyer_8,Antonio,,1979-04-04,ES75209555999983843558,TRX_N-00890-87656124,2024-03-10T20:38:37,Labastida,expenses,cash,-100.0,757.75
buyer_8,Antonio,,1979-04-04,ES75209555999983843558,TRX_N-00891-96084368,2024-03-13T20:03:39,Labastida,expenses,food,-62.86,694.89
buyer_8,Antonio,,1979-04-04,ES75209555999983843558,TRX_N-00892-07115429,2024-03-14T17:05:20,Labastida,expenses,cash,-100.0,594.89
buyer_8,Antonio,,1979-04-04,ES75209555999983843558,TRX_N-00893-85279483,2024-03-17T10:12:00,Labastida,expenses,food,-88.39,506.5
buyer_8,Antonio,,1979-04-04,ES75209555999983843558,TRX_N-00894-67750944,2024-03-17T16:21:07,Labastida,expenses,clothing,-108.52,397.98
buyer_8,Antonio,,1979-04-04,ES75209555999983843558,TRX_N-00895-00986820,2024-03-18T13:46:05,Oy√≥n-Oion,expenses,food,-86.32,311.66
buyer_8,Antonio,,1979-04-04,ES75209555999983843558,TRX_N-00896-74710000,2024-03-20T18:48:02,Labastida,expenses,appliances,-334.77,-23.11
buyer_8,Antonio,,1979-04-04,ES75209555999983843558,TRX_N-00897-20386728,2024-03-22T02:29:15,Labastida,expenses,leisure,-26.18,-49.29
buyer_8,Antonio,,1979-04-04,ES75209555999983843558,TRX_N-00898-67034613,2024-03-23T12:12:54,Labastida,expenses,food,-104.76,-154.05
buyer_8,Antonio,,1979-04-04,ES75209555999983843558,TRX_N-00899-96290420,2024-03-23T19:09:32,Labastida,expenses,clothing,-65.08,-219.13
buyer_8,Antonio,,1979-04-04,ES75209555999983843558,TRX_N-00900-91731441,2024-03-24T10:31:16,Labastida,expenses,repairs,-190.12,-409.25
buyer_8,Antonio,,1979-04-04,ES75209555999983843558,TRX_N-00901-13797408,2024-03-25T18:57:25,Labastida,expenses,food,-106.82,-516.07
buyer_8,Antonio,,1979-04-04,ES75209555999983843558,TRX_N-00902-31458310,2024-03-25T12:33:43,Labastida,expenses,education,-75.2,-591.27
buyer_8,Antonio,,1979-04-04,ES75209555999983843558,TRX_N-00903-31416673,2024-03-25T09:47:33,Labastida,expenses,repairs,-101.9,-693.17
buyer_8,Antonio,,1979-04-04,ES75209555999983843558,TRX_N-00904-96000434,2024-03-25T18:18:22,Errenteria,expenses,gifts,-301.32,-994.49
buyer_8,Antonio,,1979-04-04,ES75209555999983843558,TRX_N-00905-77022495,2024-03-26T18:27:40,Elciego,expenses,cash,-100.0,-1094.49
buyer_8,Antonio,,1979-04-04,ES75209555999983843558,TRX_N-00906-05089650,2024-03-27T15:50:15,Labastida,expenses,clothing,-47.08,-1141.57
buyer_8,Antonio,,1979-04-04,ES75209555999983843558,TRX_N-00907-37807256,2024-03-28T11:31:55,Oy√≥n-Oion,expenses,transport,-40.05,-1181.62
buyer_8,Antonio,,1979-04-04,ES75209555999983843558,TRX_N-00908-22889208,2024-03-28T12:43:56,Labastida,expenses,healthcare,-84.6,-1266.22
buyer_8,Antonio,,1979-04-04,ES75209555999983843558,TRX_N-00909-48420495,2024-03-29T12:36:59,Labastida,expenses,food,-112.18,-1378.4
buyer_8,Antonio,,1979-04-04,ES75209555999983843558,TRX_N-00910-83951987,2024-03-29T15:20:25,Getxo,expenses,transport,-64.35,-1442.75
buyer_8,Antonio,,1979-04-04,ES75209555999983843558,TRX_N-00911-10268696,2024-04-01T23:34:14,Labastida,incomes,salary,3944.27,2501.52
buyer_8,Antonio,,1979-04-04,ES75209555999983843558,TRX_N-00912-64440836,2024-04-01T23:34:14,Labastida,incomes,extra_income,614.38,3115.9
buyer_8,Antonio,,1979-04-04,ES75209555999983843558,TRX_N-00913-71289165,2024-04-01T19:36:36,Labastida,expenses,repairs,-71.82,3044.08
buyer_8,Antonio,,1979-04-04,ES75209555999983843558,TRX_N-00914-16183765,2024-04-02T17:44:57,Labastida,expenses,leisure,-50.02,2994.06
buyer_8,Antonio,,1979-04-04,ES75209555999983843558,TRX_N-00915-61552265,2024-04-02T20:48:19,Labastida,expenses,healthcare,-49.57,2944.49
buyer_8,Antonio,,1979-04-04,ES75209555999983843558,TRX_N-00916-05865815,2024-04-03T02:07:19,Labastida,expenses,food,-122.11,2822.38
buyer_8,Antonio,,1979-04-04,ES75209555999983843558,TRX_N-00917-40712495,2024-04-04T20:39:46,Labastida,expenses,mortgage,-775.96,2046.42
buyer_8,Antonio,,1979-04-04,ES75209555999983843558,TRX_N-00918-42394965,2024-04-04T18:56:40,Labastida,expenses,transport,-71.05,1975.37
buyer_8,Antonio,,1979-04-04,ES75209555999983843558,TRX_N-00919-59096800,2024-04-05T07:36:32,Labastida,expenses,food,-117.16,1858.21
buyer_8,Antonio,,1979-04-04,ES75209555999983843558,TRX_N-00920-51789661,2024-04-06T14:42:13,Labastida,expenses,phone,-42.07,1816.14
buyer_8,Antonio,,1979-04-04,ES75209555999983843558,TRX_N-00921-04124260,2024-04-06T10:08:49,Labastida,expenses,leisure,-20.41,1795.73
buyer_8,Antonio,,1979-04-04,ES75209555999983843558,TRX_N-00922-04413695,2024-04-06T18:50:46,Labastida,expenses,cash,-100.0,1695.73
buyer_8,Antonio,,1979-04-04,ES75209555999983843558,TRX_N-00923-46705004,2024-04-07T10:13:28,Labastida,expenses,internet,-42.0,1653.73
buyer_8,Antonio,,1979-04-04,ES75209555999983843558,TRX_N-00924-80455582,2024-04-08T10:08:54,Labastida,expenses,water,-42.75,1610.98
buyer_8,Antonio,,1979-04-04,ES75209555999983843558,TRX_N-00925-48725313,2024-04-08T20:23:22,Labastida,expenses,electricity,-71.99,1538.99
buyer_8,Antonio,,1979-04-04,ES75209555999983843558,TRX_N-00926-65117706,2024-04-08T17:34:02,Labastida,expenses,gas,-97.29,1441.7
buyer_8,Antonio,,1979-04-04,ES75209555999983843558,TRX_N-00927-93502473,2024-04-09T17:27:53,Labastida,expenses,cash,-100.0,1341.7
buyer_8,Antonio,,1979-04-04,ES75209555999983843558,TRX_N-00928-93915063,2024-04-11T12:20:08,Labastida,expenses,cash,-100.0,1241.7
buyer_8,Antonio,,1979-04-04,ES75209555999983843558,TRX_N-00929-87142417,2024-04-13T22:43:44,Basauri,expenses,transport,-46.58,1195.12
buyer_8,Antonio,,1979-04-04,ES75209555999983843558,TRX_N-00930-64079497,2024-04-13T13:41:01,Labastida,expenses,leisure,-32.66,1162.46
buyer_8,Antonio,,1979-04-04,ES75209555999983843558,TRX_N-00931-06698318,2024-04-13T14:33:59,Labastida,expenses,travel,-889.14,273.32
buyer_8,Antonio,,1979-04-04,ES75209555999983843558,TRX_N-00932-33879699,2024-04-15T11:43:43,Alegr√≠a-Dulantzi,expenses,leisure,-31.51,241.81
buyer_8,Antonio,,1979-04-04,ES75209555999983843558,TRX_N-00933-05450150,2024-04-15T10:50:26,Labastida,expenses,education,-51.13,190.68
buyer_8,Antonio,,1979-04-04,ES75209555999983843558,TRX_N-00934-78036359,2024-04-17T12:52:28,Labastida,expenses,food,-66.85,123.83
buyer_8,Antonio,,1979-04-04,ES75209555999983843558,TRX_N-00935-29634986,2024-04-17T15:49:16,Donostia,expenses,leisure,-21.8,102.03
buyer_8,Antonio,,1979-04-04,ES75209555999983843558,TRX_N-00936-30107701,2024-04-19T11:10:59,Labastida,expenses,cash,-100.0,2.03
buyer_8,Antonio,,1979-04-04,ES75209555999983843558,TRX_N-00937-02371932,2024-04-24T23:03:24,Labastida,expenses,gifts,-600.42,-598.39
buyer_8,Antonio,,1979-04-04,ES75209555999983843558,TRX_N-00938-62703842,2024-04-25T09:41:04,Labastida,expenses,gifts,-172.04,-770.43
buyer_8,Antonio,,1979-04-04,ES75209555999983843558,TRX_N-00939-95698618,2024-04-26T08:51:36,Labastida,expenses,leisure,-37.95,-808.38
buyer_8,Antonio,,1979-04-04,ES75209555999983843558,TRX_N-00940-00357286,2024-04-27T03:17:36,Labastida,expenses,gifts,-303.61,-1111.99
buyer_8,Antonio,,1979-04-04,ES75209555999983843558,TRX_N-00941-57547145,2024-04-29T08:20:21,Labastida,expenses,cash,-100.0,-1211.99
buyer_8,Antonio,,1979-04-04,ES75209555999983843558,TRX_N-00942-32891217,2024-04-30T20:24:37,Labastida,expenses,food,-81.22,-1293.21
buyer_8,Antonio,,1979-04-04,ES75209555999983843558,TRX_N-00943-46155819,2024-05-01T10:49:12,Labastida,incomes,salary,3944.27,2651.06
buyer_8,Antonio,,1979-04-04,ES75209555999983843558,TRX_N-00944-49260894,2024-05-01T13:18:18,Labastida,expenses,food,-116.87,2534.19
buyer_8,Antonio,,1979-04-04,ES75209555999983843558,TRX_N-00945-34197415,2024-05-02T17:19:20,Labastida,expenses,transport,-76.32,2457.87
buyer_8,Antonio,,1979-04-04,ES75209555999983843558,TRX_N-00946-26492595,2024-05-02T02:32:10,Labastida,expenses,leisure,-45.25,2412.62
buyer_8,Antonio,,1979-04-04,ES75209555999983843558,TRX_N-00947-72557136,2024-05-02T01:24:50,Labastida,expenses,cash,-100.0,2312.62
buyer_8,Antonio,,1979-04-04,ES75209555999983843558,TRX_N-00948-50527575,2024-05-04T13:01:52,Labastida,expenses,mortgage,-775.96,1536.66
buyer_8,Antonio,,1979-04-04,ES75209555999983843558,TRX_N-00949-84988646,2024-05-05T16:21:12,Labastida,expenses,gas,-53.77,1482.89
buyer_8,Antonio,,1979-04-04,ES75209555999983843558,TRX_N-00950-30094812,2024-05-06T16:43:42,Labastida,expenses,electricity,-62.82,1420.07
buyer_8,Antonio,,1979-04-04,ES75209555999983843558,TRX_N-00951-44090364,2024-05-06T19:24:41,Labastida,expenses,phone,-36.96,1383.11
buyer_8,Antonio,,1979-04-04,ES75209555999983843558,TRX_N-00952-18879676,2024-05-08T14:41:26,Labastida,expenses,internet,-42.0,1341.11
buyer_8,Antonio,,1979-04-04,ES75209555999983843558,TRX_N-00953-07918734,2024-05-08T21:13:19,Labastida,expenses,water,-38.74,1302.37
buyer_8,Antonio,,1979-04-04,ES75209555999983843558,TRX_N-00954-66927414,2024-05-08T16:18:56,Labastida,expenses,transport,-84.82,1217.55
buyer_8,Antonio,,1979-04-04,ES75209555999983843558,TRX_N-00955-49737610,2024-05-09T12:45:03,Labastida,expenses,transport,-50.28,1167.27
buyer_8,Antonio,,1979-04-04,ES75209555999983843558,TRX_N-00956-92766284,2024-05-10T15:59:24,Labastida,expenses,clothing,-105.31,1061.96
buyer_8,Antonio,,1979-04-04,ES75209555999983843558,TRX_N-00957-15538635,2024-05-10T08:48:01,Labastida,expenses,cash,-100.0,961.96
buyer_8,Antonio,,1979-04-04,ES75209555999983843558,TRX_N-00958-56239897,2024-05-10T19:21:09,Labastida,expenses,appliances,-187.76,774.2
buyer_8,Antonio,,1979-04-04,ES75209555999983843558,TRX_N-00959-91189195,2024-05-10T17:46:17,Labastida,expenses,gifts,-496.02,278.18
buyer_8,Antonio,,1979-04-04,ES75209555999983843558,TRX_N-00960-80617146,2024-05-14T17:57:10,Irun,expenses,food,-91.16,187.02
buyer_8,Antonio,,1979-04-04,ES75209555999983843558,TRX_N-00961-82519298,2024-05-14T18:56:25,Labastida,expenses,appliances,-318.36,-131.34
buyer_8,Antonio,,1979-04-04,ES75209555999983843558,TRX_N-00962-66961354,2024-05-15T16:00:38,Pasaia,expenses,cash,-100.0,-231.34
buyer_8,Antonio,,1979-04-04,ES75209555999983843558,TRX_N-00963-88275058,2024-05-19T13:46:24,Labastida,expenses,gifts,-155.1,-386.44
buyer_8,Antonio,,1979-04-04,ES75209555999983843558,TRX_N-00964-02457018,2024-05-20T14:45:35,Barakaldo,expenses,leisure,-20.85,-407.29
buyer_8,Antonio,,1979-04-04,ES75209555999983843558,TRX_N-00965-08703104,2024-05-23T11:33:29,Labastida,expenses,education,-61.61,-468.9
buyer_8,Antonio,,1979-04-04,ES75209555999983843558,TRX_N-00966-76262814,2024-05-24T18:51:42,Labastida,expenses,healthcare,-48.22,-517.12
buyer_8,Antonio,,1979-04-04,ES75209555999983843558,TRX_N-00967-67267204,2024-05-25T13:17:59,Labastida,expenses,food,-97.12,-614.24
buyer_8,Antonio,,1979-04-04,ES75209555999983843558,TRX_N-00968-93962543,2024-05-26T12:23:50,Labastida,expenses,education,-60.01,-674.25
buyer_8,Antonio,,1979-04-04,ES75209555999983843558,TRX_N-00969-14959571,2024-05-29T09:20:41,Labastida,expenses,clothing,-75.76,-750.01
buyer_8,Antonio,,1979-04-04,ES75209555999983843558,TRX_N-00970-06790023,2024-05-31T12:00:59,Labastida,expenses,transport,-86.17,-836.18
buyer_8,Antonio,,1979-04-04,ES75209555999983843558,TRX_N-00971-61261789,2024-06-01T20:20:25,Labastida,incomes,salary,3944.27,3108.09
buyer_8,Antonio,,1979-04-04,ES75209555999983843558,TRX_N-00972-60786946,2024-06-01T20:20:25,Labastida,incomes,salary_bonus,2825.52,5933.61
buyer_8,Antonio,,1979-04-04,ES75209555999983843558,TRX_N-00973-21916246,2024-06-01T09:33:10,Labastida,expenses,leisure,-59.2,5874.41
buyer_8,Antonio,,1979-04-04,ES75209555999983843558,TRX_N-00974-09309001,2024-06-01T20:07:57,Labastida,expenses,education,-51.08,5823.33
buyer_8,Antonio,,1979-04-04,ES75209555999983843558,TRX_N-00975-05082513,2024-06-03T18:23:18,Labastida,expenses,cash,-100.0,5723.33
buyer_8,Antonio,,1979-04-04,ES75209555999983843558,TRX_N-00976-47516914,2024-06-04T20:11:35,Labastida,expenses,mortgage,-775.96,4947.37
buyer_8,Antonio,,1979-04-04,ES75209555999983843558,TRX_N-00977-59614210,2024-06-04T14:18:29,Andoain,expenses,transport,-71.33,4876.04
buyer_8,Antonio,,1979-04-04,ES75209555999983843558,TRX_N-00978-60404927,2024-06-05T11:56:36,Labastida,expenses,food,-80.19,4795.85
buyer_8,Antonio,,1979-04-04,ES75209555999983843558,TRX_N-00979-43401360,2024-06-05T17:14:48,Labastida,expenses,transport,-83.16,4712.69
buyer_8,Antonio,,1979-04-04,ES75209555999983843558,TRX_N-00980-26557180,2024-06-06T17:42:24,Labastida,expenses,gas,-102.52,4610.17
buyer_8,Antonio,,1979-04-04,ES75209555999983843558,TRX_N-00981-62776956,2024-06-06T22:59:05,Labastida,expenses,internet,-42.0,4568.17
buyer_8,Antonio,,1979-04-04,ES75209555999983843558,TRX_N-00982-70373424,2024-06-06T12:29:03,Labastida,expenses,healthcare,-157.26,4410.91
buyer_8,Antonio,,1979-04-04,ES75209555999983843558,TRX_N-00983-65247547,2024-06-07T20:57:11,Labastida,expenses,water,-20.2,4390.71
buyer_8,Antonio,,1979-04-04,ES75209555999983843558,TRX_N-00984-59176779,2024-06-07T08:56:13,Labastida,expenses,phone,-36.32,4354.39
buyer_8,Antonio,,1979-04-04,ES75209555999983843558,TRX_N-00985-53848708,2024-06-07T14:48:05,Labastida,expenses,car,-246.63,4107.76
buyer_8,Antonio,,1979-04-04,ES75209555999983843558,TRX_N-00986-98704514,2024-06-08T10:17:51,Labastida,expenses,electricity,-73.11,4034.65
buyer_8,Antonio,,1979-04-04,ES75209555999983843558,TRX_N-00987-31488364,2024-06-08T11:10:18,Labastida,expenses,cash,-100.0,3934.65
buyer_8,Antonio,,1979-04-04,ES75209555999983843558,TRX_N-00988-54784796,2024-06-12T20:49:47,Labastida,expenses,cash,-100.0,3834.65
buyer_8,Antonio,,1979-04-04,ES75209555999983843558,TRX_N-00989-23594589,2024-06-14T15:48:34,Labastida,expenses,repairs,-74.88,3759.77
buyer_8,Antonio,,1979-04-04,ES75209555999983843558,TRX_N-00990-57095971,2024-06-16T13:18:16,Labastida,expenses,food,-105.27,3654.5
buyer_8,Antonio,,1979-04-04,ES75209555999983843558,TRX_N-00991-64251736,2024-06-18T09:48:51,Labastida,expenses,cash,-100.0,3554.5
buyer_8,Antonio,,1979-04-04,ES75209555999983843558,TRX_N-00992-32096934,2024-06-19T18:07:11,Labastida,expenses,cash,-100.0,3454.5
buyer_8,Antonio,,1979-04-04,ES75209555999983843558,TRX_N-00993-31147559,2024-06-21T16:09:19,Lasarte-Oria,expenses,food,-69.11,3385.39
buyer_8,Antonio,,1979-04-04,ES75209555999983843558,TRX_N-00994-61200233,2024-06-22T17:26:08,Labastida,expenses,food,-102.79,3282.6
buyer_8,Antonio,,1979-04-04,ES75209555999983843558,TRX_N-00995-79248345,2024-06-22T20:26:28,Labastida,expenses,leisure,-45.73,3236.87
buyer_8,Antonio,,1979-04-04,ES75209555999983843558,TRX_N-00996-88780909,2024-06-22T10:26:19,Labastida,expenses,cash,-100.0,3136.87
buyer_8,Antonio,,1979-04-04,ES75209555999983843558,TRX_N-00997-85291361,2024-06-24T13:15:55,Labastida,expenses,healthcare,-69.5,3067.37
buyer_8,Antonio,,1979-04-04,ES75209555999983843558,TRX_N-00998-57481618,2024-06-27T21:42:50,Labastida,expenses,food,-61.64,3005.73
buyer_8,Antonio,,1979-04-04,ES75209555999983843558,TRX_N-00999-98099519,2024-06-28T11:57:15,Labastida,expenses,leisure,-63.92,2941.81
buyer_8,Antonio,,1979-04-04,ES75209555999983843558,TRX_N-01000-13289779,2024-06-28T13:02:17,Labastida,expenses,cash,-100.0,2841.81
buyer_8,Antonio,,1979-04-04,ES75209555999983843558,TRX_N-01001-71155681,2024-06-30T16:44:31,Labastida,expenses,transport,-79.62,2762.19
buyer_8,Antonio,,1979-04-04,ES75209555999983843558,TRX_N-01002-39656713,2024-06-30T08:08:25,Elciego,expenses,clothing,-68.78,2693.41
buyer_8,Antonio,,1979-04-04,ES75209555999983843558,TRX_N-01003-51361753,2024-06-30T14:01:53,Labastida,expenses,repairs,-136.76,2556.65
buyer_8,Antonio,,1979-04-04,ES75209555999983843558,TRX_N-01004-13427957,2024-07-01T23:29:57,Labastida,incomes,salary,3944.27,6500.92
buyer_8,Antonio,,1979-04-04,ES75209555999983843558,TRX_N-01005-00785137,2024-07-02T19:14:57,Bermeo,expenses,transport,-87.18,6413.74
buyer_8,Antonio,,1979-04-04,ES75209555999983843558,TRX_N-01006-88251547,2024-07-02T11:06:29,Labastida,expenses,cash,-100.0,6313.74
buyer_8,Antonio,,1979-04-04,ES75209555999983843558,TRX_N-01007-50283608,2024-07-02T08:52:49,Labastida,expenses,gifts,-176.29,6137.45
buyer_8,Antonio,,1979-04-04,ES75209555999983843558,TRX_N-01008-12945059,2024-07-04T16:21:15,Labastida,expenses,mortgage,-775.96,5361.49
buyer_8,Antonio,,1979-04-04,ES75209555999983843558,TRX_N-01009-26605514,2024-07-04T21:09:05,Labastida,expenses,leisure,-56.64,5304.85
buyer_8,Antonio,,1979-04-04,ES75209555999983843558,TRX_N-01010-98238217,2024-07-04T14:20:20,Irun,expenses,education,-43.36,5261.49
buyer_8,Antonio,,1979-04-04,ES75209555999983843558,TRX_N-01011-99411228,2024-07-04T03:10:31,Leioa,expenses,appliances,-364.21,4897.28
buyer_8,Antonio,,1979-04-04,ES75209555999983843558,TRX_N-01012-69406262,2024-07-05T08:36:12,Labastida,expenses,electricity,-27.71,4869.57
buyer_8,Antonio,,1979-04-04,ES75209555999983843558,TRX_N-01013-13166617,2024-07-05T13:38:42,Labastida,expenses,gas,-80.0,4789.57
buyer_8,Antonio,,1979-04-04,ES75209555999983843558,TRX_N-01014-36012158,2024-07-06T23:38:34,Labastida,expenses,internet,-42.0,4747.57
buyer_8,Antonio,,1979-04-04,ES75209555999983843558,TRX_N-01015-35571740,2024-07-06T21:37:50,Labastida,expenses,phone,-44.19,4703.38
buyer_8,Antonio,,1979-04-04,ES75209555999983843558,TRX_N-01016-17450695,2024-07-07T13:59:48,Labastida,expenses,water,-21.26,4682.12
buyer_8,Antonio,,1979-04-04,ES75209555999983843558,TRX_N-01017-20262969,2024-07-09T14:30:09,Labastida,expenses,transport,-65.35,4616.77
buyer_8,Antonio,,1979-04-04,ES75209555999983843558,TRX_N-01018-81334206,2024-07-11T09:56:18,Labastida,expenses,cash,-100.0,4516.77
buyer_8,Antonio,,1979-04-04,ES75209555999983843558,TRX_N-01019-77457878,2024-07-13T11:19:45,Labastida,expenses,leisure,-45.93,4470.84
buyer_8,Antonio,,1979-04-04,ES75209555999983843558,TRX_N-01020-53469084,2024-07-14T16:56:21,Hondarribia,expenses,food,-107.62,4363.22
buyer_8,Antonio,,1979-04-04,ES75209555999983843558,TRX_N-01021-08526079,2024-07-14T15:01:38,Labastida,expenses,transport,-74.44,4288.78
buyer_8,Antonio,,1979-04-04,ES75209555999983843558,TRX_N-01022-31968913,2024-07-14T13:59:22,Amurrio,expenses,clothing,-139.39,4149.39
buyer_8,Antonio,,1979-04-04,ES75209555999983843558,TRX_N-01023-59549313,2024-07-15T19:10:54,Labastida,expenses,transport,-82.78,4066.61
buyer_8,Antonio,,1979-04-04,ES75209555999983843558,TRX_N-01024-96662098,2024-07-17T22:31:55,Labastida,expenses,leisure,-71.96,3994.65
buyer_8,Antonio,,1979-04-04,ES75209555999983843558,TRX_N-01025-79094883,2024-07-17T08:29:31,Labastida,expenses,cash,-100.0,3894.65
buyer_8,Antonio,,1979-04-04,ES75209555999983843558,TRX_N-01026-69542770,2024-07-18T07:40:47,Labastida,expenses,education,-42.29,3852.36
buyer_8,Antonio,,1979-04-04,ES75209555999983843558,TRX_N-01027-48197402,2024-07-19T19:01:05,Hernani,expenses,cash,-100.0,3752.36
buyer_8,Antonio,,1979-04-04,ES75209555999983843558,TRX_N-01028-67434248,2024-07-21T10:12:20,Labastida,expenses,gifts,-537.27,3215.09
buyer_8,Antonio,,1979-04-04,ES75209555999983843558,TRX_N-01029-56399092,2024-07-23T16:42:31,Labastida,expenses,repairs,-98.86,3116.23
buyer_8,Antonio,,1979-04-04,ES75209555999983843558,TRX_N-01030-96865425,2024-07-25T13:06:35,Labastida,expenses,food,-91.99,3024.24
buyer_8,Antonio,,1979-04-04,ES75209555999983843558,TRX_N-01031-36471603,2024-07-25T11:49:27,Labastida,expenses,cash,-100.0,2924.24
buyer_8,Antonio,,1979-04-04,ES75209555999983843558,TRX_N-01032-36718267,2024-07-26T16:09:37,Berango,expenses,transport,-64.8,2859.44
buyer_8,Antonio,,1979-04-04,ES75209555999983843558,TRX_N-01033-02579991,2024-07-26T10:13:51,Eibar,expenses,healthcare,-150.07,2709.37
buyer_8,Antonio,,1979-04-04,ES75209555999983843558,TRX_N-01034-29383611,2024-07-27T09:35:55,Getxo,expenses,food,-91.62,2617.75
buyer_8,Antonio,,1979-04-04,ES75209555999983843558,TRX_N-01035-69234458,2024-07-29T11:18:41,Hernani,expenses,repairs,-69.59,2548.16
buyer_8,Antonio,,1979-04-04,ES75209555999983843558,TRX_N-01036-09421392,2024-08-01T20:47:07,Labastida,incomes,salary,3944.27,6492.43
buyer_8,Antonio,,1979-04-04,ES75209555999983843558,TRX_N-01037-75508664,2024-08-01T20:47:07,Labastida,incomes,extra_income,614.38,7106.81
buyer_8,Antonio,,1979-04-04,ES75209555999983843558,TRX_N-01038-64432182,2024-08-02T02:23:30,Irun,expenses,transport,-71.6,7035.21
buyer_8,Antonio,,1979-04-04,ES75209555999983843558,TRX_N-01039-90092016,2024-08-04T15:56:28,Labastida,expenses,mortgage,-775.96,6259.25
buyer_8,Antonio,,1979-04-04,ES75209555999983843558,TRX_N-01040-83036021,2024-08-04T08:27:23,Labastida,expenses,food,-103.45,6155.8
buyer_8,Antonio,,1979-04-04,ES75209555999983843558,TRX_N-01041-97539161,2024-08-05T18:41:11,Labastida,expenses,internet,-42.0,6113.8
buyer_8,Antonio,,1979-04-04,ES75209555999983843558,TRX_N-01042-08299665,2024-08-05T12:21:30,Labastida,expenses,leisure,-72.06,6041.74
buyer_8,Antonio,,1979-04-04,ES75209555999983843558,TRX_N-01043-90899486,2024-08-06T09:13:37,Labastida,expenses,electricity,-81.08,5960.66
buyer_8,Antonio,,1979-04-04,ES75209555999983843558,TRX_N-01044-12309235,2024-08-06T13:16:19,Labastida,expenses,gas,-105.26,5855.4
buyer_8,Antonio,,1979-04-04,ES75209555999983843558,TRX_N-01045-34771075,2024-08-07T08:56:19,Labastida,expenses,cash,-100.0,5755.4
buyer_8,Antonio,,1979-04-04,ES75209555999983843558,TRX_N-01046-16713601,2024-08-07T08:48:04,Labastida,expenses,appliances,-192.57,5562.83
buyer_8,Antonio,,1979-04-04,ES75209555999983843558,TRX_N-01047-45885068,2024-08-08T14:32:14,Labastida,expenses,water,-22.37,5540.46
buyer_8,Antonio,,1979-04-04,ES75209555999983843558,TRX_N-01048-61645206,2024-08-08T19:55:03,Labastida,expenses,phone,-44.98,5495.48
buyer_8,Antonio,,1979-04-04,ES75209555999983843558,TRX_N-01049-07988290,2024-08-08T15:04:10,Labastida,expenses,food,-118.82,5376.66
buyer_8,Antonio,,1979-04-04,ES75209555999983843558,TRX_N-01050-27584888,2024-08-08T06:10:41,Labastida,expenses,repairs,-273.42,5103.24
buyer_8,Antonio,,1979-04-04,ES75209555999983843558,TRX_N-01051-72226181,2024-08-08T09:17:07,Labastida,expenses,gifts,-768.4,4334.84
buyer_8,Antonio,,1979-04-04,ES75209555999983843558,TRX_N-01052-06423242,2024-08-09T14:49:01,Labastida,expenses,cash,-100.0,4234.84
buyer_8,Antonio,,1979-04-04,ES75209555999983843558,TRX_N-01053-50208730,2024-08-09T17:48:27,Labastida,expenses,gifts,-338.03,3896.81
buyer_8,Antonio,,1979-04-04,ES75209555999983843558,TRX_N-01054-39676759,2024-08-11T20:31:06,Labastida,expenses,leisure,-50.18,3846.63
buyer_8,Antonio,,1979-04-04,ES75209555999983843558,TRX_N-01055-81474249,2024-08-12T11:01:14,Erandio,expenses,gifts,-151.99,3694.64
buyer_8,Antonio,,1979-04-04,ES75209555999983843558,TRX_N-01056-62197144,2024-08-17T15:38:57,Labastida,expenses,clothing,-155.55,3539.09
buyer_8,Antonio,,1979-04-04,ES75209555999983843558,TRX_N-01057-91283967,2024-08-18T17:36:58,Labastida,expenses,food,-87.38,3451.71
buyer_8,Antonio,,1979-04-04,ES75209555999983843558,TRX_N-01058-54558305,2024-08-18T14:49:10,Vitoria-Gasteiz,expenses,cash,-100.0,3351.71
buyer_8,Antonio,,1979-04-04,ES75209555999983843558,TRX_N-01059-87071672,2024-08-20T11:14:17,Labastida,expenses,food,-86.1,3265.61
buyer_8,Antonio,,1979-04-04,ES75209555999983843558,TRX_N-01060-52074585,2024-08-20T19:51:09,Labastida,expenses,education,-49.28,3216.33
buyer_8,Antonio,,1979-04-04,ES75209555999983843558,TRX_N-01061-92268522,2024-08-20T12:55:49,Labastida,expenses,cash,-100.0,3116.33
buyer_8,Antonio,,1979-04-04,ES75209555999983843558,TRX_N-01062-15367858,2024-08-22T18:25:32,Labastida,expenses,food,-124.55,2991.78
buyer_8,Antonio,,1979-04-04,ES75209555999983843558,TRX_N-01063-87957575,2024-08-25T20:57:34,Labastida,expenses,leisure,-52.15,2939.63
buyer_8,Antonio,,1979-04-04,ES75209555999983843558,TRX_N-01064-29892906,2024-08-25T23:29:20,Labastida,expenses,cash,-100.0,2839.63
buyer_8,Antonio,,1979-04-04,ES75209555999983843558,TRX_N-01065-28631603,2024-08-25T16:01:17,Labastida,expenses,repairs,-205.97,2633.66
buyer_8,Antonio,,1979-04-04,ES75209555999983843558,TRX_N-01066-70118555,2024-08-27T08:53:03,Labastida,expenses,clothing,-103.28,2530.38
buyer_8,Antonio,,1979-04-04,ES75209555999983843558,TRX_N-01067-51991954,2024-08-28T19:36:02,Labastida,expenses,cash,-100.0,2430.38
buyer_8,Antonio,,1979-04-04,ES75209555999983843558,TRX_N-01068-43173014,2024-08-29T17:38:25,Labastida,expenses,food,-62.95,2367.43
buyer_8,Antonio,,1979-04-04,ES75209555999983843558,TRX_N-01069-03582786,2024-08-31T10:53:30,Labastida,expenses,leisure,-46.3,2321.13
buyer_8,Antonio,,1979-04-04,ES75209555999983843558,TRX_N-01070-71689070,2024-09-01T09:17:38,Labastida,incomes,salary,3944.27,6265.4
buyer_8,Antonio,,1979-04-04,ES75209555999983843558,TRX_N-01071-05930384,2024-09-02T20:43:09,Labastida,expenses,transport,-60.73,6204.67
buyer_8,Antonio,,1979-04-04,ES75209555999983843558,TRX_N-01072-37148795,2024-09-03T02:45:12,Labastida,expenses,cash,-100.0,6104.67
buyer_8,Antonio,,1979-04-04,ES75209555999983843558,TRX_N-01073-15695017,2024-09-04T10:21:39,Labastida,expenses,mortgage,-775.96,5328.71
buyer_8,Antonio,,1979-04-04,ES75209555999983843558,TRX_N-01074-12539770,2024-09-04T18:36:12,Labastida,expenses,education,-78.28,5250.43
buyer_8,Antonio,,1979-04-04,ES75209555999983843558,TRX_N-01075-54837124,2024-09-04T15:13:19,Galdakao,expenses,cash,-100.0,5150.43
buyer_8,Antonio,,1979-04-04,ES75209555999983843558,TRX_N-01076-37144573,2024-09-05T11:13:51,Labastida,expenses,water,-42.02,5108.41
buyer_8,Antonio,,1979-04-04,ES75209555999983843558,TRX_N-01077-34257599,2024-09-05T20:56:51,Labastida,expenses,phone,-44.86,5063.55
buyer_8,Antonio,,1979-04-04,ES75209555999983843558,TRX_N-01078-40870832,2024-09-06T19:40:24,Labastida,expenses,electricity,-54.98,5008.57
buyer_8,Antonio,,1979-04-04,ES75209555999983843558,TRX_N-01079-33592207,2024-09-08T12:35:35,Labastida,expenses,gas,-57.4,4951.17
buyer_8,Antonio,,1979-04-04,ES75209555999983843558,TRX_N-01080-92411923,2024-09-08T13:07:08,Labastida,expenses,internet,-42.0,4909.17
buyer_8,Antonio,,1979-04-04,ES75209555999983843558,TRX_N-01081-98718395,2024-09-08T14:24:07,Labastida,expenses,food,-67.08,4842.09
buyer_8,Antonio,,1979-04-04,ES75209555999983843558,TRX_N-01082-30858575,2024-09-10T20:19:47,Labastida,expenses,cash,-100.0,4742.09
buyer_8,Antonio,,1979-04-04,ES75209555999983843558,TRX_N-01083-53818581,2024-09-11T20:10:53,Bermeo,expenses,food,-86.73,4655.36
buyer_8,Antonio,,1979-04-04,ES75209555999983843558,TRX_N-01084-70526113,2024-09-11T08:45:05,Labastida,expenses,leisure,-67.58,4587.78
buyer_8,Antonio,,1979-04-04,ES75209555999983843558,TRX_N-01085-52033923,2024-09-11T16:43:57,Labastida,expenses,cash,-100.0,4487.78
buyer_8,Antonio,,1979-04-04,ES75209555999983843558,TRX_N-01086-01393058,2024-09-13T10:00:31,Labastida,expenses,transport,-80.54,4407.24
buyer_8,Antonio,,1979-04-04,ES75209555999983843558,TRX_N-01087-68686119,2024-09-15T00:50:09,Labastida,expenses,travel,-1042.72,3364.52
buyer_8,Antonio,,1979-04-04,ES75209555999983843558,TRX_N-01088-15587111,2024-09-15T14:58:59,Labastida,expenses,repairs,-178.02,3186.5
buyer_8,Antonio,,1979-04-04,ES75209555999983843558,TRX_N-01089-69084020,2024-09-17T16:26:55,Labastida,expenses,food,-94.76,3091.74
buyer_8,Antonio,,1979-04-04,ES75209555999983843558,TRX_N-01090-35414003,2024-09-17T18:40:31,Labastida,expenses,leisure,-72.54,3019.2
buyer_8,Antonio,,1979-04-04,ES75209555999983843558,TRX_N-01091-82867760,2024-09-17T12:57:14,Labastida,expenses,travel,-285.85,2733.35
buyer_8,Antonio,,1979-04-04,ES75209555999983843558,TRX_N-01092-89478791,2024-09-17T13:13:41,Eibar,expenses,gifts,-187.46,2545.89
buyer_8,Antonio,,1979-04-04,ES75209555999983843558,TRX_N-01093-16183283,2024-09-20T19:10:11,Labastida,expenses,food,-99.92,2445.97
buyer_8,Antonio,,1979-04-04,ES75209555999983843558,TRX_N-01094-99003420,2024-09-22T10:54:00,Labastida,expenses,cash,-100.0,2345.97
buyer_8,Antonio,,1979-04-04,ES75209555999983843558,TRX_N-01095-49659373,2024-09-23T13:17:29,Labastida,expenses,transport,-72.69,2273.28
buyer_8,Antonio,,1979-04-04,ES75209555999983843558,TRX_N-01096-66695620,2024-09-24T09:04:33,Labastida,expenses,leisure,-25.74,2247.54
buyer_8,Antonio,,1979-04-04,ES75209555999983843558,TRX_N-01097-38281764,2024-09-25T23:05:27,Barakaldo,expenses,food,-100.16,2147.38
buyer_8,Antonio,,1979-04-04,ES75209555999983843558,TRX_N-01098-91303225,2024-09-26T22:48:41,Labastida,expenses,gifts,-167.07,1980.31
buyer_8,Antonio,,1979-04-04,ES75209555999983843558,TRX_N-01099-57041078,2024-09-27T15:22:41,Zarautz,expenses,food,-87.81,1892.5
buyer_8,Antonio,,1979-04-04,ES75209555999983843558,TRX_N-01100-21553709,2024-09-27T20:09:32,Pasaia,expenses,transport,-53.29,1839.21
buyer_8,Antonio,,1979-04-04,ES75209555999983843558,TRX_N-01101-33910628,2024-09-27T06:27:38,Labastida,expenses,cash,-100.0,1739.21
buyer_8,Antonio,,1979-04-04,ES75209555999983843558,TRX_N-01102-31064595,2024-09-27T14:37:33,Labastida,expenses,gifts,-193.9,1545.31
buyer_8,Antonio,,1979-04-04,ES75209555999983843558,TRX_N-01103-77828816,2024-09-28T10:24:12,Labastida,expenses,food,-66.9,1478.41
buyer_8,Antonio,,1979-04-04,ES75209555999983843558,TRX_N-01104-87029994,2024-09-28T09:57:54,Labastida,expenses,gifts,-670.11,808.3
buyer_8,Antonio,,1979-04-04,ES75209555999983843558,TRX_N-01105-18386917,2024-09-29T13:56:00,Labastida,expenses,transport,-52.28,756.02
buyer_8,Antonio,,1979-04-04,ES75209555999983843558,TRX_N-01106-48694484,2024-09-30T13:17:39,Basauri,expenses,food,-63.8,692.22
buyer_8,Antonio,,1979-04-04,ES75209555999983843558,TRX_N-01107-38197478,2024-09-30T19:33:29,Labastida,expenses,leisure,-74.46,617.76
buyer_8,Antonio,,1979-04-04,ES75209555999983843558,TRX_N-01108-33858479,2024-10-01T10:16:06,Labastida,incomes,salary,3944.27,4562.03
buyer_8,Antonio,,1979-04-04,ES75209555999983843558,TRX_N-01109-15915565,2024-10-01T12:24:14,Labastida,expenses,transport,-71.85,4490.18
buyer_8,Antonio,,1979-04-04,ES75209555999983843558,TRX_N-01110-50997466,2024-10-01T16:29:17,Oy√≥n-Oion,expenses,leisure,-83.93,4406.25
buyer_8,Antonio,,1979-04-04,ES75209555999983843558,TRX_N-01111-95397520,2024-10-01T12:10:35,Labastida,expenses,education,-58.25,4348.0
buyer_8,Antonio,,1979-04-04,ES75209555999983843558,TRX_N-01112-44375830,2024-10-02T20:05:58,Labastida,expenses,transport,-46.12,4301.88
buyer_8,Antonio,,1979-04-04,ES75209555999983843558,TRX_N-01113-37648902,2024-10-02T11:02:19,Labastida,expenses,leisure,-81.15,4220.73
buyer_8,Antonio,,1979-04-04,ES75209555999983843558,TRX_N-01114-55378135,2024-10-02T15:35:44,Labastida,expenses,cash,-100.0,4120.73
buyer_8,Antonio,,1979-04-04,ES75209555999983843558,TRX_N-01115-67638026,2024-10-04T19:07:43,Labastida,expenses,mortgage,-775.96,3344.77
buyer_8,Antonio,,1979-04-04,ES75209555999983843558,TRX_N-01116-55436872,2024-10-05T20:29:57,Labastida,expenses,water,-21.12,3323.65
buyer_8,Antonio,,1979-04-04,ES75209555999983843558,TRX_N-01117-60223219,2024-10-05T17:32:02,Labastida,expenses,internet,-42.0,3281.65
buyer_8,Antonio,,1979-04-04,ES75209555999983843558,TRX_N-01118-89417938,2024-10-05T15:37:25,Labastida,expenses,food,-109.98,3171.67
buyer_8,Antonio,,1979-04-04,ES75209555999983843558,TRX_N-01119-88341017,2024-10-05T03:28:13,Labastida,expenses,repairs,-312.99,2858.68
buyer_8,Antonio,,1979-04-04,ES75209555999983843558,TRX_N-01120-84678063,2024-10-07T09:05:05,Labastida,expenses,gas,-104.52,2754.16
buyer_8,Antonio,,1979-04-04,ES75209555999983843558,TRX_N-01121-97645997,2024-10-08T10:39:44,Labastida,expenses,electricity,-77.85,2676.31
buyer_8,Antonio,,1979-04-04,ES75209555999983843558,TRX_N-01122-45218255,2024-10-08T12:23:36,Labastida,expenses,phone,-38.15,2638.16
buyer_8,Antonio,,1979-04-04,ES75209555999983843558,TRX_N-01123-15034152,2024-10-08T18:12:09,Donostia,expenses,cash,-100.0,2538.16
buyer_8,Antonio,,1979-04-04,ES75209555999983843558,TRX_N-01124-46757759,2024-10-09T09:28:10,Labastida,expenses,education,-73.98,2464.18
