profile,name,surname,birth_date,dni,email,password,iban,assets,timestamp,city,type,category,amount,balance
buyer_1,Aitor,López,1996-08-10,84942326Z,aitor.lopez@smartcode.org,563227,ES02209563310500830014,3761.2,2022-01-01T15:11:18,Bilbao,incomes,salary,552.89,4314.09
buyer_1,Aitor,López,1996-08-10,84942326Z,aitor.lopez@smartcode.org,563227,ES02209563310500830014,3761.2,2022-01-01T11:43:00,Bilbao,expenses,food,-74.52,4239.57
buyer_1,Aitor,López,1996-08-10,84942326Z,aitor.lopez@smartcode.org,563227,ES02209563310500830014,3761.2,2022-01-02T00:38:45,Bilbao,expenses,cash,-100.0,4139.57
buyer_1,Aitor,López,1996-08-10,84942326Z,aitor.lopez@smartcode.org,563227,ES02209563310500830014,3761.2,2022-01-04T08:03:11,Bilbao,expenses,cash,-100.0,4039.57
buyer_1,Aitor,López,1996-08-10,84942326Z,aitor.lopez@smartcode.org,563227,ES02209563310500830014,3761.2,2022-01-05T02:50:40,Bilbao,expenses,rent,-183.87,3855.7
buyer_1,Aitor,López,1996-08-10,84942326Z,aitor.lopez@smartcode.org,563227,ES02209563310500830014,3761.2,2022-01-05T13:03:33,Bilbao,expenses,electricity,-21.69,3834.01
buyer_1,Aitor,López,1996-08-10,84942326Z,aitor.lopez@smartcode.org,563227,ES02209563310500830014,3761.2,2022-01-06T02:45:01,Bilbao,expenses,electricity,-5.7,3828.31
buyer_1,Aitor,López,1996-08-10,84942326Z,aitor.lopez@smartcode.org,563227,ES02209563310500830014,3761.2,2022-01-06T23:38:22,Bilbao,expenses,internet,-11.61,3816.7
buyer_1,Aitor,López,1996-08-10,84942326Z,aitor.lopez@smartcode.org,563227,ES02209563310500830014,3761.2,2022-01-06T19:02:11,Bilbao,expenses,food,-67.2,3749.5
buyer_1,Aitor,López,1996-08-10,84942326Z,aitor.lopez@smartcode.org,563227,ES02209563310500830014,3761.2,2022-01-06T13:00:51,Bilbao,expenses,gifts,-69.25,3680.25
buyer_1,Aitor,López,1996-08-10,84942326Z,aitor.lopez@smartcode.org,563227,ES02209563310500830014,3761.2,2022-01-07T09:40:29,Bilbao,expenses,gas,-14.77,3665.48
buyer_1,Aitor,López,1996-08-10,84942326Z,aitor.lopez@smartcode.org,563227,ES02209563310500830014,3761.2,2022-01-07T21:48:20,Bilbao,expenses,internet,-11.61,3653.87
buyer_1,Aitor,López,1996-08-10,84942326Z,aitor.lopez@smartcode.org,563227,ES02209563310500830014,3761.2,2022-01-07T18:32:02,Bilbao,expenses,transport,-64.18,3589.69
buyer_1,Aitor,López,1996-08-10,84942326Z,aitor.lopez@smartcode.org,563227,ES02209563310500830014,3761.2,2022-01-08T19:41:08,Bilbao,expenses,cash,-100.0,3489.69
buyer_1,Aitor,López,1996-08-10,84942326Z,aitor.lopez@smartcode.org,563227,ES02209563310500830014,3761.2,2022-01-12T15:23:31,Bilbao,expenses,food,-101.13,3388.56
buyer_1,Aitor,López,1996-08-10,84942326Z,aitor.lopez@smartcode.org,563227,ES02209563310500830014,3761.2,2022-01-12T23:29:38,Bilbao,expenses,transport,-74.95,3313.61
buyer_1,Aitor,López,1996-08-10,84942326Z,aitor.lopez@smartcode.org,563227,ES02209563310500830014,3761.2,2022-01-12T16:38:44,Bilbao,expenses,education,-42.86,3270.75
buyer_1,Aitor,López,1996-08-10,84942326Z,aitor.lopez@smartcode.org,563227,ES02209563310500830014,3761.2,2022-01-13T17:47:22,Bilbao,expenses,healthcare,-60.87,3209.88
buyer_1,Aitor,López,1996-08-10,84942326Z,aitor.lopez@smartcode.org,563227,ES02209563310500830014,3761.2,2022-01-13T13:43:28,Bilbao,expenses,appliances,-156.12,3053.76
buyer_1,Aitor,López,1996-08-10,84942326Z,aitor.lopez@smartcode.org,563227,ES02209563310500830014,3761.2,2022-01-15T18:27:40,Bilbao,expenses,food,-121.9,2931.86
buyer_1,Aitor,López,1996-08-10,84942326Z,aitor.lopez@smartcode.org,563227,ES02209563310500830014,3761.2,2022-01-15T16:59:11,Bilbao,expenses,leisure,-28.16,2903.7
buyer_1,Aitor,López,1996-08-10,84942326Z,aitor.lopez@smartcode.org,563227,ES02209563310500830014,3761.2,2022-01-15T11:13:57,Bilbao,expenses,gifts,-44.52,2859.18
buyer_1,Aitor,López,1996-08-10,84942326Z,aitor.lopez@smartcode.org,563227,ES02209563310500830014,3761.2,2022-01-19T16:30:25,Bilbao,expenses,cash,-100.0,2759.18
buyer_1,Aitor,López,1996-08-10,84942326Z,aitor.lopez@smartcode.org,563227,ES02209563310500830014,3761.2,2022-01-20T19:08:12,Bilbao,expenses,clothing,-61.29,2697.89
buyer_1,Aitor,López,1996-08-10,84942326Z,aitor.lopez@smartcode.org,563227,ES02209563310500830014,3761.2,2022-01-20T14:07:17,Bilbao,expenses,repairs,-161.04,2536.85
buyer_1,Aitor,López,1996-08-10,84942326Z,aitor.lopez@smartcode.org,563227,ES02209563310500830014,3761.2,2022-01-21T17:06:56,Bilbao,expenses,appliances,-194.12,2342.73
buyer_1,Aitor,López,1996-08-10,84942326Z,aitor.lopez@smartcode.org,563227,ES02209563310500830014,3761.2,2022-01-22T22:24:54,Bilbao,expenses,gifts,-108.27,2234.46
buyer_1,Aitor,López,1996-08-10,84942326Z,aitor.lopez@smartcode.org,563227,ES02209563310500830014,3761.2,2022-01-23T18:57:57,Bilbao,expenses,food,-96.41,2138.05
buyer_1,Aitor,López,1996-08-10,84942326Z,aitor.lopez@smartcode.org,563227,ES02209563310500830014,3761.2,2022-01-23T06:01:53,Bilbao,expenses,education,-55.93,2082.12
buyer_1,Aitor,López,1996-08-10,84942326Z,aitor.lopez@smartcode.org,563227,ES02209563310500830014,3761.2,2022-01-23T09:38:45,Bilbao,expenses,travel,-76.23,2005.89
buyer_1,Aitor,López,1996-08-10,84942326Z,aitor.lopez@smartcode.org,563227,ES02209563310500830014,3761.2,2022-01-25T19:48:56,Bilbao,expenses,food,-80.98,1924.91
buyer_1,Aitor,López,1996-08-10,84942326Z,aitor.lopez@smartcode.org,563227,ES02209563310500830014,3761.2,2022-01-25T13:03:19,Bilbao,expenses,transport,-69.01,1855.9
buyer_1,Aitor,López,1996-08-10,84942326Z,aitor.lopez@smartcode.org,563227,ES02209563310500830014,3761.2,2022-01-25T19:17:23,Bilbao,expenses,healthcare,-49.27,1806.63
buyer_1,Aitor,López,1996-08-10,84942326Z,aitor.lopez@smartcode.org,563227,ES02209563310500830014,3761.2,2022-01-27T10:09:16,Bilbao,expenses,transport,-64.63,1742.0
buyer_1,Aitor,López,1996-08-10,84942326Z,aitor.lopez@smartcode.org,563227,ES02209563310500830014,3761.2,2022-01-27T17:24:01,Bilbao,expenses,leisure,-47.08,1694.92
buyer_1,Aitor,López,1996-08-10,84942326Z,aitor.lopez@smartcode.org,563227,ES02209563310500830014,3761.2,2022-01-27T11:55:16,Bilbao,expenses,repairs,-48.65,1646.27
buyer_1,Aitor,López,1996-08-10,84942326Z,aitor.lopez@smartcode.org,563227,ES02209563310500830014,3761.2,2022-01-28T20:38:36,Bilbao,expenses,food,-111.59,1534.68
buyer_1,Aitor,López,1996-08-10,84942326Z,aitor.lopez@smartcode.org,563227,ES02209563310500830014,3761.2,2022-01-31T14:18:11,Bilbao,expenses,cash,-100.0,1434.68
buyer_1,Aitor,López,1996-08-10,84942326Z,aitor.lopez@smartcode.org,563227,ES02209563310500830014,3761.2,2022-02-01T15:32:19,Bilbao,incomes,salary,552.89,1987.57
buyer_1,Aitor,López,1996-08-10,84942326Z,aitor.lopez@smartcode.org,563227,ES02209563310500830014,3761.2,2022-02-04T17:17:01,Bilbao,expenses,gifts,-68.81,1918.76
buyer_1,Aitor,López,1996-08-10,84942326Z,aitor.lopez@smartcode.org,563227,ES02209563310500830014,3761.2,2022-02-05T10:52:23,Bilbao,expenses,rent,-183.87,1734.89
buyer_1,Aitor,López,1996-08-10,84942326Z,aitor.lopez@smartcode.org,563227,ES02209563310500830014,3761.2,2022-02-05T13:14:42,Bilbao,expenses,electricity,-23.44,1711.45
buyer_1,Aitor,López,1996-08-10,84942326Z,aitor.lopez@smartcode.org,563227,ES02209563310500830014,3761.2,2022-02-06T20:18:40,Bilbao,expenses,phone,-10.47,1700.98
buyer_1,Aitor,López,1996-08-10,84942326Z,aitor.lopez@smartcode.org,563227,ES02209563310500830014,3761.2,2022-02-07T00:58:14,Bilbao,expenses,electricity,-24.16,1676.82
buyer_1,Aitor,López,1996-08-10,84942326Z,aitor.lopez@smartcode.org,563227,ES02209563310500830014,3761.2,2022-02-07T10:54:14,Bilbao,expenses,food,-90.77,1586.05
buyer_1,Aitor,López,1996-08-10,84942326Z,aitor.lopez@smartcode.org,563227,ES02209563310500830014,3761.2,2022-02-07T10:30:39,Bilbao,expenses,repairs,-90.63,1495.42
buyer_1,Aitor,López,1996-08-10,84942326Z,aitor.lopez@smartcode.org,563227,ES02209563310500830014,3761.2,2022-02-08T02:42:46,Bilbao,expenses,healthcare,-134.4,1361.02
buyer_1,Aitor,López,1996-08-10,84942326Z,aitor.lopez@smartcode.org,563227,ES02209563310500830014,3761.2,2022-02-09T10:50:24,Bilbao,expenses,leisure,-67.61,1293.41
buyer_1,Aitor,López,1996-08-10,84942326Z,aitor.lopez@smartcode.org,563227,ES02209563310500830014,3761.2,2022-02-09T20:03:51,Bilbao,expenses,cash,-100.0,1193.41
buyer_1,Aitor,López,1996-08-10,84942326Z,aitor.lopez@smartcode.org,563227,ES02209563310500830014,3761.2,2022-02-09T12:19:18,Bilbao,expenses,gifts,-54.44,1138.97
buyer_1,Aitor,López,1996-08-10,84942326Z,aitor.lopez@smartcode.org,563227,ES02209563310500830014,3761.2,2022-02-10T17:26:43,Bilbao,expenses,food,-78.26,1060.71
buyer_1,Aitor,López,1996-08-10,84942326Z,aitor.lopez@smartcode.org,563227,ES02209563310500830014,3761.2,2022-02-11T10:42:34,Bilbao,expenses,healthcare,-46.44,1014.27
buyer_1,Aitor,López,1996-08-10,84942326Z,aitor.lopez@smartcode.org,563227,ES02209563310500830014,3761.2,2022-02-14T15:00:42,Bilbao,expenses,food,-124.03,890.24
buyer_1,Aitor,López,1996-08-10,84942326Z,aitor.lopez@smartcode.org,563227,ES02209563310500830014,3761.2,2022-02-14T15:01:35,Bilbao,expenses,cash,-100.0,790.24
buyer_1,Aitor,López,1996-08-10,84942326Z,aitor.lopez@smartcode.org,563227,ES02209563310500830014,3761.2,2022-02-15T12:33:46,Bilbao,expenses,food,-63.18,727.06
buyer_1,Aitor,López,1996-08-10,84942326Z,aitor.lopez@smartcode.org,563227,ES02209563310500830014,3761.2,2022-02-16T14:19:08,Bilbao,expenses,food,-97.7,629.36
buyer_1,Aitor,López,1996-08-10,84942326Z,aitor.lopez@smartcode.org,563227,ES02209563310500830014,3761.2,2022-02-16T18:12:04,Bilbao,expenses,cash,-100.0,529.36
buyer_1,Aitor,López,1996-08-10,84942326Z,aitor.lopez@smartcode.org,563227,ES02209563310500830014,3761.2,2022-02-17T17:30:08,Bilbao,expenses,transport,-83.22,446.14
buyer_1,Aitor,López,1996-08-10,84942326Z,aitor.lopez@smartcode.org,563227,ES02209563310500830014,3761.2,2022-02-19T15:52:26,Bilbao,expenses,appliances,-89.72,356.42
buyer_1,Aitor,López,1996-08-10,84942326Z,aitor.lopez@smartcode.org,563227,ES02209563310500830014,3761.2,2022-02-20T10:17:09,Bilbao,expenses,education,-74.0,282.42
buyer_1,Aitor,López,1996-08-10,84942326Z,aitor.lopez@smartcode.org,563227,ES02209563310500830014,3761.2,2022-02-22T15:58:51,Bilbao,expenses,healthcare,-189.17,93.25
buyer_1,Aitor,López,1996-08-10,84942326Z,aitor.lopez@smartcode.org,563227,ES02209563310500830014,3761.2,2022-02-22T12:33:12,Bilbao,expenses,gifts,-33.48,59.77
buyer_1,Aitor,López,1996-08-10,84942326Z,aitor.lopez@smartcode.org,563227,ES02209563310500830014,3761.2,2022-02-25T13:38:09,Bilbao,expenses,food,-81.75,-21.98
buyer_1,Aitor,López,1996-08-10,84942326Z,aitor.lopez@smartcode.org,563227,ES02209563310500830014,3761.2,2022-03-01T12:02:29,Bilbao,incomes,salary,552.89,530.91
buyer_1,Aitor,López,1996-08-10,84942326Z,aitor.lopez@smartcode.org,563227,ES02209563310500830014,3761.2,2022-03-01T20:57:32,Bilbao,expenses,transport,-77.88,453.03
buyer_1,Aitor,López,1996-08-10,84942326Z,aitor.lopez@smartcode.org,563227,ES02209563310500830014,3761.2,2022-03-01T10:09:32,Bilbao,expenses,education,-49.15,403.88
buyer_1,Aitor,López,1996-08-10,84942326Z,aitor.lopez@smartcode.org,563227,ES02209563310500830014,3761.2,2022-03-01T14:48:40,Bilbao,expenses,cash,-98.47,305.41
buyer_1,Aitor,López,1996-08-10,84942326Z,aitor.lopez@smartcode.org,563227,ES02209563310500830014,3761.2,2022-03-03T12:09:17,Bilbao,expenses,cash,-100.0,205.41
buyer_1,Aitor,López,1996-08-10,84942326Z,aitor.lopez@smartcode.org,563227,ES02209563310500830014,3761.2,2022-03-05T11:29:38,Bilbao,expenses,rent,-183.87,21.54
buyer_1,Aitor,López,1996-08-10,84942326Z,aitor.lopez@smartcode.org,563227,ES02209563310500830014,3761.2,2022-03-05T20:32:38,Bilbao,expenses,water,-10.54,11.0
buyer_1,Aitor,López,1996-08-10,84942326Z,aitor.lopez@smartcode.org,563227,ES02209563310500830014,3761.2,2022-03-05T08:35:41,Bilbao,expenses,phone,-9.93,1.07
buyer_1,Aitor,López,1996-08-10,84942326Z,aitor.lopez@smartcode.org,563227,ES02209563310500830014,3761.2,2022-03-05T13:09:43,Bilbao,expenses,food,-88.59,-87.52
buyer_1,Aitor,López,1996-08-10,84942326Z,aitor.lopez@smartcode.org,563227,ES02209563310500830014,3761.2,2022-03-06T21:57:22,Bilbao,expenses,water,-6.23,-93.75
buyer_1,Aitor,López,1996-08-10,84942326Z,aitor.lopez@smartcode.org,563227,ES02209563310500830014,3761.2,2022-03-06T22:41:31,Bilbao,expenses,gas,-12.31,-106.06
buyer_1,Aitor,López,1996-08-10,84942326Z,aitor.lopez@smartcode.org,563227,ES02209563310500830014,3761.2,2022-03-07T13:13:15,Bilbao,expenses,water,-9.73,-115.79
buyer_1,Aitor,López,1996-08-10,84942326Z,aitor.lopez@smartcode.org,563227,ES02209563310500830014,3761.2,2022-03-08T16:19:51,Bilbao,expenses,electricity,-8.96,-124.75
buyer_1,Aitor,López,1996-08-10,84942326Z,aitor.lopez@smartcode.org,563227,ES02209563310500830014,3761.2,2022-03-08T09:36:33,Bilbao,expenses,internet,-11.61,-136.36
buyer_1,Aitor,López,1996-08-10,84942326Z,aitor.lopez@smartcode.org,563227,ES02209563310500830014,3761.2,2022-03-08T18:05:25,Bilbao,expenses,phone,-12.08,-148.44
buyer_1,Aitor,López,1996-08-10,84942326Z,aitor.lopez@smartcode.org,563227,ES02209563310500830014,3761.2,2022-03-08T12:30:17,Bilbao,expenses,transport,-46.88,-195.32
buyer_1,Aitor,López,1996-08-10,84942326Z,aitor.lopez@smartcode.org,563227,ES02209563310500830014,3761.2,2022-03-08T13:42:46,Bilbao,expenses,leisure,-40.34,-235.66
buyer_1,Aitor,López,1996-08-10,84942326Z,aitor.lopez@smartcode.org,563227,ES02209563310500830014,3761.2,2022-03-10T11:20:35,Bilbao,expenses,food,-113.38,-349.04
buyer_1,Aitor,López,1996-08-10,84942326Z,aitor.lopez@smartcode.org,563227,ES02209563310500830014,3761.2,2022-03-10T16:00:26,Bilbao,expenses,leisure,-23.33,-372.37
buyer_1,Aitor,López,1996-08-10,84942326Z,aitor.lopez@smartcode.org,563227,ES02209563310500830014,3761.2,2022-03-10T20:21:11,Bilbao,expenses,cash,-99.15,-471.52
buyer_1,Aitor,López,1996-08-10,84942326Z,aitor.lopez@smartcode.org,563227,ES02209563310500830014,3761.2,2022-03-11T11:30:55,Bilbao,expenses,clothing,-76.44,-547.96
buyer_1,Aitor,López,1996-08-10,84942326Z,aitor.lopez@smartcode.org,563227,ES02209563310500830014,3761.2,2022-03-15T08:14:03,Bilbao,expenses,food,-63.08,-611.04
buyer_1,Aitor,López,1996-08-10,84942326Z,aitor.lopez@smartcode.org,563227,ES02209563310500830014,3761.2,2022-03-15T10:01:21,Bilbao,expenses,transport,-57.42,-668.46
buyer_1,Aitor,López,1996-08-10,84942326Z,aitor.lopez@smartcode.org,563227,ES02209563310500830014,3761.2,2022-03-18T14:14:36,Bilbao,expenses,repairs,-37.15,-705.61
buyer_1,Aitor,López,1996-08-10,84942326Z,aitor.lopez@smartcode.org,563227,ES02209563310500830014,3761.2,2022-03-19T17:31:20,Bilbao,expenses,leisure,-38.44,-744.05
buyer_1,Aitor,López,1996-08-10,84942326Z,aitor.lopez@smartcode.org,563227,ES02209563310500830014,3761.2,2022-03-22T08:08:35,Bilbao,expenses,cash,-100.0,-844.05
buyer_1,Aitor,López,1996-08-10,84942326Z,aitor.lopez@smartcode.org,563227,ES02209563310500830014,3761.2,2022-03-22T08:47:14,Bilbao,expenses,repairs,-77.79,-921.84
buyer_1,Aitor,López,1996-08-10,84942326Z,aitor.lopez@smartcode.org,563227,ES02209563310500830014,3761.2,2022-03-23T03:00:56,Bilbao,expenses,cash,-100.0,-1021.84
buyer_1,Aitor,López,1996-08-10,84942326Z,aitor.lopez@smartcode.org,563227,ES02209563310500830014,3761.2,2022-03-24T09:15:46,Bilbao,expenses,food,-101.66,-1123.5
buyer_1,Aitor,López,1996-08-10,84942326Z,aitor.lopez@smartcode.org,563227,ES02209563310500830014,3761.2,2022-03-25T10:36:10,Bilbao,expenses,education,-67.7,-1191.2
buyer_1,Aitor,López,1996-08-10,84942326Z,aitor.lopez@smartcode.org,563227,ES02209563310500830014,3761.2,2022-03-27T21:06:40,Bilbao,expenses,cash,-100.0,-1291.2
buyer_1,Aitor,López,1996-08-10,84942326Z,aitor.lopez@smartcode.org,563227,ES02209563310500830014,3761.2,2022-03-27T16:24:28,Bilbao,expenses,gifts,-123.45,-1414.65
buyer_1,Aitor,López,1996-08-10,84942326Z,aitor.lopez@smartcode.org,563227,ES02209563310500830014,3761.2,2022-03-30T09:59:21,Bilbao,expenses,cash,-100.0,-1514.65
buyer_1,Aitor,López,1996-08-10,84942326Z,aitor.lopez@smartcode.org,563227,ES02209563310500830014,3761.2,2022-03-30T19:12:30,Bilbao,expenses,repairs,-52.68,-1567.33
buyer_1,Aitor,López,1996-08-10,84942326Z,aitor.lopez@smartcode.org,563227,ES02209563310500830014,3761.2,2022-03-31T20:22:09,Bilbao,expenses,food,-82.18,-1649.51
buyer_1,Aitor,López,1996-08-10,84942326Z,aitor.lopez@smartcode.org,563227,ES02209563310500830014,3761.2,2022-04-01T20:04:12,Bilbao,incomes,salary,552.89,-1096.62
buyer_1,Aitor,López,1996-08-10,84942326Z,aitor.lopez@smartcode.org,563227,ES02209563310500830014,3761.2,2022-04-01T20:04:12,Bilbao,incomes,extra_income,102.64,-993.98
buyer_1,Aitor,López,1996-08-10,84942326Z,aitor.lopez@smartcode.org,563227,ES02209563310500830014,3761.2,2022-04-01T08:52:54,Bilbao,expenses,cash,-100.0,-1093.98
buyer_1,Aitor,López,1996-08-10,84942326Z,aitor.lopez@smartcode.org,563227,ES02209563310500830014,3761.2,2022-04-03T16:28:37,Bilbao,expenses,food,-71.38,-1165.36
buyer_1,Aitor,López,1996-08-10,84942326Z,aitor.lopez@smartcode.org,563227,ES02209563310500830014,3761.2,2022-04-03T05:22:49,Bilbao,expenses,cash,-100.0,-1265.36
buyer_1,Aitor,López,1996-08-10,84942326Z,aitor.lopez@smartcode.org,563227,ES02209563310500830014,3761.2,2022-04-04T15:30:50,Bilbao,expenses,leisure,-19.94,-1285.3
buyer_1,Aitor,López,1996-08-10,84942326Z,aitor.lopez@smartcode.org,563227,ES02209563310500830014,3761.2,2022-04-05T11:17:46,Bilbao,expenses,rent,-183.87,-1469.17
buyer_1,Aitor,López,1996-08-10,84942326Z,aitor.lopez@smartcode.org,563227,ES02209563310500830014,3761.2,2022-04-05T10:04:37,Bilbao,expenses,water,-10.04,-1479.21
buyer_1,Aitor,López,1996-08-10,84942326Z,aitor.lopez@smartcode.org,563227,ES02209563310500830014,3761.2,2022-04-06T17:29:12,Bilbao,expenses,transport,-75.52,-1554.73
buyer_1,Aitor,López,1996-08-10,84942326Z,aitor.lopez@smartcode.org,563227,ES02209563310500830014,3761.2,2022-04-06T09:14:46,Bilbao,expenses,leisure,-77.29,-1632.02
buyer_1,Aitor,López,1996-08-10,84942326Z,aitor.lopez@smartcode.org,563227,ES02209563310500830014,3761.2,2022-04-08T16:05:05,Bilbao,expenses,food,-95.9,-1727.92
buyer_1,Aitor,López,1996-08-10,84942326Z,aitor.lopez@smartcode.org,563227,ES02209563310500830014,3761.2,2022-04-09T14:02:39,Bilbao,expenses,cash,-100.0,-1827.92
buyer_1,Aitor,López,1996-08-10,84942326Z,aitor.lopez@smartcode.org,563227,ES02209563310500830014,3761.2,2022-04-10T20:17:33,Bilbao,expenses,cash,-100.0,-1927.92
buyer_1,Aitor,López,1996-08-10,84942326Z,aitor.lopez@smartcode.org,563227,ES02209563310500830014,3761.2,2022-04-11T08:09:23,Bilbao,expenses,cash,-100.0,-2027.92
buyer_1,Aitor,López,1996-08-10,84942326Z,aitor.lopez@smartcode.org,563227,ES02209563310500830014,3761.2,2022-04-12T10:50:00,Bilbao,expenses,leisure,-51.05,-2078.97
buyer_1,Aitor,López,1996-08-10,84942326Z,aitor.lopez@smartcode.org,563227,ES02209563310500830014,3761.2,2022-04-17T14:37:47,Bilbao,expenses,cash,-100.0,-2178.97
buyer_1,Aitor,López,1996-08-10,84942326Z,aitor.lopez@smartcode.org,563227,ES02209563310500830014,3761.2,2022-04-18T12:52:09,Bilbao,expenses,transport,-40.17,-2219.14
buyer_1,Aitor,López,1996-08-10,84942326Z,aitor.lopez@smartcode.org,563227,ES02209563310500830014,3761.2,2022-04-19T09:48:07,Bilbao,expenses,leisure,-74.23,-2293.37
buyer_1,Aitor,López,1996-08-10,84942326Z,aitor.lopez@smartcode.org,563227,ES02209563310500830014,3761.2,2022-04-19T18:26:42,Bilbao,expenses,appliances,-144.1,-2437.47
buyer_1,Aitor,López,1996-08-10,84942326Z,aitor.lopez@smartcode.org,563227,ES02209563310500830014,3761.2,2022-04-20T13:10:51,Bilbao,expenses,leisure,-54.88,-2492.35
buyer_1,Aitor,López,1996-08-10,84942326Z,aitor.lopez@smartcode.org,563227,ES02209563310500830014,3761.2,2022-04-20T16:36:26,Bilbao,expenses,appliances,-88.64,-2580.99
buyer_1,Aitor,López,1996-08-10,84942326Z,aitor.lopez@smartcode.org,563227,ES02209563310500830014,3761.2,2022-04-24T13:54:54,Bilbao,expenses,food,-90.95,-2671.94
buyer_1,Aitor,López,1996-08-10,84942326Z,aitor.lopez@smartcode.org,563227,ES02209563310500830014,3761.2,2022-04-25T00:48:38,Bilbao,expenses,transport,-69.02,-2740.96
buyer_1,Aitor,López,1996-08-10,84942326Z,aitor.lopez@smartcode.org,563227,ES02209563310500830014,3761.2,2022-04-26T15:53:31,Bilbao,expenses,leisure,-60.94,-2801.9
buyer_1,Aitor,López,1996-08-10,84942326Z,aitor.lopez@smartcode.org,563227,ES02209563310500830014,3761.2,2022-04-26T13:13:38,Bilbao,expenses,cash,-100.0,-2901.9
buyer_1,Aitor,López,1996-08-10,84942326Z,aitor.lopez@smartcode.org,563227,ES02209563310500830014,3761.2,2022-04-26T16:23:01,Bilbao,expenses,appliances,-67.6,-2969.5
buyer_1,Aitor,López,1996-08-10,84942326Z,aitor.lopez@smartcode.org,563227,ES02209563310500830014,3761.2,2022-04-27T09:33:56,Bilbao,expenses,healthcare,-85.11,-3054.61
buyer_1,Aitor,López,1996-08-10,84942326Z,aitor.lopez@smartcode.org,563227,ES02209563310500830014,3761.2,2022-04-28T19:53:42,Bilbao,expenses,food,-83.42,-3138.03
buyer_1,Aitor,López,1996-08-10,84942326Z,aitor.lopez@smartcode.org,563227,ES02209563310500830014,3761.2,2022-04-28T23:01:57,Bilbao,expenses,cash,-100.0,-3238.03
buyer_1,Aitor,López,1996-08-10,84942326Z,aitor.lopez@smartcode.org,563227,ES02209563310500830014,3761.2,2022-05-01T07:06:44,Bilbao,incomes,salary,552.89,-2685.14
buyer_1,Aitor,López,1996-08-10,84942326Z,aitor.lopez@smartcode.org,563227,ES02209563310500830014,3761.2,2022-05-02T18:43:27,Bilbao,expenses,cash,-100.0,-2785.14
buyer_1,Aitor,López,1996-08-10,84942326Z,aitor.lopez@smartcode.org,563227,ES02209563310500830014,3761.2,2022-05-03T20:54:43,Bilbao,expenses,cash,-100.0,-2885.14
buyer_1,Aitor,López,1996-08-10,84942326Z,aitor.lopez@smartcode.org,563227,ES02209563310500830014,3761.2,2022-05-03T17:31:59,Bilbao,expenses,repairs,-67.23,-2952.37
buyer_1,Aitor,López,1996-08-10,84942326Z,aitor.lopez@smartcode.org,563227,ES02209563310500830014,3761.2,2022-05-04T14:29:22,Bilbao,expenses,transport,-42.78,-2995.15
buyer_1,Aitor,López,1996-08-10,84942326Z,aitor.lopez@smartcode.org,563227,ES02209563310500830014,3761.2,2022-05-05T22:44:43,Bilbao,expenses,rent,-183.87,-3179.02
buyer_1,Aitor,López,1996-08-10,84942326Z,aitor.lopez@smartcode.org,563227,ES02209563310500830014,3761.2,2022-05-05T17:20:33,Bilbao,expenses,leisure,-40.65,-3219.67
buyer_1,Aitor,López,1996-08-10,84942326Z,aitor.lopez@smartcode.org,563227,ES02209563310500830014,3761.2,2022-05-06T17:01:06,Bilbao,expenses,water,-6.71,-3226.38
buyer_1,Aitor,López,1996-08-10,84942326Z,aitor.lopez@smartcode.org,563227,ES02209563310500830014,3761.2,2022-05-06T17:32:12,Bilbao,expenses,internet,-11.61,-3237.99
buyer_1,Aitor,López,1996-08-10,84942326Z,aitor.lopez@smartcode.org,563227,ES02209563310500830014,3761.2,2022-05-06T16:52:52,Bilbao,expenses,phone,-11.05,-3249.04
buyer_1,Aitor,López,1996-08-10,84942326Z,aitor.lopez@smartcode.org,563227,ES02209563310500830014,3761.2,2022-05-06T09:46:40,Bilbao,expenses,repairs,-185.41,-3434.45
buyer_1,Aitor,López,1996-08-10,84942326Z,aitor.lopez@smartcode.org,563227,ES02209563310500830014,3761.2,2022-05-07T00:31:14,Bilbao,expenses,electricity,-6.75,-3441.2
buyer_1,Aitor,López,1996-08-10,84942326Z,aitor.lopez@smartcode.org,563227,ES02209563310500830014,3761.2,2022-05-07T18:08:06,Bilbao,expenses,phone,-9.54,-3450.74
buyer_1,Aitor,López,1996-08-10,84942326Z,aitor.lopez@smartcode.org,563227,ES02209563310500830014,3761.2,2022-05-08T02:17:15,Bilbao,expenses,internet,-11.61,-3462.35
buyer_1,Aitor,López,1996-08-10,84942326Z,aitor.lopez@smartcode.org,563227,ES02209563310500830014,3761.2,2022-05-08T09:46:35,Bilbao,expenses,phone,-11.57,-3473.92
buyer_1,Aitor,López,1996-08-10,84942326Z,aitor.lopez@smartcode.org,563227,ES02209563310500830014,3761.2,2022-05-08T14:11:40,Bilbao,expenses,travel,-236.2,-3710.12
buyer_1,Aitor,López,1996-08-10,84942326Z,aitor.lopez@smartcode.org,563227,ES02209563310500830014,3761.2,2022-05-12T10:43:35,Bilbao,expenses,food,-74.89,-3785.01
buyer_1,Aitor,López,1996-08-10,84942326Z,aitor.lopez@smartcode.org,563227,ES02209563310500830014,3761.2,2022-05-13T14:08:09,Bilbao,expenses,leisure,-34.77,-3819.78
buyer_1,Aitor,López,1996-08-10,84942326Z,aitor.lopez@smartcode.org,563227,ES02209563310500830014,3761.2,2022-05-16T15:44:34,Bilbao,expenses,healthcare,-56.69,-3876.47
buyer_1,Aitor,López,1996-08-10,84942326Z,aitor.lopez@smartcode.org,563227,ES02209563310500830014,3761.2,2022-05-17T11:09:06,Bilbao,expenses,cash,-100.0,-3976.47
buyer_1,Aitor,López,1996-08-10,84942326Z,aitor.lopez@smartcode.org,563227,ES02209563310500830014,3761.2,2022-05-18T20:07:52,Bilbao,expenses,education,-66.55,-4043.02
buyer_1,Aitor,López,1996-08-10,84942326Z,aitor.lopez@smartcode.org,563227,ES02209563310500830014,3761.2,2022-05-18T11:51:39,Bilbao,expenses,cash,-100.0,-4143.02
buyer_1,Aitor,López,1996-08-10,84942326Z,aitor.lopez@smartcode.org,563227,ES02209563310500830014,3761.2,2022-05-19T14:25:55,Bilbao,expenses,gifts,-67.11,-4210.13
buyer_1,Aitor,López,1996-08-10,84942326Z,aitor.lopez@smartcode.org,563227,ES02209563310500830014,3761.2,2022-05-20T10:50:13,Bilbao,expenses,leisure,-51.2,-4261.33
buyer_1,Aitor,López,1996-08-10,84942326Z,aitor.lopez@smartcode.org,563227,ES02209563310500830014,3761.2,2022-05-22T17:03:46,Bilbao,expenses,clothing,-105.28,-4366.61
buyer_1,Aitor,López,1996-08-10,84942326Z,aitor.lopez@smartcode.org,563227,ES02209563310500830014,3761.2,2022-05-22T11:06:07,Bilbao,expenses,gifts,-90.08,-4456.69
buyer_1,Aitor,López,1996-08-10,84942326Z,aitor.lopez@smartcode.org,563227,ES02209563310500830014,3761.2,2022-05-23T23:51:25,Bilbao,expenses,cash,-100.0,-4556.69
buyer_1,Aitor,López,1996-08-10,84942326Z,aitor.lopez@smartcode.org,563227,ES02209563310500830014,3761.2,2022-05-24T18:18:21,Bilbao,expenses,food,-91.98,-4648.67
buyer_1,Aitor,López,1996-08-10,84942326Z,aitor.lopez@smartcode.org,563227,ES02209563310500830014,3761.2,2022-05-26T21:10:51,Bilbao,expenses,food,-97.71,-4746.38
buyer_1,Aitor,López,1996-08-10,84942326Z,aitor.lopez@smartcode.org,563227,ES02209563310500830014,3761.2,2022-05-29T12:24:06,Bilbao,expenses,leisure,-46.37,-4792.75
buyer_1,Aitor,López,1996-08-10,84942326Z,aitor.lopez@smartcode.org,563227,ES02209563310500830014,3761.2,2022-06-01T16:34:34,Bilbao,incomes,salary,552.89,-4239.86
buyer_1,Aitor,López,1996-08-10,84942326Z,aitor.lopez@smartcode.org,563227,ES02209563310500830014,3761.2,2022-06-01T16:34:34,Bilbao,incomes,salary_bonus,433.98,-3805.88
buyer_1,Aitor,López,1996-08-10,84942326Z,aitor.lopez@smartcode.org,563227,ES02209563310500830014,3761.2,2022-06-01T11:58:49,Bilbao,expenses,food,-65.75,-3871.63
buyer_1,Aitor,López,1996-08-10,84942326Z,aitor.lopez@smartcode.org,563227,ES02209563310500830014,3761.2,2022-06-03T12:07:09,Bilbao,expenses,taxes,-415.27,-4286.9
buyer_1,Aitor,López,1996-08-10,84942326Z,aitor.lopez@smartcode.org,563227,ES02209563310500830014,3761.2,2022-06-03T16:16:33,Bilbao,expenses,insurance,-161.38,-4448.28
buyer_1,Aitor,López,1996-08-10,84942326Z,aitor.lopez@smartcode.org,563227,ES02209563310500830014,3761.2,2022-06-03T10:01:33,Bilbao,expenses,leisure,-22.41,-4470.69
buyer_1,Aitor,López,1996-08-10,84942326Z,aitor.lopez@smartcode.org,563227,ES02209563310500830014,3761.2,2022-06-03T23:44:51,Bilbao,expenses,cash,-100.0,-4570.69
buyer_1,Aitor,López,1996-08-10,84942326Z,aitor.lopez@smartcode.org,563227,ES02209563310500830014,3761.2,2022-06-04T13:00:54,Bilbao,expenses,food,-89.22,-4659.91
buyer_1,Aitor,López,1996-08-10,84942326Z,aitor.lopez@smartcode.org,563227,ES02209563310500830014,3761.2,2022-06-04T08:34:20,Bilbao,expenses,appliances,-107.87,-4767.78
buyer_1,Aitor,López,1996-08-10,84942326Z,aitor.lopez@smartcode.org,563227,ES02209563310500830014,3761.2,2022-06-05T04:45:36,Bilbao,expenses,rent,-183.87,-4951.65
buyer_1,Aitor,López,1996-08-10,84942326Z,aitor.lopez@smartcode.org,563227,ES02209563310500830014,3761.2,2022-06-05T16:42:03,Bilbao,expenses,water,-7.24,-4958.89
buyer_1,Aitor,López,1996-08-10,84942326Z,aitor.lopez@smartcode.org,563227,ES02209563310500830014,3761.2,2022-06-05T09:34:58,Bilbao,expenses,leisure,-43.28,-5002.17
buyer_1,Aitor,López,1996-08-10,84942326Z,aitor.lopez@smartcode.org,563227,ES02209563310500830014,3761.2,2022-06-05T18:48:06,Bilbao,expenses,cash,-100.0,-5102.17
buyer_1,Aitor,López,1996-08-10,84942326Z,aitor.lopez@smartcode.org,563227,ES02209563310500830014,3761.2,2022-06-05T14:24:24,Bilbao,expenses,appliances,-81.13,-5183.3
buyer_1,Aitor,López,1996-08-10,84942326Z,aitor.lopez@smartcode.org,563227,ES02209563310500830014,3761.2,2022-06-06T20:04:12,Bilbao,expenses,water,-9.97,-5193.27
buyer_1,Aitor,López,1996-08-10,84942326Z,aitor.lopez@smartcode.org,563227,ES02209563310500830014,3761.2,2022-06-07T11:21:29,Bilbao,expenses,gas,-15.39,-5208.66
buyer_1,Aitor,López,1996-08-10,84942326Z,aitor.lopez@smartcode.org,563227,ES02209563310500830014,3761.2,2022-06-07T19:00:09,Bilbao,expenses,phone,-10.63,-5219.29
buyer_1,Aitor,López,1996-08-10,84942326Z,aitor.lopez@smartcode.org,563227,ES02209563310500830014,3761.2,2022-06-08T11:21:03,Bilbao,expenses,water,-10.14,-5229.43
buyer_1,Aitor,López,1996-08-10,84942326Z,aitor.lopez@smartcode.org,563227,ES02209563310500830014,3761.2,2022-06-08T16:42:38,Bilbao,expenses,gas,-19.65,-5249.08
buyer_1,Aitor,López,1996-08-10,84942326Z,aitor.lopez@smartcode.org,563227,ES02209563310500830014,3761.2,2022-06-10T18:55:24,Bilbao,expenses,cash,-100.0,-5349.08
buyer_1,Aitor,López,1996-08-10,84942326Z,aitor.lopez@smartcode.org,563227,ES02209563310500830014,3761.2,2022-06-11T11:08:36,Bilbao,expenses,food,-60.66,-5409.74
buyer_1,Aitor,López,1996-08-10,84942326Z,aitor.lopez@smartcode.org,563227,ES02209563310500830014,3761.2,2022-06-11T20:45:57,Bilbao,expenses,leisure,-44.61,-5454.35
buyer_1,Aitor,López,1996-08-10,84942326Z,aitor.lopez@smartcode.org,563227,ES02209563310500830014,3761.2,2022-06-11T11:23:34,Bilbao,expenses,clothing,-85.84,-5540.19
buyer_1,Aitor,López,1996-08-10,84942326Z,aitor.lopez@smartcode.org,563227,ES02209563310500830014,3761.2,2022-06-12T14:39:23,Bilbao,expenses,food,-71.6,-5611.79
buyer_1,Aitor,López,1996-08-10,84942326Z,aitor.lopez@smartcode.org,563227,ES02209563310500830014,3761.2,2022-06-12T09:34:52,Bilbao,expenses,healthcare,-54.7,-5666.49
buyer_1,Aitor,López,1996-08-10,84942326Z,aitor.lopez@smartcode.org,563227,ES02209563310500830014,3761.2,2022-06-12T20:47:48,Bilbao,expenses,gifts,-69.3,-5735.79
buyer_1,Aitor,López,1996-08-10,84942326Z,aitor.lopez@smartcode.org,563227,ES02209563310500830014,3761.2,2022-06-13T11:11:44,Bilbao,expenses,food,-63.37,-5799.16
buyer_1,Aitor,López,1996-08-10,84942326Z,aitor.lopez@smartcode.org,563227,ES02209563310500830014,3761.2,2022-06-13T18:22:01,Bilbao,expenses,education,-64.4,-5863.56
buyer_1,Aitor,López,1996-08-10,84942326Z,aitor.lopez@smartcode.org,563227,ES02209563310500830014,3761.2,2022-06-13T20:00:31,Bilbao,expenses,repairs,-64.14,-5927.7
buyer_1,Aitor,López,1996-08-10,84942326Z,aitor.lopez@smartcode.org,563227,ES02209563310500830014,3761.2,2022-06-14T08:08:33,Bilbao,expenses,transport,-74.37,-6002.07
buyer_1,Aitor,López,1996-08-10,84942326Z,aitor.lopez@smartcode.org,563227,ES02209563310500830014,3761.2,2022-06-18T18:46:54,Bilbao,expenses,repairs,-199.95,-6202.02
buyer_1,Aitor,López,1996-08-10,84942326Z,aitor.lopez@smartcode.org,563227,ES02209563310500830014,3761.2,2022-06-19T22:50:12,Bilbao,expenses,cash,-100.0,-6302.02
buyer_1,Aitor,López,1996-08-10,84942326Z,aitor.lopez@smartcode.org,563227,ES02209563310500830014,3761.2,2022-06-20T15:44:08,Bilbao,expenses,transport,-70.39,-6372.41
buyer_1,Aitor,López,1996-08-10,84942326Z,aitor.lopez@smartcode.org,563227,ES02209563310500830014,3761.2,2022-06-21T14:13:55,Bilbao,expenses,transport,-78.19,-6450.6
buyer_1,Aitor,López,1996-08-10,84942326Z,aitor.lopez@smartcode.org,563227,ES02209563310500830014,3761.2,2022-06-22T16:11:52,Bilbao,expenses,transport,-60.61,-6511.21
buyer_1,Aitor,López,1996-08-10,84942326Z,aitor.lopez@smartcode.org,563227,ES02209563310500830014,3761.2,2022-06-24T17:20:31,Bilbao,expenses,transport,-65.49,-6576.7
buyer_1,Aitor,López,1996-08-10,84942326Z,aitor.lopez@smartcode.org,563227,ES02209563310500830014,3761.2,2022-06-25T12:56:59,Bilbao,expenses,transport,-79.52,-6656.22
buyer_1,Aitor,López,1996-08-10,84942326Z,aitor.lopez@smartcode.org,563227,ES02209563310500830014,3761.2,2022-06-25T11:21:28,Bilbao,expenses,cash,-100.0,-6756.22
buyer_1,Aitor,López,1996-08-10,84942326Z,aitor.lopez@smartcode.org,563227,ES02209563310500830014,3761.2,2022-06-28T09:27:43,Bilbao,expenses,food,-82.85,-6839.07
buyer_1,Aitor,López,1996-08-10,84942326Z,aitor.lopez@smartcode.org,563227,ES02209563310500830014,3761.2,2022-06-28T14:36:27,Bilbao,expenses,repairs,-101.76,-6940.83
buyer_1,Aitor,López,1996-08-10,84942326Z,aitor.lopez@smartcode.org,563227,ES02209563310500830014,3761.2,2022-06-29T21:05:18,Bilbao,expenses,transport,-62.11,-7002.94
buyer_1,Aitor,López,1996-08-10,84942326Z,aitor.lopez@smartcode.org,563227,ES02209563310500830014,3761.2,2022-06-29T13:21:20,Bilbao,expenses,gifts,-106.18,-7109.12
buyer_1,Aitor,López,1996-08-10,84942326Z,aitor.lopez@smartcode.org,563227,ES02209563310500830014,3761.2,2022-06-30T08:12:51,Bilbao,expenses,repairs,-86.44,-7195.56
buyer_1,Aitor,López,1996-08-10,84942326Z,aitor.lopez@smartcode.org,563227,ES02209563310500830014,3761.2,2022-07-01T14:27:32,Bilbao,incomes,salary,552.89,-6642.67
buyer_1,Aitor,López,1996-08-10,84942326Z,aitor.lopez@smartcode.org,563227,ES02209563310500830014,3761.2,2022-07-01T14:27:32,Bilbao,incomes,extra_income,102.64,-6540.03
buyer_1,Aitor,López,1996-08-10,84942326Z,aitor.lopez@smartcode.org,563227,ES02209563310500830014,3761.2,2022-07-02T23:43:35,Bilbao,expenses,food,-85.38,-6625.41
buyer_1,Aitor,López,1996-08-10,84942326Z,aitor.lopez@smartcode.org,563227,ES02209563310500830014,3761.2,2022-07-03T16:54:07,Bilbao,expenses,repairs,-153.52,-6778.93
buyer_1,Aitor,López,1996-08-10,84942326Z,aitor.lopez@smartcode.org,563227,ES02209563310500830014,3761.2,2022-07-05T08:13:29,Bilbao,expenses,rent,-183.87,-6962.8
buyer_1,Aitor,López,1996-08-10,84942326Z,aitor.lopez@smartcode.org,563227,ES02209563310500830014,3761.2,2022-07-05T11:30:06,Bilbao,expenses,water,-9.29,-6972.09
buyer_1,Aitor,López,1996-08-10,84942326Z,aitor.lopez@smartcode.org,563227,ES02209563310500830014,3761.2,2022-07-05T20:18:28,Bilbao,expenses,internet,-11.61,-6983.7
buyer_1,Aitor,López,1996-08-10,84942326Z,aitor.lopez@smartcode.org,563227,ES02209563310500830014,3761.2,2022-07-05T20:46:38,Bilbao,expenses,food,-96.3,-7080.0
buyer_1,Aitor,López,1996-08-10,84942326Z,aitor.lopez@smartcode.org,563227,ES02209563310500830014,3761.2,2022-07-05T14:44:30,Bilbao,expenses,leisure,-38.57,-7118.57
buyer_1,Aitor,López,1996-08-10,84942326Z,aitor.lopez@smartcode.org,563227,ES02209563310500830014,3761.2,2022-07-06T13:22:05,Bilbao,expenses,water,-6.5,-7125.07
buyer_1,Aitor,López,1996-08-10,84942326Z,aitor.lopez@smartcode.org,563227,ES02209563310500830014,3761.2,2022-07-06T15:04:27,Bilbao,expenses,gas,-28.72,-7153.79
buyer_1,Aitor,López,1996-08-10,84942326Z,aitor.lopez@smartcode.org,563227,ES02209563310500830014,3761.2,2022-07-06T17:55:05,Bilbao,expenses,internet,-11.61,-7165.4
buyer_1,Aitor,López,1996-08-10,84942326Z,aitor.lopez@smartcode.org,563227,ES02209563310500830014,3761.2,2022-07-06T12:54:40,Bilbao,expenses,transport,-54.72,-7220.12
buyer_1,Aitor,López,1996-08-10,84942326Z,aitor.lopez@smartcode.org,563227,ES02209563310500830014,3761.2,2022-07-06T15:52:00,Bilbao,expenses,cash,-100.0,-7320.12
buyer_1,Aitor,López,1996-08-10,84942326Z,aitor.lopez@smartcode.org,563227,ES02209563310500830014,3761.2,2022-07-07T14:48:49,Bilbao,expenses,electricity,-16.34,-7336.46
buyer_1,Aitor,López,1996-08-10,84942326Z,aitor.lopez@smartcode.org,563227,ES02209563310500830014,3761.2,2022-07-07T09:06:23,Bilbao,expenses,food,-108.73,-7445.19
buyer_1,Aitor,López,1996-08-10,84942326Z,aitor.lopez@smartcode.org,563227,ES02209563310500830014,3761.2,2022-07-07T19:12:24,Bilbao,expenses,cash,-100.0,-7545.19
buyer_1,Aitor,López,1996-08-10,84942326Z,aitor.lopez@smartcode.org,563227,ES02209563310500830014,3761.2,2022-07-08T12:29:48,Bilbao,expenses,transport,-58.31,-7603.5
buyer_1,Aitor,López,1996-08-10,84942326Z,aitor.lopez@smartcode.org,563227,ES02209563310500830014,3761.2,2022-07-09T02:02:29,Bilbao,expenses,food,-68.37,-7671.87
buyer_1,Aitor,López,1996-08-10,84942326Z,aitor.lopez@smartcode.org,563227,ES02209563310500830014,3761.2,2022-07-11T19:48:27,Bilbao,expenses,transport,-74.37,-7746.24
buyer_1,Aitor,López,1996-08-10,84942326Z,aitor.lopez@smartcode.org,563227,ES02209563310500830014,3761.2,2022-07-13T13:41:22,Bilbao,expenses,food,-69.08,-7815.32
buyer_1,Aitor,López,1996-08-10,84942326Z,aitor.lopez@smartcode.org,563227,ES02209563310500830014,3761.2,2022-07-15T11:55:10,Bilbao,expenses,education,-47.31,-7862.63
buyer_1,Aitor,López,1996-08-10,84942326Z,aitor.lopez@smartcode.org,563227,ES02209563310500830014,3761.2,2022-07-16T18:52:00,Bilbao,expenses,food,-95.08,-7957.71
buyer_1,Aitor,López,1996-08-10,84942326Z,aitor.lopez@smartcode.org,563227,ES02209563310500830014,3761.2,2022-07-17T18:33:29,Bilbao,expenses,leisure,-37.22,-7994.93
buyer_1,Aitor,López,1996-08-10,84942326Z,aitor.lopez@smartcode.org,563227,ES02209563310500830014,3761.2,2022-07-18T08:22:20,Bilbao,expenses,education,-68.6,-8063.53
buyer_1,Aitor,López,1996-08-10,84942326Z,aitor.lopez@smartcode.org,563227,ES02209563310500830014,3761.2,2022-07-19T18:16:51,Bilbao,expenses,food,-99.79,-8163.32
buyer_1,Aitor,López,1996-08-10,84942326Z,aitor.lopez@smartcode.org,563227,ES02209563310500830014,3761.2,2022-07-20T10:15:48,Bilbao,expenses,food,-95.63,-8258.95
buyer_1,Aitor,López,1996-08-10,84942326Z,aitor.lopez@smartcode.org,563227,ES02209563310500830014,3761.2,2022-07-21T14:11:12,Bilbao,expenses,transport,-80.92,-8339.87
buyer_1,Aitor,López,1996-08-10,84942326Z,aitor.lopez@smartcode.org,563227,ES02209563310500830014,3761.2,2022-07-23T11:27:28,Bilbao,expenses,repairs,-57.12,-8396.99
buyer_1,Aitor,López,1996-08-10,84942326Z,aitor.lopez@smartcode.org,563227,ES02209563310500830014,3761.2,2022-07-26T12:30:43,Bilbao,expenses,repairs,-84.91,-8481.9
buyer_1,Aitor,López,1996-08-10,84942326Z,aitor.lopez@smartcode.org,563227,ES02209563310500830014,3761.2,2022-07-29T08:53:50,Bilbao,expenses,transport,-50.51,-8532.41
buyer_1,Aitor,López,1996-08-10,84942326Z,aitor.lopez@smartcode.org,563227,ES02209563310500830014,3761.2,2022-07-29T16:56:31,Bilbao,expenses,repairs,-78.17,-8610.58
buyer_1,Aitor,López,1996-08-10,84942326Z,aitor.lopez@smartcode.org,563227,ES02209563310500830014,3761.2,2022-07-30T10:13:53,Bilbao,expenses,transport,-78.24,-8688.82
buyer_1,Aitor,López,1996-08-10,84942326Z,aitor.lopez@smartcode.org,563227,ES02209563310500830014,3761.2,2022-07-30T13:33:13,Bilbao,expenses,cash,-100.0,-8788.82
buyer_1,Aitor,López,1996-08-10,84942326Z,aitor.lopez@smartcode.org,563227,ES02209563310500830014,3761.2,2022-07-30T16:14:03,Bilbao,expenses,travel,-191.62,-8980.44
buyer_1,Aitor,López,1996-08-10,84942326Z,aitor.lopez@smartcode.org,563227,ES02209563310500830014,3761.2,2022-07-31T19:40:59,Bilbao,expenses,healthcare,-56.23,-9036.67
buyer_1,Aitor,López,1996-08-10,84942326Z,aitor.lopez@smartcode.org,563227,ES02209563310500830014,3761.2,2022-07-31T18:51:29,Bilbao,expenses,appliances,-111.98,-9148.65
buyer_1,Aitor,López,1996-08-10,84942326Z,aitor.lopez@smartcode.org,563227,ES02209563310500830014,3761.2,2022-08-01T18:10:41,Bilbao,incomes,salary,552.89,-8595.76
buyer_1,Aitor,López,1996-08-10,84942326Z,aitor.lopez@smartcode.org,563227,ES02209563310500830014,3761.2,2022-08-02T08:10:00,Bilbao,expenses,cash,-100.0,-8695.76
buyer_1,Aitor,López,1996-08-10,84942326Z,aitor.lopez@smartcode.org,563227,ES02209563310500830014,3761.2,2022-08-03T06:48:45,Bilbao,expenses,cash,-100.0,-8795.76
buyer_1,Aitor,López,1996-08-10,84942326Z,aitor.lopez@smartcode.org,563227,ES02209563310500830014,3761.2,2022-08-04T16:53:45,Bilbao,expenses,education,-76.91,-8872.67
buyer_1,Aitor,López,1996-08-10,84942326Z,aitor.lopez@smartcode.org,563227,ES02209563310500830014,3761.2,2022-08-04T08:54:20,Bilbao,expenses,repairs,-134.09,-9006.76
buyer_1,Aitor,López,1996-08-10,84942326Z,aitor.lopez@smartcode.org,563227,ES02209563310500830014,3761.2,2022-08-05T10:58:56,Bilbao,expenses,rent,-183.87,-9190.63
buyer_1,Aitor,López,1996-08-10,84942326Z,aitor.lopez@smartcode.org,563227,ES02209563310500830014,3761.2,2022-08-05T13:31:51,Bilbao,expenses,electricity,-21.85,-9212.48
buyer_1,Aitor,López,1996-08-10,84942326Z,aitor.lopez@smartcode.org,563227,ES02209563310500830014,3761.2,2022-08-05T09:48:26,Bilbao,expenses,internet,-11.61,-9224.09
buyer_1,Aitor,López,1996-08-10,84942326Z,aitor.lopez@smartcode.org,563227,ES02209563310500830014,3761.2,2022-08-05T23:15:16,Bilbao,expenses,phone,-8.59,-9232.68
buyer_1,Aitor,López,1996-08-10,84942326Z,aitor.lopez@smartcode.org,563227,ES02209563310500830014,3761.2,2022-08-06T04:36:55,Bilbao,expenses,water,-7.31,-9239.99
buyer_1,Aitor,López,1996-08-10,84942326Z,aitor.lopez@smartcode.org,563227,ES02209563310500830014,3761.2,2022-08-06T13:35:37,Bilbao,expenses,travel,-264.75,-9504.74
buyer_1,Aitor,López,1996-08-10,84942326Z,aitor.lopez@smartcode.org,563227,ES02209563310500830014,3761.2,2022-08-07T09:32:59,Bilbao,expenses,water,-10.78,-9515.52
buyer_1,Aitor,López,1996-08-10,84942326Z,aitor.lopez@smartcode.org,563227,ES02209563310500830014,3761.2,2022-08-07T22:36:47,Bilbao,expenses,electricity,-10.46,-9525.98
buyer_1,Aitor,López,1996-08-10,84942326Z,aitor.lopez@smartcode.org,563227,ES02209563310500830014,3761.2,2022-08-08T05:17:15,Bilbao,expenses,transport,-53.0,-9578.98
buyer_1,Aitor,López,1996-08-10,84942326Z,aitor.lopez@smartcode.org,563227,ES02209563310500830014,3761.2,2022-08-12T02:48:01,Bilbao,expenses,clothing,-147.09,-9726.07
buyer_1,Aitor,López,1996-08-10,84942326Z,aitor.lopez@smartcode.org,563227,ES02209563310500830014,3761.2,2022-08-14T14:19:52,Bilbao,expenses,food,-113.27,-9839.34
buyer_1,Aitor,López,1996-08-10,84942326Z,aitor.lopez@smartcode.org,563227,ES02209563310500830014,3761.2,2022-08-14T15:38:40,Bilbao,expenses,cash,-100.0,-9939.34
buyer_1,Aitor,López,1996-08-10,84942326Z,aitor.lopez@smartcode.org,563227,ES02209563310500830014,3761.2,2022-08-15T14:32:19,Bilbao,expenses,transport,-85.28,-10024.62
buyer_1,Aitor,López,1996-08-10,84942326Z,aitor.lopez@smartcode.org,563227,ES02209563310500830014,3761.2,2022-08-15T20:39:52,Bilbao,expenses,cash,-100.0,-10124.62
buyer_1,Aitor,López,1996-08-10,84942326Z,aitor.lopez@smartcode.org,563227,ES02209563310500830014,3761.2,2022-08-15T20:30:03,Bilbao,expenses,repairs,-36.34,-10160.96
buyer_1,Aitor,López,1996-08-10,84942326Z,aitor.lopez@smartcode.org,563227,ES02209563310500830014,3761.2,2022-08-16T05:02:13,Bilbao,expenses,healthcare,-137.98,-10298.94
buyer_1,Aitor,López,1996-08-10,84942326Z,aitor.lopez@smartcode.org,563227,ES02209563310500830014,3761.2,2022-08-17T14:50:42,Bilbao,expenses,clothing,-141.0,-10439.94
buyer_1,Aitor,López,1996-08-10,84942326Z,aitor.lopez@smartcode.org,563227,ES02209563310500830014,3761.2,2022-08-17T16:19:57,Bilbao,expenses,repairs,-51.24,-10491.18
buyer_1,Aitor,López,1996-08-10,84942326Z,aitor.lopez@smartcode.org,563227,ES02209563310500830014,3761.2,2022-08-21T15:44:18,Bilbao,expenses,leisure,-75.26,-10566.44
buyer_1,Aitor,López,1996-08-10,84942326Z,aitor.lopez@smartcode.org,563227,ES02209563310500830014,3761.2,2022-08-22T21:15:22,Bilbao,expenses,appliances,-144.42,-10710.86
buyer_1,Aitor,López,1996-08-10,84942326Z,aitor.lopez@smartcode.org,563227,ES02209563310500830014,3761.2,2022-08-24T18:46:42,Bilbao,expenses,food,-81.98,-10792.84
buyer_1,Aitor,López,1996-08-10,84942326Z,aitor.lopez@smartcode.org,563227,ES02209563310500830014,3761.2,2022-08-26T20:41:24,Bilbao,expenses,education,-65.26,-10858.1
buyer_1,Aitor,López,1996-08-10,84942326Z,aitor.lopez@smartcode.org,563227,ES02209563310500830014,3761.2,2022-08-27T20:59:16,Bilbao,expenses,food,-123.9,-10982.0
buyer_1,Aitor,López,1996-08-10,84942326Z,aitor.lopez@smartcode.org,563227,ES02209563310500830014,3761.2,2022-08-28T18:54:18,Bilbao,expenses,food,-109.97,-11091.97
buyer_1,Aitor,López,1996-08-10,84942326Z,aitor.lopez@smartcode.org,563227,ES02209563310500830014,3761.2,2022-08-31T14:30:34,Bilbao,expenses,healthcare,-126.48,-11218.45
buyer_1,Aitor,López,1996-08-10,84942326Z,aitor.lopez@smartcode.org,563227,ES02209563310500830014,3761.2,2022-09-01T11:26:25,Bilbao,incomes,salary,552.89,-10665.56
buyer_1,Aitor,López,1996-08-10,84942326Z,aitor.lopez@smartcode.org,563227,ES02209563310500830014,3761.2,2022-09-04T19:44:28,Bilbao,expenses,cash,-100.0,-10765.56
buyer_1,Aitor,López,1996-08-10,84942326Z,aitor.lopez@smartcode.org,563227,ES02209563310500830014,3761.2,2022-09-05T17:29:08,Bilbao,expenses,rent,-183.87,-10949.43
buyer_1,Aitor,López,1996-08-10,84942326Z,aitor.lopez@smartcode.org,563227,ES02209563310500830014,3761.2,2022-09-05T06:32:08,Bilbao,expenses,water,-5.73,-10955.16
buyer_1,Aitor,López,1996-08-10,84942326Z,aitor.lopez@smartcode.org,563227,ES02209563310500830014,3761.2,2022-09-05T20:36:32,Bilbao,expenses,leisure,-25.36,-10980.52
buyer_1,Aitor,López,1996-08-10,84942326Z,aitor.lopez@smartcode.org,563227,ES02209563310500830014,3761.2,2022-09-05T01:02:59,Bilbao,expenses,travel,-242.26,-11222.78
buyer_1,Aitor,López,1996-08-10,84942326Z,aitor.lopez@smartcode.org,563227,ES02209563310500830014,3761.2,2022-09-06T22:26:21,Bilbao,expenses,electricity,-24.29,-11247.07
buyer_1,Aitor,López,1996-08-10,84942326Z,aitor.lopez@smartcode.org,563227,ES02209563310500830014,3761.2,2022-09-06T18:19:51,Bilbao,expenses,gas,-13.65,-11260.72
buyer_1,Aitor,López,1996-08-10,84942326Z,aitor.lopez@smartcode.org,563227,ES02209563310500830014,3761.2,2022-09-07T23:08:00,Bilbao,expenses,gas,-16.47,-11277.19
buyer_1,Aitor,López,1996-08-10,84942326Z,aitor.lopez@smartcode.org,563227,ES02209563310500830014,3761.2,2022-09-07T20:09:52,Bilbao,expenses,repairs,-79.86,-11357.05
buyer_1,Aitor,López,1996-08-10,84942326Z,aitor.lopez@smartcode.org,563227,ES02209563310500830014,3761.2,2022-09-08T08:00:21,Bilbao,expenses,repairs,-146.77,-11503.82
buyer_1,Aitor,López,1996-08-10,84942326Z,aitor.lopez@smartcode.org,563227,ES02209563310500830014,3761.2,2022-09-10T11:51:18,Bilbao,expenses,healthcare,-173.25,-11677.07
buyer_1,Aitor,López,1996-08-10,84942326Z,aitor.lopez@smartcode.org,563227,ES02209563310500830014,3761.2,2022-09-11T18:31:53,Bilbao,expenses,repairs,-53.16,-11730.23
buyer_1,Aitor,López,1996-08-10,84942326Z,aitor.lopez@smartcode.org,563227,ES02209563310500830014,3761.2,2022-09-12T00:09:39,Bilbao,expenses,transport,-67.98,-11798.21
buyer_1,Aitor,López,1996-08-10,84942326Z,aitor.lopez@smartcode.org,563227,ES02209563310500830014,3761.2,2022-09-17T14:47:10,Bilbao,expenses,cash,-100.0,-11898.21
buyer_1,Aitor,López,1996-08-10,84942326Z,aitor.lopez@smartcode.org,563227,ES02209563310500830014,3761.2,2022-09-25T14:17:04,Bilbao,expenses,food,-91.15,-11989.36
buyer_1,Aitor,López,1996-08-10,84942326Z,aitor.lopez@smartcode.org,563227,ES02209563310500830014,3761.2,2022-09-26T09:31:08,Bilbao,expenses,food,-114.99,-12104.35
buyer_1,Aitor,López,1996-08-10,84942326Z,aitor.lopez@smartcode.org,563227,ES02209563310500830014,3761.2,2022-09-26T15:32:02,Bilbao,expenses,gifts,-88.96,-12193.31
buyer_1,Aitor,López,1996-08-10,84942326Z,aitor.lopez@smartcode.org,563227,ES02209563310500830014,3761.2,2022-09-27T16:59:45,Bilbao,expenses,food,-95.13,-12288.44
buyer_1,Aitor,López,1996-08-10,84942326Z,aitor.lopez@smartcode.org,563227,ES02209563310500830014,3761.2,2022-09-28T19:57:05,Bilbao,expenses,leisure,-21.99,-12310.43
buyer_1,Aitor,López,1996-08-10,84942326Z,aitor.lopez@smartcode.org,563227,ES02209563310500830014,3761.2,2022-09-30T13:05:58,Bilbao,expenses,transport,-58.06,-12368.49
buyer_1,Aitor,López,1996-08-10,84942326Z,aitor.lopez@smartcode.org,563227,ES02209563310500830014,3761.2,2022-10-01T16:52:24,Bilbao,incomes,salary,552.89,-11815.6
buyer_1,Aitor,López,1996-08-10,84942326Z,aitor.lopez@smartcode.org,563227,ES02209563310500830014,3761.2,2022-10-02T23:33:59,Bilbao,expenses,cash,-100.0,-11915.6
buyer_1,Aitor,López,1996-08-10,84942326Z,aitor.lopez@smartcode.org,563227,ES02209563310500830014,3761.2,2022-10-03T13:12:39,Bilbao,expenses,cash,-100.0,-12015.6
buyer_1,Aitor,López,1996-08-10,84942326Z,aitor.lopez@smartcode.org,563227,ES02209563310500830014,3761.2,2022-10-05T18:11:12,Bilbao,expenses,rent,-183.87,-12199.47
buyer_1,Aitor,López,1996-08-10,84942326Z,aitor.lopez@smartcode.org,563227,ES02209563310500830014,3761.2,2022-10-05T14:06:52,Bilbao,expenses,phone,-11.98,-12211.45
buyer_1,Aitor,López,1996-08-10,84942326Z,aitor.lopez@smartcode.org,563227,ES02209563310500830014,3761.2,2022-10-06T20:24:47,Bilbao,expenses,water,-8.67,-12220.12
buyer_1,Aitor,López,1996-08-10,84942326Z,aitor.lopez@smartcode.org,563227,ES02209563310500830014,3761.2,2022-10-06T15:05:54,Bilbao,expenses,internet,-11.61,-12231.73
buyer_1,Aitor,López,1996-08-10,84942326Z,aitor.lopez@smartcode.org,563227,ES02209563310500830014,3761.2,2022-10-06T09:21:48,Bilbao,expenses,education,-61.01,-12292.74
buyer_1,Aitor,López,1996-08-10,84942326Z,aitor.lopez@smartcode.org,563227,ES02209563310500830014,3761.2,2022-10-08T19:54:42,Bilbao,expenses,internet,-11.61,-12304.35
buyer_1,Aitor,López,1996-08-10,84942326Z,aitor.lopez@smartcode.org,563227,ES02209563310500830014,3761.2,2022-10-10T16:39:07,Bilbao,expenses,leisure,-81.29,-12385.64
buyer_1,Aitor,López,1996-08-10,84942326Z,aitor.lopez@smartcode.org,563227,ES02209563310500830014,3761.2,2022-10-10T10:49:40,Bilbao,expenses,repairs,-132.51,-12518.15
buyer_1,Aitor,López,1996-08-10,84942326Z,aitor.lopez@smartcode.org,563227,ES02209563310500830014,3761.2,2022-10-13T10:09:46,Bilbao,expenses,cash,-100.0,-12618.15
buyer_1,Aitor,López,1996-08-10,84942326Z,aitor.lopez@smartcode.org,563227,ES02209563310500830014,3761.2,2022-10-13T22:27:32,Bilbao,expenses,gifts,-82.15,-12700.3
buyer_1,Aitor,López,1996-08-10,84942326Z,aitor.lopez@smartcode.org,563227,ES02209563310500830014,3761.2,2022-10-16T18:30:17,Bilbao,expenses,food,-103.13,-12803.43
buyer_1,Aitor,López,1996-08-10,84942326Z,aitor.lopez@smartcode.org,563227,ES02209563310500830014,3761.2,2022-10-17T09:22:31,Bilbao,expenses,cash,-100.0,-12903.43
buyer_1,Aitor,López,1996-08-10,84942326Z,aitor.lopez@smartcode.org,563227,ES02209563310500830014,3761.2,2022-10-17T20:54:23,Bilbao,expenses,repairs,-123.84,-13027.27
buyer_1,Aitor,López,1996-08-10,84942326Z,aitor.lopez@smartcode.org,563227,ES02209563310500830014,3761.2,2022-10-18T13:25:36,Bilbao,expenses,healthcare,-40.85,-13068.12
buyer_1,Aitor,López,1996-08-10,84942326Z,aitor.lopez@smartcode.org,563227,ES02209563310500830014,3761.2,2022-10-18T09:39:32,Bilbao,expenses,cash,-100.0,-13168.12
buyer_1,Aitor,López,1996-08-10,84942326Z,aitor.lopez@smartcode.org,563227,ES02209563310500830014,3761.2,2022-10-19T12:49:36,Bilbao,expenses,education,-67.01,-13235.13
buyer_1,Aitor,López,1996-08-10,84942326Z,aitor.lopez@smartcode.org,563227,ES02209563310500830014,3761.2,2022-10-19T14:35:53,Bilbao,expenses,cash,-100.0,-13335.13
buyer_1,Aitor,López,1996-08-10,84942326Z,aitor.lopez@smartcode.org,563227,ES02209563310500830014,3761.2,2022-10-21T10:46:16,Bilbao,expenses,leisure,-56.75,-13391.88
buyer_1,Aitor,López,1996-08-10,84942326Z,aitor.lopez@smartcode.org,563227,ES02209563310500830014,3761.2,2022-10-22T17:53:56,Bilbao,expenses,food,-123.14,-13515.02
buyer_1,Aitor,López,1996-08-10,84942326Z,aitor.lopez@smartcode.org,563227,ES02209563310500830014,3761.2,2022-10-25T10:51:43,Bilbao,expenses,gifts,-179.8,-13694.82
buyer_1,Aitor,López,1996-08-10,84942326Z,aitor.lopez@smartcode.org,563227,ES02209563310500830014,3761.2,2022-10-26T21:46:04,Bilbao,expenses,appliances,-82.52,-13777.34
buyer_1,Aitor,López,1996-08-10,84942326Z,aitor.lopez@smartcode.org,563227,ES02209563310500830014,3761.2,2022-10-26T20:46:07,Bilbao,expenses,gifts,-111.15,-13888.49
buyer_1,Aitor,López,1996-08-10,84942326Z,aitor.lopez@smartcode.org,563227,ES02209563310500830014,3761.2,2022-10-27T10:29:06,Bilbao,expenses,leisure,-59.75,-13948.24
buyer_1,Aitor,López,1996-08-10,84942326Z,aitor.lopez@smartcode.org,563227,ES02209563310500830014,3761.2,2022-10-28T17:36:57,Bilbao,expenses,transport,-55.58,-14003.82
buyer_1,Aitor,López,1996-08-10,84942326Z,aitor.lopez@smartcode.org,563227,ES02209563310500830014,3761.2,2022-10-28T11:04:42,Bilbao,expenses,leisure,-82.97,-14086.79
buyer_1,Aitor,López,1996-08-10,84942326Z,aitor.lopez@smartcode.org,563227,ES02209563310500830014,3761.2,2022-10-29T17:47:40,Bilbao,expenses,transport,-43.83,-14130.62
buyer_1,Aitor,López,1996-08-10,84942326Z,aitor.lopez@smartcode.org,563227,ES02209563310500830014,3761.2,2022-10-29T05:21:03,Bilbao,expenses,clothing,-124.09,-14254.71
buyer_1,Aitor,López,1996-08-10,84942326Z,aitor.lopez@smartcode.org,563227,ES02209563310500830014,3761.2,2022-10-30T21:13:58,Bilbao,expenses,clothing,-76.7,-14331.41
buyer_1,Aitor,López,1996-08-10,84942326Z,aitor.lopez@smartcode.org,563227,ES02209563310500830014,3761.2,2022-10-30T19:30:10,Bilbao,expenses,education,-48.64,-14380.05
buyer_1,Aitor,López,1996-08-10,84942326Z,aitor.lopez@smartcode.org,563227,ES02209563310500830014,3761.2,2022-10-30T13:53:26,Bilbao,expenses,gifts,-98.98,-14479.03
buyer_1,Aitor,López,1996-08-10,84942326Z,aitor.lopez@smartcode.org,563227,ES02209563310500830014,3761.2,2022-10-31T20:40:02,Bilbao,expenses,clothing,-114.23,-14593.26
buyer_1,Aitor,López,1996-08-10,84942326Z,aitor.lopez@smartcode.org,563227,ES02209563310500830014,3761.2,2022-11-01T18:30:22,Bilbao,incomes,salary,552.89,-14040.37
buyer_1,Aitor,López,1996-08-10,84942326Z,aitor.lopez@smartcode.org,563227,ES02209563310500830014,3761.2,2022-11-01T18:30:22,Bilbao,incomes,extra_income,102.64,-13937.73
buyer_1,Aitor,López,1996-08-10,84942326Z,aitor.lopez@smartcode.org,563227,ES02209563310500830014,3761.2,2022-11-02T18:22:07,Bilbao,expenses,cash,-100.0,-14037.73
buyer_1,Aitor,López,1996-08-10,84942326Z,aitor.lopez@smartcode.org,563227,ES02209563310500830014,3761.2,2022-11-04T12:07:06,Bilbao,expenses,repairs,-45.11,-14082.84
buyer_1,Aitor,López,1996-08-10,84942326Z,aitor.lopez@smartcode.org,563227,ES02209563310500830014,3761.2,2022-11-05T17:21:57,Bilbao,expenses,rent,-183.87,-14266.71
buyer_1,Aitor,López,1996-08-10,84942326Z,aitor.lopez@smartcode.org,563227,ES02209563310500830014,3761.2,2022-11-05T14:32:58,Bilbao,expenses,phone,-10.42,-14277.13
buyer_1,Aitor,López,1996-08-10,84942326Z,aitor.lopez@smartcode.org,563227,ES02209563310500830014,3761.2,2022-11-05T08:50:38,Bilbao,expenses,leisure,-42.32,-14319.45
buyer_1,Aitor,López,1996-08-10,84942326Z,aitor.lopez@smartcode.org,563227,ES02209563310500830014,3761.2,2022-11-05T08:18:20,Bilbao,expenses,cash,-100.0,-14419.45
buyer_1,Aitor,López,1996-08-10,84942326Z,aitor.lopez@smartcode.org,563227,ES02209563310500830014,3761.2,2022-11-06T20:52:09,Bilbao,expenses,internet,-11.61,-14431.06
buyer_1,Aitor,López,1996-08-10,84942326Z,aitor.lopez@smartcode.org,563227,ES02209563310500830014,3761.2,2022-11-07T08:10:01,Bilbao,expenses,gas,-28.74,-14459.8
buyer_1,Aitor,López,1996-08-10,84942326Z,aitor.lopez@smartcode.org,563227,ES02209563310500830014,3761.2,2022-11-07T20:15:32,Bilbao,expenses,phone,-10.44,-14470.24
buyer_1,Aitor,López,1996-08-10,84942326Z,aitor.lopez@smartcode.org,563227,ES02209563310500830014,3761.2,2022-11-08T12:43:15,Bilbao,expenses,electricity,-17.74,-14487.98
buyer_1,Aitor,López,1996-08-10,84942326Z,aitor.lopez@smartcode.org,563227,ES02209563310500830014,3761.2,2022-11-12T08:58:19,Bilbao,expenses,leisure,-62.38,-14550.36
buyer_1,Aitor,López,1996-08-10,84942326Z,aitor.lopez@smartcode.org,563227,ES02209563310500830014,3761.2,2022-11-12T15:14:05,Bilbao,expenses,healthcare,-83.19,-14633.55
buyer_1,Aitor,López,1996-08-10,84942326Z,aitor.lopez@smartcode.org,563227,ES02209563310500830014,3761.2,2022-11-13T20:15:04,Bilbao,expenses,leisure,-53.57,-14687.12
buyer_1,Aitor,López,1996-08-10,84942326Z,aitor.lopez@smartcode.org,563227,ES02209563310500830014,3761.2,2022-11-13T17:46:56,Bilbao,expenses,cash,-100.0,-14787.12
buyer_1,Aitor,López,1996-08-10,84942326Z,aitor.lopez@smartcode.org,563227,ES02209563310500830014,3761.2,2022-11-13T04:24:40,Bilbao,expenses,gifts,-48.2,-14835.32
buyer_1,Aitor,López,1996-08-10,84942326Z,aitor.lopez@smartcode.org,563227,ES02209563310500830014,3761.2,2022-11-14T14:20:28,Bilbao,expenses,clothing,-49.98,-14885.3
buyer_1,Aitor,López,1996-08-10,84942326Z,aitor.lopez@smartcode.org,563227,ES02209563310500830014,3761.2,2022-11-15T15:21:16,Bilbao,expenses,cash,-100.0,-14985.3
buyer_1,Aitor,López,1996-08-10,84942326Z,aitor.lopez@smartcode.org,563227,ES02209563310500830014,3761.2,2022-11-16T11:52:24,Bilbao,expenses,food,-111.74,-15097.04
buyer_1,Aitor,López,1996-08-10,84942326Z,aitor.lopez@smartcode.org,563227,ES02209563310500830014,3761.2,2022-11-16T10:08:20,Bilbao,expenses,transport,-46.24,-15143.28
buyer_1,Aitor,López,1996-08-10,84942326Z,aitor.lopez@smartcode.org,563227,ES02209563310500830014,3761.2,2022-11-16T14:55:40,Bilbao,expenses,cash,-82.24,-15225.52
buyer_1,Aitor,López,1996-08-10,84942326Z,aitor.lopez@smartcode.org,563227,ES02209563310500830014,3761.2,2022-11-21T13:14:44,Bilbao,expenses,leisure,-47.9,-15273.42
buyer_1,Aitor,López,1996-08-10,84942326Z,aitor.lopez@smartcode.org,563227,ES02209563310500830014,3761.2,2022-11-21T17:40:44,Bilbao,expenses,education,-49.74,-15323.16
buyer_1,Aitor,López,1996-08-10,84942326Z,aitor.lopez@smartcode.org,563227,ES02209563310500830014,3761.2,2022-11-23T19:41:47,Bilbao,expenses,food,-82.1,-15405.26
buyer_1,Aitor,López,1996-08-10,84942326Z,aitor.lopez@smartcode.org,563227,ES02209563310500830014,3761.2,2022-11-23T18:17:10,Bilbao,expenses,repairs,-95.66,-15500.92
buyer_1,Aitor,López,1996-08-10,84942326Z,aitor.lopez@smartcode.org,563227,ES02209563310500830014,3761.2,2022-11-24T08:11:11,Bilbao,expenses,education,-73.57,-15574.49
buyer_1,Aitor,López,1996-08-10,84942326Z,aitor.lopez@smartcode.org,563227,ES02209563310500830014,3761.2,2022-11-25T15:29:48,Bilbao,expenses,cash,-100.0,-15674.49
buyer_1,Aitor,López,1996-08-10,84942326Z,aitor.lopez@smartcode.org,563227,ES02209563310500830014,3761.2,2022-11-28T09:29:34,Bilbao,expenses,clothing,-57.97,-15732.46
buyer_1,Aitor,López,1996-08-10,84942326Z,aitor.lopez@smartcode.org,563227,ES02209563310500830014,3761.2,2022-11-28T10:14:24,Bilbao,expenses,repairs,-151.94,-15884.4
buyer_1,Aitor,López,1996-08-10,84942326Z,aitor.lopez@smartcode.org,563227,ES02209563310500830014,3761.2,2022-11-30T14:43:21,Bilbao,expenses,repairs,-186.25,-16070.65
buyer_1,Aitor,López,1996-08-10,84942326Z,aitor.lopez@smartcode.org,563227,ES02209563310500830014,3761.2,2022-12-01T19:25:06,Bilbao,incomes,salary,552.89,-15517.76
buyer_1,Aitor,López,1996-08-10,84942326Z,aitor.lopez@smartcode.org,563227,ES02209563310500830014,3761.2,2022-12-01T19:25:06,Bilbao,incomes,salary_bonus,434.5,-15083.26
buyer_1,Aitor,López,1996-08-10,84942326Z,aitor.lopez@smartcode.org,563227,ES02209563310500830014,3761.2,2022-12-01T12:00:47,Bilbao,expenses,gifts,-212.93,-15296.19
buyer_1,Aitor,López,1996-08-10,84942326Z,aitor.lopez@smartcode.org,563227,ES02209563310500830014,3761.2,2022-12-03T11:09:16,Bilbao,expenses,gifts,-186.86,-15483.05
buyer_1,Aitor,López,1996-08-10,84942326Z,aitor.lopez@smartcode.org,563227,ES02209563310500830014,3761.2,2022-12-04T05:56:01,Bilbao,expenses,transport,-47.23,-15530.28
buyer_1,Aitor,López,1996-08-10,84942326Z,aitor.lopez@smartcode.org,563227,ES02209563310500830014,3761.2,2022-12-05T12:50:59,Bilbao,expenses,rent,-183.87,-15714.15
buyer_1,Aitor,López,1996-08-10,84942326Z,aitor.lopez@smartcode.org,563227,ES02209563310500830014,3761.2,2022-12-05T14:20:13,Bilbao,expenses,leisure,-84.38,-15798.53
buyer_1,Aitor,López,1996-08-10,84942326Z,aitor.lopez@smartcode.org,563227,ES02209563310500830014,3761.2,2022-12-05T14:51:43,Bilbao,expenses,cash,-100.0,-15898.53
buyer_1,Aitor,López,1996-08-10,84942326Z,aitor.lopez@smartcode.org,563227,ES02209563310500830014,3761.2,2022-12-05T13:56:06,Bilbao,expenses,repairs,-38.61,-15937.14
buyer_1,Aitor,López,1996-08-10,84942326Z,aitor.lopez@smartcode.org,563227,ES02209563310500830014,3761.2,2022-12-07T18:18:50,Bilbao,expenses,phone,-10.33,-15947.47
buyer_1,Aitor,López,1996-08-10,84942326Z,aitor.lopez@smartcode.org,563227,ES02209563310500830014,3761.2,2022-12-08T10:15:01,Bilbao,expenses,gas,-9.91,-15957.38
buyer_1,Aitor,López,1996-08-10,84942326Z,aitor.lopez@smartcode.org,563227,ES02209563310500830014,3761.2,2022-12-09T16:40:28,Bilbao,expenses,food,-121.08,-16078.46
buyer_1,Aitor,López,1996-08-10,84942326Z,aitor.lopez@smartcode.org,563227,ES02209563310500830014,3761.2,2022-12-10T10:30:14,Bilbao,expenses,food,-68.75,-16147.21
buyer_1,Aitor,López,1996-08-10,84942326Z,aitor.lopez@smartcode.org,563227,ES02209563310500830014,3761.2,2022-12-10T18:02:48,Bilbao,expenses,cash,-100.0,-16247.21
buyer_1,Aitor,López,1996-08-10,84942326Z,aitor.lopez@smartcode.org,563227,ES02209563310500830014,3761.2,2022-12-11T14:05:36,Bilbao,expenses,transport,-83.92,-16331.13
buyer_1,Aitor,López,1996-08-10,84942326Z,aitor.lopez@smartcode.org,563227,ES02209563310500830014,3761.2,2022-12-12T16:07:30,Bilbao,expenses,education,-78.57,-16409.7
buyer_1,Aitor,López,1996-08-10,84942326Z,aitor.lopez@smartcode.org,563227,ES02209563310500830014,3761.2,2022-12-12T15:57:54,Bilbao,expenses,cash,-100.0,-16509.7
buyer_1,Aitor,López,1996-08-10,84942326Z,aitor.lopez@smartcode.org,563227,ES02209563310500830014,3761.2,2022-12-14T12:02:13,Bilbao,expenses,food,-121.43,-16631.13
buyer_1,Aitor,López,1996-08-10,84942326Z,aitor.lopez@smartcode.org,563227,ES02209563310500830014,3761.2,2022-12-15T16:05:41,Bilbao,expenses,cash,-100.0,-16731.13
buyer_1,Aitor,López,1996-08-10,84942326Z,aitor.lopez@smartcode.org,563227,ES02209563310500830014,3761.2,2022-12-16T12:34:21,Bilbao,expenses,cash,-100.0,-16831.13
buyer_1,Aitor,López,1996-08-10,84942326Z,aitor.lopez@smartcode.org,563227,ES02209563310500830014,3761.2,2022-12-17T19:19:52,Bilbao,expenses,cash,-100.0,-16931.13
buyer_1,Aitor,López,1996-08-10,84942326Z,aitor.lopez@smartcode.org,563227,ES02209563310500830014,3761.2,2022-12-20T21:09:38,Bilbao,expenses,leisure,-52.24,-16983.37
buyer_1,Aitor,López,1996-08-10,84942326Z,aitor.lopez@smartcode.org,563227,ES02209563310500830014,3761.2,2022-12-23T12:10:57,Bilbao,expenses,food,-91.99,-17075.36
buyer_1,Aitor,López,1996-08-10,84942326Z,aitor.lopez@smartcode.org,563227,ES02209563310500830014,3761.2,2022-12-24T04:45:11,Bilbao,expenses,food,-62.59,-17137.95
buyer_1,Aitor,López,1996-08-10,84942326Z,aitor.lopez@smartcode.org,563227,ES02209563310500830014,3761.2,2022-12-27T22:15:18,Bilbao,expenses,healthcare,-155.91,-17293.86
buyer_1,Aitor,López,1996-08-10,84942326Z,aitor.lopez@smartcode.org,563227,ES02209563310500830014,3761.2,2022-12-27T10:38:44,Bilbao,expenses,gifts,-37.02,-17330.88
buyer_1,Aitor,López,1996-08-10,84942326Z,aitor.lopez@smartcode.org,563227,ES02209563310500830014,3761.2,2022-12-28T06:42:45,Bilbao,expenses,transport,-58.41,-17389.29
buyer_1,Aitor,López,1996-08-10,84942326Z,aitor.lopez@smartcode.org,563227,ES02209563310500830014,3761.2,2022-12-28T17:43:47,Bilbao,expenses,gifts,-117.63,-17506.92
buyer_1,Aitor,López,1996-08-10,84942326Z,aitor.lopez@smartcode.org,563227,ES02209563310500830014,3761.2,2022-12-31T14:14:15,Bilbao,expenses,food,-70.47,-17577.39
buyer_1,Aitor,López,1996-08-10,84942326Z,aitor.lopez@smartcode.org,563227,ES02209563310500830014,3761.2,2022-12-31T15:22:58,Bilbao,expenses,education,-71.54,-17648.93
buyer_1,Aitor,López,1996-08-10,84942326Z,aitor.lopez@smartcode.org,563227,ES02209563310500830014,3761.2,2023-01-01T14:37:53,Bilbao,incomes,salary,569.21,-17079.72
buyer_1,Aitor,López,1996-08-10,84942326Z,aitor.lopez@smartcode.org,563227,ES02209563310500830014,3761.2,2023-01-02T14:54:33,Bilbao,expenses,leisure,-58.43,-17138.15
buyer_1,Aitor,López,1996-08-10,84942326Z,aitor.lopez@smartcode.org,563227,ES02209563310500830014,3761.2,2023-01-03T03:14:15,Bilbao,expenses,food,-111.82,-17249.97
buyer_1,Aitor,López,1996-08-10,84942326Z,aitor.lopez@smartcode.org,563227,ES02209563310500830014,3761.2,2023-01-03T23:01:47,Bilbao,expenses,repairs,-98.65,-17348.62
buyer_1,Aitor,López,1996-08-10,84942326Z,aitor.lopez@smartcode.org,563227,ES02209563310500830014,3761.2,2023-01-05T13:15:16,Bilbao,expenses,rent,-217.48,-17566.1
buyer_1,Aitor,López,1996-08-10,84942326Z,aitor.lopez@smartcode.org,563227,ES02209563310500830014,3761.2,2023-01-05T09:57:50,Bilbao,expenses,gas,-17.58,-17583.68
buyer_1,Aitor,López,1996-08-10,84942326Z,aitor.lopez@smartcode.org,563227,ES02209563310500830014,3761.2,2023-01-05T21:38:34,Bilbao,expenses,education,-44.16,-17627.84
buyer_1,Aitor,López,1996-08-10,84942326Z,aitor.lopez@smartcode.org,563227,ES02209563310500830014,3761.2,2023-01-06T13:16:12,Bilbao,expenses,phone,-10.32,-17638.16
buyer_1,Aitor,López,1996-08-10,84942326Z,aitor.lopez@smartcode.org,563227,ES02209563310500830014,3761.2,2023-01-06T17:58:37,Bilbao,expenses,cash,-100.0,-17738.16
buyer_1,Aitor,López,1996-08-10,84942326Z,aitor.lopez@smartcode.org,563227,ES02209563310500830014,3761.2,2023-01-06T11:09:41,Bilbao,expenses,car,-73.77,-17811.93
buyer_1,Aitor,López,1996-08-10,84942326Z,aitor.lopez@smartcode.org,563227,ES02209563310500830014,3761.2,2023-01-07T08:12:53,Bilbao,expenses,water,-7.67,-17819.6
buyer_1,Aitor,López,1996-08-10,84942326Z,aitor.lopez@smartcode.org,563227,ES02209563310500830014,3761.2,2023-01-07T09:43:40,Bilbao,expenses,food,-88.86,-17908.46
buyer_1,Aitor,López,1996-08-10,84942326Z,aitor.lopez@smartcode.org,563227,ES02209563310500830014,3761.2,2023-01-08T14:11:42,Bilbao,expenses,water,-12.28,-17920.74
buyer_1,Aitor,López,1996-08-10,84942326Z,aitor.lopez@smartcode.org,563227,ES02209563310500830014,3761.2,2023-01-08T08:03:42,Bilbao,expenses,cash,-100.0,-18020.74
buyer_1,Aitor,López,1996-08-10,84942326Z,aitor.lopez@smartcode.org,563227,ES02209563310500830014,3761.2,2023-01-10T20:31:41,Bilbao,expenses,cash,-100.0,-18120.74
buyer_1,Aitor,López,1996-08-10,84942326Z,aitor.lopez@smartcode.org,563227,ES02209563310500830014,3761.2,2023-01-11T22:34:18,Bilbao,expenses,leisure,-34.0,-18154.74
buyer_1,Aitor,López,1996-08-10,84942326Z,aitor.lopez@smartcode.org,563227,ES02209563310500830014,3761.2,2023-01-13T12:00:41,Bilbao,expenses,leisure,-38.62,-18193.36
buyer_1,Aitor,López,1996-08-10,84942326Z,aitor.lopez@smartcode.org,563227,ES02209563310500830014,3761.2,2023-01-13T23:13:59,Bilbao,expenses,gifts,-136.44,-18329.8
buyer_1,Aitor,López,1996-08-10,84942326Z,aitor.lopez@smartcode.org,563227,ES02209563310500830014,3761.2,2023-01-18T18:50:14,Bilbao,expenses,cash,-100.0,-18429.8
buyer_1,Aitor,López,1996-08-10,84942326Z,aitor.lopez@smartcode.org,563227,ES02209563310500830014,3761.2,2023-01-19T11:53:27,Bilbao,expenses,leisure,-54.57,-18484.37
buyer_1,Aitor,López,1996-08-10,84942326Z,aitor.lopez@smartcode.org,563227,ES02209563310500830014,3761.2,2023-01-19T10:50:49,Bilbao,expenses,travel,-236.06,-18720.43
buyer_1,Aitor,López,1996-08-10,84942326Z,aitor.lopez@smartcode.org,563227,ES02209563310500830014,3761.2,2023-01-21T20:49:04,Bilbao,expenses,cash,-100.0,-18820.43
buyer_1,Aitor,López,1996-08-10,84942326Z,aitor.lopez@smartcode.org,563227,ES02209563310500830014,3761.2,2023-01-22T06:11:20,Bilbao,expenses,food,-94.63,-18915.06
buyer_1,Aitor,López,1996-08-10,84942326Z,aitor.lopez@smartcode.org,563227,ES02209563310500830014,3761.2,2023-01-24T21:59:56,Bilbao,expenses,appliances,-195.96,-19111.02
buyer_1,Aitor,López,1996-08-10,84942326Z,aitor.lopez@smartcode.org,563227,ES02209563310500830014,3761.2,2023-01-25T09:26:50,Bilbao,expenses,food,-97.52,-19208.54
buyer_1,Aitor,López,1996-08-10,84942326Z,aitor.lopez@smartcode.org,563227,ES02209563310500830014,3761.2,2023-01-26T10:27:47,Bilbao,expenses,transport,-89.69,-19298.23
buyer_1,Aitor,López,1996-08-10,84942326Z,aitor.lopez@smartcode.org,563227,ES02209563310500830014,3761.2,2023-01-28T20:26:14,Bilbao,expenses,travel,-242.64,-19540.87
buyer_1,Aitor,López,1996-08-10,84942326Z,aitor.lopez@smartcode.org,563227,ES02209563310500830014,3761.2,2023-01-29T06:21:11,Bilbao,expenses,leisure,-76.26,-19617.13
buyer_1,Aitor,López,1996-08-10,84942326Z,aitor.lopez@smartcode.org,563227,ES02209563310500830014,3761.2,2023-01-29T10:21:40,Bilbao,expenses,repairs,-44.73,-19661.86
buyer_1,Aitor,López,1996-08-10,84942326Z,aitor.lopez@smartcode.org,563227,ES02209563310500830014,3761.2,2023-01-31T15:56:52,Bilbao,expenses,food,-116.22,-19778.08
buyer_1,Aitor,López,1996-08-10,84942326Z,aitor.lopez@smartcode.org,563227,ES02209563310500830014,3761.2,2023-01-31T21:19:30,Bilbao,expenses,cash,-100.0,-19878.08
buyer_1,Aitor,López,1996-08-10,84942326Z,aitor.lopez@smartcode.org,563227,ES02209563310500830014,3761.2,2023-02-01T08:25:12,Bilbao,incomes,salary,569.21,-19308.87
buyer_1,Aitor,López,1996-08-10,84942326Z,aitor.lopez@smartcode.org,563227,ES02209563310500830014,3761.2,2023-02-01T08:25:12,Bilbao,incomes,extra_income,102.64,-19206.23
buyer_1,Aitor,López,1996-08-10,84942326Z,aitor.lopez@smartcode.org,563227,ES02209563310500830014,3761.2,2023-02-03T13:00:57,Bilbao,expenses,leisure,-64.48,-19270.71
buyer_1,Aitor,López,1996-08-10,84942326Z,aitor.lopez@smartcode.org,563227,ES02209563310500830014,3761.2,2023-02-05T15:58:56,Bilbao,expenses,rent,-217.48,-19488.19
buyer_1,Aitor,López,1996-08-10,84942326Z,aitor.lopez@smartcode.org,563227,ES02209563310500830014,3761.2,2023-02-05T20:03:49,Bilbao,expenses,food,-98.31,-19586.5
buyer_1,Aitor,López,1996-08-10,84942326Z,aitor.lopez@smartcode.org,563227,ES02209563310500830014,3761.2,2023-02-06T10:32:07,Bilbao,expenses,water,-5.98,-19592.48
buyer_1,Aitor,López,1996-08-10,84942326Z,aitor.lopez@smartcode.org,563227,ES02209563310500830014,3761.2,2023-02-06T09:54:40,Bilbao,expenses,gifts,-180.23,-19772.71
buyer_1,Aitor,López,1996-08-10,84942326Z,aitor.lopez@smartcode.org,563227,ES02209563310500830014,3761.2,2023-02-07T10:17:35,Bilbao,expenses,internet,-11.95,-19784.66
buyer_1,Aitor,López,1996-08-10,84942326Z,aitor.lopez@smartcode.org,563227,ES02209563310500830014,3761.2,2023-02-08T21:16:35,Bilbao,expenses,water,-6.85,-19791.51
buyer_1,Aitor,López,1996-08-10,84942326Z,aitor.lopez@smartcode.org,563227,ES02209563310500830014,3761.2,2023-02-08T12:52:20,Bilbao,expenses,gas,-14.17,-19805.68
buyer_1,Aitor,López,1996-08-10,84942326Z,aitor.lopez@smartcode.org,563227,ES02209563310500830014,3761.2,2023-02-08T20:07:29,Bilbao,expenses,healthcare,-39.71,-19845.39
buyer_1,Aitor,López,1996-08-10,84942326Z,aitor.lopez@smartcode.org,563227,ES02209563310500830014,3761.2,2023-02-08T19:13:08,Bilbao,expenses,travel,-279.74,-20125.13
buyer_1,Aitor,López,1996-08-10,84942326Z,aitor.lopez@smartcode.org,563227,ES02209563310500830014,3761.2,2023-02-09T20:16:14,Bilbao,expenses,cash,-100.0,-20225.13
buyer_1,Aitor,López,1996-08-10,84942326Z,aitor.lopez@smartcode.org,563227,ES02209563310500830014,3761.2,2023-02-10T08:49:21,Bilbao,expenses,cash,-100.0,-20325.13
buyer_1,Aitor,López,1996-08-10,84942326Z,aitor.lopez@smartcode.org,563227,ES02209563310500830014,3761.2,2023-02-11T13:00:50,Bilbao,expenses,food,-80.84,-20405.97
buyer_1,Aitor,López,1996-08-10,84942326Z,aitor.lopez@smartcode.org,563227,ES02209563310500830014,3761.2,2023-02-13T00:47:16,Bilbao,expenses,food,-92.52,-20498.49
buyer_1,Aitor,López,1996-08-10,84942326Z,aitor.lopez@smartcode.org,563227,ES02209563310500830014,3761.2,2023-02-14T20:03:35,Bilbao,expenses,cash,-100.0,-20598.49
buyer_1,Aitor,López,1996-08-10,84942326Z,aitor.lopez@smartcode.org,563227,ES02209563310500830014,3761.2,2023-02-15T17:35:23,Bilbao,expenses,gifts,-215.14,-20813.63
buyer_1,Aitor,López,1996-08-10,84942326Z,aitor.lopez@smartcode.org,563227,ES02209563310500830014,3761.2,2023-02-16T10:07:38,Bilbao,expenses,food,-68.35,-20881.98
buyer_1,Aitor,López,1996-08-10,84942326Z,aitor.lopez@smartcode.org,563227,ES02209563310500830014,3761.2,2023-02-20T20:03:54,Bilbao,expenses,clothing,-113.84,-20995.82
buyer_1,Aitor,López,1996-08-10,84942326Z,aitor.lopez@smartcode.org,563227,ES02209563310500830014,3761.2,2023-02-21T09:21:12,Bilbao,expenses,cash,-100.0,-21095.82
buyer_1,Aitor,López,1996-08-10,84942326Z,aitor.lopez@smartcode.org,563227,ES02209563310500830014,3761.2,2023-02-22T19:37:33,Bilbao,expenses,cash,-100.0,-21195.82
buyer_1,Aitor,López,1996-08-10,84942326Z,aitor.lopez@smartcode.org,563227,ES02209563310500830014,3761.2,2023-02-24T20:50:55,Bilbao,expenses,cash,-100.0,-21295.82
buyer_1,Aitor,López,1996-08-10,84942326Z,aitor.lopez@smartcode.org,563227,ES02209563310500830014,3761.2,2023-02-26T18:18:06,Bilbao,expenses,leisure,-62.86,-21358.68
buyer_1,Aitor,López,1996-08-10,84942326Z,aitor.lopez@smartcode.org,563227,ES02209563310500830014,3761.2,2023-03-01T14:08:09,Bilbao,incomes,salary,569.21,-20789.47
buyer_1,Aitor,López,1996-08-10,84942326Z,aitor.lopez@smartcode.org,563227,ES02209563310500830014,3761.2,2023-03-03T09:19:27,Bilbao,expenses,leisure,-39.39,-20828.86
buyer_1,Aitor,López,1996-08-10,84942326Z,aitor.lopez@smartcode.org,563227,ES02209563310500830014,3761.2,2023-03-04T08:12:04,Bilbao,expenses,food,-76.45,-20905.31
buyer_1,Aitor,López,1996-08-10,84942326Z,aitor.lopez@smartcode.org,563227,ES02209563310500830014,3761.2,2023-03-04T08:12:32,Bilbao,expenses,clothing,-45.24,-20950.55
buyer_1,Aitor,López,1996-08-10,84942326Z,aitor.lopez@smartcode.org,563227,ES02209563310500830014,3761.2,2023-03-04T08:18:00,Bilbao,expenses,cash,-100.0,-21050.55
buyer_1,Aitor,López,1996-08-10,84942326Z,aitor.lopez@smartcode.org,563227,ES02209563310500830014,3761.2,2023-03-05T13:59:20,Bilbao,expenses,rent,-217.48,-21268.03
buyer_1,Aitor,López,1996-08-10,84942326Z,aitor.lopez@smartcode.org,563227,ES02209563310500830014,3761.2,2023-03-05T10:37:32,Bilbao,expenses,internet,-11.95,-21279.98
buyer_1,Aitor,López,1996-08-10,84942326Z,aitor.lopez@smartcode.org,563227,ES02209563310500830014,3761.2,2023-03-05T11:04:12,Bilbao,expenses,gifts,-65.35,-21345.33
buyer_1,Aitor,López,1996-08-10,84942326Z,aitor.lopez@smartcode.org,563227,ES02209563310500830014,3761.2,2023-03-06T05:31:09,Bilbao,expenses,gas,-10.95,-21356.28
buyer_1,Aitor,López,1996-08-10,84942326Z,aitor.lopez@smartcode.org,563227,ES02209563310500830014,3761.2,2023-03-06T20:27:56,Bilbao,expenses,phone,-12.65,-21368.93
buyer_1,Aitor,López,1996-08-10,84942326Z,aitor.lopez@smartcode.org,563227,ES02209563310500830014,3761.2,2023-03-07T09:17:47,Bilbao,expenses,water,-9.67,-21378.6
buyer_1,Aitor,López,1996-08-10,84942326Z,aitor.lopez@smartcode.org,563227,ES02209563310500830014,3761.2,2023-03-07T21:37:46,Bilbao,expenses,electricity,-22.43,-21401.03
buyer_1,Aitor,López,1996-08-10,84942326Z,aitor.lopez@smartcode.org,563227,ES02209563310500830014,3761.2,2023-03-08T08:15:10,Bilbao,expenses,water,-12.43,-21413.46
buyer_1,Aitor,López,1996-08-10,84942326Z,aitor.lopez@smartcode.org,563227,ES02209563310500830014,3761.2,2023-03-08T12:19:26,Bilbao,expenses,gifts,-78.54,-21492.0
buyer_1,Aitor,López,1996-08-10,84942326Z,aitor.lopez@smartcode.org,563227,ES02209563310500830014,3761.2,2023-03-11T11:37:01,Bilbao,expenses,leisure,-83.2,-21575.2
buyer_1,Aitor,López,1996-08-10,84942326Z,aitor.lopez@smartcode.org,563227,ES02209563310500830014,3761.2,2023-03-11T10:05:43,Bilbao,expenses,education,-43.43,-21618.63
buyer_1,Aitor,López,1996-08-10,84942326Z,aitor.lopez@smartcode.org,563227,ES02209563310500830014,3761.2,2023-03-11T10:48:16,Bilbao,expenses,cash,-99.69,-21718.32
buyer_1,Aitor,López,1996-08-10,84942326Z,aitor.lopez@smartcode.org,563227,ES02209563310500830014,3761.2,2023-03-13T16:34:39,Bilbao,expenses,leisure,-48.28,-21766.6
buyer_1,Aitor,López,1996-08-10,84942326Z,aitor.lopez@smartcode.org,563227,ES02209563310500830014,3761.2,2023-03-13T14:12:39,Bilbao,expenses,cash,-100.0,-21866.6
buyer_1,Aitor,López,1996-08-10,84942326Z,aitor.lopez@smartcode.org,563227,ES02209563310500830014,3761.2,2023-03-15T13:45:20,Bilbao,expenses,leisure,-72.62,-21939.22
buyer_1,Aitor,López,1996-08-10,84942326Z,aitor.lopez@smartcode.org,563227,ES02209563310500830014,3761.2,2023-03-15T17:40:14,Bilbao,expenses,travel,-170.23,-22109.45
buyer_1,Aitor,López,1996-08-10,84942326Z,aitor.lopez@smartcode.org,563227,ES02209563310500830014,3761.2,2023-03-17T11:57:14,Bilbao,expenses,cash,-100.0,-22209.45
buyer_1,Aitor,López,1996-08-10,84942326Z,aitor.lopez@smartcode.org,563227,ES02209563310500830014,3761.2,2023-03-19T12:56:21,Bilbao,expenses,leisure,-23.56,-22233.01
buyer_1,Aitor,López,1996-08-10,84942326Z,aitor.lopez@smartcode.org,563227,ES02209563310500830014,3761.2,2023-03-20T08:48:58,Bilbao,expenses,cash,-100.0,-22333.01
buyer_1,Aitor,López,1996-08-10,84942326Z,aitor.lopez@smartcode.org,563227,ES02209563310500830014,3761.2,2023-03-23T11:14:32,Bilbao,expenses,transport,-77.45,-22410.46
buyer_1,Aitor,López,1996-08-10,84942326Z,aitor.lopez@smartcode.org,563227,ES02209563310500830014,3761.2,2023-03-25T22:28:12,Bilbao,expenses,food,-102.8,-22513.26
buyer_1,Aitor,López,1996-08-10,84942326Z,aitor.lopez@smartcode.org,563227,ES02209563310500830014,3761.2,2023-03-25T18:29:12,Bilbao,expenses,education,-42.11,-22555.37
buyer_1,Aitor,López,1996-08-10,84942326Z,aitor.lopez@smartcode.org,563227,ES02209563310500830014,3761.2,2023-03-25T21:55:51,Bilbao,expenses,cash,-97.47,-22652.84
buyer_1,Aitor,López,1996-08-10,84942326Z,aitor.lopez@smartcode.org,563227,ES02209563310500830014,3761.2,2023-03-26T11:16:49,Bilbao,expenses,leisure,-75.99,-22728.83
buyer_1,Aitor,López,1996-08-10,84942326Z,aitor.lopez@smartcode.org,563227,ES02209563310500830014,3761.2,2023-03-27T04:51:16,Bilbao,expenses,food,-91.36,-22820.19
buyer_1,Aitor,López,1996-08-10,84942326Z,aitor.lopez@smartcode.org,563227,ES02209563310500830014,3761.2,2023-03-28T18:40:03,Bilbao,expenses,leisure,-19.51,-22839.7
buyer_1,Aitor,López,1996-08-10,84942326Z,aitor.lopez@smartcode.org,563227,ES02209563310500830014,3761.2,2023-03-28T10:10:37,Bilbao,expenses,clothing,-139.72,-22979.42
buyer_1,Aitor,López,1996-08-10,84942326Z,aitor.lopez@smartcode.org,563227,ES02209563310500830014,3761.2,2023-03-30T10:56:19,Bilbao,expenses,gifts,-206.51,-23185.93
buyer_1,Aitor,López,1996-08-10,84942326Z,aitor.lopez@smartcode.org,563227,ES02209563310500830014,3761.2,2023-03-31T13:59:02,Bilbao,expenses,repairs,-107.21,-23293.14
buyer_1,Aitor,López,1996-08-10,84942326Z,aitor.lopez@smartcode.org,563227,ES02209563310500830014,3761.2,2023-04-01T13:38:25,Bilbao,incomes,salary,569.21,-22723.93
buyer_1,Aitor,López,1996-08-10,84942326Z,aitor.lopez@smartcode.org,563227,ES02209563310500830014,3761.2,2023-04-03T11:18:32,Bilbao,expenses,cash,-100.0,-22823.93
buyer_1,Aitor,López,1996-08-10,84942326Z,aitor.lopez@smartcode.org,563227,ES02209563310500830014,3761.2,2023-04-04T19:30:41,Bilbao,expenses,leisure,-64.16,-22888.09
buyer_1,Aitor,López,1996-08-10,84942326Z,aitor.lopez@smartcode.org,563227,ES02209563310500830014,3761.2,2023-04-05T13:58:16,Bilbao,expenses,rent,-217.48,-23105.57
buyer_1,Aitor,López,1996-08-10,84942326Z,aitor.lopez@smartcode.org,563227,ES02209563310500830014,3761.2,2023-04-05T16:49:55,Bilbao,expenses,gas,-30.81,-23136.38
buyer_1,Aitor,López,1996-08-10,84942326Z,aitor.lopez@smartcode.org,563227,ES02209563310500830014,3761.2,2023-04-05T17:20:11,Bilbao,expenses,clothing,-69.83,-23206.21
buyer_1,Aitor,López,1996-08-10,84942326Z,aitor.lopez@smartcode.org,563227,ES02209563310500830014,3761.2,2023-04-06T19:32:43,Bilbao,expenses,water,-12.81,-23219.02
buyer_1,Aitor,López,1996-08-10,84942326Z,aitor.lopez@smartcode.org,563227,ES02209563310500830014,3761.2,2023-04-06T13:05:41,Bilbao,expenses,phone,-9.82,-23228.84
buyer_1,Aitor,López,1996-08-10,84942326Z,aitor.lopez@smartcode.org,563227,ES02209563310500830014,3761.2,2023-04-06T07:41:30,Bilbao,expenses,repairs,-209.76,-23438.6
buyer_1,Aitor,López,1996-08-10,84942326Z,aitor.lopez@smartcode.org,563227,ES02209563310500830014,3761.2,2023-04-07T08:00:59,Bilbao,expenses,water,-6.73,-23445.33
buyer_1,Aitor,López,1996-08-10,84942326Z,aitor.lopez@smartcode.org,563227,ES02209563310500830014,3761.2,2023-04-07T14:55:03,Bilbao,expenses,internet,-11.95,-23457.28
buyer_1,Aitor,López,1996-08-10,84942326Z,aitor.lopez@smartcode.org,563227,ES02209563310500830014,3761.2,2023-04-07T10:09:09,Bilbao,expenses,phone,-10.24,-23467.52
buyer_1,Aitor,López,1996-08-10,84942326Z,aitor.lopez@smartcode.org,563227,ES02209563310500830014,3761.2,2023-04-07T23:17:40,Bilbao,expenses,cash,-100.0,-23567.52
buyer_1,Aitor,López,1996-08-10,84942326Z,aitor.lopez@smartcode.org,563227,ES02209563310500830014,3761.2,2023-04-07T09:06:44,Bilbao,expenses,gifts,-101.41,-23668.93
buyer_1,Aitor,López,1996-08-10,84942326Z,aitor.lopez@smartcode.org,563227,ES02209563310500830014,3761.2,2023-04-08T14:13:32,Bilbao,expenses,water,-6.02,-23674.95
buyer_1,Aitor,López,1996-08-10,84942326Z,aitor.lopez@smartcode.org,563227,ES02209563310500830014,3761.2,2023-04-08T05:55:10,Bilbao,expenses,phone,-10.91,-23685.86
buyer_1,Aitor,López,1996-08-10,84942326Z,aitor.lopez@smartcode.org,563227,ES02209563310500830014,3761.2,2023-04-08T16:17:37,Bilbao,expenses,healthcare,-174.6,-23860.46
buyer_1,Aitor,López,1996-08-10,84942326Z,aitor.lopez@smartcode.org,563227,ES02209563310500830014,3761.2,2023-04-09T17:41:12,Bilbao,expenses,healthcare,-102.84,-23963.3
buyer_1,Aitor,López,1996-08-10,84942326Z,aitor.lopez@smartcode.org,563227,ES02209563310500830014,3761.2,2023-04-10T19:30:04,Bilbao,expenses,healthcare,-126.44,-24089.74
buyer_1,Aitor,López,1996-08-10,84942326Z,aitor.lopez@smartcode.org,563227,ES02209563310500830014,3761.2,2023-04-11T10:23:53,Bilbao,expenses,cash,-100.0,-24189.74
buyer_1,Aitor,López,1996-08-10,84942326Z,aitor.lopez@smartcode.org,563227,ES02209563310500830014,3761.2,2023-04-11T22:30:54,Bilbao,expenses,repairs,-77.78,-24267.52
buyer_1,Aitor,López,1996-08-10,84942326Z,aitor.lopez@smartcode.org,563227,ES02209563310500830014,3761.2,2023-04-12T07:52:26,Bilbao,expenses,cash,-100.0,-24367.52
buyer_1,Aitor,López,1996-08-10,84942326Z,aitor.lopez@smartcode.org,563227,ES02209563310500830014,3761.2,2023-04-13T17:22:00,Bilbao,expenses,food,-98.39,-24465.91
buyer_1,Aitor,López,1996-08-10,84942326Z,aitor.lopez@smartcode.org,563227,ES02209563310500830014,3761.2,2023-04-14T12:05:56,Bilbao,expenses,clothing,-50.44,-24516.35
buyer_1,Aitor,López,1996-08-10,84942326Z,aitor.lopez@smartcode.org,563227,ES02209563310500830014,3761.2,2023-04-16T09:22:02,Bilbao,expenses,travel,-271.39,-24787.74
buyer_1,Aitor,López,1996-08-10,84942326Z,aitor.lopez@smartcode.org,563227,ES02209563310500830014,3761.2,2023-04-18T21:07:14,Bilbao,expenses,cash,-100.0,-24887.74
buyer_1,Aitor,López,1996-08-10,84942326Z,aitor.lopez@smartcode.org,563227,ES02209563310500830014,3761.2,2023-04-20T03:42:16,Bilbao,expenses,leisure,-66.52,-24954.26
buyer_1,Aitor,López,1996-08-10,84942326Z,aitor.lopez@smartcode.org,563227,ES02209563310500830014,3761.2,2023-04-25T11:31:56,Bilbao,expenses,appliances,-103.51,-25057.77
buyer_1,Aitor,López,1996-08-10,84942326Z,aitor.lopez@smartcode.org,563227,ES02209563310500830014,3761.2,2023-04-28T23:27:15,Bilbao,expenses,clothing,-117.68,-25175.45
buyer_1,Aitor,López,1996-08-10,84942326Z,aitor.lopez@smartcode.org,563227,ES02209563310500830014,3761.2,2023-04-30T17:35:56,Bilbao,expenses,food,-78.37,-25253.82
buyer_1,Aitor,López,1996-08-10,84942326Z,aitor.lopez@smartcode.org,563227,ES02209563310500830014,3761.2,2023-05-01T23:10:47,Bilbao,incomes,salary,569.21,-24684.61
buyer_1,Aitor,López,1996-08-10,84942326Z,aitor.lopez@smartcode.org,563227,ES02209563310500830014,3761.2,2023-05-01T23:10:47,Bilbao,incomes,extra_income,102.64,-24581.97
buyer_1,Aitor,López,1996-08-10,84942326Z,aitor.lopez@smartcode.org,563227,ES02209563310500830014,3761.2,2023-05-04T14:23:05,Bilbao,expenses,cash,-100.0,-24681.97
buyer_1,Aitor,López,1996-08-10,84942326Z,aitor.lopez@smartcode.org,563227,ES02209563310500830014,3761.2,2023-05-04T10:37:58,Bilbao,expenses,repairs,-51.63,-24733.6
buyer_1,Aitor,López,1996-08-10,84942326Z,aitor.lopez@smartcode.org,563227,ES02209563310500830014,3761.2,2023-05-05T17:08:53,Bilbao,expenses,rent,-217.48,-24951.08
buyer_1,Aitor,López,1996-08-10,84942326Z,aitor.lopez@smartcode.org,563227,ES02209563310500830014,3761.2,2023-05-05T18:48:08,Bilbao,expenses,internet,-11.95,-24963.03
buyer_1,Aitor,López,1996-08-10,84942326Z,aitor.lopez@smartcode.org,563227,ES02209563310500830014,3761.2,2023-05-05T18:29:46,Bilbao,expenses,food,-106.44,-25069.47
buyer_1,Aitor,López,1996-08-10,84942326Z,aitor.lopez@smartcode.org,563227,ES02209563310500830014,3761.2,2023-05-06T14:34:33,Bilbao,expenses,phone,-10.33,-25079.8
buyer_1,Aitor,López,1996-08-10,84942326Z,aitor.lopez@smartcode.org,563227,ES02209563310500830014,3761.2,2023-05-07T15:51:24,Bilbao,expenses,cash,-100.0,-25179.8
buyer_1,Aitor,López,1996-08-10,84942326Z,aitor.lopez@smartcode.org,563227,ES02209563310500830014,3761.2,2023-05-07T11:03:00,Bilbao,expenses,appliances,-82.31,-25262.11
buyer_1,Aitor,López,1996-08-10,84942326Z,aitor.lopez@smartcode.org,563227,ES02209563310500830014,3761.2,2023-05-08T13:46:59,Bilbao,expenses,electricity,-19.24,-25281.35
buyer_1,Aitor,López,1996-08-10,84942326Z,aitor.lopez@smartcode.org,563227,ES02209563310500830014,3761.2,2023-05-08T07:32:00,Bilbao,expenses,repairs,-107.91,-25389.26
buyer_1,Aitor,López,1996-08-10,84942326Z,aitor.lopez@smartcode.org,563227,ES02209563310500830014,3761.2,2023-05-09T06:56:10,Bilbao,expenses,car,-52.09,-25441.35
buyer_1,Aitor,López,1996-08-10,84942326Z,aitor.lopez@smartcode.org,563227,ES02209563310500830014,3761.2,2023-05-10T03:31:04,Bilbao,expenses,food,-92.79,-25534.14
buyer_1,Aitor,López,1996-08-10,84942326Z,aitor.lopez@smartcode.org,563227,ES02209563310500830014,3761.2,2023-05-10T11:19:00,Bilbao,expenses,clothing,-83.08,-25617.22
buyer_1,Aitor,López,1996-08-10,84942326Z,aitor.lopez@smartcode.org,563227,ES02209563310500830014,3761.2,2023-05-11T11:18:27,Bilbao,expenses,cash,-100.0,-25717.22
buyer_1,Aitor,López,1996-08-10,84942326Z,aitor.lopez@smartcode.org,563227,ES02209563310500830014,3761.2,2023-05-12T15:07:18,Bilbao,expenses,food,-121.58,-25838.8
buyer_1,Aitor,López,1996-08-10,84942326Z,aitor.lopez@smartcode.org,563227,ES02209563310500830014,3761.2,2023-05-13T09:23:21,Bilbao,expenses,cash,-100.0,-25938.8
buyer_1,Aitor,López,1996-08-10,84942326Z,aitor.lopez@smartcode.org,563227,ES02209563310500830014,3761.2,2023-05-14T14:47:42,Bilbao,expenses,healthcare,-102.68,-26041.48
buyer_1,Aitor,López,1996-08-10,84942326Z,aitor.lopez@smartcode.org,563227,ES02209563310500830014,3761.2,2023-05-14T07:10:36,Bilbao,expenses,cash,-100.0,-26141.48
buyer_1,Aitor,López,1996-08-10,84942326Z,aitor.lopez@smartcode.org,563227,ES02209563310500830014,3761.2,2023-05-16T16:30:59,Bilbao,expenses,transport,-74.62,-26216.1
buyer_1,Aitor,López,1996-08-10,84942326Z,aitor.lopez@smartcode.org,563227,ES02209563310500830014,3761.2,2023-05-16T10:58:59,Bilbao,expenses,cash,-100.0,-26316.1
buyer_1,Aitor,López,1996-08-10,84942326Z,aitor.lopez@smartcode.org,563227,ES02209563310500830014,3761.2,2023-05-17T14:18:23,Bilbao,expenses,leisure,-71.85,-26387.95
buyer_1,Aitor,López,1996-08-10,84942326Z,aitor.lopez@smartcode.org,563227,ES02209563310500830014,3761.2,2023-05-17T20:23:12,Bilbao,expenses,cash,-100.0,-26487.95
buyer_1,Aitor,López,1996-08-10,84942326Z,aitor.lopez@smartcode.org,563227,ES02209563310500830014,3761.2,2023-05-17T14:50:52,Bilbao,expenses,repairs,-42.24,-26530.19
buyer_1,Aitor,López,1996-08-10,84942326Z,aitor.lopez@smartcode.org,563227,ES02209563310500830014,3761.2,2023-05-18T20:50:35,Bilbao,expenses,cash,-100.0,-26630.19
buyer_1,Aitor,López,1996-08-10,84942326Z,aitor.lopez@smartcode.org,563227,ES02209563310500830014,3761.2,2023-05-18T12:05:16,Bilbao,expenses,gifts,-55.26,-26685.45
buyer_1,Aitor,López,1996-08-10,84942326Z,aitor.lopez@smartcode.org,563227,ES02209563310500830014,3761.2,2023-05-19T19:58:37,Bilbao,expenses,gifts,-168.31,-26853.76
buyer_1,Aitor,López,1996-08-10,84942326Z,aitor.lopez@smartcode.org,563227,ES02209563310500830014,3761.2,2023-05-20T16:40:31,Bilbao,expenses,cash,-100.0,-26953.76
buyer_1,Aitor,López,1996-08-10,84942326Z,aitor.lopez@smartcode.org,563227,ES02209563310500830014,3761.2,2023-05-21T17:47:03,Bilbao,expenses,food,-87.82,-27041.58
buyer_1,Aitor,López,1996-08-10,84942326Z,aitor.lopez@smartcode.org,563227,ES02209563310500830014,3761.2,2023-05-27T20:04:11,Bilbao,expenses,food,-90.13,-27131.71
buyer_1,Aitor,López,1996-08-10,84942326Z,aitor.lopez@smartcode.org,563227,ES02209563310500830014,3761.2,2023-05-27T11:23:18,Bilbao,expenses,cash,-100.0,-27231.71
buyer_1,Aitor,López,1996-08-10,84942326Z,aitor.lopez@smartcode.org,563227,ES02209563310500830014,3761.2,2023-05-28T20:44:05,Bilbao,expenses,transport,-49.54,-27281.25
buyer_1,Aitor,López,1996-08-10,84942326Z,aitor.lopez@smartcode.org,563227,ES02209563310500830014,3761.2,2023-05-28T11:48:55,Bilbao,expenses,leisure,-38.68,-27319.93
buyer_1,Aitor,López,1996-08-10,84942326Z,aitor.lopez@smartcode.org,563227,ES02209563310500830014,3761.2,2023-05-28T19:27:41,Bilbao,expenses,clothing,-94.37,-27414.3
buyer_1,Aitor,López,1996-08-10,84942326Z,aitor.lopez@smartcode.org,563227,ES02209563310500830014,3761.2,2023-05-29T19:29:54,Bilbao,expenses,education,-42.37,-27456.67
buyer_1,Aitor,López,1996-08-10,84942326Z,aitor.lopez@smartcode.org,563227,ES02209563310500830014,3761.2,2023-05-30T13:17:49,Bilbao,expenses,clothing,-147.83,-27604.5
buyer_1,Aitor,López,1996-08-10,84942326Z,aitor.lopez@smartcode.org,563227,ES02209563310500830014,3761.2,2023-05-31T15:06:07,Bilbao,expenses,transport,-71.68,-27676.18
buyer_1,Aitor,López,1996-08-10,84942326Z,aitor.lopez@smartcode.org,563227,ES02209563310500830014,3761.2,2023-05-31T12:59:42,Bilbao,expenses,cash,-100.0,-27776.18
buyer_1,Aitor,López,1996-08-10,84942326Z,aitor.lopez@smartcode.org,563227,ES02209563310500830014,3761.2,2023-05-31T20:15:20,Bilbao,expenses,appliances,-67.24,-27843.42
buyer_1,Aitor,López,1996-08-10,84942326Z,aitor.lopez@smartcode.org,563227,ES02209563310500830014,3761.2,2023-06-01T12:59:23,Bilbao,incomes,salary,569.21,-27274.21
buyer_1,Aitor,López,1996-08-10,84942326Z,aitor.lopez@smartcode.org,563227,ES02209563310500830014,3761.2,2023-06-01T12:59:23,Bilbao,incomes,salary_bonus,425.46,-26848.75
buyer_1,Aitor,López,1996-08-10,84942326Z,aitor.lopez@smartcode.org,563227,ES02209563310500830014,3761.2,2023-06-01T08:21:03,Bilbao,expenses,food,-71.49,-26920.24
buyer_1,Aitor,López,1996-08-10,84942326Z,aitor.lopez@smartcode.org,563227,ES02209563310500830014,3761.2,2023-06-01T16:13:12,Bilbao,expenses,cash,-100.0,-27020.24
buyer_1,Aitor,López,1996-08-10,84942326Z,aitor.lopez@smartcode.org,563227,ES02209563310500830014,3761.2,2023-06-02T17:53:59,Bilbao,expenses,food,-110.35,-27130.59
buyer_1,Aitor,López,1996-08-10,84942326Z,aitor.lopez@smartcode.org,563227,ES02209563310500830014,3761.2,2023-06-02T15:25:33,Bilbao,expenses,clothing,-100.25,-27230.84
buyer_1,Aitor,López,1996-08-10,84942326Z,aitor.lopez@smartcode.org,563227,ES02209563310500830014,3761.2,2023-06-03T12:28:16,Bilbao,expenses,transport,-66.73,-27297.57
buyer_1,Aitor,López,1996-08-10,84942326Z,aitor.lopez@smartcode.org,563227,ES02209563310500830014,3761.2,2023-06-03T09:06:14,Bilbao,expenses,cash,-100.0,-27397.57
buyer_1,Aitor,López,1996-08-10,84942326Z,aitor.lopez@smartcode.org,563227,ES02209563310500830014,3761.2,2023-06-04T13:25:37,Bilbao,expenses,taxes,-462.41,-27859.98
buyer_1,Aitor,López,1996-08-10,84942326Z,aitor.lopez@smartcode.org,563227,ES02209563310500830014,3761.2,2023-06-04T10:12:29,Bilbao,expenses,insurance,-115.18,-27975.16
buyer_1,Aitor,López,1996-08-10,84942326Z,aitor.lopez@smartcode.org,563227,ES02209563310500830014,3761.2,2023-06-05T16:02:41,Bilbao,expenses,rent,-217.48,-28192.64
buyer_1,Aitor,López,1996-08-10,84942326Z,aitor.lopez@smartcode.org,563227,ES02209563310500830014,3761.2,2023-06-05T12:37:31,Bilbao,expenses,healthcare,-185.43,-28378.07
buyer_1,Aitor,López,1996-08-10,84942326Z,aitor.lopez@smartcode.org,563227,ES02209563310500830014,3761.2,2023-06-06T08:58:36,Bilbao,expenses,phone,-8.76,-28386.83
buyer_1,Aitor,López,1996-08-10,84942326Z,aitor.lopez@smartcode.org,563227,ES02209563310500830014,3761.2,2023-06-06T11:16:59,Bilbao,expenses,food,-100.81,-28487.64
buyer_1,Aitor,López,1996-08-10,84942326Z,aitor.lopez@smartcode.org,563227,ES02209563310500830014,3761.2,2023-06-06T15:45:08,Bilbao,expenses,cash,-100.0,-28587.64
buyer_1,Aitor,López,1996-08-10,84942326Z,aitor.lopez@smartcode.org,563227,ES02209563310500830014,3761.2,2023-06-07T10:20:30,Bilbao,expenses,water,-12.44,-28600.08
buyer_1,Aitor,López,1996-08-10,84942326Z,aitor.lopez@smartcode.org,563227,ES02209563310500830014,3761.2,2023-06-07T21:56:15,Bilbao,expenses,gas,-32.25,-28632.33
buyer_1,Aitor,López,1996-08-10,84942326Z,aitor.lopez@smartcode.org,563227,ES02209563310500830014,3761.2,2023-06-07T19:24:48,Bilbao,expenses,clothing,-116.28,-28748.61
buyer_1,Aitor,López,1996-08-10,84942326Z,aitor.lopez@smartcode.org,563227,ES02209563310500830014,3761.2,2023-06-08T13:23:37,Bilbao,expenses,food,-118.09,-28866.7
buyer_1,Aitor,López,1996-08-10,84942326Z,aitor.lopez@smartcode.org,563227,ES02209563310500830014,3761.2,2023-06-09T21:47:26,Bilbao,expenses,cash,-100.0,-28966.7
buyer_1,Aitor,López,1996-08-10,84942326Z,aitor.lopez@smartcode.org,563227,ES02209563310500830014,3761.2,2023-06-09T19:00:24,Bilbao,expenses,gifts,-58.3,-29025.0
buyer_1,Aitor,López,1996-08-10,84942326Z,aitor.lopez@smartcode.org,563227,ES02209563310500830014,3761.2,2023-06-12T14:36:09,Bilbao,expenses,clothing,-85.62,-29110.62
buyer_1,Aitor,López,1996-08-10,84942326Z,aitor.lopez@smartcode.org,563227,ES02209563310500830014,3761.2,2023-06-16T12:28:55,Bilbao,expenses,cash,-100.0,-29210.62
buyer_1,Aitor,López,1996-08-10,84942326Z,aitor.lopez@smartcode.org,563227,ES02209563310500830014,3761.2,2023-06-19T12:57:57,Bilbao,expenses,education,-76.64,-29287.26
buyer_1,Aitor,López,1996-08-10,84942326Z,aitor.lopez@smartcode.org,563227,ES02209563310500830014,3761.2,2023-06-20T09:43:12,Bilbao,expenses,food,-95.8,-29383.06
buyer_1,Aitor,López,1996-08-10,84942326Z,aitor.lopez@smartcode.org,563227,ES02209563310500830014,3761.2,2023-06-21T08:49:11,Bilbao,expenses,food,-106.16,-29489.22
buyer_1,Aitor,López,1996-08-10,84942326Z,aitor.lopez@smartcode.org,563227,ES02209563310500830014,3761.2,2023-06-21T17:19:37,Bilbao,expenses,cash,-100.0,-29589.22
buyer_1,Aitor,López,1996-08-10,84942326Z,aitor.lopez@smartcode.org,563227,ES02209563310500830014,3761.2,2023-06-21T08:53:46,Bilbao,expenses,travel,-197.24,-29786.46
buyer_1,Aitor,López,1996-08-10,84942326Z,aitor.lopez@smartcode.org,563227,ES02209563310500830014,3761.2,2023-06-22T17:03:03,Bilbao,expenses,gifts,-180.86,-29967.32
buyer_1,Aitor,López,1996-08-10,84942326Z,aitor.lopez@smartcode.org,563227,ES02209563310500830014,3761.2,2023-06-23T11:51:46,Bilbao,expenses,food,-85.06,-30052.38
buyer_1,Aitor,López,1996-08-10,84942326Z,aitor.lopez@smartcode.org,563227,ES02209563310500830014,3761.2,2023-06-26T00:52:21,Bilbao,expenses,repairs,-54.17,-30106.55
buyer_1,Aitor,López,1996-08-10,84942326Z,aitor.lopez@smartcode.org,563227,ES02209563310500830014,3761.2,2023-06-28T15:34:25,Bilbao,expenses,cash,-100.0,-30206.55
buyer_1,Aitor,López,1996-08-10,84942326Z,aitor.lopez@smartcode.org,563227,ES02209563310500830014,3761.2,2023-06-30T12:51:28,Bilbao,expenses,education,-65.97,-30272.52
buyer_1,Aitor,López,1996-08-10,84942326Z,aitor.lopez@smartcode.org,563227,ES02209563310500830014,3761.2,2023-07-01T10:51:34,Bilbao,incomes,salary,569.21,-29703.31
buyer_1,Aitor,López,1996-08-10,84942326Z,aitor.lopez@smartcode.org,563227,ES02209563310500830014,3761.2,2023-07-03T10:42:41,Bilbao,expenses,cash,-100.0,-29803.31
buyer_1,Aitor,López,1996-08-10,84942326Z,aitor.lopez@smartcode.org,563227,ES02209563310500830014,3761.2,2023-07-04T20:58:50,Bilbao,expenses,cash,-100.0,-29903.31
buyer_1,Aitor,López,1996-08-10,84942326Z,aitor.lopez@smartcode.org,563227,ES02209563310500830014,3761.2,2023-07-04T17:09:11,Bilbao,expenses,repairs,-98.17,-30001.48
buyer_1,Aitor,López,1996-08-10,84942326Z,aitor.lopez@smartcode.org,563227,ES02209563310500830014,3761.2,2023-07-05T09:46:05,Bilbao,expenses,rent,-217.48,-30218.96
buyer_1,Aitor,López,1996-08-10,84942326Z,aitor.lopez@smartcode.org,563227,ES02209563310500830014,3761.2,2023-07-05T11:17:55,Bilbao,expenses,gifts,-145.77,-30364.73
buyer_1,Aitor,López,1996-08-10,84942326Z,aitor.lopez@smartcode.org,563227,ES02209563310500830014,3761.2,2023-07-06T12:39:12,Bilbao,expenses,education,-59.68,-30424.41
buyer_1,Aitor,López,1996-08-10,84942326Z,aitor.lopez@smartcode.org,563227,ES02209563310500830014,3761.2,2023-07-06T17:04:45,Bilbao,expenses,repairs,-143.35,-30567.76
buyer_1,Aitor,López,1996-08-10,84942326Z,aitor.lopez@smartcode.org,563227,ES02209563310500830014,3761.2,2023-07-07T10:13:08,Bilbao,expenses,electricity,-19.8,-30587.56
buyer_1,Aitor,López,1996-08-10,84942326Z,aitor.lopez@smartcode.org,563227,ES02209563310500830014,3761.2,2023-07-07T17:06:55,Bilbao,expenses,gas,-15.57,-30603.13
buyer_1,Aitor,López,1996-08-10,84942326Z,aitor.lopez@smartcode.org,563227,ES02209563310500830014,3761.2,2023-07-07T13:27:36,Bilbao,expenses,phone,-11.51,-30614.64
buyer_1,Aitor,López,1996-08-10,84942326Z,aitor.lopez@smartcode.org,563227,ES02209563310500830014,3761.2,2023-07-07T17:37:01,Bilbao,expenses,cash,-100.0,-30714.64
buyer_1,Aitor,López,1996-08-10,84942326Z,aitor.lopez@smartcode.org,563227,ES02209563310500830014,3761.2,2023-07-08T11:54:44,Bilbao,expenses,electricity,-12.37,-30727.01
buyer_1,Aitor,López,1996-08-10,84942326Z,aitor.lopez@smartcode.org,563227,ES02209563310500830014,3761.2,2023-07-08T09:52:27,Bilbao,expenses,gas,-27.86,-30754.87
buyer_1,Aitor,López,1996-08-10,84942326Z,aitor.lopez@smartcode.org,563227,ES02209563310500830014,3761.2,2023-07-08T23:45:26,Bilbao,expenses,food,-61.37,-30816.24
buyer_1,Aitor,López,1996-08-10,84942326Z,aitor.lopez@smartcode.org,563227,ES02209563310500830014,3761.2,2023-07-10T20:45:45,Bilbao,expenses,cash,-100.0,-30916.24
buyer_1,Aitor,López,1996-08-10,84942326Z,aitor.lopez@smartcode.org,563227,ES02209563310500830014,3761.2,2023-07-12T11:05:55,Bilbao,expenses,travel,-245.55,-31161.79
buyer_1,Aitor,López,1996-08-10,84942326Z,aitor.lopez@smartcode.org,563227,ES02209563310500830014,3761.2,2023-07-13T21:53:53,Bilbao,expenses,cash,-100.0,-31261.79
buyer_1,Aitor,López,1996-08-10,84942326Z,aitor.lopez@smartcode.org,563227,ES02209563310500830014,3761.2,2023-07-17T18:47:25,Bilbao,expenses,food,-108.33,-31370.12
buyer_1,Aitor,López,1996-08-10,84942326Z,aitor.lopez@smartcode.org,563227,ES02209563310500830014,3761.2,2023-07-19T21:59:12,Bilbao,expenses,leisure,-40.46,-31410.58
buyer_1,Aitor,López,1996-08-10,84942326Z,aitor.lopez@smartcode.org,563227,ES02209563310500830014,3761.2,2023-07-20T08:55:21,Bilbao,expenses,cash,-100.0,-31510.58
buyer_1,Aitor,López,1996-08-10,84942326Z,aitor.lopez@smartcode.org,563227,ES02209563310500830014,3761.2,2023-07-21T20:35:27,Bilbao,expenses,cash,-100.0,-31610.58
buyer_1,Aitor,López,1996-08-10,84942326Z,aitor.lopez@smartcode.org,563227,ES02209563310500830014,3761.2,2023-07-21T13:19:04,Bilbao,expenses,gifts,-52.01,-31662.59
buyer_1,Aitor,López,1996-08-10,84942326Z,aitor.lopez@smartcode.org,563227,ES02209563310500830014,3761.2,2023-07-23T00:44:37,Bilbao,expenses,travel,-264.55,-31927.14
buyer_1,Aitor,López,1996-08-10,84942326Z,aitor.lopez@smartcode.org,563227,ES02209563310500830014,3761.2,2023-07-25T09:30:37,Bilbao,expenses,transport,-62.93,-31990.07
buyer_1,Aitor,López,1996-08-10,84942326Z,aitor.lopez@smartcode.org,563227,ES02209563310500830014,3761.2,2023-07-26T18:50:39,Bilbao,expenses,leisure,-73.68,-32063.75
buyer_1,Aitor,López,1996-08-10,84942326Z,aitor.lopez@smartcode.org,563227,ES02209563310500830014,3761.2,2023-07-27T14:59:55,Bilbao,expenses,food,-64.93,-32128.68
buyer_1,Aitor,López,1996-08-10,84942326Z,aitor.lopez@smartcode.org,563227,ES02209563310500830014,3761.2,2023-07-29T20:13:28,Bilbao,expenses,cash,-100.0,-32228.68
buyer_1,Aitor,López,1996-08-10,84942326Z,aitor.lopez@smartcode.org,563227,ES02209563310500830014,3761.2,2023-07-31T17:37:42,Bilbao,expenses,leisure,-71.27,-32299.95
buyer_1,Aitor,López,1996-08-10,84942326Z,aitor.lopez@smartcode.org,563227,ES02209563310500830014,3761.2,2023-08-01T13:19:12,Bilbao,incomes,salary,569.21,-31730.74
buyer_1,Aitor,López,1996-08-10,84942326Z,aitor.lopez@smartcode.org,563227,ES02209563310500830014,3761.2,2023-08-01T13:19:12,Bilbao,incomes,extra_income,102.64,-31628.1
buyer_1,Aitor,López,1996-08-10,84942326Z,aitor.lopez@smartcode.org,563227,ES02209563310500830014,3761.2,2023-08-01T15:47:09,Bilbao,expenses,transport,-55.83,-31683.93
buyer_1,Aitor,López,1996-08-10,84942326Z,aitor.lopez@smartcode.org,563227,ES02209563310500830014,3761.2,2023-08-01T18:04:27,Bilbao,expenses,cash,-100.0,-31783.93
buyer_1,Aitor,López,1996-08-10,84942326Z,aitor.lopez@smartcode.org,563227,ES02209563310500830014,3761.2,2023-08-02T12:41:22,Bilbao,expenses,cash,-100.0,-31883.93
buyer_1,Aitor,López,1996-08-10,84942326Z,aitor.lopez@smartcode.org,563227,ES02209563310500830014,3761.2,2023-08-03T11:11:18,Bilbao,expenses,cash,-100.0,-31983.93
buyer_1,Aitor,López,1996-08-10,84942326Z,aitor.lopez@smartcode.org,563227,ES02209563310500830014,3761.2,2023-08-05T08:40:05,Bilbao,expenses,rent,-217.48,-32201.41
buyer_1,Aitor,López,1996-08-10,84942326Z,aitor.lopez@smartcode.org,563227,ES02209563310500830014,3761.2,2023-08-05T13:21:17,Bilbao,expenses,internet,-11.95,-32213.36
buyer_1,Aitor,López,1996-08-10,84942326Z,aitor.lopez@smartcode.org,563227,ES02209563310500830014,3761.2,2023-08-05T18:41:06,Bilbao,expenses,leisure,-51.29,-32264.65
buyer_1,Aitor,López,1996-08-10,84942326Z,aitor.lopez@smartcode.org,563227,ES02209563310500830014,3761.2,2023-08-06T06:33:54,Bilbao,expenses,cash,-100.0,-32364.65
buyer_1,Aitor,López,1996-08-10,84942326Z,aitor.lopez@smartcode.org,563227,ES02209563310500830014,3761.2,2023-08-06T21:51:35,Bilbao,expenses,repairs,-83.34,-32447.99
buyer_1,Aitor,López,1996-08-10,84942326Z,aitor.lopez@smartcode.org,563227,ES02209563310500830014,3761.2,2023-08-07T20:58:26,Bilbao,expenses,gas,-31.12,-32479.11
buyer_1,Aitor,López,1996-08-10,84942326Z,aitor.lopez@smartcode.org,563227,ES02209563310500830014,3761.2,2023-08-07T23:37:57,Bilbao,expenses,internet,-11.95,-32491.06
buyer_1,Aitor,López,1996-08-10,84942326Z,aitor.lopez@smartcode.org,563227,ES02209563310500830014,3761.2,2023-08-07T13:24:04,Bilbao,expenses,food,-111.66,-32602.72
buyer_1,Aitor,López,1996-08-10,84942326Z,aitor.lopez@smartcode.org,563227,ES02209563310500830014,3761.2,2023-08-07T11:33:43,Bilbao,expenses,transport,-64.75,-32667.47
buyer_1,Aitor,López,1996-08-10,84942326Z,aitor.lopez@smartcode.org,563227,ES02209563310500830014,3761.2,2023-08-07T13:38:20,Bilbao,expenses,appliances,-58.85,-32726.32
buyer_1,Aitor,López,1996-08-10,84942326Z,aitor.lopez@smartcode.org,563227,ES02209563310500830014,3761.2,2023-08-08T13:59:42,Bilbao,expenses,healthcare,-150.38,-32876.7
buyer_1,Aitor,López,1996-08-10,84942326Z,aitor.lopez@smartcode.org,563227,ES02209563310500830014,3761.2,2023-08-12T11:21:35,Bilbao,expenses,cash,-100.0,-32976.7
buyer_1,Aitor,López,1996-08-10,84942326Z,aitor.lopez@smartcode.org,563227,ES02209563310500830014,3761.2,2023-08-13T23:10:34,Bilbao,expenses,leisure,-60.9,-33037.6
buyer_1,Aitor,López,1996-08-10,84942326Z,aitor.lopez@smartcode.org,563227,ES02209563310500830014,3761.2,2023-08-16T13:57:44,Bilbao,expenses,cash,-100.0,-33137.6
buyer_1,Aitor,López,1996-08-10,84942326Z,aitor.lopez@smartcode.org,563227,ES02209563310500830014,3761.2,2023-08-16T18:53:05,Bilbao,expenses,gifts,-78.65,-33216.25
buyer_1,Aitor,López,1996-08-10,84942326Z,aitor.lopez@smartcode.org,563227,ES02209563310500830014,3761.2,2023-08-17T20:37:00,Bilbao,expenses,food,-108.94,-33325.19
buyer_1,Aitor,López,1996-08-10,84942326Z,aitor.lopez@smartcode.org,563227,ES02209563310500830014,3761.2,2023-08-17T17:17:07,Bilbao,expenses,repairs,-58.47,-33383.66
buyer_1,Aitor,López,1996-08-10,84942326Z,aitor.lopez@smartcode.org,563227,ES02209563310500830014,3761.2,2023-08-19T20:14:00,Bilbao,expenses,food,-80.27,-33463.93
buyer_1,Aitor,López,1996-08-10,84942326Z,aitor.lopez@smartcode.org,563227,ES02209563310500830014,3761.2,2023-08-21T17:45:44,Bilbao,expenses,gifts,-196.93,-33660.86
buyer_1,Aitor,López,1996-08-10,84942326Z,aitor.lopez@smartcode.org,563227,ES02209563310500830014,3761.2,2023-08-22T10:19:46,Bilbao,expenses,transport,-73.91,-33734.77
buyer_1,Aitor,López,1996-08-10,84942326Z,aitor.lopez@smartcode.org,563227,ES02209563310500830014,3761.2,2023-08-23T12:48:21,Bilbao,expenses,transport,-76.34,-33811.11
buyer_1,Aitor,López,1996-08-10,84942326Z,aitor.lopez@smartcode.org,563227,ES02209563310500830014,3761.2,2023-08-25T13:37:47,Bilbao,expenses,leisure,-51.77,-33862.88
buyer_1,Aitor,López,1996-08-10,84942326Z,aitor.lopez@smartcode.org,563227,ES02209563310500830014,3761.2,2023-08-25T08:24:02,Bilbao,expenses,clothing,-73.71,-33936.59
buyer_1,Aitor,López,1996-08-10,84942326Z,aitor.lopez@smartcode.org,563227,ES02209563310500830014,3761.2,2023-08-26T21:42:54,Bilbao,expenses,leisure,-47.68,-33984.27
buyer_1,Aitor,López,1996-08-10,84942326Z,aitor.lopez@smartcode.org,563227,ES02209563310500830014,3761.2,2023-08-27T16:33:32,Bilbao,expenses,clothing,-101.26,-34085.53
buyer_1,Aitor,López,1996-08-10,84942326Z,aitor.lopez@smartcode.org,563227,ES02209563310500830014,3761.2,2023-08-27T18:45:38,Bilbao,expenses,cash,-100.0,-34185.53
buyer_1,Aitor,López,1996-08-10,84942326Z,aitor.lopez@smartcode.org,563227,ES02209563310500830014,3761.2,2023-08-28T13:06:15,Bilbao,expenses,food,-121.56,-34307.09
buyer_1,Aitor,López,1996-08-10,84942326Z,aitor.lopez@smartcode.org,563227,ES02209563310500830014,3761.2,2023-08-28T18:39:24,Bilbao,expenses,gifts,-54.72,-34361.81
buyer_1,Aitor,López,1996-08-10,84942326Z,aitor.lopez@smartcode.org,563227,ES02209563310500830014,3761.2,2023-08-30T19:48:06,Bilbao,expenses,transport,-83.98,-34445.79
buyer_1,Aitor,López,1996-08-10,84942326Z,aitor.lopez@smartcode.org,563227,ES02209563310500830014,3761.2,2023-08-31T11:32:42,Bilbao,expenses,food,-106.54,-34552.33
buyer_1,Aitor,López,1996-08-10,84942326Z,aitor.lopez@smartcode.org,563227,ES02209563310500830014,3761.2,2023-09-01T10:49:38,Bilbao,incomes,salary,569.21,-33983.12
buyer_1,Aitor,López,1996-08-10,84942326Z,aitor.lopez@smartcode.org,563227,ES02209563310500830014,3761.2,2023-09-04T17:31:03,Bilbao,expenses,clothing,-126.72,-34109.84
buyer_1,Aitor,López,1996-08-10,84942326Z,aitor.lopez@smartcode.org,563227,ES02209563310500830014,3761.2,2023-09-05T13:12:03,Bilbao,expenses,rent,-217.48,-34327.32
buyer_1,Aitor,López,1996-08-10,84942326Z,aitor.lopez@smartcode.org,563227,ES02209563310500830014,3761.2,2023-09-05T19:46:20,Bilbao,expenses,internet,-11.95,-34339.27
buyer_1,Aitor,López,1996-08-10,84942326Z,aitor.lopez@smartcode.org,563227,ES02209563310500830014,3761.2,2023-09-05T05:52:24,Bilbao,expenses,leisure,-27.93,-34367.2
buyer_1,Aitor,López,1996-08-10,84942326Z,aitor.lopez@smartcode.org,563227,ES02209563310500830014,3761.2,2023-09-05T13:23:26,Bilbao,expenses,education,-62.85,-34430.05
buyer_1,Aitor,López,1996-08-10,84942326Z,aitor.lopez@smartcode.org,563227,ES02209563310500830014,3761.2,2023-09-06T09:03:21,Bilbao,expenses,electricity,-24.0,-34454.05
buyer_1,Aitor,López,1996-08-10,84942326Z,aitor.lopez@smartcode.org,563227,ES02209563310500830014,3761.2,2023-09-06T20:03:09,Bilbao,expenses,gas,-10.51,-34464.56
buyer_1,Aitor,López,1996-08-10,84942326Z,aitor.lopez@smartcode.org,563227,ES02209563310500830014,3761.2,2023-09-06T16:21:54,Bilbao,expenses,leisure,-43.0,-34507.56
buyer_1,Aitor,López,1996-08-10,84942326Z,aitor.lopez@smartcode.org,563227,ES02209563310500830014,3761.2,2023-09-06T06:46:18,Bilbao,expenses,healthcare,-62.0,-34569.56
buyer_1,Aitor,López,1996-08-10,84942326Z,aitor.lopez@smartcode.org,563227,ES02209563310500830014,3761.2,2023-09-06T14:57:33,Bilbao,expenses,cash,-100.0,-34669.56
buyer_1,Aitor,López,1996-08-10,84942326Z,aitor.lopez@smartcode.org,563227,ES02209563310500830014,3761.2,2023-09-07T20:04:57,Bilbao,expenses,gas,-25.54,-34695.1
buyer_1,Aitor,López,1996-08-10,84942326Z,aitor.lopez@smartcode.org,563227,ES02209563310500830014,3761.2,2023-09-07T09:20:49,Bilbao,expenses,repairs,-158.68,-34853.78
buyer_1,Aitor,López,1996-08-10,84942326Z,aitor.lopez@smartcode.org,563227,ES02209563310500830014,3761.2,2023-09-08T12:23:14,Bilbao,expenses,gas,-26.2,-34879.98
buyer_1,Aitor,López,1996-08-10,84942326Z,aitor.lopez@smartcode.org,563227,ES02209563310500830014,3761.2,2023-09-08T23:49:14,Bilbao,expenses,internet,-11.95,-34891.93
buyer_1,Aitor,López,1996-08-10,84942326Z,aitor.lopez@smartcode.org,563227,ES02209563310500830014,3761.2,2023-09-08T16:07:15,Bilbao,expenses,cash,-100.0,-34991.93
buyer_1,Aitor,López,1996-08-10,84942326Z,aitor.lopez@smartcode.org,563227,ES02209563310500830014,3761.2,2023-09-09T14:40:07,Bilbao,expenses,education,-53.46,-35045.39
buyer_1,Aitor,López,1996-08-10,84942326Z,aitor.lopez@smartcode.org,563227,ES02209563310500830014,3761.2,2023-09-09T13:28:37,Bilbao,expenses,cash,-100.0,-35145.39
buyer_1,Aitor,López,1996-08-10,84942326Z,aitor.lopez@smartcode.org,563227,ES02209563310500830014,3761.2,2023-09-10T13:11:18,Bilbao,expenses,transport,-84.05,-35229.44
buyer_1,Aitor,López,1996-08-10,84942326Z,aitor.lopez@smartcode.org,563227,ES02209563310500830014,3761.2,2023-09-10T05:10:32,Bilbao,expenses,cash,-100.0,-35329.44
buyer_1,Aitor,López,1996-08-10,84942326Z,aitor.lopez@smartcode.org,563227,ES02209563310500830014,3761.2,2023-09-11T10:40:29,Bilbao,expenses,food,-91.77,-35421.21
buyer_1,Aitor,López,1996-08-10,84942326Z,aitor.lopez@smartcode.org,563227,ES02209563310500830014,3761.2,2023-09-16T16:47:59,Bilbao,expenses,clothing,-122.52,-35543.73
buyer_1,Aitor,López,1996-08-10,84942326Z,aitor.lopez@smartcode.org,563227,ES02209563310500830014,3761.2,2023-09-16T09:59:02,Bilbao,expenses,cash,-100.0,-35643.73
buyer_1,Aitor,López,1996-08-10,84942326Z,aitor.lopez@smartcode.org,563227,ES02209563310500830014,3761.2,2023-09-18T14:54:32,Bilbao,expenses,leisure,-24.27,-35668.0
buyer_1,Aitor,López,1996-08-10,84942326Z,aitor.lopez@smartcode.org,563227,ES02209563310500830014,3761.2,2023-09-19T08:28:59,Bilbao,expenses,transport,-79.25,-35747.25
buyer_1,Aitor,López,1996-08-10,84942326Z,aitor.lopez@smartcode.org,563227,ES02209563310500830014,3761.2,2023-09-20T21:57:56,Bilbao,expenses,clothing,-124.3,-35871.55
buyer_1,Aitor,López,1996-08-10,84942326Z,aitor.lopez@smartcode.org,563227,ES02209563310500830014,3761.2,2023-09-21T16:34:18,Bilbao,expenses,leisure,-83.11,-35954.66
buyer_1,Aitor,López,1996-08-10,84942326Z,aitor.lopez@smartcode.org,563227,ES02209563310500830014,3761.2,2023-09-21T19:07:05,Bilbao,expenses,repairs,-138.7,-36093.36
buyer_1,Aitor,López,1996-08-10,84942326Z,aitor.lopez@smartcode.org,563227,ES02209563310500830014,3761.2,2023-09-21T01:36:30,Bilbao,expenses,gifts,-14.99,-36108.35
buyer_1,Aitor,López,1996-08-10,84942326Z,aitor.lopez@smartcode.org,563227,ES02209563310500830014,3761.2,2023-09-22T11:32:53,Bilbao,expenses,education,-69.73,-36178.08
buyer_1,Aitor,López,1996-08-10,84942326Z,aitor.lopez@smartcode.org,563227,ES02209563310500830014,3761.2,2023-09-24T22:00:46,Bilbao,expenses,food,-66.32,-36244.4
buyer_1,Aitor,López,1996-08-10,84942326Z,aitor.lopez@smartcode.org,563227,ES02209563310500830014,3761.2,2023-09-26T19:19:11,Bilbao,expenses,clothing,-100.08,-36344.48
buyer_1,Aitor,López,1996-08-10,84942326Z,aitor.lopez@smartcode.org,563227,ES02209563310500830014,3761.2,2023-09-27T17:55:35,Bilbao,expenses,gifts,-92.26,-36436.74
buyer_1,Aitor,López,1996-08-10,84942326Z,aitor.lopez@smartcode.org,563227,ES02209563310500830014,3761.2,2023-10-01T13:13:54,Bilbao,incomes,salary,569.21,-35867.53
buyer_1,Aitor,López,1996-08-10,84942326Z,aitor.lopez@smartcode.org,563227,ES02209563310500830014,3761.2,2023-10-02T20:10:57,Bilbao,expenses,food,-116.93,-35984.46
buyer_1,Aitor,López,1996-08-10,84942326Z,aitor.lopez@smartcode.org,563227,ES02209563310500830014,3761.2,2023-10-02T17:41:13,Bilbao,expenses,leisure,-64.44,-36048.9
buyer_1,Aitor,López,1996-08-10,84942326Z,aitor.lopez@smartcode.org,563227,ES02209563310500830014,3761.2,2023-10-05T17:02:31,Bilbao,expenses,rent,-217.48,-36266.38
buyer_1,Aitor,López,1996-08-10,84942326Z,aitor.lopez@smartcode.org,563227,ES02209563310500830014,3761.2,2023-10-05T19:07:58,Bilbao,expenses,water,-5.79,-36272.17
buyer_1,Aitor,López,1996-08-10,84942326Z,aitor.lopez@smartcode.org,563227,ES02209563310500830014,3761.2,2023-10-05T14:48:47,Bilbao,expenses,gas,-29.91,-36302.08
buyer_1,Aitor,López,1996-08-10,84942326Z,aitor.lopez@smartcode.org,563227,ES02209563310500830014,3761.2,2023-10-05T15:08:27,Bilbao,expenses,internet,-11.95,-36314.03
buyer_1,Aitor,López,1996-08-10,84942326Z,aitor.lopez@smartcode.org,563227,ES02209563310500830014,3761.2,2023-10-05T17:01:16,Bilbao,expenses,phone,-11.96,-36325.99
buyer_1,Aitor,López,1996-08-10,84942326Z,aitor.lopez@smartcode.org,563227,ES02209563310500830014,3761.2,2023-10-05T11:56:30,Bilbao,expenses,food,-111.49,-36437.48
buyer_1,Aitor,López,1996-08-10,84942326Z,aitor.lopez@smartcode.org,563227,ES02209563310500830014,3761.2,2023-10-06T08:09:09,Bilbao,expenses,electricity,-22.39,-36459.87
buyer_1,Aitor,López,1996-08-10,84942326Z,aitor.lopez@smartcode.org,563227,ES02209563310500830014,3761.2,2023-10-06T20:38:11,Bilbao,expenses,gas,-32.0,-36491.87
buyer_1,Aitor,López,1996-08-10,84942326Z,aitor.lopez@smartcode.org,563227,ES02209563310500830014,3761.2,2023-10-06T22:32:55,Bilbao,expenses,internet,-11.95,-36503.82
buyer_1,Aitor,López,1996-08-10,84942326Z,aitor.lopez@smartcode.org,563227,ES02209563310500830014,3761.2,2023-10-07T18:52:12,Bilbao,expenses,water,-10.56,-36514.38
buyer_1,Aitor,López,1996-08-10,84942326Z,aitor.lopez@smartcode.org,563227,ES02209563310500830014,3761.2,2023-10-07T14:17:37,Bilbao,expenses,food,-93.49,-36607.87
buyer_1,Aitor,López,1996-08-10,84942326Z,aitor.lopez@smartcode.org,563227,ES02209563310500830014,3761.2,2023-10-08T14:30:23,Bilbao,expenses,phone,-11.93,-36619.8
buyer_1,Aitor,López,1996-08-10,84942326Z,aitor.lopez@smartcode.org,563227,ES02209563310500830014,3761.2,2023-10-08T09:11:40,Bilbao,expenses,food,-105.46,-36725.26
buyer_1,Aitor,López,1996-08-10,84942326Z,aitor.lopez@smartcode.org,563227,ES02209563310500830014,3761.2,2023-10-08T18:49:06,Bilbao,expenses,education,-65.32,-36790.58
buyer_1,Aitor,López,1996-08-10,84942326Z,aitor.lopez@smartcode.org,563227,ES02209563310500830014,3761.2,2023-10-08T16:51:05,Bilbao,expenses,cash,-98.87,-36889.45
buyer_1,Aitor,López,1996-08-10,84942326Z,aitor.lopez@smartcode.org,563227,ES02209563310500830014,3761.2,2023-10-09T17:10:31,Bilbao,expenses,repairs,-53.02,-36942.47
buyer_1,Aitor,López,1996-08-10,84942326Z,aitor.lopez@smartcode.org,563227,ES02209563310500830014,3761.2,2023-10-16T15:18:55,Bilbao,expenses,transport,-63.32,-37005.79
buyer_1,Aitor,López,1996-08-10,84942326Z,aitor.lopez@smartcode.org,563227,ES02209563310500830014,3761.2,2023-10-17T11:28:20,Bilbao,expenses,appliances,-108.51,-37114.3
buyer_1,Aitor,López,1996-08-10,84942326Z,aitor.lopez@smartcode.org,563227,ES02209563310500830014,3761.2,2023-10-18T08:06:08,Bilbao,expenses,leisure,-24.17,-37138.47
buyer_1,Aitor,López,1996-08-10,84942326Z,aitor.lopez@smartcode.org,563227,ES02209563310500830014,3761.2,2023-10-19T08:54:03,Bilbao,expenses,transport,-59.72,-37198.19
buyer_1,Aitor,López,1996-08-10,84942326Z,aitor.lopez@smartcode.org,563227,ES02209563310500830014,3761.2,2023-10-21T18:30:45,Bilbao,expenses,education,-74.57,-37272.76
buyer_1,Aitor,López,1996-08-10,84942326Z,aitor.lopez@smartcode.org,563227,ES02209563310500830014,3761.2,2023-10-23T10:42:56,Bilbao,expenses,leisure,-19.69,-37292.45
buyer_1,Aitor,López,1996-08-10,84942326Z,aitor.lopez@smartcode.org,563227,ES02209563310500830014,3761.2,2023-10-24T13:40:03,Bilbao,expenses,leisure,-71.65,-37364.1
buyer_1,Aitor,López,1996-08-10,84942326Z,aitor.lopez@smartcode.org,563227,ES02209563310500830014,3761.2,2023-10-25T19:51:38,Bilbao,expenses,gifts,-224.71,-37588.81
buyer_1,Aitor,López,1996-08-10,84942326Z,aitor.lopez@smartcode.org,563227,ES02209563310500830014,3761.2,2023-10-27T16:54:25,Bilbao,expenses,transport,-84.55,-37673.36
buyer_1,Aitor,López,1996-08-10,84942326Z,aitor.lopez@smartcode.org,563227,ES02209563310500830014,3761.2,2023-10-28T14:10:44,Bilbao,expenses,gifts,-104.61,-37777.97
buyer_1,Aitor,López,1996-08-10,84942326Z,aitor.lopez@smartcode.org,563227,ES02209563310500830014,3761.2,2023-10-29T15:18:53,Bilbao,expenses,food,-106.39,-37884.36
buyer_1,Aitor,López,1996-08-10,84942326Z,aitor.lopez@smartcode.org,563227,ES02209563310500830014,3761.2,2023-10-29T15:52:10,Bilbao,expenses,transport,-45.39,-37929.75
buyer_1,Aitor,López,1996-08-10,84942326Z,aitor.lopez@smartcode.org,563227,ES02209563310500830014,3761.2,2023-10-29T09:13:48,Bilbao,expenses,clothing,-71.82,-38001.57
buyer_1,Aitor,López,1996-08-10,84942326Z,aitor.lopez@smartcode.org,563227,ES02209563310500830014,3761.2,2023-10-29T18:28:31,Bilbao,expenses,cash,-50.69,-38052.26
buyer_1,Aitor,López,1996-08-10,84942326Z,aitor.lopez@smartcode.org,563227,ES02209563310500830014,3761.2,2023-10-30T13:19:48,Bilbao,expenses,transport,-41.4,-38093.66
buyer_1,Aitor,López,1996-08-10,84942326Z,aitor.lopez@smartcode.org,563227,ES02209563310500830014,3761.2,2023-10-31T15:00:07,Bilbao,expenses,clothing,-48.87,-38142.53
buyer_1,Aitor,López,1996-08-10,84942326Z,aitor.lopez@smartcode.org,563227,ES02209563310500830014,3761.2,2023-10-31T10:44:40,Bilbao,expenses,car,-77.45,-38219.98
buyer_1,Aitor,López,1996-08-10,84942326Z,aitor.lopez@smartcode.org,563227,ES02209563310500830014,3761.2,2023-11-01T14:50:49,Bilbao,incomes,salary,569.21,-37650.77
buyer_1,Aitor,López,1996-08-10,84942326Z,aitor.lopez@smartcode.org,563227,ES02209563310500830014,3761.2,2023-11-01T14:50:49,Bilbao,incomes,extra_income,102.64,-37548.13
buyer_1,Aitor,López,1996-08-10,84942326Z,aitor.lopez@smartcode.org,563227,ES02209563310500830014,3761.2,2023-11-01T20:35:54,Bilbao,expenses,leisure,-54.65,-37602.78
buyer_1,Aitor,López,1996-08-10,84942326Z,aitor.lopez@smartcode.org,563227,ES02209563310500830014,3761.2,2023-11-02T19:27:20,Bilbao,expenses,transport,-83.66,-37686.44
buyer_1,Aitor,López,1996-08-10,84942326Z,aitor.lopez@smartcode.org,563227,ES02209563310500830014,3761.2,2023-11-03T19:31:49,Bilbao,expenses,leisure,-21.59,-37708.03
buyer_1,Aitor,López,1996-08-10,84942326Z,aitor.lopez@smartcode.org,563227,ES02209563310500830014,3761.2,2023-11-05T11:16:17,Bilbao,expenses,rent,-217.48,-37925.51
buyer_1,Aitor,López,1996-08-10,84942326Z,aitor.lopez@smartcode.org,563227,ES02209563310500830014,3761.2,2023-11-05T19:03:51,Bilbao,expenses,electricity,-9.75,-37935.26
buyer_1,Aitor,López,1996-08-10,84942326Z,aitor.lopez@smartcode.org,563227,ES02209563310500830014,3761.2,2023-11-06T15:01:23,Bilbao,expenses,cash,-100.0,-38035.26
buyer_1,Aitor,López,1996-08-10,84942326Z,aitor.lopez@smartcode.org,563227,ES02209563310500830014,3761.2,2023-11-07T03:47:57,Bilbao,expenses,water,-9.88,-38045.14
buyer_1,Aitor,López,1996-08-10,84942326Z,aitor.lopez@smartcode.org,563227,ES02209563310500830014,3761.2,2023-11-07T23:39:05,Bilbao,expenses,electricity,-22.9,-38068.04
buyer_1,Aitor,López,1996-08-10,84942326Z,aitor.lopez@smartcode.org,563227,ES02209563310500830014,3761.2,2023-11-07T19:59:44,Bilbao,expenses,education,-77.99,-38146.03
buyer_1,Aitor,López,1996-08-10,84942326Z,aitor.lopez@smartcode.org,563227,ES02209563310500830014,3761.2,2023-11-08T15:45:17,Bilbao,expenses,electricity,-15.03,-38161.06
buyer_1,Aitor,López,1996-08-10,84942326Z,aitor.lopez@smartcode.org,563227,ES02209563310500830014,3761.2,2023-11-08T06:03:47,Bilbao,expenses,internet,-11.95,-38173.01
buyer_1,Aitor,López,1996-08-10,84942326Z,aitor.lopez@smartcode.org,563227,ES02209563310500830014,3761.2,2023-11-08T00:10:44,Bilbao,expenses,phone,-11.52,-38184.53
buyer_1,Aitor,López,1996-08-10,84942326Z,aitor.lopez@smartcode.org,563227,ES02209563310500830014,3761.2,2023-11-08T15:22:56,Bilbao,expenses,food,-61.93,-38246.46
buyer_1,Aitor,López,1996-08-10,84942326Z,aitor.lopez@smartcode.org,563227,ES02209563310500830014,3761.2,2023-11-08T18:59:53,Bilbao,expenses,cash,-100.0,-38346.46
buyer_1,Aitor,López,1996-08-10,84942326Z,aitor.lopez@smartcode.org,563227,ES02209563310500830014,3761.2,2023-11-09T12:19:59,Bilbao,expenses,repairs,-173.88,-38520.34
buyer_1,Aitor,López,1996-08-10,84942326Z,aitor.lopez@smartcode.org,563227,ES02209563310500830014,3761.2,2023-11-10T12:27:34,Bilbao,expenses,leisure,-65.76,-38586.1
buyer_1,Aitor,López,1996-08-10,84942326Z,aitor.lopez@smartcode.org,563227,ES02209563310500830014,3761.2,2023-11-10T11:11:38,Bilbao,expenses,education,-60.59,-38646.69
buyer_1,Aitor,López,1996-08-10,84942326Z,aitor.lopez@smartcode.org,563227,ES02209563310500830014,3761.2,2023-11-10T13:58:00,Bilbao,expenses,cash,-99.55,-38746.24
buyer_1,Aitor,López,1996-08-10,84942326Z,aitor.lopez@smartcode.org,563227,ES02209563310500830014,3761.2,2023-11-11T09:14:19,Bilbao,expenses,cash,-100.0,-38846.24
buyer_1,Aitor,López,1996-08-10,84942326Z,aitor.lopez@smartcode.org,563227,ES02209563310500830014,3761.2,2023-11-11T11:29:07,Bilbao,expenses,travel,-253.52,-39099.76
buyer_1,Aitor,López,1996-08-10,84942326Z,aitor.lopez@smartcode.org,563227,ES02209563310500830014,3761.2,2023-11-13T19:55:22,Bilbao,expenses,cash,-100.0,-39199.76
buyer_1,Aitor,López,1996-08-10,84942326Z,aitor.lopez@smartcode.org,563227,ES02209563310500830014,3761.2,2023-11-13T19:57:21,Bilbao,expenses,appliances,-94.71,-39294.47
buyer_1,Aitor,López,1996-08-10,84942326Z,aitor.lopez@smartcode.org,563227,ES02209563310500830014,3761.2,2023-11-14T20:21:36,Bilbao,expenses,cash,-100.0,-39394.47
buyer_1,Aitor,López,1996-08-10,84942326Z,aitor.lopez@smartcode.org,563227,ES02209563310500830014,3761.2,2023-11-15T06:39:48,Bilbao,expenses,gifts,-63.86,-39458.33
buyer_1,Aitor,López,1996-08-10,84942326Z,aitor.lopez@smartcode.org,563227,ES02209563310500830014,3761.2,2023-11-16T17:57:31,Bilbao,expenses,travel,-277.41,-39735.74
buyer_1,Aitor,López,1996-08-10,84942326Z,aitor.lopez@smartcode.org,563227,ES02209563310500830014,3761.2,2023-11-17T17:11:40,Bilbao,expenses,clothing,-120.75,-39856.49
buyer_1,Aitor,López,1996-08-10,84942326Z,aitor.lopez@smartcode.org,563227,ES02209563310500830014,3761.2,2023-11-21T11:50:02,Bilbao,expenses,repairs,-133.51,-39990.0
buyer_1,Aitor,López,1996-08-10,84942326Z,aitor.lopez@smartcode.org,563227,ES02209563310500830014,3761.2,2023-11-24T15:48:30,Bilbao,expenses,leisure,-37.4,-40027.4
buyer_1,Aitor,López,1996-08-10,84942326Z,aitor.lopez@smartcode.org,563227,ES02209563310500830014,3761.2,2023-11-27T03:41:21,Bilbao,expenses,gifts,-154.5,-40181.9
buyer_1,Aitor,López,1996-08-10,84942326Z,aitor.lopez@smartcode.org,563227,ES02209563310500830014,3761.2,2023-11-28T23:23:30,Bilbao,expenses,food,-67.52,-40249.42
buyer_1,Aitor,López,1996-08-10,84942326Z,aitor.lopez@smartcode.org,563227,ES02209563310500830014,3761.2,2023-11-28T11:47:14,Bilbao,expenses,repairs,-27.89,-40277.31
buyer_1,Aitor,López,1996-08-10,84942326Z,aitor.lopez@smartcode.org,563227,ES02209563310500830014,3761.2,2023-11-30T15:44:45,Bilbao,expenses,leisure,-43.4,-40320.71
buyer_1,Aitor,López,1996-08-10,84942326Z,aitor.lopez@smartcode.org,563227,ES02209563310500830014,3761.2,2023-12-01T09:39:49,Bilbao,incomes,salary,569.21,-39751.5
buyer_1,Aitor,López,1996-08-10,84942326Z,aitor.lopez@smartcode.org,563227,ES02209563310500830014,3761.2,2023-12-01T09:39:49,Bilbao,incomes,salary_bonus,437.39,-39314.11
buyer_1,Aitor,López,1996-08-10,84942326Z,aitor.lopez@smartcode.org,563227,ES02209563310500830014,3761.2,2023-12-02T16:00:25,Bilbao,expenses,food,-87.98,-39402.09
buyer_1,Aitor,López,1996-08-10,84942326Z,aitor.lopez@smartcode.org,563227,ES02209563310500830014,3761.2,2023-12-04T21:57:23,Bilbao,expenses,leisure,-26.98,-39429.07
buyer_1,Aitor,López,1996-08-10,84942326Z,aitor.lopez@smartcode.org,563227,ES02209563310500830014,3761.2,2023-12-05T16:14:46,Bilbao,expenses,rent,-217.48,-39646.55
buyer_1,Aitor,López,1996-08-10,84942326Z,aitor.lopez@smartcode.org,563227,ES02209563310500830014,3761.2,2023-12-06T13:06:47,Bilbao,expenses,electricity,-13.06,-39659.61
buyer_1,Aitor,López,1996-08-10,84942326Z,aitor.lopez@smartcode.org,563227,ES02209563310500830014,3761.2,2023-12-06T10:31:47,Bilbao,expenses,food,-113.66,-39773.27
buyer_1,Aitor,López,1996-08-10,84942326Z,aitor.lopez@smartcode.org,563227,ES02209563310500830014,3761.2,2023-12-06T15:19:35,Bilbao,expenses,cash,-100.0,-39873.27
buyer_1,Aitor,López,1996-08-10,84942326Z,aitor.lopez@smartcode.org,563227,ES02209563310500830014,3761.2,2023-12-07T20:01:15,Bilbao,expenses,phone,-10.69,-39883.96
buyer_1,Aitor,López,1996-08-10,84942326Z,aitor.lopez@smartcode.org,563227,ES02209563310500830014,3761.2,2023-12-07T14:34:17,Bilbao,expenses,cash,-100.0,-39983.96
buyer_1,Aitor,López,1996-08-10,84942326Z,aitor.lopez@smartcode.org,563227,ES02209563310500830014,3761.2,2023-12-08T05:23:34,Bilbao,expenses,electricity,-12.64,-39996.6
buyer_1,Aitor,López,1996-08-10,84942326Z,aitor.lopez@smartcode.org,563227,ES02209563310500830014,3761.2,2023-12-08T02:52:26,Bilbao,expenses,internet,-11.95,-40008.55
buyer_1,Aitor,López,1996-08-10,84942326Z,aitor.lopez@smartcode.org,563227,ES02209563310500830014,3761.2,2023-12-09T19:58:15,Bilbao,expenses,leisure,-69.95,-40078.5
buyer_1,Aitor,López,1996-08-10,84942326Z,aitor.lopez@smartcode.org,563227,ES02209563310500830014,3761.2,2023-12-09T13:45:17,Bilbao,expenses,cash,-100.0,-40178.5
buyer_1,Aitor,López,1996-08-10,84942326Z,aitor.lopez@smartcode.org,563227,ES02209563310500830014,3761.2,2023-12-12T14:46:46,Bilbao,expenses,food,-88.38,-40266.88
buyer_1,Aitor,López,1996-08-10,84942326Z,aitor.lopez@smartcode.org,563227,ES02209563310500830014,3761.2,2023-12-12T20:50:26,Bilbao,expenses,cash,-100.0,-40366.88
buyer_1,Aitor,López,1996-08-10,84942326Z,aitor.lopez@smartcode.org,563227,ES02209563310500830014,3761.2,2023-12-14T09:41:30,Bilbao,expenses,food,-111.53,-40478.41
buyer_1,Aitor,López,1996-08-10,84942326Z,aitor.lopez@smartcode.org,563227,ES02209563310500830014,3761.2,2023-12-18T20:11:10,Bilbao,expenses,leisure,-27.3,-40505.71
buyer_1,Aitor,López,1996-08-10,84942326Z,aitor.lopez@smartcode.org,563227,ES02209563310500830014,3761.2,2023-12-23T11:54:23,Bilbao,expenses,cash,-100.0,-40605.71
buyer_1,Aitor,López,1996-08-10,84942326Z,aitor.lopez@smartcode.org,563227,ES02209563310500830014,3761.2,2023-12-27T06:51:22,Bilbao,expenses,repairs,-152.64,-40758.35
buyer_1,Aitor,López,1996-08-10,84942326Z,aitor.lopez@smartcode.org,563227,ES02209563310500830014,3761.2,2023-12-29T14:48:10,Bilbao,expenses,food,-108.88,-40867.23
buyer_1,Aitor,López,1996-08-10,84942326Z,aitor.lopez@smartcode.org,563227,ES02209563310500830014,3761.2,2023-12-30T18:49:53,Bilbao,expenses,food,-83.15,-40950.38
buyer_1,Aitor,López,1996-08-10,84942326Z,aitor.lopez@smartcode.org,563227,ES02209563310500830014,3761.2,2023-12-31T21:06:40,Bilbao,expenses,healthcare,-167.98,-41118.36
buyer_1,Aitor,López,1996-08-10,84942326Z,aitor.lopez@smartcode.org,563227,ES02209563310500830014,3761.2,2024-01-01T10:27:53,Bilbao,incomes,salary,582.24,-40536.12
buyer_1,Aitor,López,1996-08-10,84942326Z,aitor.lopez@smartcode.org,563227,ES02209563310500830014,3761.2,2024-01-02T17:02:54,Bilbao,expenses,food,-120.77,-40656.89
buyer_1,Aitor,López,1996-08-10,84942326Z,aitor.lopez@smartcode.org,563227,ES02209563310500830014,3761.2,2024-01-02T19:55:45,Bilbao,expenses,transport,-43.93,-40700.82
buyer_1,Aitor,López,1996-08-10,84942326Z,aitor.lopez@smartcode.org,563227,ES02209563310500830014,3761.2,2024-01-03T09:25:05,Bilbao,expenses,cash,-100.0,-40800.82
buyer_1,Aitor,López,1996-08-10,84942326Z,aitor.lopez@smartcode.org,563227,ES02209563310500830014,3761.2,2024-01-03T09:59:26,Bilbao,expenses,travel,-254.39,-41055.21
buyer_1,Aitor,López,1996-08-10,84942326Z,aitor.lopez@smartcode.org,563227,ES02209563310500830014,3761.2,2024-01-04T11:14:18,Bilbao,expenses,food,-102.69,-41157.9
buyer_1,Aitor,López,1996-08-10,84942326Z,aitor.lopez@smartcode.org,563227,ES02209563310500830014,3761.2,2024-01-05T18:53:21,Bilbao,expenses,rent,-199.53,-41357.43
buyer_1,Aitor,López,1996-08-10,84942326Z,aitor.lopez@smartcode.org,563227,ES02209563310500830014,3761.2,2024-01-05T11:00:31,Bilbao,expenses,electricity,-26.16,-41383.59
buyer_1,Aitor,López,1996-08-10,84942326Z,aitor.lopez@smartcode.org,563227,ES02209563310500830014,3761.2,2024-01-05T16:05:52,Bilbao,expenses,internet,-12.23,-41395.82
buyer_1,Aitor,López,1996-08-10,84942326Z,aitor.lopez@smartcode.org,563227,ES02209563310500830014,3761.2,2024-01-05T19:40:34,Bilbao,expenses,leisure,-61.51,-41457.33
buyer_1,Aitor,López,1996-08-10,84942326Z,aitor.lopez@smartcode.org,563227,ES02209563310500830014,3761.2,2024-01-06T11:46:16,Bilbao,expenses,gas,-25.36,-41482.69
buyer_1,Aitor,López,1996-08-10,84942326Z,aitor.lopez@smartcode.org,563227,ES02209563310500830014,3761.2,2024-01-06T12:52:19,Bilbao,expenses,food,-88.75,-41571.44
buyer_1,Aitor,López,1996-08-10,84942326Z,aitor.lopez@smartcode.org,563227,ES02209563310500830014,3761.2,2024-01-07T09:49:01,Bilbao,expenses,water,-6.6,-41578.04
buyer_1,Aitor,López,1996-08-10,84942326Z,aitor.lopez@smartcode.org,563227,ES02209563310500830014,3761.2,2024-01-07T17:22:14,Bilbao,expenses,gifts,-27.65,-41605.69
buyer_1,Aitor,López,1996-08-10,84942326Z,aitor.lopez@smartcode.org,563227,ES02209563310500830014,3761.2,2024-01-08T15:32:00,Bilbao,expenses,internet,-12.23,-41617.92
buyer_1,Aitor,López,1996-08-10,84942326Z,aitor.lopez@smartcode.org,563227,ES02209563310500830014,3761.2,2024-01-08T14:40:41,Bilbao,expenses,phone,-11.81,-41629.73
buyer_1,Aitor,López,1996-08-10,84942326Z,aitor.lopez@smartcode.org,563227,ES02209563310500830014,3761.2,2024-01-08T04:56:23,Bilbao,expenses,education,-55.16,-41684.89
buyer_1,Aitor,López,1996-08-10,84942326Z,aitor.lopez@smartcode.org,563227,ES02209563310500830014,3761.2,2024-01-08T17:42:29,Bilbao,expenses,cash,-100.0,-41784.89
buyer_1,Aitor,López,1996-08-10,84942326Z,aitor.lopez@smartcode.org,563227,ES02209563310500830014,3761.2,2024-01-12T08:42:24,Bilbao,expenses,gifts,-88.64,-41873.53
buyer_1,Aitor,López,1996-08-10,84942326Z,aitor.lopez@smartcode.org,563227,ES02209563310500830014,3761.2,2024-01-14T20:17:33,Bilbao,expenses,transport,-54.88,-41928.41
buyer_1,Aitor,López,1996-08-10,84942326Z,aitor.lopez@smartcode.org,563227,ES02209563310500830014,3761.2,2024-01-15T19:57:39,Bilbao,expenses,repairs,-81.57,-42009.98
buyer_1,Aitor,López,1996-08-10,84942326Z,aitor.lopez@smartcode.org,563227,ES02209563310500830014,3761.2,2024-01-16T08:52:52,Bilbao,expenses,leisure,-75.31,-42085.29
buyer_1,Aitor,López,1996-08-10,84942326Z,aitor.lopez@smartcode.org,563227,ES02209563310500830014,3761.2,2024-01-23T15:23:54,Bilbao,expenses,leisure,-45.78,-42131.07
buyer_1,Aitor,López,1996-08-10,84942326Z,aitor.lopez@smartcode.org,563227,ES02209563310500830014,3761.2,2024-01-24T12:46:25,Bilbao,expenses,education,-48.52,-42179.59
buyer_1,Aitor,López,1996-08-10,84942326Z,aitor.lopez@smartcode.org,563227,ES02209563310500830014,3761.2,2024-01-25T19:24:12,Bilbao,expenses,education,-62.32,-42241.91
buyer_1,Aitor,López,1996-08-10,84942326Z,aitor.lopez@smartcode.org,563227,ES02209563310500830014,3761.2,2024-01-28T21:50:59,Bilbao,expenses,appliances,-210.16,-42452.07
buyer_1,Aitor,López,1996-08-10,84942326Z,aitor.lopez@smartcode.org,563227,ES02209563310500830014,3761.2,2024-01-29T12:48:37,Bilbao,expenses,transport,-49.9,-42501.97
buyer_1,Aitor,López,1996-08-10,84942326Z,aitor.lopez@smartcode.org,563227,ES02209563310500830014,3761.2,2024-01-29T16:57:31,Bilbao,expenses,leisure,-60.35,-42562.32
buyer_1,Aitor,López,1996-08-10,84942326Z,aitor.lopez@smartcode.org,563227,ES02209563310500830014,3761.2,2024-01-30T20:05:36,Bilbao,expenses,cash,-100.0,-42662.32
buyer_1,Aitor,López,1996-08-10,84942326Z,aitor.lopez@smartcode.org,563227,ES02209563310500830014,3761.2,2024-01-31T14:09:51,Bilbao,expenses,education,-45.82,-42708.14
buyer_1,Aitor,López,1996-08-10,84942326Z,aitor.lopez@smartcode.org,563227,ES02209563310500830014,3761.2,2024-02-01T23:41:10,Bilbao,incomes,salary,582.24,-42125.9
buyer_1,Aitor,López,1996-08-10,84942326Z,aitor.lopez@smartcode.org,563227,ES02209563310500830014,3761.2,2024-02-01T23:41:10,Bilbao,incomes,extra_income,102.64,-42023.26
buyer_1,Aitor,López,1996-08-10,84942326Z,aitor.lopez@smartcode.org,563227,ES02209563310500830014,3761.2,2024-02-02T12:43:21,Bilbao,expenses,transport,-52.38,-42075.64
buyer_1,Aitor,López,1996-08-10,84942326Z,aitor.lopez@smartcode.org,563227,ES02209563310500830014,3761.2,2024-02-03T19:24:08,Bilbao,expenses,food,-103.19,-42178.83
buyer_1,Aitor,López,1996-08-10,84942326Z,aitor.lopez@smartcode.org,563227,ES02209563310500830014,3761.2,2024-02-03T12:34:26,Bilbao,expenses,leisure,-52.44,-42231.27
buyer_1,Aitor,López,1996-08-10,84942326Z,aitor.lopez@smartcode.org,563227,ES02209563310500830014,3761.2,2024-02-04T15:13:46,Bilbao,expenses,education,-53.87,-42285.14
buyer_1,Aitor,López,1996-08-10,84942326Z,aitor.lopez@smartcode.org,563227,ES02209563310500830014,3761.2,2024-02-05T09:02:36,Bilbao,expenses,rent,-199.53,-42484.67
buyer_1,Aitor,López,1996-08-10,84942326Z,aitor.lopez@smartcode.org,563227,ES02209563310500830014,3761.2,2024-02-06T17:42:25,Bilbao,expenses,water,-12.82,-42497.49
buyer_1,Aitor,López,1996-08-10,84942326Z,aitor.lopez@smartcode.org,563227,ES02209563310500830014,3761.2,2024-02-06T10:59:29,Bilbao,expenses,gas,-9.16,-42506.65
buyer_1,Aitor,López,1996-08-10,84942326Z,aitor.lopez@smartcode.org,563227,ES02209563310500830014,3761.2,2024-02-06T16:00:42,Bilbao,expenses,food,-63.68,-42570.33
buyer_1,Aitor,López,1996-08-10,84942326Z,aitor.lopez@smartcode.org,563227,ES02209563310500830014,3761.2,2024-02-06T20:30:33,Bilbao,expenses,clothing,-75.68,-42646.01
buyer_1,Aitor,López,1996-08-10,84942326Z,aitor.lopez@smartcode.org,563227,ES02209563310500830014,3761.2,2024-02-06T23:09:45,Bilbao,expenses,gifts,-80.88,-42726.89
buyer_1,Aitor,López,1996-08-10,84942326Z,aitor.lopez@smartcode.org,563227,ES02209563310500830014,3761.2,2024-02-07T08:51:23,Bilbao,expenses,water,-12.35,-42739.24
buyer_1,Aitor,López,1996-08-10,84942326Z,aitor.lopez@smartcode.org,563227,ES02209563310500830014,3761.2,2024-02-07T17:06:40,Bilbao,expenses,gas,-10.16,-42749.4
buyer_1,Aitor,López,1996-08-10,84942326Z,aitor.lopez@smartcode.org,563227,ES02209563310500830014,3761.2,2024-02-07T20:34:34,Bilbao,expenses,cash,-100.0,-42849.4
buyer_1,Aitor,López,1996-08-10,84942326Z,aitor.lopez@smartcode.org,563227,ES02209563310500830014,3761.2,2024-02-07T20:43:06,Bilbao,expenses,appliances,-75.41,-42924.81
buyer_1,Aitor,López,1996-08-10,84942326Z,aitor.lopez@smartcode.org,563227,ES02209563310500830014,3761.2,2024-02-08T19:00:13,Bilbao,expenses,water,-10.62,-42935.43
buyer_1,Aitor,López,1996-08-10,84942326Z,aitor.lopez@smartcode.org,563227,ES02209563310500830014,3761.2,2024-02-10T17:01:01,Bilbao,expenses,travel,-246.18,-43181.61
buyer_1,Aitor,López,1996-08-10,84942326Z,aitor.lopez@smartcode.org,563227,ES02209563310500830014,3761.2,2024-02-11T18:34:56,Bilbao,expenses,food,-87.46,-43269.07
buyer_1,Aitor,López,1996-08-10,84942326Z,aitor.lopez@smartcode.org,563227,ES02209563310500830014,3761.2,2024-02-11T18:24:13,Bilbao,expenses,cash,-100.0,-43369.07
buyer_1,Aitor,López,1996-08-10,84942326Z,aitor.lopez@smartcode.org,563227,ES02209563310500830014,3761.2,2024-02-12T20:26:47,Bilbao,expenses,repairs,-124.02,-43493.09
buyer_1,Aitor,López,1996-08-10,84942326Z,aitor.lopez@smartcode.org,563227,ES02209563310500830014,3761.2,2024-02-16T19:19:19,Bilbao,expenses,cash,-100.0,-43593.09
buyer_1,Aitor,López,1996-08-10,84942326Z,aitor.lopez@smartcode.org,563227,ES02209563310500830014,3761.2,2024-02-19T12:32:48,Bilbao,expenses,cash,-100.0,-43693.09
buyer_1,Aitor,López,1996-08-10,84942326Z,aitor.lopez@smartcode.org,563227,ES02209563310500830014,3761.2,2024-02-20T10:22:33,Bilbao,expenses,transport,-84.91,-43778.0
buyer_1,Aitor,López,1996-08-10,84942326Z,aitor.lopez@smartcode.org,563227,ES02209563310500830014,3761.2,2024-02-22T18:03:56,Bilbao,expenses,food,-89.76,-43867.76
buyer_1,Aitor,López,1996-08-10,84942326Z,aitor.lopez@smartcode.org,563227,ES02209563310500830014,3761.2,2024-02-22T09:35:45,Bilbao,expenses,appliances,-137.59,-44005.35
buyer_1,Aitor,López,1996-08-10,84942326Z,aitor.lopez@smartcode.org,563227,ES02209563310500830014,3761.2,2024-02-23T16:33:14,Bilbao,expenses,transport,-53.06,-44058.41
buyer_1,Aitor,López,1996-08-10,84942326Z,aitor.lopez@smartcode.org,563227,ES02209563310500830014,3761.2,2024-02-24T15:03:54,Bilbao,expenses,food,-118.54,-44176.95
buyer_1,Aitor,López,1996-08-10,84942326Z,aitor.lopez@smartcode.org,563227,ES02209563310500830014,3761.2,2024-02-24T11:01:03,Bilbao,expenses,education,-75.31,-44252.26
buyer_1,Aitor,López,1996-08-10,84942326Z,aitor.lopez@smartcode.org,563227,ES02209563310500830014,3761.2,2024-02-25T20:47:31,Bilbao,expenses,food,-89.84,-44342.1
buyer_1,Aitor,López,1996-08-10,84942326Z,aitor.lopez@smartcode.org,563227,ES02209563310500830014,3761.2,2024-02-27T13:24:34,Bilbao,expenses,gifts,-33.18,-44375.28
buyer_1,Aitor,López,1996-08-10,84942326Z,aitor.lopez@smartcode.org,563227,ES02209563310500830014,3761.2,2024-02-28T17:03:37,Bilbao,expenses,cash,-100.0,-44475.28
buyer_1,Aitor,López,1996-08-10,84942326Z,aitor.lopez@smartcode.org,563227,ES02209563310500830014,3761.2,2024-02-29T21:11:02,Bilbao,expenses,cash,-100.0,-44575.28
buyer_1,Aitor,López,1996-08-10,84942326Z,aitor.lopez@smartcode.org,563227,ES02209563310500830014,3761.2,2024-03-01T20:20:42,Bilbao,incomes,salary,582.24,-43993.04
buyer_1,Aitor,López,1996-08-10,84942326Z,aitor.lopez@smartcode.org,563227,ES02209563310500830014,3761.2,2024-03-03T16:00:22,Bilbao,expenses,transport,-45.56,-44038.6
buyer_1,Aitor,López,1996-08-10,84942326Z,aitor.lopez@smartcode.org,563227,ES02209563310500830014,3761.2,2024-03-03T13:48:02,Bilbao,expenses,clothing,-88.16,-44126.76
buyer_1,Aitor,López,1996-08-10,84942326Z,aitor.lopez@smartcode.org,563227,ES02209563310500830014,3761.2,2024-03-05T15:54:52,Bilbao,expenses,rent,-199.53,-44326.29
buyer_1,Aitor,López,1996-08-10,84942326Z,aitor.lopez@smartcode.org,563227,ES02209563310500830014,3761.2,2024-03-05T17:22:13,Bilbao,expenses,water,-11.75,-44338.04
buyer_1,Aitor,López,1996-08-10,84942326Z,aitor.lopez@smartcode.org,563227,ES02209563310500830014,3761.2,2024-03-05T22:33:34,Bilbao,expenses,electricity,-10.03,-44348.07
buyer_1,Aitor,López,1996-08-10,84942326Z,aitor.lopez@smartcode.org,563227,ES02209563310500830014,3761.2,2024-03-06T18:50:58,Bilbao,expenses,gas,-29.95,-44378.02
buyer_1,Aitor,López,1996-08-10,84942326Z,aitor.lopez@smartcode.org,563227,ES02209563310500830014,3761.2,2024-03-06T17:17:09,Bilbao,expenses,phone,-12.83,-44390.85
buyer_1,Aitor,López,1996-08-10,84942326Z,aitor.lopez@smartcode.org,563227,ES02209563310500830014,3761.2,2024-03-07T04:15:42,Bilbao,expenses,phone,-10.58,-44401.43
buyer_1,Aitor,López,1996-08-10,84942326Z,aitor.lopez@smartcode.org,563227,ES02209563310500830014,3761.2,2024-03-07T11:11:22,Bilbao,expenses,gifts,-185.6,-44587.03
buyer_1,Aitor,López,1996-08-10,84942326Z,aitor.lopez@smartcode.org,563227,ES02209563310500830014,3761.2,2024-03-08T01:06:07,Bilbao,expenses,electricity,-14.65,-44601.68
buyer_1,Aitor,López,1996-08-10,84942326Z,aitor.lopez@smartcode.org,563227,ES02209563310500830014,3761.2,2024-03-08T12:44:13,Bilbao,expenses,gas,-10.95,-44612.63
buyer_1,Aitor,López,1996-08-10,84942326Z,aitor.lopez@smartcode.org,563227,ES02209563310500830014,3761.2,2024-03-08T16:09:17,Bilbao,expenses,food,-97.35,-44709.98
buyer_1,Aitor,López,1996-08-10,84942326Z,aitor.lopez@smartcode.org,563227,ES02209563310500830014,3761.2,2024-03-09T02:36:47,Bilbao,expenses,leisure,-52.23,-44762.21
buyer_1,Aitor,López,1996-08-10,84942326Z,aitor.lopez@smartcode.org,563227,ES02209563310500830014,3761.2,2024-03-10T23:39:57,Bilbao,expenses,education,-50.75,-44812.96
buyer_1,Aitor,López,1996-08-10,84942326Z,aitor.lopez@smartcode.org,563227,ES02209563310500830014,3761.2,2024-03-11T19:46:42,Bilbao,expenses,appliances,-121.43,-44934.39
buyer_1,Aitor,López,1996-08-10,84942326Z,aitor.lopez@smartcode.org,563227,ES02209563310500830014,3761.2,2024-03-14T12:39:51,Bilbao,expenses,food,-64.59,-44998.98
buyer_1,Aitor,López,1996-08-10,84942326Z,aitor.lopez@smartcode.org,563227,ES02209563310500830014,3761.2,2024-03-14T22:07:47,Bilbao,expenses,clothing,-132.04,-45131.02
buyer_1,Aitor,López,1996-08-10,84942326Z,aitor.lopez@smartcode.org,563227,ES02209563310500830014,3761.2,2024-03-15T15:50:54,Bilbao,expenses,food,-62.6,-45193.62
buyer_1,Aitor,López,1996-08-10,84942326Z,aitor.lopez@smartcode.org,563227,ES02209563310500830014,3761.2,2024-03-16T14:31:08,Bilbao,expenses,cash,-100.0,-45293.62
buyer_1,Aitor,López,1996-08-10,84942326Z,aitor.lopez@smartcode.org,563227,ES02209563310500830014,3761.2,2024-03-19T14:05:24,Bilbao,expenses,cash,-100.0,-45393.62
buyer_1,Aitor,López,1996-08-10,84942326Z,aitor.lopez@smartcode.org,563227,ES02209563310500830014,3761.2,2024-03-20T08:01:50,Bilbao,expenses,clothing,-93.54,-45487.16
buyer_1,Aitor,López,1996-08-10,84942326Z,aitor.lopez@smartcode.org,563227,ES02209563310500830014,3761.2,2024-03-21T16:03:55,Bilbao,expenses,transport,-55.69,-45542.85
buyer_1,Aitor,López,1996-08-10,84942326Z,aitor.lopez@smartcode.org,563227,ES02209563310500830014,3761.2,2024-03-22T10:03:19,Bilbao,expenses,clothing,-82.03,-45624.88
buyer_1,Aitor,López,1996-08-10,84942326Z,aitor.lopez@smartcode.org,563227,ES02209563310500830014,3761.2,2024-03-23T06:56:00,Bilbao,expenses,appliances,-93.41,-45718.29
buyer_1,Aitor,López,1996-08-10,84942326Z,aitor.lopez@smartcode.org,563227,ES02209563310500830014,3761.2,2024-03-24T02:10:17,Bilbao,expenses,food,-101.03,-45819.32
buyer_1,Aitor,López,1996-08-10,84942326Z,aitor.lopez@smartcode.org,563227,ES02209563310500830014,3761.2,2024-03-26T14:28:40,Bilbao,expenses,food,-95.79,-45915.11
buyer_1,Aitor,López,1996-08-10,84942326Z,aitor.lopez@smartcode.org,563227,ES02209563310500830014,3761.2,2024-03-26T03:38:59,Bilbao,expenses,repairs,-32.46,-45947.57
buyer_1,Aitor,López,1996-08-10,84942326Z,aitor.lopez@smartcode.org,563227,ES02209563310500830014,3761.2,2024-03-29T20:02:58,Bilbao,expenses,food,-99.11,-46046.68
buyer_1,Aitor,López,1996-08-10,84942326Z,aitor.lopez@smartcode.org,563227,ES02209563310500830014,3761.2,2024-03-30T18:39:34,Bilbao,expenses,clothing,-53.87,-46100.55
buyer_1,Aitor,López,1996-08-10,84942326Z,aitor.lopez@smartcode.org,563227,ES02209563310500830014,3761.2,2024-03-31T08:56:12,Bilbao,expenses,leisure,-26.25,-46126.8
buyer_1,Aitor,López,1996-08-10,84942326Z,aitor.lopez@smartcode.org,563227,ES02209563310500830014,3761.2,2024-04-01T02:14:19,Bilbao,incomes,salary,582.24,-45544.56
buyer_1,Aitor,López,1996-08-10,84942326Z,aitor.lopez@smartcode.org,563227,ES02209563310500830014,3761.2,2024-04-01T12:52:33,Bilbao,expenses,transport,-76.85,-45621.41
buyer_1,Aitor,López,1996-08-10,84942326Z,aitor.lopez@smartcode.org,563227,ES02209563310500830014,3761.2,2024-04-02T15:22:35,Bilbao,expenses,food,-85.76,-45707.17
buyer_1,Aitor,López,1996-08-10,84942326Z,aitor.lopez@smartcode.org,563227,ES02209563310500830014,3761.2,2024-04-02T15:18:28,Bilbao,expenses,repairs,-37.7,-45744.87
buyer_1,Aitor,López,1996-08-10,84942326Z,aitor.lopez@smartcode.org,563227,ES02209563310500830014,3761.2,2024-04-03T08:18:32,Bilbao,expenses,transport,-84.07,-45828.94
buyer_1,Aitor,López,1996-08-10,84942326Z,aitor.lopez@smartcode.org,563227,ES02209563310500830014,3761.2,2024-04-04T11:30:29,Bilbao,expenses,food,-114.75,-45943.69
buyer_1,Aitor,López,1996-08-10,84942326Z,aitor.lopez@smartcode.org,563227,ES02209563310500830014,3761.2,2024-04-05T05:10:08,Bilbao,expenses,rent,-199.53,-46143.22
buyer_1,Aitor,López,1996-08-10,84942326Z,aitor.lopez@smartcode.org,563227,ES02209563310500830014,3761.2,2024-04-05T19:11:22,Bilbao,expenses,electricity,-21.7,-46164.92
buyer_1,Aitor,López,1996-08-10,84942326Z,aitor.lopez@smartcode.org,563227,ES02209563310500830014,3761.2,2024-04-06T16:47:32,Bilbao,expenses,electricity,-23.73,-46188.65
buyer_1,Aitor,López,1996-08-10,84942326Z,aitor.lopez@smartcode.org,563227,ES02209563310500830014,3761.2,2024-04-06T15:33:58,Bilbao,expenses,gas,-26.67,-46215.32
buyer_1,Aitor,López,1996-08-10,84942326Z,aitor.lopez@smartcode.org,563227,ES02209563310500830014,3761.2,2024-04-06T13:53:55,Bilbao,expenses,internet,-12.23,-46227.55
buyer_1,Aitor,López,1996-08-10,84942326Z,aitor.lopez@smartcode.org,563227,ES02209563310500830014,3761.2,2024-04-06T12:12:06,Bilbao,expenses,food,-100.29,-46327.84
buyer_1,Aitor,López,1996-08-10,84942326Z,aitor.lopez@smartcode.org,563227,ES02209563310500830014,3761.2,2024-04-06T12:46:58,Bilbao,expenses,transport,-46.63,-46374.47
buyer_1,Aitor,López,1996-08-10,84942326Z,aitor.lopez@smartcode.org,563227,ES02209563310500830014,3761.2,2024-04-07T14:01:51,Bilbao,expenses,leisure,-62.82,-46437.29
buyer_1,Aitor,López,1996-08-10,84942326Z,aitor.lopez@smartcode.org,563227,ES02209563310500830014,3761.2,2024-04-08T09:53:35,Bilbao,expenses,water,-7.31,-46444.6
buyer_1,Aitor,López,1996-08-10,84942326Z,aitor.lopez@smartcode.org,563227,ES02209563310500830014,3761.2,2024-04-08T17:21:28,Bilbao,expenses,internet,-12.23,-46456.83
buyer_1,Aitor,López,1996-08-10,84942326Z,aitor.lopez@smartcode.org,563227,ES02209563310500830014,3761.2,2024-04-10T02:07:53,Bilbao,expenses,cash,-100.0,-46556.83
buyer_1,Aitor,López,1996-08-10,84942326Z,aitor.lopez@smartcode.org,563227,ES02209563310500830014,3761.2,2024-04-10T00:01:33,Bilbao,expenses,repairs,-46.27,-46603.1
buyer_1,Aitor,López,1996-08-10,84942326Z,aitor.lopez@smartcode.org,563227,ES02209563310500830014,3761.2,2024-04-11T01:48:15,Bilbao,expenses,repairs,-106.86,-46709.96
buyer_1,Aitor,López,1996-08-10,84942326Z,aitor.lopez@smartcode.org,563227,ES02209563310500830014,3761.2,2024-04-12T08:07:47,Bilbao,expenses,cash,-100.0,-46809.96
buyer_1,Aitor,López,1996-08-10,84942326Z,aitor.lopez@smartcode.org,563227,ES02209563310500830014,3761.2,2024-04-17T08:40:04,Bilbao,expenses,leisure,-19.93,-46829.89
buyer_1,Aitor,López,1996-08-10,84942326Z,aitor.lopez@smartcode.org,563227,ES02209563310500830014,3761.2,2024-04-17T08:46:32,Bilbao,expenses,cash,-100.0,-46929.89
buyer_1,Aitor,López,1996-08-10,84942326Z,aitor.lopez@smartcode.org,563227,ES02209563310500830014,3761.2,2024-04-18T18:34:39,Bilbao,expenses,food,-93.15,-47023.04
buyer_1,Aitor,López,1996-08-10,84942326Z,aitor.lopez@smartcode.org,563227,ES02209563310500830014,3761.2,2024-04-19T14:08:00,Bilbao,expenses,transport,-60.41,-47083.45
buyer_1,Aitor,López,1996-08-10,84942326Z,aitor.lopez@smartcode.org,563227,ES02209563310500830014,3761.2,2024-04-20T17:23:15,Bilbao,expenses,appliances,-159.27,-47242.72
buyer_1,Aitor,López,1996-08-10,84942326Z,aitor.lopez@smartcode.org,563227,ES02209563310500830014,3761.2,2024-04-21T20:18:14,Bilbao,expenses,transport,-85.24,-47327.96
buyer_1,Aitor,López,1996-08-10,84942326Z,aitor.lopez@smartcode.org,563227,ES02209563310500830014,3761.2,2024-04-21T10:37:55,Bilbao,expenses,cash,-100.0,-47427.96
buyer_1,Aitor,López,1996-08-10,84942326Z,aitor.lopez@smartcode.org,563227,ES02209563310500830014,3761.2,2024-04-22T10:38:18,Bilbao,expenses,gifts,-108.83,-47536.79
buyer_1,Aitor,López,1996-08-10,84942326Z,aitor.lopez@smartcode.org,563227,ES02209563310500830014,3761.2,2024-04-23T08:33:36,Bilbao,expenses,food,-101.81,-47638.6
buyer_1,Aitor,López,1996-08-10,84942326Z,aitor.lopez@smartcode.org,563227,ES02209563310500830014,3761.2,2024-04-25T09:40:21,Bilbao,expenses,food,-89.67,-47728.27
buyer_1,Aitor,López,1996-08-10,84942326Z,aitor.lopez@smartcode.org,563227,ES02209563310500830014,3761.2,2024-04-25T19:01:35,Bilbao,expenses,cash,-100.0,-47828.27
buyer_1,Aitor,López,1996-08-10,84942326Z,aitor.lopez@smartcode.org,563227,ES02209563310500830014,3761.2,2024-04-26T08:27:17,Bilbao,expenses,food,-95.22,-47923.49
buyer_1,Aitor,López,1996-08-10,84942326Z,aitor.lopez@smartcode.org,563227,ES02209563310500830014,3761.2,2024-04-26T11:26:35,Bilbao,expenses,education,-72.98,-47996.47
buyer_1,Aitor,López,1996-08-10,84942326Z,aitor.lopez@smartcode.org,563227,ES02209563310500830014,3761.2,2024-04-27T12:50:53,Bilbao,expenses,gifts,-224.96,-48221.43
buyer_1,Aitor,López,1996-08-10,84942326Z,aitor.lopez@smartcode.org,563227,ES02209563310500830014,3761.2,2024-04-30T14:44:21,Bilbao,expenses,education,-43.52,-48264.95
buyer_1,Aitor,López,1996-08-10,84942326Z,aitor.lopez@smartcode.org,563227,ES02209563310500830014,3761.2,2024-05-01T19:05:19,Bilbao,incomes,salary,582.24,-47682.71
buyer_1,Aitor,López,1996-08-10,84942326Z,aitor.lopez@smartcode.org,563227,ES02209563310500830014,3761.2,2024-05-01T15:04:36,Bilbao,expenses,leisure,-56.46,-47739.17
buyer_1,Aitor,López,1996-08-10,84942326Z,aitor.lopez@smartcode.org,563227,ES02209563310500830014,3761.2,2024-05-01T12:24:56,Bilbao,expenses,repairs,-146.29,-47885.46
buyer_1,Aitor,López,1996-08-10,84942326Z,aitor.lopez@smartcode.org,563227,ES02209563310500830014,3761.2,2024-05-04T08:37:32,Bilbao,expenses,cash,-100.0,-47985.46
buyer_1,Aitor,López,1996-08-10,84942326Z,aitor.lopez@smartcode.org,563227,ES02209563310500830014,3761.2,2024-05-05T08:33:49,Bilbao,expenses,rent,-199.53,-48184.99
buyer_1,Aitor,López,1996-08-10,84942326Z,aitor.lopez@smartcode.org,563227,ES02209563310500830014,3761.2,2024-05-05T09:55:43,Bilbao,expenses,electricity,-23.15,-48208.14
buyer_1,Aitor,López,1996-08-10,84942326Z,aitor.lopez@smartcode.org,563227,ES02209563310500830014,3761.2,2024-05-05T01:18:01,Bilbao,expenses,phone,-11.69,-48219.83
buyer_1,Aitor,López,1996-08-10,84942326Z,aitor.lopez@smartcode.org,563227,ES02209563310500830014,3761.2,2024-05-06T11:19:56,Bilbao,expenses,water,-11.53,-48231.36
buyer_1,Aitor,López,1996-08-10,84942326Z,aitor.lopez@smartcode.org,563227,ES02209563310500830014,3761.2,2024-05-06T03:58:04,Bilbao,expenses,gas,-20.17,-48251.53
buyer_1,Aitor,López,1996-08-10,84942326Z,aitor.lopez@smartcode.org,563227,ES02209563310500830014,3761.2,2024-05-06T14:38:27,Bilbao,expenses,leisure,-49.84,-48301.37
buyer_1,Aitor,López,1996-08-10,84942326Z,aitor.lopez@smartcode.org,563227,ES02209563310500830014,3761.2,2024-05-07T10:55:37,Bilbao,expenses,electricity,-15.61,-48316.98
buyer_1,Aitor,López,1996-08-10,84942326Z,aitor.lopez@smartcode.org,563227,ES02209563310500830014,3761.2,2024-05-12T00:47:59,Bilbao,expenses,cash,-100.0,-48416.98
buyer_1,Aitor,López,1996-08-10,84942326Z,aitor.lopez@smartcode.org,563227,ES02209563310500830014,3761.2,2024-05-13T18:49:10,Bilbao,expenses,cash,-100.0,-48516.98
buyer_1,Aitor,López,1996-08-10,84942326Z,aitor.lopez@smartcode.org,563227,ES02209563310500830014,3761.2,2024-05-15T10:34:36,Bilbao,expenses,transport,-62.71,-48579.69
buyer_1,Aitor,López,1996-08-10,84942326Z,aitor.lopez@smartcode.org,563227,ES02209563310500830014,3761.2,2024-05-15T08:50:52,Bilbao,expenses,clothing,-145.19,-48724.88
buyer_1,Aitor,López,1996-08-10,84942326Z,aitor.lopez@smartcode.org,563227,ES02209563310500830014,3761.2,2024-05-15T10:38:19,Bilbao,expenses,gifts,-24.39,-48749.27
buyer_1,Aitor,López,1996-08-10,84942326Z,aitor.lopez@smartcode.org,563227,ES02209563310500830014,3761.2,2024-05-18T08:04:41,Bilbao,expenses,leisure,-30.6,-48779.87
buyer_1,Aitor,López,1996-08-10,84942326Z,aitor.lopez@smartcode.org,563227,ES02209563310500830014,3761.2,2024-05-18T11:02:17,Bilbao,expenses,cash,-100.0,-48879.87
buyer_1,Aitor,López,1996-08-10,84942326Z,aitor.lopez@smartcode.org,563227,ES02209563310500830014,3761.2,2024-05-19T17:01:31,Bilbao,expenses,transport,-56.75,-48936.62
buyer_1,Aitor,López,1996-08-10,84942326Z,aitor.lopez@smartcode.org,563227,ES02209563310500830014,3761.2,2024-05-20T23:18:18,Bilbao,expenses,transport,-83.58,-49020.2
buyer_1,Aitor,López,1996-08-10,84942326Z,aitor.lopez@smartcode.org,563227,ES02209563310500830014,3761.2,2024-05-21T18:33:53,Bilbao,expenses,cash,-100.0,-49120.2
buyer_1,Aitor,López,1996-08-10,84942326Z,aitor.lopez@smartcode.org,563227,ES02209563310500830014,3761.2,2024-05-22T21:35:51,Bilbao,expenses,leisure,-32.65,-49152.85
buyer_1,Aitor,López,1996-08-10,84942326Z,aitor.lopez@smartcode.org,563227,ES02209563310500830014,3761.2,2024-05-22T18:36:08,Bilbao,expenses,appliances,-158.18,-49311.03
buyer_1,Aitor,López,1996-08-10,84942326Z,aitor.lopez@smartcode.org,563227,ES02209563310500830014,3761.2,2024-05-26T14:27:06,Bilbao,expenses,transport,-79.52,-49390.55
buyer_1,Aitor,López,1996-08-10,84942326Z,aitor.lopez@smartcode.org,563227,ES02209563310500830014,3761.2,2024-05-26T13:53:51,Bilbao,expenses,repairs,-68.9,-49459.45
buyer_1,Aitor,López,1996-08-10,84942326Z,aitor.lopez@smartcode.org,563227,ES02209563310500830014,3761.2,2024-05-28T15:13:41,Bilbao,expenses,repairs,-184.72,-49644.17
buyer_1,Aitor,López,1996-08-10,84942326Z,aitor.lopez@smartcode.org,563227,ES02209563310500830014,3761.2,2024-05-29T15:23:02,Bilbao,expenses,cash,-100.0,-49744.17
buyer_1,Aitor,López,1996-08-10,84942326Z,aitor.lopez@smartcode.org,563227,ES02209563310500830014,3761.2,2024-06-01T19:38:48,Bilbao,incomes,salary,582.24,-49161.93
buyer_1,Aitor,López,1996-08-10,84942326Z,aitor.lopez@smartcode.org,563227,ES02209563310500830014,3761.2,2024-06-01T19:38:48,Bilbao,incomes,extra_income,102.64,-49059.29
buyer_1,Aitor,López,1996-08-10,84942326Z,aitor.lopez@smartcode.org,563227,ES02209563310500830014,3761.2,2024-06-01T19:38:48,Bilbao,incomes,salary_bonus,450.32,-48608.97
buyer_1,Aitor,López,1996-08-10,84942326Z,aitor.lopez@smartcode.org,563227,ES02209563310500830014,3761.2,2024-06-01T14:08:53,Bilbao,expenses,taxes,-421.66,-49030.63
buyer_1,Aitor,López,1996-08-10,84942326Z,aitor.lopez@smartcode.org,563227,ES02209563310500830014,3761.2,2024-06-01T18:46:15,Bilbao,expenses,insurance,-132.17,-49162.8
buyer_1,Aitor,López,1996-08-10,84942326Z,aitor.lopez@smartcode.org,563227,ES02209563310500830014,3761.2,2024-06-02T11:45:24,Bilbao,expenses,leisure,-38.86,-49201.66
buyer_1,Aitor,López,1996-08-10,84942326Z,aitor.lopez@smartcode.org,563227,ES02209563310500830014,3761.2,2024-06-03T10:55:43,Bilbao,expenses,clothing,-138.98,-49340.64
buyer_1,Aitor,López,1996-08-10,84942326Z,aitor.lopez@smartcode.org,563227,ES02209563310500830014,3761.2,2024-06-04T10:32:27,Bilbao,expenses,food,-114.28,-49454.92
buyer_1,Aitor,López,1996-08-10,84942326Z,aitor.lopez@smartcode.org,563227,ES02209563310500830014,3761.2,2024-06-04T12:27:10,Bilbao,expenses,leisure,-65.72,-49520.64
buyer_1,Aitor,López,1996-08-10,84942326Z,aitor.lopez@smartcode.org,563227,ES02209563310500830014,3761.2,2024-06-05T14:55:07,Bilbao,expenses,rent,-199.53,-49720.17
buyer_1,Aitor,López,1996-08-10,84942326Z,aitor.lopez@smartcode.org,563227,ES02209563310500830014,3761.2,2024-06-05T08:43:51,Bilbao,expenses,gas,-20.79,-49740.96
buyer_1,Aitor,López,1996-08-10,84942326Z,aitor.lopez@smartcode.org,563227,ES02209563310500830014,3761.2,2024-06-05T18:27:44,Bilbao,expenses,education,-49.34,-49790.3
buyer_1,Aitor,López,1996-08-10,84942326Z,aitor.lopez@smartcode.org,563227,ES02209563310500830014,3761.2,2024-06-06T11:53:31,Bilbao,expenses,electricity,-9.29,-49799.59
buyer_1,Aitor,López,1996-08-10,84942326Z,aitor.lopez@smartcode.org,563227,ES02209563310500830014,3761.2,2024-06-06T12:05:23,Bilbao,expenses,internet,-12.23,-49811.82
buyer_1,Aitor,López,1996-08-10,84942326Z,aitor.lopez@smartcode.org,563227,ES02209563310500830014,3761.2,2024-06-06T08:38:52,Bilbao,expenses,phone,-12.14,-49823.96
buyer_1,Aitor,López,1996-08-10,84942326Z,aitor.lopez@smartcode.org,563227,ES02209563310500830014,3761.2,2024-06-06T12:40:29,Bilbao,expenses,gifts,-181.08,-50005.04
buyer_1,Aitor,López,1996-08-10,84942326Z,aitor.lopez@smartcode.org,563227,ES02209563310500830014,3761.2,2024-06-07T19:39:15,Bilbao,expenses,internet,-12.23,-50017.27
buyer_1,Aitor,López,1996-08-10,84942326Z,aitor.lopez@smartcode.org,563227,ES02209563310500830014,3761.2,2024-06-07T11:57:01,Bilbao,expenses,food,-123.97,-50141.24
buyer_1,Aitor,López,1996-08-10,84942326Z,aitor.lopez@smartcode.org,563227,ES02209563310500830014,3761.2,2024-06-07T11:09:33,Bilbao,expenses,healthcare,-86.34,-50227.58
buyer_1,Aitor,López,1996-08-10,84942326Z,aitor.lopez@smartcode.org,563227,ES02209563310500830014,3761.2,2024-06-08T02:00:47,Bilbao,expenses,transport,-46.13,-50273.71
buyer_1,Aitor,López,1996-08-10,84942326Z,aitor.lopez@smartcode.org,563227,ES02209563310500830014,3761.2,2024-06-09T06:14:52,Bilbao,expenses,food,-61.07,-50334.78
buyer_1,Aitor,López,1996-08-10,84942326Z,aitor.lopez@smartcode.org,563227,ES02209563310500830014,3761.2,2024-06-09T05:09:35,Bilbao,expenses,leisure,-29.41,-50364.19
buyer_1,Aitor,López,1996-08-10,84942326Z,aitor.lopez@smartcode.org,563227,ES02209563310500830014,3761.2,2024-06-10T08:32:17,Bilbao,expenses,clothing,-101.24,-50465.43
buyer_1,Aitor,López,1996-08-10,84942326Z,aitor.lopez@smartcode.org,563227,ES02209563310500830014,3761.2,2024-06-10T11:21:09,Bilbao,expenses,repairs,-91.06,-50556.49
buyer_1,Aitor,López,1996-08-10,84942326Z,aitor.lopez@smartcode.org,563227,ES02209563310500830014,3761.2,2024-06-11T10:55:16,Bilbao,expenses,food,-79.65,-50636.14
buyer_1,Aitor,López,1996-08-10,84942326Z,aitor.lopez@smartcode.org,563227,ES02209563310500830014,3761.2,2024-06-12T12:51:38,Bilbao,expenses,food,-64.73,-50700.87
buyer_1,Aitor,López,1996-08-10,84942326Z,aitor.lopez@smartcode.org,563227,ES02209563310500830014,3761.2,2024-06-12T15:03:04,Bilbao,expenses,cash,-100.0,-50800.87
buyer_1,Aitor,López,1996-08-10,84942326Z,aitor.lopez@smartcode.org,563227,ES02209563310500830014,3761.2,2024-06-13T13:46:06,Bilbao,expenses,education,-74.71,-50875.58
buyer_1,Aitor,López,1996-08-10,84942326Z,aitor.lopez@smartcode.org,563227,ES02209563310500830014,3761.2,2024-06-14T20:32:29,Bilbao,expenses,repairs,-165.18,-51040.76
buyer_1,Aitor,López,1996-08-10,84942326Z,aitor.lopez@smartcode.org,563227,ES02209563310500830014,3761.2,2024-06-15T14:11:10,Bilbao,expenses,repairs,-104.22,-51144.98
buyer_1,Aitor,López,1996-08-10,84942326Z,aitor.lopez@smartcode.org,563227,ES02209563310500830014,3761.2,2024-06-16T12:17:00,Bilbao,expenses,appliances,-160.0,-51304.98
buyer_1,Aitor,López,1996-08-10,84942326Z,aitor.lopez@smartcode.org,563227,ES02209563310500830014,3761.2,2024-06-17T19:56:57,Bilbao,expenses,healthcare,-138.89,-51443.87
buyer_1,Aitor,López,1996-08-10,84942326Z,aitor.lopez@smartcode.org,563227,ES02209563310500830014,3761.2,2024-06-19T13:41:01,Bilbao,expenses,clothing,-53.14,-51497.01
buyer_1,Aitor,López,1996-08-10,84942326Z,aitor.lopez@smartcode.org,563227,ES02209563310500830014,3761.2,2024-06-19T15:25:45,Bilbao,expenses,cash,-100.0,-51597.01
buyer_1,Aitor,López,1996-08-10,84942326Z,aitor.lopez@smartcode.org,563227,ES02209563310500830014,3761.2,2024-06-20T17:34:56,Bilbao,expenses,education,-43.09,-51640.1
buyer_1,Aitor,López,1996-08-10,84942326Z,aitor.lopez@smartcode.org,563227,ES02209563310500830014,3761.2,2024-06-20T18:15:59,Bilbao,expenses,cash,-100.0,-51740.1
buyer_1,Aitor,López,1996-08-10,84942326Z,aitor.lopez@smartcode.org,563227,ES02209563310500830014,3761.2,2024-06-20T08:39:35,Bilbao,expenses,travel,-131.89,-51871.99
buyer_1,Aitor,López,1996-08-10,84942326Z,aitor.lopez@smartcode.org,563227,ES02209563310500830014,3761.2,2024-06-21T16:24:06,Bilbao,expenses,transport,-82.57,-51954.56
buyer_1,Aitor,López,1996-08-10,84942326Z,aitor.lopez@smartcode.org,563227,ES02209563310500830014,3761.2,2024-06-22T17:15:05,Bilbao,expenses,transport,-57.37,-52011.93
buyer_1,Aitor,López,1996-08-10,84942326Z,aitor.lopez@smartcode.org,563227,ES02209563310500830014,3761.2,2024-06-25T13:10:40,Bilbao,expenses,leisure,-47.29,-52059.22
buyer_1,Aitor,López,1996-08-10,84942326Z,aitor.lopez@smartcode.org,563227,ES02209563310500830014,3761.2,2024-06-26T10:13:29,Bilbao,expenses,cash,-100.0,-52159.22
buyer_1,Aitor,López,1996-08-10,84942326Z,aitor.lopez@smartcode.org,563227,ES02209563310500830014,3761.2,2024-06-27T16:31:17,Bilbao,expenses,cash,-100.0,-52259.22
buyer_1,Aitor,López,1996-08-10,84942326Z,aitor.lopez@smartcode.org,563227,ES02209563310500830014,3761.2,2024-06-29T12:26:41,Bilbao,expenses,food,-105.4,-52364.62
buyer_1,Aitor,López,1996-08-10,84942326Z,aitor.lopez@smartcode.org,563227,ES02209563310500830014,3761.2,2024-07-01T18:39:08,Bilbao,incomes,salary,582.24,-51782.38
buyer_1,Aitor,López,1996-08-10,84942326Z,aitor.lopez@smartcode.org,563227,ES02209563310500830014,3761.2,2024-07-01T17:39:14,Bilbao,expenses,leisure,-26.21,-51808.59
buyer_1,Aitor,López,1996-08-10,84942326Z,aitor.lopez@smartcode.org,563227,ES02209563310500830014,3761.2,2024-07-03T14:26:19,Bilbao,expenses,gifts,-42.38,-51850.97
buyer_1,Aitor,López,1996-08-10,84942326Z,aitor.lopez@smartcode.org,563227,ES02209563310500830014,3761.2,2024-07-05T08:43:05,Bilbao,expenses,rent,-199.53,-52050.5
buyer_1,Aitor,López,1996-08-10,84942326Z,aitor.lopez@smartcode.org,563227,ES02209563310500830014,3761.2,2024-07-05T22:59:44,Bilbao,expenses,food,-120.76,-52171.26
buyer_1,Aitor,López,1996-08-10,84942326Z,aitor.lopez@smartcode.org,563227,ES02209563310500830014,3761.2,2024-07-05T14:59:33,Bilbao,expenses,clothing,-73.73,-52244.99
buyer_1,Aitor,López,1996-08-10,84942326Z,aitor.lopez@smartcode.org,563227,ES02209563310500830014,3761.2,2024-07-06T12:54:24,Bilbao,expenses,gas,-20.08,-52265.07
buyer_1,Aitor,López,1996-08-10,84942326Z,aitor.lopez@smartcode.org,563227,ES02209563310500830014,3761.2,2024-07-06T15:05:55,Bilbao,expenses,phone,-10.94,-52276.01
buyer_1,Aitor,López,1996-08-10,84942326Z,aitor.lopez@smartcode.org,563227,ES02209563310500830014,3761.2,2024-07-06T17:23:37,Bilbao,expenses,cash,-100.0,-52376.01
buyer_1,Aitor,López,1996-08-10,84942326Z,aitor.lopez@smartcode.org,563227,ES02209563310500830014,3761.2,2024-07-06T08:32:01,Bilbao,expenses,gifts,-77.89,-52453.9
buyer_1,Aitor,López,1996-08-10,84942326Z,aitor.lopez@smartcode.org,563227,ES02209563310500830014,3761.2,2024-07-08T20:18:45,Bilbao,expenses,gas,-26.83,-52480.73
buyer_1,Aitor,López,1996-08-10,84942326Z,aitor.lopez@smartcode.org,563227,ES02209563310500830014,3761.2,2024-07-09T19:09:21,Bilbao,expenses,food,-88.26,-52568.99
buyer_1,Aitor,López,1996-08-10,84942326Z,aitor.lopez@smartcode.org,563227,ES02209563310500830014,3761.2,2024-07-11T12:15:15,Bilbao,expenses,cash,-100.0,-52668.99
buyer_1,Aitor,López,1996-08-10,84942326Z,aitor.lopez@smartcode.org,563227,ES02209563310500830014,3761.2,2024-07-11T11:06:44,Bilbao,expenses,travel,-242.77,-52911.76
buyer_1,Aitor,López,1996-08-10,84942326Z,aitor.lopez@smartcode.org,563227,ES02209563310500830014,3761.2,2024-07-12T15:41:54,Bilbao,expenses,leisure,-50.84,-52962.6
buyer_1,Aitor,López,1996-08-10,84942326Z,aitor.lopez@smartcode.org,563227,ES02209563310500830014,3761.2,2024-07-17T14:38:52,Bilbao,expenses,transport,-81.48,-53044.08
buyer_1,Aitor,López,1996-08-10,84942326Z,aitor.lopez@smartcode.org,563227,ES02209563310500830014,3761.2,2024-07-19T21:11:49,Bilbao,expenses,cash,-100.0,-53144.08
buyer_1,Aitor,López,1996-08-10,84942326Z,aitor.lopez@smartcode.org,563227,ES02209563310500830014,3761.2,2024-07-20T16:02:36,Bilbao,expenses,healthcare,-163.19,-53307.27
buyer_1,Aitor,López,1996-08-10,84942326Z,aitor.lopez@smartcode.org,563227,ES02209563310500830014,3761.2,2024-07-21T04:09:40,Bilbao,expenses,healthcare,-161.93,-53469.2
buyer_1,Aitor,López,1996-08-10,84942326Z,aitor.lopez@smartcode.org,563227,ES02209563310500830014,3761.2,2024-07-21T17:15:39,Bilbao,expenses,cash,-98.39,-53567.59
buyer_1,Aitor,López,1996-08-10,84942326Z,aitor.lopez@smartcode.org,563227,ES02209563310500830014,3761.2,2024-07-22T03:01:25,Bilbao,expenses,food,-87.76,-53655.35
buyer_1,Aitor,López,1996-08-10,84942326Z,aitor.lopez@smartcode.org,563227,ES02209563310500830014,3761.2,2024-07-22T10:54:05,Bilbao,expenses,transport,-44.29,-53699.64
buyer_1,Aitor,López,1996-08-10,84942326Z,aitor.lopez@smartcode.org,563227,ES02209563310500830014,3761.2,2024-07-23T17:59:48,Bilbao,expenses,cash,-100.0,-53799.64
buyer_1,Aitor,López,1996-08-10,84942326Z,aitor.lopez@smartcode.org,563227,ES02209563310500830014,3761.2,2024-07-23T18:48:50,Bilbao,expenses,repairs,-120.85,-53920.49
buyer_1,Aitor,López,1996-08-10,84942326Z,aitor.lopez@smartcode.org,563227,ES02209563310500830014,3761.2,2024-07-24T23:27:01,Bilbao,expenses,leisure,-51.17,-53971.66
buyer_1,Aitor,López,1996-08-10,84942326Z,aitor.lopez@smartcode.org,563227,ES02209563310500830014,3761.2,2024-07-25T11:53:07,Bilbao,expenses,transport,-88.09,-54059.75
buyer_1,Aitor,López,1996-08-10,84942326Z,aitor.lopez@smartcode.org,563227,ES02209563310500830014,3761.2,2024-07-27T09:41:17,Bilbao,expenses,food,-98.0,-54157.75
buyer_1,Aitor,López,1996-08-10,84942326Z,aitor.lopez@smartcode.org,563227,ES02209563310500830014,3761.2,2024-07-28T06:24:21,Bilbao,expenses,healthcare,-167.37,-54325.12
buyer_1,Aitor,López,1996-08-10,84942326Z,aitor.lopez@smartcode.org,563227,ES02209563310500830014,3761.2,2024-07-30T16:49:39,Bilbao,expenses,travel,-268.94,-54594.06
buyer_1,Aitor,López,1996-08-10,84942326Z,aitor.lopez@smartcode.org,563227,ES02209563310500830014,3761.2,2024-08-01T01:19:36,Bilbao,incomes,salary,582.24,-54011.82
buyer_1,Aitor,López,1996-08-10,84942326Z,aitor.lopez@smartcode.org,563227,ES02209563310500830014,3761.2,2024-08-02T20:10:25,Bilbao,expenses,leisure,-47.33,-54059.15
buyer_1,Aitor,López,1996-08-10,84942326Z,aitor.lopez@smartcode.org,563227,ES02209563310500830014,3761.2,2024-08-03T17:28:46,Bilbao,expenses,education,-64.37,-54123.52
buyer_1,Aitor,López,1996-08-10,84942326Z,aitor.lopez@smartcode.org,563227,ES02209563310500830014,3761.2,2024-08-05T19:24:50,Bilbao,expenses,rent,-199.53,-54323.05
buyer_1,Aitor,López,1996-08-10,84942326Z,aitor.lopez@smartcode.org,563227,ES02209563310500830014,3761.2,2024-08-06T08:19:06,Bilbao,expenses,electricity,-23.21,-54346.26
buyer_1,Aitor,López,1996-08-10,84942326Z,aitor.lopez@smartcode.org,563227,ES02209563310500830014,3761.2,2024-08-06T11:47:49,Bilbao,expenses,gas,-27.51,-54373.77
buyer_1,Aitor,López,1996-08-10,84942326Z,aitor.lopez@smartcode.org,563227,ES02209563310500830014,3761.2,2024-08-06T19:53:41,Bilbao,expenses,internet,-12.23,-54386.0
buyer_1,Aitor,López,1996-08-10,84942326Z,aitor.lopez@smartcode.org,563227,ES02209563310500830014,3761.2,2024-08-06T13:53:56,Bilbao,expenses,food,-67.86,-54453.86
buyer_1,Aitor,López,1996-08-10,84942326Z,aitor.lopez@smartcode.org,563227,ES02209563310500830014,3761.2,2024-08-06T12:03:12,Bilbao,expenses,gifts,-62.16,-54516.02
buyer_1,Aitor,López,1996-08-10,84942326Z,aitor.lopez@smartcode.org,563227,ES02209563310500830014,3761.2,2024-08-07T10:28:27,Bilbao,expenses,food,-84.52,-54600.54
buyer_1,Aitor,López,1996-08-10,84942326Z,aitor.lopez@smartcode.org,563227,ES02209563310500830014,3761.2,2024-08-07T19:59:52,Bilbao,expenses,cash,-100.0,-54700.54
buyer_1,Aitor,López,1996-08-10,84942326Z,aitor.lopez@smartcode.org,563227,ES02209563310500830014,3761.2,2024-08-08T14:49:52,Bilbao,expenses,water,-9.94,-54710.48
buyer_1,Aitor,López,1996-08-10,84942326Z,aitor.lopez@smartcode.org,563227,ES02209563310500830014,3761.2,2024-08-08T10:34:50,Bilbao,expenses,cash,-100.0,-54810.48
buyer_1,Aitor,López,1996-08-10,84942326Z,aitor.lopez@smartcode.org,563227,ES02209563310500830014,3761.2,2024-08-09T23:19:33,Bilbao,expenses,gifts,-139.27,-54949.75
buyer_1,Aitor,López,1996-08-10,84942326Z,aitor.lopez@smartcode.org,563227,ES02209563310500830014,3761.2,2024-08-10T15:12:46,Bilbao,expenses,repairs,-159.54,-55109.29
buyer_1,Aitor,López,1996-08-10,84942326Z,aitor.lopez@smartcode.org,563227,ES02209563310500830014,3761.2,2024-08-13T18:55:02,Bilbao,expenses,travel,-274.58,-55383.87
buyer_1,Aitor,López,1996-08-10,84942326Z,aitor.lopez@smartcode.org,563227,ES02209563310500830014,3761.2,2024-08-14T08:15:07,Bilbao,expenses,leisure,-48.15,-55432.02
buyer_1,Aitor,López,1996-08-10,84942326Z,aitor.lopez@smartcode.org,563227,ES02209563310500830014,3761.2,2024-08-16T23:54:33,Bilbao,expenses,healthcare,-109.58,-55541.6
buyer_1,Aitor,López,1996-08-10,84942326Z,aitor.lopez@smartcode.org,563227,ES02209563310500830014,3761.2,2024-08-16T12:26:14,Bilbao,expenses,cash,-100.0,-55641.6
buyer_1,Aitor,López,1996-08-10,84942326Z,aitor.lopez@smartcode.org,563227,ES02209563310500830014,3761.2,2024-08-17T09:37:53,Bilbao,expenses,clothing,-47.28,-55688.88
buyer_1,Aitor,López,1996-08-10,84942326Z,aitor.lopez@smartcode.org,563227,ES02209563310500830014,3761.2,2024-08-17T18:37:33,Bilbao,expenses,cash,-100.0,-55788.88
buyer_1,Aitor,López,1996-08-10,84942326Z,aitor.lopez@smartcode.org,563227,ES02209563310500830014,3761.2,2024-08-23T00:39:42,Bilbao,expenses,leisure,-20.35,-55809.23
buyer_1,Aitor,López,1996-08-10,84942326Z,aitor.lopez@smartcode.org,563227,ES02209563310500830014,3761.2,2024-08-26T05:53:26,Bilbao,expenses,cash,-100.0,-55909.23
buyer_1,Aitor,López,1996-08-10,84942326Z,aitor.lopez@smartcode.org,563227,ES02209563310500830014,3761.2,2024-08-27T11:29:10,Bilbao,expenses,gifts,-43.5,-55952.73
buyer_1,Aitor,López,1996-08-10,84942326Z,aitor.lopez@smartcode.org,563227,ES02209563310500830014,3761.2,2024-08-28T08:21:40,Bilbao,expenses,food,-104.4,-56057.13
buyer_1,Aitor,López,1996-08-10,84942326Z,aitor.lopez@smartcode.org,563227,ES02209563310500830014,3761.2,2024-08-28T11:32:17,Bilbao,expenses,cash,-100.0,-56157.13
buyer_1,Aitor,López,1996-08-10,84942326Z,aitor.lopez@smartcode.org,563227,ES02209563310500830014,3761.2,2024-08-28T04:58:18,Bilbao,expenses,appliances,-74.84,-56231.97
buyer_1,Aitor,López,1996-08-10,84942326Z,aitor.lopez@smartcode.org,563227,ES02209563310500830014,3761.2,2024-08-29T17:38:39,Bilbao,expenses,transport,-51.99,-56283.96
buyer_1,Aitor,López,1996-08-10,84942326Z,aitor.lopez@smartcode.org,563227,ES02209563310500830014,3761.2,2024-08-29T13:14:41,Bilbao,expenses,leisure,-42.2,-56326.16
buyer_1,Aitor,López,1996-08-10,84942326Z,aitor.lopez@smartcode.org,563227,ES02209563310500830014,3761.2,2024-08-30T16:12:13,Bilbao,expenses,cash,-100.0,-56426.16
buyer_1,Aitor,López,1996-08-10,84942326Z,aitor.lopez@smartcode.org,563227,ES02209563310500830014,3761.2,2024-09-01T08:12:29,Bilbao,incomes,salary,582.24,-55843.92
buyer_1,Aitor,López,1996-08-10,84942326Z,aitor.lopez@smartcode.org,563227,ES02209563310500830014,3761.2,2024-09-01T20:39:09,Bilbao,expenses,leisure,-41.02,-55884.94
buyer_1,Aitor,López,1996-08-10,84942326Z,aitor.lopez@smartcode.org,563227,ES02209563310500830014,3761.2,2024-09-01T11:57:44,Bilbao,expenses,cash,-100.0,-55984.94
buyer_1,Aitor,López,1996-08-10,84942326Z,aitor.lopez@smartcode.org,563227,ES02209563310500830014,3761.2,2024-09-05T10:33:20,Bilbao,expenses,rent,-199.53,-56184.47
buyer_1,Aitor,López,1996-08-10,84942326Z,aitor.lopez@smartcode.org,563227,ES02209563310500830014,3761.2,2024-09-05T08:26:31,Bilbao,expenses,internet,-12.23,-56196.7
buyer_1,Aitor,López,1996-08-10,84942326Z,aitor.lopez@smartcode.org,563227,ES02209563310500830014,3761.2,2024-09-06T14:34:09,Bilbao,expenses,gifts,-188.46,-56385.16
buyer_1,Aitor,López,1996-08-10,84942326Z,aitor.lopez@smartcode.org,563227,ES02209563310500830014,3761.2,2024-09-07T15:36:49,Bilbao,expenses,gas,-18.6,-56403.76
buyer_1,Aitor,López,1996-08-10,84942326Z,aitor.lopez@smartcode.org,563227,ES02209563310500830014,3761.2,2024-09-07T15:23:10,Bilbao,expenses,clothing,-53.94,-56457.7
buyer_1,Aitor,López,1996-08-10,84942326Z,aitor.lopez@smartcode.org,563227,ES02209563310500830014,3761.2,2024-09-08T22:15:27,Bilbao,expenses,gas,-32.64,-56490.34
buyer_1,Aitor,López,1996-08-10,84942326Z,aitor.lopez@smartcode.org,563227,ES02209563310500830014,3761.2,2024-09-08T18:25:31,Bilbao,expenses,phone,-11.99,-56502.33
buyer_1,Aitor,López,1996-08-10,84942326Z,aitor.lopez@smartcode.org,563227,ES02209563310500830014,3761.2,2024-09-08T20:35:03,Bilbao,expenses,leisure,-44.14,-56546.47
buyer_1,Aitor,López,1996-08-10,84942326Z,aitor.lopez@smartcode.org,563227,ES02209563310500830014,3761.2,2024-09-08T20:19:31,Bilbao,expenses,repairs,-135.91,-56682.38
buyer_1,Aitor,López,1996-08-10,84942326Z,aitor.lopez@smartcode.org,563227,ES02209563310500830014,3761.2,2024-09-09T16:37:23,Bilbao,expenses,leisure,-29.03,-56711.41
buyer_1,Aitor,López,1996-08-10,84942326Z,aitor.lopez@smartcode.org,563227,ES02209563310500830014,3761.2,2024-09-09T17:50:06,Bilbao,expenses,education,-68.59,-56780.0
buyer_1,Aitor,López,1996-08-10,84942326Z,aitor.lopez@smartcode.org,563227,ES02209563310500830014,3761.2,2024-09-09T20:45:11,Bilbao,expenses,cash,-100.0,-56880.0
buyer_1,Aitor,López,1996-08-10,84942326Z,aitor.lopez@smartcode.org,563227,ES02209563310500830014,3761.2,2024-09-10T19:42:06,Bilbao,expenses,education,-77.55,-56957.55
buyer_1,Aitor,López,1996-08-10,84942326Z,aitor.lopez@smartcode.org,563227,ES02209563310500830014,3761.2,2024-09-11T11:54:05,Bilbao,expenses,transport,-59.63,-57017.18
buyer_1,Aitor,López,1996-08-10,84942326Z,aitor.lopez@smartcode.org,563227,ES02209563310500830014,3761.2,2024-09-11T15:45:53,Bilbao,expenses,cash,-100.0,-57117.18
buyer_1,Aitor,López,1996-08-10,84942326Z,aitor.lopez@smartcode.org,563227,ES02209563310500830014,3761.2,2024-09-14T18:56:00,Bilbao,expenses,transport,-66.42,-57183.6
buyer_1,Aitor,López,1996-08-10,84942326Z,aitor.lopez@smartcode.org,563227,ES02209563310500830014,3761.2,2024-09-14T12:14:32,Bilbao,expenses,leisure,-28.27,-57211.87
buyer_1,Aitor,López,1996-08-10,84942326Z,aitor.lopez@smartcode.org,563227,ES02209563310500830014,3761.2,2024-09-15T12:30:29,Bilbao,expenses,healthcare,-137.88,-57349.75
buyer_1,Aitor,López,1996-08-10,84942326Z,aitor.lopez@smartcode.org,563227,ES02209563310500830014,3761.2,2024-09-15T13:39:57,Bilbao,expenses,gifts,-90.54,-57440.29
buyer_1,Aitor,López,1996-08-10,84942326Z,aitor.lopez@smartcode.org,563227,ES02209563310500830014,3761.2,2024-09-17T11:06:34,Bilbao,expenses,repairs,-219.91,-57660.2
buyer_1,Aitor,López,1996-08-10,84942326Z,aitor.lopez@smartcode.org,563227,ES02209563310500830014,3761.2,2024-09-19T07:02:02,Bilbao,expenses,repairs,-156.32,-57816.52
buyer_1,Aitor,López,1996-08-10,84942326Z,aitor.lopez@smartcode.org,563227,ES02209563310500830014,3761.2,2024-09-22T20:03:47,Bilbao,expenses,transport,-53.06,-57869.58
buyer_1,Aitor,López,1996-08-10,84942326Z,aitor.lopez@smartcode.org,563227,ES02209563310500830014,3761.2,2024-09-23T10:54:18,Bilbao,expenses,food,-120.02,-57989.6
buyer_1,Aitor,López,1996-08-10,84942326Z,aitor.lopez@smartcode.org,563227,ES02209563310500830014,3761.2,2024-09-23T08:29:01,Bilbao,expenses,cash,-100.0,-58089.6
buyer_1,Aitor,López,1996-08-10,84942326Z,aitor.lopez@smartcode.org,563227,ES02209563310500830014,3761.2,2024-09-26T15:59:33,Bilbao,expenses,food,-62.42,-58152.02
buyer_1,Aitor,López,1996-08-10,84942326Z,aitor.lopez@smartcode.org,563227,ES02209563310500830014,3761.2,2024-09-27T15:40:34,Bilbao,expenses,healthcare,-189.52,-58341.54
buyer_1,Aitor,López,1996-08-10,84942326Z,aitor.lopez@smartcode.org,563227,ES02209563310500830014,3761.2,2024-09-29T08:20:10,Bilbao,expenses,gifts,-220.89,-58562.43
buyer_1,Aitor,López,1996-08-10,84942326Z,aitor.lopez@smartcode.org,563227,ES02209563310500830014,3761.2,2024-09-30T18:00:37,Bilbao,expenses,leisure,-79.71,-58642.14
buyer_1,Aitor,López,1996-08-10,84942326Z,aitor.lopez@smartcode.org,563227,ES02209563310500830014,3761.2,2024-10-01T15:30:22,Bilbao,incomes,salary,582.24,-58059.9
buyer_1,Aitor,López,1996-08-10,84942326Z,aitor.lopez@smartcode.org,563227,ES02209563310500830014,3761.2,2024-10-01T15:30:22,Bilbao,incomes,extra_income,102.64,-57957.26
buyer_1,Aitor,López,1996-08-10,84942326Z,aitor.lopez@smartcode.org,563227,ES02209563310500830014,3761.2,2024-10-01T19:43:55,Bilbao,expenses,leisure,-49.29,-58006.55
buyer_1,Aitor,López,1996-08-10,84942326Z,aitor.lopez@smartcode.org,563227,ES02209563310500830014,3761.2,2024-10-02T14:15:00,Bilbao,expenses,transport,-70.29,-58076.84
buyer_1,Aitor,López,1996-08-10,84942326Z,aitor.lopez@smartcode.org,563227,ES02209563310500830014,3761.2,2024-10-03T10:34:07,Bilbao,expenses,food,-83.42,-58160.26
buyer_1,Aitor,López,1996-08-10,84942326Z,aitor.lopez@smartcode.org,563227,ES02209563310500830014,3761.2,2024-10-04T12:56:10,Bilbao,expenses,transport,-40.51,-58200.77
buyer_1,Aitor,López,1996-08-10,84942326Z,aitor.lopez@smartcode.org,563227,ES02209563310500830014,3761.2,2024-10-04T19:55:11,Bilbao,expenses,leisure,-46.78,-58247.55
buyer_1,Aitor,López,1996-08-10,84942326Z,aitor.lopez@smartcode.org,563227,ES02209563310500830014,3761.2,2024-10-05T15:43:38,Bilbao,expenses,rent,-199.53,-58447.08
buyer_1,Aitor,López,1996-08-10,84942326Z,aitor.lopez@smartcode.org,563227,ES02209563310500830014,3761.2,2024-10-05T08:01:31,Bilbao,expenses,gifts,-108.89,-58555.97
buyer_1,Aitor,López,1996-08-10,84942326Z,aitor.lopez@smartcode.org,563227,ES02209563310500830014,3761.2,2024-10-06T06:07:04,Bilbao,expenses,water,-10.39,-58566.36
buyer_1,Aitor,López,1996-08-10,84942326Z,aitor.lopez@smartcode.org,563227,ES02209563310500830014,3761.2,2024-10-06T15:36:40,Bilbao,expenses,internet,-12.23,-58578.59
buyer_1,Aitor,López,1996-08-10,84942326Z,aitor.lopez@smartcode.org,563227,ES02209563310500830014,3761.2,2024-10-06T12:08:53,Bilbao,expenses,food,-73.29,-58651.88
buyer_1,Aitor,López,1996-08-10,84942326Z,aitor.lopez@smartcode.org,563227,ES02209563310500830014,3761.2,2024-10-08T15:03:16,Bilbao,expenses,internet,-12.23,-58664.11
buyer_1,Aitor,López,1996-08-10,84942326Z,aitor.lopez@smartcode.org,563227,ES02209563310500830014,3761.2,2024-10-08T18:08:52,Bilbao,expenses,cash,-100.0,-58764.11
buyer_1,Aitor,López,1996-08-10,84942326Z,aitor.lopez@smartcode.org,563227,ES02209563310500830014,3761.2,2024-10-10T21:22:20,Bilbao,expenses,clothing,-128.73,-58892.84
buyer_1,Aitor,López,1996-08-10,84942326Z,aitor.lopez@smartcode.org,563227,ES02209563310500830014,3761.2,2024-10-10T01:44:43,Bilbao,expenses,cash,-99.98,-58992.82
buyer_1,Aitor,López,1996-08-10,84942326Z,aitor.lopez@smartcode.org,563227,ES02209563310500830014,3761.2,2024-10-11T18:45:29,Bilbao,expenses,leisure,-44.77,-59037.59
buyer_1,Aitor,López,1996-08-10,84942326Z,aitor.lopez@smartcode.org,563227,ES02209563310500830014,3761.2,2024-10-11T20:03:28,Bilbao,expenses,cash,-100.0,-59137.59
buyer_2,Aitxiber,Beitia,1984-09-05,35972942E,aitxiber.beitia@extremecode.io,325203,ES33209505222907029444,5037.33,2022-01-01T19:54:43,Gernika,incomes,salary,1979.72,7017.05
buyer_2,Aitxiber,Beitia,1984-09-05,35972942E,aitxiber.beitia@extremecode.io,325203,ES33209505222907029444,5037.33,2022-01-03T13:09:31,Gernika,expenses,transport,-74.34,6942.71
buyer_2,Aitxiber,Beitia,1984-09-05,35972942E,aitxiber.beitia@extremecode.io,325203,ES33209505222907029444,5037.33,2022-01-03T06:57:54,Gernika,expenses,gifts,-421.39,6521.32
buyer_2,Aitxiber,Beitia,1984-09-05,35972942E,aitxiber.beitia@extremecode.io,325203,ES33209505222907029444,5037.33,2022-01-04T18:25:03,Gernika,expenses,food,-100.22,6421.1
buyer_2,Aitxiber,Beitia,1984-09-05,35972942E,aitxiber.beitia@extremecode.io,325203,ES33209505222907029444,5037.33,2022-01-05T18:10:37,Gernika,expenses,mortgage,-836.66,5584.44
buyer_2,Aitxiber,Beitia,1984-09-05,35972942E,aitxiber.beitia@extremecode.io,325203,ES33209505222907029444,5037.33,2022-01-05T15:48:49,Gernika,expenses,water,-41.32,5543.12
buyer_2,Aitxiber,Beitia,1984-09-05,35972942E,aitxiber.beitia@extremecode.io,325203,ES33209505222907029444,5037.33,2022-01-05T11:42:37,Gernika,expenses,electricity,-86.04,5457.08
buyer_2,Aitxiber,Beitia,1984-09-05,35972942E,aitxiber.beitia@extremecode.io,325203,ES33209505222907029444,5037.33,2022-01-05T11:54:19,Gernika,expenses,gas,-64.6,5392.48
buyer_2,Aitxiber,Beitia,1984-09-05,35972942E,aitxiber.beitia@extremecode.io,325203,ES33209505222907029444,5037.33,2022-01-05T20:53:35,Gernika,expenses,internet,-41.57,5350.91
buyer_2,Aitxiber,Beitia,1984-09-05,35972942E,aitxiber.beitia@extremecode.io,325203,ES33209505222907029444,5037.33,2022-01-05T12:32:43,Gernika,expenses,cash,-100.0,5250.91
buyer_2,Aitxiber,Beitia,1984-09-05,35972942E,aitxiber.beitia@extremecode.io,325203,ES33209505222907029444,5037.33,2022-01-05T17:44:49,Gernika,expenses,repairs,-295.81,4955.1
buyer_2,Aitxiber,Beitia,1984-09-05,35972942E,aitxiber.beitia@extremecode.io,325203,ES33209505222907029444,5037.33,2022-01-06T19:08:28,Gernika,expenses,water,-21.66,4933.44
buyer_2,Aitxiber,Beitia,1984-09-05,35972942E,aitxiber.beitia@extremecode.io,325203,ES33209505222907029444,5037.33,2022-01-06T21:58:34,Gernika,expenses,electricity,-39.85,4893.59
buyer_2,Aitxiber,Beitia,1984-09-05,35972942E,aitxiber.beitia@extremecode.io,325203,ES33209505222907029444,5037.33,2022-01-06T10:28:14,Gernika,expenses,food,-72.19,4821.4
buyer_2,Aitxiber,Beitia,1984-09-05,35972942E,aitxiber.beitia@extremecode.io,325203,ES33209505222907029444,5037.33,2022-01-08T13:06:56,Gernika,expenses,water,-44.09,4777.31
buyer_2,Aitxiber,Beitia,1984-09-05,35972942E,aitxiber.beitia@extremecode.io,325203,ES33209505222907029444,5037.33,2022-01-08T10:59:24,Gernika,expenses,electricity,-63.09,4714.22
buyer_2,Aitxiber,Beitia,1984-09-05,35972942E,aitxiber.beitia@extremecode.io,325203,ES33209505222907029444,5037.33,2022-01-08T09:35:51,Gernika,expenses,gas,-67.14,4647.08
buyer_2,Aitxiber,Beitia,1984-09-05,35972942E,aitxiber.beitia@extremecode.io,325203,ES33209505222907029444,5037.33,2022-01-08T09:21:51,Gernika,expenses,clothing,-151.72,4495.36
buyer_2,Aitxiber,Beitia,1984-09-05,35972942E,aitxiber.beitia@extremecode.io,325203,ES33209505222907029444,5037.33,2022-01-10T12:42:23,Gernika,expenses,food,-113.16,4382.2
buyer_2,Aitxiber,Beitia,1984-09-05,35972942E,aitxiber.beitia@extremecode.io,325203,ES33209505222907029444,5037.33,2022-01-10T08:22:46,Gernika,expenses,transport,-74.49,4307.71
buyer_2,Aitxiber,Beitia,1984-09-05,35972942E,aitxiber.beitia@extremecode.io,325203,ES33209505222907029444,5037.33,2022-01-10T16:34:31,Gernika,expenses,leisure,-36.91,4270.8
buyer_2,Aitxiber,Beitia,1984-09-05,35972942E,aitxiber.beitia@extremecode.io,325203,ES33209505222907029444,5037.33,2022-01-11T21:19:33,Gernika,expenses,repairs,-55.42,4215.38
buyer_2,Aitxiber,Beitia,1984-09-05,35972942E,aitxiber.beitia@extremecode.io,325203,ES33209505222907029444,5037.33,2022-01-12T08:08:15,Gernika,expenses,appliances,-295.29,3920.09
buyer_2,Aitxiber,Beitia,1984-09-05,35972942E,aitxiber.beitia@extremecode.io,325203,ES33209505222907029444,5037.33,2022-01-13T18:49:06,Gernika,expenses,cash,-100.0,3820.09
buyer_2,Aitxiber,Beitia,1984-09-05,35972942E,aitxiber.beitia@extremecode.io,325203,ES33209505222907029444,5037.33,2022-01-15T12:08:11,Gernika,expenses,transport,-53.91,3766.18
buyer_2,Aitxiber,Beitia,1984-09-05,35972942E,aitxiber.beitia@extremecode.io,325203,ES33209505222907029444,5037.33,2022-01-17T03:37:24,Gernika,expenses,food,-83.29,3682.89
buyer_2,Aitxiber,Beitia,1984-09-05,35972942E,aitxiber.beitia@extremecode.io,325203,ES33209505222907029444,5037.33,2022-01-17T18:05:54,Gernika,expenses,leisure,-28.47,3654.42
buyer_2,Aitxiber,Beitia,1984-09-05,35972942E,aitxiber.beitia@extremecode.io,325203,ES33209505222907029444,5037.33,2022-01-17T20:52:32,Gernika,expenses,cash,-100.0,3554.42
buyer_2,Aitxiber,Beitia,1984-09-05,35972942E,aitxiber.beitia@extremecode.io,325203,ES33209505222907029444,5037.33,2022-01-18T17:58:42,Gernika,expenses,education,-62.59,3491.83
buyer_2,Aitxiber,Beitia,1984-09-05,35972942E,aitxiber.beitia@extremecode.io,325203,ES33209505222907029444,5037.33,2022-01-19T23:32:51,Gernika,expenses,cash,-100.0,3391.83
buyer_2,Aitxiber,Beitia,1984-09-05,35972942E,aitxiber.beitia@extremecode.io,325203,ES33209505222907029444,5037.33,2022-01-19T11:58:24,Gernika,expenses,gifts,-192.27,3199.56
buyer_2,Aitxiber,Beitia,1984-09-05,35972942E,aitxiber.beitia@extremecode.io,325203,ES33209505222907029444,5037.33,2022-01-20T13:23:43,Gernika,expenses,gifts,-765.21,2434.35
buyer_2,Aitxiber,Beitia,1984-09-05,35972942E,aitxiber.beitia@extremecode.io,325203,ES33209505222907029444,5037.33,2022-01-21T16:24:23,Gernika,expenses,gifts,-121.65,2312.7
buyer_2,Aitxiber,Beitia,1984-09-05,35972942E,aitxiber.beitia@extremecode.io,325203,ES33209505222907029444,5037.33,2022-01-21T12:26:40,Gernika,expenses,children,-509.44,1803.26
buyer_2,Aitxiber,Beitia,1984-09-05,35972942E,aitxiber.beitia@extremecode.io,325203,ES33209505222907029444,5037.33,2022-01-22T13:14:31,Gernika,expenses,education,-43.18,1760.08
buyer_2,Aitxiber,Beitia,1984-09-05,35972942E,aitxiber.beitia@extremecode.io,325203,ES33209505222907029444,5037.33,2022-01-23T18:36:36,Gernika,expenses,transport,-53.69,1706.39
buyer_2,Aitxiber,Beitia,1984-09-05,35972942E,aitxiber.beitia@extremecode.io,325203,ES33209505222907029444,5037.33,2022-01-24T20:34:49,Gernika,expenses,food,-96.3,1610.09
buyer_2,Aitxiber,Beitia,1984-09-05,35972942E,aitxiber.beitia@extremecode.io,325203,ES33209505222907029444,5037.33,2022-01-24T19:18:16,Gernika,expenses,cash,-100.0,1510.09
buyer_2,Aitxiber,Beitia,1984-09-05,35972942E,aitxiber.beitia@extremecode.io,325203,ES33209505222907029444,5037.33,2022-01-28T17:22:41,Gernika,expenses,food,-62.93,1447.16
buyer_2,Aitxiber,Beitia,1984-09-05,35972942E,aitxiber.beitia@extremecode.io,325203,ES33209505222907029444,5037.33,2022-01-29T19:42:49,Gernika,expenses,food,-99.36,1347.8
buyer_2,Aitxiber,Beitia,1984-09-05,35972942E,aitxiber.beitia@extremecode.io,325203,ES33209505222907029444,5037.33,2022-01-29T11:44:20,Gernika,expenses,leisure,-59.77,1288.03
buyer_2,Aitxiber,Beitia,1984-09-05,35972942E,aitxiber.beitia@extremecode.io,325203,ES33209505222907029444,5037.33,2022-01-30T15:10:20,Gernika,expenses,clothing,-123.72,1164.31
buyer_2,Aitxiber,Beitia,1984-09-05,35972942E,aitxiber.beitia@extremecode.io,325203,ES33209505222907029444,5037.33,2022-01-31T08:20:29,Gernika,expenses,food,-95.45,1068.86
buyer_2,Aitxiber,Beitia,1984-09-05,35972942E,aitxiber.beitia@extremecode.io,325203,ES33209505222907029444,5037.33,2022-02-01T16:17:00,Gernika,incomes,salary,1979.72,3048.58
buyer_2,Aitxiber,Beitia,1984-09-05,35972942E,aitxiber.beitia@extremecode.io,325203,ES33209505222907029444,5037.33,2022-02-03T14:32:15,Gernika,expenses,food,-60.69,2987.89
buyer_2,Aitxiber,Beitia,1984-09-05,35972942E,aitxiber.beitia@extremecode.io,325203,ES33209505222907029444,5037.33,2022-02-04T11:38:17,Gernika,expenses,children,-246.61,2741.28
buyer_2,Aitxiber,Beitia,1984-09-05,35972942E,aitxiber.beitia@extremecode.io,325203,ES33209505222907029444,5037.33,2022-02-05T09:42:13,Gernika,expenses,mortgage,-836.66,1904.62
buyer_2,Aitxiber,Beitia,1984-09-05,35972942E,aitxiber.beitia@extremecode.io,325203,ES33209505222907029444,5037.33,2022-02-05T16:29:07,Gernika,expenses,transport,-86.39,1818.23
buyer_2,Aitxiber,Beitia,1984-09-05,35972942E,aitxiber.beitia@extremecode.io,325203,ES33209505222907029444,5037.33,2022-02-06T10:46:02,Gernika,expenses,electricity,-64.84,1753.39
buyer_2,Aitxiber,Beitia,1984-09-05,35972942E,aitxiber.beitia@extremecode.io,325203,ES33209505222907029444,5037.33,2022-02-06T18:07:12,Gernika,expenses,internet,-41.57,1711.82
buyer_2,Aitxiber,Beitia,1984-09-05,35972942E,aitxiber.beitia@extremecode.io,325203,ES33209505222907029444,5037.33,2022-02-07T11:35:19,Gernika,expenses,internet,-41.57,1670.25
buyer_2,Aitxiber,Beitia,1984-09-05,35972942E,aitxiber.beitia@extremecode.io,325203,ES33209505222907029444,5037.33,2022-02-07T23:08:43,Gernika,expenses,leisure,-72.94,1597.31
buyer_2,Aitxiber,Beitia,1984-09-05,35972942E,aitxiber.beitia@extremecode.io,325203,ES33209505222907029444,5037.33,2022-02-08T20:56:30,Gernika,expenses,electricity,-43.3,1554.01
buyer_2,Aitxiber,Beitia,1984-09-05,35972942E,aitxiber.beitia@extremecode.io,325203,ES33209505222907029444,5037.33,2022-02-08T12:13:39,Gernika,expenses,gas,-37.98,1516.03
buyer_2,Aitxiber,Beitia,1984-09-05,35972942E,aitxiber.beitia@extremecode.io,325203,ES33209505222907029444,5037.33,2022-02-08T13:30:11,Gernika,expenses,healthcare,-94.05,1421.98
buyer_2,Aitxiber,Beitia,1984-09-05,35972942E,aitxiber.beitia@extremecode.io,325203,ES33209505222907029444,5037.33,2022-02-08T23:48:24,Gernika,expenses,repairs,-273.7,1148.28
buyer_2,Aitxiber,Beitia,1984-09-05,35972942E,aitxiber.beitia@extremecode.io,325203,ES33209505222907029444,5037.33,2022-02-09T09:33:11,Gernika,expenses,food,-75.74,1072.54
buyer_2,Aitxiber,Beitia,1984-09-05,35972942E,aitxiber.beitia@extremecode.io,325203,ES33209505222907029444,5037.33,2022-02-11T09:14:33,Gernika,expenses,food,-107.14,965.4
buyer_2,Aitxiber,Beitia,1984-09-05,35972942E,aitxiber.beitia@extremecode.io,325203,ES33209505222907029444,5037.33,2022-02-11T09:04:00,Gernika,expenses,education,-78.14,887.26
buyer_2,Aitxiber,Beitia,1984-09-05,35972942E,aitxiber.beitia@extremecode.io,325203,ES33209505222907029444,5037.33,2022-02-11T09:26:44,Gernika,expenses,children,-601.2,286.06
buyer_2,Aitxiber,Beitia,1984-09-05,35972942E,aitxiber.beitia@extremecode.io,325203,ES33209505222907029444,5037.33,2022-02-12T08:49:18,Gernika,expenses,appliances,-145.71,140.35
buyer_2,Aitxiber,Beitia,1984-09-05,35972942E,aitxiber.beitia@extremecode.io,325203,ES33209505222907029444,5037.33,2022-02-12T20:53:55,Gernika,expenses,gifts,-374.02,-233.67
buyer_2,Aitxiber,Beitia,1984-09-05,35972942E,aitxiber.beitia@extremecode.io,325203,ES33209505222907029444,5037.33,2022-02-13T18:59:41,Gernika,expenses,transport,-57.61,-291.28
buyer_2,Aitxiber,Beitia,1984-09-05,35972942E,aitxiber.beitia@extremecode.io,325203,ES33209505222907029444,5037.33,2022-02-14T18:53:30,Gernika,expenses,repairs,-69.42,-360.7
buyer_2,Aitxiber,Beitia,1984-09-05,35972942E,aitxiber.beitia@extremecode.io,325203,ES33209505222907029444,5037.33,2022-02-14T09:48:16,Gernika,expenses,children,-226.69,-587.39
buyer_2,Aitxiber,Beitia,1984-09-05,35972942E,aitxiber.beitia@extremecode.io,325203,ES33209505222907029444,5037.33,2022-02-15T18:46:40,Gernika,expenses,cash,-100.0,-687.39
buyer_2,Aitxiber,Beitia,1984-09-05,35972942E,aitxiber.beitia@extremecode.io,325203,ES33209505222907029444,5037.33,2022-02-16T18:53:42,Gernika,expenses,leisure,-18.69,-706.08
buyer_2,Aitxiber,Beitia,1984-09-05,35972942E,aitxiber.beitia@extremecode.io,325203,ES33209505222907029444,5037.33,2022-02-16T17:21:59,Gernika,expenses,healthcare,-156.35,-862.43
buyer_2,Aitxiber,Beitia,1984-09-05,35972942E,aitxiber.beitia@extremecode.io,325203,ES33209505222907029444,5037.33,2022-02-17T10:46:54,Gernika,expenses,gifts,-372.21,-1234.64
buyer_2,Aitxiber,Beitia,1984-09-05,35972942E,aitxiber.beitia@extremecode.io,325203,ES33209505222907029444,5037.33,2022-02-18T23:19:44,Gernika,expenses,food,-115.05,-1349.69
buyer_2,Aitxiber,Beitia,1984-09-05,35972942E,aitxiber.beitia@extremecode.io,325203,ES33209505222907029444,5037.33,2022-02-19T12:52:41,Gernika,expenses,food,-75.3,-1424.99
buyer_2,Aitxiber,Beitia,1984-09-05,35972942E,aitxiber.beitia@extremecode.io,325203,ES33209505222907029444,5037.33,2022-02-19T21:23:27,Gernika,expenses,leisure,-71.22,-1496.21
buyer_2,Aitxiber,Beitia,1984-09-05,35972942E,aitxiber.beitia@extremecode.io,325203,ES33209505222907029444,5037.33,2022-02-19T21:08:15,Gernika,expenses,gifts,-129.41,-1625.62
buyer_2,Aitxiber,Beitia,1984-09-05,35972942E,aitxiber.beitia@extremecode.io,325203,ES33209505222907029444,5037.33,2022-02-20T16:42:29,Gernika,expenses,food,-102.98,-1728.6
buyer_2,Aitxiber,Beitia,1984-09-05,35972942E,aitxiber.beitia@extremecode.io,325203,ES33209505222907029444,5037.33,2022-02-20T11:26:26,Gernika,expenses,leisure,-37.83,-1766.43
buyer_2,Aitxiber,Beitia,1984-09-05,35972942E,aitxiber.beitia@extremecode.io,325203,ES33209505222907029444,5037.33,2022-02-21T10:18:06,Gernika,expenses,cash,-100.0,-1866.43
buyer_2,Aitxiber,Beitia,1984-09-05,35972942E,aitxiber.beitia@extremecode.io,325203,ES33209505222907029444,5037.33,2022-02-22T09:39:38,Gernika,expenses,cash,-100.0,-1966.43
buyer_2,Aitxiber,Beitia,1984-09-05,35972942E,aitxiber.beitia@extremecode.io,325203,ES33209505222907029444,5037.33,2022-02-23T10:22:33,Gernika,expenses,cash,-100.0,-2066.43
buyer_2,Aitxiber,Beitia,1984-09-05,35972942E,aitxiber.beitia@extremecode.io,325203,ES33209505222907029444,5037.33,2022-02-24T16:42:45,Gernika,expenses,transport,-41.27,-2107.7
buyer_2,Aitxiber,Beitia,1984-09-05,35972942E,aitxiber.beitia@extremecode.io,325203,ES33209505222907029444,5037.33,2022-02-24T19:46:47,Gernika,expenses,appliances,-248.32,-2356.02
buyer_2,Aitxiber,Beitia,1984-09-05,35972942E,aitxiber.beitia@extremecode.io,325203,ES33209505222907029444,5037.33,2022-02-25T20:30:16,Gernika,expenses,appliances,-135.97,-2491.99
buyer_2,Aitxiber,Beitia,1984-09-05,35972942E,aitxiber.beitia@extremecode.io,325203,ES33209505222907029444,5037.33,2022-03-01T22:45:12,Gernika,incomes,salary,1979.72,-512.27
buyer_2,Aitxiber,Beitia,1984-09-05,35972942E,aitxiber.beitia@extremecode.io,325203,ES33209505222907029444,5037.33,2022-03-01T22:45:12,Gernika,incomes,extra_income,380.33,-131.94
buyer_2,Aitxiber,Beitia,1984-09-05,35972942E,aitxiber.beitia@extremecode.io,325203,ES33209505222907029444,5037.33,2022-03-02T20:12:09,Gernika,expenses,healthcare,-184.82,-316.76
buyer_2,Aitxiber,Beitia,1984-09-05,35972942E,aitxiber.beitia@extremecode.io,325203,ES33209505222907029444,5037.33,2022-03-02T13:31:01,Gernika,expenses,cash,-100.0,-416.76
buyer_2,Aitxiber,Beitia,1984-09-05,35972942E,aitxiber.beitia@extremecode.io,325203,ES33209505222907029444,5037.33,2022-03-04T03:58:40,Gernika,expenses,transport,-81.33,-498.09
buyer_2,Aitxiber,Beitia,1984-09-05,35972942E,aitxiber.beitia@extremecode.io,325203,ES33209505222907029444,5037.33,2022-03-04T21:05:09,Gernika,expenses,children,-283.97,-782.06
buyer_2,Aitxiber,Beitia,1984-09-05,35972942E,aitxiber.beitia@extremecode.io,325203,ES33209505222907029444,5037.33,2022-03-05T22:15:44,Gernika,expenses,mortgage,-836.66,-1618.72
buyer_2,Aitxiber,Beitia,1984-09-05,35972942E,aitxiber.beitia@extremecode.io,325203,ES33209505222907029444,5037.33,2022-03-05T06:43:14,Gernika,expenses,gas,-113.72,-1732.44
buyer_2,Aitxiber,Beitia,1984-09-05,35972942E,aitxiber.beitia@extremecode.io,325203,ES33209505222907029444,5037.33,2022-03-06T19:30:14,Gernika,expenses,gas,-75.25,-1807.69
buyer_2,Aitxiber,Beitia,1984-09-05,35972942E,aitxiber.beitia@extremecode.io,325203,ES33209505222907029444,5037.33,2022-03-06T04:07:05,Gernika,expenses,repairs,-108.13,-1915.82
buyer_2,Aitxiber,Beitia,1984-09-05,35972942E,aitxiber.beitia@extremecode.io,325203,ES33209505222907029444,5037.33,2022-03-07T19:32:22,Gernika,expenses,electricity,-27.06,-1942.88
buyer_2,Aitxiber,Beitia,1984-09-05,35972942E,aitxiber.beitia@extremecode.io,325203,ES33209505222907029444,5037.33,2022-03-07T20:18:09,Gernika,expenses,internet,-41.57,-1984.45
buyer_2,Aitxiber,Beitia,1984-09-05,35972942E,aitxiber.beitia@extremecode.io,325203,ES33209505222907029444,5037.33,2022-03-07T13:18:34,Gernika,expenses,leisure,-83.27,-2067.72
buyer_2,Aitxiber,Beitia,1984-09-05,35972942E,aitxiber.beitia@extremecode.io,325203,ES33209505222907029444,5037.33,2022-03-08T08:50:46,Gernika,expenses,water,-20.93,-2088.65
buyer_2,Aitxiber,Beitia,1984-09-05,35972942E,aitxiber.beitia@extremecode.io,325203,ES33209505222907029444,5037.33,2022-03-08T14:39:06,Gernika,expenses,phone,-41.82,-2130.47
buyer_2,Aitxiber,Beitia,1984-09-05,35972942E,aitxiber.beitia@extremecode.io,325203,ES33209505222907029444,5037.33,2022-03-09T18:29:37,Gernika,expenses,repairs,-253.83,-2384.3
buyer_2,Aitxiber,Beitia,1984-09-05,35972942E,aitxiber.beitia@extremecode.io,325203,ES33209505222907029444,5037.33,2022-03-13T12:28:37,Gernika,expenses,gifts,-817.87,-3202.17
buyer_2,Aitxiber,Beitia,1984-09-05,35972942E,aitxiber.beitia@extremecode.io,325203,ES33209505222907029444,5037.33,2022-03-14T01:14:29,Gernika,expenses,food,-93.25,-3295.42
buyer_2,Aitxiber,Beitia,1984-09-05,35972942E,aitxiber.beitia@extremecode.io,325203,ES33209505222907029444,5037.33,2022-03-17T12:28:34,Gernika,expenses,transport,-89.26,-3384.68
buyer_2,Aitxiber,Beitia,1984-09-05,35972942E,aitxiber.beitia@extremecode.io,325203,ES33209505222907029444,5037.33,2022-03-17T19:19:50,Gernika,expenses,education,-56.66,-3441.34
buyer_2,Aitxiber,Beitia,1984-09-05,35972942E,aitxiber.beitia@extremecode.io,325203,ES33209505222907029444,5037.33,2022-03-17T09:15:00,Gernika,expenses,cash,-100.0,-3541.34
buyer_2,Aitxiber,Beitia,1984-09-05,35972942E,aitxiber.beitia@extremecode.io,325203,ES33209505222907029444,5037.33,2022-03-19T18:12:04,Gernika,expenses,transport,-57.39,-3598.73
buyer_2,Aitxiber,Beitia,1984-09-05,35972942E,aitxiber.beitia@extremecode.io,325203,ES33209505222907029444,5037.33,2022-03-20T04:55:12,Gernika,expenses,transport,-52.14,-3650.87
buyer_2,Aitxiber,Beitia,1984-09-05,35972942E,aitxiber.beitia@extremecode.io,325203,ES33209505222907029444,5037.33,2022-03-20T15:34:49,Gernika,expenses,repairs,-253.32,-3904.19
buyer_2,Aitxiber,Beitia,1984-09-05,35972942E,aitxiber.beitia@extremecode.io,325203,ES33209505222907029444,5037.33,2022-03-21T10:03:29,Gernika,expenses,transport,-48.84,-3953.03
buyer_2,Aitxiber,Beitia,1984-09-05,35972942E,aitxiber.beitia@extremecode.io,325203,ES33209505222907029444,5037.33,2022-03-21T15:38:30,Gernika,expenses,leisure,-31.66,-3984.69
buyer_2,Aitxiber,Beitia,1984-09-05,35972942E,aitxiber.beitia@extremecode.io,325203,ES33209505222907029444,5037.33,2022-03-22T12:18:44,Gernika,expenses,cash,-100.0,-4084.69
buyer_2,Aitxiber,Beitia,1984-09-05,35972942E,aitxiber.beitia@extremecode.io,325203,ES33209505222907029444,5037.33,2022-03-24T14:37:01,Gernika,expenses,education,-56.87,-4141.56
buyer_2,Aitxiber,Beitia,1984-09-05,35972942E,aitxiber.beitia@extremecode.io,325203,ES33209505222907029444,5037.33,2022-03-25T13:58:14,Gernika,expenses,clothing,-136.98,-4278.54
buyer_2,Aitxiber,Beitia,1984-09-05,35972942E,aitxiber.beitia@extremecode.io,325203,ES33209505222907029444,5037.33,2022-03-25T16:53:15,Gernika,expenses,cash,-100.0,-4378.54
buyer_2,Aitxiber,Beitia,1984-09-05,35972942E,aitxiber.beitia@extremecode.io,325203,ES33209505222907029444,5037.33,2022-03-26T19:34:00,Gernika,expenses,cash,-100.0,-4478.54
buyer_2,Aitxiber,Beitia,1984-09-05,35972942E,aitxiber.beitia@extremecode.io,325203,ES33209505222907029444,5037.33,2022-03-26T20:28:40,Gernika,expenses,repairs,-146.9,-4625.44
buyer_2,Aitxiber,Beitia,1984-09-05,35972942E,aitxiber.beitia@extremecode.io,325203,ES33209505222907029444,5037.33,2022-03-26T19:24:12,Gernika,expenses,gifts,-490.74,-5116.18
buyer_2,Aitxiber,Beitia,1984-09-05,35972942E,aitxiber.beitia@extremecode.io,325203,ES33209505222907029444,5037.33,2022-03-28T20:02:16,Gernika,expenses,transport,-48.44,-5164.62
buyer_2,Aitxiber,Beitia,1984-09-05,35972942E,aitxiber.beitia@extremecode.io,325203,ES33209505222907029444,5037.33,2022-03-30T15:18:42,Gernika,expenses,transport,-79.37,-5243.99
buyer_2,Aitxiber,Beitia,1984-09-05,35972942E,aitxiber.beitia@extremecode.io,325203,ES33209505222907029444,5037.33,2022-03-31T08:43:52,Gernika,expenses,cash,-100.0,-5343.99
buyer_2,Aitxiber,Beitia,1984-09-05,35972942E,aitxiber.beitia@extremecode.io,325203,ES33209505222907029444,5037.33,2022-04-01T18:03:38,Gernika,incomes,salary,1979.72,-3364.27
buyer_2,Aitxiber,Beitia,1984-09-05,35972942E,aitxiber.beitia@extremecode.io,325203,ES33209505222907029444,5037.33,2022-04-01T17:19:39,Gernika,expenses,leisure,-26.27,-3390.54
buyer_2,Aitxiber,Beitia,1984-09-05,35972942E,aitxiber.beitia@extremecode.io,325203,ES33209505222907029444,5037.33,2022-04-02T11:25:26,Gernika,expenses,clothing,-151.44,-3541.98
buyer_2,Aitxiber,Beitia,1984-09-05,35972942E,aitxiber.beitia@extremecode.io,325203,ES33209505222907029444,5037.33,2022-04-02T17:48:51,Gernika,expenses,gifts,-46.9,-3588.88
buyer_2,Aitxiber,Beitia,1984-09-05,35972942E,aitxiber.beitia@extremecode.io,325203,ES33209505222907029444,5037.33,2022-04-04T12:31:35,Gernika,expenses,cash,-100.0,-3688.88
buyer_2,Aitxiber,Beitia,1984-09-05,35972942E,aitxiber.beitia@extremecode.io,325203,ES33209505222907029444,5037.33,2022-04-05T13:17:49,Gernika,expenses,mortgage,-836.66,-4525.54
buyer_2,Aitxiber,Beitia,1984-09-05,35972942E,aitxiber.beitia@extremecode.io,325203,ES33209505222907029444,5037.33,2022-04-05T05:54:50,Gernika,expenses,electricity,-52.01,-4577.55
buyer_2,Aitxiber,Beitia,1984-09-05,35972942E,aitxiber.beitia@extremecode.io,325203,ES33209505222907029444,5037.33,2022-04-06T10:49:22,Gernika,expenses,water,-38.6,-4616.15
buyer_2,Aitxiber,Beitia,1984-09-05,35972942E,aitxiber.beitia@extremecode.io,325203,ES33209505222907029444,5037.33,2022-04-06T16:00:14,Gernika,expenses,electricity,-72.68,-4688.83
buyer_2,Aitxiber,Beitia,1984-09-05,35972942E,aitxiber.beitia@extremecode.io,325203,ES33209505222907029444,5037.33,2022-04-06T15:39:06,Gernika,expenses,gas,-112.04,-4800.87
buyer_2,Aitxiber,Beitia,1984-09-05,35972942E,aitxiber.beitia@extremecode.io,325203,ES33209505222907029444,5037.33,2022-04-06T16:30:31,Gernika,expenses,internet,-41.57,-4842.44
buyer_2,Aitxiber,Beitia,1984-09-05,35972942E,aitxiber.beitia@extremecode.io,325203,ES33209505222907029444,5037.33,2022-04-06T13:48:00,Gernika,expenses,repairs,-296.52,-5138.96
buyer_2,Aitxiber,Beitia,1984-09-05,35972942E,aitxiber.beitia@extremecode.io,325203,ES33209505222907029444,5037.33,2022-04-08T16:36:32,Gernika,expenses,internet,-41.57,-5180.53
buyer_2,Aitxiber,Beitia,1984-09-05,35972942E,aitxiber.beitia@extremecode.io,325203,ES33209505222907029444,5037.33,2022-04-08T13:02:52,Gernika,expenses,leisure,-46.45,-5226.98
buyer_2,Aitxiber,Beitia,1984-09-05,35972942E,aitxiber.beitia@extremecode.io,325203,ES33209505222907029444,5037.33,2022-04-08T22:27:46,Gernika,expenses,clothing,-68.91,-5295.89
buyer_2,Aitxiber,Beitia,1984-09-05,35972942E,aitxiber.beitia@extremecode.io,325203,ES33209505222907029444,5037.33,2022-04-08T08:50:19,Gernika,expenses,appliances,-349.1,-5644.99
buyer_2,Aitxiber,Beitia,1984-09-05,35972942E,aitxiber.beitia@extremecode.io,325203,ES33209505222907029444,5037.33,2022-04-09T09:01:38,Gernika,expenses,leisure,-46.43,-5691.42
buyer_2,Aitxiber,Beitia,1984-09-05,35972942E,aitxiber.beitia@extremecode.io,325203,ES33209505222907029444,5037.33,2022-04-09T14:30:26,Gernika,expenses,repairs,-323.73,-6015.15
buyer_2,Aitxiber,Beitia,1984-09-05,35972942E,aitxiber.beitia@extremecode.io,325203,ES33209505222907029444,5037.33,2022-04-10T07:50:51,Gernika,expenses,food,-63.68,-6078.83
buyer_2,Aitxiber,Beitia,1984-09-05,35972942E,aitxiber.beitia@extremecode.io,325203,ES33209505222907029444,5037.33,2022-04-10T16:48:17,Gernika,expenses,cash,-100.0,-6178.83
buyer_2,Aitxiber,Beitia,1984-09-05,35972942E,aitxiber.beitia@extremecode.io,325203,ES33209505222907029444,5037.33,2022-04-10T21:25:52,Gernika,expenses,repairs,-233.68,-6412.51
buyer_2,Aitxiber,Beitia,1984-09-05,35972942E,aitxiber.beitia@extremecode.io,325203,ES33209505222907029444,5037.33,2022-04-11T03:01:04,Gernika,expenses,cash,-100.0,-6512.51
buyer_2,Aitxiber,Beitia,1984-09-05,35972942E,aitxiber.beitia@extremecode.io,325203,ES33209505222907029444,5037.33,2022-04-11T12:54:55,Gernika,expenses,children,-257.04,-6769.55
buyer_2,Aitxiber,Beitia,1984-09-05,35972942E,aitxiber.beitia@extremecode.io,325203,ES33209505222907029444,5037.33,2022-04-12T20:36:49,Gernika,expenses,education,-71.83,-6841.38
buyer_2,Aitxiber,Beitia,1984-09-05,35972942E,aitxiber.beitia@extremecode.io,325203,ES33209505222907029444,5037.33,2022-04-12T18:44:26,Gernika,expenses,repairs,-254.97,-7096.35
buyer_2,Aitxiber,Beitia,1984-09-05,35972942E,aitxiber.beitia@extremecode.io,325203,ES33209505222907029444,5037.33,2022-04-14T06:51:55,Gernika,expenses,transport,-73.03,-7169.38
buyer_2,Aitxiber,Beitia,1984-09-05,35972942E,aitxiber.beitia@extremecode.io,325203,ES33209505222907029444,5037.33,2022-04-16T09:53:04,Gernika,expenses,leisure,-48.39,-7217.77
buyer_2,Aitxiber,Beitia,1984-09-05,35972942E,aitxiber.beitia@extremecode.io,325203,ES33209505222907029444,5037.33,2022-04-16T09:45:59,Gernika,expenses,cash,-100.0,-7317.77
buyer_2,Aitxiber,Beitia,1984-09-05,35972942E,aitxiber.beitia@extremecode.io,325203,ES33209505222907029444,5037.33,2022-04-18T14:24:56,Gernika,expenses,food,-119.09,-7436.86
buyer_2,Aitxiber,Beitia,1984-09-05,35972942E,aitxiber.beitia@extremecode.io,325203,ES33209505222907029444,5037.33,2022-04-19T20:01:03,Gernika,expenses,leisure,-37.24,-7474.1
buyer_2,Aitxiber,Beitia,1984-09-05,35972942E,aitxiber.beitia@extremecode.io,325203,ES33209505222907029444,5037.33,2022-04-19T16:33:33,Gernika,expenses,clothing,-62.67,-7536.77
buyer_2,Aitxiber,Beitia,1984-09-05,35972942E,aitxiber.beitia@extremecode.io,325203,ES33209505222907029444,5037.33,2022-04-19T18:55:53,Gernika,expenses,cash,-100.0,-7636.77
buyer_2,Aitxiber,Beitia,1984-09-05,35972942E,aitxiber.beitia@extremecode.io,325203,ES33209505222907029444,5037.33,2022-04-19T18:34:11,Gernika,expenses,gifts,-259.25,-7896.02
buyer_2,Aitxiber,Beitia,1984-09-05,35972942E,aitxiber.beitia@extremecode.io,325203,ES33209505222907029444,5037.33,2022-04-20T11:20:12,Gernika,expenses,food,-115.87,-8011.89
buyer_2,Aitxiber,Beitia,1984-09-05,35972942E,aitxiber.beitia@extremecode.io,325203,ES33209505222907029444,5037.33,2022-04-20T12:22:07,Gernika,expenses,cash,-100.0,-8111.89
buyer_2,Aitxiber,Beitia,1984-09-05,35972942E,aitxiber.beitia@extremecode.io,325203,ES33209505222907029444,5037.33,2022-04-21T21:44:12,Gernika,expenses,healthcare,-183.62,-8295.51
buyer_2,Aitxiber,Beitia,1984-09-05,35972942E,aitxiber.beitia@extremecode.io,325203,ES33209505222907029444,5037.33,2022-04-23T19:37:27,Gernika,expenses,appliances,-238.31,-8533.82
buyer_2,Aitxiber,Beitia,1984-09-05,35972942E,aitxiber.beitia@extremecode.io,325203,ES33209505222907029444,5037.33,2022-04-30T12:54:42,Gernika,expenses,transport,-52.44,-8586.26
buyer_2,Aitxiber,Beitia,1984-09-05,35972942E,aitxiber.beitia@extremecode.io,325203,ES33209505222907029444,5037.33,2022-05-01T10:04:37,Gernika,incomes,salary,1979.72,-6606.54
buyer_2,Aitxiber,Beitia,1984-09-05,35972942E,aitxiber.beitia@extremecode.io,325203,ES33209505222907029444,5037.33,2022-05-03T20:47:45,Gernika,expenses,transport,-69.6,-6676.14
buyer_2,Aitxiber,Beitia,1984-09-05,35972942E,aitxiber.beitia@extremecode.io,325203,ES33209505222907029444,5037.33,2022-05-03T12:34:05,Gernika,expenses,cash,-100.0,-6776.14
buyer_2,Aitxiber,Beitia,1984-09-05,35972942E,aitxiber.beitia@extremecode.io,325203,ES33209505222907029444,5037.33,2022-05-03T19:42:27,Gernika,expenses,travel,-512.69,-7288.83
buyer_2,Aitxiber,Beitia,1984-09-05,35972942E,aitxiber.beitia@extremecode.io,325203,ES33209505222907029444,5037.33,2022-05-04T14:55:09,Gernika,expenses,transport,-44.05,-7332.88
buyer_2,Aitxiber,Beitia,1984-09-05,35972942E,aitxiber.beitia@extremecode.io,325203,ES33209505222907029444,5037.33,2022-05-05T16:44:34,Gernika,expenses,mortgage,-836.66,-8169.54
buyer_2,Aitxiber,Beitia,1984-09-05,35972942E,aitxiber.beitia@extremecode.io,325203,ES33209505222907029444,5037.33,2022-05-05T11:13:50,Gernika,expenses,internet,-41.57,-8211.11
buyer_2,Aitxiber,Beitia,1984-09-05,35972942E,aitxiber.beitia@extremecode.io,325203,ES33209505222907029444,5037.33,2022-05-05T16:57:57,Gernika,expenses,clothing,-45.85,-8256.96
buyer_2,Aitxiber,Beitia,1984-09-05,35972942E,aitxiber.beitia@extremecode.io,325203,ES33209505222907029444,5037.33,2022-05-06T18:41:03,Gernika,expenses,cash,-100.0,-8356.96
buyer_2,Aitxiber,Beitia,1984-09-05,35972942E,aitxiber.beitia@extremecode.io,325203,ES33209505222907029444,5037.33,2022-05-07T08:25:06,Gernika,expenses,phone,-29.9,-8386.86
buyer_2,Aitxiber,Beitia,1984-09-05,35972942E,aitxiber.beitia@extremecode.io,325203,ES33209505222907029444,5037.33,2022-05-07T23:19:10,Gernika,expenses,leisure,-56.06,-8442.92
buyer_2,Aitxiber,Beitia,1984-09-05,35972942E,aitxiber.beitia@extremecode.io,325203,ES33209505222907029444,5037.33,2022-05-08T16:35:24,Gernika,expenses,electricity,-57.84,-8500.76
buyer_2,Aitxiber,Beitia,1984-09-05,35972942E,aitxiber.beitia@extremecode.io,325203,ES33209505222907029444,5037.33,2022-05-08T16:10:19,Gernika,expenses,gas,-73.7,-8574.46
buyer_2,Aitxiber,Beitia,1984-09-05,35972942E,aitxiber.beitia@extremecode.io,325203,ES33209505222907029444,5037.33,2022-05-08T08:28:35,Gernika,expenses,cash,-100.0,-8674.46
buyer_2,Aitxiber,Beitia,1984-09-05,35972942E,aitxiber.beitia@extremecode.io,325203,ES33209505222907029444,5037.33,2022-05-08T19:20:53,Gernika,expenses,repairs,-58.95,-8733.41
buyer_2,Aitxiber,Beitia,1984-09-05,35972942E,aitxiber.beitia@extremecode.io,325203,ES33209505222907029444,5037.33,2022-05-09T12:20:10,Gernika,expenses,food,-70.71,-8804.12
buyer_2,Aitxiber,Beitia,1984-09-05,35972942E,aitxiber.beitia@extremecode.io,325203,ES33209505222907029444,5037.33,2022-05-09T21:16:36,Gernika,expenses,transport,-75.24,-8879.36
buyer_2,Aitxiber,Beitia,1984-09-05,35972942E,aitxiber.beitia@extremecode.io,325203,ES33209505222907029444,5037.33,2022-05-10T09:53:04,Gernika,expenses,food,-108.87,-8988.23
buyer_2,Aitxiber,Beitia,1984-09-05,35972942E,aitxiber.beitia@extremecode.io,325203,ES33209505222907029444,5037.33,2022-05-10T08:58:06,Gernika,expenses,gifts,-361.57,-9349.8
buyer_2,Aitxiber,Beitia,1984-09-05,35972942E,aitxiber.beitia@extremecode.io,325203,ES33209505222907029444,5037.33,2022-05-11T09:55:52,Gernika,expenses,transport,-84.26,-9434.06
buyer_2,Aitxiber,Beitia,1984-09-05,35972942E,aitxiber.beitia@extremecode.io,325203,ES33209505222907029444,5037.33,2022-05-12T20:20:12,Gernika,expenses,gifts,-751.01,-10185.07
buyer_2,Aitxiber,Beitia,1984-09-05,35972942E,aitxiber.beitia@extremecode.io,325203,ES33209505222907029444,5037.33,2022-05-16T19:14:48,Gernika,expenses,food,-119.83,-10304.9
buyer_2,Aitxiber,Beitia,1984-09-05,35972942E,aitxiber.beitia@extremecode.io,325203,ES33209505222907029444,5037.33,2022-05-17T19:44:19,Gernika,expenses,transport,-58.73,-10363.63
buyer_2,Aitxiber,Beitia,1984-09-05,35972942E,aitxiber.beitia@extremecode.io,325203,ES33209505222907029444,5037.33,2022-05-20T08:28:52,Gernika,expenses,transport,-85.78,-10449.41
buyer_2,Aitxiber,Beitia,1984-09-05,35972942E,aitxiber.beitia@extremecode.io,325203,ES33209505222907029444,5037.33,2022-05-20T14:20:44,Gernika,expenses,cash,-100.0,-10549.41
buyer_2,Aitxiber,Beitia,1984-09-05,35972942E,aitxiber.beitia@extremecode.io,325203,ES33209505222907029444,5037.33,2022-05-21T12:49:04,Gernika,expenses,leisure,-37.48,-10586.89
buyer_2,Aitxiber,Beitia,1984-09-05,35972942E,aitxiber.beitia@extremecode.io,325203,ES33209505222907029444,5037.33,2022-05-22T01:14:59,Gernika,expenses,leisure,-84.95,-10671.84
buyer_2,Aitxiber,Beitia,1984-09-05,35972942E,aitxiber.beitia@extremecode.io,325203,ES33209505222907029444,5037.33,2022-05-22T19:56:01,Gernika,expenses,cash,-100.0,-10771.84
buyer_2,Aitxiber,Beitia,1984-09-05,35972942E,aitxiber.beitia@extremecode.io,325203,ES33209505222907029444,5037.33,2022-05-23T15:18:28,Gernika,expenses,transport,-43.5,-10815.34
buyer_2,Aitxiber,Beitia,1984-09-05,35972942E,aitxiber.beitia@extremecode.io,325203,ES33209505222907029444,5037.33,2022-05-24T01:34:43,Gernika,expenses,repairs,-278.29,-11093.63
buyer_2,Aitxiber,Beitia,1984-09-05,35972942E,aitxiber.beitia@extremecode.io,325203,ES33209505222907029444,5037.33,2022-05-25T17:20:01,Gernika,expenses,travel,-639.11,-11732.74
buyer_2,Aitxiber,Beitia,1984-09-05,35972942E,aitxiber.beitia@extremecode.io,325203,ES33209505222907029444,5037.33,2022-05-25T22:57:27,Gernika,expenses,gifts,-63.21,-11795.95
buyer_2,Aitxiber,Beitia,1984-09-05,35972942E,aitxiber.beitia@extremecode.io,325203,ES33209505222907029444,5037.33,2022-05-26T12:35:19,Gernika,expenses,healthcare,-41.15,-11837.1
buyer_2,Aitxiber,Beitia,1984-09-05,35972942E,aitxiber.beitia@extremecode.io,325203,ES33209505222907029444,5037.33,2022-05-26T21:07:13,Gernika,expenses,repairs,-252.88,-12089.98
buyer_2,Aitxiber,Beitia,1984-09-05,35972942E,aitxiber.beitia@extremecode.io,325203,ES33209505222907029444,5037.33,2022-05-31T10:20:55,Gernika,expenses,leisure,-27.48,-12117.46
buyer_2,Aitxiber,Beitia,1984-09-05,35972942E,aitxiber.beitia@extremecode.io,325203,ES33209505222907029444,5037.33,2022-06-01T11:01:35,Gernika,incomes,salary,1979.72,-10137.74
buyer_2,Aitxiber,Beitia,1984-09-05,35972942E,aitxiber.beitia@extremecode.io,325203,ES33209505222907029444,5037.33,2022-06-01T11:01:35,Gernika,incomes,salary_bonus,1553.23,-8584.51
buyer_2,Aitxiber,Beitia,1984-09-05,35972942E,aitxiber.beitia@extremecode.io,325203,ES33209505222907029444,5037.33,2022-06-01T15:27:54,Gernika,expenses,taxes,-1253.94,-9838.45
buyer_2,Aitxiber,Beitia,1984-09-05,35972942E,aitxiber.beitia@extremecode.io,325203,ES33209505222907029444,5037.33,2022-06-01T06:00:40,Gernika,expenses,insurance,-585.93,-10424.38
buyer_2,Aitxiber,Beitia,1984-09-05,35972942E,aitxiber.beitia@extremecode.io,325203,ES33209505222907029444,5037.33,2022-06-03T16:00:55,Gernika,expenses,leisure,-53.78,-10478.16
buyer_2,Aitxiber,Beitia,1984-09-05,35972942E,aitxiber.beitia@extremecode.io,325203,ES33209505222907029444,5037.33,2022-06-03T10:16:56,Gernika,expenses,repairs,-151.61,-10629.77
buyer_2,Aitxiber,Beitia,1984-09-05,35972942E,aitxiber.beitia@extremecode.io,325203,ES33209505222907029444,5037.33,2022-06-04T21:11:14,Gernika,expenses,leisure,-54.55,-10684.32
buyer_2,Aitxiber,Beitia,1984-09-05,35972942E,aitxiber.beitia@extremecode.io,325203,ES33209505222907029444,5037.33,2022-06-04T13:48:39,Gernika,expenses,gifts,-450.83,-11135.15
buyer_2,Aitxiber,Beitia,1984-09-05,35972942E,aitxiber.beitia@extremecode.io,325203,ES33209505222907029444,5037.33,2022-06-05T11:35:10,Gernika,expenses,mortgage,-836.66,-11971.81
buyer_2,Aitxiber,Beitia,1984-09-05,35972942E,aitxiber.beitia@extremecode.io,325203,ES33209505222907029444,5037.33,2022-06-05T05:46:01,Gernika,expenses,water,-21.5,-11993.31
buyer_2,Aitxiber,Beitia,1984-09-05,35972942E,aitxiber.beitia@extremecode.io,325203,ES33209505222907029444,5037.33,2022-06-06T21:31:43,Gernika,expenses,water,-32.07,-12025.38
buyer_2,Aitxiber,Beitia,1984-09-05,35972942E,aitxiber.beitia@extremecode.io,325203,ES33209505222907029444,5037.33,2022-06-06T08:54:29,Gernika,expenses,phone,-33.73,-12059.11
buyer_2,Aitxiber,Beitia,1984-09-05,35972942E,aitxiber.beitia@extremecode.io,325203,ES33209505222907029444,5037.33,2022-06-07T10:02:12,Gernika,expenses,gas,-103.45,-12162.56
buyer_2,Aitxiber,Beitia,1984-09-05,35972942E,aitxiber.beitia@extremecode.io,325203,ES33209505222907029444,5037.33,2022-06-07T11:49:36,Gernika,expenses,leisure,-58.68,-12221.24
buyer_2,Aitxiber,Beitia,1984-09-05,35972942E,aitxiber.beitia@extremecode.io,325203,ES33209505222907029444,5037.33,2022-06-08T21:33:56,Gernika,expenses,gas,-48.6,-12269.84
buyer_2,Aitxiber,Beitia,1984-09-05,35972942E,aitxiber.beitia@extremecode.io,325203,ES33209505222907029444,5037.33,2022-06-08T22:55:12,Gernika,expenses,phone,-41.63,-12311.47
buyer_2,Aitxiber,Beitia,1984-09-05,35972942E,aitxiber.beitia@extremecode.io,325203,ES33209505222907029444,5037.33,2022-06-08T18:13:46,Gernika,expenses,education,-58.6,-12370.07
buyer_2,Aitxiber,Beitia,1984-09-05,35972942E,aitxiber.beitia@extremecode.io,325203,ES33209505222907029444,5037.33,2022-06-10T16:32:16,Gernika,expenses,cash,-100.0,-12470.07
buyer_2,Aitxiber,Beitia,1984-09-05,35972942E,aitxiber.beitia@extremecode.io,325203,ES33209505222907029444,5037.33,2022-06-11T21:22:42,Gernika,expenses,leisure,-40.4,-12510.47
buyer_2,Aitxiber,Beitia,1984-09-05,35972942E,aitxiber.beitia@extremecode.io,325203,ES33209505222907029444,5037.33,2022-06-12T09:36:43,Gernika,expenses,food,-97.82,-12608.29
buyer_2,Aitxiber,Beitia,1984-09-05,35972942E,aitxiber.beitia@extremecode.io,325203,ES33209505222907029444,5037.33,2022-06-14T10:08:33,Gernika,expenses,transport,-44.54,-12652.83
buyer_2,Aitxiber,Beitia,1984-09-05,35972942E,aitxiber.beitia@extremecode.io,325203,ES33209505222907029444,5037.33,2022-06-17T15:24:41,Gernika,expenses,food,-119.69,-12772.52
buyer_2,Aitxiber,Beitia,1984-09-05,35972942E,aitxiber.beitia@extremecode.io,325203,ES33209505222907029444,5037.33,2022-06-17T16:53:06,Gernika,expenses,leisure,-61.17,-12833.69
buyer_2,Aitxiber,Beitia,1984-09-05,35972942E,aitxiber.beitia@extremecode.io,325203,ES33209505222907029444,5037.33,2022-06-17T11:14:38,Gernika,expenses,cash,-100.0,-12933.69
buyer_2,Aitxiber,Beitia,1984-09-05,35972942E,aitxiber.beitia@extremecode.io,325203,ES33209505222907029444,5037.33,2022-06-18T11:32:13,Gernika,expenses,cash,-100.0,-13033.69
buyer_2,Aitxiber,Beitia,1984-09-05,35972942E,aitxiber.beitia@extremecode.io,325203,ES33209505222907029444,5037.33,2022-06-18T17:30:10,Gernika,expenses,repairs,-68.65,-13102.34
buyer_2,Aitxiber,Beitia,1984-09-05,35972942E,aitxiber.beitia@extremecode.io,325203,ES33209505222907029444,5037.33,2022-06-20T02:13:16,Gernika,expenses,food,-81.51,-13183.85
buyer_2,Aitxiber,Beitia,1984-09-05,35972942E,aitxiber.beitia@extremecode.io,325203,ES33209505222907029444,5037.33,2022-06-20T15:14:28,Gernika,expenses,cash,-100.0,-13283.85
buyer_2,Aitxiber,Beitia,1984-09-05,35972942E,aitxiber.beitia@extremecode.io,325203,ES33209505222907029444,5037.33,2022-06-21T15:19:26,Gernika,expenses,cash,-100.0,-13383.85
buyer_2,Aitxiber,Beitia,1984-09-05,35972942E,aitxiber.beitia@extremecode.io,325203,ES33209505222907029444,5037.33,2022-06-21T16:39:55,Gernika,expenses,repairs,-39.33,-13423.18
buyer_2,Aitxiber,Beitia,1984-09-05,35972942E,aitxiber.beitia@extremecode.io,325203,ES33209505222907029444,5037.33,2022-06-21T20:03:49,Gernika,expenses,children,-604.66,-14027.84
buyer_2,Aitxiber,Beitia,1984-09-05,35972942E,aitxiber.beitia@extremecode.io,325203,ES33209505222907029444,5037.33,2022-06-22T16:07:07,Gernika,expenses,transport,-88.01,-14115.85
buyer_2,Aitxiber,Beitia,1984-09-05,35972942E,aitxiber.beitia@extremecode.io,325203,ES33209505222907029444,5037.33,2022-06-22T12:56:59,Gernika,expenses,cash,-100.0,-14215.85
buyer_2,Aitxiber,Beitia,1984-09-05,35972942E,aitxiber.beitia@extremecode.io,325203,ES33209505222907029444,5037.33,2022-06-25T19:53:31,Gernika,expenses,transport,-53.91,-14269.76
buyer_2,Aitxiber,Beitia,1984-09-05,35972942E,aitxiber.beitia@extremecode.io,325203,ES33209505222907029444,5037.33,2022-06-28T20:22:39,Gernika,expenses,appliances,-191.06,-14460.82
buyer_2,Aitxiber,Beitia,1984-09-05,35972942E,aitxiber.beitia@extremecode.io,325203,ES33209505222907029444,5037.33,2022-06-30T18:15:35,Gernika,expenses,children,-487.84,-14948.66
buyer_2,Aitxiber,Beitia,1984-09-05,35972942E,aitxiber.beitia@extremecode.io,325203,ES33209505222907029444,5037.33,2022-07-01T21:49:51,Gernika,incomes,salary,1979.72,-12968.94
buyer_2,Aitxiber,Beitia,1984-09-05,35972942E,aitxiber.beitia@extremecode.io,325203,ES33209505222907029444,5037.33,2022-07-01T21:49:51,Gernika,incomes,extra_income,380.33,-12588.61
buyer_2,Aitxiber,Beitia,1984-09-05,35972942E,aitxiber.beitia@extremecode.io,325203,ES33209505222907029444,5037.33,2022-07-01T16:35:44,Gernika,expenses,food,-82.97,-12671.58
buyer_2,Aitxiber,Beitia,1984-09-05,35972942E,aitxiber.beitia@extremecode.io,325203,ES33209505222907029444,5037.33,2022-07-04T16:51:57,Gernika,expenses,food,-119.35,-12790.93
buyer_2,Aitxiber,Beitia,1984-09-05,35972942E,aitxiber.beitia@extremecode.io,325203,ES33209505222907029444,5037.33,2022-07-04T13:01:39,Gernika,expenses,leisure,-47.0,-12837.93
buyer_2,Aitxiber,Beitia,1984-09-05,35972942E,aitxiber.beitia@extremecode.io,325203,ES33209505222907029444,5037.33,2022-07-05T15:39:04,Gernika,expenses,mortgage,-836.66,-13674.59
buyer_2,Aitxiber,Beitia,1984-09-05,35972942E,aitxiber.beitia@extremecode.io,325203,ES33209505222907029444,5037.33,2022-07-05T18:43:20,Gernika,expenses,repairs,-267.99,-13942.58
buyer_2,Aitxiber,Beitia,1984-09-05,35972942E,aitxiber.beitia@extremecode.io,325203,ES33209505222907029444,5037.33,2022-07-06T14:05:36,Gernika,expenses,gas,-77.02,-14019.6
buyer_2,Aitxiber,Beitia,1984-09-05,35972942E,aitxiber.beitia@extremecode.io,325203,ES33209505222907029444,5037.33,2022-07-06T20:16:15,Gernika,expenses,food,-70.18,-14089.78
buyer_2,Aitxiber,Beitia,1984-09-05,35972942E,aitxiber.beitia@extremecode.io,325203,ES33209505222907029444,5037.33,2022-07-07T11:48:39,Gernika,expenses,electricity,-85.53,-14175.31
buyer_2,Aitxiber,Beitia,1984-09-05,35972942E,aitxiber.beitia@extremecode.io,325203,ES33209505222907029444,5037.33,2022-07-07T19:13:35,Gernika,expenses,cash,-100.0,-14275.31
buyer_2,Aitxiber,Beitia,1984-09-05,35972942E,aitxiber.beitia@extremecode.io,325203,ES33209505222907029444,5037.33,2022-07-08T00:08:24,Gernika,expenses,cash,-100.0,-14375.31
buyer_2,Aitxiber,Beitia,1984-09-05,35972942E,aitxiber.beitia@extremecode.io,325203,ES33209505222907029444,5037.33,2022-07-09T13:33:14,Gernika,expenses,food,-89.18,-14464.49
buyer_2,Aitxiber,Beitia,1984-09-05,35972942E,aitxiber.beitia@extremecode.io,325203,ES33209505222907029444,5037.33,2022-07-12T14:06:36,Gernika,expenses,food,-63.9,-14528.39
buyer_2,Aitxiber,Beitia,1984-09-05,35972942E,aitxiber.beitia@extremecode.io,325203,ES33209505222907029444,5037.33,2022-07-14T19:50:25,Gernika,expenses,food,-111.13,-14639.52
buyer_2,Aitxiber,Beitia,1984-09-05,35972942E,aitxiber.beitia@extremecode.io,325203,ES33209505222907029444,5037.33,2022-07-14T08:12:07,Gernika,expenses,clothing,-79.0,-14718.52
buyer_2,Aitxiber,Beitia,1984-09-05,35972942E,aitxiber.beitia@extremecode.io,325203,ES33209505222907029444,5037.33,2022-07-14T10:44:16,Gernika,expenses,cash,-100.0,-14818.52
buyer_2,Aitxiber,Beitia,1984-09-05,35972942E,aitxiber.beitia@extremecode.io,325203,ES33209505222907029444,5037.33,2022-07-15T13:18:06,Gernika,expenses,leisure,-29.61,-14848.13
buyer_2,Aitxiber,Beitia,1984-09-05,35972942E,aitxiber.beitia@extremecode.io,325203,ES33209505222907029444,5037.33,2022-07-16T19:03:07,Gernika,expenses,healthcare,-111.53,-14959.66
buyer_2,Aitxiber,Beitia,1984-09-05,35972942E,aitxiber.beitia@extremecode.io,325203,ES33209505222907029444,5037.33,2022-07-16T08:34:07,Gernika,expenses,cash,-100.0,-15059.66
buyer_2,Aitxiber,Beitia,1984-09-05,35972942E,aitxiber.beitia@extremecode.io,325203,ES33209505222907029444,5037.33,2022-07-17T17:17:42,Gernika,expenses,leisure,-50.69,-15110.35
buyer_2,Aitxiber,Beitia,1984-09-05,35972942E,aitxiber.beitia@extremecode.io,325203,ES33209505222907029444,5037.33,2022-07-20T17:00:02,Gernika,expenses,children,-719.39,-15829.74
buyer_2,Aitxiber,Beitia,1984-09-05,35972942E,aitxiber.beitia@extremecode.io,325203,ES33209505222907029444,5037.33,2022-07-21T12:31:10,Gernika,expenses,healthcare,-74.59,-15904.33
buyer_2,Aitxiber,Beitia,1984-09-05,35972942E,aitxiber.beitia@extremecode.io,325203,ES33209505222907029444,5037.33,2022-07-23T14:44:52,Gernika,expenses,transport,-89.59,-15993.92
buyer_2,Aitxiber,Beitia,1984-09-05,35972942E,aitxiber.beitia@extremecode.io,325203,ES33209505222907029444,5037.33,2022-07-24T08:14:38,Gernika,expenses,repairs,-97.77,-16091.69
buyer_2,Aitxiber,Beitia,1984-09-05,35972942E,aitxiber.beitia@extremecode.io,325203,ES33209505222907029444,5037.33,2022-07-25T12:14:43,Gernika,expenses,food,-117.28,-16208.97
buyer_2,Aitxiber,Beitia,1984-09-05,35972942E,aitxiber.beitia@extremecode.io,325203,ES33209505222907029444,5037.33,2022-07-25T09:14:20,Gernika,expenses,cash,-100.0,-16308.97
buyer_2,Aitxiber,Beitia,1984-09-05,35972942E,aitxiber.beitia@extremecode.io,325203,ES33209505222907029444,5037.33,2022-07-26T13:48:19,Gernika,expenses,clothing,-56.51,-16365.48
buyer_2,Aitxiber,Beitia,1984-09-05,35972942E,aitxiber.beitia@extremecode.io,325203,ES33209505222907029444,5037.33,2022-07-26T04:21:27,Gernika,expenses,children,-646.98,-17012.46
buyer_2,Aitxiber,Beitia,1984-09-05,35972942E,aitxiber.beitia@extremecode.io,325203,ES33209505222907029444,5037.33,2022-07-28T10:22:30,Gernika,expenses,gifts,-51.58,-17064.04
buyer_2,Aitxiber,Beitia,1984-09-05,35972942E,aitxiber.beitia@extremecode.io,325203,ES33209505222907029444,5037.33,2022-07-29T21:24:15,Gernika,expenses,leisure,-33.0,-17097.04
buyer_2,Aitxiber,Beitia,1984-09-05,35972942E,aitxiber.beitia@extremecode.io,325203,ES33209505222907029444,5037.33,2022-07-29T13:48:32,Gernika,expenses,children,-338.23,-17435.27
buyer_2,Aitxiber,Beitia,1984-09-05,35972942E,aitxiber.beitia@extremecode.io,325203,ES33209505222907029444,5037.33,2022-07-31T14:37:45,Gernika,expenses,cash,-100.0,-17535.27
buyer_2,Aitxiber,Beitia,1984-09-05,35972942E,aitxiber.beitia@extremecode.io,325203,ES33209505222907029444,5037.33,2022-08-01T10:54:20,Gernika,incomes,salary,1979.72,-15555.55
buyer_2,Aitxiber,Beitia,1984-09-05,35972942E,aitxiber.beitia@extremecode.io,325203,ES33209505222907029444,5037.33,2022-08-03T15:57:20,Gernika,expenses,children,-587.55,-16143.1
buyer_2,Aitxiber,Beitia,1984-09-05,35972942E,aitxiber.beitia@extremecode.io,325203,ES33209505222907029444,5037.33,2022-08-05T20:33:37,Gernika,expenses,mortgage,-836.66,-16979.76
buyer_2,Aitxiber,Beitia,1984-09-05,35972942E,aitxiber.beitia@extremecode.io,325203,ES33209505222907029444,5037.33,2022-08-05T16:57:24,Gernika,expenses,water,-23.71,-17003.47
buyer_2,Aitxiber,Beitia,1984-09-05,35972942E,aitxiber.beitia@extremecode.io,325203,ES33209505222907029444,5037.33,2022-08-05T23:13:25,Gernika,expenses,education,-60.55,-17064.02
buyer_2,Aitxiber,Beitia,1984-09-05,35972942E,aitxiber.beitia@extremecode.io,325203,ES33209505222907029444,5037.33,2022-08-06T10:36:14,Gernika,expenses,gas,-57.74,-17121.76
buyer_2,Aitxiber,Beitia,1984-09-05,35972942E,aitxiber.beitia@extremecode.io,325203,ES33209505222907029444,5037.33,2022-08-07T08:03:40,Gernika,expenses,electricity,-33.23,-17154.99
buyer_2,Aitxiber,Beitia,1984-09-05,35972942E,aitxiber.beitia@extremecode.io,325203,ES33209505222907029444,5037.33,2022-08-08T13:50:31,Gernika,expenses,cash,-100.0,-17254.99
buyer_2,Aitxiber,Beitia,1984-09-05,35972942E,aitxiber.beitia@extremecode.io,325203,ES33209505222907029444,5037.33,2022-08-11T16:01:31,Gernika,expenses,cash,-100.0,-17354.99
buyer_2,Aitxiber,Beitia,1984-09-05,35972942E,aitxiber.beitia@extremecode.io,325203,ES33209505222907029444,5037.33,2022-08-12T10:05:50,Gernika,expenses,cash,-100.0,-17454.99
buyer_2,Aitxiber,Beitia,1984-09-05,35972942E,aitxiber.beitia@extremecode.io,325203,ES33209505222907029444,5037.33,2022-08-14T11:57:38,Gernika,expenses,repairs,-139.55,-17594.54
buyer_2,Aitxiber,Beitia,1984-09-05,35972942E,aitxiber.beitia@extremecode.io,325203,ES33209505222907029444,5037.33,2022-08-15T19:27:19,Gernika,expenses,cash,-100.0,-17694.54
buyer_2,Aitxiber,Beitia,1984-09-05,35972942E,aitxiber.beitia@extremecode.io,325203,ES33209505222907029444,5037.33,2022-08-21T19:09:27,Gernika,expenses,transport,-82.97,-17777.51
buyer_2,Aitxiber,Beitia,1984-09-05,35972942E,aitxiber.beitia@extremecode.io,325203,ES33209505222907029444,5037.33,2022-08-24T22:55:57,Gernika,expenses,leisure,-72.25,-17849.76
buyer_2,Aitxiber,Beitia,1984-09-05,35972942E,aitxiber.beitia@extremecode.io,325203,ES33209505222907029444,5037.33,2022-08-24T16:49:41,Gernika,expenses,children,-251.73,-18101.49
buyer_2,Aitxiber,Beitia,1984-09-05,35972942E,aitxiber.beitia@extremecode.io,325203,ES33209505222907029444,5037.33,2022-08-25T12:35:20,Gernika,expenses,cash,-100.0,-18201.49
buyer_2,Aitxiber,Beitia,1984-09-05,35972942E,aitxiber.beitia@extremecode.io,325203,ES33209505222907029444,5037.33,2022-08-26T14:01:58,Gernika,expenses,transport,-64.31,-18265.8
buyer_2,Aitxiber,Beitia,1984-09-05,35972942E,aitxiber.beitia@extremecode.io,325203,ES33209505222907029444,5037.33,2022-08-29T14:28:15,Gernika,expenses,leisure,-72.51,-18338.31
buyer_2,Aitxiber,Beitia,1984-09-05,35972942E,aitxiber.beitia@extremecode.io,325203,ES33209505222907029444,5037.33,2022-08-31T18:23:54,Gernika,expenses,leisure,-70.54,-18408.85
buyer_2,Aitxiber,Beitia,1984-09-05,35972942E,aitxiber.beitia@extremecode.io,325203,ES33209505222907029444,5037.33,2022-09-01T14:04:32,Gernika,incomes,salary,1979.72,-16429.13
buyer_2,Aitxiber,Beitia,1984-09-05,35972942E,aitxiber.beitia@extremecode.io,325203,ES33209505222907029444,5037.33,2022-09-02T03:12:27,Gernika,expenses,transport,-54.28,-16483.41
buyer_2,Aitxiber,Beitia,1984-09-05,35972942E,aitxiber.beitia@extremecode.io,325203,ES33209505222907029444,5037.33,2022-09-03T14:29:50,Gernika,expenses,leisure,-35.63,-16519.04
buyer_2,Aitxiber,Beitia,1984-09-05,35972942E,aitxiber.beitia@extremecode.io,325203,ES33209505222907029444,5037.33,2022-09-03T16:58:59,Gernika,expenses,cash,-100.0,-16619.04
buyer_2,Aitxiber,Beitia,1984-09-05,35972942E,aitxiber.beitia@extremecode.io,325203,ES33209505222907029444,5037.33,2022-09-05T12:01:08,Gernika,expenses,mortgage,-836.66,-17455.7
buyer_2,Aitxiber,Beitia,1984-09-05,35972942E,aitxiber.beitia@extremecode.io,325203,ES33209505222907029444,5037.33,2022-09-05T14:37:16,Gernika,expenses,water,-30.73,-17486.43
buyer_2,Aitxiber,Beitia,1984-09-05,35972942E,aitxiber.beitia@extremecode.io,325203,ES33209505222907029444,5037.33,2022-09-05T09:12:48,Gernika,expenses,internet,-41.57,-17528.0
buyer_2,Aitxiber,Beitia,1984-09-05,35972942E,aitxiber.beitia@extremecode.io,325203,ES33209505222907029444,5037.33,2022-09-05T11:28:05,Gernika,expenses,transport,-61.59,-17589.59
buyer_2,Aitxiber,Beitia,1984-09-05,35972942E,aitxiber.beitia@extremecode.io,325203,ES33209505222907029444,5037.33,2022-09-05T09:07:53,Gernika,expenses,children,-566.28,-18155.87
buyer_2,Aitxiber,Beitia,1984-09-05,35972942E,aitxiber.beitia@extremecode.io,325203,ES33209505222907029444,5037.33,2022-09-06T20:54:03,Gernika,expenses,phone,-38.24,-18194.11
buyer_2,Aitxiber,Beitia,1984-09-05,35972942E,aitxiber.beitia@extremecode.io,325203,ES33209505222907029444,5037.33,2022-09-06T15:06:50,Gernika,expenses,transport,-58.06,-18252.17
buyer_2,Aitxiber,Beitia,1984-09-05,35972942E,aitxiber.beitia@extremecode.io,325203,ES33209505222907029444,5037.33,2022-09-06T09:33:00,Gernika,expenses,leisure,-68.51,-18320.68
buyer_2,Aitxiber,Beitia,1984-09-05,35972942E,aitxiber.beitia@extremecode.io,325203,ES33209505222907029444,5037.33,2022-09-07T11:23:12,Gernika,expenses,internet,-41.57,-18362.25
buyer_2,Aitxiber,Beitia,1984-09-05,35972942E,aitxiber.beitia@extremecode.io,325203,ES33209505222907029444,5037.33,2022-09-07T12:10:32,Gernika,expenses,food,-101.51,-18463.76
buyer_2,Aitxiber,Beitia,1984-09-05,35972942E,aitxiber.beitia@extremecode.io,325203,ES33209505222907029444,5037.33,2022-09-07T14:57:44,Gernika,expenses,repairs,-133.65,-18597.41
buyer_2,Aitxiber,Beitia,1984-09-05,35972942E,aitxiber.beitia@extremecode.io,325203,ES33209505222907029444,5037.33,2022-09-08T11:01:45,Gernika,expenses,electricity,-26.88,-18624.29
buyer_2,Aitxiber,Beitia,1984-09-05,35972942E,aitxiber.beitia@extremecode.io,325203,ES33209505222907029444,5037.33,2022-09-08T19:01:58,Gernika,expenses,gas,-49.6,-18673.89
buyer_2,Aitxiber,Beitia,1984-09-05,35972942E,aitxiber.beitia@extremecode.io,325203,ES33209505222907029444,5037.33,2022-09-08T19:19:19,Gernika,expenses,food,-73.55,-18747.44
buyer_2,Aitxiber,Beitia,1984-09-05,35972942E,aitxiber.beitia@extremecode.io,325203,ES33209505222907029444,5037.33,2022-09-09T18:29:04,Gernika,expenses,cash,-100.0,-18847.44
buyer_2,Aitxiber,Beitia,1984-09-05,35972942E,aitxiber.beitia@extremecode.io,325203,ES33209505222907029444,5037.33,2022-09-10T19:41:15,Gernika,expenses,transport,-85.8,-18933.24
buyer_2,Aitxiber,Beitia,1984-09-05,35972942E,aitxiber.beitia@extremecode.io,325203,ES33209505222907029444,5037.33,2022-09-12T22:12:58,Gernika,expenses,transport,-69.82,-19003.06
buyer_2,Aitxiber,Beitia,1984-09-05,35972942E,aitxiber.beitia@extremecode.io,325203,ES33209505222907029444,5037.33,2022-09-13T16:04:21,Gernika,expenses,travel,-414.04,-19417.1
buyer_2,Aitxiber,Beitia,1984-09-05,35972942E,aitxiber.beitia@extremecode.io,325203,ES33209505222907029444,5037.33,2022-09-13T17:12:19,Gernika,expenses,repairs,-259.92,-19677.02
buyer_2,Aitxiber,Beitia,1984-09-05,35972942E,aitxiber.beitia@extremecode.io,325203,ES33209505222907029444,5037.33,2022-09-14T20:28:03,Gernika,expenses,repairs,-55.43,-19732.45
buyer_2,Aitxiber,Beitia,1984-09-05,35972942E,aitxiber.beitia@extremecode.io,325203,ES33209505222907029444,5037.33,2022-09-15T14:32:56,Gernika,expenses,transport,-67.96,-19800.41
buyer_2,Aitxiber,Beitia,1984-09-05,35972942E,aitxiber.beitia@extremecode.io,325203,ES33209505222907029444,5037.33,2022-09-18T10:52:38,Gernika,expenses,gifts,-343.71,-20144.12
buyer_2,Aitxiber,Beitia,1984-09-05,35972942E,aitxiber.beitia@extremecode.io,325203,ES33209505222907029444,5037.33,2022-09-19T14:01:22,Gernika,expenses,food,-118.77,-20262.89
buyer_2,Aitxiber,Beitia,1984-09-05,35972942E,aitxiber.beitia@extremecode.io,325203,ES33209505222907029444,5037.33,2022-09-19T11:06:15,Gernika,expenses,education,-72.98,-20335.87
buyer_2,Aitxiber,Beitia,1984-09-05,35972942E,aitxiber.beitia@extremecode.io,325203,ES33209505222907029444,5037.33,2022-09-19T13:38:42,Gernika,expenses,repairs,-225.04,-20560.91
buyer_2,Aitxiber,Beitia,1984-09-05,35972942E,aitxiber.beitia@extremecode.io,325203,ES33209505222907029444,5037.33,2022-09-22T02:48:06,Gernika,expenses,children,-174.17,-20735.08
buyer_2,Aitxiber,Beitia,1984-09-05,35972942E,aitxiber.beitia@extremecode.io,325203,ES33209505222907029444,5037.33,2022-09-25T22:08:56,Gernika,expenses,leisure,-75.66,-20810.74
buyer_2,Aitxiber,Beitia,1984-09-05,35972942E,aitxiber.beitia@extremecode.io,325203,ES33209505222907029444,5037.33,2022-09-26T11:59:13,Gernika,expenses,food,-112.55,-20923.29
buyer_2,Aitxiber,Beitia,1984-09-05,35972942E,aitxiber.beitia@extremecode.io,325203,ES33209505222907029444,5037.33,2022-09-26T14:29:14,Gernika,expenses,leisure,-41.03,-20964.32
buyer_2,Aitxiber,Beitia,1984-09-05,35972942E,aitxiber.beitia@extremecode.io,325203,ES33209505222907029444,5037.33,2022-09-27T14:47:11,Gernika,expenses,leisure,-29.84,-20994.16
buyer_2,Aitxiber,Beitia,1984-09-05,35972942E,aitxiber.beitia@extremecode.io,325203,ES33209505222907029444,5037.33,2022-09-27T21:53:57,Gernika,expenses,repairs,-194.58,-21188.74
buyer_2,Aitxiber,Beitia,1984-09-05,35972942E,aitxiber.beitia@extremecode.io,325203,ES33209505222907029444,5037.33,2022-09-29T08:09:13,Gernika,expenses,leisure,-42.78,-21231.52
buyer_2,Aitxiber,Beitia,1984-09-05,35972942E,aitxiber.beitia@extremecode.io,325203,ES33209505222907029444,5037.33,2022-09-29T09:12:38,Gernika,expenses,children,-465.53,-21697.05
buyer_2,Aitxiber,Beitia,1984-09-05,35972942E,aitxiber.beitia@extremecode.io,325203,ES33209505222907029444,5037.33,2022-09-30T10:31:08,Gernika,expenses,food,-75.7,-21772.75
buyer_2,Aitxiber,Beitia,1984-09-05,35972942E,aitxiber.beitia@extremecode.io,325203,ES33209505222907029444,5037.33,2022-10-01T10:47:19,Gernika,incomes,salary,1979.72,-19793.03
buyer_2,Aitxiber,Beitia,1984-09-05,35972942E,aitxiber.beitia@extremecode.io,325203,ES33209505222907029444,5037.33,2022-10-01T10:47:19,Gernika,incomes,extra_income,380.33,-19412.7
buyer_2,Aitxiber,Beitia,1984-09-05,35972942E,aitxiber.beitia@extremecode.io,325203,ES33209505222907029444,5037.33,2022-10-01T00:28:50,Gernika,expenses,transport,-64.93,-19477.63
buyer_2,Aitxiber,Beitia,1984-09-05,35972942E,aitxiber.beitia@extremecode.io,325203,ES33209505222907029444,5037.33,2022-10-02T06:51:59,Gernika,expenses,transport,-45.43,-19523.06
buyer_2,Aitxiber,Beitia,1984-09-05,35972942E,aitxiber.beitia@extremecode.io,325203,ES33209505222907029444,5037.33,2022-10-05T12:31:13,Gernika,expenses,mortgage,-836.66,-20359.72
buyer_2,Aitxiber,Beitia,1984-09-05,35972942E,aitxiber.beitia@extremecode.io,325203,ES33209505222907029444,5037.33,2022-10-05T10:44:57,Gernika,expenses,internet,-41.57,-20401.29
buyer_2,Aitxiber,Beitia,1984-09-05,35972942E,aitxiber.beitia@extremecode.io,325203,ES33209505222907029444,5037.33,2022-10-05T19:27:14,Gernika,expenses,clothing,-85.88,-20487.17
buyer_2,Aitxiber,Beitia,1984-09-05,35972942E,aitxiber.beitia@extremecode.io,325203,ES33209505222907029444,5037.33,2022-10-06T21:22:56,Gernika,expenses,phone,-31.01,-20518.18
buyer_2,Aitxiber,Beitia,1984-09-05,35972942E,aitxiber.beitia@extremecode.io,325203,ES33209505222907029444,5037.33,2022-10-06T12:27:24,Gernika,expenses,cash,-100.0,-20618.18
buyer_2,Aitxiber,Beitia,1984-09-05,35972942E,aitxiber.beitia@extremecode.io,325203,ES33209505222907029444,5037.33,2022-10-07T11:06:31,Gernika,expenses,cash,-100.0,-20718.18
buyer_2,Aitxiber,Beitia,1984-09-05,35972942E,aitxiber.beitia@extremecode.io,325203,ES33209505222907029444,5037.33,2022-10-08T11:29:53,Gernika,expenses,internet,-41.57,-20759.75
buyer_2,Aitxiber,Beitia,1984-09-05,35972942E,aitxiber.beitia@extremecode.io,325203,ES33209505222907029444,5037.33,2022-10-08T16:26:44,Gernika,expenses,cash,-100.0,-20859.75
buyer_2,Aitxiber,Beitia,1984-09-05,35972942E,aitxiber.beitia@extremecode.io,325203,ES33209505222907029444,5037.33,2022-10-08T20:46:22,Gernika,expenses,repairs,-29.89,-20889.64
buyer_2,Aitxiber,Beitia,1984-09-05,35972942E,aitxiber.beitia@extremecode.io,325203,ES33209505222907029444,5037.33,2022-10-09T18:49:25,Gernika,expenses,leisure,-47.71,-20937.35
buyer_2,Aitxiber,Beitia,1984-09-05,35972942E,aitxiber.beitia@extremecode.io,325203,ES33209505222907029444,5037.33,2022-10-11T16:23:12,Gernika,expenses,repairs,-133.46,-21070.81
buyer_2,Aitxiber,Beitia,1984-09-05,35972942E,aitxiber.beitia@extremecode.io,325203,ES33209505222907029444,5037.33,2022-10-12T09:16:02,Gernika,expenses,clothing,-133.74,-21204.55
buyer_2,Aitxiber,Beitia,1984-09-05,35972942E,aitxiber.beitia@extremecode.io,325203,ES33209505222907029444,5037.33,2022-10-12T13:00:59,Gernika,expenses,cash,-100.0,-21304.55
buyer_2,Aitxiber,Beitia,1984-09-05,35972942E,aitxiber.beitia@extremecode.io,325203,ES33209505222907029444,5037.33,2022-10-12T14:26:02,Gernika,expenses,children,-271.67,-21576.22
buyer_2,Aitxiber,Beitia,1984-09-05,35972942E,aitxiber.beitia@extremecode.io,325203,ES33209505222907029444,5037.33,2022-10-14T18:44:17,Gernika,expenses,food,-63.03,-21639.25
buyer_2,Aitxiber,Beitia,1984-09-05,35972942E,aitxiber.beitia@extremecode.io,325203,ES33209505222907029444,5037.33,2022-10-14T08:04:18,Gernika,expenses,leisure,-34.76,-21674.01
buyer_2,Aitxiber,Beitia,1984-09-05,35972942E,aitxiber.beitia@extremecode.io,325203,ES33209505222907029444,5037.33,2022-10-15T12:26:32,Gernika,expenses,travel,-730.85,-22404.86
buyer_2,Aitxiber,Beitia,1984-09-05,35972942E,aitxiber.beitia@extremecode.io,325203,ES33209505222907029444,5037.33,2022-10-16T13:18:11,Gernika,expenses,leisure,-20.75,-22425.61
buyer_2,Aitxiber,Beitia,1984-09-05,35972942E,aitxiber.beitia@extremecode.io,325203,ES33209505222907029444,5037.33,2022-10-18T08:36:30,Gernika,expenses,leisure,-69.43,-22495.04
buyer_2,Aitxiber,Beitia,1984-09-05,35972942E,aitxiber.beitia@extremecode.io,325203,ES33209505222907029444,5037.33,2022-10-24T12:11:50,Gernika,expenses,food,-109.59,-22604.63
buyer_2,Aitxiber,Beitia,1984-09-05,35972942E,aitxiber.beitia@extremecode.io,325203,ES33209505222907029444,5037.33,2022-10-24T09:30:30,Gernika,expenses,transport,-53.96,-22658.59
buyer_2,Aitxiber,Beitia,1984-09-05,35972942E,aitxiber.beitia@extremecode.io,325203,ES33209505222907029444,5037.33,2022-10-24T15:00:26,Gernika,expenses,children,-538.1,-23196.69
buyer_2,Aitxiber,Beitia,1984-09-05,35972942E,aitxiber.beitia@extremecode.io,325203,ES33209505222907029444,5037.33,2022-10-25T08:07:25,Gernika,expenses,healthcare,-106.16,-23302.85
buyer_2,Aitxiber,Beitia,1984-09-05,35972942E,aitxiber.beitia@extremecode.io,325203,ES33209505222907029444,5037.33,2022-10-26T16:31:40,Gernika,expenses,clothing,-56.42,-23359.27
buyer_2,Aitxiber,Beitia,1984-09-05,35972942E,aitxiber.beitia@extremecode.io,325203,ES33209505222907029444,5037.33,2022-10-28T09:11:31,Gernika,expenses,cash,-100.0,-23459.27
buyer_2,Aitxiber,Beitia,1984-09-05,35972942E,aitxiber.beitia@extremecode.io,325203,ES33209505222907029444,5037.33,2022-10-29T16:00:13,Gernika,expenses,healthcare,-116.53,-23575.8
buyer_2,Aitxiber,Beitia,1984-09-05,35972942E,aitxiber.beitia@extremecode.io,325203,ES33209505222907029444,5037.33,2022-10-29T15:52:32,Gernika,expenses,cash,-100.0,-23675.8
buyer_2,Aitxiber,Beitia,1984-09-05,35972942E,aitxiber.beitia@extremecode.io,325203,ES33209505222907029444,5037.33,2022-10-31T23:28:47,Gernika,expenses,cash,-100.0,-23775.8
buyer_2,Aitxiber,Beitia,1984-09-05,35972942E,aitxiber.beitia@extremecode.io,325203,ES33209505222907029444,5037.33,2022-11-01T15:17:02,Gernika,incomes,salary,1979.72,-21796.08
buyer_2,Aitxiber,Beitia,1984-09-05,35972942E,aitxiber.beitia@extremecode.io,325203,ES33209505222907029444,5037.33,2022-11-01T21:26:43,Gernika,expenses,food,-99.81,-21895.89
buyer_2,Aitxiber,Beitia,1984-09-05,35972942E,aitxiber.beitia@extremecode.io,325203,ES33209505222907029444,5037.33,2022-11-02T20:10:21,Gernika,expenses,education,-46.51,-21942.4
buyer_2,Aitxiber,Beitia,1984-09-05,35972942E,aitxiber.beitia@extremecode.io,325203,ES33209505222907029444,5037.33,2022-11-03T14:53:50,Gernika,expenses,leisure,-69.74,-22012.14
buyer_2,Aitxiber,Beitia,1984-09-05,35972942E,aitxiber.beitia@extremecode.io,325203,ES33209505222907029444,5037.33,2022-11-04T23:13:50,Gernika,expenses,food,-108.64,-22120.78
buyer_2,Aitxiber,Beitia,1984-09-05,35972942E,aitxiber.beitia@extremecode.io,325203,ES33209505222907029444,5037.33,2022-11-04T14:13:28,Gernika,expenses,leisure,-43.04,-22163.82
buyer_2,Aitxiber,Beitia,1984-09-05,35972942E,aitxiber.beitia@extremecode.io,325203,ES33209505222907029444,5037.33,2022-11-04T15:11:57,Gernika,expenses,appliances,-277.85,-22441.67
buyer_2,Aitxiber,Beitia,1984-09-05,35972942E,aitxiber.beitia@extremecode.io,325203,ES33209505222907029444,5037.33,2022-11-05T15:45:25,Gernika,expenses,mortgage,-836.66,-23278.33
buyer_2,Aitxiber,Beitia,1984-09-05,35972942E,aitxiber.beitia@extremecode.io,325203,ES33209505222907029444,5037.33,2022-11-06T08:02:17,Gernika,expenses,gas,-66.02,-23344.35
buyer_2,Aitxiber,Beitia,1984-09-05,35972942E,aitxiber.beitia@extremecode.io,325203,ES33209505222907029444,5037.33,2022-11-06T20:30:14,Gernika,expenses,food,-93.97,-23438.32
buyer_2,Aitxiber,Beitia,1984-09-05,35972942E,aitxiber.beitia@extremecode.io,325203,ES33209505222907029444,5037.33,2022-11-06T08:38:05,Gernika,expenses,education,-67.1,-23505.42
buyer_2,Aitxiber,Beitia,1984-09-05,35972942E,aitxiber.beitia@extremecode.io,325203,ES33209505222907029444,5037.33,2022-11-07T18:48:30,Gernika,expenses,water,-26.57,-23531.99
buyer_2,Aitxiber,Beitia,1984-09-05,35972942E,aitxiber.beitia@extremecode.io,325203,ES33209505222907029444,5037.33,2022-11-07T17:54:31,Gernika,expenses,electricity,-34.74,-23566.73
buyer_2,Aitxiber,Beitia,1984-09-05,35972942E,aitxiber.beitia@extremecode.io,325203,ES33209505222907029444,5037.33,2022-11-07T14:46:28,Gernika,expenses,gas,-62.34,-23629.07
buyer_2,Aitxiber,Beitia,1984-09-05,35972942E,aitxiber.beitia@extremecode.io,325203,ES33209505222907029444,5037.33,2022-11-07T19:40:21,Gernika,expenses,internet,-41.57,-23670.64
buyer_2,Aitxiber,Beitia,1984-09-05,35972942E,aitxiber.beitia@extremecode.io,325203,ES33209505222907029444,5037.33,2022-11-07T08:57:31,Gernika,expenses,phone,-32.59,-23703.23
buyer_2,Aitxiber,Beitia,1984-09-05,35972942E,aitxiber.beitia@extremecode.io,325203,ES33209505222907029444,5037.33,2022-11-08T12:15:42,Gernika,expenses,children,-602.71,-24305.94
buyer_2,Aitxiber,Beitia,1984-09-05,35972942E,aitxiber.beitia@extremecode.io,325203,ES33209505222907029444,5037.33,2022-11-10T15:00:26,Gernika,expenses,healthcare,-168.86,-24474.8
buyer_2,Aitxiber,Beitia,1984-09-05,35972942E,aitxiber.beitia@extremecode.io,325203,ES33209505222907029444,5037.33,2022-11-10T17:07:53,Gernika,expenses,cash,-100.0,-24574.8
buyer_2,Aitxiber,Beitia,1984-09-05,35972942E,aitxiber.beitia@extremecode.io,325203,ES33209505222907029444,5037.33,2022-11-11T10:14:05,Gernika,expenses,leisure,-77.88,-24652.68
buyer_2,Aitxiber,Beitia,1984-09-05,35972942E,aitxiber.beitia@extremecode.io,325203,ES33209505222907029444,5037.33,2022-11-12T03:51:47,Gernika,expenses,transport,-45.56,-24698.24
buyer_2,Aitxiber,Beitia,1984-09-05,35972942E,aitxiber.beitia@extremecode.io,325203,ES33209505222907029444,5037.33,2022-11-13T12:58:15,Gernika,expenses,transport,-49.66,-24747.9
buyer_2,Aitxiber,Beitia,1984-09-05,35972942E,aitxiber.beitia@extremecode.io,325203,ES33209505222907029444,5037.33,2022-11-13T16:28:08,Gernika,expenses,cash,-100.0,-24847.9
buyer_2,Aitxiber,Beitia,1984-09-05,35972942E,aitxiber.beitia@extremecode.io,325203,ES33209505222907029444,5037.33,2022-11-13T13:31:42,Gernika,expenses,appliances,-316.36,-25164.26
buyer_2,Aitxiber,Beitia,1984-09-05,35972942E,aitxiber.beitia@extremecode.io,325203,ES33209505222907029444,5037.33,2022-11-16T20:41:16,Gernika,expenses,food,-106.34,-25270.6
buyer_2,Aitxiber,Beitia,1984-09-05,35972942E,aitxiber.beitia@extremecode.io,325203,ES33209505222907029444,5037.33,2022-11-16T12:31:12,Gernika,expenses,cash,-100.0,-25370.6
buyer_2,Aitxiber,Beitia,1984-09-05,35972942E,aitxiber.beitia@extremecode.io,325203,ES33209505222907029444,5037.33,2022-11-17T08:21:22,Gernika,expenses,food,-101.33,-25471.93
buyer_2,Aitxiber,Beitia,1984-09-05,35972942E,aitxiber.beitia@extremecode.io,325203,ES33209505222907029444,5037.33,2022-11-20T13:47:51,Gernika,expenses,transport,-74.61,-25546.54
buyer_2,Aitxiber,Beitia,1984-09-05,35972942E,aitxiber.beitia@extremecode.io,325203,ES33209505222907029444,5037.33,2022-11-20T15:10:40,Gernika,expenses,cash,-100.0,-25646.54
buyer_2,Aitxiber,Beitia,1984-09-05,35972942E,aitxiber.beitia@extremecode.io,325203,ES33209505222907029444,5037.33,2022-11-20T06:45:11,Gernika,expenses,children,-657.5070000000001,-26304.05
buyer_2,Aitxiber,Beitia,1984-09-05,35972942E,aitxiber.beitia@extremecode.io,325203,ES33209505222907029444,5037.33,2022-11-21T16:08:44,Gernika,expenses,clothing,-129.77,-26433.82
buyer_2,Aitxiber,Beitia,1984-09-05,35972942E,aitxiber.beitia@extremecode.io,325203,ES33209505222907029444,5037.33,2022-11-22T18:58:35,Gernika,expenses,clothing,-83.62,-26517.44
buyer_2,Aitxiber,Beitia,1984-09-05,35972942E,aitxiber.beitia@extremecode.io,325203,ES33209505222907029444,5037.33,2022-11-23T18:06:23,Gernika,expenses,healthcare,-151.9,-26669.34
buyer_2,Aitxiber,Beitia,1984-09-05,35972942E,aitxiber.beitia@extremecode.io,325203,ES33209505222907029444,5037.33,2022-11-24T21:51:59,Gernika,expenses,repairs,-81.55,-26750.89
buyer_2,Aitxiber,Beitia,1984-09-05,35972942E,aitxiber.beitia@extremecode.io,325203,ES33209505222907029444,5037.33,2022-11-26T12:08:25,Gernika,expenses,appliances,-251.74,-27002.63
buyer_2,Aitxiber,Beitia,1984-09-05,35972942E,aitxiber.beitia@extremecode.io,325203,ES33209505222907029444,5037.33,2022-11-27T17:13:40,Gernika,expenses,gifts,-750.26,-27752.89
buyer_2,Aitxiber,Beitia,1984-09-05,35972942E,aitxiber.beitia@extremecode.io,325203,ES33209505222907029444,5037.33,2022-11-29T23:22:57,Gernika,expenses,clothing,-110.72,-27863.61
buyer_2,Aitxiber,Beitia,1984-09-05,35972942E,aitxiber.beitia@extremecode.io,325203,ES33209505222907029444,5037.33,2022-11-29T16:41:51,Gernika,expenses,cash,-100.0,-27963.61
buyer_2,Aitxiber,Beitia,1984-09-05,35972942E,aitxiber.beitia@extremecode.io,325203,ES33209505222907029444,5037.33,2022-11-30T23:16:24,Gernika,expenses,food,-78.25,-28041.86
buyer_2,Aitxiber,Beitia,1984-09-05,35972942E,aitxiber.beitia@extremecode.io,325203,ES33209505222907029444,5037.33,2022-11-30T14:38:03,Gernika,expenses,cash,-100.0,-28141.86
buyer_2,Aitxiber,Beitia,1984-09-05,35972942E,aitxiber.beitia@extremecode.io,325203,ES33209505222907029444,5037.33,2022-11-30T20:53:06,Gernika,expenses,gifts,-121.07,-28262.93
buyer_2,Aitxiber,Beitia,1984-09-05,35972942E,aitxiber.beitia@extremecode.io,325203,ES33209505222907029444,5037.33,2022-12-01T17:13:05,Gernika,incomes,salary,1979.72,-26283.21
buyer_2,Aitxiber,Beitia,1984-09-05,35972942E,aitxiber.beitia@extremecode.io,325203,ES33209505222907029444,5037.33,2022-12-01T17:13:05,Gernika,incomes,salary_bonus,1410.43,-24872.78
buyer_2,Aitxiber,Beitia,1984-09-05,35972942E,aitxiber.beitia@extremecode.io,325203,ES33209505222907029444,5037.33,2022-12-01T04:57:52,Gernika,expenses,leisure,-79.41,-24952.19
buyer_2,Aitxiber,Beitia,1984-09-05,35972942E,aitxiber.beitia@extremecode.io,325203,ES33209505222907029444,5037.33,2022-12-01T14:23:43,Gernika,expenses,repairs,-284.51,-25236.7
buyer_2,Aitxiber,Beitia,1984-09-05,35972942E,aitxiber.beitia@extremecode.io,325203,ES33209505222907029444,5037.33,2022-12-02T10:36:32,Gernika,expenses,food,-94.44,-25331.14
buyer_2,Aitxiber,Beitia,1984-09-05,35972942E,aitxiber.beitia@extremecode.io,325203,ES33209505222907029444,5037.33,2022-12-03T15:31:39,Gernika,expenses,appliances,-268.62,-25599.76
buyer_2,Aitxiber,Beitia,1984-09-05,35972942E,aitxiber.beitia@extremecode.io,325203,ES33209505222907029444,5037.33,2022-12-04T17:14:23,Gernika,expenses,leisure,-35.32,-25635.08
buyer_2,Aitxiber,Beitia,1984-09-05,35972942E,aitxiber.beitia@extremecode.io,325203,ES33209505222907029444,5037.33,2022-12-04T09:19:58,Gernika,expenses,cash,-100.0,-25735.08
buyer_2,Aitxiber,Beitia,1984-09-05,35972942E,aitxiber.beitia@extremecode.io,325203,ES33209505222907029444,5037.33,2022-12-05T15:05:31,Gernika,expenses,mortgage,-836.66,-26571.74
buyer_2,Aitxiber,Beitia,1984-09-05,35972942E,aitxiber.beitia@extremecode.io,325203,ES33209505222907029444,5037.33,2022-12-05T11:43:13,Gernika,expenses,water,-30.93,-26602.67
buyer_2,Aitxiber,Beitia,1984-09-05,35972942E,aitxiber.beitia@extremecode.io,325203,ES33209505222907029444,5037.33,2022-12-05T09:46:05,Gernika,expenses,phone,-43.36,-26646.03
buyer_2,Aitxiber,Beitia,1984-09-05,35972942E,aitxiber.beitia@extremecode.io,325203,ES33209505222907029444,5037.33,2022-12-06T15:03:11,Gernika,expenses,electricity,-71.93,-26717.96
buyer_2,Aitxiber,Beitia,1984-09-05,35972942E,aitxiber.beitia@extremecode.io,325203,ES33209505222907029444,5037.33,2022-12-06T17:32:18,Gernika,expenses,cash,-100.0,-26817.96
buyer_2,Aitxiber,Beitia,1984-09-05,35972942E,aitxiber.beitia@extremecode.io,325203,ES33209505222907029444,5037.33,2022-12-07T23:30:08,Gernika,expenses,electricity,-55.79,-26873.75
buyer_2,Aitxiber,Beitia,1984-09-05,35972942E,aitxiber.beitia@extremecode.io,325203,ES33209505222907029444,5037.33,2022-12-07T14:58:27,Gernika,expenses,gas,-90.67,-26964.42
buyer_2,Aitxiber,Beitia,1984-09-05,35972942E,aitxiber.beitia@extremecode.io,325203,ES33209505222907029444,5037.33,2022-12-07T08:21:06,Gernika,expenses,food,-77.6,-27042.02
buyer_2,Aitxiber,Beitia,1984-09-05,35972942E,aitxiber.beitia@extremecode.io,325203,ES33209505222907029444,5037.33,2022-12-08T15:03:50,Gernika,expenses,water,-20.76,-27062.78
buyer_2,Aitxiber,Beitia,1984-09-05,35972942E,aitxiber.beitia@extremecode.io,325203,ES33209505222907029444,5037.33,2022-12-08T04:06:57,Gernika,expenses,transport,-43.9,-27106.68
buyer_2,Aitxiber,Beitia,1984-09-05,35972942E,aitxiber.beitia@extremecode.io,325203,ES33209505222907029444,5037.33,2022-12-08T11:10:05,Gernika,expenses,leisure,-73.63,-27180.31
buyer_2,Aitxiber,Beitia,1984-09-05,35972942E,aitxiber.beitia@extremecode.io,325203,ES33209505222907029444,5037.33,2022-12-09T10:15:41,Gernika,expenses,clothing,-154.14,-27334.45
buyer_2,Aitxiber,Beitia,1984-09-05,35972942E,aitxiber.beitia@extremecode.io,325203,ES33209505222907029444,5037.33,2022-12-09T15:44:56,Gernika,expenses,cash,-100.0,-27434.45
buyer_2,Aitxiber,Beitia,1984-09-05,35972942E,aitxiber.beitia@extremecode.io,325203,ES33209505222907029444,5037.33,2022-12-10T20:42:27,Gernika,expenses,leisure,-71.31,-27505.76
buyer_2,Aitxiber,Beitia,1984-09-05,35972942E,aitxiber.beitia@extremecode.io,325203,ES33209505222907029444,5037.33,2022-12-11T16:33:09,Gernika,expenses,children,-278.04,-27783.8
buyer_2,Aitxiber,Beitia,1984-09-05,35972942E,aitxiber.beitia@extremecode.io,325203,ES33209505222907029444,5037.33,2022-12-13T18:08:03,Gernika,expenses,food,-106.73,-27890.53
buyer_2,Aitxiber,Beitia,1984-09-05,35972942E,aitxiber.beitia@extremecode.io,325203,ES33209505222907029444,5037.33,2022-12-14T13:38:35,Gernika,expenses,gifts,-195.55,-28086.08
buyer_2,Aitxiber,Beitia,1984-09-05,35972942E,aitxiber.beitia@extremecode.io,325203,ES33209505222907029444,5037.33,2022-12-15T13:55:43,Gernika,expenses,leisure,-64.26,-28150.34
buyer_2,Aitxiber,Beitia,1984-09-05,35972942E,aitxiber.beitia@extremecode.io,325203,ES33209505222907029444,5037.33,2022-12-17T16:00:33,Gernika,expenses,food,-124.88,-28275.22
buyer_2,Aitxiber,Beitia,1984-09-05,35972942E,aitxiber.beitia@extremecode.io,325203,ES33209505222907029444,5037.33,2022-12-17T16:57:29,Gernika,expenses,cash,-100.0,-28375.22
buyer_2,Aitxiber,Beitia,1984-09-05,35972942E,aitxiber.beitia@extremecode.io,325203,ES33209505222907029444,5037.33,2022-12-17T14:56:13,Gernika,expenses,travel,-593.51,-28968.73
buyer_2,Aitxiber,Beitia,1984-09-05,35972942E,aitxiber.beitia@extremecode.io,325203,ES33209505222907029444,5037.33,2022-12-18T19:09:18,Gernika,expenses,transport,-85.77,-29054.5
buyer_2,Aitxiber,Beitia,1984-09-05,35972942E,aitxiber.beitia@extremecode.io,325203,ES33209505222907029444,5037.33,2022-12-19T13:19:45,Gernika,expenses,gifts,-602.56,-29657.06
buyer_2,Aitxiber,Beitia,1984-09-05,35972942E,aitxiber.beitia@extremecode.io,325203,ES33209505222907029444,5037.33,2022-12-20T06:52:44,Gernika,expenses,leisure,-35.07,-29692.13
buyer_2,Aitxiber,Beitia,1984-09-05,35972942E,aitxiber.beitia@extremecode.io,325203,ES33209505222907029444,5037.33,2022-12-21T11:18:51,Gernika,expenses,repairs,-128.81,-29820.94
buyer_2,Aitxiber,Beitia,1984-09-05,35972942E,aitxiber.beitia@extremecode.io,325203,ES33209505222907029444,5037.33,2022-12-24T03:01:58,Gernika,expenses,gifts,-77.32,-29898.26
buyer_2,Aitxiber,Beitia,1984-09-05,35972942E,aitxiber.beitia@extremecode.io,325203,ES33209505222907029444,5037.33,2022-12-25T17:14:28,Gernika,expenses,leisure,-53.26,-29951.52
buyer_2,Aitxiber,Beitia,1984-09-05,35972942E,aitxiber.beitia@extremecode.io,325203,ES33209505222907029444,5037.33,2022-12-25T15:26:27,Gernika,expenses,repairs,-331.62,-30283.14
buyer_2,Aitxiber,Beitia,1984-09-05,35972942E,aitxiber.beitia@extremecode.io,325203,ES33209505222907029444,5037.33,2022-12-27T13:24:07,Gernika,expenses,gifts,-395.98,-30679.12
buyer_2,Aitxiber,Beitia,1984-09-05,35972942E,aitxiber.beitia@extremecode.io,325203,ES33209505222907029444,5037.33,2022-12-28T14:27:15,Gernika,expenses,cash,-100.0,-30779.12
buyer_2,Aitxiber,Beitia,1984-09-05,35972942E,aitxiber.beitia@extremecode.io,325203,ES33209505222907029444,5037.33,2022-12-29T22:07:26,Gernika,expenses,food,-74.64,-30853.76
buyer_2,Aitxiber,Beitia,1984-09-05,35972942E,aitxiber.beitia@extremecode.io,325203,ES33209505222907029444,5037.33,2022-12-29T13:23:55,Gernika,expenses,gifts,-341.93,-31195.69
buyer_2,Aitxiber,Beitia,1984-09-05,35972942E,aitxiber.beitia@extremecode.io,325203,ES33209505222907029444,5037.33,2022-12-30T14:43:49,Gernika,expenses,cash,-100.0,-31295.69
buyer_2,Aitxiber,Beitia,1984-09-05,35972942E,aitxiber.beitia@extremecode.io,325203,ES33209505222907029444,5037.33,2023-01-01T13:53:35,Gernika,incomes,salary,2028.34,-29267.35
buyer_2,Aitxiber,Beitia,1984-09-05,35972942E,aitxiber.beitia@extremecode.io,325203,ES33209505222907029444,5037.33,2023-01-01T13:53:35,Gernika,incomes,extra_income,380.33,-28887.02
buyer_2,Aitxiber,Beitia,1984-09-05,35972942E,aitxiber.beitia@extremecode.io,325203,ES33209505222907029444,5037.33,2023-01-02T14:29:08,Gernika,expenses,food,-114.05,-29001.07
buyer_2,Aitxiber,Beitia,1984-09-05,35972942E,aitxiber.beitia@extremecode.io,325203,ES33209505222907029444,5037.33,2023-01-02T10:52:18,Gernika,expenses,cash,-100.0,-29101.07
buyer_2,Aitxiber,Beitia,1984-09-05,35972942E,aitxiber.beitia@extremecode.io,325203,ES33209505222907029444,5037.33,2023-01-03T15:42:41,Gernika,expenses,cash,-100.0,-29201.07
buyer_2,Aitxiber,Beitia,1984-09-05,35972942E,aitxiber.beitia@extremecode.io,325203,ES33209505222907029444,5037.33,2023-01-04T20:56:21,Gernika,expenses,food,-104.31,-29305.38
buyer_2,Aitxiber,Beitia,1984-09-05,35972942E,aitxiber.beitia@extremecode.io,325203,ES33209505222907029444,5037.33,2023-01-05T12:05:09,Gernika,expenses,mortgage,-1007.54,-30312.92
buyer_2,Aitxiber,Beitia,1984-09-05,35972942E,aitxiber.beitia@extremecode.io,325203,ES33209505222907029444,5037.33,2023-01-05T15:25:15,Gernika,expenses,phone,-31.58,-30344.5
buyer_2,Aitxiber,Beitia,1984-09-05,35972942E,aitxiber.beitia@extremecode.io,325203,ES33209505222907029444,5037.33,2023-01-05T15:36:12,Gernika,expenses,cash,-100.0,-30444.5
buyer_2,Aitxiber,Beitia,1984-09-05,35972942E,aitxiber.beitia@extremecode.io,325203,ES33209505222907029444,5037.33,2023-01-06T14:32:56,Gernika,expenses,gas,-106.49,-30550.99
buyer_2,Aitxiber,Beitia,1984-09-05,35972942E,aitxiber.beitia@extremecode.io,325203,ES33209505222907029444,5037.33,2023-01-07T00:46:31,Gernika,expenses,water,-25.81,-30576.8
buyer_2,Aitxiber,Beitia,1984-09-05,35972942E,aitxiber.beitia@extremecode.io,325203,ES33209505222907029444,5037.33,2023-01-07T01:56:44,Gernika,expenses,transport,-56.87,-30633.67
buyer_2,Aitxiber,Beitia,1984-09-05,35972942E,aitxiber.beitia@extremecode.io,325203,ES33209505222907029444,5037.33,2023-01-07T05:26:17,Gernika,expenses,clothing,-95.06,-30728.73
buyer_2,Aitxiber,Beitia,1984-09-05,35972942E,aitxiber.beitia@extremecode.io,325203,ES33209505222907029444,5037.33,2023-01-07T08:17:30,Gernika,expenses,appliances,-396.84,-31125.57
buyer_2,Aitxiber,Beitia,1984-09-05,35972942E,aitxiber.beitia@extremecode.io,325203,ES33209505222907029444,5037.33,2023-01-08T08:40:40,Gernika,expenses,cash,-100.0,-31225.57
buyer_2,Aitxiber,Beitia,1984-09-05,35972942E,aitxiber.beitia@extremecode.io,325203,ES33209505222907029444,5037.33,2023-01-15T01:41:19,Gernika,expenses,leisure,-50.24,-31275.81
buyer_2,Aitxiber,Beitia,1984-09-05,35972942E,aitxiber.beitia@extremecode.io,325203,ES33209505222907029444,5037.33,2023-01-17T12:58:05,Gernika,expenses,transport,-52.38,-31328.19
buyer_2,Aitxiber,Beitia,1984-09-05,35972942E,aitxiber.beitia@extremecode.io,325203,ES33209505222907029444,5037.33,2023-01-18T09:03:33,Gernika,expenses,transport,-58.58,-31386.77
buyer_2,Aitxiber,Beitia,1984-09-05,35972942E,aitxiber.beitia@extremecode.io,325203,ES33209505222907029444,5037.33,2023-01-18T22:57:41,Gernika,expenses,cash,-100.0,-31486.77
buyer_2,Aitxiber,Beitia,1984-09-05,35972942E,aitxiber.beitia@extremecode.io,325203,ES33209505222907029444,5037.33,2023-01-18T18:51:44,Gernika,expenses,children,-486.4453333333335,-31973.22
buyer_2,Aitxiber,Beitia,1984-09-05,35972942E,aitxiber.beitia@extremecode.io,325203,ES33209505222907029444,5037.33,2023-01-21T14:50:14,Gernika,expenses,transport,-70.64,-32043.86
buyer_2,Aitxiber,Beitia,1984-09-05,35972942E,aitxiber.beitia@extremecode.io,325203,ES33209505222907029444,5037.33,2023-01-21T08:18:41,Gernika,expenses,leisure,-51.08,-32094.94
buyer_2,Aitxiber,Beitia,1984-09-05,35972942E,aitxiber.beitia@extremecode.io,325203,ES33209505222907029444,5037.33,2023-01-22T08:26:40,Gernika,expenses,leisure,-53.71,-32148.65
buyer_2,Aitxiber,Beitia,1984-09-05,35972942E,aitxiber.beitia@extremecode.io,325203,ES33209505222907029444,5037.33,2023-01-24T08:33:06,Gernika,expenses,cash,-100.0,-32248.65
buyer_2,Aitxiber,Beitia,1984-09-05,35972942E,aitxiber.beitia@extremecode.io,325203,ES33209505222907029444,5037.33,2023-01-25T14:40:18,Gernika,expenses,cash,-100.0,-32348.65
buyer_2,Aitxiber,Beitia,1984-09-05,35972942E,aitxiber.beitia@extremecode.io,325203,ES33209505222907029444,5037.33,2023-01-25T03:32:19,Gernika,expenses,repairs,-251.18,-32599.83
buyer_2,Aitxiber,Beitia,1984-09-05,35972942E,aitxiber.beitia@extremecode.io,325203,ES33209505222907029444,5037.33,2023-01-28T16:35:47,Gernika,expenses,transport,-74.8,-32674.63
buyer_2,Aitxiber,Beitia,1984-09-05,35972942E,aitxiber.beitia@extremecode.io,325203,ES33209505222907029444,5037.33,2023-01-29T09:03:16,Gernika,expenses,cash,-100.0,-32774.63
buyer_2,Aitxiber,Beitia,1984-09-05,35972942E,aitxiber.beitia@extremecode.io,325203,ES33209505222907029444,5037.33,2023-01-30T13:31:29,Gernika,expenses,transport,-51.92,-32826.55
buyer_2,Aitxiber,Beitia,1984-09-05,35972942E,aitxiber.beitia@extremecode.io,325203,ES33209505222907029444,5037.33,2023-01-30T12:48:37,Gernika,expenses,leisure,-71.41,-32897.96
buyer_2,Aitxiber,Beitia,1984-09-05,35972942E,aitxiber.beitia@extremecode.io,325203,ES33209505222907029444,5037.33,2023-01-30T17:49:03,Gernika,expenses,healthcare,-106.57,-33004.53
buyer_2,Aitxiber,Beitia,1984-09-05,35972942E,aitxiber.beitia@extremecode.io,325203,ES33209505222907029444,5037.33,2023-01-30T16:44:18,Gernika,expenses,gifts,-174.76,-33179.29
buyer_2,Aitxiber,Beitia,1984-09-05,35972942E,aitxiber.beitia@extremecode.io,325203,ES33209505222907029444,5037.33,2023-01-31T19:51:40,Gernika,expenses,transport,-75.74,-33255.03
buyer_2,Aitxiber,Beitia,1984-09-05,35972942E,aitxiber.beitia@extremecode.io,325203,ES33209505222907029444,5037.33,2023-01-31T11:02:12,Gernika,expenses,cash,-100.0,-33355.03
buyer_2,Aitxiber,Beitia,1984-09-05,35972942E,aitxiber.beitia@extremecode.io,325203,ES33209505222907029444,5037.33,2023-02-01T08:53:52,Gernika,incomes,salary,2028.34,-31326.69
buyer_2,Aitxiber,Beitia,1984-09-05,35972942E,aitxiber.beitia@extremecode.io,325203,ES33209505222907029444,5037.33,2023-02-05T18:15:30,Gernika,expenses,mortgage,-1007.54,-32334.23
buyer_2,Aitxiber,Beitia,1984-09-05,35972942E,aitxiber.beitia@extremecode.io,325203,ES33209505222907029444,5037.33,2023-02-06T17:43:23,Gernika,expenses,water,-38.06,-32372.29
buyer_2,Aitxiber,Beitia,1984-09-05,35972942E,aitxiber.beitia@extremecode.io,325203,ES33209505222907029444,5037.33,2023-02-06T17:29:03,Gernika,expenses,electricity,-21.19,-32393.48
buyer_2,Aitxiber,Beitia,1984-09-05,35972942E,aitxiber.beitia@extremecode.io,325203,ES33209505222907029444,5037.33,2023-02-06T18:46:39,Gernika,expenses,education,-78.1,-32471.58
buyer_2,Aitxiber,Beitia,1984-09-05,35972942E,aitxiber.beitia@extremecode.io,325203,ES33209505222907029444,5037.33,2023-02-06T08:30:16,Gernika,expenses,travel,-377.27,-32848.85
buyer_2,Aitxiber,Beitia,1984-09-05,35972942E,aitxiber.beitia@extremecode.io,325203,ES33209505222907029444,5037.33,2023-02-07T15:46:51,Gernika,expenses,repairs,-100.39,-32949.24
buyer_2,Aitxiber,Beitia,1984-09-05,35972942E,aitxiber.beitia@extremecode.io,325203,ES33209505222907029444,5037.33,2023-02-08T11:29:47,Gernika,expenses,phone,-37.89,-32987.13
buyer_2,Aitxiber,Beitia,1984-09-05,35972942E,aitxiber.beitia@extremecode.io,325203,ES33209505222907029444,5037.33,2023-02-08T05:33:41,Gernika,expenses,cash,-100.0,-33087.13
buyer_2,Aitxiber,Beitia,1984-09-05,35972942E,aitxiber.beitia@extremecode.io,325203,ES33209505222907029444,5037.33,2023-02-10T12:21:39,Gernika,expenses,leisure,-42.89,-33130.02
buyer_2,Aitxiber,Beitia,1984-09-05,35972942E,aitxiber.beitia@extremecode.io,325203,ES33209505222907029444,5037.33,2023-02-11T17:46:08,Gernika,expenses,food,-62.14,-33192.16
buyer_2,Aitxiber,Beitia,1984-09-05,35972942E,aitxiber.beitia@extremecode.io,325203,ES33209505222907029444,5037.33,2023-02-11T09:32:51,Gernika,expenses,children,-179.09,-33371.25
buyer_2,Aitxiber,Beitia,1984-09-05,35972942E,aitxiber.beitia@extremecode.io,325203,ES33209505222907029444,5037.33,2023-02-15T10:51:54,Gernika,expenses,food,-75.76,-33447.01
buyer_2,Aitxiber,Beitia,1984-09-05,35972942E,aitxiber.beitia@extremecode.io,325203,ES33209505222907029444,5037.33,2023-02-15T08:21:51,Gernika,expenses,transport,-71.03,-33518.04
buyer_2,Aitxiber,Beitia,1984-09-05,35972942E,aitxiber.beitia@extremecode.io,325203,ES33209505222907029444,5037.33,2023-02-15T18:16:20,Gernika,expenses,leisure,-64.26,-33582.3
buyer_2,Aitxiber,Beitia,1984-09-05,35972942E,aitxiber.beitia@extremecode.io,325203,ES33209505222907029444,5037.33,2023-02-15T04:59:56,Gernika,expenses,clothing,-136.4,-33718.7
buyer_2,Aitxiber,Beitia,1984-09-05,35972942E,aitxiber.beitia@extremecode.io,325203,ES33209505222907029444,5037.33,2023-02-16T09:33:53,Gernika,expenses,transport,-82.64,-33801.34
buyer_2,Aitxiber,Beitia,1984-09-05,35972942E,aitxiber.beitia@extremecode.io,325203,ES33209505222907029444,5037.33,2023-02-16T13:58:28,Gernika,expenses,clothing,-108.79,-33910.13
buyer_2,Aitxiber,Beitia,1984-09-05,35972942E,aitxiber.beitia@extremecode.io,325203,ES33209505222907029444,5037.33,2023-02-16T18:33:45,Gernika,expenses,appliances,-207.16,-34117.29
buyer_2,Aitxiber,Beitia,1984-09-05,35972942E,aitxiber.beitia@extremecode.io,325203,ES33209505222907029444,5037.33,2023-02-18T22:33:46,Gernika,expenses,repairs,-294.09,-34411.38
buyer_2,Aitxiber,Beitia,1984-09-05,35972942E,aitxiber.beitia@extremecode.io,325203,ES33209505222907029444,5037.33,2023-02-19T12:52:42,Gernika,expenses,leisure,-62.26,-34473.64
buyer_2,Aitxiber,Beitia,1984-09-05,35972942E,aitxiber.beitia@extremecode.io,325203,ES33209505222907029444,5037.33,2023-02-19T21:26:03,Gernika,expenses,cash,-100.0,-34573.64
buyer_2,Aitxiber,Beitia,1984-09-05,35972942E,aitxiber.beitia@extremecode.io,325203,ES33209505222907029444,5037.33,2023-02-20T15:54:16,Gernika,expenses,education,-75.14,-34648.78
buyer_2,Aitxiber,Beitia,1984-09-05,35972942E,aitxiber.beitia@extremecode.io,325203,ES33209505222907029444,5037.33,2023-02-20T23:13:31,Gernika,expenses,gifts,-492.44,-35141.22
buyer_2,Aitxiber,Beitia,1984-09-05,35972942E,aitxiber.beitia@extremecode.io,325203,ES33209505222907029444,5037.33,2023-02-23T16:48:35,Gernika,expenses,transport,-87.86,-35229.08
buyer_2,Aitxiber,Beitia,1984-09-05,35972942E,aitxiber.beitia@extremecode.io,325203,ES33209505222907029444,5037.33,2023-02-24T17:37:50,Gernika,expenses,cash,-100.0,-35329.08
buyer_2,Aitxiber,Beitia,1984-09-05,35972942E,aitxiber.beitia@extremecode.io,325203,ES33209505222907029444,5037.33,2023-02-27T17:51:31,Gernika,expenses,leisure,-49.16,-35378.24
buyer_2,Aitxiber,Beitia,1984-09-05,35972942E,aitxiber.beitia@extremecode.io,325203,ES33209505222907029444,5037.33,2023-02-28T12:09:54,Gernika,expenses,appliances,-416.55,-35794.79
buyer_2,Aitxiber,Beitia,1984-09-05,35972942E,aitxiber.beitia@extremecode.io,325203,ES33209505222907029444,5037.33,2023-03-01T17:50:50,Gernika,incomes,salary,2028.34,-33766.45
buyer_2,Aitxiber,Beitia,1984-09-05,35972942E,aitxiber.beitia@extremecode.io,325203,ES33209505222907029444,5037.33,2023-03-01T23:56:40,Gernika,expenses,food,-102.31,-33868.76
buyer_2,Aitxiber,Beitia,1984-09-05,35972942E,aitxiber.beitia@extremecode.io,325203,ES33209505222907029444,5037.33,2023-03-01T20:10:23,Gernika,expenses,leisure,-39.13,-33907.89
buyer_2,Aitxiber,Beitia,1984-09-05,35972942E,aitxiber.beitia@extremecode.io,325203,ES33209505222907029444,5037.33,2023-03-02T18:53:17,Gernika,expenses,clothing,-159.67,-34067.56
buyer_2,Aitxiber,Beitia,1984-09-05,35972942E,aitxiber.beitia@extremecode.io,325203,ES33209505222907029444,5037.33,2023-03-03T12:22:59,Gernika,expenses,leisure,-50.78,-34118.34
buyer_2,Aitxiber,Beitia,1984-09-05,35972942E,aitxiber.beitia@extremecode.io,325203,ES33209505222907029444,5037.33,2023-03-03T09:22:48,Gernika,expenses,clothing,-112.08,-34230.42
buyer_2,Aitxiber,Beitia,1984-09-05,35972942E,aitxiber.beitia@extremecode.io,325203,ES33209505222907029444,5037.33,2023-03-04T18:58:25,Gernika,expenses,cash,-100.0,-34330.42
buyer_2,Aitxiber,Beitia,1984-09-05,35972942E,aitxiber.beitia@extremecode.io,325203,ES33209505222907029444,5037.33,2023-03-04T16:08:40,Gernika,expenses,repairs,-224.25,-34554.67
buyer_2,Aitxiber,Beitia,1984-09-05,35972942E,aitxiber.beitia@extremecode.io,325203,ES33209505222907029444,5037.33,2023-03-05T16:29:01,Gernika,expenses,mortgage,-1007.54,-35562.21
buyer_2,Aitxiber,Beitia,1984-09-05,35972942E,aitxiber.beitia@extremecode.io,325203,ES33209505222907029444,5037.33,2023-03-05T18:11:46,Gernika,expenses,water,-37.7,-35599.91
buyer_2,Aitxiber,Beitia,1984-09-05,35972942E,aitxiber.beitia@extremecode.io,325203,ES33209505222907029444,5037.33,2023-03-05T02:29:03,Gernika,expenses,appliances,-151.0,-35750.91
buyer_2,Aitxiber,Beitia,1984-09-05,35972942E,aitxiber.beitia@extremecode.io,325203,ES33209505222907029444,5037.33,2023-03-06T17:47:15,Gernika,expenses,water,-36.32,-35787.23
buyer_2,Aitxiber,Beitia,1984-09-05,35972942E,aitxiber.beitia@extremecode.io,325203,ES33209505222907029444,5037.33,2023-03-07T11:09:42,Gernika,expenses,electricity,-77.71,-35864.94
buyer_2,Aitxiber,Beitia,1984-09-05,35972942E,aitxiber.beitia@extremecode.io,325203,ES33209505222907029444,5037.33,2023-03-07T21:44:28,Gernika,expenses,gas,-35.79,-35900.73
buyer_2,Aitxiber,Beitia,1984-09-05,35972942E,aitxiber.beitia@extremecode.io,325203,ES33209505222907029444,5037.33,2023-03-07T17:23:34,Gernika,expenses,internet,-42.6,-35943.33
buyer_2,Aitxiber,Beitia,1984-09-05,35972942E,aitxiber.beitia@extremecode.io,325203,ES33209505222907029444,5037.33,2023-03-07T10:31:46,Gernika,expenses,phone,-37.71,-35981.04
buyer_2,Aitxiber,Beitia,1984-09-05,35972942E,aitxiber.beitia@extremecode.io,325203,ES33209505222907029444,5037.33,2023-03-07T23:30:58,Gernika,expenses,food,-68.42,-36049.46
buyer_2,Aitxiber,Beitia,1984-09-05,35972942E,aitxiber.beitia@extremecode.io,325203,ES33209505222907029444,5037.33,2023-03-08T12:31:57,Gernika,expenses,internet,-42.6,-36092.06
buyer_2,Aitxiber,Beitia,1984-09-05,35972942E,aitxiber.beitia@extremecode.io,325203,ES33209505222907029444,5037.33,2023-03-08T13:00:47,Gernika,expenses,phone,-37.69,-36129.75
buyer_2,Aitxiber,Beitia,1984-09-05,35972942E,aitxiber.beitia@extremecode.io,325203,ES33209505222907029444,5037.33,2023-03-08T17:15:13,Gernika,expenses,children,-230.49,-36360.24
buyer_2,Aitxiber,Beitia,1984-09-05,35972942E,aitxiber.beitia@extremecode.io,325203,ES33209505222907029444,5037.33,2023-03-10T21:14:03,Gernika,expenses,transport,-72.42,-36432.66
buyer_2,Aitxiber,Beitia,1984-09-05,35972942E,aitxiber.beitia@extremecode.io,325203,ES33209505222907029444,5037.33,2023-03-10T10:22:02,Gernika,expenses,leisure,-19.18,-36451.84
buyer_2,Aitxiber,Beitia,1984-09-05,35972942E,aitxiber.beitia@extremecode.io,325203,ES33209505222907029444,5037.33,2023-03-12T14:27:14,Gernika,expenses,transport,-89.12,-36540.96
buyer_2,Aitxiber,Beitia,1984-09-05,35972942E,aitxiber.beitia@extremecode.io,325203,ES33209505222907029444,5037.33,2023-03-12T14:25:19,Gernika,expenses,leisure,-73.35,-36614.31
buyer_2,Aitxiber,Beitia,1984-09-05,35972942E,aitxiber.beitia@extremecode.io,325203,ES33209505222907029444,5037.33,2023-03-14T16:38:21,Gernika,expenses,transport,-48.84,-36663.15
buyer_2,Aitxiber,Beitia,1984-09-05,35972942E,aitxiber.beitia@extremecode.io,325203,ES33209505222907029444,5037.33,2023-03-16T22:57:04,Gernika,expenses,repairs,-31.43,-36694.58
buyer_2,Aitxiber,Beitia,1984-09-05,35972942E,aitxiber.beitia@extremecode.io,325203,ES33209505222907029444,5037.33,2023-03-19T13:09:48,Gernika,expenses,transport,-69.6,-36764.18
buyer_2,Aitxiber,Beitia,1984-09-05,35972942E,aitxiber.beitia@extremecode.io,325203,ES33209505222907029444,5037.33,2023-03-20T16:55:41,Gernika,expenses,leisure,-37.98,-36802.16
buyer_2,Aitxiber,Beitia,1984-09-05,35972942E,aitxiber.beitia@extremecode.io,325203,ES33209505222907029444,5037.33,2023-03-22T22:29:37,Gernika,expenses,transport,-83.77,-36885.93
buyer_2,Aitxiber,Beitia,1984-09-05,35972942E,aitxiber.beitia@extremecode.io,325203,ES33209505222907029444,5037.33,2023-03-25T20:13:02,Gernika,expenses,food,-83.02,-36968.95
buyer_2,Aitxiber,Beitia,1984-09-05,35972942E,aitxiber.beitia@extremecode.io,325203,ES33209505222907029444,5037.33,2023-03-26T03:48:23,Gernika,expenses,cash,-100.0,-37068.95
buyer_2,Aitxiber,Beitia,1984-09-05,35972942E,aitxiber.beitia@extremecode.io,325203,ES33209505222907029444,5037.33,2023-03-29T12:04:58,Gernika,expenses,transport,-89.41,-37158.36
buyer_2,Aitxiber,Beitia,1984-09-05,35972942E,aitxiber.beitia@extremecode.io,325203,ES33209505222907029444,5037.33,2023-03-29T22:46:54,Gernika,expenses,cash,-100.0,-37258.36
buyer_2,Aitxiber,Beitia,1984-09-05,35972942E,aitxiber.beitia@extremecode.io,325203,ES33209505222907029444,5037.33,2023-03-30T14:27:21,Gernika,expenses,cash,-100.0,-37358.36
buyer_2,Aitxiber,Beitia,1984-09-05,35972942E,aitxiber.beitia@extremecode.io,325203,ES33209505222907029444,5037.33,2023-03-30T10:56:13,Gernika,expenses,travel,-394.05,-37752.41
buyer_2,Aitxiber,Beitia,1984-09-05,35972942E,aitxiber.beitia@extremecode.io,325203,ES33209505222907029444,5037.33,2023-03-31T15:25:48,Gernika,expenses,repairs,-228.67,-37981.08
buyer_2,Aitxiber,Beitia,1984-09-05,35972942E,aitxiber.beitia@extremecode.io,325203,ES33209505222907029444,5037.33,2023-04-01T09:30:01,Gernika,incomes,salary,2028.34,-35952.74
buyer_2,Aitxiber,Beitia,1984-09-05,35972942E,aitxiber.beitia@extremecode.io,325203,ES33209505222907029444,5037.33,2023-04-01T09:30:01,Gernika,incomes,extra_income,380.33,-35572.41
buyer_2,Aitxiber,Beitia,1984-09-05,35972942E,aitxiber.beitia@extremecode.io,325203,ES33209505222907029444,5037.33,2023-04-03T14:55:47,Gernika,expenses,food,-116.99,-35689.4
buyer_2,Aitxiber,Beitia,1984-09-05,35972942E,aitxiber.beitia@extremecode.io,325203,ES33209505222907029444,5037.33,2023-04-03T10:03:02,Gernika,expenses,cash,-100.0,-35789.4
buyer_2,Aitxiber,Beitia,1984-09-05,35972942E,aitxiber.beitia@extremecode.io,325203,ES33209505222907029444,5037.33,2023-04-03T21:38:09,Gernika,expenses,travel,-382.17,-36171.57
buyer_2,Aitxiber,Beitia,1984-09-05,35972942E,aitxiber.beitia@extremecode.io,325203,ES33209505222907029444,5037.33,2023-04-04T14:31:53,Gernika,expenses,transport,-80.74,-36252.31
buyer_2,Aitxiber,Beitia,1984-09-05,35972942E,aitxiber.beitia@extremecode.io,325203,ES33209505222907029444,5037.33,2023-04-04T20:03:30,Gernika,expenses,gifts,-509.72,-36762.03
buyer_2,Aitxiber,Beitia,1984-09-05,35972942E,aitxiber.beitia@extremecode.io,325203,ES33209505222907029444,5037.33,2023-04-05T08:28:44,Gernika,expenses,mortgage,-1007.54,-37769.57
buyer_2,Aitxiber,Beitia,1984-09-05,35972942E,aitxiber.beitia@extremecode.io,325203,ES33209505222907029444,5037.33,2023-04-05T10:48:48,Gernika,expenses,gas,-75.99,-37845.56
buyer_2,Aitxiber,Beitia,1984-09-05,35972942E,aitxiber.beitia@extremecode.io,325203,ES33209505222907029444,5037.33,2023-04-05T13:33:57,Gernika,expenses,phone,-42.04,-37887.6
buyer_2,Aitxiber,Beitia,1984-09-05,35972942E,aitxiber.beitia@extremecode.io,325203,ES33209505222907029444,5037.33,2023-04-05T16:21:47,Gernika,expenses,repairs,-259.69,-38147.29
buyer_2,Aitxiber,Beitia,1984-09-05,35972942E,aitxiber.beitia@extremecode.io,325203,ES33209505222907029444,5037.33,2023-04-05T16:07:54,Gernika,expenses,gifts,-200.23,-38347.52
buyer_2,Aitxiber,Beitia,1984-09-05,35972942E,aitxiber.beitia@extremecode.io,325203,ES33209505222907029444,5037.33,2023-04-09T17:57:44,Gernika,expenses,transport,-87.57,-38435.09
buyer_2,Aitxiber,Beitia,1984-09-05,35972942E,aitxiber.beitia@extremecode.io,325203,ES33209505222907029444,5037.33,2023-04-09T13:02:39,Gernika,expenses,leisure,-66.07,-38501.16
buyer_2,Aitxiber,Beitia,1984-09-05,35972942E,aitxiber.beitia@extremecode.io,325203,ES33209505222907029444,5037.33,2023-04-09T20:59:49,Gernika,expenses,cash,-100.0,-38601.16
buyer_2,Aitxiber,Beitia,1984-09-05,35972942E,aitxiber.beitia@extremecode.io,325203,ES33209505222907029444,5037.33,2023-04-12T18:33:51,Gernika,expenses,food,-108.33,-38709.49
buyer_2,Aitxiber,Beitia,1984-09-05,35972942E,aitxiber.beitia@extremecode.io,325203,ES33209505222907029444,5037.33,2023-04-12T08:13:54,Gernika,expenses,cash,-100.0,-38809.49
buyer_2,Aitxiber,Beitia,1984-09-05,35972942E,aitxiber.beitia@extremecode.io,325203,ES33209505222907029444,5037.33,2023-04-14T11:24:45,Gernika,expenses,food,-108.22,-38917.71
buyer_2,Aitxiber,Beitia,1984-09-05,35972942E,aitxiber.beitia@extremecode.io,325203,ES33209505222907029444,5037.33,2023-04-14T10:44:03,Gernika,expenses,gifts,-121.36,-39039.07
buyer_2,Aitxiber,Beitia,1984-09-05,35972942E,aitxiber.beitia@extremecode.io,325203,ES33209505222907029444,5037.33,2023-04-17T14:13:31,Gernika,expenses,food,-97.32,-39136.39
buyer_2,Aitxiber,Beitia,1984-09-05,35972942E,aitxiber.beitia@extremecode.io,325203,ES33209505222907029444,5037.33,2023-04-19T20:11:36,Gernika,expenses,leisure,-22.38,-39158.77
buyer_2,Aitxiber,Beitia,1984-09-05,35972942E,aitxiber.beitia@extremecode.io,325203,ES33209505222907029444,5037.33,2023-04-21T18:29:12,Gernika,expenses,clothing,-107.0,-39265.77
buyer_2,Aitxiber,Beitia,1984-09-05,35972942E,aitxiber.beitia@extremecode.io,325203,ES33209505222907029444,5037.33,2023-04-22T14:28:05,Gernika,expenses,appliances,-141.91,-39407.68
buyer_2,Aitxiber,Beitia,1984-09-05,35972942E,aitxiber.beitia@extremecode.io,325203,ES33209505222907029444,5037.33,2023-04-23T13:26:07,Gernika,expenses,food,-98.12,-39505.8
buyer_2,Aitxiber,Beitia,1984-09-05,35972942E,aitxiber.beitia@extremecode.io,325203,ES33209505222907029444,5037.33,2023-04-23T12:14:54,Gernika,expenses,cash,-100.0,-39605.8
buyer_2,Aitxiber,Beitia,1984-09-05,35972942E,aitxiber.beitia@extremecode.io,325203,ES33209505222907029444,5037.33,2023-04-25T19:56:15,Gernika,expenses,leisure,-72.53,-39678.33
buyer_2,Aitxiber,Beitia,1984-09-05,35972942E,aitxiber.beitia@extremecode.io,325203,ES33209505222907029444,5037.33,2023-04-25T08:07:38,Gernika,expenses,repairs,-199.51,-39877.84
buyer_2,Aitxiber,Beitia,1984-09-05,35972942E,aitxiber.beitia@extremecode.io,325203,ES33209505222907029444,5037.33,2023-04-26T22:07:25,Gernika,expenses,cash,-100.0,-39977.84
buyer_2,Aitxiber,Beitia,1984-09-05,35972942E,aitxiber.beitia@extremecode.io,325203,ES33209505222907029444,5037.33,2023-04-28T16:10:35,Gernika,expenses,cash,-100.0,-40077.84
buyer_2,Aitxiber,Beitia,1984-09-05,35972942E,aitxiber.beitia@extremecode.io,325203,ES33209505222907029444,5037.33,2023-04-30T11:34:42,Gernika,expenses,gifts,-260.78,-40338.62
buyer_2,Aitxiber,Beitia,1984-09-05,35972942E,aitxiber.beitia@extremecode.io,325203,ES33209505222907029444,5037.33,2023-05-01T18:41:54,Gernika,incomes,salary,2028.34,-38310.28
buyer_2,Aitxiber,Beitia,1984-09-05,35972942E,aitxiber.beitia@extremecode.io,325203,ES33209505222907029444,5037.33,2023-05-01T11:31:08,Gernika,expenses,cash,-100.0,-38410.28
buyer_2,Aitxiber,Beitia,1984-09-05,35972942E,aitxiber.beitia@extremecode.io,325203,ES33209505222907029444,5037.33,2023-05-03T13:21:19,Gernika,expenses,cash,-100.0,-38510.28
buyer_2,Aitxiber,Beitia,1984-09-05,35972942E,aitxiber.beitia@extremecode.io,325203,ES33209505222907029444,5037.33,2023-05-03T12:14:31,Gernika,expenses,travel,-457.55,-38967.83
buyer_2,Aitxiber,Beitia,1984-09-05,35972942E,aitxiber.beitia@extremecode.io,325203,ES33209505222907029444,5037.33,2023-05-05T13:22:41,Gernika,expenses,mortgage,-1007.54,-39975.37
buyer_2,Aitxiber,Beitia,1984-09-05,35972942E,aitxiber.beitia@extremecode.io,325203,ES33209505222907029444,5037.33,2023-05-06T14:37:15,Gernika,expenses,water,-24.89,-40000.26
buyer_2,Aitxiber,Beitia,1984-09-05,35972942E,aitxiber.beitia@extremecode.io,325203,ES33209505222907029444,5037.33,2023-05-06T14:00:49,Gernika,expenses,appliances,-350.58,-40350.84
buyer_2,Aitxiber,Beitia,1984-09-05,35972942E,aitxiber.beitia@extremecode.io,325203,ES33209505222907029444,5037.33,2023-05-07T15:58:22,Gernika,expenses,water,-34.96,-40385.8
buyer_2,Aitxiber,Beitia,1984-09-05,35972942E,aitxiber.beitia@extremecode.io,325203,ES33209505222907029444,5037.33,2023-05-08T15:02:38,Gernika,expenses,gas,-93.91,-40479.71
buyer_2,Aitxiber,Beitia,1984-09-05,35972942E,aitxiber.beitia@extremecode.io,325203,ES33209505222907029444,5037.33,2023-05-08T19:19:32,Gernika,expenses,phone,-32.55,-40512.26
buyer_2,Aitxiber,Beitia,1984-09-05,35972942E,aitxiber.beitia@extremecode.io,325203,ES33209505222907029444,5037.33,2023-05-08T15:19:44,Gernika,expenses,education,-50.1,-40562.36
buyer_2,Aitxiber,Beitia,1984-09-05,35972942E,aitxiber.beitia@extremecode.io,325203,ES33209505222907029444,5037.33,2023-05-09T12:32:28,Gernika,expenses,food,-113.29,-40675.65
buyer_2,Aitxiber,Beitia,1984-09-05,35972942E,aitxiber.beitia@extremecode.io,325203,ES33209505222907029444,5037.33,2023-05-09T13:56:51,Gernika,expenses,transport,-75.73,-40751.38
buyer_2,Aitxiber,Beitia,1984-09-05,35972942E,aitxiber.beitia@extremecode.io,325203,ES33209505222907029444,5037.33,2023-05-10T13:03:40,Gernika,expenses,leisure,-61.61,-40812.99
buyer_2,Aitxiber,Beitia,1984-09-05,35972942E,aitxiber.beitia@extremecode.io,325203,ES33209505222907029444,5037.33,2023-05-11T10:26:30,Gernika,expenses,food,-88.97,-40901.96
buyer_2,Aitxiber,Beitia,1984-09-05,35972942E,aitxiber.beitia@extremecode.io,325203,ES33209505222907029444,5037.33,2023-05-11T16:17:03,Gernika,expenses,transport,-46.47,-40948.43
buyer_2,Aitxiber,Beitia,1984-09-05,35972942E,aitxiber.beitia@extremecode.io,325203,ES33209505222907029444,5037.33,2023-05-11T10:53:59,Gernika,expenses,cash,-100.0,-41048.43
buyer_2,Aitxiber,Beitia,1984-09-05,35972942E,aitxiber.beitia@extremecode.io,325203,ES33209505222907029444,5037.33,2023-05-12T18:10:34,Gernika,expenses,leisure,-31.12,-41079.55
buyer_2,Aitxiber,Beitia,1984-09-05,35972942E,aitxiber.beitia@extremecode.io,325203,ES33209505222907029444,5037.33,2023-05-12T17:31:37,Gernika,expenses,appliances,-103.76,-41183.31
buyer_2,Aitxiber,Beitia,1984-09-05,35972942E,aitxiber.beitia@extremecode.io,325203,ES33209505222907029444,5037.33,2023-05-13T03:32:36,Gernika,expenses,repairs,-61.61,-41244.92
buyer_2,Aitxiber,Beitia,1984-09-05,35972942E,aitxiber.beitia@extremecode.io,325203,ES33209505222907029444,5037.33,2023-05-14T09:34:40,Gernika,expenses,cash,-100.0,-41344.92
buyer_2,Aitxiber,Beitia,1984-09-05,35972942E,aitxiber.beitia@extremecode.io,325203,ES33209505222907029444,5037.33,2023-05-14T17:06:56,Gernika,expenses,appliances,-351.68,-41696.6
buyer_2,Aitxiber,Beitia,1984-09-05,35972942E,aitxiber.beitia@extremecode.io,325203,ES33209505222907029444,5037.33,2023-05-17T16:17:08,Gernika,expenses,food,-80.75,-41777.35
buyer_2,Aitxiber,Beitia,1984-09-05,35972942E,aitxiber.beitia@extremecode.io,325203,ES33209505222907029444,5037.33,2023-05-17T09:10:01,Gernika,expenses,appliances,-282.11,-42059.46
buyer_2,Aitxiber,Beitia,1984-09-05,35972942E,aitxiber.beitia@extremecode.io,325203,ES33209505222907029444,5037.33,2023-05-18T09:44:38,Gernika,expenses,food,-86.21,-42145.67
buyer_2,Aitxiber,Beitia,1984-09-05,35972942E,aitxiber.beitia@extremecode.io,325203,ES33209505222907029444,5037.33,2023-05-19T11:48:50,Gernika,expenses,gifts,-501.69,-42647.36
buyer_2,Aitxiber,Beitia,1984-09-05,35972942E,aitxiber.beitia@extremecode.io,325203,ES33209505222907029444,5037.33,2023-05-20T10:19:03,Gernika,expenses,leisure,-45.56,-42692.92
buyer_2,Aitxiber,Beitia,1984-09-05,35972942E,aitxiber.beitia@extremecode.io,325203,ES33209505222907029444,5037.33,2023-05-21T19:39:43,Gernika,expenses,cash,-100.0,-42792.92
buyer_2,Aitxiber,Beitia,1984-09-05,35972942E,aitxiber.beitia@extremecode.io,325203,ES33209505222907029444,5037.33,2023-05-22T12:16:05,Gernika,expenses,clothing,-102.7,-42895.62
buyer_2,Aitxiber,Beitia,1984-09-05,35972942E,aitxiber.beitia@extremecode.io,325203,ES33209505222907029444,5037.33,2023-05-28T08:38:54,Gernika,expenses,clothing,-98.63,-42994.25
buyer_2,Aitxiber,Beitia,1984-09-05,35972942E,aitxiber.beitia@extremecode.io,325203,ES33209505222907029444,5037.33,2023-05-29T14:10:21,Gernika,expenses,transport,-47.66,-43041.91
buyer_2,Aitxiber,Beitia,1984-09-05,35972942E,aitxiber.beitia@extremecode.io,325203,ES33209505222907029444,5037.33,2023-05-30T10:21:04,Gernika,expenses,food,-103.95,-43145.86
buyer_2,Aitxiber,Beitia,1984-09-05,35972942E,aitxiber.beitia@extremecode.io,325203,ES33209505222907029444,5037.33,2023-05-31T08:07:47,Gernika,expenses,cash,-100.0,-43245.86
buyer_2,Aitxiber,Beitia,1984-09-05,35972942E,aitxiber.beitia@extremecode.io,325203,ES33209505222907029444,5037.33,2023-05-31T04:33:26,Gernika,expenses,gifts,-134.44,-43380.3
buyer_2,Aitxiber,Beitia,1984-09-05,35972942E,aitxiber.beitia@extremecode.io,325203,ES33209505222907029444,5037.33,2023-06-01T14:49:11,Gernika,incomes,salary,2028.34,-41351.96
buyer_2,Aitxiber,Beitia,1984-09-05,35972942E,aitxiber.beitia@extremecode.io,325203,ES33209505222907029444,5037.33,2023-06-01T14:49:11,Gernika,incomes,salary_bonus,1452.77,-39899.19
buyer_2,Aitxiber,Beitia,1984-09-05,35972942E,aitxiber.beitia@extremecode.io,325203,ES33209505222907029444,5037.33,2023-06-01T12:27:04,Gernika,expenses,cash,-100.0,-39999.19
buyer_2,Aitxiber,Beitia,1984-09-05,35972942E,aitxiber.beitia@extremecode.io,325203,ES33209505222907029444,5037.33,2023-06-02T23:22:38,Gernika,expenses,taxes,-1328.84,-41328.03
buyer_2,Aitxiber,Beitia,1984-09-05,35972942E,aitxiber.beitia@extremecode.io,325203,ES33209505222907029444,5037.33,2023-06-02T00:06:08,Gernika,expenses,insurance,-456.67,-41784.7
buyer_2,Aitxiber,Beitia,1984-09-05,35972942E,aitxiber.beitia@extremecode.io,325203,ES33209505222907029444,5037.33,2023-06-02T11:03:30,Gernika,expenses,transport,-85.03,-41869.73
buyer_2,Aitxiber,Beitia,1984-09-05,35972942E,aitxiber.beitia@extremecode.io,325203,ES33209505222907029444,5037.33,2023-06-05T20:04:21,Gernika,expenses,mortgage,-1007.54,-42877.27
buyer_2,Aitxiber,Beitia,1984-09-05,35972942E,aitxiber.beitia@extremecode.io,325203,ES33209505222907029444,5037.33,2023-06-05T12:55:11,Gernika,expenses,electricity,-75.26,-42952.53
buyer_2,Aitxiber,Beitia,1984-09-05,35972942E,aitxiber.beitia@extremecode.io,325203,ES33209505222907029444,5037.33,2023-06-05T20:49:38,Gernika,expenses,gas,-98.94,-43051.47
buyer_2,Aitxiber,Beitia,1984-09-05,35972942E,aitxiber.beitia@extremecode.io,325203,ES33209505222907029444,5037.33,2023-06-05T20:15:28,Gernika,expenses,phone,-43.51,-43094.98
buyer_2,Aitxiber,Beitia,1984-09-05,35972942E,aitxiber.beitia@extremecode.io,325203,ES33209505222907029444,5037.33,2023-06-05T18:09:32,Gernika,expenses,food,-101.2,-43196.18
buyer_2,Aitxiber,Beitia,1984-09-05,35972942E,aitxiber.beitia@extremecode.io,325203,ES33209505222907029444,5037.33,2023-06-05T15:44:26,Gernika,expenses,leisure,-37.69,-43233.87
buyer_2,Aitxiber,Beitia,1984-09-05,35972942E,aitxiber.beitia@extremecode.io,325203,ES33209505222907029444,5037.33,2023-06-05T09:14:10,Gernika,expenses,repairs,-200.78,-43434.65
buyer_2,Aitxiber,Beitia,1984-09-05,35972942E,aitxiber.beitia@extremecode.io,325203,ES33209505222907029444,5037.33,2023-06-07T13:04:16,Gernika,expenses,gas,-93.27,-43527.92
buyer_2,Aitxiber,Beitia,1984-09-05,35972942E,aitxiber.beitia@extremecode.io,325203,ES33209505222907029444,5037.33,2023-06-07T16:00:54,Gernika,expenses,internet,-42.6,-43570.52
buyer_2,Aitxiber,Beitia,1984-09-05,35972942E,aitxiber.beitia@extremecode.io,325203,ES33209505222907029444,5037.33,2023-06-08T09:33:44,Gernika,expenses,gas,-37.81,-43608.33
buyer_2,Aitxiber,Beitia,1984-09-05,35972942E,aitxiber.beitia@extremecode.io,325203,ES33209505222907029444,5037.33,2023-06-09T14:09:05,Gernika,expenses,transport,-54.51,-43662.84
buyer_2,Aitxiber,Beitia,1984-09-05,35972942E,aitxiber.beitia@extremecode.io,325203,ES33209505222907029444,5037.33,2023-06-09T08:45:28,Gernika,expenses,healthcare,-75.14,-43737.98
buyer_2,Aitxiber,Beitia,1984-09-05,35972942E,aitxiber.beitia@extremecode.io,325203,ES33209505222907029444,5037.33,2023-06-10T19:16:18,Gernika,expenses,clothing,-113.34,-43851.32
buyer_2,Aitxiber,Beitia,1984-09-05,35972942E,aitxiber.beitia@extremecode.io,325203,ES33209505222907029444,5037.33,2023-06-11T09:55:30,Gernika,expenses,transport,-74.38,-43925.7
buyer_2,Aitxiber,Beitia,1984-09-05,35972942E,aitxiber.beitia@extremecode.io,325203,ES33209505222907029444,5037.33,2023-06-12T08:53:42,Gernika,expenses,education,-59.98,-43985.68
buyer_2,Aitxiber,Beitia,1984-09-05,35972942E,aitxiber.beitia@extremecode.io,325203,ES33209505222907029444,5037.33,2023-06-12T23:53:14,Gernika,expenses,repairs,-39.08,-44024.76
buyer_2,Aitxiber,Beitia,1984-09-05,35972942E,aitxiber.beitia@extremecode.io,325203,ES33209505222907029444,5037.33,2023-06-14T21:55:20,Gernika,expenses,transport,-76.5,-44101.26
buyer_2,Aitxiber,Beitia,1984-09-05,35972942E,aitxiber.beitia@extremecode.io,325203,ES33209505222907029444,5037.33,2023-06-14T13:13:35,Gernika,expenses,children,-546.29,-44647.55
buyer_2,Aitxiber,Beitia,1984-09-05,35972942E,aitxiber.beitia@extremecode.io,325203,ES33209505222907029444,5037.33,2023-06-15T16:26:26,Gernika,expenses,food,-84.56,-44732.11
buyer_2,Aitxiber,Beitia,1984-09-05,35972942E,aitxiber.beitia@extremecode.io,325203,ES33209505222907029444,5037.33,2023-06-15T04:58:12,Gernika,expenses,cash,-100.0,-44832.11
buyer_2,Aitxiber,Beitia,1984-09-05,35972942E,aitxiber.beitia@extremecode.io,325203,ES33209505222907029444,5037.33,2023-06-16T16:05:58,Gernika,expenses,leisure,-24.5,-44856.61
buyer_2,Aitxiber,Beitia,1984-09-05,35972942E,aitxiber.beitia@extremecode.io,325203,ES33209505222907029444,5037.33,2023-06-16T20:23:54,Gernika,expenses,cash,-100.0,-44956.61
buyer_2,Aitxiber,Beitia,1984-09-05,35972942E,aitxiber.beitia@extremecode.io,325203,ES33209505222907029444,5037.33,2023-06-20T10:24:48,Gernika,expenses,food,-96.41,-45053.02
buyer_2,Aitxiber,Beitia,1984-09-05,35972942E,aitxiber.beitia@extremecode.io,325203,ES33209505222907029444,5037.33,2023-06-21T15:03:07,Gernika,expenses,education,-64.08,-45117.1
buyer_2,Aitxiber,Beitia,1984-09-05,35972942E,aitxiber.beitia@extremecode.io,325203,ES33209505222907029444,5037.33,2023-06-21T11:50:28,Gernika,expenses,cash,-100.0,-45217.1
buyer_2,Aitxiber,Beitia,1984-09-05,35972942E,aitxiber.beitia@extremecode.io,325203,ES33209505222907029444,5037.33,2023-06-22T18:24:31,Gernika,expenses,cash,-100.0,-45317.1
buyer_2,Aitxiber,Beitia,1984-09-05,35972942E,aitxiber.beitia@extremecode.io,325203,ES33209505222907029444,5037.33,2023-06-23T09:44:30,Gernika,expenses,repairs,-255.71,-45572.81
buyer_2,Aitxiber,Beitia,1984-09-05,35972942E,aitxiber.beitia@extremecode.io,325203,ES33209505222907029444,5037.33,2023-06-24T09:40:33,Gernika,expenses,leisure,-60.73,-45633.54
buyer_2,Aitxiber,Beitia,1984-09-05,35972942E,aitxiber.beitia@extremecode.io,325203,ES33209505222907029444,5037.33,2023-06-24T05:29:27,Gernika,expenses,education,-53.43,-45686.97
buyer_2,Aitxiber,Beitia,1984-09-05,35972942E,aitxiber.beitia@extremecode.io,325203,ES33209505222907029444,5037.33,2023-06-24T15:22:02,Gernika,expenses,cash,-100.0,-45786.97
buyer_2,Aitxiber,Beitia,1984-09-05,35972942E,aitxiber.beitia@extremecode.io,325203,ES33209505222907029444,5037.33,2023-06-25T16:07:25,Gernika,expenses,food,-79.61,-45866.58
buyer_2,Aitxiber,Beitia,1984-09-05,35972942E,aitxiber.beitia@extremecode.io,325203,ES33209505222907029444,5037.33,2023-06-25T08:46:52,Gernika,expenses,transport,-66.55,-45933.13
buyer_2,Aitxiber,Beitia,1984-09-05,35972942E,aitxiber.beitia@extremecode.io,325203,ES33209505222907029444,5037.33,2023-06-27T14:02:34,Gernika,expenses,leisure,-20.5,-45953.63
buyer_2,Aitxiber,Beitia,1984-09-05,35972942E,aitxiber.beitia@extremecode.io,325203,ES33209505222907029444,5037.33,2023-06-30T13:43:28,Gernika,expenses,transport,-40.09,-45993.72
buyer_2,Aitxiber,Beitia,1984-09-05,35972942E,aitxiber.beitia@extremecode.io,325203,ES33209505222907029444,5037.33,2023-07-01T14:26:52,Gernika,incomes,salary,2028.34,-43965.38
buyer_2,Aitxiber,Beitia,1984-09-05,35972942E,aitxiber.beitia@extremecode.io,325203,ES33209505222907029444,5037.33,2023-07-02T16:25:35,Gernika,expenses,clothing,-134.29,-44099.67
buyer_2,Aitxiber,Beitia,1984-09-05,35972942E,aitxiber.beitia@extremecode.io,325203,ES33209505222907029444,5037.33,2023-07-03T14:13:20,Gernika,expenses,leisure,-22.81,-44122.48
buyer_2,Aitxiber,Beitia,1984-09-05,35972942E,aitxiber.beitia@extremecode.io,325203,ES33209505222907029444,5037.33,2023-07-03T18:17:58,Gernika,expenses,repairs,-277.13,-44399.61
buyer_2,Aitxiber,Beitia,1984-09-05,35972942E,aitxiber.beitia@extremecode.io,325203,ES33209505222907029444,5037.33,2023-07-05T10:04:57,Gernika,expenses,mortgage,-1007.54,-45407.15
buyer_2,Aitxiber,Beitia,1984-09-05,35972942E,aitxiber.beitia@extremecode.io,325203,ES33209505222907029444,5037.33,2023-07-05T13:14:33,Gernika,expenses,internet,-42.6,-45449.75
buyer_2,Aitxiber,Beitia,1984-09-05,35972942E,aitxiber.beitia@extremecode.io,325203,ES33209505222907029444,5037.33,2023-07-05T21:51:20,Gernika,expenses,transport,-55.83,-45505.58
buyer_2,Aitxiber,Beitia,1984-09-05,35972942E,aitxiber.beitia@extremecode.io,325203,ES33209505222907029444,5037.33,2023-07-05T18:21:02,Gernika,expenses,leisure,-68.56,-45574.14
buyer_2,Aitxiber,Beitia,1984-09-05,35972942E,aitxiber.beitia@extremecode.io,325203,ES33209505222907029444,5037.33,2023-07-06T11:39:34,Gernika,expenses,education,-70.2,-45644.34
buyer_2,Aitxiber,Beitia,1984-09-05,35972942E,aitxiber.beitia@extremecode.io,325203,ES33209505222907029444,5037.33,2023-07-07T11:34:55,Gernika,expenses,internet,-42.6,-45686.94
buyer_2,Aitxiber,Beitia,1984-09-05,35972942E,aitxiber.beitia@extremecode.io,325203,ES33209505222907029444,5037.33,2023-07-07T16:25:32,Gernika,expenses,transport,-59.37,-45746.31
buyer_2,Aitxiber,Beitia,1984-09-05,35972942E,aitxiber.beitia@extremecode.io,325203,ES33209505222907029444,5037.33,2023-07-08T11:02:33,Gernika,expenses,electricity,-81.8,-45828.11
buyer_2,Aitxiber,Beitia,1984-09-05,35972942E,aitxiber.beitia@extremecode.io,325203,ES33209505222907029444,5037.33,2023-07-10T12:03:47,Gernika,expenses,food,-107.52,-45935.63
buyer_2,Aitxiber,Beitia,1984-09-05,35972942E,aitxiber.beitia@extremecode.io,325203,ES33209505222907029444,5037.33,2023-07-10T15:42:12,Gernika,expenses,transport,-77.0,-46012.63
buyer_2,Aitxiber,Beitia,1984-09-05,35972942E,aitxiber.beitia@extremecode.io,325203,ES33209505222907029444,5037.33,2023-07-11T10:43:47,Gernika,expenses,education,-77.59,-46090.22
buyer_2,Aitxiber,Beitia,1984-09-05,35972942E,aitxiber.beitia@extremecode.io,325203,ES33209505222907029444,5037.33,2023-07-12T20:29:43,Gernika,expenses,education,-67.32,-46157.54
buyer_2,Aitxiber,Beitia,1984-09-05,35972942E,aitxiber.beitia@extremecode.io,325203,ES33209505222907029444,5037.33,2023-07-12T20:22:10,Gernika,expenses,travel,-553.02,-46710.56
buyer_2,Aitxiber,Beitia,1984-09-05,35972942E,aitxiber.beitia@extremecode.io,325203,ES33209505222907029444,5037.33,2023-07-13T21:48:01,Gernika,expenses,leisure,-51.97,-46762.53
buyer_2,Aitxiber,Beitia,1984-09-05,35972942E,aitxiber.beitia@extremecode.io,325203,ES33209505222907029444,5037.33,2023-07-13T10:55:27,Gernika,expenses,cash,-100.0,-46862.53
buyer_2,Aitxiber,Beitia,1984-09-05,35972942E,aitxiber.beitia@extremecode.io,325203,ES33209505222907029444,5037.33,2023-07-14T10:23:28,Gernika,expenses,transport,-78.55,-46941.08
buyer_2,Aitxiber,Beitia,1984-09-05,35972942E,aitxiber.beitia@extremecode.io,325203,ES33209505222907029444,5037.33,2023-07-14T08:32:16,Gernika,expenses,leisure,-20.36,-46961.44
buyer_2,Aitxiber,Beitia,1984-09-05,35972942E,aitxiber.beitia@extremecode.io,325203,ES33209505222907029444,5037.33,2023-07-15T11:00:00,Gernika,expenses,healthcare,-122.19,-47083.63
buyer_2,Aitxiber,Beitia,1984-09-05,35972942E,aitxiber.beitia@extremecode.io,325203,ES33209505222907029444,5037.33,2023-07-16T10:24:12,Gernika,expenses,education,-61.5,-47145.13
buyer_2,Aitxiber,Beitia,1984-09-05,35972942E,aitxiber.beitia@extremecode.io,325203,ES33209505222907029444,5037.33,2023-07-16T14:49:53,Gernika,expenses,cash,-100.0,-47245.13
buyer_2,Aitxiber,Beitia,1984-09-05,35972942E,aitxiber.beitia@extremecode.io,325203,ES33209505222907029444,5037.33,2023-07-18T20:58:39,Gernika,expenses,transport,-85.28,-47330.41
buyer_2,Aitxiber,Beitia,1984-09-05,35972942E,aitxiber.beitia@extremecode.io,325203,ES33209505222907029444,5037.33,2023-07-18T17:23:32,Gernika,expenses,leisure,-24.38,-47354.79
buyer_2,Aitxiber,Beitia,1984-09-05,35972942E,aitxiber.beitia@extremecode.io,325203,ES33209505222907029444,5037.33,2023-07-20T11:47:45,Gernika,expenses,cash,-100.0,-47454.79
buyer_2,Aitxiber,Beitia,1984-09-05,35972942E,aitxiber.beitia@extremecode.io,325203,ES33209505222907029444,5037.33,2023-07-20T04:30:57,Gernika,expenses,children,-545.0253333333335,-47999.82
buyer_2,Aitxiber,Beitia,1984-09-05,35972942E,aitxiber.beitia@extremecode.io,325203,ES33209505222907029444,5037.33,2023-07-23T04:40:52,Gernika,expenses,transport,-73.71,-48073.53
buyer_2,Aitxiber,Beitia,1984-09-05,35972942E,aitxiber.beitia@extremecode.io,325203,ES33209505222907029444,5037.33,2023-07-27T09:19:58,Gernika,expenses,leisure,-75.79,-48149.32
buyer_2,Aitxiber,Beitia,1984-09-05,35972942E,aitxiber.beitia@extremecode.io,325203,ES33209505222907029444,5037.33,2023-07-28T15:05:31,Gernika,expenses,food,-78.39,-48227.71
buyer_2,Aitxiber,Beitia,1984-09-05,35972942E,aitxiber.beitia@extremecode.io,325203,ES33209505222907029444,5037.33,2023-07-29T21:08:14,Gernika,expenses,food,-120.2,-48347.91
buyer_2,Aitxiber,Beitia,1984-09-05,35972942E,aitxiber.beitia@extremecode.io,325203,ES33209505222907029444,5037.33,2023-07-29T07:09:08,Gernika,expenses,clothing,-131.72,-48479.63
buyer_2,Aitxiber,Beitia,1984-09-05,35972942E,aitxiber.beitia@extremecode.io,325203,ES33209505222907029444,5037.33,2023-07-30T16:17:26,Gernika,expenses,cash,-100.0,-48579.63
buyer_2,Aitxiber,Beitia,1984-09-05,35972942E,aitxiber.beitia@extremecode.io,325203,ES33209505222907029444,5037.33,2023-07-31T11:48:21,Gernika,expenses,food,-96.88,-48676.51
buyer_2,Aitxiber,Beitia,1984-09-05,35972942E,aitxiber.beitia@extremecode.io,325203,ES33209505222907029444,5037.33,2023-08-01T17:37:59,Gernika,incomes,salary,2028.34,-46648.17
buyer_2,Aitxiber,Beitia,1984-09-05,35972942E,aitxiber.beitia@extremecode.io,325203,ES33209505222907029444,5037.33,2023-08-01T17:37:59,Gernika,incomes,extra_income,380.33,-46267.84
buyer_2,Aitxiber,Beitia,1984-09-05,35972942E,aitxiber.beitia@extremecode.io,325203,ES33209505222907029444,5037.33,2023-08-01T14:56:58,Gernika,expenses,food,-72.89,-46340.73
buyer_2,Aitxiber,Beitia,1984-09-05,35972942E,aitxiber.beitia@extremecode.io,325203,ES33209505222907029444,5037.33,2023-08-01T22:32:16,Gernika,expenses,healthcare,-103.76,-46444.49
buyer_2,Aitxiber,Beitia,1984-09-05,35972942E,aitxiber.beitia@extremecode.io,325203,ES33209505222907029444,5037.33,2023-08-01T15:51:05,Gernika,expenses,gifts,-150.11,-46594.6
buyer_2,Aitxiber,Beitia,1984-09-05,35972942E,aitxiber.beitia@extremecode.io,325203,ES33209505222907029444,5037.33,2023-08-02T12:58:37,Gernika,expenses,transport,-55.72,-46650.32
buyer_2,Aitxiber,Beitia,1984-09-05,35972942E,aitxiber.beitia@extremecode.io,325203,ES33209505222907029444,5037.33,2023-08-02T19:53:31,Gernika,expenses,leisure,-21.13,-46671.45
buyer_2,Aitxiber,Beitia,1984-09-05,35972942E,aitxiber.beitia@extremecode.io,325203,ES33209505222907029444,5037.33,2023-08-02T19:36:14,Gernika,expenses,travel,-450.71,-47122.16
buyer_2,Aitxiber,Beitia,1984-09-05,35972942E,aitxiber.beitia@extremecode.io,325203,ES33209505222907029444,5037.33,2023-08-03T12:06:45,Gernika,expenses,repairs,-122.72,-47244.88
buyer_2,Aitxiber,Beitia,1984-09-05,35972942E,aitxiber.beitia@extremecode.io,325203,ES33209505222907029444,5037.33,2023-08-04T18:22:01,Gernika,expenses,cash,-100.0,-47344.88
buyer_2,Aitxiber,Beitia,1984-09-05,35972942E,aitxiber.beitia@extremecode.io,325203,ES33209505222907029444,5037.33,2023-08-05T01:05:15,Gernika,expenses,mortgage,-1007.54,-48352.42
buyer_2,Aitxiber,Beitia,1984-09-05,35972942E,aitxiber.beitia@extremecode.io,325203,ES33209505222907029444,5037.33,2023-08-05T09:28:17,Gernika,expenses,water,-37.28,-48389.7
buyer_2,Aitxiber,Beitia,1984-09-05,35972942E,aitxiber.beitia@extremecode.io,325203,ES33209505222907029444,5037.33,2023-08-05T09:32:27,Gernika,expenses,electricity,-87.71,-48477.41
buyer_2,Aitxiber,Beitia,1984-09-05,35972942E,aitxiber.beitia@extremecode.io,325203,ES33209505222907029444,5037.33,2023-08-05T10:07:41,Gernika,expenses,gas,-67.5,-48544.91
buyer_2,Aitxiber,Beitia,1984-09-05,35972942E,aitxiber.beitia@extremecode.io,325203,ES33209505222907029444,5037.33,2023-08-06T14:33:56,Gernika,expenses,phone,-38.16,-48583.07
buyer_2,Aitxiber,Beitia,1984-09-05,35972942E,aitxiber.beitia@extremecode.io,325203,ES33209505222907029444,5037.33,2023-08-07T15:17:00,Gernika,expenses,water,-34.33,-48617.4
buyer_2,Aitxiber,Beitia,1984-09-05,35972942E,aitxiber.beitia@extremecode.io,325203,ES33209505222907029444,5037.33,2023-08-07T15:18:56,Gernika,expenses,electricity,-36.34,-48653.74
buyer_2,Aitxiber,Beitia,1984-09-05,35972942E,aitxiber.beitia@extremecode.io,325203,ES33209505222907029444,5037.33,2023-08-07T15:12:55,Gernika,expenses,cash,-100.0,-48753.74
buyer_2,Aitxiber,Beitia,1984-09-05,35972942E,aitxiber.beitia@extremecode.io,325203,ES33209505222907029444,5037.33,2023-08-08T14:57:19,Gernika,expenses,leisure,-42.84,-48796.58
buyer_2,Aitxiber,Beitia,1984-09-05,35972942E,aitxiber.beitia@extremecode.io,325203,ES33209505222907029444,5037.33,2023-08-09T20:10:45,Gernika,expenses,cash,-100.0,-48896.58
buyer_2,Aitxiber,Beitia,1984-09-05,35972942E,aitxiber.beitia@extremecode.io,325203,ES33209505222907029444,5037.33,2023-08-09T17:42:00,Gernika,expenses,travel,-510.52,-49407.1
buyer_2,Aitxiber,Beitia,1984-09-05,35972942E,aitxiber.beitia@extremecode.io,325203,ES33209505222907029444,5037.33,2023-08-10T16:38:12,Gernika,expenses,clothing,-59.91,-49467.01
buyer_2,Aitxiber,Beitia,1984-09-05,35972942E,aitxiber.beitia@extremecode.io,325203,ES33209505222907029444,5037.33,2023-08-10T09:30:57,Gernika,expenses,repairs,-117.08,-49584.09
buyer_2,Aitxiber,Beitia,1984-09-05,35972942E,aitxiber.beitia@extremecode.io,325203,ES33209505222907029444,5037.33,2023-08-11T16:25:26,Gernika,expenses,transport,-52.92,-49637.01
buyer_2,Aitxiber,Beitia,1984-09-05,35972942E,aitxiber.beitia@extremecode.io,325203,ES33209505222907029444,5037.33,2023-08-12T21:49:06,Gernika,expenses,food,-96.58,-49733.59
buyer_2,Aitxiber,Beitia,1984-09-05,35972942E,aitxiber.beitia@extremecode.io,325203,ES33209505222907029444,5037.33,2023-08-13T14:15:50,Gernika,expenses,gifts,-540.34,-50273.93
buyer_2,Aitxiber,Beitia,1984-09-05,35972942E,aitxiber.beitia@extremecode.io,325203,ES33209505222907029444,5037.33,2023-08-14T08:56:19,Gernika,expenses,cash,-100.0,-50373.93
buyer_2,Aitxiber,Beitia,1984-09-05,35972942E,aitxiber.beitia@extremecode.io,325203,ES33209505222907029444,5037.33,2023-08-15T18:17:29,Gernika,expenses,healthcare,-68.24,-50442.17
buyer_2,Aitxiber,Beitia,1984-09-05,35972942E,aitxiber.beitia@extremecode.io,325203,ES33209505222907029444,5037.33,2023-08-18T12:46:24,Gernika,expenses,food,-90.89,-50533.06
buyer_2,Aitxiber,Beitia,1984-09-05,35972942E,aitxiber.beitia@extremecode.io,325203,ES33209505222907029444,5037.33,2023-08-18T09:18:08,Gernika,expenses,clothing,-51.8,-50584.86
buyer_2,Aitxiber,Beitia,1984-09-05,35972942E,aitxiber.beitia@extremecode.io,325203,ES33209505222907029444,5037.33,2023-08-19T16:13:22,Gernika,expenses,food,-123.26,-50708.12
buyer_2,Aitxiber,Beitia,1984-09-05,35972942E,aitxiber.beitia@extremecode.io,325203,ES33209505222907029444,5037.33,2023-08-20T18:35:24,Gernika,expenses,repairs,-155.83,-50863.95
buyer_2,Aitxiber,Beitia,1984-09-05,35972942E,aitxiber.beitia@extremecode.io,325203,ES33209505222907029444,5037.33,2023-08-21T08:17:37,Gernika,expenses,clothing,-90.03,-50953.98
buyer_2,Aitxiber,Beitia,1984-09-05,35972942E,aitxiber.beitia@extremecode.io,325203,ES33209505222907029444,5037.33,2023-08-22T13:53:31,Gernika,expenses,cash,-100.0,-51053.98
buyer_2,Aitxiber,Beitia,1984-09-05,35972942E,aitxiber.beitia@extremecode.io,325203,ES33209505222907029444,5037.33,2023-08-24T12:39:28,Gernika,expenses,transport,-54.75,-51108.73
buyer_2,Aitxiber,Beitia,1984-09-05,35972942E,aitxiber.beitia@extremecode.io,325203,ES33209505222907029444,5037.33,2023-08-26T19:53:18,Gernika,expenses,cash,-100.0,-51208.73
buyer_2,Aitxiber,Beitia,1984-09-05,35972942E,aitxiber.beitia@extremecode.io,325203,ES33209505222907029444,5037.33,2023-08-28T18:50:55,Gernika,expenses,repairs,-171.25,-51379.98
buyer_2,Aitxiber,Beitia,1984-09-05,35972942E,aitxiber.beitia@extremecode.io,325203,ES33209505222907029444,5037.33,2023-08-29T23:03:19,Gernika,expenses,education,-42.48,-51422.46
buyer_2,Aitxiber,Beitia,1984-09-05,35972942E,aitxiber.beitia@extremecode.io,325203,ES33209505222907029444,5037.33,2023-08-30T15:19:55,Gernika,expenses,clothing,-135.25,-51557.71
buyer_2,Aitxiber,Beitia,1984-09-05,35972942E,aitxiber.beitia@extremecode.io,325203,ES33209505222907029444,5037.33,2023-08-30T19:08:43,Gernika,expenses,repairs,-177.24,-51734.95
buyer_2,Aitxiber,Beitia,1984-09-05,35972942E,aitxiber.beitia@extremecode.io,325203,ES33209505222907029444,5037.33,2023-09-01T16:49:28,Gernika,incomes,salary,2028.34,-49706.61
buyer_2,Aitxiber,Beitia,1984-09-05,35972942E,aitxiber.beitia@extremecode.io,325203,ES33209505222907029444,5037.33,2023-09-01T08:02:01,Gernika,expenses,cash,-100.0,-49806.61
buyer_2,Aitxiber,Beitia,1984-09-05,35972942E,aitxiber.beitia@extremecode.io,325203,ES33209505222907029444,5037.33,2023-09-02T18:25:15,Gernika,expenses,education,-57.34,-49863.95
buyer_2,Aitxiber,Beitia,1984-09-05,35972942E,aitxiber.beitia@extremecode.io,325203,ES33209505222907029444,5037.33,2023-09-04T12:27:11,Gernika,expenses,food,-124.76,-49988.71
buyer_2,Aitxiber,Beitia,1984-09-05,35972942E,aitxiber.beitia@extremecode.io,325203,ES33209505222907029444,5037.33,2023-09-05T17:40:12,Gernika,expenses,mortgage,-1007.54,-50996.25
buyer_2,Aitxiber,Beitia,1984-09-05,35972942E,aitxiber.beitia@extremecode.io,325203,ES33209505222907029444,5037.33,2023-09-05T21:42:47,Gernika,expenses,internet,-42.6,-51038.85
buyer_2,Aitxiber,Beitia,1984-09-05,35972942E,aitxiber.beitia@extremecode.io,325203,ES33209505222907029444,5037.33,2023-09-05T09:37:27,Gernika,expenses,phone,-35.8,-51074.65
buyer_2,Aitxiber,Beitia,1984-09-05,35972942E,aitxiber.beitia@extremecode.io,325203,ES33209505222907029444,5037.33,2023-09-06T14:22:12,Gernika,expenses,internet,-42.6,-51117.25
buyer_2,Aitxiber,Beitia,1984-09-05,35972942E,aitxiber.beitia@extremecode.io,325203,ES33209505222907029444,5037.33,2023-09-06T16:52:54,Gernika,expenses,leisure,-29.11,-51146.36
buyer_2,Aitxiber,Beitia,1984-09-05,35972942E,aitxiber.beitia@extremecode.io,325203,ES33209505222907029444,5037.33,2023-09-07T11:42:22,Gernika,expenses,phone,-41.86,-51188.22
buyer_2,Aitxiber,Beitia,1984-09-05,35972942E,aitxiber.beitia@extremecode.io,325203,ES33209505222907029444,5037.33,2023-09-07T19:02:20,Gernika,expenses,food,-68.45,-51256.67
buyer_2,Aitxiber,Beitia,1984-09-05,35972942E,aitxiber.beitia@extremecode.io,325203,ES33209505222907029444,5037.33,2023-09-08T17:44:33,Gernika,expenses,electricity,-37.56,-51294.23
buyer_2,Aitxiber,Beitia,1984-09-05,35972942E,aitxiber.beitia@extremecode.io,325203,ES33209505222907029444,5037.33,2023-09-08T17:37:06,Gernika,expenses,appliances,-261.39,-51555.62
buyer_2,Aitxiber,Beitia,1984-09-05,35972942E,aitxiber.beitia@extremecode.io,325203,ES33209505222907029444,5037.33,2023-09-10T11:49:45,Gernika,expenses,transport,-66.88,-51622.5
buyer_2,Aitxiber,Beitia,1984-09-05,35972942E,aitxiber.beitia@extremecode.io,325203,ES33209505222907029444,5037.33,2023-09-10T08:43:06,Gernika,expenses,gifts,-296.55,-51919.05
buyer_2,Aitxiber,Beitia,1984-09-05,35972942E,aitxiber.beitia@extremecode.io,325203,ES33209505222907029444,5037.33,2023-09-12T14:14:38,Gernika,expenses,food,-118.78,-52037.83
buyer_2,Aitxiber,Beitia,1984-09-05,35972942E,aitxiber.beitia@extremecode.io,325203,ES33209505222907029444,5037.33,2023-09-12T12:30:16,Gernika,expenses,transport,-82.54,-52120.37
buyer_2,Aitxiber,Beitia,1984-09-05,35972942E,aitxiber.beitia@extremecode.io,325203,ES33209505222907029444,5037.33,2023-09-13T17:46:42,Gernika,expenses,transport,-70.8,-52191.17
buyer_2,Aitxiber,Beitia,1984-09-05,35972942E,aitxiber.beitia@extremecode.io,325203,ES33209505222907029444,5037.33,2023-09-14T19:12:09,Gernika,expenses,cash,-100.0,-52291.17
buyer_2,Aitxiber,Beitia,1984-09-05,35972942E,aitxiber.beitia@extremecode.io,325203,ES33209505222907029444,5037.33,2023-09-14T18:56:52,Gernika,expenses,children,-545.0253333333335,-52836.2
buyer_2,Aitxiber,Beitia,1984-09-05,35972942E,aitxiber.beitia@extremecode.io,325203,ES33209505222907029444,5037.33,2023-09-16T18:54:57,Gernika,expenses,leisure,-78.56,-52914.76
buyer_2,Aitxiber,Beitia,1984-09-05,35972942E,aitxiber.beitia@extremecode.io,325203,ES33209505222907029444,5037.33,2023-09-22T17:50:43,Gernika,expenses,cash,-100.0,-53014.76
buyer_2,Aitxiber,Beitia,1984-09-05,35972942E,aitxiber.beitia@extremecode.io,325203,ES33209505222907029444,5037.33,2023-09-22T16:06:37,Gernika,expenses,appliances,-414.57,-53429.33
buyer_2,Aitxiber,Beitia,1984-09-05,35972942E,aitxiber.beitia@extremecode.io,325203,ES33209505222907029444,5037.33,2023-09-22T15:47:26,Gernika,expenses,gifts,-72.58,-53501.91
buyer_2,Aitxiber,Beitia,1984-09-05,35972942E,aitxiber.beitia@extremecode.io,325203,ES33209505222907029444,5037.33,2023-09-27T18:09:23,Gernika,expenses,healthcare,-92.45,-53594.36
buyer_2,Aitxiber,Beitia,1984-09-05,35972942E,aitxiber.beitia@extremecode.io,325203,ES33209505222907029444,5037.33,2023-09-30T21:09:44,Gernika,expenses,food,-91.38,-53685.74
buyer_2,Aitxiber,Beitia,1984-09-05,35972942E,aitxiber.beitia@extremecode.io,325203,ES33209505222907029444,5037.33,2023-10-01T09:34:26,Gernika,incomes,salary,2028.34,-51657.4
buyer_2,Aitxiber,Beitia,1984-09-05,35972942E,aitxiber.beitia@extremecode.io,325203,ES33209505222907029444,5037.33,2023-10-01T18:40:15,Gernika,expenses,leisure,-62.8,-51720.2
buyer_2,Aitxiber,Beitia,1984-09-05,35972942E,aitxiber.beitia@extremecode.io,325203,ES33209505222907029444,5037.33,2023-10-01T21:44:05,Gernika,expenses,repairs,-282.54,-52002.74
buyer_2,Aitxiber,Beitia,1984-09-05,35972942E,aitxiber.beitia@extremecode.io,325203,ES33209505222907029444,5037.33,2023-10-02T17:07:27,Gernika,expenses,transport,-53.28,-52056.02
buyer_2,Aitxiber,Beitia,1984-09-05,35972942E,aitxiber.beitia@extremecode.io,325203,ES33209505222907029444,5037.33,2023-10-02T14:05:31,Gernika,expenses,cash,-100.0,-52156.02
buyer_2,Aitxiber,Beitia,1984-09-05,35972942E,aitxiber.beitia@extremecode.io,325203,ES33209505222907029444,5037.33,2023-10-03T18:37:33,Gernika,expenses,transport,-89.54,-52245.56
buyer_2,Aitxiber,Beitia,1984-09-05,35972942E,aitxiber.beitia@extremecode.io,325203,ES33209505222907029444,5037.33,2023-10-05T11:12:07,Gernika,expenses,mortgage,-1007.54,-53253.1
buyer_2,Aitxiber,Beitia,1984-09-05,35972942E,aitxiber.beitia@extremecode.io,325203,ES33209505222907029444,5037.33,2023-10-05T10:26:11,Gernika,expenses,leisure,-70.38,-53323.48
buyer_2,Aitxiber,Beitia,1984-09-05,35972942E,aitxiber.beitia@extremecode.io,325203,ES33209505222907029444,5037.33,2023-10-05T12:46:51,Gernika,expenses,healthcare,-99.99,-53423.47
buyer_2,Aitxiber,Beitia,1984-09-05,35972942E,aitxiber.beitia@extremecode.io,325203,ES33209505222907029444,5037.33,2023-10-06T18:44:48,Gernika,expenses,gas,-39.48,-53462.95
buyer_2,Aitxiber,Beitia,1984-09-05,35972942E,aitxiber.beitia@extremecode.io,325203,ES33209505222907029444,5037.33,2023-10-06T17:37:26,Gernika,expenses,transport,-78.97,-53541.92
buyer_2,Aitxiber,Beitia,1984-09-05,35972942E,aitxiber.beitia@extremecode.io,325203,ES33209505222907029444,5037.33,2023-10-08T16:42:58,Gernika,expenses,water,-32.02,-53573.94
buyer_2,Aitxiber,Beitia,1984-09-05,35972942E,aitxiber.beitia@extremecode.io,325203,ES33209505222907029444,5037.33,2023-10-08T13:20:02,Gernika,expenses,internet,-42.6,-53616.54
buyer_2,Aitxiber,Beitia,1984-09-05,35972942E,aitxiber.beitia@extremecode.io,325203,ES33209505222907029444,5037.33,2023-10-08T15:13:51,Gernika,expenses,phone,-34.55,-53651.09
buyer_2,Aitxiber,Beitia,1984-09-05,35972942E,aitxiber.beitia@extremecode.io,325203,ES33209505222907029444,5037.33,2023-10-14T17:12:24,Gernika,expenses,leisure,-21.75,-53672.84
buyer_2,Aitxiber,Beitia,1984-09-05,35972942E,aitxiber.beitia@extremecode.io,325203,ES33209505222907029444,5037.33,2023-10-14T09:48:15,Gernika,expenses,healthcare,-137.82,-53810.66
buyer_2,Aitxiber,Beitia,1984-09-05,35972942E,aitxiber.beitia@extremecode.io,325203,ES33209505222907029444,5037.33,2023-10-15T16:05:27,Gernika,expenses,cash,-100.0,-53910.66
buyer_2,Aitxiber,Beitia,1984-09-05,35972942E,aitxiber.beitia@extremecode.io,325203,ES33209505222907029444,5037.33,2023-10-19T21:37:48,Gernika,expenses,food,-124.07,-54034.73
buyer_2,Aitxiber,Beitia,1984-09-05,35972942E,aitxiber.beitia@extremecode.io,325203,ES33209505222907029444,5037.33,2023-10-22T16:35:32,Gernika,expenses,food,-99.11,-54133.84
buyer_2,Aitxiber,Beitia,1984-09-05,35972942E,aitxiber.beitia@extremecode.io,325203,ES33209505222907029444,5037.33,2023-10-22T11:32:34,Gernika,expenses,leisure,-32.61,-54166.45
buyer_2,Aitxiber,Beitia,1984-09-05,35972942E,aitxiber.beitia@extremecode.io,325203,ES33209505222907029444,5037.33,2023-10-26T21:51:56,Gernika,expenses,leisure,-82.76,-54249.21
buyer_2,Aitxiber,Beitia,1984-09-05,35972942E,aitxiber.beitia@extremecode.io,325203,ES33209505222907029444,5037.33,2023-10-27T11:33:34,Gernika,expenses,food,-109.2,-54358.41
buyer_2,Aitxiber,Beitia,1984-09-05,35972942E,aitxiber.beitia@extremecode.io,325203,ES33209505222907029444,5037.33,2023-10-27T10:42:42,Gernika,expenses,leisure,-42.04,-54400.45
buyer_2,Aitxiber,Beitia,1984-09-05,35972942E,aitxiber.beitia@extremecode.io,325203,ES33209505222907029444,5037.33,2023-10-29T21:10:45,Gernika,expenses,food,-67.97,-54468.42
buyer_2,Aitxiber,Beitia,1984-09-05,35972942E,aitxiber.beitia@extremecode.io,325203,ES33209505222907029444,5037.33,2023-10-30T12:17:50,Gernika,expenses,transport,-55.61,-54524.03
buyer_2,Aitxiber,Beitia,1984-09-05,35972942E,aitxiber.beitia@extremecode.io,325203,ES33209505222907029444,5037.33,2023-10-30T12:51:55,Gernika,expenses,cash,-100.0,-54624.03
buyer_2,Aitxiber,Beitia,1984-09-05,35972942E,aitxiber.beitia@extremecode.io,325203,ES33209505222907029444,5037.33,2023-10-30T09:52:33,Gernika,expenses,appliances,-219.29,-54843.32
buyer_2,Aitxiber,Beitia,1984-09-05,35972942E,aitxiber.beitia@extremecode.io,325203,ES33209505222907029444,5037.33,2023-10-30T13:51:44,Gernika,expenses,gifts,-224.36,-55067.68
buyer_2,Aitxiber,Beitia,1984-09-05,35972942E,aitxiber.beitia@extremecode.io,325203,ES33209505222907029444,5037.33,2023-10-31T10:56:11,Gernika,expenses,education,-52.33,-55120.01
buyer_2,Aitxiber,Beitia,1984-09-05,35972942E,aitxiber.beitia@extremecode.io,325203,ES33209505222907029444,5037.33,2023-11-01T07:55:48,Gernika,incomes,salary,2028.34,-53091.67
buyer_2,Aitxiber,Beitia,1984-09-05,35972942E,aitxiber.beitia@extremecode.io,325203,ES33209505222907029444,5037.33,2023-11-01T10:00:09,Gernika,expenses,food,-70.5,-53162.17
buyer_2,Aitxiber,Beitia,1984-09-05,35972942E,aitxiber.beitia@extremecode.io,325203,ES33209505222907029444,5037.33,2023-11-02T13:39:31,Gernika,expenses,food,-97.42,-53259.59
buyer_2,Aitxiber,Beitia,1984-09-05,35972942E,aitxiber.beitia@extremecode.io,325203,ES33209505222907029444,5037.33,2023-11-04T11:26:28,Gernika,expenses,appliances,-394.12,-53653.71
buyer_2,Aitxiber,Beitia,1984-09-05,35972942E,aitxiber.beitia@extremecode.io,325203,ES33209505222907029444,5037.33,2023-11-05T19:30:34,Gernika,expenses,mortgage,-1007.54,-54661.25
buyer_2,Aitxiber,Beitia,1984-09-05,35972942E,aitxiber.beitia@extremecode.io,325203,ES33209505222907029444,5037.33,2023-11-05T13:28:17,Gernika,expenses,leisure,-83.0,-54744.25
buyer_2,Aitxiber,Beitia,1984-09-05,35972942E,aitxiber.beitia@extremecode.io,325203,ES33209505222907029444,5037.33,2023-11-05T13:30:18,Gernika,expenses,repairs,-199.58,-54943.83
buyer_2,Aitxiber,Beitia,1984-09-05,35972942E,aitxiber.beitia@extremecode.io,325203,ES33209505222907029444,5037.33,2023-11-06T15:51:10,Gernika,expenses,electricity,-55.97,-54999.8
buyer_2,Aitxiber,Beitia,1984-09-05,35972942E,aitxiber.beitia@extremecode.io,325203,ES33209505222907029444,5037.33,2023-11-06T22:33:49,Gernika,expenses,phone,-36.59,-55036.39
buyer_2,Aitxiber,Beitia,1984-09-05,35972942E,aitxiber.beitia@extremecode.io,325203,ES33209505222907029444,5037.33,2023-11-06T02:57:25,Gernika,expenses,leisure,-54.74,-55091.13
buyer_2,Aitxiber,Beitia,1984-09-05,35972942E,aitxiber.beitia@extremecode.io,325203,ES33209505222907029444,5037.33,2023-11-07T03:08:11,Gernika,expenses,water,-39.83,-55130.96
buyer_2,Aitxiber,Beitia,1984-09-05,35972942E,aitxiber.beitia@extremecode.io,325203,ES33209505222907029444,5037.33,2023-11-07T08:07:20,Gernika,expenses,electricity,-23.07,-55154.03
buyer_2,Aitxiber,Beitia,1984-09-05,35972942E,aitxiber.beitia@extremecode.io,325203,ES33209505222907029444,5037.33,2023-11-07T10:06:10,Gernika,expenses,internet,-42.6,-55196.63
buyer_2,Aitxiber,Beitia,1984-09-05,35972942E,aitxiber.beitia@extremecode.io,325203,ES33209505222907029444,5037.33,2023-11-07T19:07:16,Gernika,expenses,transport,-52.3,-55248.93
buyer_2,Aitxiber,Beitia,1984-09-05,35972942E,aitxiber.beitia@extremecode.io,325203,ES33209505222907029444,5037.33,2023-11-08T18:35:17,Gernika,expenses,water,-36.82,-55285.75
buyer_2,Aitxiber,Beitia,1984-09-05,35972942E,aitxiber.beitia@extremecode.io,325203,ES33209505222907029444,5037.33,2023-11-08T10:12:08,Gernika,expenses,phone,-36.62,-55322.37
buyer_2,Aitxiber,Beitia,1984-09-05,35972942E,aitxiber.beitia@extremecode.io,325203,ES33209505222907029444,5037.33,2023-11-08T13:03:42,Gernika,expenses,food,-119.47,-55441.84
buyer_2,Aitxiber,Beitia,1984-09-05,35972942E,aitxiber.beitia@extremecode.io,325203,ES33209505222907029444,5037.33,2023-11-08T08:05:42,Gernika,expenses,cash,-100.0,-55541.84
buyer_2,Aitxiber,Beitia,1984-09-05,35972942E,aitxiber.beitia@extremecode.io,325203,ES33209505222907029444,5037.33,2023-11-09T16:55:28,Gernika,expenses,food,-116.79,-55658.63
buyer_2,Aitxiber,Beitia,1984-09-05,35972942E,aitxiber.beitia@extremecode.io,325203,ES33209505222907029444,5037.33,2023-11-09T22:45:05,Gernika,expenses,clothing,-61.8,-55720.43
buyer_2,Aitxiber,Beitia,1984-09-05,35972942E,aitxiber.beitia@extremecode.io,325203,ES33209505222907029444,5037.33,2023-11-10T09:19:27,Gernika,expenses,education,-68.47,-55788.9
buyer_2,Aitxiber,Beitia,1984-09-05,35972942E,aitxiber.beitia@extremecode.io,325203,ES33209505222907029444,5037.33,2023-11-10T08:00:17,Gernika,expenses,gifts,-271.79,-56060.69
buyer_2,Aitxiber,Beitia,1984-09-05,35972942E,aitxiber.beitia@extremecode.io,325203,ES33209505222907029444,5037.33,2023-11-11T15:17:17,Gernika,expenses,transport,-49.06,-56109.75
buyer_2,Aitxiber,Beitia,1984-09-05,35972942E,aitxiber.beitia@extremecode.io,325203,ES33209505222907029444,5037.33,2023-11-11T12:16:00,Gernika,expenses,leisure,-35.98,-56145.73
buyer_2,Aitxiber,Beitia,1984-09-05,35972942E,aitxiber.beitia@extremecode.io,325203,ES33209505222907029444,5037.33,2023-11-12T17:14:46,Gernika,expenses,food,-86.38,-56232.11
buyer_2,Aitxiber,Beitia,1984-09-05,35972942E,aitxiber.beitia@extremecode.io,325203,ES33209505222907029444,5037.33,2023-11-13T11:46:15,Gernika,expenses,repairs,-110.34,-56342.45
buyer_2,Aitxiber,Beitia,1984-09-05,35972942E,aitxiber.beitia@extremecode.io,325203,ES33209505222907029444,5037.33,2023-11-13T22:06:23,Gernika,expenses,gifts,-330.0,-56672.45
buyer_2,Aitxiber,Beitia,1984-09-05,35972942E,aitxiber.beitia@extremecode.io,325203,ES33209505222907029444,5037.33,2023-11-14T15:00:13,Gernika,expenses,food,-62.05,-56734.5
buyer_2,Aitxiber,Beitia,1984-09-05,35972942E,aitxiber.beitia@extremecode.io,325203,ES33209505222907029444,5037.33,2023-11-16T13:57:35,Gernika,expenses,food,-70.92,-56805.42
buyer_2,Aitxiber,Beitia,1984-09-05,35972942E,aitxiber.beitia@extremecode.io,325203,ES33209505222907029444,5037.33,2023-11-17T16:47:52,Gernika,expenses,leisure,-68.98,-56874.4
buyer_2,Aitxiber,Beitia,1984-09-05,35972942E,aitxiber.beitia@extremecode.io,325203,ES33209505222907029444,5037.33,2023-11-17T12:23:48,Gernika,expenses,gifts,-438.09,-57312.49
buyer_2,Aitxiber,Beitia,1984-09-05,35972942E,aitxiber.beitia@extremecode.io,325203,ES33209505222907029444,5037.33,2023-11-18T14:58:33,Gernika,expenses,transport,-62.77,-57375.26
buyer_2,Aitxiber,Beitia,1984-09-05,35972942E,aitxiber.beitia@extremecode.io,325203,ES33209505222907029444,5037.33,2023-11-19T18:08:05,Gernika,expenses,clothing,-51.73,-57426.99
buyer_2,Aitxiber,Beitia,1984-09-05,35972942E,aitxiber.beitia@extremecode.io,325203,ES33209505222907029444,5037.33,2023-11-20T13:58:12,Gernika,expenses,food,-102.14,-57529.13
buyer_2,Aitxiber,Beitia,1984-09-05,35972942E,aitxiber.beitia@extremecode.io,325203,ES33209505222907029444,5037.33,2023-11-21T16:02:15,Gernika,expenses,education,-73.19,-57602.32
buyer_2,Aitxiber,Beitia,1984-09-05,35972942E,aitxiber.beitia@extremecode.io,325203,ES33209505222907029444,5037.33,2023-11-22T08:10:43,Gernika,expenses,transport,-41.94,-57644.26
buyer_2,Aitxiber,Beitia,1984-09-05,35972942E,aitxiber.beitia@extremecode.io,325203,ES33209505222907029444,5037.33,2023-11-25T20:12:36,Gernika,expenses,food,-114.68,-57758.94
buyer_2,Aitxiber,Beitia,1984-09-05,35972942E,aitxiber.beitia@extremecode.io,325203,ES33209505222907029444,5037.33,2023-11-26T18:05:42,Gernika,expenses,food,-97.58,-57856.52
buyer_2,Aitxiber,Beitia,1984-09-05,35972942E,aitxiber.beitia@extremecode.io,325203,ES33209505222907029444,5037.33,2023-11-26T12:15:50,Gernika,expenses,cash,-100.0,-57956.52
buyer_2,Aitxiber,Beitia,1984-09-05,35972942E,aitxiber.beitia@extremecode.io,325203,ES33209505222907029444,5037.33,2023-11-27T19:51:24,Gernika,expenses,clothing,-112.45,-58068.97
buyer_2,Aitxiber,Beitia,1984-09-05,35972942E,aitxiber.beitia@extremecode.io,325203,ES33209505222907029444,5037.33,2023-11-27T16:52:43,Gernika,expenses,cash,-100.0,-58168.97
buyer_2,Aitxiber,Beitia,1984-09-05,35972942E,aitxiber.beitia@extremecode.io,325203,ES33209505222907029444,5037.33,2023-11-28T12:12:18,Gernika,expenses,cash,-100.0,-58268.97
buyer_2,Aitxiber,Beitia,1984-09-05,35972942E,aitxiber.beitia@extremecode.io,325203,ES33209505222907029444,5037.33,2023-11-29T14:29:37,Gernika,expenses,transport,-50.39,-58319.36
buyer_2,Aitxiber,Beitia,1984-09-05,35972942E,aitxiber.beitia@extremecode.io,325203,ES33209505222907029444,5037.33,2023-11-29T22:50:36,Gernika,expenses,education,-67.21,-58386.57
buyer_2,Aitxiber,Beitia,1984-09-05,35972942E,aitxiber.beitia@extremecode.io,325203,ES33209505222907029444,5037.33,2023-11-30T10:26:31,Gernika,expenses,food,-62.21,-58448.78
buyer_2,Aitxiber,Beitia,1984-09-05,35972942E,aitxiber.beitia@extremecode.io,325203,ES33209505222907029444,5037.33,2023-11-30T15:42:06,Gernika,expenses,cash,-100.0,-58548.78
buyer_2,Aitxiber,Beitia,1984-09-05,35972942E,aitxiber.beitia@extremecode.io,325203,ES33209505222907029444,5037.33,2023-12-01T14:57:23,Gernika,incomes,salary,2028.34,-56520.44
buyer_2,Aitxiber,Beitia,1984-09-05,35972942E,aitxiber.beitia@extremecode.io,325203,ES33209505222907029444,5037.33,2023-12-01T14:57:23,Gernika,incomes,extra_income,380.33,-56140.11
buyer_2,Aitxiber,Beitia,1984-09-05,35972942E,aitxiber.beitia@extremecode.io,325203,ES33209505222907029444,5037.33,2023-12-01T14:57:23,Gernika,incomes,salary_bonus,1489.99,-54650.12
buyer_2,Aitxiber,Beitia,1984-09-05,35972942E,aitxiber.beitia@extremecode.io,325203,ES33209505222907029444,5037.33,2023-12-04T14:23:58,Gernika,expenses,food,-88.74,-54738.86
buyer_2,Aitxiber,Beitia,1984-09-05,35972942E,aitxiber.beitia@extremecode.io,325203,ES33209505222907029444,5037.33,2023-12-04T13:25:06,Gernika,expenses,cash,-100.0,-54838.86
buyer_2,Aitxiber,Beitia,1984-09-05,35972942E,aitxiber.beitia@extremecode.io,325203,ES33209505222907029444,5037.33,2023-12-05T12:08:02,Gernika,expenses,mortgage,-1007.54,-55846.4
buyer_2,Aitxiber,Beitia,1984-09-05,35972942E,aitxiber.beitia@extremecode.io,325203,ES33209505222907029444,5037.33,2023-12-05T17:34:06,Gernika,expenses,internet,-42.6,-55889.0
buyer_2,Aitxiber,Beitia,1984-09-05,35972942E,aitxiber.beitia@extremecode.io,325203,ES33209505222907029444,5037.33,2023-12-05T16:34:32,Gernika,expenses,gifts,-164.96,-56053.96
buyer_2,Aitxiber,Beitia,1984-09-05,35972942E,aitxiber.beitia@extremecode.io,325203,ES33209505222907029444,5037.33,2023-12-06T10:00:34,Gernika,expenses,electricity,-79.8,-56133.76
buyer_2,Aitxiber,Beitia,1984-09-05,35972942E,aitxiber.beitia@extremecode.io,325203,ES33209505222907029444,5037.33,2023-12-06T11:21:47,Gernika,expenses,phone,-34.46,-56168.22
buyer_2,Aitxiber,Beitia,1984-09-05,35972942E,aitxiber.beitia@extremecode.io,325203,ES33209505222907029444,5037.33,2023-12-06T20:12:39,Gernika,expenses,repairs,-203.33,-56371.55
buyer_2,Aitxiber,Beitia,1984-09-05,35972942E,aitxiber.beitia@extremecode.io,325203,ES33209505222907029444,5037.33,2023-12-07T20:53:36,Gernika,expenses,internet,-42.6,-56414.15
buyer_2,Aitxiber,Beitia,1984-09-05,35972942E,aitxiber.beitia@extremecode.io,325203,ES33209505222907029444,5037.33,2023-12-07T08:44:34,Gernika,expenses,phone,-41.05,-56455.2
buyer_2,Aitxiber,Beitia,1984-09-05,35972942E,aitxiber.beitia@extremecode.io,325203,ES33209505222907029444,5037.33,2023-12-08T10:59:39,Gernika,expenses,cash,-100.0,-56555.2
buyer_2,Aitxiber,Beitia,1984-09-05,35972942E,aitxiber.beitia@extremecode.io,325203,ES33209505222907029444,5037.33,2023-12-10T17:02:44,Gernika,expenses,clothing,-105.96,-56661.16
buyer_2,Aitxiber,Beitia,1984-09-05,35972942E,aitxiber.beitia@extremecode.io,325203,ES33209505222907029444,5037.33,2023-12-10T19:20:01,Gernika,expenses,children,-539.0653333333335,-57200.23
buyer_2,Aitxiber,Beitia,1984-09-05,35972942E,aitxiber.beitia@extremecode.io,325203,ES33209505222907029444,5037.33,2023-12-11T12:50:04,Gernika,expenses,education,-45.33,-57245.56
buyer_2,Aitxiber,Beitia,1984-09-05,35972942E,aitxiber.beitia@extremecode.io,325203,ES33209505222907029444,5037.33,2023-12-17T18:17:42,Gernika,expenses,cash,-100.0,-57345.56
buyer_2,Aitxiber,Beitia,1984-09-05,35972942E,aitxiber.beitia@extremecode.io,325203,ES33209505222907029444,5037.33,2023-12-18T13:23:58,Gernika,expenses,leisure,-59.34,-57404.9
buyer_2,Aitxiber,Beitia,1984-09-05,35972942E,aitxiber.beitia@extremecode.io,325203,ES33209505222907029444,5037.33,2023-12-19T17:49:30,Gernika,expenses,healthcare,-142.16,-57547.06
buyer_2,Aitxiber,Beitia,1984-09-05,35972942E,aitxiber.beitia@extremecode.io,325203,ES33209505222907029444,5037.33,2023-12-19T20:37:30,Gernika,expenses,cash,-100.0,-57647.06
buyer_2,Aitxiber,Beitia,1984-09-05,35972942E,aitxiber.beitia@extremecode.io,325203,ES33209505222907029444,5037.33,2023-12-20T23:00:40,Gernika,expenses,cash,-100.0,-57747.06
buyer_2,Aitxiber,Beitia,1984-09-05,35972942E,aitxiber.beitia@extremecode.io,325203,ES33209505222907029444,5037.33,2023-12-21T17:33:33,Gernika,expenses,gifts,-29.75,-57776.81
buyer_2,Aitxiber,Beitia,1984-09-05,35972942E,aitxiber.beitia@extremecode.io,325203,ES33209505222907029444,5037.33,2023-12-25T11:20:12,Gernika,expenses,appliances,-89.88,-57866.69
buyer_2,Aitxiber,Beitia,1984-09-05,35972942E,aitxiber.beitia@extremecode.io,325203,ES33209505222907029444,5037.33,2023-12-28T17:09:29,Gernika,expenses,food,-88.78,-57955.47
buyer_2,Aitxiber,Beitia,1984-09-05,35972942E,aitxiber.beitia@extremecode.io,325203,ES33209505222907029444,5037.33,2024-01-01T20:17:41,Gernika,incomes,salary,2072.19,-55883.28
buyer_2,Aitxiber,Beitia,1984-09-05,35972942E,aitxiber.beitia@extremecode.io,325203,ES33209505222907029444,5037.33,2024-01-03T15:54:35,Gernika,expenses,food,-122.41,-56005.69
buyer_2,Aitxiber,Beitia,1984-09-05,35972942E,aitxiber.beitia@extremecode.io,325203,ES33209505222907029444,5037.33,2024-01-04T21:09:28,Gernika,expenses,repairs,-223.33,-56229.02
buyer_2,Aitxiber,Beitia,1984-09-05,35972942E,aitxiber.beitia@extremecode.io,325203,ES33209505222907029444,5037.33,2024-01-05T11:36:07,Gernika,expenses,mortgage,-744.09,-56973.11
buyer_2,Aitxiber,Beitia,1984-09-05,35972942E,aitxiber.beitia@extremecode.io,325203,ES33209505222907029444,5037.33,2024-01-05T16:53:57,Gernika,expenses,water,-24.24,-56997.35
buyer_2,Aitxiber,Beitia,1984-09-05,35972942E,aitxiber.beitia@extremecode.io,325203,ES33209505222907029444,5037.33,2024-01-05T04:34:11,Gernika,expenses,gas,-83.01,-57080.36
buyer_2,Aitxiber,Beitia,1984-09-05,35972942E,aitxiber.beitia@extremecode.io,325203,ES33209505222907029444,5037.33,2024-01-05T11:27:53,Gernika,expenses,internet,-43.52,-57123.88
buyer_2,Aitxiber,Beitia,1984-09-05,35972942E,aitxiber.beitia@extremecode.io,325203,ES33209505222907029444,5037.33,2024-01-05T20:08:21,Gernika,expenses,phone,-39.82,-57163.7
buyer_2,Aitxiber,Beitia,1984-09-05,35972942E,aitxiber.beitia@extremecode.io,325203,ES33209505222907029444,5037.33,2024-01-06T13:03:13,Gernika,expenses,internet,-43.52,-57207.22
buyer_2,Aitxiber,Beitia,1984-09-05,35972942E,aitxiber.beitia@extremecode.io,325203,ES33209505222907029444,5037.33,2024-01-06T08:49:21,Gernika,expenses,food,-74.02,-57281.24
buyer_2,Aitxiber,Beitia,1984-09-05,35972942E,aitxiber.beitia@extremecode.io,325203,ES33209505222907029444,5037.33,2024-01-06T22:52:55,Gernika,expenses,repairs,-124.1,-57405.34
buyer_2,Aitxiber,Beitia,1984-09-05,35972942E,aitxiber.beitia@extremecode.io,325203,ES33209505222907029444,5037.33,2024-01-07T23:58:58,Gernika,expenses,gas,-109.96,-57515.3
buyer_2,Aitxiber,Beitia,1984-09-05,35972942E,aitxiber.beitia@extremecode.io,325203,ES33209505222907029444,5037.33,2024-01-07T07:02:22,Gernika,expenses,internet,-43.52,-57558.82
buyer_2,Aitxiber,Beitia,1984-09-05,35972942E,aitxiber.beitia@extremecode.io,325203,ES33209505222907029444,5037.33,2024-01-07T17:06:30,Gernika,expenses,phone,-36.88,-57595.7
buyer_2,Aitxiber,Beitia,1984-09-05,35972942E,aitxiber.beitia@extremecode.io,325203,ES33209505222907029444,5037.33,2024-01-07T04:07:41,Gernika,expenses,clothing,-63.86,-57659.56
buyer_2,Aitxiber,Beitia,1984-09-05,35972942E,aitxiber.beitia@extremecode.io,325203,ES33209505222907029444,5037.33,2024-01-08T10:22:08,Gernika,expenses,gas,-98.63,-57758.19
buyer_2,Aitxiber,Beitia,1984-09-05,35972942E,aitxiber.beitia@extremecode.io,325203,ES33209505222907029444,5037.33,2024-01-08T16:30:50,Gernika,expenses,phone,-41.8,-57799.99
buyer_2,Aitxiber,Beitia,1984-09-05,35972942E,aitxiber.beitia@extremecode.io,325203,ES33209505222907029444,5037.33,2024-01-08T16:22:10,Gernika,expenses,food,-82.86,-57882.85
buyer_2,Aitxiber,Beitia,1984-09-05,35972942E,aitxiber.beitia@extremecode.io,325203,ES33209505222907029444,5037.33,2024-01-10T11:39:18,Gernika,expenses,clothing,-45.29,-57928.14
buyer_2,Aitxiber,Beitia,1984-09-05,35972942E,aitxiber.beitia@extremecode.io,325203,ES33209505222907029444,5037.33,2024-01-10T05:53:45,Gernika,expenses,repairs,-122.84,-58050.98
buyer_2,Aitxiber,Beitia,1984-09-05,35972942E,aitxiber.beitia@extremecode.io,325203,ES33209505222907029444,5037.33,2024-01-10T19:10:14,Gernika,expenses,children,-557.41,-58608.39
buyer_2,Aitxiber,Beitia,1984-09-05,35972942E,aitxiber.beitia@extremecode.io,325203,ES33209505222907029444,5037.33,2024-01-20T23:35:40,Gernika,expenses,food,-94.25,-58702.64
buyer_2,Aitxiber,Beitia,1984-09-05,35972942E,aitxiber.beitia@extremecode.io,325203,ES33209505222907029444,5037.33,2024-01-24T11:58:41,Gernika,expenses,food,-73.43,-58776.07
buyer_2,Aitxiber,Beitia,1984-09-05,35972942E,aitxiber.beitia@extremecode.io,325203,ES33209505222907029444,5037.33,2024-01-25T17:56:59,Gernika,expenses,food,-70.07,-58846.14
buyer_2,Aitxiber,Beitia,1984-09-05,35972942E,aitxiber.beitia@extremecode.io,325203,ES33209505222907029444,5037.33,2024-01-25T14:35:17,Gernika,expenses,cash,-100.0,-58946.14
buyer_2,Aitxiber,Beitia,1984-09-05,35972942E,aitxiber.beitia@extremecode.io,325203,ES33209505222907029444,5037.33,2024-01-25T13:10:33,Gernika,expenses,appliances,-304.87,-59251.01
buyer_2,Aitxiber,Beitia,1984-09-05,35972942E,aitxiber.beitia@extremecode.io,325203,ES33209505222907029444,5037.33,2024-01-26T17:39:15,Gernika,expenses,repairs,-245.13,-59496.14
buyer_2,Aitxiber,Beitia,1984-09-05,35972942E,aitxiber.beitia@extremecode.io,325203,ES33209505222907029444,5037.33,2024-01-31T15:19:22,Gernika,expenses,food,-110.33,-59606.47
buyer_2,Aitxiber,Beitia,1984-09-05,35972942E,aitxiber.beitia@extremecode.io,325203,ES33209505222907029444,5037.33,2024-01-31T14:25:10,Gernika,expenses,transport,-79.94,-59686.41
buyer_2,Aitxiber,Beitia,1984-09-05,35972942E,aitxiber.beitia@extremecode.io,325203,ES33209505222907029444,5037.33,2024-01-31T12:56:23,Gernika,expenses,clothing,-84.72,-59771.13
buyer_2,Aitxiber,Beitia,1984-09-05,35972942E,aitxiber.beitia@extremecode.io,325203,ES33209505222907029444,5037.33,2024-01-31T19:52:31,Gernika,expenses,cash,-100.0,-59871.13
buyer_2,Aitxiber,Beitia,1984-09-05,35972942E,aitxiber.beitia@extremecode.io,325203,ES33209505222907029444,5037.33,2024-02-01T22:51:45,Gernika,incomes,salary,2072.19,-57798.94
buyer_2,Aitxiber,Beitia,1984-09-05,35972942E,aitxiber.beitia@extremecode.io,325203,ES33209505222907029444,5037.33,2024-02-01T08:17:05,Gernika,expenses,transport,-53.18,-57852.12
buyer_2,Aitxiber,Beitia,1984-09-05,35972942E,aitxiber.beitia@extremecode.io,325203,ES33209505222907029444,5037.33,2024-02-03T08:50:39,Gernika,expenses,food,-107.24,-57959.36
buyer_2,Aitxiber,Beitia,1984-09-05,35972942E,aitxiber.beitia@extremecode.io,325203,ES33209505222907029444,5037.33,2024-02-05T08:10:44,Gernika,expenses,mortgage,-744.09,-58703.45
buyer_2,Aitxiber,Beitia,1984-09-05,35972942E,aitxiber.beitia@extremecode.io,325203,ES33209505222907029444,5037.33,2024-02-05T14:24:41,Gernika,expenses,repairs,-244.79,-58948.24
buyer_2,Aitxiber,Beitia,1984-09-05,35972942E,aitxiber.beitia@extremecode.io,325203,ES33209505222907029444,5037.33,2024-02-06T13:09:19,Gernika,expenses,electricity,-48.4,-58996.64
buyer_2,Aitxiber,Beitia,1984-09-05,35972942E,aitxiber.beitia@extremecode.io,325203,ES33209505222907029444,5037.33,2024-02-06T09:59:14,Gernika,expenses,leisure,-79.07,-59075.71
buyer_2,Aitxiber,Beitia,1984-09-05,35972942E,aitxiber.beitia@extremecode.io,325203,ES33209505222907029444,5037.33,2024-02-06T20:37:14,Gernika,expenses,healthcare,-147.66,-59223.37
buyer_2,Aitxiber,Beitia,1984-09-05,35972942E,aitxiber.beitia@extremecode.io,325203,ES33209505222907029444,5037.33,2024-02-06T11:34:29,Gernika,expenses,children,-242.63,-59466.0
buyer_2,Aitxiber,Beitia,1984-09-05,35972942E,aitxiber.beitia@extremecode.io,325203,ES33209505222907029444,5037.33,2024-02-07T13:05:31,Gernika,expenses,gas,-45.74,-59511.74
buyer_2,Aitxiber,Beitia,1984-09-05,35972942E,aitxiber.beitia@extremecode.io,325203,ES33209505222907029444,5037.33,2024-02-08T06:33:17,Gernika,expenses,phone,-37.67,-59549.41
buyer_2,Aitxiber,Beitia,1984-09-05,35972942E,aitxiber.beitia@extremecode.io,325203,ES33209505222907029444,5037.33,2024-02-08T09:26:26,Gernika,expenses,cash,-100.0,-59649.41
buyer_2,Aitxiber,Beitia,1984-09-05,35972942E,aitxiber.beitia@extremecode.io,325203,ES33209505222907029444,5037.33,2024-02-09T14:01:18,Gernika,expenses,leisure,-41.47,-59690.88
buyer_2,Aitxiber,Beitia,1984-09-05,35972942E,aitxiber.beitia@extremecode.io,325203,ES33209505222907029444,5037.33,2024-02-09T18:06:26,Gernika,expenses,healthcare,-48.21,-59739.09
buyer_2,Aitxiber,Beitia,1984-09-05,35972942E,aitxiber.beitia@extremecode.io,325203,ES33209505222907029444,5037.33,2024-02-09T11:13:27,Gernika,expenses,cash,-100.0,-59839.09
buyer_2,Aitxiber,Beitia,1984-09-05,35972942E,aitxiber.beitia@extremecode.io,325203,ES33209505222907029444,5037.33,2024-02-10T00:02:31,Gernika,expenses,food,-75.7,-59914.79
buyer_2,Aitxiber,Beitia,1984-09-05,35972942E,aitxiber.beitia@extremecode.io,325203,ES33209505222907029444,5037.33,2024-02-11T11:08:14,Gernika,expenses,food,-80.67,-59995.46
buyer_2,Aitxiber,Beitia,1984-09-05,35972942E,aitxiber.beitia@extremecode.io,325203,ES33209505222907029444,5037.33,2024-02-11T13:35:58,Gernika,expenses,transport,-58.26,-60053.72
buyer_2,Aitxiber,Beitia,1984-09-05,35972942E,aitxiber.beitia@extremecode.io,325203,ES33209505222907029444,5037.33,2024-02-11T14:37:43,Gernika,expenses,leisure,-63.43,-60117.15
buyer_2,Aitxiber,Beitia,1984-09-05,35972942E,aitxiber.beitia@extremecode.io,325203,ES33209505222907029444,5037.33,2024-02-11T16:37:13,Gernika,expenses,repairs,-34.01,-60151.16
buyer_2,Aitxiber,Beitia,1984-09-05,35972942E,aitxiber.beitia@extremecode.io,325203,ES33209505222907029444,5037.33,2024-02-13T12:24:32,Gernika,expenses,healthcare,-182.45,-60333.61
buyer_2,Aitxiber,Beitia,1984-09-05,35972942E,aitxiber.beitia@extremecode.io,325203,ES33209505222907029444,5037.33,2024-02-13T15:47:52,Gernika,expenses,education,-54.23,-60387.84
buyer_2,Aitxiber,Beitia,1984-09-05,35972942E,aitxiber.beitia@extremecode.io,325203,ES33209505222907029444,5037.33,2024-02-13T04:59:42,Gernika,expenses,appliances,-235.18,-60623.02
buyer_2,Aitxiber,Beitia,1984-09-05,35972942E,aitxiber.beitia@extremecode.io,325203,ES33209505222907029444,5037.33,2024-02-14T09:15:30,Gernika,expenses,transport,-59.19,-60682.21
buyer_2,Aitxiber,Beitia,1984-09-05,35972942E,aitxiber.beitia@extremecode.io,325203,ES33209505222907029444,5037.33,2024-02-15T16:00:43,Gernika,expenses,food,-115.45,-60797.66
buyer_2,Aitxiber,Beitia,1984-09-05,35972942E,aitxiber.beitia@extremecode.io,325203,ES33209505222907029444,5037.33,2024-02-17T13:06:59,Gernika,expenses,food,-113.09,-60910.75
buyer_2,Aitxiber,Beitia,1984-09-05,35972942E,aitxiber.beitia@extremecode.io,325203,ES33209505222907029444,5037.33,2024-02-19T20:04:35,Gernika,expenses,leisure,-73.77,-60984.52
buyer_2,Aitxiber,Beitia,1984-09-05,35972942E,aitxiber.beitia@extremecode.io,325203,ES33209505222907029444,5037.33,2024-02-20T10:34:09,Gernika,expenses,gifts,-732.01,-61716.53
buyer_2,Aitxiber,Beitia,1984-09-05,35972942E,aitxiber.beitia@extremecode.io,325203,ES33209505222907029444,5037.33,2024-02-21T16:24:19,Gernika,expenses,travel,-627.26,-62343.79
buyer_2,Aitxiber,Beitia,1984-09-05,35972942E,aitxiber.beitia@extremecode.io,325203,ES33209505222907029444,5037.33,2024-02-22T18:03:47,Gernika,expenses,food,-87.32,-62431.11
buyer_2,Aitxiber,Beitia,1984-09-05,35972942E,aitxiber.beitia@extremecode.io,325203,ES33209505222907029444,5037.33,2024-02-23T19:26:30,Gernika,expenses,cash,-100.0,-62531.11
buyer_2,Aitxiber,Beitia,1984-09-05,35972942E,aitxiber.beitia@extremecode.io,325203,ES33209505222907029444,5037.33,2024-02-24T06:31:42,Gernika,expenses,leisure,-42.44,-62573.55
buyer_2,Aitxiber,Beitia,1984-09-05,35972942E,aitxiber.beitia@extremecode.io,325203,ES33209505222907029444,5037.33,2024-02-27T08:04:08,Gernika,expenses,food,-97.28,-62670.83
buyer_2,Aitxiber,Beitia,1984-09-05,35972942E,aitxiber.beitia@extremecode.io,325203,ES33209505222907029444,5037.33,2024-02-28T11:24:02,Gernika,expenses,food,-95.75,-62766.58
buyer_2,Aitxiber,Beitia,1984-09-05,35972942E,aitxiber.beitia@extremecode.io,325203,ES33209505222907029444,5037.33,2024-02-28T14:08:46,Gernika,expenses,cash,-100.0,-62866.58
buyer_2,Aitxiber,Beitia,1984-09-05,35972942E,aitxiber.beitia@extremecode.io,325203,ES33209505222907029444,5037.33,2024-02-29T10:34:06,Gernika,expenses,healthcare,-165.71,-63032.29
buyer_2,Aitxiber,Beitia,1984-09-05,35972942E,aitxiber.beitia@extremecode.io,325203,ES33209505222907029444,5037.33,2024-02-29T09:18:17,Gernika,expenses,cash,-100.0,-63132.29
buyer_2,Aitxiber,Beitia,1984-09-05,35972942E,aitxiber.beitia@extremecode.io,325203,ES33209505222907029444,5037.33,2024-02-29T08:01:46,Gernika,expenses,repairs,-107.14,-63239.43
buyer_2,Aitxiber,Beitia,1984-09-05,35972942E,aitxiber.beitia@extremecode.io,325203,ES33209505222907029444,5037.33,2024-03-01T21:54:00,Gernika,incomes,salary,2072.19,-61167.24
buyer_2,Aitxiber,Beitia,1984-09-05,35972942E,aitxiber.beitia@extremecode.io,325203,ES33209505222907029444,5037.33,2024-03-01T18:33:22,Gernika,expenses,leisure,-35.57,-61202.81
buyer_2,Aitxiber,Beitia,1984-09-05,35972942E,aitxiber.beitia@extremecode.io,325203,ES33209505222907029444,5037.33,2024-03-03T23:21:18,Gernika,expenses,repairs,-96.62,-61299.43
buyer_2,Aitxiber,Beitia,1984-09-05,35972942E,aitxiber.beitia@extremecode.io,325203,ES33209505222907029444,5037.33,2024-03-04T16:42:28,Gernika,expenses,transport,-51.46,-61350.89
buyer_2,Aitxiber,Beitia,1984-09-05,35972942E,aitxiber.beitia@extremecode.io,325203,ES33209505222907029444,5037.33,2024-03-04T01:05:36,Gernika,expenses,cash,-100.0,-61450.89
buyer_2,Aitxiber,Beitia,1984-09-05,35972942E,aitxiber.beitia@extremecode.io,325203,ES33209505222907029444,5037.33,2024-03-05T11:07:07,Gernika,expenses,mortgage,-744.09,-62194.98
buyer_2,Aitxiber,Beitia,1984-09-05,35972942E,aitxiber.beitia@extremecode.io,325203,ES33209505222907029444,5037.33,2024-03-05T19:09:56,Gernika,expenses,electricity,-23.56,-62218.54
buyer_2,Aitxiber,Beitia,1984-09-05,35972942E,aitxiber.beitia@extremecode.io,325203,ES33209505222907029444,5037.33,2024-03-05T13:58:42,Gernika,expenses,gas,-85.05,-62303.59
buyer_2,Aitxiber,Beitia,1984-09-05,35972942E,aitxiber.beitia@extremecode.io,325203,ES33209505222907029444,5037.33,2024-03-05T14:20:14,Gernika,expenses,internet,-43.52,-62347.11
buyer_2,Aitxiber,Beitia,1984-09-05,35972942E,aitxiber.beitia@extremecode.io,325203,ES33209505222907029444,5037.33,2024-03-05T19:32:25,Gernika,expenses,leisure,-60.69,-62407.8
buyer_2,Aitxiber,Beitia,1984-09-05,35972942E,aitxiber.beitia@extremecode.io,325203,ES33209505222907029444,5037.33,2024-03-05T10:40:36,Gernika,expenses,children,-543.27,-62951.07
buyer_2,Aitxiber,Beitia,1984-09-05,35972942E,aitxiber.beitia@extremecode.io,325203,ES33209505222907029444,5037.33,2024-03-06T11:31:09,Gernika,expenses,electricity,-43.78,-62994.85
buyer_2,Aitxiber,Beitia,1984-09-05,35972942E,aitxiber.beitia@extremecode.io,325203,ES33209505222907029444,5037.33,2024-03-06T08:33:45,Gernika,expenses,clothing,-59.83,-63054.68
buyer_2,Aitxiber,Beitia,1984-09-05,35972942E,aitxiber.beitia@extremecode.io,325203,ES33209505222907029444,5037.33,2024-03-08T18:49:08,Gernika,expenses,internet,-43.52,-63098.2
buyer_2,Aitxiber,Beitia,1984-09-05,35972942E,aitxiber.beitia@extremecode.io,325203,ES33209505222907029444,5037.33,2024-03-08T18:58:58,Gernika,expenses,phone,-34.16,-63132.36
buyer_2,Aitxiber,Beitia,1984-09-05,35972942E,aitxiber.beitia@extremecode.io,325203,ES33209505222907029444,5037.33,2024-03-08T07:08:58,Gernika,expenses,leisure,-77.1,-63209.46
buyer_2,Aitxiber,Beitia,1984-09-05,35972942E,aitxiber.beitia@extremecode.io,325203,ES33209505222907029444,5037.33,2024-03-08T21:23:11,Gernika,expenses,repairs,-55.24,-63264.7
buyer_2,Aitxiber,Beitia,1984-09-05,35972942E,aitxiber.beitia@extremecode.io,325203,ES33209505222907029444,5037.33,2024-03-10T17:55:10,Gernika,expenses,cash,-100.0,-63364.7
buyer_2,Aitxiber,Beitia,1984-09-05,35972942E,aitxiber.beitia@extremecode.io,325203,ES33209505222907029444,5037.33,2024-03-12T20:30:27,Gernika,expenses,cash,-100.0,-63464.7
buyer_2,Aitxiber,Beitia,1984-09-05,35972942E,aitxiber.beitia@extremecode.io,325203,ES33209505222907029444,5037.33,2024-03-13T14:50:45,Gernika,expenses,cash,-100.0,-63564.7
buyer_2,Aitxiber,Beitia,1984-09-05,35972942E,aitxiber.beitia@extremecode.io,325203,ES33209505222907029444,5037.33,2024-03-14T15:00:47,Gernika,expenses,clothing,-86.17,-63650.87
buyer_2,Aitxiber,Beitia,1984-09-05,35972942E,aitxiber.beitia@extremecode.io,325203,ES33209505222907029444,5037.33,2024-03-15T11:19:01,Gernika,expenses,repairs,-268.2,-63919.07
buyer_2,Aitxiber,Beitia,1984-09-05,35972942E,aitxiber.beitia@extremecode.io,325203,ES33209505222907029444,5037.33,2024-03-16T03:17:43,Gernika,expenses,food,-92.96,-64012.03
buyer_2,Aitxiber,Beitia,1984-09-05,35972942E,aitxiber.beitia@extremecode.io,325203,ES33209505222907029444,5037.33,2024-03-17T15:10:29,Gernika,expenses,food,-72.1,-64084.13
buyer_2,Aitxiber,Beitia,1984-09-05,35972942E,aitxiber.beitia@extremecode.io,325203,ES33209505222907029444,5037.33,2024-03-17T20:26:11,Gernika,expenses,clothing,-134.44,-64218.57
buyer_2,Aitxiber,Beitia,1984-09-05,35972942E,aitxiber.beitia@extremecode.io,325203,ES33209505222907029444,5037.33,2024-03-17T08:51:47,Gernika,expenses,healthcare,-110.96,-64329.53
buyer_2,Aitxiber,Beitia,1984-09-05,35972942E,aitxiber.beitia@extremecode.io,325203,ES33209505222907029444,5037.33,2024-03-17T09:10:49,Gernika,expenses,repairs,-51.84,-64381.37
buyer_2,Aitxiber,Beitia,1984-09-05,35972942E,aitxiber.beitia@extremecode.io,325203,ES33209505222907029444,5037.33,2024-03-18T13:07:51,Gernika,expenses,gifts,-297.19,-64678.56
buyer_2,Aitxiber,Beitia,1984-09-05,35972942E,aitxiber.beitia@extremecode.io,325203,ES33209505222907029444,5037.33,2024-03-19T04:13:01,Gernika,expenses,cash,-100.0,-64778.56
buyer_2,Aitxiber,Beitia,1984-09-05,35972942E,aitxiber.beitia@extremecode.io,325203,ES33209505222907029444,5037.33,2024-03-19T10:31:56,Gernika,expenses,repairs,-125.77,-64904.33
buyer_2,Aitxiber,Beitia,1984-09-05,35972942E,aitxiber.beitia@extremecode.io,325203,ES33209505222907029444,5037.33,2024-03-20T16:48:42,Gernika,expenses,food,-112.86,-65017.19
buyer_2,Aitxiber,Beitia,1984-09-05,35972942E,aitxiber.beitia@extremecode.io,325203,ES33209505222907029444,5037.33,2024-03-22T22:06:20,Gernika,expenses,transport,-76.07,-65093.26
buyer_2,Aitxiber,Beitia,1984-09-05,35972942E,aitxiber.beitia@extremecode.io,325203,ES33209505222907029444,5037.33,2024-03-22T09:08:26,Gernika,expenses,leisure,-42.73,-65135.99
buyer_2,Aitxiber,Beitia,1984-09-05,35972942E,aitxiber.beitia@extremecode.io,325203,ES33209505222907029444,5037.33,2024-03-22T19:45:02,Gernika,expenses,repairs,-330.09,-65466.08
buyer_2,Aitxiber,Beitia,1984-09-05,35972942E,aitxiber.beitia@extremecode.io,325203,ES33209505222907029444,5037.33,2024-03-23T13:59:30,Gernika,expenses,healthcare,-124.91,-65590.99
buyer_2,Aitxiber,Beitia,1984-09-05,35972942E,aitxiber.beitia@extremecode.io,325203,ES33209505222907029444,5037.33,2024-03-28T22:38:15,Gernika,expenses,cash,-100.0,-65690.99
buyer_2,Aitxiber,Beitia,1984-09-05,35972942E,aitxiber.beitia@extremecode.io,325203,ES33209505222907029444,5037.33,2024-03-29T20:12:26,Gernika,expenses,food,-81.88,-65772.87
buyer_2,Aitxiber,Beitia,1984-09-05,35972942E,aitxiber.beitia@extremecode.io,325203,ES33209505222907029444,5037.33,2024-03-29T11:22:31,Gernika,expenses,transport,-48.21,-65821.08
buyer_2,Aitxiber,Beitia,1984-09-05,35972942E,aitxiber.beitia@extremecode.io,325203,ES33209505222907029444,5037.33,2024-03-29T09:54:46,Gernika,expenses,education,-51.53,-65872.61
buyer_2,Aitxiber,Beitia,1984-09-05,35972942E,aitxiber.beitia@extremecode.io,325203,ES33209505222907029444,5037.33,2024-04-01T05:05:38,Gernika,incomes,salary,2072.19,-63800.42
buyer_2,Aitxiber,Beitia,1984-09-05,35972942E,aitxiber.beitia@extremecode.io,325203,ES33209505222907029444,5037.33,2024-04-01T05:05:38,Gernika,incomes,extra_income,380.33,-63420.09
buyer_2,Aitxiber,Beitia,1984-09-05,35972942E,aitxiber.beitia@extremecode.io,325203,ES33209505222907029444,5037.33,2024-04-01T16:15:01,Gernika,expenses,clothing,-102.43,-63522.52
buyer_2,Aitxiber,Beitia,1984-09-05,35972942E,aitxiber.beitia@extremecode.io,325203,ES33209505222907029444,5037.33,2024-04-01T11:33:04,Gernika,expenses,cash,-100.0,-63622.52
buyer_2,Aitxiber,Beitia,1984-09-05,35972942E,aitxiber.beitia@extremecode.io,325203,ES33209505222907029444,5037.33,2024-04-04T08:34:43,Gernika,expenses,food,-105.1,-63727.62
buyer_2,Aitxiber,Beitia,1984-09-05,35972942E,aitxiber.beitia@extremecode.io,325203,ES33209505222907029444,5037.33,2024-04-04T15:36:15,Gernika,expenses,healthcare,-134.16,-63861.78
buyer_2,Aitxiber,Beitia,1984-09-05,35972942E,aitxiber.beitia@extremecode.io,325203,ES33209505222907029444,5037.33,2024-04-04T15:06:50,Gernika,expenses,repairs,-28.52,-63890.3
buyer_2,Aitxiber,Beitia,1984-09-05,35972942E,aitxiber.beitia@extremecode.io,325203,ES33209505222907029444,5037.33,2024-04-05T09:44:21,Gernika,expenses,mortgage,-744.09,-64634.39
buyer_2,Aitxiber,Beitia,1984-09-05,35972942E,aitxiber.beitia@extremecode.io,325203,ES33209505222907029444,5037.33,2024-04-06T12:09:05,Gernika,expenses,water,-46.0,-64680.39
buyer_2,Aitxiber,Beitia,1984-09-05,35972942E,aitxiber.beitia@extremecode.io,325203,ES33209505222907029444,5037.33,2024-04-06T18:40:47,Gernika,expenses,gas,-52.43,-64732.82
buyer_2,Aitxiber,Beitia,1984-09-05,35972942E,aitxiber.beitia@extremecode.io,325203,ES33209505222907029444,5037.33,2024-04-06T23:26:37,Gernika,expenses,phone,-38.78,-64771.6
buyer_2,Aitxiber,Beitia,1984-09-05,35972942E,aitxiber.beitia@extremecode.io,325203,ES33209505222907029444,5037.33,2024-04-06T08:09:01,Gernika,expenses,leisure,-61.13,-64832.73
buyer_2,Aitxiber,Beitia,1984-09-05,35972942E,aitxiber.beitia@extremecode.io,325203,ES33209505222907029444,5037.33,2024-04-07T14:45:38,Gernika,expenses,food,-87.14,-64919.87
buyer_2,Aitxiber,Beitia,1984-09-05,35972942E,aitxiber.beitia@extremecode.io,325203,ES33209505222907029444,5037.33,2024-04-07T13:44:39,Gernika,expenses,cash,-100.0,-65019.87
buyer_2,Aitxiber,Beitia,1984-09-05,35972942E,aitxiber.beitia@extremecode.io,325203,ES33209505222907029444,5037.33,2024-04-08T15:57:31,Gernika,expenses,gas,-100.02,-65119.89
buyer_2,Aitxiber,Beitia,1984-09-05,35972942E,aitxiber.beitia@extremecode.io,325203,ES33209505222907029444,5037.33,2024-04-08T16:57:09,Gernika,expenses,phone,-46.28,-65166.17
buyer_2,Aitxiber,Beitia,1984-09-05,35972942E,aitxiber.beitia@extremecode.io,325203,ES33209505222907029444,5037.33,2024-04-08T20:48:56,Gernika,expenses,clothing,-66.47,-65232.64
buyer_2,Aitxiber,Beitia,1984-09-05,35972942E,aitxiber.beitia@extremecode.io,325203,ES33209505222907029444,5037.33,2024-04-08T19:18:41,Gernika,expenses,cash,-100.0,-65332.64
buyer_2,Aitxiber,Beitia,1984-09-05,35972942E,aitxiber.beitia@extremecode.io,325203,ES33209505222907029444,5037.33,2024-04-08T11:41:50,Gernika,expenses,repairs,-245.67,-65578.31
buyer_2,Aitxiber,Beitia,1984-09-05,35972942E,aitxiber.beitia@extremecode.io,325203,ES33209505222907029444,5037.33,2024-04-09T02:19:38,Gernika,expenses,food,-123.05,-65701.36
buyer_2,Aitxiber,Beitia,1984-09-05,35972942E,aitxiber.beitia@extremecode.io,325203,ES33209505222907029444,5037.33,2024-04-10T15:49:42,Gernika,expenses,transport,-75.66,-65777.02
buyer_2,Aitxiber,Beitia,1984-09-05,35972942E,aitxiber.beitia@extremecode.io,325203,ES33209505222907029444,5037.33,2024-04-13T20:42:33,Gernika,expenses,repairs,-249.72,-66026.74
buyer_2,Aitxiber,Beitia,1984-09-05,35972942E,aitxiber.beitia@extremecode.io,325203,ES33209505222907029444,5037.33,2024-04-14T15:27:08,Gernika,expenses,transport,-69.14,-66095.88
buyer_2,Aitxiber,Beitia,1984-09-05,35972942E,aitxiber.beitia@extremecode.io,325203,ES33209505222907029444,5037.33,2024-04-14T14:39:37,Gernika,expenses,cash,-100.0,-66195.88
buyer_2,Aitxiber,Beitia,1984-09-05,35972942E,aitxiber.beitia@extremecode.io,325203,ES33209505222907029444,5037.33,2024-04-14T13:25:16,Gernika,expenses,gifts,-364.74,-66560.62
buyer_2,Aitxiber,Beitia,1984-09-05,35972942E,aitxiber.beitia@extremecode.io,325203,ES33209505222907029444,5037.33,2024-04-15T20:48:53,Gernika,expenses,healthcare,-73.35,-66633.97
buyer_2,Aitxiber,Beitia,1984-09-05,35972942E,aitxiber.beitia@extremecode.io,325203,ES33209505222907029444,5037.33,2024-04-16T19:57:44,Gernika,expenses,leisure,-57.7,-66691.67
buyer_2,Aitxiber,Beitia,1984-09-05,35972942E,aitxiber.beitia@extremecode.io,325203,ES33209505222907029444,5037.33,2024-04-16T16:30:40,Gernika,expenses,gifts,-334.8,-67026.47
buyer_2,Aitxiber,Beitia,1984-09-05,35972942E,aitxiber.beitia@extremecode.io,325203,ES33209505222907029444,5037.33,2024-04-17T07:02:52,Gernika,expenses,food,-113.64,-67140.11
buyer_2,Aitxiber,Beitia,1984-09-05,35972942E,aitxiber.beitia@extremecode.io,325203,ES33209505222907029444,5037.33,2024-04-18T15:44:05,Gernika,expenses,leisure,-66.43,-67206.54
buyer_2,Aitxiber,Beitia,1984-09-05,35972942E,aitxiber.beitia@extremecode.io,325203,ES33209505222907029444,5037.33,2024-04-19T14:21:10,Gernika,expenses,cash,-100.0,-67306.54
buyer_2,Aitxiber,Beitia,1984-09-05,35972942E,aitxiber.beitia@extremecode.io,325203,ES33209505222907029444,5037.33,2024-04-20T00:16:41,Gernika,expenses,travel,-713.93,-68020.47
buyer_2,Aitxiber,Beitia,1984-09-05,35972942E,aitxiber.beitia@extremecode.io,325203,ES33209505222907029444,5037.33,2024-04-21T20:42:19,Gernika,expenses,leisure,-24.58,-68045.05
buyer_2,Aitxiber,Beitia,1984-09-05,35972942E,aitxiber.beitia@extremecode.io,325203,ES33209505222907029444,5037.33,2024-04-23T10:56:43,Gernika,expenses,food,-75.01,-68120.06
buyer_2,Aitxiber,Beitia,1984-09-05,35972942E,aitxiber.beitia@extremecode.io,325203,ES33209505222907029444,5037.33,2024-04-24T10:46:10,Gernika,expenses,clothing,-101.95,-68222.01
buyer_2,Aitxiber,Beitia,1984-09-05,35972942E,aitxiber.beitia@extremecode.io,325203,ES33209505222907029444,5037.33,2024-04-24T18:54:07,Gernika,expenses,gifts,-602.32,-68824.33
buyer_2,Aitxiber,Beitia,1984-09-05,35972942E,aitxiber.beitia@extremecode.io,325203,ES33209505222907029444,5037.33,2024-04-26T11:09:38,Gernika,expenses,clothing,-45.71,-68870.04
buyer_2,Aitxiber,Beitia,1984-09-05,35972942E,aitxiber.beitia@extremecode.io,325203,ES33209505222907029444,5037.33,2024-04-26T13:04:54,Gernika,expenses,repairs,-29.33,-68899.37
buyer_2,Aitxiber,Beitia,1984-09-05,35972942E,aitxiber.beitia@extremecode.io,325203,ES33209505222907029444,5037.33,2024-04-28T20:45:19,Gernika,expenses,transport,-89.93,-68989.3
buyer_2,Aitxiber,Beitia,1984-09-05,35972942E,aitxiber.beitia@extremecode.io,325203,ES33209505222907029444,5037.33,2024-04-28T08:35:10,Gernika,expenses,cash,-100.0,-69089.3
buyer_2,Aitxiber,Beitia,1984-09-05,35972942E,aitxiber.beitia@extremecode.io,325203,ES33209505222907029444,5037.33,2024-04-30T12:50:04,Gernika,expenses,healthcare,-172.24,-69261.54
buyer_2,Aitxiber,Beitia,1984-09-05,35972942E,aitxiber.beitia@extremecode.io,325203,ES33209505222907029444,5037.33,2024-05-01T10:28:22,Gernika,incomes,salary,2072.19,-67189.35
buyer_2,Aitxiber,Beitia,1984-09-05,35972942E,aitxiber.beitia@extremecode.io,325203,ES33209505222907029444,5037.33,2024-05-02T18:28:58,Gernika,expenses,food,-63.56,-67252.91
buyer_2,Aitxiber,Beitia,1984-09-05,35972942E,aitxiber.beitia@extremecode.io,325203,ES33209505222907029444,5037.33,2024-05-02T22:30:37,Gernika,expenses,transport,-79.87,-67332.78
buyer_2,Aitxiber,Beitia,1984-09-05,35972942E,aitxiber.beitia@extremecode.io,325203,ES33209505222907029444,5037.33,2024-05-03T18:47:42,Gernika,expenses,repairs,-110.6,-67443.38
buyer_2,Aitxiber,Beitia,1984-09-05,35972942E,aitxiber.beitia@extremecode.io,325203,ES33209505222907029444,5037.33,2024-05-04T09:14:36,Gernika,expenses,transport,-65.12,-67508.5
buyer_2,Aitxiber,Beitia,1984-09-05,35972942E,aitxiber.beitia@extremecode.io,325203,ES33209505222907029444,5037.33,2024-05-04T08:43:31,Gernika,expenses,cash,-100.0,-67608.5
buyer_2,Aitxiber,Beitia,1984-09-05,35972942E,aitxiber.beitia@extremecode.io,325203,ES33209505222907029444,5037.33,2024-05-05T13:51:52,Gernika,expenses,mortgage,-744.09,-68352.59
buyer_2,Aitxiber,Beitia,1984-09-05,35972942E,aitxiber.beitia@extremecode.io,325203,ES33209505222907029444,5037.33,2024-05-05T16:14:09,Gernika,expenses,electricity,-53.01,-68405.6
buyer_2,Aitxiber,Beitia,1984-09-05,35972942E,aitxiber.beitia@extremecode.io,325203,ES33209505222907029444,5037.33,2024-05-05T23:30:08,Gernika,expenses,internet,-43.52,-68449.12
buyer_2,Aitxiber,Beitia,1984-09-05,35972942E,aitxiber.beitia@extremecode.io,325203,ES33209505222907029444,5037.33,2024-05-05T14:02:31,Gernika,expenses,cash,-100.0,-68549.12
buyer_2,Aitxiber,Beitia,1984-09-05,35972942E,aitxiber.beitia@extremecode.io,325203,ES33209505222907029444,5037.33,2024-05-06T14:44:06,Gernika,expenses,gas,-116.71,-68665.83
buyer_2,Aitxiber,Beitia,1984-09-05,35972942E,aitxiber.beitia@extremecode.io,325203,ES33209505222907029444,5037.33,2024-05-07T16:23:22,Gernika,expenses,gas,-88.55,-68754.38
buyer_2,Aitxiber,Beitia,1984-09-05,35972942E,aitxiber.beitia@extremecode.io,325203,ES33209505222907029444,5037.33,2024-05-07T08:46:02,Gernika,expenses,internet,-43.52,-68797.9
buyer_2,Aitxiber,Beitia,1984-09-05,35972942E,aitxiber.beitia@extremecode.io,325203,ES33209505222907029444,5037.33,2024-05-08T16:16:54,Gernika,expenses,electricity,-54.8,-68852.7
buyer_2,Aitxiber,Beitia,1984-09-05,35972942E,aitxiber.beitia@extremecode.io,325203,ES33209505222907029444,5037.33,2024-05-08T10:17:00,Gernika,expenses,phone,-33.36,-68886.06
buyer_2,Aitxiber,Beitia,1984-09-05,35972942E,aitxiber.beitia@extremecode.io,325203,ES33209505222907029444,5037.33,2024-05-08T11:27:11,Gernika,expenses,transport,-50.3,-68936.36
buyer_2,Aitxiber,Beitia,1984-09-05,35972942E,aitxiber.beitia@extremecode.io,325203,ES33209505222907029444,5037.33,2024-05-12T20:46:50,Gernika,expenses,food,-68.03,-69004.39
buyer_2,Aitxiber,Beitia,1984-09-05,35972942E,aitxiber.beitia@extremecode.io,325203,ES33209505222907029444,5037.33,2024-05-13T08:33:03,Gernika,expenses,food,-98.63,-69103.02
buyer_2,Aitxiber,Beitia,1984-09-05,35972942E,aitxiber.beitia@extremecode.io,325203,ES33209505222907029444,5037.33,2024-05-13T09:00:30,Gernika,expenses,repairs,-146.98,-69250.0
buyer_2,Aitxiber,Beitia,1984-09-05,35972942E,aitxiber.beitia@extremecode.io,325203,ES33209505222907029444,5037.33,2024-05-14T12:08:33,Gernika,expenses,leisure,-22.65,-69272.65
buyer_2,Aitxiber,Beitia,1984-09-05,35972942E,aitxiber.beitia@extremecode.io,325203,ES33209505222907029444,5037.33,2024-05-14T14:07:58,Gernika,expenses,cash,-100.0,-69372.65
buyer_2,Aitxiber,Beitia,1984-09-05,35972942E,aitxiber.beitia@extremecode.io,325203,ES33209505222907029444,5037.33,2024-05-17T17:02:14,Gernika,expenses,food,-92.98,-69465.63
buyer_2,Aitxiber,Beitia,1984-09-05,35972942E,aitxiber.beitia@extremecode.io,325203,ES33209505222907029444,5037.33,2024-05-20T11:30:46,Gernika,expenses,gifts,-91.57,-69557.2
buyer_2,Aitxiber,Beitia,1984-09-05,35972942E,aitxiber.beitia@extremecode.io,325203,ES33209505222907029444,5037.33,2024-05-21T13:18:52,Gernika,expenses,food,-70.41,-69627.61
buyer_2,Aitxiber,Beitia,1984-09-05,35972942E,aitxiber.beitia@extremecode.io,325203,ES33209505222907029444,5037.33,2024-05-21T20:02:07,Gernika,expenses,children,-652.57,-70280.18
buyer_2,Aitxiber,Beitia,1984-09-05,35972942E,aitxiber.beitia@extremecode.io,325203,ES33209505222907029444,5037.33,2024-05-22T14:21:15,Gernika,expenses,education,-48.3,-70328.48
buyer_2,Aitxiber,Beitia,1984-09-05,35972942E,aitxiber.beitia@extremecode.io,325203,ES33209505222907029444,5037.33,2024-05-23T13:19:42,Gernika,expenses,leisure,-43.42,-70371.9
buyer_2,Aitxiber,Beitia,1984-09-05,35972942E,aitxiber.beitia@extremecode.io,325203,ES33209505222907029444,5037.33,2024-05-25T12:55:26,Gernika,expenses,clothing,-78.08,-70449.98
buyer_2,Aitxiber,Beitia,1984-09-05,35972942E,aitxiber.beitia@extremecode.io,325203,ES33209505222907029444,5037.33,2024-05-26T10:21:44,Gernika,expenses,travel,-911.96,-71361.94
buyer_2,Aitxiber,Beitia,1984-09-05,35972942E,aitxiber.beitia@extremecode.io,325203,ES33209505222907029444,5037.33,2024-05-27T16:47:17,Gernika,expenses,transport,-79.19,-71441.13
buyer_2,Aitxiber,Beitia,1984-09-05,35972942E,aitxiber.beitia@extremecode.io,325203,ES33209505222907029444,5037.33,2024-05-29T08:08:40,Gernika,expenses,repairs,-66.52,-71507.65
buyer_2,Aitxiber,Beitia,1984-09-05,35972942E,aitxiber.beitia@extremecode.io,325203,ES33209505222907029444,5037.33,2024-05-29T19:54:03,Gernika,expenses,gifts,-687.82,-72195.47
buyer_2,Aitxiber,Beitia,1984-09-05,35972942E,aitxiber.beitia@extremecode.io,325203,ES33209505222907029444,5037.33,2024-05-30T21:21:55,Gernika,expenses,food,-79.32,-72274.79
buyer_2,Aitxiber,Beitia,1984-09-05,35972942E,aitxiber.beitia@extremecode.io,325203,ES33209505222907029444,5037.33,2024-05-30T19:10:31,Gernika,expenses,transport,-49.54,-72324.33
buyer_2,Aitxiber,Beitia,1984-09-05,35972942E,aitxiber.beitia@extremecode.io,325203,ES33209505222907029444,5037.33,2024-06-01T08:05:23,Gernika,incomes,salary,2072.19,-70252.14
buyer_2,Aitxiber,Beitia,1984-09-05,35972942E,aitxiber.beitia@extremecode.io,325203,ES33209505222907029444,5037.33,2024-06-01T08:05:23,Gernika,incomes,salary_bonus,1580.21,-68671.93
buyer_2,Aitxiber,Beitia,1984-09-05,35972942E,aitxiber.beitia@extremecode.io,325203,ES33209505222907029444,5037.33,2024-06-02T14:30:46,Gernika,expenses,taxes,-1324.56,-69996.49
buyer_2,Aitxiber,Beitia,1984-09-05,35972942E,aitxiber.beitia@extremecode.io,325203,ES33209505222907029444,5037.33,2024-06-02T21:12:36,Gernika,expenses,insurance,-413.19,-70409.68
buyer_2,Aitxiber,Beitia,1984-09-05,35972942E,aitxiber.beitia@extremecode.io,325203,ES33209505222907029444,5037.33,2024-06-02T19:55:48,Gernika,expenses,food,-68.04,-70477.72
buyer_2,Aitxiber,Beitia,1984-09-05,35972942E,aitxiber.beitia@extremecode.io,325203,ES33209505222907029444,5037.33,2024-06-05T16:05:48,Gernika,expenses,mortgage,-744.09,-71221.81
buyer_2,Aitxiber,Beitia,1984-09-05,35972942E,aitxiber.beitia@extremecode.io,325203,ES33209505222907029444,5037.33,2024-06-05T07:57:03,Gernika,expenses,repairs,-173.67,-71395.48
buyer_2,Aitxiber,Beitia,1984-09-05,35972942E,aitxiber.beitia@extremecode.io,325203,ES33209505222907029444,5037.33,2024-06-06T18:50:56,Gernika,expenses,electricity,-26.73,-71422.21
buyer_2,Aitxiber,Beitia,1984-09-05,35972942E,aitxiber.beitia@extremecode.io,325203,ES33209505222907029444,5037.33,2024-06-06T02:21:10,Gernika,expenses,gas,-83.59,-71505.8
buyer_2,Aitxiber,Beitia,1984-09-05,35972942E,aitxiber.beitia@extremecode.io,325203,ES33209505222907029444,5037.33,2024-06-06T02:58:56,Gernika,expenses,travel,-408.59,-71914.39
buyer_2,Aitxiber,Beitia,1984-09-05,35972942E,aitxiber.beitia@extremecode.io,325203,ES33209505222907029444,5037.33,2024-06-07T15:17:43,Gernika,expenses,water,-28.26,-71942.65
buyer_2,Aitxiber,Beitia,1984-09-05,35972942E,aitxiber.beitia@extremecode.io,325203,ES33209505222907029444,5037.33,2024-06-13T09:39:22,Gernika,expenses,leisure,-37.53,-71980.18
buyer_2,Aitxiber,Beitia,1984-09-05,35972942E,aitxiber.beitia@extremecode.io,325203,ES33209505222907029444,5037.33,2024-06-13T10:14:43,Gernika,expenses,cash,-100.0,-72080.18
buyer_2,Aitxiber,Beitia,1984-09-05,35972942E,aitxiber.beitia@extremecode.io,325203,ES33209505222907029444,5037.33,2024-06-16T12:09:14,Gernika,expenses,cash,-100.0,-72180.18
buyer_2,Aitxiber,Beitia,1984-09-05,35972942E,aitxiber.beitia@extremecode.io,325203,ES33209505222907029444,5037.33,2024-06-19T23:31:36,Gernika,expenses,repairs,-138.24,-72318.42
buyer_2,Aitxiber,Beitia,1984-09-05,35972942E,aitxiber.beitia@extremecode.io,325203,ES33209505222907029444,5037.33,2024-06-21T20:04:03,Gernika,expenses,cash,-100.0,-72418.42
buyer_2,Aitxiber,Beitia,1984-09-05,35972942E,aitxiber.beitia@extremecode.io,325203,ES33209505222907029444,5037.33,2024-06-22T20:55:02,Gernika,expenses,cash,-100.0,-72518.42
buyer_2,Aitxiber,Beitia,1984-09-05,35972942E,aitxiber.beitia@extremecode.io,325203,ES33209505222907029444,5037.33,2024-06-22T09:34:30,Gernika,expenses,repairs,-114.03,-72632.45
buyer_2,Aitxiber,Beitia,1984-09-05,35972942E,aitxiber.beitia@extremecode.io,325203,ES33209505222907029444,5037.33,2024-06-24T12:51:51,Gernika,expenses,gifts,-45.97,-72678.42
buyer_2,Aitxiber,Beitia,1984-09-05,35972942E,aitxiber.beitia@extremecode.io,325203,ES33209505222907029444,5037.33,2024-06-25T18:09:23,Gernika,expenses,food,-83.23,-72761.65
buyer_2,Aitxiber,Beitia,1984-09-05,35972942E,aitxiber.beitia@extremecode.io,325203,ES33209505222907029444,5037.33,2024-06-26T15:38:18,Gernika,expenses,leisure,-28.34,-72789.99
buyer_2,Aitxiber,Beitia,1984-09-05,35972942E,aitxiber.beitia@extremecode.io,325203,ES33209505222907029444,5037.33,2024-07-01T01:21:04,Gernika,incomes,salary,2072.19,-70717.8
buyer_2,Aitxiber,Beitia,1984-09-05,35972942E,aitxiber.beitia@extremecode.io,325203,ES33209505222907029444,5037.33,2024-07-01T16:41:12,Gernika,expenses,food,-79.1,-70796.9
buyer_2,Aitxiber,Beitia,1984-09-05,35972942E,aitxiber.beitia@extremecode.io,325203,ES33209505222907029444,5037.33,2024-07-03T13:37:36,Gernika,expenses,food,-119.79,-70916.69
buyer_2,Aitxiber,Beitia,1984-09-05,35972942E,aitxiber.beitia@extremecode.io,325203,ES33209505222907029444,5037.33,2024-07-03T02:15:27,Gernika,expenses,gifts,-271.81,-71188.5
buyer_2,Aitxiber,Beitia,1984-09-05,35972942E,aitxiber.beitia@extremecode.io,325203,ES33209505222907029444,5037.33,2024-07-05T19:37:56,Gernika,expenses,mortgage,-744.09,-71932.59
buyer_2,Aitxiber,Beitia,1984-09-05,35972942E,aitxiber.beitia@extremecode.io,325203,ES33209505222907029444,5037.33,2024-07-05T19:28:37,Gernika,expenses,water,-29.81,-71962.4
buyer_2,Aitxiber,Beitia,1984-09-05,35972942E,aitxiber.beitia@extremecode.io,325203,ES33209505222907029444,5037.33,2024-07-05T20:35:46,Gernika,expenses,gas,-68.2,-72030.6
buyer_2,Aitxiber,Beitia,1984-09-05,35972942E,aitxiber.beitia@extremecode.io,325203,ES33209505222907029444,5037.33,2024-07-05T19:48:11,Gernika,expenses,phone,-35.59,-72066.19
buyer_2,Aitxiber,Beitia,1984-09-05,35972942E,aitxiber.beitia@extremecode.io,325203,ES33209505222907029444,5037.33,2024-07-07T09:09:24,Gernika,expenses,electricity,-54.37,-72120.56
buyer_2,Aitxiber,Beitia,1984-09-05,35972942E,aitxiber.beitia@extremecode.io,325203,ES33209505222907029444,5037.33,2024-07-08T12:46:50,Gernika,expenses,water,-34.07,-72154.63
buyer_2,Aitxiber,Beitia,1984-09-05,35972942E,aitxiber.beitia@extremecode.io,325203,ES33209505222907029444,5037.33,2024-07-08T14:48:37,Gernika,expenses,phone,-36.02,-72190.65
buyer_2,Aitxiber,Beitia,1984-09-05,35972942E,aitxiber.beitia@extremecode.io,325203,ES33209505222907029444,5037.33,2024-07-08T08:35:18,Gernika,expenses,transport,-61.97,-72252.62
buyer_2,Aitxiber,Beitia,1984-09-05,35972942E,aitxiber.beitia@extremecode.io,325203,ES33209505222907029444,5037.33,2024-07-08T22:29:42,Gernika,expenses,leisure,-50.66,-72303.28
buyer_2,Aitxiber,Beitia,1984-09-05,35972942E,aitxiber.beitia@extremecode.io,325203,ES33209505222907029444,5037.33,2024-07-09T14:08:19,Gernika,expenses,leisure,-77.96,-72381.24
buyer_2,Aitxiber,Beitia,1984-09-05,35972942E,aitxiber.beitia@extremecode.io,325203,ES33209505222907029444,5037.33,2024-07-09T08:42:55,Gernika,expenses,cash,-100.0,-72481.24
buyer_2,Aitxiber,Beitia,1984-09-05,35972942E,aitxiber.beitia@extremecode.io,325203,ES33209505222907029444,5037.33,2024-07-10T16:00:02,Gernika,expenses,transport,-46.09,-72527.33
buyer_2,Aitxiber,Beitia,1984-09-05,35972942E,aitxiber.beitia@extremecode.io,325203,ES33209505222907029444,5037.33,2024-07-11T08:53:57,Gernika,expenses,food,-69.51,-72596.84
buyer_2,Aitxiber,Beitia,1984-09-05,35972942E,aitxiber.beitia@extremecode.io,325203,ES33209505222907029444,5037.33,2024-07-14T10:23:52,Gernika,expenses,repairs,-77.19,-72674.03
buyer_2,Aitxiber,Beitia,1984-09-05,35972942E,aitxiber.beitia@extremecode.io,325203,ES33209505222907029444,5037.33,2024-07-15T02:54:32,Gernika,expenses,food,-114.25,-72788.28
buyer_2,Aitxiber,Beitia,1984-09-05,35972942E,aitxiber.beitia@extremecode.io,325203,ES33209505222907029444,5037.33,2024-07-15T15:17:57,Gernika,expenses,cash,-100.0,-72888.28
buyer_2,Aitxiber,Beitia,1984-09-05,35972942E,aitxiber.beitia@extremecode.io,325203,ES33209505222907029444,5037.33,2024-07-16T22:46:11,Gernika,expenses,healthcare,-69.61,-72957.89
buyer_2,Aitxiber,Beitia,1984-09-05,35972942E,aitxiber.beitia@extremecode.io,325203,ES33209505222907029444,5037.33,2024-07-17T16:50:36,Gernika,expenses,appliances,-347.8,-73305.69
buyer_2,Aitxiber,Beitia,1984-09-05,35972942E,aitxiber.beitia@extremecode.io,325203,ES33209505222907029444,5037.33,2024-07-18T08:25:57,Gernika,expenses,transport,-87.4,-73393.09
buyer_2,Aitxiber,Beitia,1984-09-05,35972942E,aitxiber.beitia@extremecode.io,325203,ES33209505222907029444,5037.33,2024-07-18T10:44:38,Gernika,expenses,education,-62.11,-73455.2
buyer_2,Aitxiber,Beitia,1984-09-05,35972942E,aitxiber.beitia@extremecode.io,325203,ES33209505222907029444,5037.33,2024-07-19T19:46:56,Gernika,expenses,leisure,-58.19,-73513.39
buyer_2,Aitxiber,Beitia,1984-09-05,35972942E,aitxiber.beitia@extremecode.io,325203,ES33209505222907029444,5037.33,2024-07-19T18:17:43,Gernika,expenses,cash,-100.0,-73613.39
buyer_2,Aitxiber,Beitia,1984-09-05,35972942E,aitxiber.beitia@extremecode.io,325203,ES33209505222907029444,5037.33,2024-07-20T18:25:20,Gernika,expenses,cash,-100.0,-73713.39
buyer_2,Aitxiber,Beitia,1984-09-05,35972942E,aitxiber.beitia@extremecode.io,325203,ES33209505222907029444,5037.33,2024-07-21T10:21:50,Gernika,expenses,cash,-100.0,-73813.39
buyer_2,Aitxiber,Beitia,1984-09-05,35972942E,aitxiber.beitia@extremecode.io,325203,ES33209505222907029444,5037.33,2024-07-23T13:09:00,Gernika,expenses,food,-115.38,-73928.77
buyer_2,Aitxiber,Beitia,1984-09-05,35972942E,aitxiber.beitia@extremecode.io,325203,ES33209505222907029444,5037.33,2024-07-23T15:38:59,Gernika,expenses,transport,-64.56,-73993.33
buyer_2,Aitxiber,Beitia,1984-09-05,35972942E,aitxiber.beitia@extremecode.io,325203,ES33209505222907029444,5037.33,2024-07-26T18:27:39,Gernika,expenses,healthcare,-80.43,-74073.76
buyer_2,Aitxiber,Beitia,1984-09-05,35972942E,aitxiber.beitia@extremecode.io,325203,ES33209505222907029444,5037.33,2024-07-26T23:11:16,Gernika,expenses,cash,-100.0,-74173.76
buyer_2,Aitxiber,Beitia,1984-09-05,35972942E,aitxiber.beitia@extremecode.io,325203,ES33209505222907029444,5037.33,2024-07-27T14:30:39,Gernika,expenses,cash,-100.0,-74273.76
buyer_2,Aitxiber,Beitia,1984-09-05,35972942E,aitxiber.beitia@extremecode.io,325203,ES33209505222907029444,5037.33,2024-07-28T22:34:54,Gernika,expenses,repairs,-49.28,-74323.04
buyer_2,Aitxiber,Beitia,1984-09-05,35972942E,aitxiber.beitia@extremecode.io,325203,ES33209505222907029444,5037.33,2024-07-29T10:31:42,Gernika,expenses,food,-76.18,-74399.22
buyer_2,Aitxiber,Beitia,1984-09-05,35972942E,aitxiber.beitia@extremecode.io,325203,ES33209505222907029444,5037.33,2024-07-29T11:10:31,Gernika,expenses,education,-45.31,-74444.53
buyer_2,Aitxiber,Beitia,1984-09-05,35972942E,aitxiber.beitia@extremecode.io,325203,ES33209505222907029444,5037.33,2024-07-29T14:20:59,Gernika,expenses,travel,-667.31,-75111.84
buyer_2,Aitxiber,Beitia,1984-09-05,35972942E,aitxiber.beitia@extremecode.io,325203,ES33209505222907029444,5037.33,2024-07-30T14:51:56,Gernika,expenses,travel,-653.13,-75764.97
buyer_2,Aitxiber,Beitia,1984-09-05,35972942E,aitxiber.beitia@extremecode.io,325203,ES33209505222907029444,5037.33,2024-07-31T09:34:29,Gernika,expenses,education,-47.13,-75812.1
buyer_2,Aitxiber,Beitia,1984-09-05,35972942E,aitxiber.beitia@extremecode.io,325203,ES33209505222907029444,5037.33,2024-08-01T10:16:51,Gernika,incomes,salary,2072.19,-73739.91
buyer_2,Aitxiber,Beitia,1984-09-05,35972942E,aitxiber.beitia@extremecode.io,325203,ES33209505222907029444,5037.33,2024-08-01T10:16:51,Gernika,incomes,extra_income,380.33,-73359.58
buyer_2,Aitxiber,Beitia,1984-09-05,35972942E,aitxiber.beitia@extremecode.io,325203,ES33209505222907029444,5037.33,2024-08-01T19:00:39,Gernika,expenses,cash,-100.0,-73459.58
buyer_2,Aitxiber,Beitia,1984-09-05,35972942E,aitxiber.beitia@extremecode.io,325203,ES33209505222907029444,5037.33,2024-08-03T10:23:16,Gernika,expenses,gifts,-691.15,-74150.73
buyer_2,Aitxiber,Beitia,1984-09-05,35972942E,aitxiber.beitia@extremecode.io,325203,ES33209505222907029444,5037.33,2024-08-05T12:41:15,Gernika,expenses,mortgage,-744.09,-74894.82
buyer_2,Aitxiber,Beitia,1984-09-05,35972942E,aitxiber.beitia@extremecode.io,325203,ES33209505222907029444,5037.33,2024-08-06T08:25:14,Gernika,expenses,food,-122.06,-75016.88
buyer_2,Aitxiber,Beitia,1984-09-05,35972942E,aitxiber.beitia@extremecode.io,325203,ES33209505222907029444,5037.33,2024-08-06T08:36:56,Gernika,expenses,leisure,-79.92,-75096.8
buyer_2,Aitxiber,Beitia,1984-09-05,35972942E,aitxiber.beitia@extremecode.io,325203,ES33209505222907029444,5037.33,2024-08-07T18:41:24,Gernika,expenses,internet,-43.52,-75140.32
buyer_2,Aitxiber,Beitia,1984-09-05,35972942E,aitxiber.beitia@extremecode.io,325203,ES33209505222907029444,5037.33,2024-08-07T22:04:54,Gernika,expenses,leisure,-34.7,-75175.02
buyer_2,Aitxiber,Beitia,1984-09-05,35972942E,aitxiber.beitia@extremecode.io,325203,ES33209505222907029444,5037.33,2024-08-09T10:17:57,Gernika,expenses,leisure,-26.17,-75201.19
buyer_2,Aitxiber,Beitia,1984-09-05,35972942E,aitxiber.beitia@extremecode.io,325203,ES33209505222907029444,5037.33,2024-08-11T09:47:28,Gernika,expenses,leisure,-61.91,-75263.1
buyer_2,Aitxiber,Beitia,1984-09-05,35972942E,aitxiber.beitia@extremecode.io,325203,ES33209505222907029444,5037.33,2024-08-11T18:00:56,Gernika,expenses,gifts,-267.59,-75530.69
buyer_2,Aitxiber,Beitia,1984-09-05,35972942E,aitxiber.beitia@extremecode.io,325203,ES33209505222907029444,5037.33,2024-08-18T23:47:35,Gernika,expenses,leisure,-22.74,-75553.43
buyer_2,Aitxiber,Beitia,1984-09-05,35972942E,aitxiber.beitia@extremecode.io,325203,ES33209505222907029444,5037.33,2024-08-20T23:01:07,Gernika,expenses,food,-82.76,-75636.19
buyer_2,Aitxiber,Beitia,1984-09-05,35972942E,aitxiber.beitia@extremecode.io,325203,ES33209505222907029444,5037.33,2024-08-20T10:37:21,Gernika,expenses,gifts,-738.38,-76374.57
buyer_2,Aitxiber,Beitia,1984-09-05,35972942E,aitxiber.beitia@extremecode.io,325203,ES33209505222907029444,5037.33,2024-08-23T14:25:31,Gernika,expenses,food,-83.55,-76458.12
buyer_2,Aitxiber,Beitia,1984-09-05,35972942E,aitxiber.beitia@extremecode.io,325203,ES33209505222907029444,5037.33,2024-08-24T16:32:22,Gernika,expenses,cash,-100.0,-76558.12
buyer_2,Aitxiber,Beitia,1984-09-05,35972942E,aitxiber.beitia@extremecode.io,325203,ES33209505222907029444,5037.33,2024-08-29T11:43:50,Gernika,expenses,food,-69.98,-76628.1
buyer_2,Aitxiber,Beitia,1984-09-05,35972942E,aitxiber.beitia@extremecode.io,325203,ES33209505222907029444,5037.33,2024-08-31T19:19:11,Gernika,expenses,food,-121.07,-76749.17
buyer_2,Aitxiber,Beitia,1984-09-05,35972942E,aitxiber.beitia@extremecode.io,325203,ES33209505222907029444,5037.33,2024-09-01T13:48:31,Gernika,incomes,salary,2072.19,-74676.98
buyer_2,Aitxiber,Beitia,1984-09-05,35972942E,aitxiber.beitia@extremecode.io,325203,ES33209505222907029444,5037.33,2024-09-01T06:26:41,Gernika,expenses,healthcare,-136.01,-74812.99
buyer_2,Aitxiber,Beitia,1984-09-05,35972942E,aitxiber.beitia@extremecode.io,325203,ES33209505222907029444,5037.33,2024-09-04T21:45:10,Gernika,expenses,clothing,-48.94,-74861.93
buyer_2,Aitxiber,Beitia,1984-09-05,35972942E,aitxiber.beitia@extremecode.io,325203,ES33209505222907029444,5037.33,2024-09-04T15:49:33,Gernika,expenses,repairs,-180.47,-75042.4
buyer_2,Aitxiber,Beitia,1984-09-05,35972942E,aitxiber.beitia@extremecode.io,325203,ES33209505222907029444,5037.33,2024-09-05T12:13:01,Gernika,expenses,mortgage,-744.09,-75786.49
buyer_2,Aitxiber,Beitia,1984-09-05,35972942E,aitxiber.beitia@extremecode.io,325203,ES33209505222907029444,5037.33,2024-09-05T21:40:35,Gernika,expenses,phone,-32.02,-75818.51
buyer_2,Aitxiber,Beitia,1984-09-05,35972942E,aitxiber.beitia@extremecode.io,325203,ES33209505222907029444,5037.33,2024-09-05T12:12:17,Gernika,expenses,transport,-63.53,-75882.04
buyer_2,Aitxiber,Beitia,1984-09-05,35972942E,aitxiber.beitia@extremecode.io,325203,ES33209505222907029444,5037.33,2024-09-06T08:37:08,Gernika,expenses,gas,-98.6,-75980.64
buyer_2,Aitxiber,Beitia,1984-09-05,35972942E,aitxiber.beitia@extremecode.io,325203,ES33209505222907029444,5037.33,2024-09-07T19:40:48,Gernika,expenses,electricity,-91.02,-76071.66
buyer_2,Aitxiber,Beitia,1984-09-05,35972942E,aitxiber.beitia@extremecode.io,325203,ES33209505222907029444,5037.33,2024-09-07T10:59:34,Gernika,expenses,gas,-64.9,-76136.56
buyer_2,Aitxiber,Beitia,1984-09-05,35972942E,aitxiber.beitia@extremecode.io,325203,ES33209505222907029444,5037.33,2024-09-07T18:44:37,Gernika,expenses,clothing,-119.03,-76255.59
buyer_2,Aitxiber,Beitia,1984-09-05,35972942E,aitxiber.beitia@extremecode.io,325203,ES33209505222907029444,5037.33,2024-09-07T17:22:57,Gernika,expenses,cash,-100.0,-76355.59
buyer_2,Aitxiber,Beitia,1984-09-05,35972942E,aitxiber.beitia@extremecode.io,325203,ES33209505222907029444,5037.33,2024-09-09T20:02:19,Gernika,expenses,gifts,-421.58,-76777.17
buyer_2,Aitxiber,Beitia,1984-09-05,35972942E,aitxiber.beitia@extremecode.io,325203,ES33209505222907029444,5037.33,2024-09-10T03:46:41,Gernika,expenses,education,-55.74,-76832.91
buyer_2,Aitxiber,Beitia,1984-09-05,35972942E,aitxiber.beitia@extremecode.io,325203,ES33209505222907029444,5037.33,2024-09-10T12:49:36,Gernika,expenses,cash,-100.0,-76932.91
buyer_2,Aitxiber,Beitia,1984-09-05,35972942E,aitxiber.beitia@extremecode.io,325203,ES33209505222907029444,5037.33,2024-09-10T19:14:21,Gernika,expenses,repairs,-197.9,-77130.81
buyer_2,Aitxiber,Beitia,1984-09-05,35972942E,aitxiber.beitia@extremecode.io,325203,ES33209505222907029444,5037.33,2024-09-11T11:16:48,Gernika,expenses,transport,-59.58,-77190.39
buyer_2,Aitxiber,Beitia,1984-09-05,35972942E,aitxiber.beitia@extremecode.io,325203,ES33209505222907029444,5037.33,2024-09-12T08:13:58,Gernika,expenses,leisure,-19.87,-77210.26
buyer_2,Aitxiber,Beitia,1984-09-05,35972942E,aitxiber.beitia@extremecode.io,325203,ES33209505222907029444,5037.33,2024-09-12T13:55:21,Gernika,expenses,cash,-100.0,-77310.26
buyer_2,Aitxiber,Beitia,1984-09-05,35972942E,aitxiber.beitia@extremecode.io,325203,ES33209505222907029444,5037.33,2024-09-13T10:32:18,Gernika,expenses,leisure,-72.96,-77383.22
buyer_2,Aitxiber,Beitia,1984-09-05,35972942E,aitxiber.beitia@extremecode.io,325203,ES33209505222907029444,5037.33,2024-09-16T11:52:33,Gernika,expenses,transport,-45.25,-77428.47
buyer_2,Aitxiber,Beitia,1984-09-05,35972942E,aitxiber.beitia@extremecode.io,325203,ES33209505222907029444,5037.33,2024-09-16T02:33:29,Gernika,expenses,cash,-100.0,-77528.47
buyer_2,Aitxiber,Beitia,1984-09-05,35972942E,aitxiber.beitia@extremecode.io,325203,ES33209505222907029444,5037.33,2024-09-17T15:06:40,Gernika,expenses,food,-70.09,-77598.56
buyer_2,Aitxiber,Beitia,1984-09-05,35972942E,aitxiber.beitia@extremecode.io,325203,ES33209505222907029444,5037.33,2024-09-19T11:13:58,Gernika,expenses,leisure,-31.67,-77630.23
buyer_2,Aitxiber,Beitia,1984-09-05,35972942E,aitxiber.beitia@extremecode.io,325203,ES33209505222907029444,5037.33,2024-09-20T19:40:49,Gernika,expenses,transport,-42.89,-77673.12
buyer_2,Aitxiber,Beitia,1984-09-05,35972942E,aitxiber.beitia@extremecode.io,325203,ES33209505222907029444,5037.33,2024-09-20T09:29:18,Gernika,expenses,repairs,-232.68,-77905.8
buyer_2,Aitxiber,Beitia,1984-09-05,35972942E,aitxiber.beitia@extremecode.io,325203,ES33209505222907029444,5037.33,2024-09-21T11:37:10,Gernika,expenses,transport,-49.93,-77955.73
buyer_2,Aitxiber,Beitia,1984-09-05,35972942E,aitxiber.beitia@extremecode.io,325203,ES33209505222907029444,5037.33,2024-09-22T13:24:32,Gernika,expenses,education,-42.46,-77998.19
buyer_2,Aitxiber,Beitia,1984-09-05,35972942E,aitxiber.beitia@extremecode.io,325203,ES33209505222907029444,5037.33,2024-09-23T13:47:32,Gernika,expenses,repairs,-209.22,-78207.41
buyer_2,Aitxiber,Beitia,1984-09-05,35972942E,aitxiber.beitia@extremecode.io,325203,ES33209505222907029444,5037.33,2024-09-24T11:56:39,Gernika,expenses,food,-90.09,-78297.5
buyer_2,Aitxiber,Beitia,1984-09-05,35972942E,aitxiber.beitia@extremecode.io,325203,ES33209505222907029444,5037.33,2024-09-24T01:51:07,Gernika,expenses,transport,-80.38,-78377.88
buyer_2,Aitxiber,Beitia,1984-09-05,35972942E,aitxiber.beitia@extremecode.io,325203,ES33209505222907029444,5037.33,2024-09-24T13:52:04,Gernika,expenses,leisure,-54.74,-78432.62
buyer_2,Aitxiber,Beitia,1984-09-05,35972942E,aitxiber.beitia@extremecode.io,325203,ES33209505222907029444,5037.33,2024-09-24T08:18:34,Gernika,expenses,clothing,-46.2,-78478.82
buyer_2,Aitxiber,Beitia,1984-09-05,35972942E,aitxiber.beitia@extremecode.io,325203,ES33209505222907029444,5037.33,2024-09-25T16:41:50,Gernika,expenses,cash,-100.0,-78578.82
buyer_2,Aitxiber,Beitia,1984-09-05,35972942E,aitxiber.beitia@extremecode.io,325203,ES33209505222907029444,5037.33,2024-09-25T12:04:31,Gernika,expenses,travel,-517.78,-79096.6
buyer_2,Aitxiber,Beitia,1984-09-05,35972942E,aitxiber.beitia@extremecode.io,325203,ES33209505222907029444,5037.33,2024-09-26T09:50:43,Gernika,expenses,leisure,-24.71,-79121.31
buyer_2,Aitxiber,Beitia,1984-09-05,35972942E,aitxiber.beitia@extremecode.io,325203,ES33209505222907029444,5037.33,2024-09-27T20:11:58,Gernika,expenses,children,-162.01,-79283.32
buyer_2,Aitxiber,Beitia,1984-09-05,35972942E,aitxiber.beitia@extremecode.io,325203,ES33209505222907029444,5037.33,2024-09-28T02:22:57,Gernika,expenses,food,-89.26,-79372.58
buyer_2,Aitxiber,Beitia,1984-09-05,35972942E,aitxiber.beitia@extremecode.io,325203,ES33209505222907029444,5037.33,2024-09-28T12:04:14,Gernika,expenses,education,-76.9,-79449.48
buyer_2,Aitxiber,Beitia,1984-09-05,35972942E,aitxiber.beitia@extremecode.io,325203,ES33209505222907029444,5037.33,2024-09-29T10:31:19,Gernika,expenses,transport,-70.72,-79520.2
buyer_2,Aitxiber,Beitia,1984-09-05,35972942E,aitxiber.beitia@extremecode.io,325203,ES33209505222907029444,5037.33,2024-09-30T20:48:51,Gernika,expenses,leisure,-37.56,-79557.76
buyer_2,Aitxiber,Beitia,1984-09-05,35972942E,aitxiber.beitia@extremecode.io,325203,ES33209505222907029444,5037.33,2024-10-01T12:15:13,Gernika,incomes,salary,2072.19,-77485.57
buyer_2,Aitxiber,Beitia,1984-09-05,35972942E,aitxiber.beitia@extremecode.io,325203,ES33209505222907029444,5037.33,2024-10-02T09:23:55,Gernika,expenses,food,-63.47,-77549.04
buyer_2,Aitxiber,Beitia,1984-09-05,35972942E,aitxiber.beitia@extremecode.io,325203,ES33209505222907029444,5037.33,2024-10-02T14:03:24,Gernika,expenses,clothing,-128.61,-77677.65
buyer_2,Aitxiber,Beitia,1984-09-05,35972942E,aitxiber.beitia@extremecode.io,325203,ES33209505222907029444,5037.33,2024-10-02T14:56:06,Gernika,expenses,education,-73.83,-77751.48
buyer_2,Aitxiber,Beitia,1984-09-05,35972942E,aitxiber.beitia@extremecode.io,325203,ES33209505222907029444,5037.33,2024-10-03T12:13:45,Gernika,expenses,clothing,-74.95,-77826.43
buyer_2,Aitxiber,Beitia,1984-09-05,35972942E,aitxiber.beitia@extremecode.io,325203,ES33209505222907029444,5037.33,2024-10-03T02:37:08,Gernika,expenses,cash,-100.0,-77926.43
buyer_2,Aitxiber,Beitia,1984-09-05,35972942E,aitxiber.beitia@extremecode.io,325203,ES33209505222907029444,5037.33,2024-10-04T18:07:56,Gernika,expenses,cash,-100.0,-78026.43
buyer_2,Aitxiber,Beitia,1984-09-05,35972942E,aitxiber.beitia@extremecode.io,325203,ES33209505222907029444,5037.33,2024-10-05T19:59:09,Gernika,expenses,mortgage,-744.09,-78770.52
buyer_2,Aitxiber,Beitia,1984-09-05,35972942E,aitxiber.beitia@extremecode.io,325203,ES33209505222907029444,5037.33,2024-10-05T09:46:15,Gernika,expenses,education,-64.54,-78835.06
buyer_2,Aitxiber,Beitia,1984-09-05,35972942E,aitxiber.beitia@extremecode.io,325203,ES33209505222907029444,5037.33,2024-10-06T11:46:24,Gernika,expenses,transport,-58.74,-78893.8
buyer_2,Aitxiber,Beitia,1984-09-05,35972942E,aitxiber.beitia@extremecode.io,325203,ES33209505222907029444,5037.33,2024-10-06T19:05:14,Gernika,expenses,appliances,-325.12,-79218.92
buyer_2,Aitxiber,Beitia,1984-09-05,35972942E,aitxiber.beitia@extremecode.io,325203,ES33209505222907029444,5037.33,2024-10-06T08:32:14,Gernika,expenses,children,-580.6548333333334,-79799.57
buyer_2,Aitxiber,Beitia,1984-09-05,35972942E,aitxiber.beitia@extremecode.io,325203,ES33209505222907029444,5037.33,2024-10-07T06:43:23,Gernika,expenses,electricity,-50.37,-79849.94
buyer_2,Aitxiber,Beitia,1984-09-05,35972942E,aitxiber.beitia@extremecode.io,325203,ES33209505222907029444,5037.33,2024-10-07T12:42:47,Gernika,expenses,gas,-66.2,-79916.14
buyer_2,Aitxiber,Beitia,1984-09-05,35972942E,aitxiber.beitia@extremecode.io,325203,ES33209505222907029444,5037.33,2024-10-08T09:39:39,Gernika,expenses,gas,-60.04,-79976.18
buyer_2,Aitxiber,Beitia,1984-09-05,35972942E,aitxiber.beitia@extremecode.io,325203,ES33209505222907029444,5037.33,2024-10-08T10:31:03,Gernika,expenses,phone,-35.29,-80011.47
buyer_2,Aitxiber,Beitia,1984-09-05,35972942E,aitxiber.beitia@extremecode.io,325203,ES33209505222907029444,5037.33,2024-10-08T18:47:57,Gernika,expenses,food,-61.99,-80073.46
buyer_2,Aitxiber,Beitia,1984-09-05,35972942E,aitxiber.beitia@extremecode.io,325203,ES33209505222907029444,5037.33,2024-10-08T17:51:30,Gernika,expenses,cash,-100.0,-80173.46
buyer_2,Aitxiber,Beitia,1984-09-05,35972942E,aitxiber.beitia@extremecode.io,325203,ES33209505222907029444,5037.33,2024-10-09T12:17:43,Gernika,expenses,clothing,-99.97,-80273.43
buyer_2,Aitxiber,Beitia,1984-09-05,35972942E,aitxiber.beitia@extremecode.io,325203,ES33209505222907029444,5037.33,2024-10-09T10:56:39,Gernika,expenses,travel,-325.07,-80598.5
buyer_3,Ana,Etxebarria,1989-08-23,49614208B,ana.etxebarria@megaapp.online,286945,ES22209500845884487347,6753.85,2022-01-01T11:08:35,Vitoria-Gasteiz,incomes,salary,3138.75,9892.6
buyer_3,Ana,Etxebarria,1989-08-23,49614208B,ana.etxebarria@megaapp.online,286945,ES22209500845884487347,6753.85,2022-01-01T11:08:35,Vitoria-Gasteiz,incomes,salary_partner,3762.16,13654.76
buyer_3,Ana,Etxebarria,1989-08-23,49614208B,ana.etxebarria@megaapp.online,286945,ES22209500845884487347,6753.85,2022-01-01T18:25:07,Vitoria-Gasteiz,expenses,leisure,-50.76,13604.0
buyer_3,Ana,Etxebarria,1989-08-23,49614208B,ana.etxebarria@megaapp.online,286945,ES22209500845884487347,6753.85,2022-01-02T20:43:39,Vitoria-Gasteiz,expenses,cash,-100.0,13504.0
buyer_3,Ana,Etxebarria,1989-08-23,49614208B,ana.etxebarria@megaapp.online,286945,ES22209500845884487347,6753.85,2022-01-02T21:23:49,Vitoria-Gasteiz,expenses,gifts,-313.79,13190.21
buyer_3,Ana,Etxebarria,1989-08-23,49614208B,ana.etxebarria@megaapp.online,286945,ES22209500845884487347,6753.85,2022-01-05T12:43:56,Vitoria-Gasteiz,expenses,mortgage,-3471.8,9718.41
buyer_3,Ana,Etxebarria,1989-08-23,49614208B,ana.etxebarria@megaapp.online,286945,ES22209500845884487347,6753.85,2022-01-05T18:42:10,Vitoria-Gasteiz,expenses,phone,-112.4,9606.01
buyer_3,Ana,Etxebarria,1989-08-23,49614208B,ana.etxebarria@megaapp.online,286945,ES22209500845884487347,6753.85,2022-01-06T10:10:37,Vitoria-Gasteiz,expenses,water,-147.78,9458.23
buyer_3,Ana,Etxebarria,1989-08-23,49614208B,ana.etxebarria@megaapp.online,286945,ES22209500845884487347,6753.85,2022-01-06T15:06:49,Vitoria-Gasteiz,expenses,cash,-100.0,9358.23
buyer_3,Ana,Etxebarria,1989-08-23,49614208B,ana.etxebarria@megaapp.online,286945,ES22209500845884487347,6753.85,2022-01-06T09:20:26,Vitoria-Gasteiz,expenses,repairs,-265.81,9092.42
buyer_3,Ana,Etxebarria,1989-08-23,49614208B,ana.etxebarria@megaapp.online,286945,ES22209500845884487347,6753.85,2022-01-07T11:31:25,Vitoria-Gasteiz,expenses,gas,-148.09,8944.33
buyer_3,Ana,Etxebarria,1989-08-23,49614208B,ana.etxebarria@megaapp.online,286945,ES22209500845884487347,6753.85,2022-01-07T23:18:19,Vitoria-Gasteiz,expenses,phone,-104.96,8839.37
buyer_3,Ana,Etxebarria,1989-08-23,49614208B,ana.etxebarria@megaapp.online,286945,ES22209500845884487347,6753.85,2022-01-07T19:40:33,Vitoria-Gasteiz,expenses,food,-96.68,8742.69
buyer_3,Ana,Etxebarria,1989-08-23,49614208B,ana.etxebarria@megaapp.online,286945,ES22209500845884487347,6753.85,2022-01-08T17:18:27,Vitoria-Gasteiz,expenses,gas,-355.92,8386.77
buyer_3,Ana,Etxebarria,1989-08-23,49614208B,ana.etxebarria@megaapp.online,286945,ES22209500845884487347,6753.85,2022-01-08T01:42:15,Vitoria-Gasteiz,expenses,phone,-140.01,8246.76
buyer_3,Ana,Etxebarria,1989-08-23,49614208B,ana.etxebarria@megaapp.online,286945,ES22209500845884487347,6753.85,2022-01-08T22:19:35,Vitoria-Gasteiz,expenses,transport,-43.32,8203.44
buyer_3,Ana,Etxebarria,1989-08-23,49614208B,ana.etxebarria@megaapp.online,286945,ES22209500845884487347,6753.85,2022-01-11T15:01:50,Vitoria-Gasteiz,expenses,food,-91.38,8112.06
buyer_3,Ana,Etxebarria,1989-08-23,49614208B,ana.etxebarria@megaapp.online,286945,ES22209500845884487347,6753.85,2022-01-12T02:42:46,Vitoria-Gasteiz,expenses,transport,-71.13,8040.93
buyer_3,Ana,Etxebarria,1989-08-23,49614208B,ana.etxebarria@megaapp.online,286945,ES22209500845884487347,6753.85,2022-01-13T10:07:44,Vitoria-Gasteiz,expenses,leisure,-32.71,8008.22
buyer_3,Ana,Etxebarria,1989-08-23,49614208B,ana.etxebarria@megaapp.online,286945,ES22209500845884487347,6753.85,2022-01-13T16:22:25,Vitoria-Gasteiz,expenses,healthcare,-67.47,7940.75
buyer_3,Ana,Etxebarria,1989-08-23,49614208B,ana.etxebarria@megaapp.online,286945,ES22209500845884487347,6753.85,2022-01-15T17:20:17,Vitoria-Gasteiz,expenses,food,-106.34,7834.41
buyer_3,Ana,Etxebarria,1989-08-23,49614208B,ana.etxebarria@megaapp.online,286945,ES22209500845884487347,6753.85,2022-01-16T09:31:17,Vitoria-Gasteiz,expenses,leisure,-84.53,7749.88
buyer_3,Ana,Etxebarria,1989-08-23,49614208B,ana.etxebarria@megaapp.online,286945,ES22209500845884487347,6753.85,2022-01-16T02:10:03,Vitoria-Gasteiz,expenses,cash,-100.0,7649.88
buyer_3,Ana,Etxebarria,1989-08-23,49614208B,ana.etxebarria@megaapp.online,286945,ES22209500845884487347,6753.85,2022-01-16T20:57:05,Vitoria-Gasteiz,expenses,gifts,-244.68,7405.2
buyer_3,Ana,Etxebarria,1989-08-23,49614208B,ana.etxebarria@megaapp.online,286945,ES22209500845884487347,6753.85,2022-01-17T19:35:09,Vitoria-Gasteiz,expenses,food,-85.0,7320.2
buyer_3,Ana,Etxebarria,1989-08-23,49614208B,ana.etxebarria@megaapp.online,286945,ES22209500845884487347,6753.85,2022-01-17T10:12:29,Vitoria-Gasteiz,expenses,clothing,-98.59,7221.61
buyer_3,Ana,Etxebarria,1989-08-23,49614208B,ana.etxebarria@megaapp.online,286945,ES22209500845884487347,6753.85,2022-01-17T18:08:12,Vitoria-Gasteiz,expenses,repairs,-252.62,6968.99
buyer_3,Ana,Etxebarria,1989-08-23,49614208B,ana.etxebarria@megaapp.online,286945,ES22209500845884487347,6753.85,2022-01-22T08:51:30,Vitoria-Gasteiz,expenses,leisure,-59.49,6909.5
buyer_3,Ana,Etxebarria,1989-08-23,49614208B,ana.etxebarria@megaapp.online,286945,ES22209500845884487347,6753.85,2022-01-22T23:27:13,Vitoria-Gasteiz,expenses,cash,-100.0,6809.5
buyer_3,Ana,Etxebarria,1989-08-23,49614208B,ana.etxebarria@megaapp.online,286945,ES22209500845884487347,6753.85,2022-01-23T10:22:05,Vitoria-Gasteiz,expenses,gifts,-197.84,6611.66
buyer_3,Ana,Etxebarria,1989-08-23,49614208B,ana.etxebarria@megaapp.online,286945,ES22209500845884487347,6753.85,2022-01-25T11:11:15,Vitoria-Gasteiz,expenses,repairs,-270.46,6341.2
buyer_3,Ana,Etxebarria,1989-08-23,49614208B,ana.etxebarria@megaapp.online,286945,ES22209500845884487347,6753.85,2022-01-28T13:25:32,Vitoria-Gasteiz,expenses,cash,-100.0,6241.2
buyer_3,Ana,Etxebarria,1989-08-23,49614208B,ana.etxebarria@megaapp.online,286945,ES22209500845884487347,6753.85,2022-01-28T19:15:49,Vitoria-Gasteiz,expenses,appliances,-223.8,6017.4
buyer_3,Ana,Etxebarria,1989-08-23,49614208B,ana.etxebarria@megaapp.online,286945,ES22209500845884487347,6753.85,2022-01-30T17:24:06,Vitoria-Gasteiz,expenses,clothing,-150.76,5866.64
buyer_3,Ana,Etxebarria,1989-08-23,49614208B,ana.etxebarria@megaapp.online,286945,ES22209500845884487347,6753.85,2022-02-01T20:50:18,Vitoria-Gasteiz,incomes,salary,3138.75,9005.39
buyer_3,Ana,Etxebarria,1989-08-23,49614208B,ana.etxebarria@megaapp.online,286945,ES22209500845884487347,6753.85,2022-02-01T20:50:18,Vitoria-Gasteiz,incomes,salary_partner,3762.16,12767.55
buyer_3,Ana,Etxebarria,1989-08-23,49614208B,ana.etxebarria@megaapp.online,286945,ES22209500845884487347,6753.85,2022-02-03T18:09:57,Vitoria-Gasteiz,expenses,education,-60.92,12706.63
buyer_3,Ana,Etxebarria,1989-08-23,49614208B,ana.etxebarria@megaapp.online,286945,ES22209500845884487347,6753.85,2022-02-03T17:09:26,Vitoria-Gasteiz,expenses,cash,-100.0,12606.63
buyer_3,Ana,Etxebarria,1989-08-23,49614208B,ana.etxebarria@megaapp.online,286945,ES22209500845884487347,6753.85,2022-02-04T13:10:51,Vitoria-Gasteiz,expenses,leisure,-55.77,12550.86
buyer_3,Ana,Etxebarria,1989-08-23,49614208B,ana.etxebarria@megaapp.online,286945,ES22209500845884487347,6753.85,2022-02-05T11:16:28,Vitoria-Gasteiz,expenses,mortgage,-3471.8,9079.06
buyer_3,Ana,Etxebarria,1989-08-23,49614208B,ana.etxebarria@megaapp.online,286945,ES22209500845884487347,6753.85,2022-02-05T08:43:05,Vitoria-Gasteiz,expenses,healthcare,-64.91,9014.15
buyer_3,Ana,Etxebarria,1989-08-23,49614208B,ana.etxebarria@megaapp.online,286945,ES22209500845884487347,6753.85,2022-02-05T12:27:53,Vitoria-Gasteiz,expenses,repairs,-194.09,8820.06
buyer_3,Ana,Etxebarria,1989-08-23,49614208B,ana.etxebarria@megaapp.online,286945,ES22209500845884487347,6753.85,2022-02-06T18:22:37,Vitoria-Gasteiz,expenses,electricity,-290.76,8529.3
buyer_3,Ana,Etxebarria,1989-08-23,49614208B,ana.etxebarria@megaapp.online,286945,ES22209500845884487347,6753.85,2022-02-06T18:18:57,Vitoria-Gasteiz,expenses,internet,-144.92,8384.38
buyer_3,Ana,Etxebarria,1989-08-23,49614208B,ana.etxebarria@megaapp.online,286945,ES22209500845884487347,6753.85,2022-02-06T11:24:30,Vitoria-Gasteiz,expenses,healthcare,-140.68,8243.7
buyer_3,Ana,Etxebarria,1989-08-23,49614208B,ana.etxebarria@megaapp.online,286945,ES22209500845884487347,6753.85,2022-02-07T08:35:40,Vitoria-Gasteiz,expenses,electricity,-196.38,8047.32
buyer_3,Ana,Etxebarria,1989-08-23,49614208B,ana.etxebarria@megaapp.online,286945,ES22209500845884487347,6753.85,2022-02-07T12:22:04,Vitoria-Gasteiz,expenses,internet,-144.92,7902.4
buyer_3,Ana,Etxebarria,1989-08-23,49614208B,ana.etxebarria@megaapp.online,286945,ES22209500845884487347,6753.85,2022-02-08T12:10:18,Vitoria-Gasteiz,expenses,water,-118.88,7783.52
buyer_3,Ana,Etxebarria,1989-08-23,49614208B,ana.etxebarria@megaapp.online,286945,ES22209500845884487347,6753.85,2022-02-08T11:45:57,Vitoria-Gasteiz,expenses,electricity,-101.24,7682.28
buyer_3,Ana,Etxebarria,1989-08-23,49614208B,ana.etxebarria@megaapp.online,286945,ES22209500845884487347,6753.85,2022-02-08T20:48:54,Vitoria-Gasteiz,expenses,transport,-86.49,7595.79
buyer_3,Ana,Etxebarria,1989-08-23,49614208B,ana.etxebarria@megaapp.online,286945,ES22209500845884487347,6753.85,2022-02-08T11:31:03,Vitoria-Gasteiz,expenses,education,-72.31,7523.48
buyer_3,Ana,Etxebarria,1989-08-23,49614208B,ana.etxebarria@megaapp.online,286945,ES22209500845884487347,6753.85,2022-02-08T08:03:07,Vitoria-Gasteiz,expenses,cash,-100.0,7423.48
buyer_3,Ana,Etxebarria,1989-08-23,49614208B,ana.etxebarria@megaapp.online,286945,ES22209500845884487347,6753.85,2022-02-08T18:33:21,Vitoria-Gasteiz,expenses,repairs,-283.46,7140.02
buyer_3,Ana,Etxebarria,1989-08-23,49614208B,ana.etxebarria@megaapp.online,286945,ES22209500845884487347,6753.85,2022-02-10T20:35:55,Vitoria-Gasteiz,expenses,leisure,-70.72,7069.3
buyer_3,Ana,Etxebarria,1989-08-23,49614208B,ana.etxebarria@megaapp.online,286945,ES22209500845884487347,6753.85,2022-02-11T17:42:56,Vitoria-Gasteiz,expenses,food,-123.0,6946.3
buyer_3,Ana,Etxebarria,1989-08-23,49614208B,ana.etxebarria@megaapp.online,286945,ES22209500845884487347,6753.85,2022-02-11T16:47:19,Vitoria-Gasteiz,expenses,leisure,-28.36,6917.94
buyer_3,Ana,Etxebarria,1989-08-23,49614208B,ana.etxebarria@megaapp.online,286945,ES22209500845884487347,6753.85,2022-02-15T17:50:16,Vitoria-Gasteiz,expenses,education,-43.86,6874.08
buyer_3,Ana,Etxebarria,1989-08-23,49614208B,ana.etxebarria@megaapp.online,286945,ES22209500845884487347,6753.85,2022-02-16T15:08:33,Vitoria-Gasteiz,expenses,food,-66.34,6807.74
buyer_3,Ana,Etxebarria,1989-08-23,49614208B,ana.etxebarria@megaapp.online,286945,ES22209500845884487347,6753.85,2022-02-16T14:47:28,Vitoria-Gasteiz,expenses,leisure,-56.59,6751.15
buyer_3,Ana,Etxebarria,1989-08-23,49614208B,ana.etxebarria@megaapp.online,286945,ES22209500845884487347,6753.85,2022-02-16T13:53:32,Vitoria-Gasteiz,expenses,healthcare,-118.39,6632.76
buyer_3,Ana,Etxebarria,1989-08-23,49614208B,ana.etxebarria@megaapp.online,286945,ES22209500845884487347,6753.85,2022-02-19T08:13:52,Vitoria-Gasteiz,expenses,food,-89.59,6543.17
buyer_3,Ana,Etxebarria,1989-08-23,49614208B,ana.etxebarria@megaapp.online,286945,ES22209500845884487347,6753.85,2022-02-19T17:17:03,Vitoria-Gasteiz,expenses,leisure,-64.97,6478.2
buyer_3,Ana,Etxebarria,1989-08-23,49614208B,ana.etxebarria@megaapp.online,286945,ES22209500845884487347,6753.85,2022-02-19T23:57:23,Vitoria-Gasteiz,expenses,appliances,-391.14,6087.06
buyer_3,Ana,Etxebarria,1989-08-23,49614208B,ana.etxebarria@megaapp.online,286945,ES22209500845884487347,6753.85,2022-02-20T13:45:03,Vitoria-Gasteiz,expenses,leisure,-72.97,6014.09
buyer_3,Ana,Etxebarria,1989-08-23,49614208B,ana.etxebarria@megaapp.online,286945,ES22209500845884487347,6753.85,2022-02-22T13:07:17,Vitoria-Gasteiz,expenses,education,-42.64,5971.45
buyer_3,Ana,Etxebarria,1989-08-23,49614208B,ana.etxebarria@megaapp.online,286945,ES22209500845884487347,6753.85,2022-02-23T12:38:06,Vitoria-Gasteiz,expenses,food,-70.91,5900.54
buyer_3,Ana,Etxebarria,1989-08-23,49614208B,ana.etxebarria@megaapp.online,286945,ES22209500845884487347,6753.85,2022-02-23T08:10:39,Vitoria-Gasteiz,expenses,transport,-61.28,5839.26
buyer_3,Ana,Etxebarria,1989-08-23,49614208B,ana.etxebarria@megaapp.online,286945,ES22209500845884487347,6753.85,2022-02-24T02:56:32,Vitoria-Gasteiz,expenses,travel,-966.77,4872.49
buyer_3,Ana,Etxebarria,1989-08-23,49614208B,ana.etxebarria@megaapp.online,286945,ES22209500845884487347,6753.85,2022-02-26T09:48:42,Vitoria-Gasteiz,expenses,transport,-76.28,4796.21
buyer_3,Ana,Etxebarria,1989-08-23,49614208B,ana.etxebarria@megaapp.online,286945,ES22209500845884487347,6753.85,2022-03-01T18:49:12,Vitoria-Gasteiz,incomes,salary,3138.75,7934.96
buyer_3,Ana,Etxebarria,1989-08-23,49614208B,ana.etxebarria@megaapp.online,286945,ES22209500845884487347,6753.85,2022-03-01T18:49:12,Vitoria-Gasteiz,incomes,salary_partner,3762.16,11697.12
buyer_3,Ana,Etxebarria,1989-08-23,49614208B,ana.etxebarria@megaapp.online,286945,ES22209500845884487347,6753.85,2022-03-03T10:46:52,Vitoria-Gasteiz,expenses,leisure,-52.73,11644.39
buyer_3,Ana,Etxebarria,1989-08-23,49614208B,ana.etxebarria@megaapp.online,286945,ES22209500845884487347,6753.85,2022-03-03T19:59:10,Vitoria-Gasteiz,expenses,clothing,-121.38,11523.01
buyer_3,Ana,Etxebarria,1989-08-23,49614208B,ana.etxebarria@megaapp.online,286945,ES22209500845884487347,6753.85,2022-03-03T14:33:14,Vitoria-Gasteiz,expenses,appliances,-179.86,11343.15
buyer_3,Ana,Etxebarria,1989-08-23,49614208B,ana.etxebarria@megaapp.online,286945,ES22209500845884487347,6753.85,2022-03-04T08:43:20,Vitoria-Gasteiz,expenses,food,-80.74,11262.41
buyer_3,Ana,Etxebarria,1989-08-23,49614208B,ana.etxebarria@megaapp.online,286945,ES22209500845884487347,6753.85,2022-03-04T15:37:31,Vitoria-Gasteiz,expenses,healthcare,-114.72,11147.69
buyer_3,Ana,Etxebarria,1989-08-23,49614208B,ana.etxebarria@megaapp.online,286945,ES22209500845884487347,6753.85,2022-03-05T20:57:33,Vitoria-Gasteiz,expenses,mortgage,-3471.8,7675.89
buyer_3,Ana,Etxebarria,1989-08-23,49614208B,ana.etxebarria@megaapp.online,286945,ES22209500845884487347,6753.85,2022-03-05T14:51:14,Vitoria-Gasteiz,expenses,water,-110.25,7565.64
buyer_3,Ana,Etxebarria,1989-08-23,49614208B,ana.etxebarria@megaapp.online,286945,ES22209500845884487347,6753.85,2022-03-05T17:44:54,Vitoria-Gasteiz,expenses,gas,-135.73,7429.91
buyer_3,Ana,Etxebarria,1989-08-23,49614208B,ana.etxebarria@megaapp.online,286945,ES22209500845884487347,6753.85,2022-03-05T11:15:08,Vitoria-Gasteiz,expenses,phone,-118.6,7311.31
buyer_3,Ana,Etxebarria,1989-08-23,49614208B,ana.etxebarria@megaapp.online,286945,ES22209500845884487347,6753.85,2022-03-06T06:20:32,Vitoria-Gasteiz,expenses,leisure,-58.24,7253.07
buyer_3,Ana,Etxebarria,1989-08-23,49614208B,ana.etxebarria@megaapp.online,286945,ES22209500845884487347,6753.85,2022-03-08T15:04:41,Vitoria-Gasteiz,expenses,appliances,-154.83,7098.24
buyer_3,Ana,Etxebarria,1989-08-23,49614208B,ana.etxebarria@megaapp.online,286945,ES22209500845884487347,6753.85,2022-03-08T15:13:31,Vitoria-Gasteiz,expenses,gifts,-785.15,6313.09
buyer_3,Ana,Etxebarria,1989-08-23,49614208B,ana.etxebarria@megaapp.online,286945,ES22209500845884487347,6753.85,2022-03-09T15:02:43,Vitoria-Gasteiz,expenses,transport,-54.83,6258.26
buyer_3,Ana,Etxebarria,1989-08-23,49614208B,ana.etxebarria@megaapp.online,286945,ES22209500845884487347,6753.85,2022-03-10T17:50:33,Vitoria-Gasteiz,expenses,repairs,-48.72,6209.54
buyer_3,Ana,Etxebarria,1989-08-23,49614208B,ana.etxebarria@megaapp.online,286945,ES22209500845884487347,6753.85,2022-03-11T20:08:03,Vitoria-Gasteiz,expenses,food,-105.5,6104.04
buyer_3,Ana,Etxebarria,1989-08-23,49614208B,ana.etxebarria@megaapp.online,286945,ES22209500845884487347,6753.85,2022-03-11T03:31:49,Vitoria-Gasteiz,expenses,education,-71.79,6032.25
buyer_3,Ana,Etxebarria,1989-08-23,49614208B,ana.etxebarria@megaapp.online,286945,ES22209500845884487347,6753.85,2022-03-12T17:28:09,Vitoria-Gasteiz,expenses,transport,-44.65,5987.6
buyer_3,Ana,Etxebarria,1989-08-23,49614208B,ana.etxebarria@megaapp.online,286945,ES22209500845884487347,6753.85,2022-03-12T15:31:25,Vitoria-Gasteiz,expenses,leisure,-50.06,5937.54
buyer_3,Ana,Etxebarria,1989-08-23,49614208B,ana.etxebarria@megaapp.online,286945,ES22209500845884487347,6753.85,2022-03-13T12:16:27,Vitoria-Gasteiz,expenses,food,-81.96,5855.58
buyer_3,Ana,Etxebarria,1989-08-23,49614208B,ana.etxebarria@megaapp.online,286945,ES22209500845884487347,6753.85,2022-03-14T17:57:55,Vitoria-Gasteiz,expenses,clothing,-65.76,5789.82
buyer_3,Ana,Etxebarria,1989-08-23,49614208B,ana.etxebarria@megaapp.online,286945,ES22209500845884487347,6753.85,2022-03-15T13:36:32,Vitoria-Gasteiz,expenses,cash,-100.0,5689.82
buyer_3,Ana,Etxebarria,1989-08-23,49614208B,ana.etxebarria@megaapp.online,286945,ES22209500845884487347,6753.85,2022-03-15T08:39:05,Vitoria-Gasteiz,expenses,repairs,-248.79,5441.03
buyer_3,Ana,Etxebarria,1989-08-23,49614208B,ana.etxebarria@megaapp.online,286945,ES22209500845884487347,6753.85,2022-03-16T12:35:44,Vitoria-Gasteiz,expenses,repairs,-195.34,5245.69
buyer_3,Ana,Etxebarria,1989-08-23,49614208B,ana.etxebarria@megaapp.online,286945,ES22209500845884487347,6753.85,2022-03-17T11:47:30,Vitoria-Gasteiz,expenses,cash,-100.0,5145.69
buyer_3,Ana,Etxebarria,1989-08-23,49614208B,ana.etxebarria@megaapp.online,286945,ES22209500845884487347,6753.85,2022-03-18T17:35:54,Vitoria-Gasteiz,expenses,food,-68.78,5076.91
buyer_3,Ana,Etxebarria,1989-08-23,49614208B,ana.etxebarria@megaapp.online,286945,ES22209500845884487347,6753.85,2022-03-18T19:17:41,Vitoria-Gasteiz,expenses,cash,-100.0,4976.91
buyer_3,Ana,Etxebarria,1989-08-23,49614208B,ana.etxebarria@megaapp.online,286945,ES22209500845884487347,6753.85,2022-03-19T18:11:58,Vitoria-Gasteiz,expenses,gifts,-425.28,4551.63
buyer_3,Ana,Etxebarria,1989-08-23,49614208B,ana.etxebarria@megaapp.online,286945,ES22209500845884487347,6753.85,2022-03-20T20:40:47,Vitoria-Gasteiz,expenses,food,-106.93,4444.7
buyer_3,Ana,Etxebarria,1989-08-23,49614208B,ana.etxebarria@megaapp.online,286945,ES22209500845884487347,6753.85,2022-03-21T16:15:34,Vitoria-Gasteiz,expenses,food,-115.97,4328.73
buyer_3,Ana,Etxebarria,1989-08-23,49614208B,ana.etxebarria@megaapp.online,286945,ES22209500845884487347,6753.85,2022-03-21T13:45:36,Vitoria-Gasteiz,expenses,leisure,-43.85,4284.88
buyer_3,Ana,Etxebarria,1989-08-23,49614208B,ana.etxebarria@megaapp.online,286945,ES22209500845884487347,6753.85,2022-03-23T16:46:57,Vitoria-Gasteiz,expenses,food,-80.4,4204.48
buyer_3,Ana,Etxebarria,1989-08-23,49614208B,ana.etxebarria@megaapp.online,286945,ES22209500845884487347,6753.85,2022-03-23T18:22:36,Vitoria-Gasteiz,expenses,cash,-100.0,4104.48
buyer_3,Ana,Etxebarria,1989-08-23,49614208B,ana.etxebarria@megaapp.online,286945,ES22209500845884487347,6753.85,2022-03-24T18:39:17,Vitoria-Gasteiz,expenses,transport,-54.04,4050.44
buyer_3,Ana,Etxebarria,1989-08-23,49614208B,ana.etxebarria@megaapp.online,286945,ES22209500845884487347,6753.85,2022-03-26T21:36:36,Vitoria-Gasteiz,expenses,food,-101.76,3948.68
buyer_3,Ana,Etxebarria,1989-08-23,49614208B,ana.etxebarria@megaapp.online,286945,ES22209500845884487347,6753.85,2022-03-26T14:52:53,Vitoria-Gasteiz,expenses,cash,-100.0,3848.68
buyer_3,Ana,Etxebarria,1989-08-23,49614208B,ana.etxebarria@megaapp.online,286945,ES22209500845884487347,6753.85,2022-03-26T14:35:41,Vitoria-Gasteiz,expenses,repairs,-202.24,3646.44
buyer_3,Ana,Etxebarria,1989-08-23,49614208B,ana.etxebarria@megaapp.online,286945,ES22209500845884487347,6753.85,2022-03-28T20:26:56,Vitoria-Gasteiz,expenses,transport,-44.05,3602.39
buyer_3,Ana,Etxebarria,1989-08-23,49614208B,ana.etxebarria@megaapp.online,286945,ES22209500845884487347,6753.85,2022-03-30T08:16:40,Vitoria-Gasteiz,expenses,cash,-100.0,3502.39
buyer_3,Ana,Etxebarria,1989-08-23,49614208B,ana.etxebarria@megaapp.online,286945,ES22209500845884487347,6753.85,2022-03-31T11:09:55,Vitoria-Gasteiz,expenses,food,-76.15,3426.24
buyer_3,Ana,Etxebarria,1989-08-23,49614208B,ana.etxebarria@megaapp.online,286945,ES22209500845884487347,6753.85,2022-04-01T20:07:01,Vitoria-Gasteiz,incomes,salary,3138.75,6564.99
buyer_3,Ana,Etxebarria,1989-08-23,49614208B,ana.etxebarria@megaapp.online,286945,ES22209500845884487347,6753.85,2022-04-01T20:07:01,Vitoria-Gasteiz,incomes,salary_partner,3762.16,10327.15
buyer_3,Ana,Etxebarria,1989-08-23,49614208B,ana.etxebarria@megaapp.online,286945,ES22209500845884487347,6753.85,2022-04-01T20:07:01,Vitoria-Gasteiz,incomes,extra_income,412.38,10739.53
buyer_3,Ana,Etxebarria,1989-08-23,49614208B,ana.etxebarria@megaapp.online,286945,ES22209500845884487347,6753.85,2022-04-01T12:27:44,Vitoria-Gasteiz,expenses,cash,-100.0,10639.53
buyer_3,Ana,Etxebarria,1989-08-23,49614208B,ana.etxebarria@megaapp.online,286945,ES22209500845884487347,6753.85,2022-04-02T23:35:14,Vitoria-Gasteiz,expenses,food,-117.19,10522.34
buyer_3,Ana,Etxebarria,1989-08-23,49614208B,ana.etxebarria@megaapp.online,286945,ES22209500845884487347,6753.85,2022-04-04T16:33:39,Vitoria-Gasteiz,expenses,leisure,-71.51,10450.83
buyer_3,Ana,Etxebarria,1989-08-23,49614208B,ana.etxebarria@megaapp.online,286945,ES22209500845884487347,6753.85,2022-04-04T08:14:07,Vitoria-Gasteiz,expenses,repairs,-253.23,10197.6
buyer_3,Ana,Etxebarria,1989-08-23,49614208B,ana.etxebarria@megaapp.online,286945,ES22209500845884487347,6753.85,2022-04-05T13:19:55,Vitoria-Gasteiz,expenses,mortgage,-3471.8,6725.8
buyer_3,Ana,Etxebarria,1989-08-23,49614208B,ana.etxebarria@megaapp.online,286945,ES22209500845884487347,6753.85,2022-04-05T01:17:58,Vitoria-Gasteiz,expenses,gas,-352.74,6373.06
buyer_3,Ana,Etxebarria,1989-08-23,49614208B,ana.etxebarria@megaapp.online,286945,ES22209500845884487347,6753.85,2022-04-05T09:26:48,Vitoria-Gasteiz,expenses,food,-120.01,6253.05
buyer_3,Ana,Etxebarria,1989-08-23,49614208B,ana.etxebarria@megaapp.online,286945,ES22209500845884487347,6753.85,2022-04-07T23:38:32,Vitoria-Gasteiz,expenses,gifts,-68.76,6184.29
buyer_3,Ana,Etxebarria,1989-08-23,49614208B,ana.etxebarria@megaapp.online,286945,ES22209500845884487347,6753.85,2022-04-08T19:15:20,Vitoria-Gasteiz,expenses,food,-66.04,6118.25
buyer_3,Ana,Etxebarria,1989-08-23,49614208B,ana.etxebarria@megaapp.online,286945,ES22209500845884487347,6753.85,2022-04-08T09:25:51,Vitoria-Gasteiz,expenses,leisure,-61.41,6056.84
buyer_3,Ana,Etxebarria,1989-08-23,49614208B,ana.etxebarria@megaapp.online,286945,ES22209500845884487347,6753.85,2022-04-11T21:25:31,Vitoria-Gasteiz,expenses,food,-87.62,5969.22
buyer_3,Ana,Etxebarria,1989-08-23,49614208B,ana.etxebarria@megaapp.online,286945,ES22209500845884487347,6753.85,2022-04-12T11:24:36,Vitoria-Gasteiz,expenses,food,-119.04,5850.18
buyer_3,Ana,Etxebarria,1989-08-23,49614208B,ana.etxebarria@megaapp.online,286945,ES22209500845884487347,6753.85,2022-04-13T10:00:13,Vitoria-Gasteiz,expenses,food,-77.55,5772.63
buyer_3,Ana,Etxebarria,1989-08-23,49614208B,ana.etxebarria@megaapp.online,286945,ES22209500845884487347,6753.85,2022-04-13T08:42:27,Vitoria-Gasteiz,expenses,leisure,-56.0,5716.63
buyer_3,Ana,Etxebarria,1989-08-23,49614208B,ana.etxebarria@megaapp.online,286945,ES22209500845884487347,6753.85,2022-04-14T18:57:07,Vitoria-Gasteiz,expenses,appliances,-137.86,5578.77
buyer_3,Ana,Etxebarria,1989-08-23,49614208B,ana.etxebarria@megaapp.online,286945,ES22209500845884487347,6753.85,2022-04-15T13:51:04,Vitoria-Gasteiz,expenses,clothing,-118.07,5460.7
buyer_3,Ana,Etxebarria,1989-08-23,49614208B,ana.etxebarria@megaapp.online,286945,ES22209500845884487347,6753.85,2022-04-16T20:18:58,Vitoria-Gasteiz,expenses,repairs,-279.73,5180.97
buyer_3,Ana,Etxebarria,1989-08-23,49614208B,ana.etxebarria@megaapp.online,286945,ES22209500845884487347,6753.85,2022-04-18T17:38:22,Vitoria-Gasteiz,expenses,food,-91.52,5089.45
buyer_3,Ana,Etxebarria,1989-08-23,49614208B,ana.etxebarria@megaapp.online,286945,ES22209500845884487347,6753.85,2022-04-18T14:17:36,Vitoria-Gasteiz,expenses,transport,-46.35,5043.1
buyer_3,Ana,Etxebarria,1989-08-23,49614208B,ana.etxebarria@megaapp.online,286945,ES22209500845884487347,6753.85,2022-04-19T15:07:44,Vitoria-Gasteiz,expenses,leisure,-81.94,4961.16
buyer_3,Ana,Etxebarria,1989-08-23,49614208B,ana.etxebarria@megaapp.online,286945,ES22209500845884487347,6753.85,2022-04-20T11:40:01,Vitoria-Gasteiz,expenses,cash,-100.0,4861.16
buyer_3,Ana,Etxebarria,1989-08-23,49614208B,ana.etxebarria@megaapp.online,286945,ES22209500845884487347,6753.85,2022-04-20T09:02:41,Vitoria-Gasteiz,expenses,repairs,-146.27,4714.89
buyer_3,Ana,Etxebarria,1989-08-23,49614208B,ana.etxebarria@megaapp.online,286945,ES22209500845884487347,6753.85,2022-04-20T14:45:20,Vitoria-Gasteiz,expenses,gifts,-228.11,4486.78
buyer_3,Ana,Etxebarria,1989-08-23,49614208B,ana.etxebarria@megaapp.online,286945,ES22209500845884487347,6753.85,2022-04-26T12:46:15,Vitoria-Gasteiz,expenses,education,-66.85,4419.93
buyer_3,Ana,Etxebarria,1989-08-23,49614208B,ana.etxebarria@megaapp.online,286945,ES22209500845884487347,6753.85,2022-04-27T14:58:09,Vitoria-Gasteiz,expenses,food,-123.5,4296.43
buyer_3,Ana,Etxebarria,1989-08-23,49614208B,ana.etxebarria@megaapp.online,286945,ES22209500845884487347,6753.85,2022-04-29T08:25:38,Vitoria-Gasteiz,expenses,transport,-40.48,4255.95
buyer_3,Ana,Etxebarria,1989-08-23,49614208B,ana.etxebarria@megaapp.online,286945,ES22209500845884487347,6753.85,2022-04-29T10:08:32,Vitoria-Gasteiz,expenses,gifts,-690.61,3565.34
buyer_3,Ana,Etxebarria,1989-08-23,49614208B,ana.etxebarria@megaapp.online,286945,ES22209500845884487347,6753.85,2022-05-01T11:05:08,Vitoria-Gasteiz,incomes,salary,3138.75,6704.09
buyer_3,Ana,Etxebarria,1989-08-23,49614208B,ana.etxebarria@megaapp.online,286945,ES22209500845884487347,6753.85,2022-05-01T11:05:08,Vitoria-Gasteiz,incomes,salary_partner,3762.16,10466.25
buyer_3,Ana,Etxebarria,1989-08-23,49614208B,ana.etxebarria@megaapp.online,286945,ES22209500845884487347,6753.85,2022-05-01T16:56:55,Vitoria-Gasteiz,expenses,education,-57.69,10408.56
buyer_3,Ana,Etxebarria,1989-08-23,49614208B,ana.etxebarria@megaapp.online,286945,ES22209500845884487347,6753.85,2022-05-02T12:04:46,Vitoria-Gasteiz,expenses,transport,-54.44,10354.12
buyer_3,Ana,Etxebarria,1989-08-23,49614208B,ana.etxebarria@megaapp.online,286945,ES22209500845884487347,6753.85,2022-05-03T15:46:24,Vitoria-Gasteiz,expenses,food,-61.78,10292.34
buyer_3,Ana,Etxebarria,1989-08-23,49614208B,ana.etxebarria@megaapp.online,286945,ES22209500845884487347,6753.85,2022-05-03T16:24:45,Vitoria-Gasteiz,expenses,gifts,-97.18,10195.16
buyer_3,Ana,Etxebarria,1989-08-23,49614208B,ana.etxebarria@megaapp.online,286945,ES22209500845884487347,6753.85,2022-05-04T10:14:35,Vitoria-Gasteiz,expenses,food,-83.51,10111.65
buyer_3,Ana,Etxebarria,1989-08-23,49614208B,ana.etxebarria@megaapp.online,286945,ES22209500845884487347,6753.85,2022-05-05T00:33:18,Vitoria-Gasteiz,expenses,mortgage,-3471.8,6639.85
buyer_3,Ana,Etxebarria,1989-08-23,49614208B,ana.etxebarria@megaapp.online,286945,ES22209500845884487347,6753.85,2022-05-07T15:07:15,Vitoria-Gasteiz,expenses,electricity,-84.87,6554.98
buyer_3,Ana,Etxebarria,1989-08-23,49614208B,ana.etxebarria@megaapp.online,286945,ES22209500845884487347,6753.85,2022-05-07T13:01:47,Vitoria-Gasteiz,expenses,internet,-144.92,6410.06
buyer_3,Ana,Etxebarria,1989-08-23,49614208B,ana.etxebarria@megaapp.online,286945,ES22209500845884487347,6753.85,2022-05-07T02:00:50,Vitoria-Gasteiz,expenses,repairs,-272.03,6138.03
buyer_3,Ana,Etxebarria,1989-08-23,49614208B,ana.etxebarria@megaapp.online,286945,ES22209500845884487347,6753.85,2022-05-08T08:13:54,Vitoria-Gasteiz,expenses,electricity,-163.21,5974.82
buyer_3,Ana,Etxebarria,1989-08-23,49614208B,ana.etxebarria@megaapp.online,286945,ES22209500845884487347,6753.85,2022-05-09T20:02:44,Vitoria-Gasteiz,expenses,food,-124.22,5850.6
buyer_3,Ana,Etxebarria,1989-08-23,49614208B,ana.etxebarria@megaapp.online,286945,ES22209500845884487347,6753.85,2022-05-09T15:49:36,Vitoria-Gasteiz,expenses,leisure,-20.39,5830.21
buyer_3,Ana,Etxebarria,1989-08-23,49614208B,ana.etxebarria@megaapp.online,286945,ES22209500845884487347,6753.85,2022-05-10T15:58:34,Vitoria-Gasteiz,expenses,food,-106.8,5723.41
buyer_3,Ana,Etxebarria,1989-08-23,49614208B,ana.etxebarria@megaapp.online,286945,ES22209500845884487347,6753.85,2022-05-11T09:18:47,Vitoria-Gasteiz,expenses,cash,-100.0,5623.41
buyer_3,Ana,Etxebarria,1989-08-23,49614208B,ana.etxebarria@megaapp.online,286945,ES22209500845884487347,6753.85,2022-05-12T09:43:12,Vitoria-Gasteiz,expenses,clothing,-61.9,5561.51
buyer_3,Ana,Etxebarria,1989-08-23,49614208B,ana.etxebarria@megaapp.online,286945,ES22209500845884487347,6753.85,2022-05-13T10:13:48,Vitoria-Gasteiz,expenses,food,-121.63,5439.88
buyer_3,Ana,Etxebarria,1989-08-23,49614208B,ana.etxebarria@megaapp.online,286945,ES22209500845884487347,6753.85,2022-05-14T14:08:29,Vitoria-Gasteiz,expenses,food,-112.42,5327.46
buyer_3,Ana,Etxebarria,1989-08-23,49614208B,ana.etxebarria@megaapp.online,286945,ES22209500845884487347,6753.85,2022-05-14T13:12:25,Vitoria-Gasteiz,expenses,transport,-86.97,5240.49
buyer_3,Ana,Etxebarria,1989-08-23,49614208B,ana.etxebarria@megaapp.online,286945,ES22209500845884487347,6753.85,2022-05-14T20:44:52,Vitoria-Gasteiz,expenses,healthcare,-157.55,5082.94
buyer_3,Ana,Etxebarria,1989-08-23,49614208B,ana.etxebarria@megaapp.online,286945,ES22209500845884487347,6753.85,2022-05-15T06:50:59,Vitoria-Gasteiz,expenses,food,-72.6,5010.34
buyer_3,Ana,Etxebarria,1989-08-23,49614208B,ana.etxebarria@megaapp.online,286945,ES22209500845884487347,6753.85,2022-05-15T04:34:54,Vitoria-Gasteiz,expenses,repairs,-259.62,4750.72
buyer_3,Ana,Etxebarria,1989-08-23,49614208B,ana.etxebarria@megaapp.online,286945,ES22209500845884487347,6753.85,2022-05-15T13:03:06,Vitoria-Gasteiz,expenses,gifts,-89.65,4661.07
buyer_3,Ana,Etxebarria,1989-08-23,49614208B,ana.etxebarria@megaapp.online,286945,ES22209500845884487347,6753.85,2022-05-16T18:07:30,Vitoria-Gasteiz,expenses,appliances,-121.35,4539.72
buyer_3,Ana,Etxebarria,1989-08-23,49614208B,ana.etxebarria@megaapp.online,286945,ES22209500845884487347,6753.85,2022-05-19T21:07:07,Vitoria-Gasteiz,expenses,transport,-76.2,4463.52
buyer_3,Ana,Etxebarria,1989-08-23,49614208B,ana.etxebarria@megaapp.online,286945,ES22209500845884487347,6753.85,2022-05-19T10:12:17,Vitoria-Gasteiz,expenses,car,-509.39,3954.13
buyer_3,Ana,Etxebarria,1989-08-23,49614208B,ana.etxebarria@megaapp.online,286945,ES22209500845884487347,6753.85,2022-05-20T13:46:34,Vitoria-Gasteiz,expenses,transport,-81.67,3872.46
buyer_3,Ana,Etxebarria,1989-08-23,49614208B,ana.etxebarria@megaapp.online,286945,ES22209500845884487347,6753.85,2022-05-21T17:01:00,Vitoria-Gasteiz,expenses,cash,-100.0,3772.46
buyer_3,Ana,Etxebarria,1989-08-23,49614208B,ana.etxebarria@megaapp.online,286945,ES22209500845884487347,6753.85,2022-05-22T12:48:44,Vitoria-Gasteiz,expenses,leisure,-46.22,3726.24
buyer_3,Ana,Etxebarria,1989-08-23,49614208B,ana.etxebarria@megaapp.online,286945,ES22209500845884487347,6753.85,2022-05-22T13:54:41,Vitoria-Gasteiz,expenses,cash,-100.0,3626.24
buyer_3,Ana,Etxebarria,1989-08-23,49614208B,ana.etxebarria@megaapp.online,286945,ES22209500845884487347,6753.85,2022-05-23T16:34:31,Vitoria-Gasteiz,expenses,cash,-100.0,3526.24
buyer_3,Ana,Etxebarria,1989-08-23,49614208B,ana.etxebarria@megaapp.online,286945,ES22209500845884487347,6753.85,2022-05-25T08:33:11,Vitoria-Gasteiz,expenses,food,-63.21,3463.03
buyer_3,Ana,Etxebarria,1989-08-23,49614208B,ana.etxebarria@megaapp.online,286945,ES22209500845884487347,6753.85,2022-05-26T20:40:41,Vitoria-Gasteiz,expenses,transport,-48.82,3414.21
buyer_3,Ana,Etxebarria,1989-08-23,49614208B,ana.etxebarria@megaapp.online,286945,ES22209500845884487347,6753.85,2022-05-26T19:30:59,Vitoria-Gasteiz,expenses,repairs,-293.56,3120.65
buyer_3,Ana,Etxebarria,1989-08-23,49614208B,ana.etxebarria@megaapp.online,286945,ES22209500845884487347,6753.85,2022-05-28T17:20:29,Vitoria-Gasteiz,expenses,cash,-100.0,3020.65
buyer_3,Ana,Etxebarria,1989-08-23,49614208B,ana.etxebarria@megaapp.online,286945,ES22209500845884487347,6753.85,2022-05-29T17:21:03,Vitoria-Gasteiz,expenses,food,-120.29,2900.36
buyer_3,Ana,Etxebarria,1989-08-23,49614208B,ana.etxebarria@megaapp.online,286945,ES22209500845884487347,6753.85,2022-05-31T20:11:15,Vitoria-Gasteiz,expenses,cash,-100.0,2800.36
buyer_3,Ana,Etxebarria,1989-08-23,49614208B,ana.etxebarria@megaapp.online,286945,ES22209500845884487347,6753.85,2022-06-01T09:14:50,Vitoria-Gasteiz,incomes,salary,3138.75,5939.11
buyer_3,Ana,Etxebarria,1989-08-23,49614208B,ana.etxebarria@megaapp.online,286945,ES22209500845884487347,6753.85,2022-06-01T09:14:50,Vitoria-Gasteiz,incomes,salary_partner,3762.16,9701.27
buyer_3,Ana,Etxebarria,1989-08-23,49614208B,ana.etxebarria@megaapp.online,286945,ES22209500845884487347,6753.85,2022-06-01T09:14:50,Vitoria-Gasteiz,incomes,salary_bonus,2273.89,11975.16
buyer_3,Ana,Etxebarria,1989-08-23,49614208B,ana.etxebarria@megaapp.online,286945,ES22209500845884487347,6753.85,2022-06-01T09:14:50,Vitoria-Gasteiz,incomes,salary_partner_bonus,2961.25,14936.41
buyer_3,Ana,Etxebarria,1989-08-23,49614208B,ana.etxebarria@megaapp.online,286945,ES22209500845884487347,6753.85,2022-06-01T14:39:26,Vitoria-Gasteiz,expenses,food,-74.74,14861.67
buyer_3,Ana,Etxebarria,1989-08-23,49614208B,ana.etxebarria@megaapp.online,286945,ES22209500845884487347,6753.85,2022-06-02T14:51:00,Vitoria-Gasteiz,expenses,clothing,-91.77,14769.9
buyer_3,Ana,Etxebarria,1989-08-23,49614208B,ana.etxebarria@megaapp.online,286945,ES22209500845884487347,6753.85,2022-06-04T19:47:59,Vitoria-Gasteiz,expenses,leisure,-40.83,14729.07
buyer_3,Ana,Etxebarria,1989-08-23,49614208B,ana.etxebarria@megaapp.online,286945,ES22209500845884487347,6753.85,2022-06-05T22:27:42,Vitoria-Gasteiz,expenses,mortgage,-3471.8,11257.27
buyer_3,Ana,Etxebarria,1989-08-23,49614208B,ana.etxebarria@megaapp.online,286945,ES22209500845884487347,6753.85,2022-06-06T06:47:18,Vitoria-Gasteiz,expenses,water,-82.59,11174.68
buyer_3,Ana,Etxebarria,1989-08-23,49614208B,ana.etxebarria@megaapp.online,286945,ES22209500845884487347,6753.85,2022-06-06T17:38:19,Vitoria-Gasteiz,expenses,gas,-354.25,10820.43
buyer_3,Ana,Etxebarria,1989-08-23,49614208B,ana.etxebarria@megaapp.online,286945,ES22209500845884487347,6753.85,2022-06-06T21:00:18,Vitoria-Gasteiz,expenses,transport,-74.96,10745.47
buyer_3,Ana,Etxebarria,1989-08-23,49614208B,ana.etxebarria@megaapp.online,286945,ES22209500845884487347,6753.85,2022-06-06T20:37:00,Vitoria-Gasteiz,expenses,travel,-289.87,10455.6
buyer_3,Ana,Etxebarria,1989-08-23,49614208B,ana.etxebarria@megaapp.online,286945,ES22209500845884487347,6753.85,2022-06-07T10:23:06,Vitoria-Gasteiz,expenses,internet,-144.92,10310.68
buyer_3,Ana,Etxebarria,1989-08-23,49614208B,ana.etxebarria@megaapp.online,286945,ES22209500845884487347,6753.85,2022-06-08T11:10:08,Vitoria-Gasteiz,expenses,gas,-213.25,10097.43
buyer_3,Ana,Etxebarria,1989-08-23,49614208B,ana.etxebarria@megaapp.online,286945,ES22209500845884487347,6753.85,2022-06-08T17:02:35,Vitoria-Gasteiz,expenses,food,-74.45,10022.98
buyer_3,Ana,Etxebarria,1989-08-23,49614208B,ana.etxebarria@megaapp.online,286945,ES22209500845884487347,6753.85,2022-06-09T08:21:18,Vitoria-Gasteiz,expenses,taxes,-5551.6,4471.38
buyer_3,Ana,Etxebarria,1989-08-23,49614208B,ana.etxebarria@megaapp.online,286945,ES22209500845884487347,6753.85,2022-06-09T19:38:30,Vitoria-Gasteiz,expenses,insurance,-1063.24,3408.14
buyer_3,Ana,Etxebarria,1989-08-23,49614208B,ana.etxebarria@megaapp.online,286945,ES22209500845884487347,6753.85,2022-06-11T19:44:54,Vitoria-Gasteiz,expenses,transport,-61.37,3346.77
buyer_3,Ana,Etxebarria,1989-08-23,49614208B,ana.etxebarria@megaapp.online,286945,ES22209500845884487347,6753.85,2022-06-13T03:37:22,Vitoria-Gasteiz,expenses,gifts,-738.83,2607.94
buyer_3,Ana,Etxebarria,1989-08-23,49614208B,ana.etxebarria@megaapp.online,286945,ES22209500845884487347,6753.85,2022-06-14T13:25:33,Vitoria-Gasteiz,expenses,food,-123.8,2484.14
buyer_3,Ana,Etxebarria,1989-08-23,49614208B,ana.etxebarria@megaapp.online,286945,ES22209500845884487347,6753.85,2022-06-16T11:23:32,Vitoria-Gasteiz,expenses,food,-117.92,2366.22
buyer_3,Ana,Etxebarria,1989-08-23,49614208B,ana.etxebarria@megaapp.online,286945,ES22209500845884487347,6753.85,2022-06-17T13:22:27,Vitoria-Gasteiz,expenses,food,-66.2,2300.02
buyer_3,Ana,Etxebarria,1989-08-23,49614208B,ana.etxebarria@megaapp.online,286945,ES22209500845884487347,6753.85,2022-06-19T16:35:45,Vitoria-Gasteiz,expenses,leisure,-38.36,2261.66
buyer_3,Ana,Etxebarria,1989-08-23,49614208B,ana.etxebarria@megaapp.online,286945,ES22209500845884487347,6753.85,2022-06-21T22:09:47,Vitoria-Gasteiz,expenses,transport,-66.02,2195.64
buyer_3,Ana,Etxebarria,1989-08-23,49614208B,ana.etxebarria@megaapp.online,286945,ES22209500845884487347,6753.85,2022-06-23T09:08:53,Vitoria-Gasteiz,expenses,cash,-100.0,2095.64
buyer_3,Ana,Etxebarria,1989-08-23,49614208B,ana.etxebarria@megaapp.online,286945,ES22209500845884487347,6753.85,2022-06-24T20:07:25,Vitoria-Gasteiz,expenses,transport,-64.07,2031.57
buyer_3,Ana,Etxebarria,1989-08-23,49614208B,ana.etxebarria@megaapp.online,286945,ES22209500845884487347,6753.85,2022-06-24T05:58:37,Vitoria-Gasteiz,expenses,cash,-100.0,1931.57
buyer_3,Ana,Etxebarria,1989-08-23,49614208B,ana.etxebarria@megaapp.online,286945,ES22209500845884487347,6753.85,2022-06-25T17:09:48,Vitoria-Gasteiz,expenses,transport,-43.95,1887.62
buyer_3,Ana,Etxebarria,1989-08-23,49614208B,ana.etxebarria@megaapp.online,286945,ES22209500845884487347,6753.85,2022-06-25T12:38:39,Vitoria-Gasteiz,expenses,cash,-100.0,1787.62
buyer_3,Ana,Etxebarria,1989-08-23,49614208B,ana.etxebarria@megaapp.online,286945,ES22209500845884487347,6753.85,2022-06-28T09:19:08,Vitoria-Gasteiz,expenses,leisure,-56.42,1731.2
buyer_3,Ana,Etxebarria,1989-08-23,49614208B,ana.etxebarria@megaapp.online,286945,ES22209500845884487347,6753.85,2022-06-28T19:30:07,Vitoria-Gasteiz,expenses,education,-64.98,1666.22
buyer_3,Ana,Etxebarria,1989-08-23,49614208B,ana.etxebarria@megaapp.online,286945,ES22209500845884487347,6753.85,2022-06-29T08:57:26,Vitoria-Gasteiz,expenses,cash,-100.0,1566.22
buyer_3,Ana,Etxebarria,1989-08-23,49614208B,ana.etxebarria@megaapp.online,286945,ES22209500845884487347,6753.85,2022-06-30T16:06:10,Vitoria-Gasteiz,expenses,transport,-64.78,1501.44
buyer_3,Ana,Etxebarria,1989-08-23,49614208B,ana.etxebarria@megaapp.online,286945,ES22209500845884487347,6753.85,2022-07-01T12:15:09,Vitoria-Gasteiz,incomes,salary,3138.75,4640.19
buyer_3,Ana,Etxebarria,1989-08-23,49614208B,ana.etxebarria@megaapp.online,286945,ES22209500845884487347,6753.85,2022-07-01T12:15:09,Vitoria-Gasteiz,incomes,salary_partner,3762.16,8402.35
buyer_3,Ana,Etxebarria,1989-08-23,49614208B,ana.etxebarria@megaapp.online,286945,ES22209500845884487347,6753.85,2022-07-01T12:15:09,Vitoria-Gasteiz,incomes,extra_income,412.38,8814.73
buyer_3,Ana,Etxebarria,1989-08-23,49614208B,ana.etxebarria@megaapp.online,286945,ES22209500845884487347,6753.85,2022-07-01T11:34:59,Vitoria-Gasteiz,expenses,leisure,-49.74,8764.99
buyer_3,Ana,Etxebarria,1989-08-23,49614208B,ana.etxebarria@megaapp.online,286945,ES22209500845884487347,6753.85,2022-07-02T20:37:23,Vitoria-Gasteiz,expenses,food,-86.2,8678.79
buyer_3,Ana,Etxebarria,1989-08-23,49614208B,ana.etxebarria@megaapp.online,286945,ES22209500845884487347,6753.85,2022-07-02T04:27:14,Vitoria-Gasteiz,expenses,clothing,-46.07,8632.72
buyer_3,Ana,Etxebarria,1989-08-23,49614208B,ana.etxebarria@megaapp.online,286945,ES22209500845884487347,6753.85,2022-07-04T08:00:12,Vitoria-Gasteiz,expenses,cash,-100.0,8532.72
buyer_3,Ana,Etxebarria,1989-08-23,49614208B,ana.etxebarria@megaapp.online,286945,ES22209500845884487347,6753.85,2022-07-05T17:28:53,Vitoria-Gasteiz,expenses,mortgage,-3471.8,5060.92
buyer_3,Ana,Etxebarria,1989-08-23,49614208B,ana.etxebarria@megaapp.online,286945,ES22209500845884487347,6753.85,2022-07-05T14:07:23,Vitoria-Gasteiz,expenses,electricity,-203.95,4856.97
buyer_3,Ana,Etxebarria,1989-08-23,49614208B,ana.etxebarria@megaapp.online,286945,ES22209500845884487347,6753.85,2022-07-05T08:04:33,Vitoria-Gasteiz,expenses,internet,-144.92,4712.05
buyer_3,Ana,Etxebarria,1989-08-23,49614208B,ana.etxebarria@megaapp.online,286945,ES22209500845884487347,6753.85,2022-07-05T17:59:42,Vitoria-Gasteiz,expenses,cash,-100.0,4612.05
buyer_3,Ana,Etxebarria,1989-08-23,49614208B,ana.etxebarria@megaapp.online,286945,ES22209500845884487347,6753.85,2022-07-06T11:02:25,Vitoria-Gasteiz,expenses,gas,-329.77,4282.28
buyer_3,Ana,Etxebarria,1989-08-23,49614208B,ana.etxebarria@megaapp.online,286945,ES22209500845884487347,6753.85,2022-07-06T19:17:59,Vitoria-Gasteiz,expenses,internet,-144.92,4137.36
buyer_3,Ana,Etxebarria,1989-08-23,49614208B,ana.etxebarria@megaapp.online,286945,ES22209500845884487347,6753.85,2022-07-08T21:16:41,Vitoria-Gasteiz,expenses,water,-102.87,4034.49
buyer_3,Ana,Etxebarria,1989-08-23,49614208B,ana.etxebarria@megaapp.online,286945,ES22209500845884487347,6753.85,2022-07-08T08:37:54,Vitoria-Gasteiz,expenses,phone,-149.42,3885.07
buyer_3,Ana,Etxebarria,1989-08-23,49614208B,ana.etxebarria@megaapp.online,286945,ES22209500845884487347,6753.85,2022-07-09T16:30:25,Vitoria-Gasteiz,expenses,cash,-100.0,3785.07
buyer_3,Ana,Etxebarria,1989-08-23,49614208B,ana.etxebarria@megaapp.online,286945,ES22209500845884487347,6753.85,2022-07-10T16:20:52,Vitoria-Gasteiz,expenses,transport,-80.72,3704.35
buyer_3,Ana,Etxebarria,1989-08-23,49614208B,ana.etxebarria@megaapp.online,286945,ES22209500845884487347,6753.85,2022-07-11T18:53:22,Vitoria-Gasteiz,expenses,transport,-83.16,3621.19
buyer_3,Ana,Etxebarria,1989-08-23,49614208B,ana.etxebarria@megaapp.online,286945,ES22209500845884487347,6753.85,2022-07-13T09:44:40,Vitoria-Gasteiz,expenses,food,-69.18,3552.01
buyer_3,Ana,Etxebarria,1989-08-23,49614208B,ana.etxebarria@megaapp.online,286945,ES22209500845884487347,6753.85,2022-07-14T17:26:17,Vitoria-Gasteiz,expenses,transport,-48.97,3503.04
buyer_3,Ana,Etxebarria,1989-08-23,49614208B,ana.etxebarria@megaapp.online,286945,ES22209500845884487347,6753.85,2022-07-15T10:46:04,Vitoria-Gasteiz,expenses,appliances,-81.59,3421.45
buyer_3,Ana,Etxebarria,1989-08-23,49614208B,ana.etxebarria@megaapp.online,286945,ES22209500845884487347,6753.85,2022-07-18T13:25:35,Vitoria-Gasteiz,expenses,transport,-78.76,3342.69
buyer_3,Ana,Etxebarria,1989-08-23,49614208B,ana.etxebarria@megaapp.online,286945,ES22209500845884487347,6753.85,2022-07-19T23:24:50,Vitoria-Gasteiz,expenses,education,-60.48,3282.21
buyer_3,Ana,Etxebarria,1989-08-23,49614208B,ana.etxebarria@megaapp.online,286945,ES22209500845884487347,6753.85,2022-07-19T17:29:28,Vitoria-Gasteiz,expenses,cash,-100.0,3182.21
buyer_3,Ana,Etxebarria,1989-08-23,49614208B,ana.etxebarria@megaapp.online,286945,ES22209500845884487347,6753.85,2022-07-20T10:47:43,Vitoria-Gasteiz,expenses,cash,-100.0,3082.21
buyer_3,Ana,Etxebarria,1989-08-23,49614208B,ana.etxebarria@megaapp.online,286945,ES22209500845884487347,6753.85,2022-07-21T18:03:21,Vitoria-Gasteiz,expenses,leisure,-47.0,3035.21
buyer_3,Ana,Etxebarria,1989-08-23,49614208B,ana.etxebarria@megaapp.online,286945,ES22209500845884487347,6753.85,2022-07-22T16:09:26,Vitoria-Gasteiz,expenses,education,-63.07,2972.14
buyer_3,Ana,Etxebarria,1989-08-23,49614208B,ana.etxebarria@megaapp.online,286945,ES22209500845884487347,6753.85,2022-07-25T08:03:01,Vitoria-Gasteiz,expenses,transport,-55.99,2916.15
buyer_3,Ana,Etxebarria,1989-08-23,49614208B,ana.etxebarria@megaapp.online,286945,ES22209500845884487347,6753.85,2022-07-25T01:44:36,Vitoria-Gasteiz,expenses,cash,-100.0,2816.15
buyer_3,Ana,Etxebarria,1989-08-23,49614208B,ana.etxebarria@megaapp.online,286945,ES22209500845884487347,6753.85,2022-07-26T17:51:22,Vitoria-Gasteiz,expenses,transport,-57.8,2758.35
buyer_3,Ana,Etxebarria,1989-08-23,49614208B,ana.etxebarria@megaapp.online,286945,ES22209500845884487347,6753.85,2022-07-27T18:44:54,Vitoria-Gasteiz,expenses,leisure,-70.28,2688.07
buyer_3,Ana,Etxebarria,1989-08-23,49614208B,ana.etxebarria@megaapp.online,286945,ES22209500845884487347,6753.85,2022-07-27T19:57:00,Vitoria-Gasteiz,expenses,cash,-100.0,2588.07
buyer_3,Ana,Etxebarria,1989-08-23,49614208B,ana.etxebarria@megaapp.online,286945,ES22209500845884487347,6753.85,2022-07-29T14:03:19,Vitoria-Gasteiz,expenses,clothing,-101.14,2486.93
buyer_3,Ana,Etxebarria,1989-08-23,49614208B,ana.etxebarria@megaapp.online,286945,ES22209500845884487347,6753.85,2022-07-31T20:37:59,Vitoria-Gasteiz,expenses,leisure,-84.21,2402.72
buyer_3,Ana,Etxebarria,1989-08-23,49614208B,ana.etxebarria@megaapp.online,286945,ES22209500845884487347,6753.85,2022-08-01T18:33:21,Vitoria-Gasteiz,incomes,salary,3138.75,5541.47
buyer_3,Ana,Etxebarria,1989-08-23,49614208B,ana.etxebarria@megaapp.online,286945,ES22209500845884487347,6753.85,2022-08-01T18:33:21,Vitoria-Gasteiz,incomes,salary_partner,3762.16,9303.63
buyer_3,Ana,Etxebarria,1989-08-23,49614208B,ana.etxebarria@megaapp.online,286945,ES22209500845884487347,6753.85,2022-08-03T19:26:16,Vitoria-Gasteiz,expenses,car,-511.54,8792.09
buyer_3,Ana,Etxebarria,1989-08-23,49614208B,ana.etxebarria@megaapp.online,286945,ES22209500845884487347,6753.85,2022-08-04T13:38:35,Vitoria-Gasteiz,expenses,leisure,-30.62,8761.47
buyer_3,Ana,Etxebarria,1989-08-23,49614208B,ana.etxebarria@megaapp.online,286945,ES22209500845884487347,6753.85,2022-08-05T19:17:41,Vitoria-Gasteiz,expenses,mortgage,-3471.8,5289.67
buyer_3,Ana,Etxebarria,1989-08-23,49614208B,ana.etxebarria@megaapp.online,286945,ES22209500845884487347,6753.85,2022-08-05T20:59:46,Vitoria-Gasteiz,expenses,electricity,-83.11,5206.56
buyer_3,Ana,Etxebarria,1989-08-23,49614208B,ana.etxebarria@megaapp.online,286945,ES22209500845884487347,6753.85,2022-08-06T23:04:09,Vitoria-Gasteiz,expenses,water,-105.07,5101.49
buyer_3,Ana,Etxebarria,1989-08-23,49614208B,ana.etxebarria@megaapp.online,286945,ES22209500845884487347,6753.85,2022-08-06T12:57:48,Vitoria-Gasteiz,expenses,gas,-239.85,4861.64
buyer_3,Ana,Etxebarria,1989-08-23,49614208B,ana.etxebarria@megaapp.online,286945,ES22209500845884487347,6753.85,2022-08-06T08:46:42,Vitoria-Gasteiz,expenses,internet,-144.92,4716.72
buyer_3,Ana,Etxebarria,1989-08-23,49614208B,ana.etxebarria@megaapp.online,286945,ES22209500845884487347,6753.85,2022-08-06T13:04:36,Vitoria-Gasteiz,expenses,cash,-100.0,4616.72
buyer_3,Ana,Etxebarria,1989-08-23,49614208B,ana.etxebarria@megaapp.online,286945,ES22209500845884487347,6753.85,2022-08-06T17:57:22,Vitoria-Gasteiz,expenses,gifts,-392.63,4224.09
buyer_3,Ana,Etxebarria,1989-08-23,49614208B,ana.etxebarria@megaapp.online,286945,ES22209500845884487347,6753.85,2022-08-07T09:24:52,Vitoria-Gasteiz,expenses,water,-99.45,4124.64
buyer_3,Ana,Etxebarria,1989-08-23,49614208B,ana.etxebarria@megaapp.online,286945,ES22209500845884487347,6753.85,2022-08-07T04:03:33,Vitoria-Gasteiz,expenses,internet,-144.92,3979.72
buyer_3,Ana,Etxebarria,1989-08-23,49614208B,ana.etxebarria@megaapp.online,286945,ES22209500845884487347,6753.85,2022-08-08T13:35:05,Vitoria-Gasteiz,expenses,leisure,-82.57,3897.15
buyer_3,Ana,Etxebarria,1989-08-23,49614208B,ana.etxebarria@megaapp.online,286945,ES22209500845884487347,6753.85,2022-08-08T02:30:28,Vitoria-Gasteiz,expenses,healthcare,-75.35,3821.8
buyer_3,Ana,Etxebarria,1989-08-23,49614208B,ana.etxebarria@megaapp.online,286945,ES22209500845884487347,6753.85,2022-08-09T08:48:10,Vitoria-Gasteiz,expenses,food,-98.17,3723.63
buyer_3,Ana,Etxebarria,1989-08-23,49614208B,ana.etxebarria@megaapp.online,286945,ES22209500845884487347,6753.85,2022-08-11T19:09:01,Vitoria-Gasteiz,expenses,cash,-100.0,3623.63
buyer_3,Ana,Etxebarria,1989-08-23,49614208B,ana.etxebarria@megaapp.online,286945,ES22209500845884487347,6753.85,2022-08-11T20:16:06,Vitoria-Gasteiz,expenses,gifts,-279.09,3344.54
buyer_3,Ana,Etxebarria,1989-08-23,49614208B,ana.etxebarria@megaapp.online,286945,ES22209500845884487347,6753.85,2022-08-13T21:17:05,Vitoria-Gasteiz,expenses,food,-76.13,3268.41
buyer_3,Ana,Etxebarria,1989-08-23,49614208B,ana.etxebarria@megaapp.online,286945,ES22209500845884487347,6753.85,2022-08-13T17:24:46,Vitoria-Gasteiz,expenses,clothing,-135.9,3132.51
buyer_3,Ana,Etxebarria,1989-08-23,49614208B,ana.etxebarria@megaapp.online,286945,ES22209500845884487347,6753.85,2022-08-14T20:27:57,Vitoria-Gasteiz,expenses,repairs,-269.63,2862.88
buyer_3,Ana,Etxebarria,1989-08-23,49614208B,ana.etxebarria@megaapp.online,286945,ES22209500845884487347,6753.85,2022-08-17T14:00:27,Vitoria-Gasteiz,expenses,transport,-58.35,2804.53
buyer_3,Ana,Etxebarria,1989-08-23,49614208B,ana.etxebarria@megaapp.online,286945,ES22209500845884487347,6753.85,2022-08-17T13:26:50,Vitoria-Gasteiz,expenses,leisure,-18.47,2786.06
buyer_3,Ana,Etxebarria,1989-08-23,49614208B,ana.etxebarria@megaapp.online,286945,ES22209500845884487347,6753.85,2022-08-17T10:54:27,Vitoria-Gasteiz,expenses,gifts,-304.21,2481.85
buyer_3,Ana,Etxebarria,1989-08-23,49614208B,ana.etxebarria@megaapp.online,286945,ES22209500845884487347,6753.85,2022-08-23T22:17:57,Vitoria-Gasteiz,expenses,repairs,-249.83,2232.02
buyer_3,Ana,Etxebarria,1989-08-23,49614208B,ana.etxebarria@megaapp.online,286945,ES22209500845884487347,6753.85,2022-08-24T12:15:17,Vitoria-Gasteiz,expenses,cash,-100.0,2132.02
buyer_3,Ana,Etxebarria,1989-08-23,49614208B,ana.etxebarria@megaapp.online,286945,ES22209500845884487347,6753.85,2022-08-24T08:24:00,Vitoria-Gasteiz,expenses,appliances,-403.82,1728.2
buyer_3,Ana,Etxebarria,1989-08-23,49614208B,ana.etxebarria@megaapp.online,286945,ES22209500845884487347,6753.85,2022-08-25T21:43:09,Vitoria-Gasteiz,expenses,food,-102.79,1625.41
buyer_3,Ana,Etxebarria,1989-08-23,49614208B,ana.etxebarria@megaapp.online,286945,ES22209500845884487347,6753.85,2022-08-26T13:46:22,Vitoria-Gasteiz,expenses,food,-118.65,1506.76
buyer_3,Ana,Etxebarria,1989-08-23,49614208B,ana.etxebarria@megaapp.online,286945,ES22209500845884487347,6753.85,2022-08-27T12:34:25,Vitoria-Gasteiz,expenses,food,-75.31,1431.45
buyer_3,Ana,Etxebarria,1989-08-23,49614208B,ana.etxebarria@megaapp.online,286945,ES22209500845884487347,6753.85,2022-08-28T18:21:45,Vitoria-Gasteiz,expenses,leisure,-27.92,1403.53
buyer_3,Ana,Etxebarria,1989-08-23,49614208B,ana.etxebarria@megaapp.online,286945,ES22209500845884487347,6753.85,2022-08-31T11:02:36,Vitoria-Gasteiz,expenses,cash,-100.0,1303.53
buyer_3,Ana,Etxebarria,1989-08-23,49614208B,ana.etxebarria@megaapp.online,286945,ES22209500845884487347,6753.85,2022-08-31T12:19:23,Vitoria-Gasteiz,expenses,repairs,-83.2,1220.33
buyer_3,Ana,Etxebarria,1989-08-23,49614208B,ana.etxebarria@megaapp.online,286945,ES22209500845884487347,6753.85,2022-09-01T23:41:43,Vitoria-Gasteiz,incomes,salary,3138.75,4359.08
buyer_3,Ana,Etxebarria,1989-08-23,49614208B,ana.etxebarria@megaapp.online,286945,ES22209500845884487347,6753.85,2022-09-01T23:41:43,Vitoria-Gasteiz,incomes,salary_partner,3762.16,8121.24
buyer_3,Ana,Etxebarria,1989-08-23,49614208B,ana.etxebarria@megaapp.online,286945,ES22209500845884487347,6753.85,2022-09-01T18:16:19,Vitoria-Gasteiz,expenses,food,-96.19,8025.05
buyer_3,Ana,Etxebarria,1989-08-23,49614208B,ana.etxebarria@megaapp.online,286945,ES22209500845884487347,6753.85,2022-09-01T17:41:33,Vitoria-Gasteiz,expenses,leisure,-78.84,7946.21
buyer_3,Ana,Etxebarria,1989-08-23,49614208B,ana.etxebarria@megaapp.online,286945,ES22209500845884487347,6753.85,2022-09-03T18:10:49,Vitoria-Gasteiz,expenses,cash,-100.0,7846.21
buyer_3,Ana,Etxebarria,1989-08-23,49614208B,ana.etxebarria@megaapp.online,286945,ES22209500845884487347,6753.85,2022-09-05T20:49:19,Vitoria-Gasteiz,expenses,mortgage,-3471.8,4374.41
buyer_3,Ana,Etxebarria,1989-08-23,49614208B,ana.etxebarria@megaapp.online,286945,ES22209500845884487347,6753.85,2022-09-05T04:58:37,Vitoria-Gasteiz,expenses,cash,-100.0,4274.41
buyer_3,Ana,Etxebarria,1989-08-23,49614208B,ana.etxebarria@megaapp.online,286945,ES22209500845884487347,6753.85,2022-09-06T15:35:52,Vitoria-Gasteiz,expenses,electricity,-295.59,3978.82
buyer_3,Ana,Etxebarria,1989-08-23,49614208B,ana.etxebarria@megaapp.online,286945,ES22209500845884487347,6753.85,2022-09-06T09:35:05,Vitoria-Gasteiz,expenses,phone,-148.8,3830.02
buyer_3,Ana,Etxebarria,1989-08-23,49614208B,ana.etxebarria@megaapp.online,286945,ES22209500845884487347,6753.85,2022-09-08T17:28:22,Vitoria-Gasteiz,expenses,water,-151.62,3678.4
buyer_3,Ana,Etxebarria,1989-08-23,49614208B,ana.etxebarria@megaapp.online,286945,ES22209500845884487347,6753.85,2022-09-08T20:03:52,Vitoria-Gasteiz,expenses,electricity,-197.32,3481.08
buyer_3,Ana,Etxebarria,1989-08-23,49614208B,ana.etxebarria@megaapp.online,286945,ES22209500845884487347,6753.85,2022-09-08T12:03:11,Vitoria-Gasteiz,expenses,internet,-144.92,3336.16
buyer_3,Ana,Etxebarria,1989-08-23,49614208B,ana.etxebarria@megaapp.online,286945,ES22209500845884487347,6753.85,2022-09-09T08:33:45,Vitoria-Gasteiz,expenses,clothing,-73.3,3262.86
buyer_3,Ana,Etxebarria,1989-08-23,49614208B,ana.etxebarria@megaapp.online,286945,ES22209500845884487347,6753.85,2022-09-10T13:32:00,Vitoria-Gasteiz,expenses,food,-91.65,3171.21
buyer_3,Ana,Etxebarria,1989-08-23,49614208B,ana.etxebarria@megaapp.online,286945,ES22209500845884487347,6753.85,2022-09-10T08:18:52,Vitoria-Gasteiz,expenses,clothing,-94.79,3076.42
buyer_3,Ana,Etxebarria,1989-08-23,49614208B,ana.etxebarria@megaapp.online,286945,ES22209500845884487347,6753.85,2022-09-14T07:06:42,Vitoria-Gasteiz,expenses,leisure,-38.21,3038.21
buyer_3,Ana,Etxebarria,1989-08-23,49614208B,ana.etxebarria@megaapp.online,286945,ES22209500845884487347,6753.85,2022-09-14T17:17:48,Vitoria-Gasteiz,expenses,cash,-100.0,2938.21
buyer_3,Ana,Etxebarria,1989-08-23,49614208B,ana.etxebarria@megaapp.online,286945,ES22209500845884487347,6753.85,2022-09-15T09:40:49,Vitoria-Gasteiz,expenses,education,-66.26,2871.95
buyer_3,Ana,Etxebarria,1989-08-23,49614208B,ana.etxebarria@megaapp.online,286945,ES22209500845884487347,6753.85,2022-09-16T15:56:45,Vitoria-Gasteiz,expenses,healthcare,-80.29,2791.66
buyer_3,Ana,Etxebarria,1989-08-23,49614208B,ana.etxebarria@megaapp.online,286945,ES22209500845884487347,6753.85,2022-09-17T12:14:23,Vitoria-Gasteiz,expenses,education,-77.79,2713.87
buyer_3,Ana,Etxebarria,1989-08-23,49614208B,ana.etxebarria@megaapp.online,286945,ES22209500845884487347,6753.85,2022-09-18T16:28:12,Vitoria-Gasteiz,expenses,leisure,-37.65,2676.22
buyer_3,Ana,Etxebarria,1989-08-23,49614208B,ana.etxebarria@megaapp.online,286945,ES22209500845884487347,6753.85,2022-09-18T04:24:00,Vitoria-Gasteiz,expenses,cash,-100.0,2576.22
buyer_3,Ana,Etxebarria,1989-08-23,49614208B,ana.etxebarria@megaapp.online,286945,ES22209500845884487347,6753.85,2022-09-23T10:13:05,Vitoria-Gasteiz,expenses,leisure,-64.48,2511.74
buyer_3,Ana,Etxebarria,1989-08-23,49614208B,ana.etxebarria@megaapp.online,286945,ES22209500845884487347,6753.85,2022-09-24T09:16:42,Vitoria-Gasteiz,expenses,leisure,-71.49,2440.25
buyer_3,Ana,Etxebarria,1989-08-23,49614208B,ana.etxebarria@megaapp.online,286945,ES22209500845884487347,6753.85,2022-09-24T16:46:27,Vitoria-Gasteiz,expenses,cash,-100.0,2340.25
buyer_3,Ana,Etxebarria,1989-08-23,49614208B,ana.etxebarria@megaapp.online,286945,ES22209500845884487347,6753.85,2022-09-26T12:32:49,Vitoria-Gasteiz,expenses,cash,-100.0,2240.25
buyer_3,Ana,Etxebarria,1989-08-23,49614208B,ana.etxebarria@megaapp.online,286945,ES22209500845884487347,6753.85,2022-09-28T15:57:07,Vitoria-Gasteiz,expenses,food,-69.81,2170.44
buyer_3,Ana,Etxebarria,1989-08-23,49614208B,ana.etxebarria@megaapp.online,286945,ES22209500845884487347,6753.85,2022-10-01T12:45:23,Vitoria-Gasteiz,incomes,salary,3138.75,5309.19
buyer_3,Ana,Etxebarria,1989-08-23,49614208B,ana.etxebarria@megaapp.online,286945,ES22209500845884487347,6753.85,2022-10-01T12:45:23,Vitoria-Gasteiz,incomes,salary_partner,3762.16,9071.35
buyer_3,Ana,Etxebarria,1989-08-23,49614208B,ana.etxebarria@megaapp.online,286945,ES22209500845884487347,6753.85,2022-10-01T12:45:23,Vitoria-Gasteiz,incomes,extra_income,412.38,9483.73
buyer_3,Ana,Etxebarria,1989-08-23,49614208B,ana.etxebarria@megaapp.online,286945,ES22209500845884487347,6753.85,2022-10-01T08:28:23,Vitoria-Gasteiz,expenses,food,-90.75,9392.98
buyer_3,Ana,Etxebarria,1989-08-23,49614208B,ana.etxebarria@megaapp.online,286945,ES22209500845884487347,6753.85,2022-10-02T12:45:18,Vitoria-Gasteiz,expenses,transport,-47.41,9345.57
buyer_3,Ana,Etxebarria,1989-08-23,49614208B,ana.etxebarria@megaapp.online,286945,ES22209500845884487347,6753.85,2022-10-02T04:32:27,Vitoria-Gasteiz,expenses,education,-45.47,9300.1
buyer_3,Ana,Etxebarria,1989-08-23,49614208B,ana.etxebarria@megaapp.online,286945,ES22209500845884487347,6753.85,2022-10-03T08:01:12,Vitoria-Gasteiz,expenses,clothing,-50.67,9249.43
buyer_3,Ana,Etxebarria,1989-08-23,49614208B,ana.etxebarria@megaapp.online,286945,ES22209500845884487347,6753.85,2022-10-03T09:30:13,Vitoria-Gasteiz,expenses,gifts,-299.88,8949.55
buyer_3,Ana,Etxebarria,1989-08-23,49614208B,ana.etxebarria@megaapp.online,286945,ES22209500845884487347,6753.85,2022-10-04T08:12:15,Vitoria-Gasteiz,expenses,clothing,-119.6,8829.95
buyer_3,Ana,Etxebarria,1989-08-23,49614208B,ana.etxebarria@megaapp.online,286945,ES22209500845884487347,6753.85,2022-10-04T09:04:14,Vitoria-Gasteiz,expenses,cash,-100.0,8729.95
buyer_3,Ana,Etxebarria,1989-08-23,49614208B,ana.etxebarria@megaapp.online,286945,ES22209500845884487347,6753.85,2022-10-05T17:41:31,Vitoria-Gasteiz,expenses,mortgage,-3471.8,5258.15
buyer_3,Ana,Etxebarria,1989-08-23,49614208B,ana.etxebarria@megaapp.online,286945,ES22209500845884487347,6753.85,2022-10-05T03:49:52,Vitoria-Gasteiz,expenses,water,-117.68,5140.47
buyer_3,Ana,Etxebarria,1989-08-23,49614208B,ana.etxebarria@megaapp.online,286945,ES22209500845884487347,6753.85,2022-10-05T13:47:45,Vitoria-Gasteiz,expenses,repairs,-326.74,4813.73
buyer_3,Ana,Etxebarria,1989-08-23,49614208B,ana.etxebarria@megaapp.online,286945,ES22209500845884487347,6753.85,2022-10-06T08:05:30,Vitoria-Gasteiz,expenses,electricity,-91.91,4721.82
buyer_3,Ana,Etxebarria,1989-08-23,49614208B,ana.etxebarria@megaapp.online,286945,ES22209500845884487347,6753.85,2022-10-08T11:54:59,Vitoria-Gasteiz,expenses,water,-81.83,4639.99
buyer_3,Ana,Etxebarria,1989-08-23,49614208B,ana.etxebarria@megaapp.online,286945,ES22209500845884487347,6753.85,2022-10-08T16:55:19,Vitoria-Gasteiz,expenses,internet,-144.92,4495.07
buyer_3,Ana,Etxebarria,1989-08-23,49614208B,ana.etxebarria@megaapp.online,286945,ES22209500845884487347,6753.85,2022-10-08T11:45:56,Vitoria-Gasteiz,expenses,cash,-100.0,4395.07
buyer_3,Ana,Etxebarria,1989-08-23,49614208B,ana.etxebarria@megaapp.online,286945,ES22209500845884487347,6753.85,2022-10-09T11:41:58,Vitoria-Gasteiz,expenses,leisure,-51.35,4343.72
buyer_3,Ana,Etxebarria,1989-08-23,49614208B,ana.etxebarria@megaapp.online,286945,ES22209500845884487347,6753.85,2022-10-10T13:53:28,Vitoria-Gasteiz,expenses,food,-82.25,4261.47
buyer_3,Ana,Etxebarria,1989-08-23,49614208B,ana.etxebarria@megaapp.online,286945,ES22209500845884487347,6753.85,2022-10-10T16:18:58,Vitoria-Gasteiz,expenses,transport,-42.98,4218.49
buyer_3,Ana,Etxebarria,1989-08-23,49614208B,ana.etxebarria@megaapp.online,286945,ES22209500845884487347,6753.85,2022-10-10T09:48:57,Vitoria-Gasteiz,expenses,leisure,-71.03,4147.46
buyer_3,Ana,Etxebarria,1989-08-23,49614208B,ana.etxebarria@megaapp.online,286945,ES22209500845884487347,6753.85,2022-10-10T10:11:52,Vitoria-Gasteiz,expenses,appliances,-239.17,3908.29
buyer_3,Ana,Etxebarria,1989-08-23,49614208B,ana.etxebarria@megaapp.online,286945,ES22209500845884487347,6753.85,2022-10-11T22:03:00,Vitoria-Gasteiz,expenses,cash,-100.0,3808.29
buyer_3,Ana,Etxebarria,1989-08-23,49614208B,ana.etxebarria@megaapp.online,286945,ES22209500845884487347,6753.85,2022-10-12T21:33:06,Vitoria-Gasteiz,expenses,education,-46.36,3761.93
buyer_3,Ana,Etxebarria,1989-08-23,49614208B,ana.etxebarria@megaapp.online,286945,ES22209500845884487347,6753.85,2022-10-12T17:55:25,Vitoria-Gasteiz,expenses,gifts,-349.55,3412.38
buyer_3,Ana,Etxebarria,1989-08-23,49614208B,ana.etxebarria@megaapp.online,286945,ES22209500845884487347,6753.85,2022-10-13T13:43:39,Vitoria-Gasteiz,expenses,cash,-100.0,3312.38
buyer_3,Ana,Etxebarria,1989-08-23,49614208B,ana.etxebarria@megaapp.online,286945,ES22209500845884487347,6753.85,2022-10-14T11:26:50,Vitoria-Gasteiz,expenses,food,-108.71,3203.67
buyer_3,Ana,Etxebarria,1989-08-23,49614208B,ana.etxebarria@megaapp.online,286945,ES22209500845884487347,6753.85,2022-10-15T12:22:01,Vitoria-Gasteiz,expenses,clothing,-159.52,3044.15
buyer_3,Ana,Etxebarria,1989-08-23,49614208B,ana.etxebarria@megaapp.online,286945,ES22209500845884487347,6753.85,2022-10-16T15:02:44,Vitoria-Gasteiz,expenses,leisure,-29.97,3014.18
buyer_3,Ana,Etxebarria,1989-08-23,49614208B,ana.etxebarria@megaapp.online,286945,ES22209500845884487347,6753.85,2022-10-17T20:46:08,Vitoria-Gasteiz,expenses,repairs,-198.65,2815.53
buyer_3,Ana,Etxebarria,1989-08-23,49614208B,ana.etxebarria@megaapp.online,286945,ES22209500845884487347,6753.85,2022-10-19T21:27:34,Vitoria-Gasteiz,expenses,food,-113.36,2702.17
buyer_3,Ana,Etxebarria,1989-08-23,49614208B,ana.etxebarria@megaapp.online,286945,ES22209500845884487347,6753.85,2022-10-22T09:27:19,Vitoria-Gasteiz,expenses,transport,-62.39,2639.78
buyer_3,Ana,Etxebarria,1989-08-23,49614208B,ana.etxebarria@megaapp.online,286945,ES22209500845884487347,6753.85,2022-10-22T10:07:03,Vitoria-Gasteiz,expenses,cash,-100.0,2539.78
buyer_3,Ana,Etxebarria,1989-08-23,49614208B,ana.etxebarria@megaapp.online,286945,ES22209500845884487347,6753.85,2022-10-23T12:41:48,Vitoria-Gasteiz,expenses,education,-50.47,2489.31
buyer_3,Ana,Etxebarria,1989-08-23,49614208B,ana.etxebarria@megaapp.online,286945,ES22209500845884487347,6753.85,2022-10-24T09:39:10,Vitoria-Gasteiz,expenses,gifts,-146.52,2342.79
buyer_3,Ana,Etxebarria,1989-08-23,49614208B,ana.etxebarria@megaapp.online,286945,ES22209500845884487347,6753.85,2022-10-26T04:00:11,Vitoria-Gasteiz,expenses,transport,-58.2,2284.59
buyer_3,Ana,Etxebarria,1989-08-23,49614208B,ana.etxebarria@megaapp.online,286945,ES22209500845884487347,6753.85,2022-10-26T14:37:04,Vitoria-Gasteiz,expenses,clothing,-154.5,2130.09
buyer_3,Ana,Etxebarria,1989-08-23,49614208B,ana.etxebarria@megaapp.online,286945,ES22209500845884487347,6753.85,2022-10-27T06:36:14,Vitoria-Gasteiz,expenses,transport,-68.56,2061.53
buyer_3,Ana,Etxebarria,1989-08-23,49614208B,ana.etxebarria@megaapp.online,286945,ES22209500845884487347,6753.85,2022-10-27T20:55:37,Vitoria-Gasteiz,expenses,cash,-100.0,1961.53
buyer_3,Ana,Etxebarria,1989-08-23,49614208B,ana.etxebarria@megaapp.online,286945,ES22209500845884487347,6753.85,2022-10-28T16:46:19,Vitoria-Gasteiz,expenses,food,-79.47,1882.06
buyer_3,Ana,Etxebarria,1989-08-23,49614208B,ana.etxebarria@megaapp.online,286945,ES22209500845884487347,6753.85,2022-10-29T07:39:56,Vitoria-Gasteiz,expenses,cash,-100.0,1782.06
buyer_3,Ana,Etxebarria,1989-08-23,49614208B,ana.etxebarria@megaapp.online,286945,ES22209500845884487347,6753.85,2022-10-30T17:33:13,Vitoria-Gasteiz,expenses,cash,-100.0,1682.06
buyer_3,Ana,Etxebarria,1989-08-23,49614208B,ana.etxebarria@megaapp.online,286945,ES22209500845884487347,6753.85,2022-11-01T14:16:42,Vitoria-Gasteiz,incomes,salary,3138.75,4820.81
buyer_3,Ana,Etxebarria,1989-08-23,49614208B,ana.etxebarria@megaapp.online,286945,ES22209500845884487347,6753.85,2022-11-01T14:16:42,Vitoria-Gasteiz,incomes,salary_partner,3762.16,8582.97
buyer_3,Ana,Etxebarria,1989-08-23,49614208B,ana.etxebarria@megaapp.online,286945,ES22209500845884487347,6753.85,2022-11-01T21:20:51,Vitoria-Gasteiz,expenses,leisure,-80.91,8502.06
buyer_3,Ana,Etxebarria,1989-08-23,49614208B,ana.etxebarria@megaapp.online,286945,ES22209500845884487347,6753.85,2022-11-02T10:16:40,Vitoria-Gasteiz,expenses,food,-66.35,8435.71
buyer_3,Ana,Etxebarria,1989-08-23,49614208B,ana.etxebarria@megaapp.online,286945,ES22209500845884487347,6753.85,2022-11-02T18:13:04,Vitoria-Gasteiz,expenses,leisure,-59.31,8376.4
buyer_3,Ana,Etxebarria,1989-08-23,49614208B,ana.etxebarria@megaapp.online,286945,ES22209500845884487347,6753.85,2022-11-03T16:27:30,Vitoria-Gasteiz,expenses,food,-71.92,8304.48
buyer_3,Ana,Etxebarria,1989-08-23,49614208B,ana.etxebarria@megaapp.online,286945,ES22209500845884487347,6753.85,2022-11-03T10:53:21,Vitoria-Gasteiz,expenses,repairs,-108.29,8196.19
buyer_3,Ana,Etxebarria,1989-08-23,49614208B,ana.etxebarria@megaapp.online,286945,ES22209500845884487347,6753.85,2022-11-04T08:46:22,Vitoria-Gasteiz,expenses,transport,-85.51,8110.68
buyer_3,Ana,Etxebarria,1989-08-23,49614208B,ana.etxebarria@megaapp.online,286945,ES22209500845884487347,6753.85,2022-11-05T16:19:09,Vitoria-Gasteiz,expenses,mortgage,-3471.8,4638.88
buyer_3,Ana,Etxebarria,1989-08-23,49614208B,ana.etxebarria@megaapp.online,286945,ES22209500845884487347,6753.85,2022-11-05T11:01:53,Vitoria-Gasteiz,expenses,electricity,-194.06,4444.82
buyer_3,Ana,Etxebarria,1989-08-23,49614208B,ana.etxebarria@megaapp.online,286945,ES22209500845884487347,6753.85,2022-11-06T10:28:09,Vitoria-Gasteiz,expenses,water,-111.81,4333.01
buyer_3,Ana,Etxebarria,1989-08-23,49614208B,ana.etxebarria@megaapp.online,286945,ES22209500845884487347,6753.85,2022-11-06T19:06:58,Vitoria-Gasteiz,expenses,phone,-148.84,4184.17
buyer_3,Ana,Etxebarria,1989-08-23,49614208B,ana.etxebarria@megaapp.online,286945,ES22209500845884487347,6753.85,2022-11-07T12:19:44,Vitoria-Gasteiz,expenses,water,-94.08,4090.09
buyer_3,Ana,Etxebarria,1989-08-23,49614208B,ana.etxebarria@megaapp.online,286945,ES22209500845884487347,6753.85,2022-11-07T12:57:05,Vitoria-Gasteiz,expenses,transport,-41.7,4048.39
buyer_3,Ana,Etxebarria,1989-08-23,49614208B,ana.etxebarria@megaapp.online,286945,ES22209500845884487347,6753.85,2022-11-07T11:50:03,Vitoria-Gasteiz,expenses,gifts,-816.43,3231.96
buyer_3,Ana,Etxebarria,1989-08-23,49614208B,ana.etxebarria@megaapp.online,286945,ES22209500845884487347,6753.85,2022-11-11T14:14:08,Vitoria-Gasteiz,expenses,transport,-41.83,3190.13
buyer_3,Ana,Etxebarria,1989-08-23,49614208B,ana.etxebarria@megaapp.online,286945,ES22209500845884487347,6753.85,2022-11-13T15:18:00,Vitoria-Gasteiz,expenses,gifts,-286.27,2903.86
buyer_3,Ana,Etxebarria,1989-08-23,49614208B,ana.etxebarria@megaapp.online,286945,ES22209500845884487347,6753.85,2022-11-16T14:02:36,Vitoria-Gasteiz,expenses,transport,-66.63,2837.23
buyer_3,Ana,Etxebarria,1989-08-23,49614208B,ana.etxebarria@megaapp.online,286945,ES22209500845884487347,6753.85,2022-11-16T09:55:30,Vitoria-Gasteiz,expenses,healthcare,-163.72,2673.51
buyer_3,Ana,Etxebarria,1989-08-23,49614208B,ana.etxebarria@megaapp.online,286945,ES22209500845884487347,6753.85,2022-11-18T19:50:38,Vitoria-Gasteiz,expenses,transport,-78.96,2594.55
buyer_3,Ana,Etxebarria,1989-08-23,49614208B,ana.etxebarria@megaapp.online,286945,ES22209500845884487347,6753.85,2022-11-19T15:58:56,Vitoria-Gasteiz,expenses,food,-102.77,2491.78
buyer_3,Ana,Etxebarria,1989-08-23,49614208B,ana.etxebarria@megaapp.online,286945,ES22209500845884487347,6753.85,2022-11-20T20:51:27,Vitoria-Gasteiz,expenses,repairs,-136.06,2355.72
buyer_3,Ana,Etxebarria,1989-08-23,49614208B,ana.etxebarria@megaapp.online,286945,ES22209500845884487347,6753.85,2022-11-27T20:03:03,Vitoria-Gasteiz,expenses,education,-52.28,2303.44
buyer_3,Ana,Etxebarria,1989-08-23,49614208B,ana.etxebarria@megaapp.online,286945,ES22209500845884487347,6753.85,2022-11-28T09:47:40,Vitoria-Gasteiz,expenses,repairs,-100.81,2202.63
buyer_3,Ana,Etxebarria,1989-08-23,49614208B,ana.etxebarria@megaapp.online,286945,ES22209500845884487347,6753.85,2022-11-29T18:53:36,Vitoria-Gasteiz,expenses,gifts,-553.07,1649.56
buyer_3,Ana,Etxebarria,1989-08-23,49614208B,ana.etxebarria@megaapp.online,286945,ES22209500845884487347,6753.85,2022-12-01T12:14:04,Vitoria-Gasteiz,incomes,salary,3138.75,4788.31
buyer_3,Ana,Etxebarria,1989-08-23,49614208B,ana.etxebarria@megaapp.online,286945,ES22209500845884487347,6753.85,2022-12-01T12:14:04,Vitoria-Gasteiz,incomes,salary_partner,3762.16,8550.47
buyer_3,Ana,Etxebarria,1989-08-23,49614208B,ana.etxebarria@megaapp.online,286945,ES22209500845884487347,6753.85,2022-12-01T12:14:04,Vitoria-Gasteiz,incomes,salary_bonus,2268.22,10818.69
buyer_3,Ana,Etxebarria,1989-08-23,49614208B,ana.etxebarria@megaapp.online,286945,ES22209500845884487347,6753.85,2022-12-01T12:14:04,Vitoria-Gasteiz,incomes,salary_partner_bonus,2786.91,13605.6
buyer_3,Ana,Etxebarria,1989-08-23,49614208B,ana.etxebarria@megaapp.online,286945,ES22209500845884487347,6753.85,2022-12-04T12:15:57,Vitoria-Gasteiz,expenses,leisure,-47.49,13558.11
buyer_3,Ana,Etxebarria,1989-08-23,49614208B,ana.etxebarria@megaapp.online,286945,ES22209500845884487347,6753.85,2022-12-04T21:03:39,Vitoria-Gasteiz,expenses,clothing,-152.95,13405.16
buyer_3,Ana,Etxebarria,1989-08-23,49614208B,ana.etxebarria@megaapp.online,286945,ES22209500845884487347,6753.85,2022-12-05T09:27:12,Vitoria-Gasteiz,expenses,mortgage,-3471.8,9933.36
buyer_3,Ana,Etxebarria,1989-08-23,49614208B,ana.etxebarria@megaapp.online,286945,ES22209500845884487347,6753.85,2022-12-05T09:52:26,Vitoria-Gasteiz,expenses,water,-100.99,9832.37
buyer_3,Ana,Etxebarria,1989-08-23,49614208B,ana.etxebarria@megaapp.online,286945,ES22209500845884487347,6753.85,2022-12-05T08:31:09,Vitoria-Gasteiz,expenses,leisure,-62.4,9769.97
buyer_3,Ana,Etxebarria,1989-08-23,49614208B,ana.etxebarria@megaapp.online,286945,ES22209500845884487347,6753.85,2022-12-05T15:34:56,Vitoria-Gasteiz,expenses,gifts,-286.37,9483.6
buyer_3,Ana,Etxebarria,1989-08-23,49614208B,ana.etxebarria@megaapp.online,286945,ES22209500845884487347,6753.85,2022-12-06T08:18:17,Vitoria-Gasteiz,expenses,water,-87.2,9396.4
buyer_3,Ana,Etxebarria,1989-08-23,49614208B,ana.etxebarria@megaapp.online,286945,ES22209500845884487347,6753.85,2022-12-06T13:34:42,Vitoria-Gasteiz,expenses,gas,-222.09,9174.31
buyer_3,Ana,Etxebarria,1989-08-23,49614208B,ana.etxebarria@megaapp.online,286945,ES22209500845884487347,6753.85,2022-12-06T08:16:54,Vitoria-Gasteiz,expenses,phone,-120.49,9053.82
buyer_3,Ana,Etxebarria,1989-08-23,49614208B,ana.etxebarria@megaapp.online,286945,ES22209500845884487347,6753.85,2022-12-07T17:22:48,Vitoria-Gasteiz,expenses,water,-116.18,8937.64
buyer_3,Ana,Etxebarria,1989-08-23,49614208B,ana.etxebarria@megaapp.online,286945,ES22209500845884487347,6753.85,2022-12-07T14:38:25,Vitoria-Gasteiz,expenses,healthcare,-62.66,8874.98
buyer_3,Ana,Etxebarria,1989-08-23,49614208B,ana.etxebarria@megaapp.online,286945,ES22209500845884487347,6753.85,2022-12-08T10:57:01,Vitoria-Gasteiz,expenses,water,-146.34,8728.64
buyer_3,Ana,Etxebarria,1989-08-23,49614208B,ana.etxebarria@megaapp.online,286945,ES22209500845884487347,6753.85,2022-12-08T05:13:28,Vitoria-Gasteiz,expenses,electricity,-229.39,8499.25
buyer_3,Ana,Etxebarria,1989-08-23,49614208B,ana.etxebarria@megaapp.online,286945,ES22209500845884487347,6753.85,2022-12-08T16:31:52,Vitoria-Gasteiz,expenses,gas,-319.99,8179.26
buyer_3,Ana,Etxebarria,1989-08-23,49614208B,ana.etxebarria@megaapp.online,286945,ES22209500845884487347,6753.85,2022-12-08T14:34:06,Vitoria-Gasteiz,expenses,repairs,-214.73,7964.53
buyer_3,Ana,Etxebarria,1989-08-23,49614208B,ana.etxebarria@megaapp.online,286945,ES22209500845884487347,6753.85,2022-12-12T14:38:22,Vitoria-Gasteiz,expenses,transport,-45.18,7919.35
buyer_3,Ana,Etxebarria,1989-08-23,49614208B,ana.etxebarria@megaapp.online,286945,ES22209500845884487347,6753.85,2022-12-12T17:56:03,Vitoria-Gasteiz,expenses,cash,-100.0,7819.35
buyer_3,Ana,Etxebarria,1989-08-23,49614208B,ana.etxebarria@megaapp.online,286945,ES22209500845884487347,6753.85,2022-12-13T14:47:52,Vitoria-Gasteiz,expenses,transport,-40.88,7778.47
buyer_3,Ana,Etxebarria,1989-08-23,49614208B,ana.etxebarria@megaapp.online,286945,ES22209500845884487347,6753.85,2022-12-13T15:19:42,Vitoria-Gasteiz,expenses,leisure,-51.74,7726.73
buyer_3,Ana,Etxebarria,1989-08-23,49614208B,ana.etxebarria@megaapp.online,286945,ES22209500845884487347,6753.85,2022-12-13T10:23:08,Vitoria-Gasteiz,expenses,repairs,-140.35,7586.38
buyer_3,Ana,Etxebarria,1989-08-23,49614208B,ana.etxebarria@megaapp.online,286945,ES22209500845884487347,6753.85,2022-12-14T16:01:29,Vitoria-Gasteiz,expenses,leisure,-29.72,7556.66
buyer_3,Ana,Etxebarria,1989-08-23,49614208B,ana.etxebarria@megaapp.online,286945,ES22209500845884487347,6753.85,2022-12-16T11:19:36,Vitoria-Gasteiz,expenses,food,-97.38,7459.28
buyer_3,Ana,Etxebarria,1989-08-23,49614208B,ana.etxebarria@megaapp.online,286945,ES22209500845884487347,6753.85,2022-12-17T12:38:47,Vitoria-Gasteiz,expenses,food,-78.15,7381.13
buyer_3,Ana,Etxebarria,1989-08-23,49614208B,ana.etxebarria@megaapp.online,286945,ES22209500845884487347,6753.85,2022-12-17T19:33:26,Vitoria-Gasteiz,expenses,repairs,-329.59,7051.54
buyer_3,Ana,Etxebarria,1989-08-23,49614208B,ana.etxebarria@megaapp.online,286945,ES22209500845884487347,6753.85,2022-12-18T13:23:39,Vitoria-Gasteiz,expenses,food,-94.81,6956.73
buyer_3,Ana,Etxebarria,1989-08-23,49614208B,ana.etxebarria@megaapp.online,286945,ES22209500845884487347,6753.85,2022-12-21T18:22:08,Vitoria-Gasteiz,expenses,cash,-100.0,6856.73
buyer_3,Ana,Etxebarria,1989-08-23,49614208B,ana.etxebarria@megaapp.online,286945,ES22209500845884487347,6753.85,2022-12-25T12:18:13,Vitoria-Gasteiz,expenses,leisure,-29.3,6827.43
buyer_3,Ana,Etxebarria,1989-08-23,49614208B,ana.etxebarria@megaapp.online,286945,ES22209500845884487347,6753.85,2022-12-26T12:34:37,Vitoria-Gasteiz,expenses,food,-61.26,6766.17
buyer_3,Ana,Etxebarria,1989-08-23,49614208B,ana.etxebarria@megaapp.online,286945,ES22209500845884487347,6753.85,2022-12-26T13:06:16,Vitoria-Gasteiz,expenses,cash,-100.0,6666.17
buyer_3,Ana,Etxebarria,1989-08-23,49614208B,ana.etxebarria@megaapp.online,286945,ES22209500845884487347,6753.85,2022-12-29T16:41:27,Vitoria-Gasteiz,expenses,transport,-41.36,6624.81
buyer_3,Ana,Etxebarria,1989-08-23,49614208B,ana.etxebarria@megaapp.online,286945,ES22209500845884487347,6753.85,2023-01-01T10:04:07,Vitoria-Gasteiz,incomes,salary,3260.85,9885.66
buyer_3,Ana,Etxebarria,1989-08-23,49614208B,ana.etxebarria@megaapp.online,286945,ES22209500845884487347,6753.85,2023-01-01T10:04:07,Vitoria-Gasteiz,incomes,salary_partner,3908.51,13794.17
buyer_3,Ana,Etxebarria,1989-08-23,49614208B,ana.etxebarria@megaapp.online,286945,ES22209500845884487347,6753.85,2023-01-01T08:00:44,Vitoria-Gasteiz,expenses,leisure,-39.97,13754.2
buyer_3,Ana,Etxebarria,1989-08-23,49614208B,ana.etxebarria@megaapp.online,286945,ES22209500845884487347,6753.85,2023-01-03T17:45:26,Vitoria-Gasteiz,expenses,transport,-54.93,13699.27
buyer_3,Ana,Etxebarria,1989-08-23,49614208B,ana.etxebarria@megaapp.online,286945,ES22209500845884487347,6753.85,2023-01-03T12:02:45,Vitoria-Gasteiz,expenses,cash,-100.0,13599.27
buyer_3,Ana,Etxebarria,1989-08-23,49614208B,ana.etxebarria@megaapp.online,286945,ES22209500845884487347,6753.85,2023-01-05T08:32:36,Vitoria-Gasteiz,expenses,mortgage,-3872.86,9726.41
buyer_3,Ana,Etxebarria,1989-08-23,49614208B,ana.etxebarria@megaapp.online,286945,ES22209500845884487347,6753.85,2023-01-05T14:35:42,Vitoria-Gasteiz,expenses,education,-60.16,9666.25
buyer_3,Ana,Etxebarria,1989-08-23,49614208B,ana.etxebarria@megaapp.online,286945,ES22209500845884487347,6753.85,2023-01-05T10:46:47,Vitoria-Gasteiz,expenses,cash,-100.0,9566.25
buyer_3,Ana,Etxebarria,1989-08-23,49614208B,ana.etxebarria@megaapp.online,286945,ES22209500845884487347,6753.85,2023-01-06T16:55:22,Vitoria-Gasteiz,expenses,phone,-134.61,9431.64
buyer_3,Ana,Etxebarria,1989-08-23,49614208B,ana.etxebarria@megaapp.online,286945,ES22209500845884487347,6753.85,2023-01-07T03:20:00,Vitoria-Gasteiz,expenses,electricity,-204.36,9227.28
buyer_3,Ana,Etxebarria,1989-08-23,49614208B,ana.etxebarria@megaapp.online,286945,ES22209500845884487347,6753.85,2023-01-08T17:00:15,Vitoria-Gasteiz,expenses,electricity,-303.38,8923.9
buyer_3,Ana,Etxebarria,1989-08-23,49614208B,ana.etxebarria@megaapp.online,286945,ES22209500845884487347,6753.85,2023-01-08T16:29:29,Vitoria-Gasteiz,expenses,internet,-150.56,8773.34
buyer_3,Ana,Etxebarria,1989-08-23,49614208B,ana.etxebarria@megaapp.online,286945,ES22209500845884487347,6753.85,2023-01-08T10:27:08,Vitoria-Gasteiz,expenses,food,-92.73,8680.61
buyer_3,Ana,Etxebarria,1989-08-23,49614208B,ana.etxebarria@megaapp.online,286945,ES22209500845884487347,6753.85,2023-01-08T19:16:25,Vitoria-Gasteiz,expenses,gifts,-355.48,8325.13
buyer_3,Ana,Etxebarria,1989-08-23,49614208B,ana.etxebarria@megaapp.online,286945,ES22209500845884487347,6753.85,2023-01-10T17:59:03,Vitoria-Gasteiz,expenses,food,-71.74,8253.39
buyer_3,Ana,Etxebarria,1989-08-23,49614208B,ana.etxebarria@megaapp.online,286945,ES22209500845884487347,6753.85,2023-01-11T18:44:15,Vitoria-Gasteiz,expenses,cash,-100.0,8153.39
buyer_3,Ana,Etxebarria,1989-08-23,49614208B,ana.etxebarria@megaapp.online,286945,ES22209500845884487347,6753.85,2023-01-12T22:38:29,Vitoria-Gasteiz,expenses,food,-62.63,8090.76
buyer_3,Ana,Etxebarria,1989-08-23,49614208B,ana.etxebarria@megaapp.online,286945,ES22209500845884487347,6753.85,2023-01-12T17:01:38,Vitoria-Gasteiz,expenses,transport,-70.24,8020.52
buyer_3,Ana,Etxebarria,1989-08-23,49614208B,ana.etxebarria@megaapp.online,286945,ES22209500845884487347,6753.85,2023-01-13T16:49:46,Vitoria-Gasteiz,expenses,food,-66.72,7953.8
buyer_3,Ana,Etxebarria,1989-08-23,49614208B,ana.etxebarria@megaapp.online,286945,ES22209500845884487347,6753.85,2023-01-13T15:15:59,Vitoria-Gasteiz,expenses,cash,-100.0,7853.8
buyer_3,Ana,Etxebarria,1989-08-23,49614208B,ana.etxebarria@megaapp.online,286945,ES22209500845884487347,6753.85,2023-01-15T16:52:08,Vitoria-Gasteiz,expenses,education,-71.44,7782.36
buyer_3,Ana,Etxebarria,1989-08-23,49614208B,ana.etxebarria@megaapp.online,286945,ES22209500845884487347,6753.85,2023-01-15T10:54:16,Vitoria-Gasteiz,expenses,appliances,-362.09,7420.27
buyer_3,Ana,Etxebarria,1989-08-23,49614208B,ana.etxebarria@megaapp.online,286945,ES22209500845884487347,6753.85,2023-01-18T17:25:11,Vitoria-Gasteiz,expenses,cash,-100.0,7320.27
buyer_3,Ana,Etxebarria,1989-08-23,49614208B,ana.etxebarria@megaapp.online,286945,ES22209500845884487347,6753.85,2023-01-18T10:46:43,Vitoria-Gasteiz,expenses,appliances,-167.99,7152.28
buyer_3,Ana,Etxebarria,1989-08-23,49614208B,ana.etxebarria@megaapp.online,286945,ES22209500845884487347,6753.85,2023-01-20T16:40:44,Vitoria-Gasteiz,expenses,food,-80.85,7071.43
buyer_3,Ana,Etxebarria,1989-08-23,49614208B,ana.etxebarria@megaapp.online,286945,ES22209500845884487347,6753.85,2023-01-22T20:48:58,Vitoria-Gasteiz,expenses,food,-86.61,6984.82
buyer_3,Ana,Etxebarria,1989-08-23,49614208B,ana.etxebarria@megaapp.online,286945,ES22209500845884487347,6753.85,2023-01-22T17:12:47,Vitoria-Gasteiz,expenses,cash,-100.0,6884.82
buyer_3,Ana,Etxebarria,1989-08-23,49614208B,ana.etxebarria@megaapp.online,286945,ES22209500845884487347,6753.85,2023-01-23T11:52:33,Vitoria-Gasteiz,expenses,leisure,-20.71,6864.11
buyer_3,Ana,Etxebarria,1989-08-23,49614208B,ana.etxebarria@megaapp.online,286945,ES22209500845884487347,6753.85,2023-01-24T09:59:31,Vitoria-Gasteiz,expenses,repairs,-100.25,6763.86
buyer_3,Ana,Etxebarria,1989-08-23,49614208B,ana.etxebarria@megaapp.online,286945,ES22209500845884487347,6753.85,2023-01-25T14:19:19,Vitoria-Gasteiz,expenses,cash,-100.0,6663.86
buyer_3,Ana,Etxebarria,1989-08-23,49614208B,ana.etxebarria@megaapp.online,286945,ES22209500845884487347,6753.85,2023-01-30T13:56:14,Vitoria-Gasteiz,expenses,transport,-43.68,6620.18
buyer_3,Ana,Etxebarria,1989-08-23,49614208B,ana.etxebarria@megaapp.online,286945,ES22209500845884487347,6753.85,2023-01-31T12:22:39,Vitoria-Gasteiz,expenses,education,-56.01,6564.17
buyer_3,Ana,Etxebarria,1989-08-23,49614208B,ana.etxebarria@megaapp.online,286945,ES22209500845884487347,6753.85,2023-02-01T19:05:51,Vitoria-Gasteiz,incomes,salary,3260.85,9825.02
buyer_3,Ana,Etxebarria,1989-08-23,49614208B,ana.etxebarria@megaapp.online,286945,ES22209500845884487347,6753.85,2023-02-01T19:05:51,Vitoria-Gasteiz,incomes,salary_partner,3908.51,13733.53
buyer_3,Ana,Etxebarria,1989-08-23,49614208B,ana.etxebarria@megaapp.online,286945,ES22209500845884487347,6753.85,2023-02-01T19:05:51,Vitoria-Gasteiz,incomes,extra_income,412.38,14145.91
buyer_3,Ana,Etxebarria,1989-08-23,49614208B,ana.etxebarria@megaapp.online,286945,ES22209500845884487347,6753.85,2023-02-05T10:10:08,Vitoria-Gasteiz,expenses,mortgage,-3872.86,10273.05
buyer_3,Ana,Etxebarria,1989-08-23,49614208B,ana.etxebarria@megaapp.online,286945,ES22209500845884487347,6753.85,2023-02-05T14:15:03,Vitoria-Gasteiz,expenses,gas,-332.89,9940.16
buyer_3,Ana,Etxebarria,1989-08-23,49614208B,ana.etxebarria@megaapp.online,286945,ES22209500845884487347,6753.85,2023-02-06T14:52:52,Vitoria-Gasteiz,expenses,gas,-213.18,9726.98
buyer_3,Ana,Etxebarria,1989-08-23,49614208B,ana.etxebarria@megaapp.online,286945,ES22209500845884487347,6753.85,2023-02-07T09:40:48,Vitoria-Gasteiz,expenses,phone,-149.45,9577.53
buyer_3,Ana,Etxebarria,1989-08-23,49614208B,ana.etxebarria@megaapp.online,286945,ES22209500845884487347,6753.85,2023-02-07T22:21:48,Vitoria-Gasteiz,expenses,food,-105.49,9472.04
buyer_3,Ana,Etxebarria,1989-08-23,49614208B,ana.etxebarria@megaapp.online,286945,ES22209500845884487347,6753.85,2023-02-08T19:51:02,Vitoria-Gasteiz,expenses,water,-120.67,9351.37
buyer_3,Ana,Etxebarria,1989-08-23,49614208B,ana.etxebarria@megaapp.online,286945,ES22209500845884487347,6753.85,2023-02-08T17:21:28,Vitoria-Gasteiz,expenses,internet,-150.56,9200.81
buyer_3,Ana,Etxebarria,1989-08-23,49614208B,ana.etxebarria@megaapp.online,286945,ES22209500845884487347,6753.85,2023-02-09T14:55:09,Vitoria-Gasteiz,expenses,gifts,-696.07,8504.74
buyer_3,Ana,Etxebarria,1989-08-23,49614208B,ana.etxebarria@megaapp.online,286945,ES22209500845884487347,6753.85,2023-02-11T16:29:05,Vitoria-Gasteiz,expenses,cash,-100.0,8404.74
buyer_3,Ana,Etxebarria,1989-08-23,49614208B,ana.etxebarria@megaapp.online,286945,ES22209500845884487347,6753.85,2023-02-12T14:49:33,Vitoria-Gasteiz,expenses,transport,-54.43,8350.31
buyer_3,Ana,Etxebarria,1989-08-23,49614208B,ana.etxebarria@megaapp.online,286945,ES22209500845884487347,6753.85,2023-02-13T14:40:26,Vitoria-Gasteiz,expenses,food,-92.19,8258.12
buyer_3,Ana,Etxebarria,1989-08-23,49614208B,ana.etxebarria@megaapp.online,286945,ES22209500845884487347,6753.85,2023-02-14T13:02:49,Vitoria-Gasteiz,expenses,transport,-81.78,8176.34
buyer_3,Ana,Etxebarria,1989-08-23,49614208B,ana.etxebarria@megaapp.online,286945,ES22209500845884487347,6753.85,2023-02-14T16:55:38,Vitoria-Gasteiz,expenses,clothing,-74.52,8101.82
buyer_3,Ana,Etxebarria,1989-08-23,49614208B,ana.etxebarria@megaapp.online,286945,ES22209500845884487347,6753.85,2023-02-14T16:19:55,Vitoria-Gasteiz,expenses,cash,-100.0,8001.82
buyer_3,Ana,Etxebarria,1989-08-23,49614208B,ana.etxebarria@megaapp.online,286945,ES22209500845884487347,6753.85,2023-02-16T15:54:25,Vitoria-Gasteiz,expenses,cash,-100.0,7901.82
buyer_3,Ana,Etxebarria,1989-08-23,49614208B,ana.etxebarria@megaapp.online,286945,ES22209500845884487347,6753.85,2023-02-17T21:41:46,Vitoria-Gasteiz,expenses,clothing,-142.08,7759.74
buyer_3,Ana,Etxebarria,1989-08-23,49614208B,ana.etxebarria@megaapp.online,286945,ES22209500845884487347,6753.85,2023-02-17T12:20:04,Vitoria-Gasteiz,expenses,cash,-100.0,7659.74
buyer_3,Ana,Etxebarria,1989-08-23,49614208B,ana.etxebarria@megaapp.online,286945,ES22209500845884487347,6753.85,2023-02-17T17:22:59,Vitoria-Gasteiz,expenses,travel,-615.8,7043.94
buyer_3,Ana,Etxebarria,1989-08-23,49614208B,ana.etxebarria@megaapp.online,286945,ES22209500845884487347,6753.85,2023-02-18T14:14:36,Vitoria-Gasteiz,expenses,gifts,-593.89,6450.05
buyer_3,Ana,Etxebarria,1989-08-23,49614208B,ana.etxebarria@megaapp.online,286945,ES22209500845884487347,6753.85,2023-02-19T16:09:56,Vitoria-Gasteiz,expenses,food,-63.16,6386.89
buyer_3,Ana,Etxebarria,1989-08-23,49614208B,ana.etxebarria@megaapp.online,286945,ES22209500845884487347,6753.85,2023-02-19T23:17:58,Vitoria-Gasteiz,expenses,travel,-300.01,6086.88
buyer_3,Ana,Etxebarria,1989-08-23,49614208B,ana.etxebarria@megaapp.online,286945,ES22209500845884487347,6753.85,2023-02-20T15:13:31,Vitoria-Gasteiz,expenses,food,-75.94,6010.94
buyer_3,Ana,Etxebarria,1989-08-23,49614208B,ana.etxebarria@megaapp.online,286945,ES22209500845884487347,6753.85,2023-02-22T09:19:07,Vitoria-Gasteiz,expenses,education,-52.03,5958.91
buyer_3,Ana,Etxebarria,1989-08-23,49614208B,ana.etxebarria@megaapp.online,286945,ES22209500845884487347,6753.85,2023-02-25T19:01:31,Vitoria-Gasteiz,expenses,food,-88.75,5870.16
buyer_3,Ana,Etxebarria,1989-08-23,49614208B,ana.etxebarria@megaapp.online,286945,ES22209500845884487347,6753.85,2023-02-26T12:43:38,Vitoria-Gasteiz,expenses,food,-124.35,5745.81
buyer_3,Ana,Etxebarria,1989-08-23,49614208B,ana.etxebarria@megaapp.online,286945,ES22209500845884487347,6753.85,2023-02-27T11:06:17,Vitoria-Gasteiz,expenses,food,-120.54,5625.27
buyer_3,Ana,Etxebarria,1989-08-23,49614208B,ana.etxebarria@megaapp.online,286945,ES22209500845884487347,6753.85,2023-02-28T15:48:13,Vitoria-Gasteiz,expenses,healthcare,-100.4,5524.87
buyer_3,Ana,Etxebarria,1989-08-23,49614208B,ana.etxebarria@megaapp.online,286945,ES22209500845884487347,6753.85,2023-03-01T23:06:14,Vitoria-Gasteiz,incomes,salary,3260.85,8785.72
buyer_3,Ana,Etxebarria,1989-08-23,49614208B,ana.etxebarria@megaapp.online,286945,ES22209500845884487347,6753.85,2023-03-01T23:06:14,Vitoria-Gasteiz,incomes,salary_partner,3908.51,12694.23
buyer_3,Ana,Etxebarria,1989-08-23,49614208B,ana.etxebarria@megaapp.online,286945,ES22209500845884487347,6753.85,2023-03-01T15:32:08,Vitoria-Gasteiz,expenses,leisure,-38.98,12655.25
buyer_3,Ana,Etxebarria,1989-08-23,49614208B,ana.etxebarria@megaapp.online,286945,ES22209500845884487347,6753.85,2023-03-02T05:50:23,Vitoria-Gasteiz,expenses,cash,-100.0,12555.25
buyer_3,Ana,Etxebarria,1989-08-23,49614208B,ana.etxebarria@megaapp.online,286945,ES22209500845884487347,6753.85,2023-03-03T17:19:16,Vitoria-Gasteiz,expenses,repairs,-257.79,12297.46
buyer_3,Ana,Etxebarria,1989-08-23,49614208B,ana.etxebarria@megaapp.online,286945,ES22209500845884487347,6753.85,2023-03-04T09:57:52,Vitoria-Gasteiz,expenses,cash,-100.0,12197.46
buyer_3,Ana,Etxebarria,1989-08-23,49614208B,ana.etxebarria@megaapp.online,286945,ES22209500845884487347,6753.85,2023-03-05T19:57:23,Vitoria-Gasteiz,expenses,mortgage,-3872.86,8324.6
buyer_3,Ana,Etxebarria,1989-08-23,49614208B,ana.etxebarria@megaapp.online,286945,ES22209500845884487347,6753.85,2023-03-05T11:39:15,Vitoria-Gasteiz,expenses,electricity,-225.42,8099.18
buyer_3,Ana,Etxebarria,1989-08-23,49614208B,ana.etxebarria@megaapp.online,286945,ES22209500845884487347,6753.85,2023-03-05T10:29:26,Vitoria-Gasteiz,expenses,phone,-131.6,7967.58
buyer_3,Ana,Etxebarria,1989-08-23,49614208B,ana.etxebarria@megaapp.online,286945,ES22209500845884487347,6753.85,2023-03-05T09:14:55,Vitoria-Gasteiz,expenses,healthcare,-144.26,7823.32
buyer_3,Ana,Etxebarria,1989-08-23,49614208B,ana.etxebarria@megaapp.online,286945,ES22209500845884487347,6753.85,2023-03-08T19:09:51,Vitoria-Gasteiz,expenses,water,-114.49,7708.83
buyer_3,Ana,Etxebarria,1989-08-23,49614208B,ana.etxebarria@megaapp.online,286945,ES22209500845884487347,6753.85,2023-03-08T10:35:20,Vitoria-Gasteiz,expenses,gas,-214.41,7494.42
buyer_3,Ana,Etxebarria,1989-08-23,49614208B,ana.etxebarria@megaapp.online,286945,ES22209500845884487347,6753.85,2023-03-08T09:30:32,Vitoria-Gasteiz,expenses,phone,-115.99,7378.43
buyer_3,Ana,Etxebarria,1989-08-23,49614208B,ana.etxebarria@megaapp.online,286945,ES22209500845884487347,6753.85,2023-03-08T10:21:18,Vitoria-Gasteiz,expenses,food,-78.7,7299.73
buyer_3,Ana,Etxebarria,1989-08-23,49614208B,ana.etxebarria@megaapp.online,286945,ES22209500845884487347,6753.85,2023-03-09T20:01:34,Vitoria-Gasteiz,expenses,transport,-60.19,7239.54
buyer_3,Ana,Etxebarria,1989-08-23,49614208B,ana.etxebarria@megaapp.online,286945,ES22209500845884487347,6753.85,2023-03-11T10:21:33,Vitoria-Gasteiz,expenses,transport,-78.91,7160.63
buyer_3,Ana,Etxebarria,1989-08-23,49614208B,ana.etxebarria@megaapp.online,286945,ES22209500845884487347,6753.85,2023-03-13T00:49:42,Vitoria-Gasteiz,expenses,clothing,-138.98,7021.65
buyer_3,Ana,Etxebarria,1989-08-23,49614208B,ana.etxebarria@megaapp.online,286945,ES22209500845884487347,6753.85,2023-03-14T22:26:08,Vitoria-Gasteiz,expenses,food,-104.16,6917.49
buyer_3,Ana,Etxebarria,1989-08-23,49614208B,ana.etxebarria@megaapp.online,286945,ES22209500845884487347,6753.85,2023-03-14T23:46:52,Vitoria-Gasteiz,expenses,transport,-66.7,6850.79
buyer_3,Ana,Etxebarria,1989-08-23,49614208B,ana.etxebarria@megaapp.online,286945,ES22209500845884487347,6753.85,2023-03-14T11:58:25,Vitoria-Gasteiz,expenses,repairs,-219.93,6630.86
buyer_3,Ana,Etxebarria,1989-08-23,49614208B,ana.etxebarria@megaapp.online,286945,ES22209500845884487347,6753.85,2023-03-17T22:07:54,Vitoria-Gasteiz,expenses,cash,-100.0,6530.86
buyer_3,Ana,Etxebarria,1989-08-23,49614208B,ana.etxebarria@megaapp.online,286945,ES22209500845884487347,6753.85,2023-03-17T15:24:39,Vitoria-Gasteiz,expenses,repairs,-46.6,6484.26
buyer_3,Ana,Etxebarria,1989-08-23,49614208B,ana.etxebarria@megaapp.online,286945,ES22209500845884487347,6753.85,2023-03-18T08:06:49,Vitoria-Gasteiz,expenses,cash,-100.0,6384.26
buyer_3,Ana,Etxebarria,1989-08-23,49614208B,ana.etxebarria@megaapp.online,286945,ES22209500845884487347,6753.85,2023-03-22T23:26:22,Vitoria-Gasteiz,expenses,food,-72.38,6311.88
buyer_3,Ana,Etxebarria,1989-08-23,49614208B,ana.etxebarria@megaapp.online,286945,ES22209500845884487347,6753.85,2023-03-23T16:37:23,Vitoria-Gasteiz,expenses,cash,-100.0,6211.88
buyer_3,Ana,Etxebarria,1989-08-23,49614208B,ana.etxebarria@megaapp.online,286945,ES22209500845884487347,6753.85,2023-03-26T02:06:54,Vitoria-Gasteiz,expenses,cash,-100.0,6111.88
buyer_3,Ana,Etxebarria,1989-08-23,49614208B,ana.etxebarria@megaapp.online,286945,ES22209500845884487347,6753.85,2023-03-27T16:31:06,Vitoria-Gasteiz,expenses,cash,-100.0,6011.88
buyer_3,Ana,Etxebarria,1989-08-23,49614208B,ana.etxebarria@megaapp.online,286945,ES22209500845884487347,6753.85,2023-03-28T15:06:55,Vitoria-Gasteiz,expenses,gifts,-556.82,5455.06
buyer_3,Ana,Etxebarria,1989-08-23,49614208B,ana.etxebarria@megaapp.online,286945,ES22209500845884487347,6753.85,2023-03-31T12:22:22,Vitoria-Gasteiz,expenses,cash,-100.0,5355.06
buyer_3,Ana,Etxebarria,1989-08-23,49614208B,ana.etxebarria@megaapp.online,286945,ES22209500845884487347,6753.85,2023-03-31T23:49:32,Vitoria-Gasteiz,expenses,gifts,-724.98,4630.08
buyer_3,Ana,Etxebarria,1989-08-23,49614208B,ana.etxebarria@megaapp.online,286945,ES22209500845884487347,6753.85,2023-04-01T17:00:25,Vitoria-Gasteiz,incomes,salary,3260.85,7890.93
buyer_3,Ana,Etxebarria,1989-08-23,49614208B,ana.etxebarria@megaapp.online,286945,ES22209500845884487347,6753.85,2023-04-01T17:00:25,Vitoria-Gasteiz,incomes,salary_partner,3908.51,11799.44
buyer_3,Ana,Etxebarria,1989-08-23,49614208B,ana.etxebarria@megaapp.online,286945,ES22209500845884487347,6753.85,2023-04-02T18:48:08,Vitoria-Gasteiz,expenses,cash,-100.0,11699.44
buyer_3,Ana,Etxebarria,1989-08-23,49614208B,ana.etxebarria@megaapp.online,286945,ES22209500845884487347,6753.85,2023-04-04T12:23:32,Vitoria-Gasteiz,expenses,food,-119.32,11580.12
buyer_3,Ana,Etxebarria,1989-08-23,49614208B,ana.etxebarria@megaapp.online,286945,ES22209500845884487347,6753.85,2023-04-04T13:12:14,Vitoria-Gasteiz,expenses,education,-68.47,11511.65
buyer_3,Ana,Etxebarria,1989-08-23,49614208B,ana.etxebarria@megaapp.online,286945,ES22209500845884487347,6753.85,2023-04-04T12:04:22,Vitoria-Gasteiz,expenses,gifts,-480.78,11030.87
buyer_3,Ana,Etxebarria,1989-08-23,49614208B,ana.etxebarria@megaapp.online,286945,ES22209500845884487347,6753.85,2023-04-05T08:53:29,Vitoria-Gasteiz,expenses,mortgage,-3872.86,7158.01
buyer_3,Ana,Etxebarria,1989-08-23,49614208B,ana.etxebarria@megaapp.online,286945,ES22209500845884487347,6753.85,2023-04-05T09:47:32,Vitoria-Gasteiz,expenses,transport,-50.95,7107.06
buyer_3,Ana,Etxebarria,1989-08-23,49614208B,ana.etxebarria@megaapp.online,286945,ES22209500845884487347,6753.85,2023-04-05T11:14:54,Vitoria-Gasteiz,expenses,repairs,-171.12,6935.94
buyer_3,Ana,Etxebarria,1989-08-23,49614208B,ana.etxebarria@megaapp.online,286945,ES22209500845884487347,6753.85,2023-04-06T11:29:00,Vitoria-Gasteiz,expenses,food,-112.96,6822.98
buyer_3,Ana,Etxebarria,1989-08-23,49614208B,ana.etxebarria@megaapp.online,286945,ES22209500845884487347,6753.85,2023-04-06T16:17:44,Vitoria-Gasteiz,expenses,cash,-100.0,6722.98
buyer_3,Ana,Etxebarria,1989-08-23,49614208B,ana.etxebarria@megaapp.online,286945,ES22209500845884487347,6753.85,2023-04-08T17:42:11,Vitoria-Gasteiz,expenses,gas,-288.5,6434.48
buyer_3,Ana,Etxebarria,1989-08-23,49614208B,ana.etxebarria@megaapp.online,286945,ES22209500845884487347,6753.85,2023-04-09T00:19:03,Vitoria-Gasteiz,expenses,education,-53.11,6381.37
buyer_3,Ana,Etxebarria,1989-08-23,49614208B,ana.etxebarria@megaapp.online,286945,ES22209500845884487347,6753.85,2023-04-10T19:46:01,Vitoria-Gasteiz,expenses,transport,-77.34,6304.03
buyer_3,Ana,Etxebarria,1989-08-23,49614208B,ana.etxebarria@megaapp.online,286945,ES22209500845884487347,6753.85,2023-04-10T16:30:24,Vitoria-Gasteiz,expenses,cash,-100.0,6204.03
buyer_3,Ana,Etxebarria,1989-08-23,49614208B,ana.etxebarria@megaapp.online,286945,ES22209500845884487347,6753.85,2023-04-11T20:38:01,Vitoria-Gasteiz,expenses,cash,-100.0,6104.03
buyer_3,Ana,Etxebarria,1989-08-23,49614208B,ana.etxebarria@megaapp.online,286945,ES22209500845884487347,6753.85,2023-04-14T15:54:52,Vitoria-Gasteiz,expenses,leisure,-45.49,6058.54
buyer_3,Ana,Etxebarria,1989-08-23,49614208B,ana.etxebarria@megaapp.online,286945,ES22209500845884487347,6753.85,2023-04-15T12:09:27,Vitoria-Gasteiz,expenses,healthcare,-171.89,5886.65
buyer_3,Ana,Etxebarria,1989-08-23,49614208B,ana.etxebarria@megaapp.online,286945,ES22209500845884487347,6753.85,2023-04-16T10:57:29,Vitoria-Gasteiz,expenses,transport,-75.29,5811.36
buyer_3,Ana,Etxebarria,1989-08-23,49614208B,ana.etxebarria@megaapp.online,286945,ES22209500845884487347,6753.85,2023-04-17T10:07:19,Vitoria-Gasteiz,expenses,food,-78.58,5732.78
buyer_3,Ana,Etxebarria,1989-08-23,49614208B,ana.etxebarria@megaapp.online,286945,ES22209500845884487347,6753.85,2023-04-17T17:54:00,Vitoria-Gasteiz,expenses,appliances,-272.36,5460.42
buyer_3,Ana,Etxebarria,1989-08-23,49614208B,ana.etxebarria@megaapp.online,286945,ES22209500845884487347,6753.85,2023-04-19T14:21:27,Vitoria-Gasteiz,expenses,leisure,-37.74,5422.68
buyer_3,Ana,Etxebarria,1989-08-23,49614208B,ana.etxebarria@megaapp.online,286945,ES22209500845884487347,6753.85,2023-04-21T17:05:42,Vitoria-Gasteiz,expenses,leisure,-66.27,5356.41
buyer_3,Ana,Etxebarria,1989-08-23,49614208B,ana.etxebarria@megaapp.online,286945,ES22209500845884487347,6753.85,2023-04-22T19:29:19,Vitoria-Gasteiz,expenses,food,-117.88,5238.53
buyer_3,Ana,Etxebarria,1989-08-23,49614208B,ana.etxebarria@megaapp.online,286945,ES22209500845884487347,6753.85,2023-04-23T13:10:11,Vitoria-Gasteiz,expenses,healthcare,-142.06,5096.47
buyer_3,Ana,Etxebarria,1989-08-23,49614208B,ana.etxebarria@megaapp.online,286945,ES22209500845884487347,6753.85,2023-04-26T15:58:45,Vitoria-Gasteiz,expenses,leisure,-48.69,5047.78
buyer_3,Ana,Etxebarria,1989-08-23,49614208B,ana.etxebarria@megaapp.online,286945,ES22209500845884487347,6753.85,2023-04-28T15:21:00,Vitoria-Gasteiz,expenses,travel,-400.57,4647.21
buyer_3,Ana,Etxebarria,1989-08-23,49614208B,ana.etxebarria@megaapp.online,286945,ES22209500845884487347,6753.85,2023-05-01T09:30:37,Vitoria-Gasteiz,incomes,salary,3260.85,7908.06
buyer_3,Ana,Etxebarria,1989-08-23,49614208B,ana.etxebarria@megaapp.online,286945,ES22209500845884487347,6753.85,2023-05-01T09:30:37,Vitoria-Gasteiz,incomes,salary_partner,3908.51,11816.57
buyer_3,Ana,Etxebarria,1989-08-23,49614208B,ana.etxebarria@megaapp.online,286945,ES22209500845884487347,6753.85,2023-05-01T09:30:37,Vitoria-Gasteiz,incomes,extra_income,412.38,12228.95
buyer_3,Ana,Etxebarria,1989-08-23,49614208B,ana.etxebarria@megaapp.online,286945,ES22209500845884487347,6753.85,2023-05-01T09:03:34,Vitoria-Gasteiz,expenses,leisure,-55.65,12173.3
buyer_3,Ana,Etxebarria,1989-08-23,49614208B,ana.etxebarria@megaapp.online,286945,ES22209500845884487347,6753.85,2023-05-01T19:24:21,Vitoria-Gasteiz,expenses,cash,-100.0,12073.3
buyer_3,Ana,Etxebarria,1989-08-23,49614208B,ana.etxebarria@megaapp.online,286945,ES22209500845884487347,6753.85,2023-05-02T15:24:36,Vitoria-Gasteiz,expenses,food,-79.98,11993.32
buyer_3,Ana,Etxebarria,1989-08-23,49614208B,ana.etxebarria@megaapp.online,286945,ES22209500845884487347,6753.85,2023-05-02T14:32:03,Vitoria-Gasteiz,expenses,gifts,-82.64,11910.68
buyer_3,Ana,Etxebarria,1989-08-23,49614208B,ana.etxebarria@megaapp.online,286945,ES22209500845884487347,6753.85,2023-05-03T13:22:07,Vitoria-Gasteiz,expenses,education,-70.29,11840.39
buyer_3,Ana,Etxebarria,1989-08-23,49614208B,ana.etxebarria@megaapp.online,286945,ES22209500845884487347,6753.85,2023-05-04T12:55:28,Vitoria-Gasteiz,expenses,repairs,-246.3,11594.09
buyer_3,Ana,Etxebarria,1989-08-23,49614208B,ana.etxebarria@megaapp.online,286945,ES22209500845884487347,6753.85,2023-05-05T11:32:22,Vitoria-Gasteiz,expenses,mortgage,-3872.86,7721.23
buyer_3,Ana,Etxebarria,1989-08-23,49614208B,ana.etxebarria@megaapp.online,286945,ES22209500845884487347,6753.85,2023-05-06T03:26:20,Vitoria-Gasteiz,expenses,water,-134.55,7586.68
buyer_3,Ana,Etxebarria,1989-08-23,49614208B,ana.etxebarria@megaapp.online,286945,ES22209500845884487347,6753.85,2023-05-06T16:46:07,Vitoria-Gasteiz,expenses,gas,-356.04,7230.64
buyer_3,Ana,Etxebarria,1989-08-23,49614208B,ana.etxebarria@megaapp.online,286945,ES22209500845884487347,6753.85,2023-05-06T12:05:56,Vitoria-Gasteiz,expenses,healthcare,-175.98,7054.66
buyer_3,Ana,Etxebarria,1989-08-23,49614208B,ana.etxebarria@megaapp.online,286945,ES22209500845884487347,6753.85,2023-05-06T22:47:16,Vitoria-Gasteiz,expenses,cash,-100.0,6954.66
buyer_3,Ana,Etxebarria,1989-08-23,49614208B,ana.etxebarria@megaapp.online,286945,ES22209500845884487347,6753.85,2023-05-07T22:10:35,Vitoria-Gasteiz,expenses,water,-146.7,6807.96
buyer_3,Ana,Etxebarria,1989-08-23,49614208B,ana.etxebarria@megaapp.online,286945,ES22209500845884487347,6753.85,2023-05-08T16:54:42,Vitoria-Gasteiz,expenses,internet,-150.56,6657.4
buyer_3,Ana,Etxebarria,1989-08-23,49614208B,ana.etxebarria@megaapp.online,286945,ES22209500845884487347,6753.85,2023-05-08T00:08:41,Vitoria-Gasteiz,expenses,phone,-143.26,6514.14
buyer_3,Ana,Etxebarria,1989-08-23,49614208B,ana.etxebarria@megaapp.online,286945,ES22209500845884487347,6753.85,2023-05-09T18:11:34,Vitoria-Gasteiz,expenses,food,-113.03,6401.11
buyer_3,Ana,Etxebarria,1989-08-23,49614208B,ana.etxebarria@megaapp.online,286945,ES22209500845884487347,6753.85,2023-05-09T11:39:03,Vitoria-Gasteiz,expenses,leisure,-64.39,6336.72
buyer_3,Ana,Etxebarria,1989-08-23,49614208B,ana.etxebarria@megaapp.online,286945,ES22209500845884487347,6753.85,2023-05-14T12:53:50,Vitoria-Gasteiz,expenses,cash,-100.0,6236.72
buyer_3,Ana,Etxebarria,1989-08-23,49614208B,ana.etxebarria@megaapp.online,286945,ES22209500845884487347,6753.85,2023-05-15T09:44:22,Vitoria-Gasteiz,expenses,cash,-100.0,6136.72
buyer_3,Ana,Etxebarria,1989-08-23,49614208B,ana.etxebarria@megaapp.online,286945,ES22209500845884487347,6753.85,2023-05-15T11:03:02,Vitoria-Gasteiz,expenses,appliances,-379.67,5757.05
buyer_3,Ana,Etxebarria,1989-08-23,49614208B,ana.etxebarria@megaapp.online,286945,ES22209500845884487347,6753.85,2023-05-16T03:25:07,Vitoria-Gasteiz,expenses,healthcare,-60.88,5696.17
buyer_3,Ana,Etxebarria,1989-08-23,49614208B,ana.etxebarria@megaapp.online,286945,ES22209500845884487347,6753.85,2023-05-16T10:12:03,Vitoria-Gasteiz,expenses,appliances,-328.41,5367.76
buyer_3,Ana,Etxebarria,1989-08-23,49614208B,ana.etxebarria@megaapp.online,286945,ES22209500845884487347,6753.85,2023-05-16T12:54:51,Vitoria-Gasteiz,expenses,gifts,-243.36,5124.4
buyer_3,Ana,Etxebarria,1989-08-23,49614208B,ana.etxebarria@megaapp.online,286945,ES22209500845884487347,6753.85,2023-05-18T11:09:18,Vitoria-Gasteiz,expenses,transport,-68.78,5055.62
buyer_3,Ana,Etxebarria,1989-08-23,49614208B,ana.etxebarria@megaapp.online,286945,ES22209500845884487347,6753.85,2023-05-19T19:07:37,Vitoria-Gasteiz,expenses,clothing,-64.24,4991.38
buyer_3,Ana,Etxebarria,1989-08-23,49614208B,ana.etxebarria@megaapp.online,286945,ES22209500845884487347,6753.85,2023-05-20T19:19:34,Vitoria-Gasteiz,expenses,leisure,-54.74,4936.64
buyer_3,Ana,Etxebarria,1989-08-23,49614208B,ana.etxebarria@megaapp.online,286945,ES22209500845884487347,6753.85,2023-05-21T17:46:47,Vitoria-Gasteiz,expenses,transport,-55.21,4881.43
buyer_3,Ana,Etxebarria,1989-08-23,49614208B,ana.etxebarria@megaapp.online,286945,ES22209500845884487347,6753.85,2023-05-22T10:58:39,Vitoria-Gasteiz,expenses,cash,-100.0,4781.43
buyer_3,Ana,Etxebarria,1989-08-23,49614208B,ana.etxebarria@megaapp.online,286945,ES22209500845884487347,6753.85,2023-05-25T19:30:46,Vitoria-Gasteiz,expenses,travel,-423.28,4358.15
buyer_3,Ana,Etxebarria,1989-08-23,49614208B,ana.etxebarria@megaapp.online,286945,ES22209500845884487347,6753.85,2023-05-28T19:56:58,Vitoria-Gasteiz,expenses,transport,-66.93,4291.22
buyer_3,Ana,Etxebarria,1989-08-23,49614208B,ana.etxebarria@megaapp.online,286945,ES22209500845884487347,6753.85,2023-05-29T16:41:58,Vitoria-Gasteiz,expenses,leisure,-71.53,4219.69
buyer_3,Ana,Etxebarria,1989-08-23,49614208B,ana.etxebarria@megaapp.online,286945,ES22209500845884487347,6753.85,2023-05-30T18:32:46,Vitoria-Gasteiz,expenses,gifts,-574.79,3644.9
buyer_3,Ana,Etxebarria,1989-08-23,49614208B,ana.etxebarria@megaapp.online,286945,ES22209500845884487347,6753.85,2023-06-01T20:39:08,Vitoria-Gasteiz,incomes,salary,3260.85,6905.75
buyer_3,Ana,Etxebarria,1989-08-23,49614208B,ana.etxebarria@megaapp.online,286945,ES22209500845884487347,6753.85,2023-06-01T20:39:08,Vitoria-Gasteiz,incomes,salary_partner,3908.51,10814.26
buyer_3,Ana,Etxebarria,1989-08-23,49614208B,ana.etxebarria@megaapp.online,286945,ES22209500845884487347,6753.85,2023-06-01T20:39:08,Vitoria-Gasteiz,incomes,salary_bonus,2294.85,13109.11
buyer_3,Ana,Etxebarria,1989-08-23,49614208B,ana.etxebarria@megaapp.online,286945,ES22209500845884487347,6753.85,2023-06-01T20:39:08,Vitoria-Gasteiz,incomes,salary_partner_bonus,2901.11,16010.22
buyer_3,Ana,Etxebarria,1989-08-23,49614208B,ana.etxebarria@megaapp.online,286945,ES22209500845884487347,6753.85,2023-06-01T13:35:26,Vitoria-Gasteiz,expenses,taxes,-5681.15,10329.07
buyer_3,Ana,Etxebarria,1989-08-23,49614208B,ana.etxebarria@megaapp.online,286945,ES22209500845884487347,6753.85,2023-06-01T09:02:26,Vitoria-Gasteiz,expenses,insurance,-1862.52,8466.55
buyer_3,Ana,Etxebarria,1989-08-23,49614208B,ana.etxebarria@megaapp.online,286945,ES22209500845884487347,6753.85,2023-06-02T16:55:16,Vitoria-Gasteiz,expenses,education,-48.02,8418.53
buyer_3,Ana,Etxebarria,1989-08-23,49614208B,ana.etxebarria@megaapp.online,286945,ES22209500845884487347,6753.85,2023-06-03T19:16:03,Vitoria-Gasteiz,expenses,food,-104.25,8314.28
buyer_3,Ana,Etxebarria,1989-08-23,49614208B,ana.etxebarria@megaapp.online,286945,ES22209500845884487347,6753.85,2023-06-05T16:50:16,Vitoria-Gasteiz,expenses,mortgage,-3872.86,4441.42
buyer_3,Ana,Etxebarria,1989-08-23,49614208B,ana.etxebarria@megaapp.online,286945,ES22209500845884487347,6753.85,2023-06-05T11:06:19,Vitoria-Gasteiz,expenses,phone,-132.99,4308.43
buyer_3,Ana,Etxebarria,1989-08-23,49614208B,ana.etxebarria@megaapp.online,286945,ES22209500845884487347,6753.85,2023-06-06T06:40:41,Vitoria-Gasteiz,expenses,phone,-158.12,4150.31
buyer_3,Ana,Etxebarria,1989-08-23,49614208B,ana.etxebarria@megaapp.online,286945,ES22209500845884487347,6753.85,2023-06-07T12:27:53,Vitoria-Gasteiz,expenses,gas,-361.17,3789.14
buyer_3,Ana,Etxebarria,1989-08-23,49614208B,ana.etxebarria@megaapp.online,286945,ES22209500845884487347,6753.85,2023-06-07T09:56:14,Vitoria-Gasteiz,expenses,transport,-61.68,3727.46
buyer_3,Ana,Etxebarria,1989-08-23,49614208B,ana.etxebarria@megaapp.online,286945,ES22209500845884487347,6753.85,2023-06-07T06:23:41,Vitoria-Gasteiz,expenses,healthcare,-117.64,3609.82
buyer_3,Ana,Etxebarria,1989-08-23,49614208B,ana.etxebarria@megaapp.online,286945,ES22209500845884487347,6753.85,2023-06-07T16:36:19,Vitoria-Gasteiz,expenses,cash,-100.0,3509.82
buyer_3,Ana,Etxebarria,1989-08-23,49614208B,ana.etxebarria@megaapp.online,286945,ES22209500845884487347,6753.85,2023-06-10T09:42:42,Vitoria-Gasteiz,expenses,repairs,-263.38,3246.44
buyer_3,Ana,Etxebarria,1989-08-23,49614208B,ana.etxebarria@megaapp.online,286945,ES22209500845884487347,6753.85,2023-06-11T17:22:16,Vitoria-Gasteiz,expenses,education,-71.33,3175.11
buyer_3,Ana,Etxebarria,1989-08-23,49614208B,ana.etxebarria@megaapp.online,286945,ES22209500845884487347,6753.85,2023-06-11T16:55:33,Vitoria-Gasteiz,expenses,cash,-100.0,3075.11
buyer_3,Ana,Etxebarria,1989-08-23,49614208B,ana.etxebarria@megaapp.online,286945,ES22209500845884487347,6753.85,2023-06-12T00:36:10,Vitoria-Gasteiz,expenses,cash,-100.0,2975.11
buyer_3,Ana,Etxebarria,1989-08-23,49614208B,ana.etxebarria@megaapp.online,286945,ES22209500845884487347,6753.85,2023-06-14T22:52:36,Vitoria-Gasteiz,expenses,cash,-100.0,2875.11
buyer_3,Ana,Etxebarria,1989-08-23,49614208B,ana.etxebarria@megaapp.online,286945,ES22209500845884487347,6753.85,2023-06-21T20:38:46,Vitoria-Gasteiz,expenses,transport,-68.08,2807.03
buyer_3,Ana,Etxebarria,1989-08-23,49614208B,ana.etxebarria@megaapp.online,286945,ES22209500845884487347,6753.85,2023-06-22T09:55:55,Vitoria-Gasteiz,expenses,education,-54.68,2752.35
buyer_3,Ana,Etxebarria,1989-08-23,49614208B,ana.etxebarria@megaapp.online,286945,ES22209500845884487347,6753.85,2023-06-25T08:26:08,Vitoria-Gasteiz,expenses,food,-82.42,2669.93
buyer_3,Ana,Etxebarria,1989-08-23,49614208B,ana.etxebarria@megaapp.online,286945,ES22209500845884487347,6753.85,2023-06-25T20:46:12,Vitoria-Gasteiz,expenses,cash,-100.0,2569.93
buyer_3,Ana,Etxebarria,1989-08-23,49614208B,ana.etxebarria@megaapp.online,286945,ES22209500845884487347,6753.85,2023-06-26T13:29:53,Vitoria-Gasteiz,expenses,healthcare,-145.54,2424.39
buyer_3,Ana,Etxebarria,1989-08-23,49614208B,ana.etxebarria@megaapp.online,286945,ES22209500845884487347,6753.85,2023-06-27T12:17:46,Vitoria-Gasteiz,expenses,leisure,-23.67,2400.72
buyer_3,Ana,Etxebarria,1989-08-23,49614208B,ana.etxebarria@megaapp.online,286945,ES22209500845884487347,6753.85,2023-06-28T18:40:12,Vitoria-Gasteiz,expenses,cash,-100.0,2300.72
buyer_3,Ana,Etxebarria,1989-08-23,49614208B,ana.etxebarria@megaapp.online,286945,ES22209500845884487347,6753.85,2023-06-29T04:03:38,Vitoria-Gasteiz,expenses,leisure,-54.2,2246.52
buyer_3,Ana,Etxebarria,1989-08-23,49614208B,ana.etxebarria@megaapp.online,286945,ES22209500845884487347,6753.85,2023-06-30T22:58:02,Vitoria-Gasteiz,expenses,transport,-43.91,2202.61
buyer_3,Ana,Etxebarria,1989-08-23,49614208B,ana.etxebarria@megaapp.online,286945,ES22209500845884487347,6753.85,2023-07-01T12:45:29,Vitoria-Gasteiz,incomes,salary,3260.85,5463.46
buyer_3,Ana,Etxebarria,1989-08-23,49614208B,ana.etxebarria@megaapp.online,286945,ES22209500845884487347,6753.85,2023-07-01T12:45:29,Vitoria-Gasteiz,incomes,salary_partner,3908.51,9371.97
buyer_3,Ana,Etxebarria,1989-08-23,49614208B,ana.etxebarria@megaapp.online,286945,ES22209500845884487347,6753.85,2023-07-02T15:09:35,Vitoria-Gasteiz,expenses,leisure,-26.27,9345.7
buyer_3,Ana,Etxebarria,1989-08-23,49614208B,ana.etxebarria@megaapp.online,286945,ES22209500845884487347,6753.85,2023-07-04T00:04:44,Vitoria-Gasteiz,expenses,clothing,-106.29,9239.41
buyer_3,Ana,Etxebarria,1989-08-23,49614208B,ana.etxebarria@megaapp.online,286945,ES22209500845884487347,6753.85,2023-07-05T15:55:27,Vitoria-Gasteiz,expenses,mortgage,-3872.86,5366.55
buyer_3,Ana,Etxebarria,1989-08-23,49614208B,ana.etxebarria@megaapp.online,286945,ES22209500845884487347,6753.85,2023-07-05T12:34:29,Vitoria-Gasteiz,expenses,water,-124.19,5242.36
buyer_3,Ana,Etxebarria,1989-08-23,49614208B,ana.etxebarria@megaapp.online,286945,ES22209500845884487347,6753.85,2023-07-06T13:52:14,Vitoria-Gasteiz,expenses,water,-103.69,5138.67
buyer_3,Ana,Etxebarria,1989-08-23,49614208B,ana.etxebarria@megaapp.online,286945,ES22209500845884487347,6753.85,2023-07-06T09:53:11,Vitoria-Gasteiz,expenses,phone,-136.74,5001.93
buyer_3,Ana,Etxebarria,1989-08-23,49614208B,ana.etxebarria@megaapp.online,286945,ES22209500845884487347,6753.85,2023-07-06T19:47:49,Vitoria-Gasteiz,expenses,food,-106.76,4895.17
buyer_3,Ana,Etxebarria,1989-08-23,49614208B,ana.etxebarria@megaapp.online,286945,ES22209500845884487347,6753.85,2023-07-06T19:43:04,Vitoria-Gasteiz,expenses,cash,-100.0,4795.17
buyer_3,Ana,Etxebarria,1989-08-23,49614208B,ana.etxebarria@megaapp.online,286945,ES22209500845884487347,6753.85,2023-07-07T21:33:43,Vitoria-Gasteiz,expenses,electricity,-299.43,4495.74
buyer_3,Ana,Etxebarria,1989-08-23,49614208B,ana.etxebarria@megaapp.online,286945,ES22209500845884487347,6753.85,2023-07-07T04:32:08,Vitoria-Gasteiz,expenses,gas,-271.19,4224.55
buyer_3,Ana,Etxebarria,1989-08-23,49614208B,ana.etxebarria@megaapp.online,286945,ES22209500845884487347,6753.85,2023-07-07T20:59:58,Vitoria-Gasteiz,expenses,internet,-150.56,4073.99
buyer_3,Ana,Etxebarria,1989-08-23,49614208B,ana.etxebarria@megaapp.online,286945,ES22209500845884487347,6753.85,2023-07-08T17:21:51,Vitoria-Gasteiz,expenses,gas,-245.44,3828.55
buyer_3,Ana,Etxebarria,1989-08-23,49614208B,ana.etxebarria@megaapp.online,286945,ES22209500845884487347,6753.85,2023-07-08T09:39:56,Vitoria-Gasteiz,expenses,phone,-109.88,3718.67
buyer_3,Ana,Etxebarria,1989-08-23,49614208B,ana.etxebarria@megaapp.online,286945,ES22209500845884487347,6753.85,2023-07-09T15:47:41,Vitoria-Gasteiz,expenses,food,-68.33,3650.34
buyer_3,Ana,Etxebarria,1989-08-23,49614208B,ana.etxebarria@megaapp.online,286945,ES22209500845884487347,6753.85,2023-07-10T12:15:39,Vitoria-Gasteiz,expenses,clothing,-58.64,3591.7
buyer_3,Ana,Etxebarria,1989-08-23,49614208B,ana.etxebarria@megaapp.online,286945,ES22209500845884487347,6753.85,2023-07-11T14:01:09,Vitoria-Gasteiz,expenses,gifts,-73.85,3517.85
buyer_3,Ana,Etxebarria,1989-08-23,49614208B,ana.etxebarria@megaapp.online,286945,ES22209500845884487347,6753.85,2023-07-15T17:34:20,Vitoria-Gasteiz,expenses,transport,-43.47,3474.38
buyer_3,Ana,Etxebarria,1989-08-23,49614208B,ana.etxebarria@megaapp.online,286945,ES22209500845884487347,6753.85,2023-07-15T11:38:24,Vitoria-Gasteiz,expenses,repairs,-301.1,3173.28
buyer_3,Ana,Etxebarria,1989-08-23,49614208B,ana.etxebarria@megaapp.online,286945,ES22209500845884487347,6753.85,2023-07-17T20:20:59,Vitoria-Gasteiz,expenses,leisure,-81.67,3091.61
buyer_3,Ana,Etxebarria,1989-08-23,49614208B,ana.etxebarria@megaapp.online,286945,ES22209500845884487347,6753.85,2023-07-19T09:09:31,Vitoria-Gasteiz,expenses,food,-88.94,3002.67
buyer_3,Ana,Etxebarria,1989-08-23,49614208B,ana.etxebarria@megaapp.online,286945,ES22209500845884487347,6753.85,2023-07-19T19:30:20,Vitoria-Gasteiz,expenses,education,-67.98,2934.69
buyer_3,Ana,Etxebarria,1989-08-23,49614208B,ana.etxebarria@megaapp.online,286945,ES22209500845884487347,6753.85,2023-07-19T16:00:14,Vitoria-Gasteiz,expenses,cash,-100.0,2834.69
buyer_3,Ana,Etxebarria,1989-08-23,49614208B,ana.etxebarria@megaapp.online,286945,ES22209500845884487347,6753.85,2023-07-19T01:18:13,Vitoria-Gasteiz,expenses,gifts,-132.63,2702.06
buyer_3,Ana,Etxebarria,1989-08-23,49614208B,ana.etxebarria@megaapp.online,286945,ES22209500845884487347,6753.85,2023-07-20T23:17:17,Vitoria-Gasteiz,expenses,appliances,-250.53,2451.53
buyer_3,Ana,Etxebarria,1989-08-23,49614208B,ana.etxebarria@megaapp.online,286945,ES22209500845884487347,6753.85,2023-07-21T00:41:50,Vitoria-Gasteiz,expenses,food,-95.16,2356.37
buyer_3,Ana,Etxebarria,1989-08-23,49614208B,ana.etxebarria@megaapp.online,286945,ES22209500845884487347,6753.85,2023-07-22T14:45:07,Vitoria-Gasteiz,expenses,food,-61.41,2294.96
buyer_3,Ana,Etxebarria,1989-08-23,49614208B,ana.etxebarria@megaapp.online,286945,ES22209500845884487347,6753.85,2023-07-22T09:07:45,Vitoria-Gasteiz,expenses,clothing,-90.47,2204.49
buyer_3,Ana,Etxebarria,1989-08-23,49614208B,ana.etxebarria@megaapp.online,286945,ES22209500845884487347,6753.85,2023-07-23T18:47:43,Vitoria-Gasteiz,expenses,food,-103.91,2100.58
buyer_3,Ana,Etxebarria,1989-08-23,49614208B,ana.etxebarria@megaapp.online,286945,ES22209500845884487347,6753.85,2023-07-23T16:59:51,Vitoria-Gasteiz,expenses,transport,-76.86,2023.72
buyer_3,Ana,Etxebarria,1989-08-23,49614208B,ana.etxebarria@megaapp.online,286945,ES22209500845884487347,6753.85,2023-07-25T20:09:22,Vitoria-Gasteiz,expenses,gifts,-72.57,1951.15
buyer_3,Ana,Etxebarria,1989-08-23,49614208B,ana.etxebarria@megaapp.online,286945,ES22209500845884487347,6753.85,2023-07-27T10:24:16,Vitoria-Gasteiz,expenses,transport,-78.57,1872.58
buyer_3,Ana,Etxebarria,1989-08-23,49614208B,ana.etxebarria@megaapp.online,286945,ES22209500845884487347,6753.85,2023-07-27T15:17:14,Vitoria-Gasteiz,expenses,clothing,-67.08,1805.5
buyer_3,Ana,Etxebarria,1989-08-23,49614208B,ana.etxebarria@megaapp.online,286945,ES22209500845884487347,6753.85,2023-07-27T11:18:27,Vitoria-Gasteiz,expenses,cash,-100.0,1705.5
buyer_3,Ana,Etxebarria,1989-08-23,49614208B,ana.etxebarria@megaapp.online,286945,ES22209500845884487347,6753.85,2023-07-27T09:15:43,Vitoria-Gasteiz,expenses,repairs,-253.85,1451.65
buyer_3,Ana,Etxebarria,1989-08-23,49614208B,ana.etxebarria@megaapp.online,286945,ES22209500845884487347,6753.85,2023-07-28T15:16:14,Vitoria-Gasteiz,expenses,gifts,-796.73,654.92
buyer_3,Ana,Etxebarria,1989-08-23,49614208B,ana.etxebarria@megaapp.online,286945,ES22209500845884487347,6753.85,2023-07-30T18:46:15,Vitoria-Gasteiz,expenses,transport,-84.55,570.37
buyer_3,Ana,Etxebarria,1989-08-23,49614208B,ana.etxebarria@megaapp.online,286945,ES22209500845884487347,6753.85,2023-07-31T20:43:00,Vitoria-Gasteiz,expenses,cash,-100.0,470.37
buyer_3,Ana,Etxebarria,1989-08-23,49614208B,ana.etxebarria@megaapp.online,286945,ES22209500845884487347,6753.85,2023-08-01T21:30:18,Vitoria-Gasteiz,incomes,salary,3260.85,3731.22
buyer_3,Ana,Etxebarria,1989-08-23,49614208B,ana.etxebarria@megaapp.online,286945,ES22209500845884487347,6753.85,2023-08-01T21:30:18,Vitoria-Gasteiz,incomes,salary_partner,3908.51,7639.73
buyer_3,Ana,Etxebarria,1989-08-23,49614208B,ana.etxebarria@megaapp.online,286945,ES22209500845884487347,6753.85,2023-08-01T09:39:50,Vitoria-Gasteiz,expenses,cash,-100.0,7539.73
buyer_3,Ana,Etxebarria,1989-08-23,49614208B,ana.etxebarria@megaapp.online,286945,ES22209500845884487347,6753.85,2023-08-02T19:01:19,Vitoria-Gasteiz,expenses,food,-99.46,7440.27
buyer_3,Ana,Etxebarria,1989-08-23,49614208B,ana.etxebarria@megaapp.online,286945,ES22209500845884487347,6753.85,2023-08-03T19:00:52,Vitoria-Gasteiz,expenses,appliances,-112.76,7327.51
buyer_3,Ana,Etxebarria,1989-08-23,49614208B,ana.etxebarria@megaapp.online,286945,ES22209500845884487347,6753.85,2023-08-05T13:14:42,Vitoria-Gasteiz,expenses,mortgage,-3872.86,3454.65
buyer_3,Ana,Etxebarria,1989-08-23,49614208B,ana.etxebarria@megaapp.online,286945,ES22209500845884487347,6753.85,2023-08-05T21:32:31,Vitoria-Gasteiz,expenses,water,-128.36,3326.29
buyer_3,Ana,Etxebarria,1989-08-23,49614208B,ana.etxebarria@megaapp.online,286945,ES22209500845884487347,6753.85,2023-08-05T09:10:36,Vitoria-Gasteiz,expenses,gas,-116.61,3209.68
buyer_3,Ana,Etxebarria,1989-08-23,49614208B,ana.etxebarria@megaapp.online,286945,ES22209500845884487347,6753.85,2023-08-05T09:04:19,Vitoria-Gasteiz,expenses,cash,-100.0,3109.68
buyer_3,Ana,Etxebarria,1989-08-23,49614208B,ana.etxebarria@megaapp.online,286945,ES22209500845884487347,6753.85,2023-08-05T10:32:39,Vitoria-Gasteiz,expenses,repairs,-70.15,3039.53
buyer_3,Ana,Etxebarria,1989-08-23,49614208B,ana.etxebarria@megaapp.online,286945,ES22209500845884487347,6753.85,2023-08-06T20:42:38,Vitoria-Gasteiz,expenses,transport,-61.6,2977.93
buyer_3,Ana,Etxebarria,1989-08-23,49614208B,ana.etxebarria@megaapp.online,286945,ES22209500845884487347,6753.85,2023-08-07T08:43:34,Vitoria-Gasteiz,expenses,water,-128.76,2849.17
buyer_3,Ana,Etxebarria,1989-08-23,49614208B,ana.etxebarria@megaapp.online,286945,ES22209500845884487347,6753.85,2023-08-07T09:15:56,Vitoria-Gasteiz,expenses,internet,-150.56,2698.61
buyer_3,Ana,Etxebarria,1989-08-23,49614208B,ana.etxebarria@megaapp.online,286945,ES22209500845884487347,6753.85,2023-08-08T00:46:56,Vitoria-Gasteiz,expenses,leisure,-19.71,2678.9
buyer_3,Ana,Etxebarria,1989-08-23,49614208B,ana.etxebarria@megaapp.online,286945,ES22209500845884487347,6753.85,2023-08-10T15:08:49,Vitoria-Gasteiz,expenses,cash,-100.0,2578.9
buyer_3,Ana,Etxebarria,1989-08-23,49614208B,ana.etxebarria@megaapp.online,286945,ES22209500845884487347,6753.85,2023-08-12T13:01:50,Vitoria-Gasteiz,expenses,food,-102.11,2476.79
buyer_3,Ana,Etxebarria,1989-08-23,49614208B,ana.etxebarria@megaapp.online,286945,ES22209500845884487347,6753.85,2023-08-15T08:28:01,Vitoria-Gasteiz,expenses,transport,-59.66,2417.13
buyer_3,Ana,Etxebarria,1989-08-23,49614208B,ana.etxebarria@megaapp.online,286945,ES22209500845884487347,6753.85,2023-08-18T21:09:50,Vitoria-Gasteiz,expenses,clothing,-131.0,2286.13
buyer_3,Ana,Etxebarria,1989-08-23,49614208B,ana.etxebarria@megaapp.online,286945,ES22209500845884487347,6753.85,2023-08-18T13:17:46,Vitoria-Gasteiz,expenses,cash,-100.0,2186.13
buyer_3,Ana,Etxebarria,1989-08-23,49614208B,ana.etxebarria@megaapp.online,286945,ES22209500845884487347,6753.85,2023-08-19T13:49:52,Vitoria-Gasteiz,expenses,cash,-100.0,2086.13
buyer_3,Ana,Etxebarria,1989-08-23,49614208B,ana.etxebarria@megaapp.online,286945,ES22209500845884487347,6753.85,2023-08-19T19:07:56,Vitoria-Gasteiz,expenses,appliances,-249.81,1836.32
buyer_3,Ana,Etxebarria,1989-08-23,49614208B,ana.etxebarria@megaapp.online,286945,ES22209500845884487347,6753.85,2023-08-20T09:29:38,Vitoria-Gasteiz,expenses,healthcare,-66.26,1770.06
buyer_3,Ana,Etxebarria,1989-08-23,49614208B,ana.etxebarria@megaapp.online,286945,ES22209500845884487347,6753.85,2023-08-24T14:13:43,Vitoria-Gasteiz,expenses,cash,-100.0,1670.06
buyer_3,Ana,Etxebarria,1989-08-23,49614208B,ana.etxebarria@megaapp.online,286945,ES22209500845884487347,6753.85,2023-08-27T14:04:05,Vitoria-Gasteiz,expenses,education,-57.5,1612.56
buyer_3,Ana,Etxebarria,1989-08-23,49614208B,ana.etxebarria@megaapp.online,286945,ES22209500845884487347,6753.85,2023-08-27T09:07:22,Vitoria-Gasteiz,expenses,cash,-100.0,1512.56
buyer_3,Ana,Etxebarria,1989-08-23,49614208B,ana.etxebarria@megaapp.online,286945,ES22209500845884487347,6753.85,2023-08-29T12:14:51,Vitoria-Gasteiz,expenses,gifts,-487.71,1024.85
buyer_3,Ana,Etxebarria,1989-08-23,49614208B,ana.etxebarria@megaapp.online,286945,ES22209500845884487347,6753.85,2023-09-01T14:54:41,Vitoria-Gasteiz,incomes,salary,3260.85,4285.7
buyer_3,Ana,Etxebarria,1989-08-23,49614208B,ana.etxebarria@megaapp.online,286945,ES22209500845884487347,6753.85,2023-09-01T14:54:41,Vitoria-Gasteiz,incomes,salary_partner,3908.51,8194.21
buyer_3,Ana,Etxebarria,1989-08-23,49614208B,ana.etxebarria@megaapp.online,286945,ES22209500845884487347,6753.85,2023-09-01T14:54:41,Vitoria-Gasteiz,incomes,extra_income,412.38,8606.59
buyer_3,Ana,Etxebarria,1989-08-23,49614208B,ana.etxebarria@megaapp.online,286945,ES22209500845884487347,6753.85,2023-09-01T07:44:49,Vitoria-Gasteiz,expenses,transport,-40.61,8565.98
buyer_3,Ana,Etxebarria,1989-08-23,49614208B,ana.etxebarria@megaapp.online,286945,ES22209500845884487347,6753.85,2023-09-03T15:59:12,Vitoria-Gasteiz,expenses,transport,-51.26,8514.72
buyer_3,Ana,Etxebarria,1989-08-23,49614208B,ana.etxebarria@megaapp.online,286945,ES22209500845884487347,6753.85,2023-09-03T10:19:58,Vitoria-Gasteiz,expenses,cash,-100.0,8414.72
buyer_3,Ana,Etxebarria,1989-08-23,49614208B,ana.etxebarria@megaapp.online,286945,ES22209500845884487347,6753.85,2023-09-03T16:23:15,Vitoria-Gasteiz,expenses,repairs,-105.91,8308.81
buyer_3,Ana,Etxebarria,1989-08-23,49614208B,ana.etxebarria@megaapp.online,286945,ES22209500845884487347,6753.85,2023-09-05T15:27:15,Vitoria-Gasteiz,expenses,mortgage,-3872.86,4435.95
buyer_3,Ana,Etxebarria,1989-08-23,49614208B,ana.etxebarria@megaapp.online,286945,ES22209500845884487347,6753.85,2023-09-06T13:02:06,Vitoria-Gasteiz,expenses,water,-122.36,4313.59
buyer_3,Ana,Etxebarria,1989-08-23,49614208B,ana.etxebarria@megaapp.online,286945,ES22209500845884487347,6753.85,2023-09-06T04:52:02,Vitoria-Gasteiz,expenses,electricity,-84.93,4228.66
buyer_3,Ana,Etxebarria,1989-08-23,49614208B,ana.etxebarria@megaapp.online,286945,ES22209500845884487347,6753.85,2023-09-06T12:15:30,Vitoria-Gasteiz,expenses,phone,-121.95,4106.71
buyer_3,Ana,Etxebarria,1989-08-23,49614208B,ana.etxebarria@megaapp.online,286945,ES22209500845884487347,6753.85,2023-09-08T14:33:28,Vitoria-Gasteiz,expenses,transport,-63.16,4043.55
buyer_3,Ana,Etxebarria,1989-08-23,49614208B,ana.etxebarria@megaapp.online,286945,ES22209500845884487347,6753.85,2023-09-08T09:28:58,Vitoria-Gasteiz,expenses,healthcare,-162.22,3881.33
buyer_3,Ana,Etxebarria,1989-08-23,49614208B,ana.etxebarria@megaapp.online,286945,ES22209500845884487347,6753.85,2023-09-09T11:39:49,Vitoria-Gasteiz,expenses,transport,-63.34,3817.99
buyer_3,Ana,Etxebarria,1989-08-23,49614208B,ana.etxebarria@megaapp.online,286945,ES22209500845884487347,6753.85,2023-09-10T08:41:25,Vitoria-Gasteiz,expenses,food,-63.97,3754.02
buyer_3,Ana,Etxebarria,1989-08-23,49614208B,ana.etxebarria@megaapp.online,286945,ES22209500845884487347,6753.85,2023-09-11T15:16:51,Vitoria-Gasteiz,expenses,cash,-100.0,3654.02
buyer_3,Ana,Etxebarria,1989-08-23,49614208B,ana.etxebarria@megaapp.online,286945,ES22209500845884487347,6753.85,2023-09-11T02:53:33,Vitoria-Gasteiz,expenses,travel,-309.31,3344.71
buyer_3,Ana,Etxebarria,1989-08-23,49614208B,ana.etxebarria@megaapp.online,286945,ES22209500845884487347,6753.85,2023-09-12T15:26:32,Vitoria-Gasteiz,expenses,cash,-100.0,3244.71
buyer_3,Ana,Etxebarria,1989-08-23,49614208B,ana.etxebarria@megaapp.online,286945,ES22209500845884487347,6753.85,2023-09-13T11:00:37,Vitoria-Gasteiz,expenses,food,-65.1,3179.61
buyer_3,Ana,Etxebarria,1989-08-23,49614208B,ana.etxebarria@megaapp.online,286945,ES22209500845884487347,6753.85,2023-09-13T08:09:46,Vitoria-Gasteiz,expenses,car,-467.86,2711.75
buyer_3,Ana,Etxebarria,1989-08-23,49614208B,ana.etxebarria@megaapp.online,286945,ES22209500845884487347,6753.85,2023-09-14T16:53:12,Vitoria-Gasteiz,expenses,leisure,-74.68,2637.07
buyer_3,Ana,Etxebarria,1989-08-23,49614208B,ana.etxebarria@megaapp.online,286945,ES22209500845884487347,6753.85,2023-09-15T19:34:54,Vitoria-Gasteiz,expenses,leisure,-65.9,2571.17
buyer_3,Ana,Etxebarria,1989-08-23,49614208B,ana.etxebarria@megaapp.online,286945,ES22209500845884487347,6753.85,2023-09-16T21:28:06,Vitoria-Gasteiz,expenses,food,-109.06,2462.11
buyer_3,Ana,Etxebarria,1989-08-23,49614208B,ana.etxebarria@megaapp.online,286945,ES22209500845884487347,6753.85,2023-09-16T17:57:02,Vitoria-Gasteiz,expenses,leisure,-28.3,2433.81
buyer_3,Ana,Etxebarria,1989-08-23,49614208B,ana.etxebarria@megaapp.online,286945,ES22209500845884487347,6753.85,2023-09-18T12:42:54,Vitoria-Gasteiz,expenses,cash,-100.0,2333.81
buyer_3,Ana,Etxebarria,1989-08-23,49614208B,ana.etxebarria@megaapp.online,286945,ES22209500845884487347,6753.85,2023-09-19T15:15:16,Vitoria-Gasteiz,expenses,cash,-100.0,2233.81
buyer_3,Ana,Etxebarria,1989-08-23,49614208B,ana.etxebarria@megaapp.online,286945,ES22209500845884487347,6753.85,2023-09-20T12:09:11,Vitoria-Gasteiz,expenses,cash,-100.0,2133.81
buyer_3,Ana,Etxebarria,1989-08-23,49614208B,ana.etxebarria@megaapp.online,286945,ES22209500845884487347,6753.85,2023-09-23T11:17:18,Vitoria-Gasteiz,expenses,leisure,-60.33,2073.48
buyer_3,Ana,Etxebarria,1989-08-23,49614208B,ana.etxebarria@megaapp.online,286945,ES22209500845884487347,6753.85,2023-09-25T18:13:40,Vitoria-Gasteiz,expenses,leisure,-28.56,2044.92
buyer_3,Ana,Etxebarria,1989-08-23,49614208B,ana.etxebarria@megaapp.online,286945,ES22209500845884487347,6753.85,2023-09-25T12:44:09,Vitoria-Gasteiz,expenses,cash,-100.0,1944.92
buyer_3,Ana,Etxebarria,1989-08-23,49614208B,ana.etxebarria@megaapp.online,286945,ES22209500845884487347,6753.85,2023-09-27T11:07:11,Vitoria-Gasteiz,expenses,cash,-100.0,1844.92
buyer_3,Ana,Etxebarria,1989-08-23,49614208B,ana.etxebarria@megaapp.online,286945,ES22209500845884487347,6753.85,2023-09-28T12:26:24,Vitoria-Gasteiz,expenses,cash,-100.0,1744.92
buyer_3,Ana,Etxebarria,1989-08-23,49614208B,ana.etxebarria@megaapp.online,286945,ES22209500845884487347,6753.85,2023-09-30T00:39:07,Vitoria-Gasteiz,expenses,food,-107.46,1637.46
buyer_3,Ana,Etxebarria,1989-08-23,49614208B,ana.etxebarria@megaapp.online,286945,ES22209500845884487347,6753.85,2023-09-30T14:53:34,Vitoria-Gasteiz,expenses,transport,-61.02,1576.44
buyer_3,Ana,Etxebarria,1989-08-23,49614208B,ana.etxebarria@megaapp.online,286945,ES22209500845884487347,6753.85,2023-09-30T14:28:44,Vitoria-Gasteiz,expenses,leisure,-84.13,1492.31
buyer_3,Ana,Etxebarria,1989-08-23,49614208B,ana.etxebarria@megaapp.online,286945,ES22209500845884487347,6753.85,2023-09-30T14:56:11,Vitoria-Gasteiz,expenses,cash,-100.0,1392.31
buyer_3,Ana,Etxebarria,1989-08-23,49614208B,ana.etxebarria@megaapp.online,286945,ES22209500845884487347,6753.85,2023-09-30T14:13:54,Vitoria-Gasteiz,expenses,repairs,-119.91,1272.4
buyer_3,Ana,Etxebarria,1989-08-23,49614208B,ana.etxebarria@megaapp.online,286945,ES22209500845884487347,6753.85,2023-10-01T10:37:57,Vitoria-Gasteiz,incomes,salary,3260.85,4533.25
buyer_3,Ana,Etxebarria,1989-08-23,49614208B,ana.etxebarria@megaapp.online,286945,ES22209500845884487347,6753.85,2023-10-01T10:37:57,Vitoria-Gasteiz,incomes,salary_partner,3908.51,8441.76
buyer_3,Ana,Etxebarria,1989-08-23,49614208B,ana.etxebarria@megaapp.online,286945,ES22209500845884487347,6753.85,2023-10-01T19:55:51,Vitoria-Gasteiz,expenses,education,-66.18,8375.58
buyer_3,Ana,Etxebarria,1989-08-23,49614208B,ana.etxebarria@megaapp.online,286945,ES22209500845884487347,6753.85,2023-10-04T14:02:41,Vitoria-Gasteiz,expenses,repairs,-89.78,8285.8
buyer_3,Ana,Etxebarria,1989-08-23,49614208B,ana.etxebarria@megaapp.online,286945,ES22209500845884487347,6753.85,2023-10-05T08:34:25,Vitoria-Gasteiz,expenses,mortgage,-3872.86,4412.94
buyer_3,Ana,Etxebarria,1989-08-23,49614208B,ana.etxebarria@megaapp.online,286945,ES22209500845884487347,6753.85,2023-10-05T09:33:04,Vitoria-Gasteiz,expenses,electricity,-143.06,4269.88
buyer_3,Ana,Etxebarria,1989-08-23,49614208B,ana.etxebarria@megaapp.online,286945,ES22209500845884487347,6753.85,2023-10-05T01:00:30,Vitoria-Gasteiz,expenses,phone,-117.51,4152.37
buyer_3,Ana,Etxebarria,1989-08-23,49614208B,ana.etxebarria@megaapp.online,286945,ES22209500845884487347,6753.85,2023-10-08T14:24:31,Vitoria-Gasteiz,expenses,electricity,-98.59,4053.78
buyer_3,Ana,Etxebarria,1989-08-23,49614208B,ana.etxebarria@megaapp.online,286945,ES22209500845884487347,6753.85,2023-10-12T17:18:22,Vitoria-Gasteiz,expenses,education,-68.25,3985.53
buyer_3,Ana,Etxebarria,1989-08-23,49614208B,ana.etxebarria@megaapp.online,286945,ES22209500845884487347,6753.85,2023-10-13T06:57:56,Vitoria-Gasteiz,expenses,transport,-72.01,3913.52
buyer_3,Ana,Etxebarria,1989-08-23,49614208B,ana.etxebarria@megaapp.online,286945,ES22209500845884487347,6753.85,2023-10-14T08:24:15,Vitoria-Gasteiz,expenses,leisure,-80.5,3833.02
buyer_3,Ana,Etxebarria,1989-08-23,49614208B,ana.etxebarria@megaapp.online,286945,ES22209500845884487347,6753.85,2023-10-14T17:28:19,Vitoria-Gasteiz,expenses,clothing,-114.15,3718.87
buyer_3,Ana,Etxebarria,1989-08-23,49614208B,ana.etxebarria@megaapp.online,286945,ES22209500845884487347,6753.85,2023-10-14T09:30:43,Vitoria-Gasteiz,expenses,cash,-100.0,3618.87
buyer_3,Ana,Etxebarria,1989-08-23,49614208B,ana.etxebarria@megaapp.online,286945,ES22209500845884487347,6753.85,2023-10-15T11:43:19,Vitoria-Gasteiz,expenses,cash,-100.0,3518.87
buyer_3,Ana,Etxebarria,1989-08-23,49614208B,ana.etxebarria@megaapp.online,286945,ES22209500845884487347,6753.85,2023-10-16T18:08:37,Vitoria-Gasteiz,expenses,leisure,-32.55,3486.32
buyer_3,Ana,Etxebarria,1989-08-23,49614208B,ana.etxebarria@megaapp.online,286945,ES22209500845884487347,6753.85,2023-10-16T15:06:17,Vitoria-Gasteiz,expenses,appliances,-102.96,3383.36
buyer_3,Ana,Etxebarria,1989-08-23,49614208B,ana.etxebarria@megaapp.online,286945,ES22209500845884487347,6753.85,2023-10-17T22:30:53,Vitoria-Gasteiz,expenses,cash,-100.0,3283.36
buyer_3,Ana,Etxebarria,1989-08-23,49614208B,ana.etxebarria@megaapp.online,286945,ES22209500845884487347,6753.85,2023-10-18T13:28:01,Vitoria-Gasteiz,expenses,food,-91.34,3192.02
buyer_3,Ana,Etxebarria,1989-08-23,49614208B,ana.etxebarria@megaapp.online,286945,ES22209500845884487347,6753.85,2023-10-18T11:42:50,Vitoria-Gasteiz,expenses,healthcare,-135.21,3056.81
buyer_3,Ana,Etxebarria,1989-08-23,49614208B,ana.etxebarria@megaapp.online,286945,ES22209500845884487347,6753.85,2023-10-20T18:38:50,Vitoria-Gasteiz,expenses,repairs,-302.99,2753.82
buyer_3,Ana,Etxebarria,1989-08-23,49614208B,ana.etxebarria@megaapp.online,286945,ES22209500845884487347,6753.85,2023-10-21T16:58:08,Vitoria-Gasteiz,expenses,food,-114.16,2639.66
buyer_3,Ana,Etxebarria,1989-08-23,49614208B,ana.etxebarria@megaapp.online,286945,ES22209500845884487347,6753.85,2023-10-21T11:29:16,Vitoria-Gasteiz,expenses,appliances,-308.71,2330.95
buyer_3,Ana,Etxebarria,1989-08-23,49614208B,ana.etxebarria@megaapp.online,286945,ES22209500845884487347,6753.85,2023-10-21T10:31:01,Vitoria-Gasteiz,expenses,gifts,-38.77,2292.18
buyer_3,Ana,Etxebarria,1989-08-23,49614208B,ana.etxebarria@megaapp.online,286945,ES22209500845884487347,6753.85,2023-10-24T10:26:51,Vitoria-Gasteiz,expenses,leisure,-73.93,2218.25
buyer_3,Ana,Etxebarria,1989-08-23,49614208B,ana.etxebarria@megaapp.online,286945,ES22209500845884487347,6753.85,2023-10-26T10:53:58,Vitoria-Gasteiz,expenses,leisure,-71.87,2146.38
buyer_3,Ana,Etxebarria,1989-08-23,49614208B,ana.etxebarria@megaapp.online,286945,ES22209500845884487347,6753.85,2023-10-29T16:26:27,Vitoria-Gasteiz,expenses,food,-102.7,2043.68
buyer_3,Ana,Etxebarria,1989-08-23,49614208B,ana.etxebarria@megaapp.online,286945,ES22209500845884487347,6753.85,2023-10-29T19:07:21,Vitoria-Gasteiz,expenses,leisure,-80.5,1963.18
buyer_3,Ana,Etxebarria,1989-08-23,49614208B,ana.etxebarria@megaapp.online,286945,ES22209500845884487347,6753.85,2023-10-29T16:22:17,Vitoria-Gasteiz,expenses,education,-54.58,1908.6
buyer_3,Ana,Etxebarria,1989-08-23,49614208B,ana.etxebarria@megaapp.online,286945,ES22209500845884487347,6753.85,2023-10-29T14:57:21,Vitoria-Gasteiz,expenses,cash,-100.0,1808.6
buyer_3,Ana,Etxebarria,1989-08-23,49614208B,ana.etxebarria@megaapp.online,286945,ES22209500845884487347,6753.85,2023-10-31T21:33:06,Vitoria-Gasteiz,expenses,transport,-80.18,1728.42
buyer_3,Ana,Etxebarria,1989-08-23,49614208B,ana.etxebarria@megaapp.online,286945,ES22209500845884487347,6753.85,2023-10-31T19:54:53,Vitoria-Gasteiz,expenses,appliances,-318.84,1409.58
buyer_3,Ana,Etxebarria,1989-08-23,49614208B,ana.etxebarria@megaapp.online,286945,ES22209500845884487347,6753.85,2023-10-31T19:35:51,Vitoria-Gasteiz,expenses,gifts,-532.92,876.66
buyer_3,Ana,Etxebarria,1989-08-23,49614208B,ana.etxebarria@megaapp.online,286945,ES22209500845884487347,6753.85,2023-11-01T10:39:26,Vitoria-Gasteiz,incomes,salary,3260.85,4137.51
buyer_3,Ana,Etxebarria,1989-08-23,49614208B,ana.etxebarria@megaapp.online,286945,ES22209500845884487347,6753.85,2023-11-01T10:39:26,Vitoria-Gasteiz,incomes,salary_partner,3908.51,8046.02
buyer_3,Ana,Etxebarria,1989-08-23,49614208B,ana.etxebarria@megaapp.online,286945,ES22209500845884487347,6753.85,2023-11-04T08:13:12,Vitoria-Gasteiz,expenses,repairs,-332.54,7713.48
buyer_3,Ana,Etxebarria,1989-08-23,49614208B,ana.etxebarria@megaapp.online,286945,ES22209500845884487347,6753.85,2023-11-05T09:20:52,Vitoria-Gasteiz,expenses,mortgage,-3872.86,3840.62
buyer_3,Ana,Etxebarria,1989-08-23,49614208B,ana.etxebarria@megaapp.online,286945,ES22209500845884487347,6753.85,2023-11-05T15:13:27,Vitoria-Gasteiz,expenses,water,-127.04,3713.58
buyer_3,Ana,Etxebarria,1989-08-23,49614208B,ana.etxebarria@megaapp.online,286945,ES22209500845884487347,6753.85,2023-11-05T16:18:45,Vitoria-Gasteiz,expenses,internet,-150.56,3563.02
buyer_3,Ana,Etxebarria,1989-08-23,49614208B,ana.etxebarria@megaapp.online,286945,ES22209500845884487347,6753.85,2023-11-05T17:28:22,Vitoria-Gasteiz,expenses,phone,-147.86,3415.16
buyer_3,Ana,Etxebarria,1989-08-23,49614208B,ana.etxebarria@megaapp.online,286945,ES22209500845884487347,6753.85,2023-11-05T14:21:24,Vitoria-Gasteiz,expenses,food,-103.79,3311.37
buyer_3,Ana,Etxebarria,1989-08-23,49614208B,ana.etxebarria@megaapp.online,286945,ES22209500845884487347,6753.85,2023-11-06T13:26:53,Vitoria-Gasteiz,expenses,internet,-150.56,3160.81
buyer_3,Ana,Etxebarria,1989-08-23,49614208B,ana.etxebarria@megaapp.online,286945,ES22209500845884487347,6753.85,2023-11-06T11:59:48,Vitoria-Gasteiz,expenses,food,-68.9,3091.91
buyer_3,Ana,Etxebarria,1989-08-23,49614208B,ana.etxebarria@megaapp.online,286945,ES22209500845884487347,6753.85,2023-11-07T13:37:35,Vitoria-Gasteiz,expenses,transport,-59.81,3032.1
buyer_3,Ana,Etxebarria,1989-08-23,49614208B,ana.etxebarria@megaapp.online,286945,ES22209500845884487347,6753.85,2023-11-07T19:58:57,Vitoria-Gasteiz,expenses,leisure,-28.11,3003.99
buyer_3,Ana,Etxebarria,1989-08-23,49614208B,ana.etxebarria@megaapp.online,286945,ES22209500845884487347,6753.85,2023-11-08T15:02:14,Vitoria-Gasteiz,expenses,food,-89.3,2914.69
buyer_3,Ana,Etxebarria,1989-08-23,49614208B,ana.etxebarria@megaapp.online,286945,ES22209500845884487347,6753.85,2023-11-12T21:59:50,Vitoria-Gasteiz,expenses,clothing,-118.91,2795.78
buyer_3,Ana,Etxebarria,1989-08-23,49614208B,ana.etxebarria@megaapp.online,286945,ES22209500845884487347,6753.85,2023-11-13T16:54:29,Vitoria-Gasteiz,expenses,food,-75.09,2720.69
buyer_3,Ana,Etxebarria,1989-08-23,49614208B,ana.etxebarria@megaapp.online,286945,ES22209500845884487347,6753.85,2023-11-13T19:24:16,Vitoria-Gasteiz,expenses,clothing,-110.37,2610.32
buyer_3,Ana,Etxebarria,1989-08-23,49614208B,ana.etxebarria@megaapp.online,286945,ES22209500845884487347,6753.85,2023-11-15T08:40:43,Vitoria-Gasteiz,expenses,food,-65.97,2544.35
buyer_3,Ana,Etxebarria,1989-08-23,49614208B,ana.etxebarria@megaapp.online,286945,ES22209500845884487347,6753.85,2023-11-18T11:37:19,Vitoria-Gasteiz,expenses,food,-81.17,2463.18
buyer_3,Ana,Etxebarria,1989-08-23,49614208B,ana.etxebarria@megaapp.online,286945,ES22209500845884487347,6753.85,2023-11-18T15:52:01,Vitoria-Gasteiz,expenses,leisure,-74.95,2388.23
buyer_3,Ana,Etxebarria,1989-08-23,49614208B,ana.etxebarria@megaapp.online,286945,ES22209500845884487347,6753.85,2023-11-19T04:26:59,Vitoria-Gasteiz,expenses,food,-82.92,2305.31
buyer_3,Ana,Etxebarria,1989-08-23,49614208B,ana.etxebarria@megaapp.online,286945,ES22209500845884487347,6753.85,2023-11-20T08:28:59,Vitoria-Gasteiz,expenses,cash,-100.0,2205.31
buyer_3,Ana,Etxebarria,1989-08-23,49614208B,ana.etxebarria@megaapp.online,286945,ES22209500845884487347,6753.85,2023-11-21T13:25:55,Vitoria-Gasteiz,expenses,repairs,-161.47,2043.84
buyer_3,Ana,Etxebarria,1989-08-23,49614208B,ana.etxebarria@megaapp.online,286945,ES22209500845884487347,6753.85,2023-11-24T13:57:09,Vitoria-Gasteiz,expenses,transport,-85.38,1958.46
buyer_3,Ana,Etxebarria,1989-08-23,49614208B,ana.etxebarria@megaapp.online,286945,ES22209500845884487347,6753.85,2023-11-25T10:24:55,Vitoria-Gasteiz,expenses,food,-102.59,1855.87
buyer_3,Ana,Etxebarria,1989-08-23,49614208B,ana.etxebarria@megaapp.online,286945,ES22209500845884487347,6753.85,2023-11-25T23:18:25,Vitoria-Gasteiz,expenses,travel,-466.3,1389.57
buyer_3,Ana,Etxebarria,1989-08-23,49614208B,ana.etxebarria@megaapp.online,286945,ES22209500845884487347,6753.85,2023-11-28T19:25:27,Vitoria-Gasteiz,expenses,cash,-100.0,1289.57
buyer_3,Ana,Etxebarria,1989-08-23,49614208B,ana.etxebarria@megaapp.online,286945,ES22209500845884487347,6753.85,2023-11-29T09:50:15,Vitoria-Gasteiz,expenses,food,-76.16,1213.41
buyer_3,Ana,Etxebarria,1989-08-23,49614208B,ana.etxebarria@megaapp.online,286945,ES22209500845884487347,6753.85,2023-11-29T20:56:16,Vitoria-Gasteiz,expenses,repairs,-295.97,917.44
buyer_3,Ana,Etxebarria,1989-08-23,49614208B,ana.etxebarria@megaapp.online,286945,ES22209500845884487347,6753.85,2023-11-30T19:16:52,Vitoria-Gasteiz,expenses,leisure,-67.05,850.39
buyer_3,Ana,Etxebarria,1989-08-23,49614208B,ana.etxebarria@megaapp.online,286945,ES22209500845884487347,6753.85,2023-12-01T17:31:31,Vitoria-Gasteiz,incomes,salary,3260.85,4111.24
buyer_3,Ana,Etxebarria,1989-08-23,49614208B,ana.etxebarria@megaapp.online,286945,ES22209500845884487347,6753.85,2023-12-01T17:31:31,Vitoria-Gasteiz,incomes,salary_partner,3908.51,8019.75
buyer_3,Ana,Etxebarria,1989-08-23,49614208B,ana.etxebarria@megaapp.online,286945,ES22209500845884487347,6753.85,2023-12-01T17:31:31,Vitoria-Gasteiz,incomes,extra_income,412.38,8432.13
buyer_3,Ana,Etxebarria,1989-08-23,49614208B,ana.etxebarria@megaapp.online,286945,ES22209500845884487347,6753.85,2023-12-01T17:31:31,Vitoria-Gasteiz,incomes,salary_bonus,2458.64,10890.77
buyer_3,Ana,Etxebarria,1989-08-23,49614208B,ana.etxebarria@megaapp.online,286945,ES22209500845884487347,6753.85,2023-12-01T17:31:31,Vitoria-Gasteiz,incomes,salary_partner_bonus,2808.94,13699.71
buyer_3,Ana,Etxebarria,1989-08-23,49614208B,ana.etxebarria@megaapp.online,286945,ES22209500845884487347,6753.85,2023-12-01T12:11:39,Vitoria-Gasteiz,expenses,education,-62.07,13637.64
buyer_3,Ana,Etxebarria,1989-08-23,49614208B,ana.etxebarria@megaapp.online,286945,ES22209500845884487347,6753.85,2023-12-01T13:30:41,Vitoria-Gasteiz,expenses,cash,-100.0,13537.64
buyer_3,Ana,Etxebarria,1989-08-23,49614208B,ana.etxebarria@megaapp.online,286945,ES22209500845884487347,6753.85,2023-12-03T18:05:18,Vitoria-Gasteiz,expenses,leisure,-48.26,13489.38
buyer_3,Ana,Etxebarria,1989-08-23,49614208B,ana.etxebarria@megaapp.online,286945,ES22209500845884487347,6753.85,2023-12-04T09:05:36,Vitoria-Gasteiz,expenses,leisure,-31.86,13457.52
buyer_3,Ana,Etxebarria,1989-08-23,49614208B,ana.etxebarria@megaapp.online,286945,ES22209500845884487347,6753.85,2023-12-05T11:47:39,Vitoria-Gasteiz,expenses,mortgage,-3872.86,9584.66
buyer_3,Ana,Etxebarria,1989-08-23,49614208B,ana.etxebarria@megaapp.online,286945,ES22209500845884487347,6753.85,2023-12-05T16:02:32,Vitoria-Gasteiz,expenses,gas,-171.45,9413.21
buyer_3,Ana,Etxebarria,1989-08-23,49614208B,ana.etxebarria@megaapp.online,286945,ES22209500845884487347,6753.85,2023-12-05T19:04:54,Vitoria-Gasteiz,expenses,cash,-100.0,9313.21
buyer_3,Ana,Etxebarria,1989-08-23,49614208B,ana.etxebarria@megaapp.online,286945,ES22209500845884487347,6753.85,2023-12-05T13:15:44,Vitoria-Gasteiz,expenses,repairs,-132.32,9180.89
buyer_3,Ana,Etxebarria,1989-08-23,49614208B,ana.etxebarria@megaapp.online,286945,ES22209500845884487347,6753.85,2023-12-06T19:42:32,Vitoria-Gasteiz,expenses,leisure,-26.93,9153.96
buyer_3,Ana,Etxebarria,1989-08-23,49614208B,ana.etxebarria@megaapp.online,286945,ES22209500845884487347,6753.85,2023-12-07T11:28:08,Vitoria-Gasteiz,expenses,gas,-301.53,8852.43
buyer_3,Ana,Etxebarria,1989-08-23,49614208B,ana.etxebarria@megaapp.online,286945,ES22209500845884487347,6753.85,2023-12-07T08:10:32,Vitoria-Gasteiz,expenses,leisure,-74.15,8778.28
buyer_3,Ana,Etxebarria,1989-08-23,49614208B,ana.etxebarria@megaapp.online,286945,ES22209500845884487347,6753.85,2023-12-07T09:34:03,Vitoria-Gasteiz,expenses,cash,-100.0,8678.28
buyer_3,Ana,Etxebarria,1989-08-23,49614208B,ana.etxebarria@megaapp.online,286945,ES22209500845884487347,6753.85,2023-12-08T08:21:01,Vitoria-Gasteiz,expenses,water,-81.69,8596.59
buyer_3,Ana,Etxebarria,1989-08-23,49614208B,ana.etxebarria@megaapp.online,286945,ES22209500845884487347,6753.85,2023-12-08T11:14:34,Vitoria-Gasteiz,expenses,gas,-140.16,8456.43
buyer_3,Ana,Etxebarria,1989-08-23,49614208B,ana.etxebarria@megaapp.online,286945,ES22209500845884487347,6753.85,2023-12-08T14:44:22,Vitoria-Gasteiz,expenses,education,-52.16,8404.27
buyer_3,Ana,Etxebarria,1989-08-23,49614208B,ana.etxebarria@megaapp.online,286945,ES22209500845884487347,6753.85,2023-12-08T02:48:11,Vitoria-Gasteiz,expenses,cash,-100.0,8304.27
buyer_3,Ana,Etxebarria,1989-08-23,49614208B,ana.etxebarria@megaapp.online,286945,ES22209500845884487347,6753.85,2023-12-12T14:39:34,Vitoria-Gasteiz,expenses,transport,-68.0,8236.27
buyer_3,Ana,Etxebarria,1989-08-23,49614208B,ana.etxebarria@megaapp.online,286945,ES22209500845884487347,6753.85,2023-12-12T09:44:05,Vitoria-Gasteiz,expenses,repairs,-205.35,8030.92
buyer_3,Ana,Etxebarria,1989-08-23,49614208B,ana.etxebarria@megaapp.online,286945,ES22209500845884487347,6753.85,2023-12-18T15:29:21,Vitoria-Gasteiz,expenses,cash,-100.0,7930.92
buyer_3,Ana,Etxebarria,1989-08-23,49614208B,ana.etxebarria@megaapp.online,286945,ES22209500845884487347,6753.85,2023-12-18T15:11:36,Vitoria-Gasteiz,expenses,gifts,-298.41,7632.51
buyer_3,Ana,Etxebarria,1989-08-23,49614208B,ana.etxebarria@megaapp.online,286945,ES22209500845884487347,6753.85,2023-12-22T07:54:42,Vitoria-Gasteiz,expenses,cash,-100.0,7532.51
buyer_3,Ana,Etxebarria,1989-08-23,49614208B,ana.etxebarria@megaapp.online,286945,ES22209500845884487347,6753.85,2023-12-24T09:48:47,Vitoria-Gasteiz,expenses,food,-74.7,7457.81
buyer_3,Ana,Etxebarria,1989-08-23,49614208B,ana.etxebarria@megaapp.online,286945,ES22209500845884487347,6753.85,2023-12-26T14:42:53,Vitoria-Gasteiz,expenses,leisure,-68.44,7389.37
buyer_3,Ana,Etxebarria,1989-08-23,49614208B,ana.etxebarria@megaapp.online,286945,ES22209500845884487347,6753.85,2023-12-26T09:09:32,Vitoria-Gasteiz,expenses,cash,-100.0,7289.37
buyer_3,Ana,Etxebarria,1989-08-23,49614208B,ana.etxebarria@megaapp.online,286945,ES22209500845884487347,6753.85,2023-12-29T02:37:02,Vitoria-Gasteiz,expenses,food,-65.74,7223.63
buyer_3,Ana,Etxebarria,1989-08-23,49614208B,ana.etxebarria@megaapp.online,286945,ES22209500845884487347,6753.85,2023-12-31T20:34:49,Vitoria-Gasteiz,expenses,transport,-59.68,7163.95
buyer_3,Ana,Etxebarria,1989-08-23,49614208B,ana.etxebarria@megaapp.online,286945,ES22209500845884487347,6753.85,2024-01-01T17:38:13,Vitoria-Gasteiz,incomes,salary,3332.08,10496.03
buyer_3,Ana,Etxebarria,1989-08-23,49614208B,ana.etxebarria@megaapp.online,286945,ES22209500845884487347,6753.85,2024-01-01T17:38:13,Vitoria-Gasteiz,incomes,salary_partner,3993.88,14489.91
buyer_3,Ana,Etxebarria,1989-08-23,49614208B,ana.etxebarria@megaapp.online,286945,ES22209500845884487347,6753.85,2024-01-05T12:42:44,Vitoria-Gasteiz,expenses,mortgage,-3467.84,11022.07
buyer_3,Ana,Etxebarria,1989-08-23,49614208B,ana.etxebarria@megaapp.online,286945,ES22209500845884487347,6753.85,2024-01-05T18:09:05,Vitoria-Gasteiz,expenses,gas,-293.23,10728.84
buyer_3,Ana,Etxebarria,1989-08-23,49614208B,ana.etxebarria@megaapp.online,286945,ES22209500845884487347,6753.85,2024-01-05T15:50:19,Vitoria-Gasteiz,expenses,internet,-153.85,10574.99
buyer_3,Ana,Etxebarria,1989-08-23,49614208B,ana.etxebarria@megaapp.online,286945,ES22209500845884487347,6753.85,2024-01-05T13:38:20,Vitoria-Gasteiz,expenses,phone,-156.8,10418.19
buyer_3,Ana,Etxebarria,1989-08-23,49614208B,ana.etxebarria@megaapp.online,286945,ES22209500845884487347,6753.85,2024-01-06T19:33:50,Vitoria-Gasteiz,expenses,food,-85.91,10332.28
buyer_3,Ana,Etxebarria,1989-08-23,49614208B,ana.etxebarria@megaapp.online,286945,ES22209500845884487347,6753.85,2024-01-07T11:42:12,Vitoria-Gasteiz,expenses,electricity,-228.45,10103.83
buyer_3,Ana,Etxebarria,1989-08-23,49614208B,ana.etxebarria@megaapp.online,286945,ES22209500845884487347,6753.85,2024-01-07T13:25:19,Vitoria-Gasteiz,expenses,phone,-133.68,9970.15
buyer_3,Ana,Etxebarria,1989-08-23,49614208B,ana.etxebarria@megaapp.online,286945,ES22209500845884487347,6753.85,2024-01-08T13:44:11,Vitoria-Gasteiz,expenses,water,-113.84,9856.31
buyer_3,Ana,Etxebarria,1989-08-23,49614208B,ana.etxebarria@megaapp.online,286945,ES22209500845884487347,6753.85,2024-01-08T16:07:32,Vitoria-Gasteiz,expenses,gas,-243.87,9612.44
buyer_3,Ana,Etxebarria,1989-08-23,49614208B,ana.etxebarria@megaapp.online,286945,ES22209500845884487347,6753.85,2024-01-08T15:04:44,Vitoria-Gasteiz,expenses,food,-110.28,9502.16
buyer_3,Ana,Etxebarria,1989-08-23,49614208B,ana.etxebarria@megaapp.online,286945,ES22209500845884487347,6753.85,2024-01-08T19:34:09,Vitoria-Gasteiz,expenses,transport,-52.98,9449.18
buyer_3,Ana,Etxebarria,1989-08-23,49614208B,ana.etxebarria@megaapp.online,286945,ES22209500845884487347,6753.85,2024-01-08T17:29:08,Vitoria-Gasteiz,expenses,leisure,-31.87,9417.31
buyer_3,Ana,Etxebarria,1989-08-23,49614208B,ana.etxebarria@megaapp.online,286945,ES22209500845884487347,6753.85,2024-01-08T11:38:23,Vitoria-Gasteiz,expenses,education,-67.47,9349.84
buyer_3,Ana,Etxebarria,1989-08-23,49614208B,ana.etxebarria@megaapp.online,286945,ES22209500845884487347,6753.85,2024-01-09T14:42:33,Vitoria-Gasteiz,expenses,transport,-57.46,9292.38
buyer_3,Ana,Etxebarria,1989-08-23,49614208B,ana.etxebarria@megaapp.online,286945,ES22209500845884487347,6753.85,2024-01-09T14:38:18,Vitoria-Gasteiz,expenses,cash,-100.0,9192.38
buyer_3,Ana,Etxebarria,1989-08-23,49614208B,ana.etxebarria@megaapp.online,286945,ES22209500845884487347,6753.85,2024-01-10T19:09:36,Vitoria-Gasteiz,expenses,appliances,-402.66,8789.72
buyer_3,Ana,Etxebarria,1989-08-23,49614208B,ana.etxebarria@megaapp.online,286945,ES22209500845884487347,6753.85,2024-01-11T08:31:02,Vitoria-Gasteiz,expenses,transport,-54.06,8735.66
buyer_3,Ana,Etxebarria,1989-08-23,49614208B,ana.etxebarria@megaapp.online,286945,ES22209500845884487347,6753.85,2024-01-14T19:56:11,Vitoria-Gasteiz,expenses,cash,-100.0,8635.66
buyer_3,Ana,Etxebarria,1989-08-23,49614208B,ana.etxebarria@megaapp.online,286945,ES22209500845884487347,6753.85,2024-01-15T13:58:13,Vitoria-Gasteiz,expenses,food,-70.25,8565.41
buyer_3,Ana,Etxebarria,1989-08-23,49614208B,ana.etxebarria@megaapp.online,286945,ES22209500845884487347,6753.85,2024-01-15T11:05:06,Vitoria-Gasteiz,expenses,healthcare,-71.23,8494.18
buyer_3,Ana,Etxebarria,1989-08-23,49614208B,ana.etxebarria@megaapp.online,286945,ES22209500845884487347,6753.85,2024-01-17T02:15:55,Vitoria-Gasteiz,expenses,gifts,-779.74,7714.44
buyer_3,Ana,Etxebarria,1989-08-23,49614208B,ana.etxebarria@megaapp.online,286945,ES22209500845884487347,6753.85,2024-01-18T15:31:05,Vitoria-Gasteiz,expenses,education,-48.16,7666.28
buyer_3,Ana,Etxebarria,1989-08-23,49614208B,ana.etxebarria@megaapp.online,286945,ES22209500845884487347,6753.85,2024-01-20T15:31:53,Vitoria-Gasteiz,expenses,cash,-100.0,7566.28
buyer_3,Ana,Etxebarria,1989-08-23,49614208B,ana.etxebarria@megaapp.online,286945,ES22209500845884487347,6753.85,2024-01-23T04:37:29,Vitoria-Gasteiz,expenses,transport,-79.85,7486.43
buyer_3,Ana,Etxebarria,1989-08-23,49614208B,ana.etxebarria@megaapp.online,286945,ES22209500845884487347,6753.85,2024-01-23T17:43:09,Vitoria-Gasteiz,expenses,cash,-100.0,7386.43
buyer_3,Ana,Etxebarria,1989-08-23,49614208B,ana.etxebarria@megaapp.online,286945,ES22209500845884487347,6753.85,2024-01-25T17:40:37,Vitoria-Gasteiz,expenses,appliances,-336.16,7050.27
buyer_3,Ana,Etxebarria,1989-08-23,49614208B,ana.etxebarria@megaapp.online,286945,ES22209500845884487347,6753.85,2024-01-26T14:03:52,Vitoria-Gasteiz,expenses,food,-89.11,6961.16
buyer_3,Ana,Etxebarria,1989-08-23,49614208B,ana.etxebarria@megaapp.online,286945,ES22209500845884487347,6753.85,2024-01-27T12:09:36,Vitoria-Gasteiz,expenses,education,-69.96,6891.2
buyer_3,Ana,Etxebarria,1989-08-23,49614208B,ana.etxebarria@megaapp.online,286945,ES22209500845884487347,6753.85,2024-01-27T22:00:29,Vitoria-Gasteiz,expenses,cash,-100.0,6791.2
buyer_3,Ana,Etxebarria,1989-08-23,49614208B,ana.etxebarria@megaapp.online,286945,ES22209500845884487347,6753.85,2024-01-28T10:40:40,Vitoria-Gasteiz,expenses,food,-80.98,6710.22
buyer_3,Ana,Etxebarria,1989-08-23,49614208B,ana.etxebarria@megaapp.online,286945,ES22209500845884487347,6753.85,2024-01-28T22:18:27,Vitoria-Gasteiz,expenses,leisure,-78.6,6631.62
buyer_3,Ana,Etxebarria,1989-08-23,49614208B,ana.etxebarria@megaapp.online,286945,ES22209500845884487347,6753.85,2024-01-29T18:12:33,Vitoria-Gasteiz,expenses,transport,-45.71,6585.91
buyer_3,Ana,Etxebarria,1989-08-23,49614208B,ana.etxebarria@megaapp.online,286945,ES22209500845884487347,6753.85,2024-01-29T06:07:45,Vitoria-Gasteiz,expenses,education,-58.37,6527.54
buyer_3,Ana,Etxebarria,1989-08-23,49614208B,ana.etxebarria@megaapp.online,286945,ES22209500845884487347,6753.85,2024-01-31T17:28:33,Vitoria-Gasteiz,expenses,education,-68.9,6458.64
buyer_3,Ana,Etxebarria,1989-08-23,49614208B,ana.etxebarria@megaapp.online,286945,ES22209500845884487347,6753.85,2024-01-31T10:16:50,Vitoria-Gasteiz,expenses,travel,-887.88,5570.76
buyer_3,Ana,Etxebarria,1989-08-23,49614208B,ana.etxebarria@megaapp.online,286945,ES22209500845884487347,6753.85,2024-02-01T18:51:25,Vitoria-Gasteiz,incomes,salary,3332.08,8902.84
buyer_3,Ana,Etxebarria,1989-08-23,49614208B,ana.etxebarria@megaapp.online,286945,ES22209500845884487347,6753.85,2024-02-01T18:51:25,Vitoria-Gasteiz,incomes,salary_partner,3993.88,12896.72
buyer_3,Ana,Etxebarria,1989-08-23,49614208B,ana.etxebarria@megaapp.online,286945,ES22209500845884487347,6753.85,2024-02-02T15:01:55,Vitoria-Gasteiz,expenses,travel,-726.35,12170.37
buyer_3,Ana,Etxebarria,1989-08-23,49614208B,ana.etxebarria@megaapp.online,286945,ES22209500845884487347,6753.85,2024-02-03T19:04:28,Vitoria-Gasteiz,expenses,cash,-100.0,12070.37
buyer_3,Ana,Etxebarria,1989-08-23,49614208B,ana.etxebarria@megaapp.online,286945,ES22209500845884487347,6753.85,2024-02-05T09:33:28,Vitoria-Gasteiz,expenses,mortgage,-3467.84,8602.53
buyer_3,Ana,Etxebarria,1989-08-23,49614208B,ana.etxebarria@megaapp.online,286945,ES22209500845884487347,6753.85,2024-02-05T15:58:11,Vitoria-Gasteiz,expenses,internet,-153.85,8448.68
buyer_3,Ana,Etxebarria,1989-08-23,49614208B,ana.etxebarria@megaapp.online,286945,ES22209500845884487347,6753.85,2024-02-06T02:52:45,Vitoria-Gasteiz,expenses,gas,-307.47,8141.21
buyer_3,Ana,Etxebarria,1989-08-23,49614208B,ana.etxebarria@megaapp.online,286945,ES22209500845884487347,6753.85,2024-02-06T09:03:26,Vitoria-Gasteiz,expenses,phone,-127.44,8013.77
buyer_3,Ana,Etxebarria,1989-08-23,49614208B,ana.etxebarria@megaapp.online,286945,ES22209500845884487347,6753.85,2024-02-07T15:57:18,Vitoria-Gasteiz,expenses,electricity,-101.26,7912.51
buyer_3,Ana,Etxebarria,1989-08-23,49614208B,ana.etxebarria@megaapp.online,286945,ES22209500845884487347,6753.85,2024-02-07T23:00:42,Vitoria-Gasteiz,expenses,gas,-264.6,7647.91
buyer_3,Ana,Etxebarria,1989-08-23,49614208B,ana.etxebarria@megaapp.online,286945,ES22209500845884487347,6753.85,2024-02-07T23:18:50,Vitoria-Gasteiz,expenses,food,-113.89,7534.02
buyer_3,Ana,Etxebarria,1989-08-23,49614208B,ana.etxebarria@megaapp.online,286945,ES22209500845884487347,6753.85,2024-02-07T08:22:00,Vitoria-Gasteiz,expenses,healthcare,-149.21,7384.81
buyer_3,Ana,Etxebarria,1989-08-23,49614208B,ana.etxebarria@megaapp.online,286945,ES22209500845884487347,6753.85,2024-02-07T19:48:52,Vitoria-Gasteiz,expenses,cash,-100.0,7284.81
buyer_3,Ana,Etxebarria,1989-08-23,49614208B,ana.etxebarria@megaapp.online,286945,ES22209500845884487347,6753.85,2024-02-08T17:17:49,Vitoria-Gasteiz,expenses,gas,-303.52,6981.29
buyer_3,Ana,Etxebarria,1989-08-23,49614208B,ana.etxebarria@megaapp.online,286945,ES22209500845884487347,6753.85,2024-02-10T20:04:54,Vitoria-Gasteiz,expenses,food,-84.48,6896.81
buyer_3,Ana,Etxebarria,1989-08-23,49614208B,ana.etxebarria@megaapp.online,286945,ES22209500845884487347,6753.85,2024-02-12T07:22:54,Vitoria-Gasteiz,expenses,healthcare,-52.33,6844.48
buyer_3,Ana,Etxebarria,1989-08-23,49614208B,ana.etxebarria@megaapp.online,286945,ES22209500845884487347,6753.85,2024-02-13T16:25:59,Vitoria-Gasteiz,expenses,leisure,-20.82,6823.66
buyer_3,Ana,Etxebarria,1989-08-23,49614208B,ana.etxebarria@megaapp.online,286945,ES22209500845884487347,6753.85,2024-02-15T20:26:02,Vitoria-Gasteiz,expenses,transport,-72.09,6751.57
buyer_3,Ana,Etxebarria,1989-08-23,49614208B,ana.etxebarria@megaapp.online,286945,ES22209500845884487347,6753.85,2024-02-15T14:24:03,Vitoria-Gasteiz,expenses,repairs,-324.68,6426.89
buyer_3,Ana,Etxebarria,1989-08-23,49614208B,ana.etxebarria@megaapp.online,286945,ES22209500845884487347,6753.85,2024-02-16T20:58:20,Vitoria-Gasteiz,expenses,clothing,-123.86,6303.03
buyer_3,Ana,Etxebarria,1989-08-23,49614208B,ana.etxebarria@megaapp.online,286945,ES22209500845884487347,6753.85,2024-02-17T12:47:32,Vitoria-Gasteiz,expenses,clothing,-141.06,6161.97
buyer_3,Ana,Etxebarria,1989-08-23,49614208B,ana.etxebarria@megaapp.online,286945,ES22209500845884487347,6753.85,2024-02-18T10:05:32,Vitoria-Gasteiz,expenses,travel,-957.4,5204.57
buyer_3,Ana,Etxebarria,1989-08-23,49614208B,ana.etxebarria@megaapp.online,286945,ES22209500845884487347,6753.85,2024-02-18T11:03:14,Vitoria-Gasteiz,expenses,repairs,-237.67,4966.9
buyer_3,Ana,Etxebarria,1989-08-23,49614208B,ana.etxebarria@megaapp.online,286945,ES22209500845884487347,6753.85,2024-02-20T09:41:22,Vitoria-Gasteiz,expenses,repairs,-227.67,4739.23
buyer_3,Ana,Etxebarria,1989-08-23,49614208B,ana.etxebarria@megaapp.online,286945,ES22209500845884487347,6753.85,2024-02-22T01:54:41,Vitoria-Gasteiz,expenses,education,-56.92,4682.31
buyer_3,Ana,Etxebarria,1989-08-23,49614208B,ana.etxebarria@megaapp.online,286945,ES22209500845884487347,6753.85,2024-02-23T12:25:03,Vitoria-Gasteiz,expenses,gifts,-828.42,3853.89
buyer_3,Ana,Etxebarria,1989-08-23,49614208B,ana.etxebarria@megaapp.online,286945,ES22209500845884487347,6753.85,2024-02-24T12:26:43,Vitoria-Gasteiz,expenses,leisure,-25.97,3827.92
buyer_3,Ana,Etxebarria,1989-08-23,49614208B,ana.etxebarria@megaapp.online,286945,ES22209500845884487347,6753.85,2024-02-25T04:23:54,Vitoria-Gasteiz,expenses,food,-74.62,3753.3
buyer_3,Ana,Etxebarria,1989-08-23,49614208B,ana.etxebarria@megaapp.online,286945,ES22209500845884487347,6753.85,2024-02-25T15:15:24,Vitoria-Gasteiz,expenses,education,-52.99,3700.31
buyer_3,Ana,Etxebarria,1989-08-23,49614208B,ana.etxebarria@megaapp.online,286945,ES22209500845884487347,6753.85,2024-02-26T20:45:46,Vitoria-Gasteiz,expenses,leisure,-76.45,3623.86
buyer_3,Ana,Etxebarria,1989-08-23,49614208B,ana.etxebarria@megaapp.online,286945,ES22209500845884487347,6753.85,2024-02-27T06:03:33,Vitoria-Gasteiz,expenses,transport,-58.49,3565.37
buyer_3,Ana,Etxebarria,1989-08-23,49614208B,ana.etxebarria@megaapp.online,286945,ES22209500845884487347,6753.85,2024-02-27T10:05:47,Vitoria-Gasteiz,expenses,cash,-100.0,3465.37
buyer_3,Ana,Etxebarria,1989-08-23,49614208B,ana.etxebarria@megaapp.online,286945,ES22209500845884487347,6753.85,2024-02-28T18:31:54,Vitoria-Gasteiz,expenses,transport,-73.69,3391.68
buyer_3,Ana,Etxebarria,1989-08-23,49614208B,ana.etxebarria@megaapp.online,286945,ES22209500845884487347,6753.85,2024-02-28T22:32:09,Vitoria-Gasteiz,expenses,cash,-100.0,3291.68
buyer_3,Ana,Etxebarria,1989-08-23,49614208B,ana.etxebarria@megaapp.online,286945,ES22209500845884487347,6753.85,2024-03-01T23:26:58,Vitoria-Gasteiz,incomes,salary,3332.08,6623.76
buyer_3,Ana,Etxebarria,1989-08-23,49614208B,ana.etxebarria@megaapp.online,286945,ES22209500845884487347,6753.85,2024-03-01T23:26:58,Vitoria-Gasteiz,incomes,salary_partner,3993.88,10617.64
buyer_3,Ana,Etxebarria,1989-08-23,49614208B,ana.etxebarria@megaapp.online,286945,ES22209500845884487347,6753.85,2024-03-03T14:30:56,Vitoria-Gasteiz,expenses,clothing,-104.21,10513.43
buyer_3,Ana,Etxebarria,1989-08-23,49614208B,ana.etxebarria@megaapp.online,286945,ES22209500845884487347,6753.85,2024-03-04T13:58:59,Vitoria-Gasteiz,expenses,education,-63.23,10450.2
buyer_3,Ana,Etxebarria,1989-08-23,49614208B,ana.etxebarria@megaapp.online,286945,ES22209500845884487347,6753.85,2024-03-05T14:57:52,Vitoria-Gasteiz,expenses,mortgage,-3467.84,6982.36
buyer_3,Ana,Etxebarria,1989-08-23,49614208B,ana.etxebarria@megaapp.online,286945,ES22209500845884487347,6753.85,2024-03-05T16:39:21,Vitoria-Gasteiz,expenses,electricity,-282.98,6699.38
buyer_3,Ana,Etxebarria,1989-08-23,49614208B,ana.etxebarria@megaapp.online,286945,ES22209500845884487347,6753.85,2024-03-05T18:43:37,Vitoria-Gasteiz,expenses,internet,-153.85,6545.53
buyer_3,Ana,Etxebarria,1989-08-23,49614208B,ana.etxebarria@megaapp.online,286945,ES22209500845884487347,6753.85,2024-03-06T10:39:22,Vitoria-Gasteiz,expenses,phone,-157.12,6388.41
buyer_3,Ana,Etxebarria,1989-08-23,49614208B,ana.etxebarria@megaapp.online,286945,ES22209500845884487347,6753.85,2024-03-06T20:31:09,Vitoria-Gasteiz,expenses,food,-109.37,6279.04
buyer_3,Ana,Etxebarria,1989-08-23,49614208B,ana.etxebarria@megaapp.online,286945,ES22209500845884487347,6753.85,2024-03-07T08:36:07,Vitoria-Gasteiz,expenses,gas,-354.75,5924.29
buyer_3,Ana,Etxebarria,1989-08-23,49614208B,ana.etxebarria@megaapp.online,286945,ES22209500845884487347,6753.85,2024-03-08T09:23:07,Vitoria-Gasteiz,expenses,water,-146.87,5777.42
buyer_3,Ana,Etxebarria,1989-08-23,49614208B,ana.etxebarria@megaapp.online,286945,ES22209500845884487347,6753.85,2024-03-08T09:03:46,Vitoria-Gasteiz,expenses,electricity,-172.7,5604.72
buyer_3,Ana,Etxebarria,1989-08-23,49614208B,ana.etxebarria@megaapp.online,286945,ES22209500845884487347,6753.85,2024-03-08T08:31:31,Vitoria-Gasteiz,expenses,leisure,-84.6,5520.12
buyer_3,Ana,Etxebarria,1989-08-23,49614208B,ana.etxebarria@megaapp.online,286945,ES22209500845884487347,6753.85,2024-03-10T18:15:33,Vitoria-Gasteiz,expenses,food,-117.78,5402.34
buyer_3,Ana,Etxebarria,1989-08-23,49614208B,ana.etxebarria@megaapp.online,286945,ES22209500845884487347,6753.85,2024-03-10T09:05:40,Vitoria-Gasteiz,expenses,leisure,-56.67,5345.67
buyer_3,Ana,Etxebarria,1989-08-23,49614208B,ana.etxebarria@megaapp.online,286945,ES22209500845884487347,6753.85,2024-03-12T09:05:01,Vitoria-Gasteiz,expenses,repairs,-300.36,5045.31
buyer_3,Ana,Etxebarria,1989-08-23,49614208B,ana.etxebarria@megaapp.online,286945,ES22209500845884487347,6753.85,2024-03-15T14:21:51,Vitoria-Gasteiz,expenses,leisure,-69.02,4976.29
buyer_3,Ana,Etxebarria,1989-08-23,49614208B,ana.etxebarria@megaapp.online,286945,ES22209500845884487347,6753.85,2024-03-16T10:09:21,Vitoria-Gasteiz,expenses,transport,-81.82,4894.47
buyer_3,Ana,Etxebarria,1989-08-23,49614208B,ana.etxebarria@megaapp.online,286945,ES22209500845884487347,6753.85,2024-03-16T17:15:57,Vitoria-Gasteiz,expenses,education,-44.02,4850.45
buyer_3,Ana,Etxebarria,1989-08-23,49614208B,ana.etxebarria@megaapp.online,286945,ES22209500845884487347,6753.85,2024-03-17T04:19:09,Vitoria-Gasteiz,expenses,transport,-85.27,4765.18
buyer_3,Ana,Etxebarria,1989-08-23,49614208B,ana.etxebarria@megaapp.online,286945,ES22209500845884487347,6753.85,2024-03-18T22:48:40,Vitoria-Gasteiz,expenses,gifts,-27.59,4737.59
buyer_3,Ana,Etxebarria,1989-08-23,49614208B,ana.etxebarria@megaapp.online,286945,ES22209500845884487347,6753.85,2024-03-19T18:40:01,Vitoria-Gasteiz,expenses,food,-98.21,4639.38
buyer_3,Ana,Etxebarria,1989-08-23,49614208B,ana.etxebarria@megaapp.online,286945,ES22209500845884487347,6753.85,2024-03-22T18:20:37,Vitoria-Gasteiz,expenses,leisure,-83.11,4556.27
buyer_3,Ana,Etxebarria,1989-08-23,49614208B,ana.etxebarria@megaapp.online,286945,ES22209500845884487347,6753.85,2024-03-22T19:17:20,Vitoria-Gasteiz,expenses,clothing,-113.76,4442.51
buyer_3,Ana,Etxebarria,1989-08-23,49614208B,ana.etxebarria@megaapp.online,286945,ES22209500845884487347,6753.85,2024-03-24T17:49:13,Vitoria-Gasteiz,expenses,cash,-100.0,4342.51
buyer_3,Ana,Etxebarria,1989-08-23,49614208B,ana.etxebarria@megaapp.online,286945,ES22209500845884487347,6753.85,2024-03-30T16:14:26,Vitoria-Gasteiz,expenses,food,-97.73,4244.78
buyer_3,Ana,Etxebarria,1989-08-23,49614208B,ana.etxebarria@megaapp.online,286945,ES22209500845884487347,6753.85,2024-04-01T23:26:47,Vitoria-Gasteiz,incomes,salary,3332.08,7576.86
buyer_3,Ana,Etxebarria,1989-08-23,49614208B,ana.etxebarria@megaapp.online,286945,ES22209500845884487347,6753.85,2024-04-01T23:26:47,Vitoria-Gasteiz,incomes,salary_partner,3993.88,11570.74
buyer_3,Ana,Etxebarria,1989-08-23,49614208B,ana.etxebarria@megaapp.online,286945,ES22209500845884487347,6753.85,2024-04-01T23:26:47,Vitoria-Gasteiz,incomes,extra_income,412.38,11983.12
buyer_3,Ana,Etxebarria,1989-08-23,49614208B,ana.etxebarria@megaapp.online,286945,ES22209500845884487347,6753.85,2024-04-02T12:16:24,Vitoria-Gasteiz,expenses,leisure,-32.35,11950.77
buyer_3,Ana,Etxebarria,1989-08-23,49614208B,ana.etxebarria@megaapp.online,286945,ES22209500845884487347,6753.85,2024-04-02T14:50:37,Vitoria-Gasteiz,expenses,clothing,-87.22,11863.55
buyer_3,Ana,Etxebarria,1989-08-23,49614208B,ana.etxebarria@megaapp.online,286945,ES22209500845884487347,6753.85,2024-04-03T06:39:48,Vitoria-Gasteiz,expenses,travel,-1212.81,10650.74
buyer_3,Ana,Etxebarria,1989-08-23,49614208B,ana.etxebarria@megaapp.online,286945,ES22209500845884487347,6753.85,2024-04-04T18:40:07,Vitoria-Gasteiz,expenses,education,-60.86,10589.88
buyer_3,Ana,Etxebarria,1989-08-23,49614208B,ana.etxebarria@megaapp.online,286945,ES22209500845884487347,6753.85,2024-04-05T08:55:53,Vitoria-Gasteiz,expenses,mortgage,-3467.84,7122.04
buyer_3,Ana,Etxebarria,1989-08-23,49614208B,ana.etxebarria@megaapp.online,286945,ES22209500845884487347,6753.85,2024-04-05T12:59:37,Vitoria-Gasteiz,expenses,repairs,-101.0,7021.04
buyer_3,Ana,Etxebarria,1989-08-23,49614208B,ana.etxebarria@megaapp.online,286945,ES22209500845884487347,6753.85,2024-04-06T13:17:21,Vitoria-Gasteiz,expenses,water,-149.88,6871.16
buyer_3,Ana,Etxebarria,1989-08-23,49614208B,ana.etxebarria@megaapp.online,286945,ES22209500845884487347,6753.85,2024-04-06T09:35:04,Vitoria-Gasteiz,expenses,phone,-155.27,6715.89
buyer_3,Ana,Etxebarria,1989-08-23,49614208B,ana.etxebarria@megaapp.online,286945,ES22209500845884487347,6753.85,2024-04-06T09:18:56,Vitoria-Gasteiz,expenses,education,-78.39,6637.5
buyer_3,Ana,Etxebarria,1989-08-23,49614208B,ana.etxebarria@megaapp.online,286945,ES22209500845884487347,6753.85,2024-04-07T20:53:53,Vitoria-Gasteiz,expenses,internet,-153.85,6483.65
buyer_3,Ana,Etxebarria,1989-08-23,49614208B,ana.etxebarria@megaapp.online,286945,ES22209500845884487347,6753.85,2024-04-07T14:05:54,Vitoria-Gasteiz,expenses,phone,-150.98,6332.67
buyer_3,Ana,Etxebarria,1989-08-23,49614208B,ana.etxebarria@megaapp.online,286945,ES22209500845884487347,6753.85,2024-04-10T17:07:00,Vitoria-Gasteiz,expenses,gifts,-435.78,5896.89
buyer_3,Ana,Etxebarria,1989-08-23,49614208B,ana.etxebarria@megaapp.online,286945,ES22209500845884487347,6753.85,2024-04-11T13:02:56,Vitoria-Gasteiz,expenses,clothing,-148.85,5748.04
buyer_3,Ana,Etxebarria,1989-08-23,49614208B,ana.etxebarria@megaapp.online,286945,ES22209500845884487347,6753.85,2024-04-12T21:22:49,Vitoria-Gasteiz,expenses,food,-106.46,5641.58
buyer_3,Ana,Etxebarria,1989-08-23,49614208B,ana.etxebarria@megaapp.online,286945,ES22209500845884487347,6753.85,2024-04-14T08:15:10,Vitoria-Gasteiz,expenses,food,-72.48,5569.1
buyer_3,Ana,Etxebarria,1989-08-23,49614208B,ana.etxebarria@megaapp.online,286945,ES22209500845884487347,6753.85,2024-04-14T22:01:38,Vitoria-Gasteiz,expenses,leisure,-19.65,5549.45
buyer_3,Ana,Etxebarria,1989-08-23,49614208B,ana.etxebarria@megaapp.online,286945,ES22209500845884487347,6753.85,2024-04-15T09:47:17,Vitoria-Gasteiz,expenses,repairs,-163.3,5386.15
buyer_3,Ana,Etxebarria,1989-08-23,49614208B,ana.etxebarria@megaapp.online,286945,ES22209500845884487347,6753.85,2024-04-16T13:33:41,Vitoria-Gasteiz,expenses,transport,-47.29,5338.86
buyer_3,Ana,Etxebarria,1989-08-23,49614208B,ana.etxebarria@megaapp.online,286945,ES22209500845884487347,6753.85,2024-04-16T02:45:41,Vitoria-Gasteiz,expenses,education,-73.32,5265.54
buyer_3,Ana,Etxebarria,1989-08-23,49614208B,ana.etxebarria@megaapp.online,286945,ES22209500845884487347,6753.85,2024-04-17T04:47:58,Vitoria-Gasteiz,expenses,food,-100.83,5164.71
buyer_3,Ana,Etxebarria,1989-08-23,49614208B,ana.etxebarria@megaapp.online,286945,ES22209500845884487347,6753.85,2024-04-19T19:59:27,Vitoria-Gasteiz,expenses,cash,-100.0,5064.71
buyer_3,Ana,Etxebarria,1989-08-23,49614208B,ana.etxebarria@megaapp.online,286945,ES22209500845884487347,6753.85,2024-04-20T16:37:08,Vitoria-Gasteiz,expenses,healthcare,-159.29,4905.42
buyer_3,Ana,Etxebarria,1989-08-23,49614208B,ana.etxebarria@megaapp.online,286945,ES22209500845884487347,6753.85,2024-04-21T10:51:19,Vitoria-Gasteiz,expenses,food,-109.06,4796.36
buyer_3,Ana,Etxebarria,1989-08-23,49614208B,ana.etxebarria@megaapp.online,286945,ES22209500845884487347,6753.85,2024-04-21T13:23:09,Vitoria-Gasteiz,expenses,leisure,-48.07,4748.29
buyer_3,Ana,Etxebarria,1989-08-23,49614208B,ana.etxebarria@megaapp.online,286945,ES22209500845884487347,6753.85,2024-04-22T08:37:52,Vitoria-Gasteiz,expenses,food,-105.43,4642.86
buyer_3,Ana,Etxebarria,1989-08-23,49614208B,ana.etxebarria@megaapp.online,286945,ES22209500845884487347,6753.85,2024-04-22T19:52:04,Vitoria-Gasteiz,expenses,leisure,-56.22,4586.64
buyer_3,Ana,Etxebarria,1989-08-23,49614208B,ana.etxebarria@megaapp.online,286945,ES22209500845884487347,6753.85,2024-04-23T06:45:47,Vitoria-Gasteiz,expenses,food,-123.42,4463.22
buyer_3,Ana,Etxebarria,1989-08-23,49614208B,ana.etxebarria@megaapp.online,286945,ES22209500845884487347,6753.85,2024-04-23T18:30:45,Vitoria-Gasteiz,expenses,cash,-100.0,4363.22
buyer_3,Ana,Etxebarria,1989-08-23,49614208B,ana.etxebarria@megaapp.online,286945,ES22209500845884487347,6753.85,2024-04-23T16:32:23,Vitoria-Gasteiz,expenses,appliances,-332.51,4030.71
buyer_3,Ana,Etxebarria,1989-08-23,49614208B,ana.etxebarria@megaapp.online,286945,ES22209500845884487347,6753.85,2024-04-23T11:08:22,Vitoria-Gasteiz,expenses,repairs,-90.13,3940.58
buyer_3,Ana,Etxebarria,1989-08-23,49614208B,ana.etxebarria@megaapp.online,286945,ES22209500845884487347,6753.85,2024-04-26T08:24:43,Vitoria-Gasteiz,expenses,clothing,-103.86,3836.72
buyer_3,Ana,Etxebarria,1989-08-23,49614208B,ana.etxebarria@megaapp.online,286945,ES22209500845884487347,6753.85,2024-04-26T06:55:50,Vitoria-Gasteiz,expenses,cash,-100.0,3736.72
buyer_3,Ana,Etxebarria,1989-08-23,49614208B,ana.etxebarria@megaapp.online,286945,ES22209500845884487347,6753.85,2024-04-27T09:51:48,Vitoria-Gasteiz,expenses,transport,-67.98,3668.74
buyer_3,Ana,Etxebarria,1989-08-23,49614208B,ana.etxebarria@megaapp.online,286945,ES22209500845884487347,6753.85,2024-04-27T10:31:04,Vitoria-Gasteiz,expenses,appliances,-390.09,3278.65
buyer_3,Ana,Etxebarria,1989-08-23,49614208B,ana.etxebarria@megaapp.online,286945,ES22209500845884487347,6753.85,2024-04-29T08:44:39,Vitoria-Gasteiz,expenses,transport,-75.5,3203.15
buyer_3,Ana,Etxebarria,1989-08-23,49614208B,ana.etxebarria@megaapp.online,286945,ES22209500845884487347,6753.85,2024-04-29T08:16:53,Vitoria-Gasteiz,expenses,leisure,-75.49,3127.66
buyer_3,Ana,Etxebarria,1989-08-23,49614208B,ana.etxebarria@megaapp.online,286945,ES22209500845884487347,6753.85,2024-04-30T11:05:21,Vitoria-Gasteiz,expenses,clothing,-146.33,2981.33
buyer_3,Ana,Etxebarria,1989-08-23,49614208B,ana.etxebarria@megaapp.online,286945,ES22209500845884487347,6753.85,2024-04-30T07:50:20,Vitoria-Gasteiz,expenses,repairs,-288.64,2692.69
buyer_3,Ana,Etxebarria,1989-08-23,49614208B,ana.etxebarria@megaapp.online,286945,ES22209500845884487347,6753.85,2024-05-01T17:41:09,Vitoria-Gasteiz,incomes,salary,3332.08,6024.77
buyer_3,Ana,Etxebarria,1989-08-23,49614208B,ana.etxebarria@megaapp.online,286945,ES22209500845884487347,6753.85,2024-05-01T17:41:09,Vitoria-Gasteiz,incomes,salary_partner,3993.88,10018.65
buyer_3,Ana,Etxebarria,1989-08-23,49614208B,ana.etxebarria@megaapp.online,286945,ES22209500845884487347,6753.85,2024-05-01T19:00:07,Vitoria-Gasteiz,expenses,transport,-68.04,9950.61
buyer_3,Ana,Etxebarria,1989-08-23,49614208B,ana.etxebarria@megaapp.online,286945,ES22209500845884487347,6753.85,2024-05-02T19:48:13,Vitoria-Gasteiz,expenses,leisure,-26.48,9924.13
buyer_3,Ana,Etxebarria,1989-08-23,49614208B,ana.etxebarria@megaapp.online,286945,ES22209500845884487347,6753.85,2024-05-04T12:16:18,Vitoria-Gasteiz,expenses,clothing,-55.43,9868.7
buyer_3,Ana,Etxebarria,1989-08-23,49614208B,ana.etxebarria@megaapp.online,286945,ES22209500845884487347,6753.85,2024-05-05T14:12:42,Vitoria-Gasteiz,expenses,mortgage,-3467.84,6400.86
buyer_3,Ana,Etxebarria,1989-08-23,49614208B,ana.etxebarria@megaapp.online,286945,ES22209500845884487347,6753.85,2024-05-05T12:01:05,Vitoria-Gasteiz,expenses,water,-99.67,6301.19
buyer_3,Ana,Etxebarria,1989-08-23,49614208B,ana.etxebarria@megaapp.online,286945,ES22209500845884487347,6753.85,2024-05-05T14:28:11,Vitoria-Gasteiz,expenses,internet,-153.85,6147.34
buyer_3,Ana,Etxebarria,1989-08-23,49614208B,ana.etxebarria@megaapp.online,286945,ES22209500845884487347,6753.85,2024-05-05T04:32:54,Vitoria-Gasteiz,expenses,transport,-46.98,6100.36
buyer_3,Ana,Etxebarria,1989-08-23,49614208B,ana.etxebarria@megaapp.online,286945,ES22209500845884487347,6753.85,2024-05-06T20:43:55,Vitoria-Gasteiz,expenses,internet,-153.85,5946.51
buyer_3,Ana,Etxebarria,1989-08-23,49614208B,ana.etxebarria@megaapp.online,286945,ES22209500845884487347,6753.85,2024-05-07T19:09:22,Vitoria-Gasteiz,expenses,water,-154.74,5791.77
buyer_3,Ana,Etxebarria,1989-08-23,49614208B,ana.etxebarria@megaapp.online,286945,ES22209500845884487347,6753.85,2024-05-07T09:14:48,Vitoria-Gasteiz,expenses,electricity,-234.09,5557.68
buyer_3,Ana,Etxebarria,1989-08-23,49614208B,ana.etxebarria@megaapp.online,286945,ES22209500845884487347,6753.85,2024-05-07T03:11:58,Vitoria-Gasteiz,expenses,gas,-309.22,5248.46
buyer_3,Ana,Etxebarria,1989-08-23,49614208B,ana.etxebarria@megaapp.online,286945,ES22209500845884487347,6753.85,2024-05-07T14:16:50,Vitoria-Gasteiz,expenses,internet,-153.85,5094.61
buyer_3,Ana,Etxebarria,1989-08-23,49614208B,ana.etxebarria@megaapp.online,286945,ES22209500845884487347,6753.85,2024-05-07T15:43:08,Vitoria-Gasteiz,expenses,phone,-157.65,4936.96
buyer_3,Ana,Etxebarria,1989-08-23,49614208B,ana.etxebarria@megaapp.online,286945,ES22209500845884487347,6753.85,2024-05-08T10:01:22,Vitoria-Gasteiz,expenses,electricity,-89.24,4847.72
buyer_3,Ana,Etxebarria,1989-08-23,49614208B,ana.etxebarria@megaapp.online,286945,ES22209500845884487347,6753.85,2024-05-08T17:25:39,Vitoria-Gasteiz,expenses,leisure,-67.07,4780.65
buyer_3,Ana,Etxebarria,1989-08-23,49614208B,ana.etxebarria@megaapp.online,286945,ES22209500845884487347,6753.85,2024-05-09T08:07:04,Vitoria-Gasteiz,expenses,cash,-100.0,4680.65
buyer_3,Ana,Etxebarria,1989-08-23,49614208B,ana.etxebarria@megaapp.online,286945,ES22209500845884487347,6753.85,2024-05-10T13:44:20,Vitoria-Gasteiz,expenses,education,-57.1,4623.55
buyer_3,Ana,Etxebarria,1989-08-23,49614208B,ana.etxebarria@megaapp.online,286945,ES22209500845884487347,6753.85,2024-05-10T14:25:03,Vitoria-Gasteiz,expenses,cash,-100.0,4523.55
buyer_3,Ana,Etxebarria,1989-08-23,49614208B,ana.etxebarria@megaapp.online,286945,ES22209500845884487347,6753.85,2024-05-11T10:38:13,Vitoria-Gasteiz,expenses,healthcare,-74.28,4449.27
buyer_3,Ana,Etxebarria,1989-08-23,49614208B,ana.etxebarria@megaapp.online,286945,ES22209500845884487347,6753.85,2024-05-12T17:59:09,Vitoria-Gasteiz,expenses,transport,-52.11,4397.16
buyer_3,Ana,Etxebarria,1989-08-23,49614208B,ana.etxebarria@megaapp.online,286945,ES22209500845884487347,6753.85,2024-05-12T11:56:31,Vitoria-Gasteiz,expenses,leisure,-80.81,4316.35
buyer_3,Ana,Etxebarria,1989-08-23,49614208B,ana.etxebarria@megaapp.online,286945,ES22209500845884487347,6753.85,2024-05-17T19:36:27,Vitoria-Gasteiz,expenses,food,-107.26,4209.09
buyer_3,Ana,Etxebarria,1989-08-23,49614208B,ana.etxebarria@megaapp.online,286945,ES22209500845884487347,6753.85,2024-05-17T18:53:18,Vitoria-Gasteiz,expenses,transport,-67.2,4141.89
buyer_3,Ana,Etxebarria,1989-08-23,49614208B,ana.etxebarria@megaapp.online,286945,ES22209500845884487347,6753.85,2024-05-17T13:38:47,Vitoria-Gasteiz,expenses,repairs,-77.21,4064.68
buyer_3,Ana,Etxebarria,1989-08-23,49614208B,ana.etxebarria@megaapp.online,286945,ES22209500845884487347,6753.85,2024-05-20T23:03:04,Vitoria-Gasteiz,expenses,food,-74.19,3990.49
buyer_3,Ana,Etxebarria,1989-08-23,49614208B,ana.etxebarria@megaapp.online,286945,ES22209500845884487347,6753.85,2024-05-20T17:00:08,Vitoria-Gasteiz,expenses,leisure,-67.01,3923.48
buyer_3,Ana,Etxebarria,1989-08-23,49614208B,ana.etxebarria@megaapp.online,286945,ES22209500845884487347,6753.85,2024-05-21T20:01:15,Vitoria-Gasteiz,expenses,food,-100.87,3822.61
buyer_3,Ana,Etxebarria,1989-08-23,49614208B,ana.etxebarria@megaapp.online,286945,ES22209500845884487347,6753.85,2024-05-22T23:51:35,Vitoria-Gasteiz,expenses,transport,-58.82,3763.79
buyer_3,Ana,Etxebarria,1989-08-23,49614208B,ana.etxebarria@megaapp.online,286945,ES22209500845884487347,6753.85,2024-05-22T03:44:30,Vitoria-Gasteiz,expenses,clothing,-157.33,3606.46
buyer_3,Ana,Etxebarria,1989-08-23,49614208B,ana.etxebarria@megaapp.online,286945,ES22209500845884487347,6753.85,2024-05-25T09:11:01,Vitoria-Gasteiz,expenses,leisure,-76.24,3530.22
buyer_3,Ana,Etxebarria,1989-08-23,49614208B,ana.etxebarria@megaapp.online,286945,ES22209500845884487347,6753.85,2024-05-26T16:49:56,Vitoria-Gasteiz,expenses,healthcare,-95.38,3434.84
buyer_3,Ana,Etxebarria,1989-08-23,49614208B,ana.etxebarria@megaapp.online,286945,ES22209500845884487347,6753.85,2024-05-27T17:03:18,Vitoria-Gasteiz,expenses,education,-53.4,3381.44
buyer_3,Ana,Etxebarria,1989-08-23,49614208B,ana.etxebarria@megaapp.online,286945,ES22209500845884487347,6753.85,2024-05-28T19:29:13,Vitoria-Gasteiz,expenses,leisure,-39.48,3341.96
buyer_3,Ana,Etxebarria,1989-08-23,49614208B,ana.etxebarria@megaapp.online,286945,ES22209500845884487347,6753.85,2024-05-28T23:00:07,Vitoria-Gasteiz,expenses,repairs,-63.29,3278.67
buyer_3,Ana,Etxebarria,1989-08-23,49614208B,ana.etxebarria@megaapp.online,286945,ES22209500845884487347,6753.85,2024-05-29T06:37:14,Vitoria-Gasteiz,expenses,food,-63.2,3215.47
buyer_3,Ana,Etxebarria,1989-08-23,49614208B,ana.etxebarria@megaapp.online,286945,ES22209500845884487347,6753.85,2024-05-29T09:36:23,Vitoria-Gasteiz,expenses,leisure,-74.35,3141.12
buyer_3,Ana,Etxebarria,1989-08-23,49614208B,ana.etxebarria@megaapp.online,286945,ES22209500845884487347,6753.85,2024-05-29T19:42:29,Vitoria-Gasteiz,expenses,gifts,-739.43,2401.69
buyer_3,Ana,Etxebarria,1989-08-23,49614208B,ana.etxebarria@megaapp.online,286945,ES22209500845884487347,6753.85,2024-05-30T02:27:24,Vitoria-Gasteiz,expenses,food,-81.76,2319.93
buyer_3,Ana,Etxebarria,1989-08-23,49614208B,ana.etxebarria@megaapp.online,286945,ES22209500845884487347,6753.85,2024-05-30T11:30:20,Vitoria-Gasteiz,expenses,cash,-100.0,2219.93
buyer_3,Ana,Etxebarria,1989-08-23,49614208B,ana.etxebarria@megaapp.online,286945,ES22209500845884487347,6753.85,2024-05-31T11:39:52,Vitoria-Gasteiz,expenses,travel,-1105.7,1114.23
buyer_3,Ana,Etxebarria,1989-08-23,49614208B,ana.etxebarria@megaapp.online,286945,ES22209500845884487347,6753.85,2024-06-01T17:23:27,Vitoria-Gasteiz,incomes,salary,3332.08,4446.31
buyer_3,Ana,Etxebarria,1989-08-23,49614208B,ana.etxebarria@megaapp.online,286945,ES22209500845884487347,6753.85,2024-06-01T17:23:27,Vitoria-Gasteiz,incomes,salary_partner,3993.88,8440.19
buyer_3,Ana,Etxebarria,1989-08-23,49614208B,ana.etxebarria@megaapp.online,286945,ES22209500845884487347,6753.85,2024-06-01T17:23:27,Vitoria-Gasteiz,incomes,salary_bonus,2424.33,10864.52
buyer_3,Ana,Etxebarria,1989-08-23,49614208B,ana.etxebarria@megaapp.online,286945,ES22209500845884487347,6753.85,2024-06-01T17:23:27,Vitoria-Gasteiz,incomes,salary_partner_bonus,3006.26,13870.78
buyer_3,Ana,Etxebarria,1989-08-23,49614208B,ana.etxebarria@megaapp.online,286945,ES22209500845884487347,6753.85,2024-06-02T18:53:46,Vitoria-Gasteiz,expenses,taxes,-5816.44,8054.34
buyer_3,Ana,Etxebarria,1989-08-23,49614208B,ana.etxebarria@megaapp.online,286945,ES22209500845884487347,6753.85,2024-06-02T14:03:06,Vitoria-Gasteiz,expenses,insurance,-1929.73,6124.61
buyer_3,Ana,Etxebarria,1989-08-23,49614208B,ana.etxebarria@megaapp.online,286945,ES22209500845884487347,6753.85,2024-06-02T19:11:05,Vitoria-Gasteiz,expenses,leisure,-65.22,6059.39
buyer_3,Ana,Etxebarria,1989-08-23,49614208B,ana.etxebarria@megaapp.online,286945,ES22209500845884487347,6753.85,2024-06-02T23:45:33,Vitoria-Gasteiz,expenses,healthcare,-176.48,5882.91
buyer_3,Ana,Etxebarria,1989-08-23,49614208B,ana.etxebarria@megaapp.online,286945,ES22209500845884487347,6753.85,2024-06-03T05:09:13,Vitoria-Gasteiz,expenses,transport,-50.63,5832.28
buyer_3,Ana,Etxebarria,1989-08-23,49614208B,ana.etxebarria@megaapp.online,286945,ES22209500845884487347,6753.85,2024-06-05T20:16:40,Vitoria-Gasteiz,expenses,mortgage,-3467.84,2364.44
buyer_3,Ana,Etxebarria,1989-08-23,49614208B,ana.etxebarria@megaapp.online,286945,ES22209500845884487347,6753.85,2024-06-05T18:52:03,Vitoria-Gasteiz,expenses,clothing,-122.82,2241.62
buyer_3,Ana,Etxebarria,1989-08-23,49614208B,ana.etxebarria@megaapp.online,286945,ES22209500845884487347,6753.85,2024-06-05T12:41:47,Vitoria-Gasteiz,expenses,cash,-100.0,2141.62
buyer_3,Ana,Etxebarria,1989-08-23,49614208B,ana.etxebarria@megaapp.online,286945,ES22209500845884487347,6753.85,2024-06-06T01:40:30,Vitoria-Gasteiz,expenses,water,-76.59,2065.03
buyer_3,Ana,Etxebarria,1989-08-23,49614208B,ana.etxebarria@megaapp.online,286945,ES22209500845884487347,6753.85,2024-06-06T16:36:43,Vitoria-Gasteiz,expenses,transport,-55.43,2009.6
buyer_3,Ana,Etxebarria,1989-08-23,49614208B,ana.etxebarria@megaapp.online,286945,ES22209500845884487347,6753.85,2024-06-07T12:13:21,Vitoria-Gasteiz,expenses,cash,-100.0,1909.6
buyer_3,Ana,Etxebarria,1989-08-23,49614208B,ana.etxebarria@megaapp.online,286945,ES22209500845884487347,6753.85,2024-06-08T08:38:31,Vitoria-Gasteiz,expenses,cash,-100.0,1809.6
buyer_3,Ana,Etxebarria,1989-08-23,49614208B,ana.etxebarria@megaapp.online,286945,ES22209500845884487347,6753.85,2024-06-09T18:19:36,Vitoria-Gasteiz,expenses,transport,-40.56,1769.04
buyer_3,Ana,Etxebarria,1989-08-23,49614208B,ana.etxebarria@megaapp.online,286945,ES22209500845884487347,6753.85,2024-06-10T20:02:51,Vitoria-Gasteiz,expenses,appliances,-127.08,1641.96
buyer_3,Ana,Etxebarria,1989-08-23,49614208B,ana.etxebarria@megaapp.online,286945,ES22209500845884487347,6753.85,2024-06-11T17:41:56,Vitoria-Gasteiz,expenses,cash,-100.0,1541.96
buyer_3,Ana,Etxebarria,1989-08-23,49614208B,ana.etxebarria@megaapp.online,286945,ES22209500845884487347,6753.85,2024-06-13T11:48:30,Vitoria-Gasteiz,expenses,gifts,-712.18,829.78
buyer_3,Ana,Etxebarria,1989-08-23,49614208B,ana.etxebarria@megaapp.online,286945,ES22209500845884487347,6753.85,2024-06-15T17:41:25,Vitoria-Gasteiz,expenses,transport,-41.06,788.72
buyer_3,Ana,Etxebarria,1989-08-23,49614208B,ana.etxebarria@megaapp.online,286945,ES22209500845884487347,6753.85,2024-06-17T20:15:52,Vitoria-Gasteiz,expenses,food,-104.09,684.63
buyer_3,Ana,Etxebarria,1989-08-23,49614208B,ana.etxebarria@megaapp.online,286945,ES22209500845884487347,6753.85,2024-06-18T12:04:48,Vitoria-Gasteiz,expenses,food,-115.76,568.87
buyer_3,Ana,Etxebarria,1989-08-23,49614208B,ana.etxebarria@megaapp.online,286945,ES22209500845884487347,6753.85,2024-06-20T16:50:23,Vitoria-Gasteiz,expenses,food,-84.95,483.92
buyer_3,Ana,Etxebarria,1989-08-23,49614208B,ana.etxebarria@megaapp.online,286945,ES22209500845884487347,6753.85,2024-06-20T08:41:39,Vitoria-Gasteiz,expenses,leisure,-55.15,428.77
buyer_3,Ana,Etxebarria,1989-08-23,49614208B,ana.etxebarria@megaapp.online,286945,ES22209500845884487347,6753.85,2024-06-21T19:48:47,Vitoria-Gasteiz,expenses,education,-77.46,351.31
buyer_3,Ana,Etxebarria,1989-08-23,49614208B,ana.etxebarria@megaapp.online,286945,ES22209500845884487347,6753.85,2024-06-22T11:48:26,Vitoria-Gasteiz,expenses,food,-120.9,230.41
buyer_3,Ana,Etxebarria,1989-08-23,49614208B,ana.etxebarria@megaapp.online,286945,ES22209500845884487347,6753.85,2024-06-23T09:19:04,Vitoria-Gasteiz,expenses,education,-57.06,173.35
buyer_3,Ana,Etxebarria,1989-08-23,49614208B,ana.etxebarria@megaapp.online,286945,ES22209500845884487347,6753.85,2024-06-24T14:23:21,Vitoria-Gasteiz,expenses,food,-106.58,66.77
buyer_3,Ana,Etxebarria,1989-08-23,49614208B,ana.etxebarria@megaapp.online,286945,ES22209500845884487347,6753.85,2024-06-27T20:31:04,Vitoria-Gasteiz,expenses,food,-95.81,-29.04
buyer_3,Ana,Etxebarria,1989-08-23,49614208B,ana.etxebarria@megaapp.online,286945,ES22209500845884487347,6753.85,2024-06-28T18:34:27,Vitoria-Gasteiz,expenses,education,-52.33,-81.37
buyer_3,Ana,Etxebarria,1989-08-23,49614208B,ana.etxebarria@megaapp.online,286945,ES22209500845884487347,6753.85,2024-06-30T09:34:31,Vitoria-Gasteiz,expenses,cash,-100.0,-181.37
buyer_3,Ana,Etxebarria,1989-08-23,49614208B,ana.etxebarria@megaapp.online,286945,ES22209500845884487347,6753.85,2024-07-01T17:02:40,Vitoria-Gasteiz,incomes,salary,3332.08,3150.71
buyer_3,Ana,Etxebarria,1989-08-23,49614208B,ana.etxebarria@megaapp.online,286945,ES22209500845884487347,6753.85,2024-07-01T17:02:40,Vitoria-Gasteiz,incomes,salary_partner,3993.88,7144.59
buyer_3,Ana,Etxebarria,1989-08-23,49614208B,ana.etxebarria@megaapp.online,286945,ES22209500845884487347,6753.85,2024-07-02T19:49:01,Vitoria-Gasteiz,expenses,food,-99.74,7044.85
buyer_3,Ana,Etxebarria,1989-08-23,49614208B,ana.etxebarria@megaapp.online,286945,ES22209500845884487347,6753.85,2024-07-03T10:14:21,Vitoria-Gasteiz,expenses,transport,-55.81,6989.04
buyer_3,Ana,Etxebarria,1989-08-23,49614208B,ana.etxebarria@megaapp.online,286945,ES22209500845884487347,6753.85,2024-07-03T19:41:45,Vitoria-Gasteiz,expenses,cash,-100.0,6889.04
buyer_3,Ana,Etxebarria,1989-08-23,49614208B,ana.etxebarria@megaapp.online,286945,ES22209500845884487347,6753.85,2024-07-05T05:06:46,Vitoria-Gasteiz,expenses,mortgage,-3467.84,3421.2
buyer_3,Ana,Etxebarria,1989-08-23,49614208B,ana.etxebarria@megaapp.online,286945,ES22209500845884487347,6753.85,2024-07-05T11:36:59,Vitoria-Gasteiz,expenses,electricity,-96.08,3325.12
buyer_3,Ana,Etxebarria,1989-08-23,49614208B,ana.etxebarria@megaapp.online,286945,ES22209500845884487347,6753.85,2024-07-05T23:41:57,Vitoria-Gasteiz,expenses,food,-71.46,3253.66
buyer_3,Ana,Etxebarria,1989-08-23,49614208B,ana.etxebarria@megaapp.online,286945,ES22209500845884487347,6753.85,2024-07-05T14:26:19,Vitoria-Gasteiz,expenses,leisure,-40.88,3212.78
buyer_3,Ana,Etxebarria,1989-08-23,49614208B,ana.etxebarria@megaapp.online,286945,ES22209500845884487347,6753.85,2024-07-06T14:52:12,Vitoria-Gasteiz,expenses,water,-83.21,3129.57
buyer_3,Ana,Etxebarria,1989-08-23,49614208B,ana.etxebarria@megaapp.online,286945,ES22209500845884487347,6753.85,2024-07-06T13:37:32,Vitoria-Gasteiz,expenses,phone,-131.59,2997.98
buyer_3,Ana,Etxebarria,1989-08-23,49614208B,ana.etxebarria@megaapp.online,286945,ES22209500845884487347,6753.85,2024-07-06T18:11:48,Vitoria-Gasteiz,expenses,transport,-41.31,2956.67
buyer_3,Ana,Etxebarria,1989-08-23,49614208B,ana.etxebarria@megaapp.online,286945,ES22209500845884487347,6753.85,2024-07-06T11:46:47,Vitoria-Gasteiz,expenses,gifts,-534.89,2421.78
buyer_3,Ana,Etxebarria,1989-08-23,49614208B,ana.etxebarria@megaapp.online,286945,ES22209500845884487347,6753.85,2024-07-07T03:39:39,Vitoria-Gasteiz,expenses,internet,-153.85,2267.93
buyer_3,Ana,Etxebarria,1989-08-23,49614208B,ana.etxebarria@megaapp.online,286945,ES22209500845884487347,6753.85,2024-07-07T16:45:26,Vitoria-Gasteiz,expenses,cash,-100.0,2167.93
buyer_3,Ana,Etxebarria,1989-08-23,49614208B,ana.etxebarria@megaapp.online,286945,ES22209500845884487347,6753.85,2024-07-08T09:01:21,Vitoria-Gasteiz,expenses,clothing,-64.14,2103.79
buyer_3,Ana,Etxebarria,1989-08-23,49614208B,ana.etxebarria@megaapp.online,286945,ES22209500845884487347,6753.85,2024-07-09T17:15:27,Vitoria-Gasteiz,expenses,food,-84.5,2019.29
buyer_3,Ana,Etxebarria,1989-08-23,49614208B,ana.etxebarria@megaapp.online,286945,ES22209500845884487347,6753.85,2024-07-10T13:07:43,Vitoria-Gasteiz,expenses,education,-75.3,1943.99
buyer_3,Ana,Etxebarria,1989-08-23,49614208B,ana.etxebarria@megaapp.online,286945,ES22209500845884487347,6753.85,2024-07-11T20:06:28,Vitoria-Gasteiz,expenses,transport,-40.18,1903.81
buyer_3,Ana,Etxebarria,1989-08-23,49614208B,ana.etxebarria@megaapp.online,286945,ES22209500845884487347,6753.85,2024-07-12T20:40:02,Vitoria-Gasteiz,expenses,gifts,-28.46,1875.35
buyer_3,Ana,Etxebarria,1989-08-23,49614208B,ana.etxebarria@megaapp.online,286945,ES22209500845884487347,6753.85,2024-07-14T15:22:07,Vitoria-Gasteiz,expenses,repairs,-318.26,1557.09
buyer_3,Ana,Etxebarria,1989-08-23,49614208B,ana.etxebarria@megaapp.online,286945,ES22209500845884487347,6753.85,2024-07-18T09:02:33,Vitoria-Gasteiz,expenses,transport,-45.18,1511.91
buyer_3,Ana,Etxebarria,1989-08-23,49614208B,ana.etxebarria@megaapp.online,286945,ES22209500845884487347,6753.85,2024-07-19T10:40:19,Vitoria-Gasteiz,expenses,repairs,-83.79,1428.12
buyer_3,Ana,Etxebarria,1989-08-23,49614208B,ana.etxebarria@megaapp.online,286945,ES22209500845884487347,6753.85,2024-07-20T20:14:29,Vitoria-Gasteiz,expenses,food,-93.16,1334.96
buyer_3,Ana,Etxebarria,1989-08-23,49614208B,ana.etxebarria@megaapp.online,286945,ES22209500845884487347,6753.85,2024-07-21T08:43:14,Vitoria-Gasteiz,expenses,clothing,-75.15,1259.81
buyer_3,Ana,Etxebarria,1989-08-23,49614208B,ana.etxebarria@megaapp.online,286945,ES22209500845884487347,6753.85,2024-07-22T16:18:43,Vitoria-Gasteiz,expenses,cash,-100.0,1159.81
buyer_3,Ana,Etxebarria,1989-08-23,49614208B,ana.etxebarria@megaapp.online,286945,ES22209500845884487347,6753.85,2024-07-23T20:34:17,Vitoria-Gasteiz,expenses,food,-118.31,1041.5
buyer_3,Ana,Etxebarria,1989-08-23,49614208B,ana.etxebarria@megaapp.online,286945,ES22209500845884487347,6753.85,2024-07-25T10:03:58,Vitoria-Gasteiz,expenses,cash,-100.0,941.5
buyer_3,Ana,Etxebarria,1989-08-23,49614208B,ana.etxebarria@megaapp.online,286945,ES22209500845884487347,6753.85,2024-07-26T13:30:07,Vitoria-Gasteiz,expenses,healthcare,-58.12,883.38
buyer_3,Ana,Etxebarria,1989-08-23,49614208B,ana.etxebarria@megaapp.online,286945,ES22209500845884487347,6753.85,2024-07-27T15:48:43,Vitoria-Gasteiz,expenses,cash,-100.0,783.38
buyer_3,Ana,Etxebarria,1989-08-23,49614208B,ana.etxebarria@megaapp.online,286945,ES22209500845884487347,6753.85,2024-07-28T14:53:24,Vitoria-Gasteiz,expenses,cash,-100.0,683.38
buyer_3,Ana,Etxebarria,1989-08-23,49614208B,ana.etxebarria@megaapp.online,286945,ES22209500845884487347,6753.85,2024-07-28T13:06:53,Vitoria-Gasteiz,expenses,car,-529.69,153.69
buyer_3,Ana,Etxebarria,1989-08-23,49614208B,ana.etxebarria@megaapp.online,286945,ES22209500845884487347,6753.85,2024-07-30T12:23:23,Vitoria-Gasteiz,expenses,cash,-100.0,53.69
buyer_3,Ana,Etxebarria,1989-08-23,49614208B,ana.etxebarria@megaapp.online,286945,ES22209500845884487347,6753.85,2024-07-31T19:09:03,Vitoria-Gasteiz,expenses,gifts,-353.8,-300.11
buyer_3,Ana,Etxebarria,1989-08-23,49614208B,ana.etxebarria@megaapp.online,286945,ES22209500845884487347,6753.85,2024-08-01T19:38:19,Vitoria-Gasteiz,incomes,salary,3332.08,3031.97
buyer_3,Ana,Etxebarria,1989-08-23,49614208B,ana.etxebarria@megaapp.online,286945,ES22209500845884487347,6753.85,2024-08-01T19:38:19,Vitoria-Gasteiz,incomes,salary_partner,3993.88,7025.85
buyer_3,Ana,Etxebarria,1989-08-23,49614208B,ana.etxebarria@megaapp.online,286945,ES22209500845884487347,6753.85,2024-08-01T19:38:19,Vitoria-Gasteiz,incomes,extra_income,412.38,7438.23
buyer_3,Ana,Etxebarria,1989-08-23,49614208B,ana.etxebarria@megaapp.online,286945,ES22209500845884487347,6753.85,2024-08-01T19:52:00,Vitoria-Gasteiz,expenses,education,-70.21,7368.02
buyer_3,Ana,Etxebarria,1989-08-23,49614208B,ana.etxebarria@megaapp.online,286945,ES22209500845884487347,6753.85,2024-08-01T14:30:33,Vitoria-Gasteiz,expenses,repairs,-161.49,7206.53
buyer_3,Ana,Etxebarria,1989-08-23,49614208B,ana.etxebarria@megaapp.online,286945,ES22209500845884487347,6753.85,2024-08-02T08:35:17,Vitoria-Gasteiz,expenses,food,-79.17,7127.36
buyer_3,Ana,Etxebarria,1989-08-23,49614208B,ana.etxebarria@megaapp.online,286945,ES22209500845884487347,6753.85,2024-08-03T14:34:49,Vitoria-Gasteiz,expenses,healthcare,-74.25,7053.11
buyer_3,Ana,Etxebarria,1989-08-23,49614208B,ana.etxebarria@megaapp.online,286945,ES22209500845884487347,6753.85,2024-08-04T19:36:12,Vitoria-Gasteiz,expenses,food,-119.62,6933.49
buyer_3,Ana,Etxebarria,1989-08-23,49614208B,ana.etxebarria@megaapp.online,286945,ES22209500845884487347,6753.85,2024-08-04T10:58:54,Vitoria-Gasteiz,expenses,cash,-100.0,6833.49
buyer_3,Ana,Etxebarria,1989-08-23,49614208B,ana.etxebarria@megaapp.online,286945,ES22209500845884487347,6753.85,2024-08-04T14:33:24,Vitoria-Gasteiz,expenses,repairs,-68.36,6765.13
buyer_3,Ana,Etxebarria,1989-08-23,49614208B,ana.etxebarria@megaapp.online,286945,ES22209500845884487347,6753.85,2024-08-05T17:55:43,Vitoria-Gasteiz,expenses,mortgage,-3467.84,3297.29
buyer_3,Ana,Etxebarria,1989-08-23,49614208B,ana.etxebarria@megaapp.online,286945,ES22209500845884487347,6753.85,2024-08-05T14:08:58,Vitoria-Gasteiz,expenses,water,-123.91,3173.38
buyer_3,Ana,Etxebarria,1989-08-23,49614208B,ana.etxebarria@megaapp.online,286945,ES22209500845884487347,6753.85,2024-08-05T14:10:25,Vitoria-Gasteiz,expenses,electricity,-320.3,2853.08
buyer_3,Ana,Etxebarria,1989-08-23,49614208B,ana.etxebarria@megaapp.online,286945,ES22209500845884487347,6753.85,2024-08-05T16:33:50,Vitoria-Gasteiz,expenses,leisure,-74.85,2778.23
buyer_3,Ana,Etxebarria,1989-08-23,49614208B,ana.etxebarria@megaapp.online,286945,ES22209500845884487347,6753.85,2024-08-05T21:34:53,Vitoria-Gasteiz,expenses,cash,-100.0,2678.23
buyer_3,Ana,Etxebarria,1989-08-23,49614208B,ana.etxebarria@megaapp.online,286945,ES22209500845884487347,6753.85,2024-08-06T15:44:35,Vitoria-Gasteiz,expenses,electricity,-102.25,2575.98
buyer_3,Ana,Etxebarria,1989-08-23,49614208B,ana.etxebarria@megaapp.online,286945,ES22209500845884487347,6753.85,2024-08-06T14:47:11,Vitoria-Gasteiz,expenses,internet,-153.85,2422.13
buyer_3,Ana,Etxebarria,1989-08-23,49614208B,ana.etxebarria@megaapp.online,286945,ES22209500845884487347,6753.85,2024-08-07T08:05:32,Vitoria-Gasteiz,expenses,gas,-196.24,2225.89
buyer_3,Ana,Etxebarria,1989-08-23,49614208B,ana.etxebarria@megaapp.online,286945,ES22209500845884487347,6753.85,2024-08-07T20:31:25,Vitoria-Gasteiz,expenses,leisure,-79.35,2146.54
buyer_3,Ana,Etxebarria,1989-08-23,49614208B,ana.etxebarria@megaapp.online,286945,ES22209500845884487347,6753.85,2024-08-08T09:50:17,Vitoria-Gasteiz,expenses,water,-143.5,2003.04
buyer_3,Ana,Etxebarria,1989-08-23,49614208B,ana.etxebarria@megaapp.online,286945,ES22209500845884487347,6753.85,2024-08-08T19:57:38,Vitoria-Gasteiz,expenses,gas,-177.72,1825.32
buyer_3,Ana,Etxebarria,1989-08-23,49614208B,ana.etxebarria@megaapp.online,286945,ES22209500845884487347,6753.85,2024-08-08T12:51:17,Vitoria-Gasteiz,expenses,internet,-153.85,1671.47
buyer_3,Ana,Etxebarria,1989-08-23,49614208B,ana.etxebarria@megaapp.online,286945,ES22209500845884487347,6753.85,2024-08-08T10:18:17,Vitoria-Gasteiz,expenses,food,-66.35,1605.12
buyer_3,Ana,Etxebarria,1989-08-23,49614208B,ana.etxebarria@megaapp.online,286945,ES22209500845884487347,6753.85,2024-08-09T17:59:43,Vitoria-Gasteiz,expenses,transport,-60.63,1544.49
buyer_3,Ana,Etxebarria,1989-08-23,49614208B,ana.etxebarria@megaapp.online,286945,ES22209500845884487347,6753.85,2024-08-12T13:33:31,Vitoria-Gasteiz,expenses,food,-60.79,1483.7
buyer_3,Ana,Etxebarria,1989-08-23,49614208B,ana.etxebarria@megaapp.online,286945,ES22209500845884487347,6753.85,2024-08-13T19:03:59,Vitoria-Gasteiz,expenses,leisure,-58.66,1425.04
buyer_3,Ana,Etxebarria,1989-08-23,49614208B,ana.etxebarria@megaapp.online,286945,ES22209500845884487347,6753.85,2024-08-13T05:10:48,Vitoria-Gasteiz,expenses,cash,-100.0,1325.04
buyer_3,Ana,Etxebarria,1989-08-23,49614208B,ana.etxebarria@megaapp.online,286945,ES22209500845884487347,6753.85,2024-08-14T02:15:22,Vitoria-Gasteiz,expenses,food,-114.84,1210.2
buyer_3,Ana,Etxebarria,1989-08-23,49614208B,ana.etxebarria@megaapp.online,286945,ES22209500845884487347,6753.85,2024-08-14T16:17:12,Vitoria-Gasteiz,expenses,leisure,-78.23,1131.97
buyer_3,Ana,Etxebarria,1989-08-23,49614208B,ana.etxebarria@megaapp.online,286945,ES22209500845884487347,6753.85,2024-08-15T15:21:50,Vitoria-Gasteiz,expenses,clothing,-58.42,1073.55
buyer_3,Ana,Etxebarria,1989-08-23,49614208B,ana.etxebarria@megaapp.online,286945,ES22209500845884487347,6753.85,2024-08-17T13:30:37,Vitoria-Gasteiz,expenses,cash,-100.0,973.55
buyer_3,Ana,Etxebarria,1989-08-23,49614208B,ana.etxebarria@megaapp.online,286945,ES22209500845884487347,6753.85,2024-08-19T16:52:42,Vitoria-Gasteiz,expenses,cash,-100.0,873.55
buyer_3,Ana,Etxebarria,1989-08-23,49614208B,ana.etxebarria@megaapp.online,286945,ES22209500845884487347,6753.85,2024-08-20T17:27:52,Vitoria-Gasteiz,expenses,leisure,-48.57,824.98
buyer_3,Ana,Etxebarria,1989-08-23,49614208B,ana.etxebarria@megaapp.online,286945,ES22209500845884487347,6753.85,2024-08-20T14:36:09,Vitoria-Gasteiz,expenses,repairs,-212.33,612.65
buyer_3,Ana,Etxebarria,1989-08-23,49614208B,ana.etxebarria@megaapp.online,286945,ES22209500845884487347,6753.85,2024-08-21T12:08:19,Vitoria-Gasteiz,expenses,cash,-100.0,512.65
buyer_3,Ana,Etxebarria,1989-08-23,49614208B,ana.etxebarria@megaapp.online,286945,ES22209500845884487347,6753.85,2024-08-22T18:41:56,Vitoria-Gasteiz,expenses,cash,-100.0,412.65
buyer_3,Ana,Etxebarria,1989-08-23,49614208B,ana.etxebarria@megaapp.online,286945,ES22209500845884487347,6753.85,2024-08-26T20:05:06,Vitoria-Gasteiz,expenses,gifts,-528.15,-115.5
buyer_3,Ana,Etxebarria,1989-08-23,49614208B,ana.etxebarria@megaapp.online,286945,ES22209500845884487347,6753.85,2024-08-28T12:20:55,Vitoria-Gasteiz,expenses,cash,-100.0,-215.5
buyer_3,Ana,Etxebarria,1989-08-23,49614208B,ana.etxebarria@megaapp.online,286945,ES22209500845884487347,6753.85,2024-08-30T11:58:43,Vitoria-Gasteiz,expenses,food,-105.73,-321.23
buyer_3,Ana,Etxebarria,1989-08-23,49614208B,ana.etxebarria@megaapp.online,286945,ES22209500845884487347,6753.85,2024-09-01T12:37:12,Vitoria-Gasteiz,incomes,salary,3332.08,3010.85
buyer_3,Ana,Etxebarria,1989-08-23,49614208B,ana.etxebarria@megaapp.online,286945,ES22209500845884487347,6753.85,2024-09-01T12:37:12,Vitoria-Gasteiz,incomes,salary_partner,3993.88,7004.73
buyer_3,Ana,Etxebarria,1989-08-23,49614208B,ana.etxebarria@megaapp.online,286945,ES22209500845884487347,6753.85,2024-09-03T01:30:59,Vitoria-Gasteiz,expenses,leisure,-51.85,6952.88
buyer_3,Ana,Etxebarria,1989-08-23,49614208B,ana.etxebarria@megaapp.online,286945,ES22209500845884487347,6753.85,2024-09-05T20:59:16,Vitoria-Gasteiz,expenses,mortgage,-3467.84,3485.04
buyer_3,Ana,Etxebarria,1989-08-23,49614208B,ana.etxebarria@megaapp.online,286945,ES22209500845884487347,6753.85,2024-09-05T10:28:30,Vitoria-Gasteiz,expenses,water,-153.12,3331.92
buyer_3,Ana,Etxebarria,1989-08-23,49614208B,ana.etxebarria@megaapp.online,286945,ES22209500845884487347,6753.85,2024-09-05T16:29:52,Vitoria-Gasteiz,expenses,internet,-153.85,3178.07
buyer_3,Ana,Etxebarria,1989-08-23,49614208B,ana.etxebarria@megaapp.online,286945,ES22209500845884487347,6753.85,2024-09-05T20:43:59,Vitoria-Gasteiz,expenses,phone,-116.27,3061.8
buyer_3,Ana,Etxebarria,1989-08-23,49614208B,ana.etxebarria@megaapp.online,286945,ES22209500845884487347,6753.85,2024-09-06T17:35:31,Vitoria-Gasteiz,expenses,water,-106.49,2955.31
buyer_3,Ana,Etxebarria,1989-08-23,49614208B,ana.etxebarria@megaapp.online,286945,ES22209500845884487347,6753.85,2024-09-06T20:39:09,Vitoria-Gasteiz,expenses,internet,-153.85,2801.46
buyer_3,Ana,Etxebarria,1989-08-23,49614208B,ana.etxebarria@megaapp.online,286945,ES22209500845884487347,6753.85,2024-09-07T20:46:46,Vitoria-Gasteiz,expenses,cash,-100.0,2701.46
buyer_3,Ana,Etxebarria,1989-08-23,49614208B,ana.etxebarria@megaapp.online,286945,ES22209500845884487347,6753.85,2024-09-08T20:03:46,Vitoria-Gasteiz,expenses,phone,-110.73,2590.73
buyer_3,Ana,Etxebarria,1989-08-23,49614208B,ana.etxebarria@megaapp.online,286945,ES22209500845884487347,6753.85,2024-09-08T10:28:45,Vitoria-Gasteiz,expenses,cash,-100.0,2490.73
buyer_3,Ana,Etxebarria,1989-08-23,49614208B,ana.etxebarria@megaapp.online,286945,ES22209500845884487347,6753.85,2024-09-09T16:49:38,Vitoria-Gasteiz,expenses,cash,-100.0,2390.73
buyer_3,Ana,Etxebarria,1989-08-23,49614208B,ana.etxebarria@megaapp.online,286945,ES22209500845884487347,6753.85,2024-09-10T15:47:13,Vitoria-Gasteiz,expenses,food,-101.32,2289.41
buyer_3,Ana,Etxebarria,1989-08-23,49614208B,ana.etxebarria@megaapp.online,286945,ES22209500845884487347,6753.85,2024-09-10T10:52:21,Vitoria-Gasteiz,expenses,leisure,-71.34,2218.07
buyer_3,Ana,Etxebarria,1989-08-23,49614208B,ana.etxebarria@megaapp.online,286945,ES22209500845884487347,6753.85,2024-09-11T17:27:09,Vitoria-Gasteiz,expenses,clothing,-132.76,2085.31
buyer_3,Ana,Etxebarria,1989-08-23,49614208B,ana.etxebarria@megaapp.online,286945,ES22209500845884487347,6753.85,2024-09-12T12:53:39,Vitoria-Gasteiz,expenses,leisure,-67.54,2017.77
buyer_3,Ana,Etxebarria,1989-08-23,49614208B,ana.etxebarria@megaapp.online,286945,ES22209500845884487347,6753.85,2024-09-13T17:52:46,Vitoria-Gasteiz,expenses,transport,-77.05,1940.72
buyer_3,Ana,Etxebarria,1989-08-23,49614208B,ana.etxebarria@megaapp.online,286945,ES22209500845884487347,6753.85,2024-09-13T14:22:33,Vitoria-Gasteiz,expenses,repairs,-286.64,1654.08
buyer_3,Ana,Etxebarria,1989-08-23,49614208B,ana.etxebarria@megaapp.online,286945,ES22209500845884487347,6753.85,2024-09-14T20:26:52,Vitoria-Gasteiz,expenses,education,-67.42,1586.66
buyer_3,Ana,Etxebarria,1989-08-23,49614208B,ana.etxebarria@megaapp.online,286945,ES22209500845884487347,6753.85,2024-09-15T23:18:01,Vitoria-Gasteiz,expenses,cash,-100.0,1486.66
buyer_3,Ana,Etxebarria,1989-08-23,49614208B,ana.etxebarria@megaapp.online,286945,ES22209500845884487347,6753.85,2024-09-16T19:40:50,Vitoria-Gasteiz,expenses,clothing,-119.88,1366.78
buyer_3,Ana,Etxebarria,1989-08-23,49614208B,ana.etxebarria@megaapp.online,286945,ES22209500845884487347,6753.85,2024-09-17T10:59:42,Vitoria-Gasteiz,expenses,leisure,-39.73,1327.05
buyer_3,Ana,Etxebarria,1989-08-23,49614208B,ana.etxebarria@megaapp.online,286945,ES22209500845884487347,6753.85,2024-09-18T18:21:52,Vitoria-Gasteiz,expenses,repairs,-181.67,1145.38
buyer_3,Ana,Etxebarria,1989-08-23,49614208B,ana.etxebarria@megaapp.online,286945,ES22209500845884487347,6753.85,2024-09-19T21:44:23,Vitoria-Gasteiz,expenses,cash,-100.0,1045.38
buyer_3,Ana,Etxebarria,1989-08-23,49614208B,ana.etxebarria@megaapp.online,286945,ES22209500845884487347,6753.85,2024-09-20T20:47:32,Vitoria-Gasteiz,expenses,leisure,-25.29,1020.09
buyer_3,Ana,Etxebarria,1989-08-23,49614208B,ana.etxebarria@megaapp.online,286945,ES22209500845884487347,6753.85,2024-09-21T08:16:01,Vitoria-Gasteiz,expenses,cash,-100.0,920.09
buyer_3,Ana,Etxebarria,1989-08-23,49614208B,ana.etxebarria@megaapp.online,286945,ES22209500845884487347,6753.85,2024-09-23T13:22:52,Vitoria-Gasteiz,expenses,education,-58.1,861.99
buyer_3,Ana,Etxebarria,1989-08-23,49614208B,ana.etxebarria@megaapp.online,286945,ES22209500845884487347,6753.85,2024-09-25T10:20:23,Vitoria-Gasteiz,expenses,repairs,-68.26,793.73
buyer_3,Ana,Etxebarria,1989-08-23,49614208B,ana.etxebarria@megaapp.online,286945,ES22209500845884487347,6753.85,2024-09-25T08:47:43,Vitoria-Gasteiz,expenses,gifts,-558.94,234.79
buyer_3,Ana,Etxebarria,1989-08-23,49614208B,ana.etxebarria@megaapp.online,286945,ES22209500845884487347,6753.85,2024-09-27T17:46:38,Vitoria-Gasteiz,expenses,food,-80.5,154.29
buyer_3,Ana,Etxebarria,1989-08-23,49614208B,ana.etxebarria@megaapp.online,286945,ES22209500845884487347,6753.85,2024-09-28T09:53:45,Vitoria-Gasteiz,expenses,education,-48.64,105.65
buyer_3,Ana,Etxebarria,1989-08-23,49614208B,ana.etxebarria@megaapp.online,286945,ES22209500845884487347,6753.85,2024-09-29T17:14:18,Vitoria-Gasteiz,expenses,clothing,-74.14,31.51
buyer_3,Ana,Etxebarria,1989-08-23,49614208B,ana.etxebarria@megaapp.online,286945,ES22209500845884487347,6753.85,2024-09-29T17:35:04,Vitoria-Gasteiz,expenses,gifts,-479.47,-447.96
buyer_3,Ana,Etxebarria,1989-08-23,49614208B,ana.etxebarria@megaapp.online,286945,ES22209500845884487347,6753.85,2024-09-30T11:56:19,Vitoria-Gasteiz,expenses,transport,-49.34,-497.3
buyer_3,Ana,Etxebarria,1989-08-23,49614208B,ana.etxebarria@megaapp.online,286945,ES22209500845884487347,6753.85,2024-10-01T22:06:25,Vitoria-Gasteiz,incomes,salary,3332.08,2834.78
buyer_3,Ana,Etxebarria,1989-08-23,49614208B,ana.etxebarria@megaapp.online,286945,ES22209500845884487347,6753.85,2024-10-01T22:06:25,Vitoria-Gasteiz,incomes,salary_partner,3993.88,6828.66
buyer_3,Ana,Etxebarria,1989-08-23,49614208B,ana.etxebarria@megaapp.online,286945,ES22209500845884487347,6753.85,2024-10-02T19:44:57,Vitoria-Gasteiz,expenses,leisure,-28.08,6800.58
buyer_3,Ana,Etxebarria,1989-08-23,49614208B,ana.etxebarria@megaapp.online,286945,ES22209500845884487347,6753.85,2024-10-05T15:03:54,Vitoria-Gasteiz,expenses,mortgage,-3467.84,3332.74
buyer_3,Ana,Etxebarria,1989-08-23,49614208B,ana.etxebarria@megaapp.online,286945,ES22209500845884487347,6753.85,2024-10-05T11:55:24,Vitoria-Gasteiz,expenses,education,-65.69,3267.05
buyer_3,Ana,Etxebarria,1989-08-23,49614208B,ana.etxebarria@megaapp.online,286945,ES22209500845884487347,6753.85,2024-10-05T11:47:23,Vitoria-Gasteiz,expenses,cash,-100.0,3167.05
buyer_3,Ana,Etxebarria,1989-08-23,49614208B,ana.etxebarria@megaapp.online,286945,ES22209500845884487347,6753.85,2024-10-06T17:05:32,Vitoria-Gasteiz,expenses,food,-70.07,3096.98
buyer_3,Ana,Etxebarria,1989-08-23,49614208B,ana.etxebarria@megaapp.online,286945,ES22209500845884487347,6753.85,2024-10-07T20:52:05,Vitoria-Gasteiz,expenses,phone,-129.02,2967.96
buyer_3,Ana,Etxebarria,1989-08-23,49614208B,ana.etxebarria@megaapp.online,286945,ES22209500845884487347,6753.85,2024-10-07T17:44:35,Vitoria-Gasteiz,expenses,repairs,-140.13,2827.83
buyer_3,Ana,Etxebarria,1989-08-23,49614208B,ana.etxebarria@megaapp.online,286945,ES22209500845884487347,6753.85,2024-10-08T22:49:37,Vitoria-Gasteiz,expenses,gas,-245.7,2582.13
buyer_3,Ana,Etxebarria,1989-08-23,49614208B,ana.etxebarria@megaapp.online,286945,ES22209500845884487347,6753.85,2024-10-10T11:50:08,Vitoria-Gasteiz,expenses,repairs,-155.03,2427.1
buyer_4,Marc,Andreu,1974-05-23,54922038Q,marc.andreu@brilliantapp.app,964991,ES19209587111785551517,5949.75,2022-01-01T15:41:35,Barcelona,incomes,salary,2832.82,8782.57
buyer_4,Marc,Andreu,1974-05-23,54922038Q,marc.andreu@brilliantapp.app,964991,ES19209587111785551517,5949.75,2022-01-01T11:39:44,Barcelona,expenses,transport,-74.27,8708.3
buyer_4,Marc,Andreu,1974-05-23,54922038Q,marc.andreu@brilliantapp.app,964991,ES19209587111785551517,5949.75,2022-01-02T12:30:12,Barcelona,expenses,repairs,-286.01,8422.29
buyer_4,Marc,Andreu,1974-05-23,54922038Q,marc.andreu@brilliantapp.app,964991,ES19209587111785551517,5949.75,2022-01-05T18:03:48,Barcelona,expenses,mortgage,-1458.7,6963.59
buyer_4,Marc,Andreu,1974-05-23,54922038Q,marc.andreu@brilliantapp.app,964991,ES19209587111785551517,5949.75,2022-01-05T08:49:05,Barcelona,expenses,water,-55.03,6908.56
buyer_4,Marc,Andreu,1974-05-23,54922038Q,marc.andreu@brilliantapp.app,964991,ES19209587111785551517,5949.75,2022-01-05T15:17:50,Barcelona,expenses,gas,-61.8,6846.76
buyer_4,Marc,Andreu,1974-05-23,54922038Q,marc.andreu@brilliantapp.app,964991,ES19209587111785551517,5949.75,2022-01-05T11:24:41,Barcelona,expenses,phone,-63.19,6783.57
buyer_4,Marc,Andreu,1974-05-23,54922038Q,marc.andreu@brilliantapp.app,964991,ES19209587111785551517,5949.75,2022-01-06T19:04:31,Barcelona,expenses,water,-38.08,6745.49
buyer_4,Marc,Andreu,1974-05-23,54922038Q,marc.andreu@brilliantapp.app,964991,ES19209587111785551517,5949.75,2022-01-06T00:51:31,Barcelona,expenses,children,-843.788,5901.7
buyer_4,Marc,Andreu,1974-05-23,54922038Q,marc.andreu@brilliantapp.app,964991,ES19209587111785551517,5949.75,2022-01-07T00:03:34,Barcelona,expenses,water,-49.0,5852.7
buyer_4,Marc,Andreu,1974-05-23,54922038Q,marc.andreu@brilliantapp.app,964991,ES19209587111785551517,5949.75,2022-01-07T16:32:03,Barcelona,expenses,internet,-59.49,5793.21
buyer_4,Marc,Andreu,1974-05-23,54922038Q,marc.andreu@brilliantapp.app,964991,ES19209587111785551517,5949.75,2022-01-08T18:40:31,Barcelona,expenses,leisure,-18.42,5774.79
buyer_4,Marc,Andreu,1974-05-23,54922038Q,marc.andreu@brilliantapp.app,964991,ES19209587111785551517,5949.75,2022-01-12T12:03:48,Barcelona,expenses,education,-43.0,5731.79
buyer_4,Marc,Andreu,1974-05-23,54922038Q,marc.andreu@brilliantapp.app,964991,ES19209587111785551517,5949.75,2022-01-13T15:20:04,Barcelona,expenses,transport,-69.88,5661.91
buyer_4,Marc,Andreu,1974-05-23,54922038Q,marc.andreu@brilliantapp.app,964991,ES19209587111785551517,5949.75,2022-01-13T17:25:04,Barcelona,expenses,cash,-100.0,5561.91
buyer_4,Marc,Andreu,1974-05-23,54922038Q,marc.andreu@brilliantapp.app,964991,ES19209587111785551517,5949.75,2022-01-13T14:19:08,Barcelona,expenses,children,-673.908,4888.0
buyer_4,Marc,Andreu,1974-05-23,54922038Q,marc.andreu@brilliantapp.app,964991,ES19209587111785551517,5949.75,2022-01-15T20:24:19,Barcelona,expenses,repairs,-32.96,4855.04
buyer_4,Marc,Andreu,1974-05-23,54922038Q,marc.andreu@brilliantapp.app,964991,ES19209587111785551517,5949.75,2022-01-16T12:49:08,Barcelona,expenses,clothing,-110.74,4744.3
buyer_4,Marc,Andreu,1974-05-23,54922038Q,marc.andreu@brilliantapp.app,964991,ES19209587111785551517,5949.75,2022-01-16T18:39:38,Barcelona,expenses,gifts,-523.58,4220.72
buyer_4,Marc,Andreu,1974-05-23,54922038Q,marc.andreu@brilliantapp.app,964991,ES19209587111785551517,5949.75,2022-01-17T19:30:21,Barcelona,expenses,food,-68.97,4151.75
buyer_4,Marc,Andreu,1974-05-23,54922038Q,marc.andreu@brilliantapp.app,964991,ES19209587111785551517,5949.75,2022-01-17T22:35:36,Barcelona,expenses,healthcare,-168.33,3983.42
buyer_4,Marc,Andreu,1974-05-23,54922038Q,marc.andreu@brilliantapp.app,964991,ES19209587111785551517,5949.75,2022-01-17T18:00:08,Barcelona,expenses,cash,-100.0,3883.42
buyer_4,Marc,Andreu,1974-05-23,54922038Q,marc.andreu@brilliantapp.app,964991,ES19209587111785551517,5949.75,2022-01-18T20:47:41,Barcelona,expenses,transport,-77.33,3806.09
buyer_4,Marc,Andreu,1974-05-23,54922038Q,marc.andreu@brilliantapp.app,964991,ES19209587111785551517,5949.75,2022-01-23T21:17:27,Barcelona,expenses,children,-521.18,3284.91
buyer_4,Marc,Andreu,1974-05-23,54922038Q,marc.andreu@brilliantapp.app,964991,ES19209587111785551517,5949.75,2022-01-24T17:22:42,Barcelona,expenses,leisure,-73.02,3211.89
buyer_4,Marc,Andreu,1974-05-23,54922038Q,marc.andreu@brilliantapp.app,964991,ES19209587111785551517,5949.75,2022-01-27T18:29:52,Barcelona,expenses,travel,-501.22,2710.67
buyer_4,Marc,Andreu,1974-05-23,54922038Q,marc.andreu@brilliantapp.app,964991,ES19209587111785551517,5949.75,2022-01-28T09:17:33,Barcelona,expenses,repairs,-40.42,2670.25
buyer_4,Marc,Andreu,1974-05-23,54922038Q,marc.andreu@brilliantapp.app,964991,ES19209587111785551517,5949.75,2022-01-30T12:06:54,Barcelona,expenses,education,-77.01,2593.24
buyer_4,Marc,Andreu,1974-05-23,54922038Q,marc.andreu@brilliantapp.app,964991,ES19209587111785551517,5949.75,2022-01-31T12:54:34,Barcelona,expenses,food,-68.48,2524.76
buyer_4,Marc,Andreu,1974-05-23,54922038Q,marc.andreu@brilliantapp.app,964991,ES19209587111785551517,5949.75,2022-02-01T14:13:57,Barcelona,incomes,salary,2832.82,5357.58
buyer_4,Marc,Andreu,1974-05-23,54922038Q,marc.andreu@brilliantapp.app,964991,ES19209587111785551517,5949.75,2022-02-03T10:45:41,Barcelona,expenses,food,-97.19,5260.39
buyer_4,Marc,Andreu,1974-05-23,54922038Q,marc.andreu@brilliantapp.app,964991,ES19209587111785551517,5949.75,2022-02-04T11:28:05,Barcelona,expenses,healthcare,-165.1,5095.29
buyer_4,Marc,Andreu,1974-05-23,54922038Q,marc.andreu@brilliantapp.app,964991,ES19209587111785551517,5949.75,2022-02-05T13:46:42,Barcelona,expenses,mortgage,-1458.7,3636.59
buyer_4,Marc,Andreu,1974-05-23,54922038Q,marc.andreu@brilliantapp.app,964991,ES19209587111785551517,5949.75,2022-02-05T19:26:12,Barcelona,expenses,electricity,-102.62,3533.97
buyer_4,Marc,Andreu,1974-05-23,54922038Q,marc.andreu@brilliantapp.app,964991,ES19209587111785551517,5949.75,2022-02-06T15:11:35,Barcelona,expenses,electricity,-119.97,3414.0
buyer_4,Marc,Andreu,1974-05-23,54922038Q,marc.andreu@brilliantapp.app,964991,ES19209587111785551517,5949.75,2022-02-06T14:32:29,Barcelona,expenses,phone,-55.5,3358.5
buyer_4,Marc,Andreu,1974-05-23,54922038Q,marc.andreu@brilliantapp.app,964991,ES19209587111785551517,5949.75,2022-02-06T05:50:07,Barcelona,expenses,food,-97.75,3260.75
buyer_4,Marc,Andreu,1974-05-23,54922038Q,marc.andreu@brilliantapp.app,964991,ES19209587111785551517,5949.75,2022-02-06T00:13:54,Barcelona,expenses,appliances,-145.2,3115.55
buyer_4,Marc,Andreu,1974-05-23,54922038Q,marc.andreu@brilliantapp.app,964991,ES19209587111785551517,5949.75,2022-02-07T15:21:52,Barcelona,expenses,appliances,-216.72,2898.83
buyer_4,Marc,Andreu,1974-05-23,54922038Q,marc.andreu@brilliantapp.app,964991,ES19209587111785551517,5949.75,2022-02-08T08:59:16,Barcelona,expenses,travel,-399.24,2499.59
buyer_4,Marc,Andreu,1974-05-23,54922038Q,marc.andreu@brilliantapp.app,964991,ES19209587111785551517,5949.75,2022-02-12T10:03:34,Barcelona,expenses,food,-101.24,2398.35
buyer_4,Marc,Andreu,1974-05-23,54922038Q,marc.andreu@brilliantapp.app,964991,ES19209587111785551517,5949.75,2022-02-12T23:28:10,Barcelona,expenses,transport,-80.83,2317.52
buyer_4,Marc,Andreu,1974-05-23,54922038Q,marc.andreu@brilliantapp.app,964991,ES19209587111785551517,5949.75,2022-02-13T17:00:40,Barcelona,expenses,clothing,-73.4,2244.12
buyer_4,Marc,Andreu,1974-05-23,54922038Q,marc.andreu@brilliantapp.app,964991,ES19209587111785551517,5949.75,2022-02-13T14:03:30,Barcelona,expenses,cash,-100.0,2144.12
buyer_4,Marc,Andreu,1974-05-23,54922038Q,marc.andreu@brilliantapp.app,964991,ES19209587111785551517,5949.75,2022-02-14T18:43:35,Barcelona,expenses,leisure,-41.26,2102.86
buyer_4,Marc,Andreu,1974-05-23,54922038Q,marc.andreu@brilliantapp.app,964991,ES19209587111785551517,5949.75,2022-02-16T19:58:54,Barcelona,expenses,transport,-72.8,2030.06
buyer_4,Marc,Andreu,1974-05-23,54922038Q,marc.andreu@brilliantapp.app,964991,ES19209587111785551517,5949.75,2022-02-17T10:17:44,Barcelona,expenses,food,-123.83,1906.23
buyer_4,Marc,Andreu,1974-05-23,54922038Q,marc.andreu@brilliantapp.app,964991,ES19209587111785551517,5949.75,2022-02-17T23:42:43,Barcelona,expenses,education,-48.26,1857.97
buyer_4,Marc,Andreu,1974-05-23,54922038Q,marc.andreu@brilliantapp.app,964991,ES19209587111785551517,5949.75,2022-02-18T16:17:14,Barcelona,expenses,education,-58.77,1799.2
buyer_4,Marc,Andreu,1974-05-23,54922038Q,marc.andreu@brilliantapp.app,964991,ES19209587111785551517,5949.75,2022-02-19T09:38:58,Barcelona,expenses,food,-70.19,1729.01
buyer_4,Marc,Andreu,1974-05-23,54922038Q,marc.andreu@brilliantapp.app,964991,ES19209587111785551517,5949.75,2022-02-20T16:37:59,Barcelona,expenses,leisure,-67.47,1661.54
buyer_4,Marc,Andreu,1974-05-23,54922038Q,marc.andreu@brilliantapp.app,964991,ES19209587111785551517,5949.75,2022-02-20T14:12:17,Barcelona,expenses,cash,-100.0,1561.54
buyer_4,Marc,Andreu,1974-05-23,54922038Q,marc.andreu@brilliantapp.app,964991,ES19209587111785551517,5949.75,2022-02-25T08:21:55,Barcelona,expenses,food,-68.15,1493.39
buyer_4,Marc,Andreu,1974-05-23,54922038Q,marc.andreu@brilliantapp.app,964991,ES19209587111785551517,5949.75,2022-02-25T20:42:47,Barcelona,expenses,travel,-391.48,1101.91
buyer_4,Marc,Andreu,1974-05-23,54922038Q,marc.andreu@brilliantapp.app,964991,ES19209587111785551517,5949.75,2022-02-26T09:29:14,Barcelona,expenses,car,-256.33,845.58
buyer_4,Marc,Andreu,1974-05-23,54922038Q,marc.andreu@brilliantapp.app,964991,ES19209587111785551517,5949.75,2022-02-28T12:28:37,Barcelona,expenses,cash,-100.0,745.58
buyer_4,Marc,Andreu,1974-05-23,54922038Q,marc.andreu@brilliantapp.app,964991,ES19209587111785551517,5949.75,2022-03-01T17:13:37,Barcelona,incomes,salary,2832.82,3578.4
buyer_4,Marc,Andreu,1974-05-23,54922038Q,marc.andreu@brilliantapp.app,964991,ES19209587111785551517,5949.75,2022-03-04T05:30:51,Barcelona,expenses,cash,-100.0,3478.4
buyer_4,Marc,Andreu,1974-05-23,54922038Q,marc.andreu@brilliantapp.app,964991,ES19209587111785551517,5949.75,2022-03-05T05:42:19,Barcelona,expenses,mortgage,-1458.7,2019.7
buyer_4,Marc,Andreu,1974-05-23,54922038Q,marc.andreu@brilliantapp.app,964991,ES19209587111785551517,5949.75,2022-03-05T09:24:11,Barcelona,expenses,internet,-59.49,1960.21
buyer_4,Marc,Andreu,1974-05-23,54922038Q,marc.andreu@brilliantapp.app,964991,ES19209587111785551517,5949.75,2022-03-06T03:14:26,Barcelona,expenses,electricity,-36.91,1923.3
buyer_4,Marc,Andreu,1974-05-23,54922038Q,marc.andreu@brilliantapp.app,964991,ES19209587111785551517,5949.75,2022-03-06T13:41:36,Barcelona,expenses,gas,-44.56,1878.74
buyer_4,Marc,Andreu,1974-05-23,54922038Q,marc.andreu@brilliantapp.app,964991,ES19209587111785551517,5949.75,2022-03-06T19:54:36,Barcelona,expenses,internet,-59.49,1819.25
buyer_4,Marc,Andreu,1974-05-23,54922038Q,marc.andreu@brilliantapp.app,964991,ES19209587111785551517,5949.75,2022-03-07T16:59:00,Barcelona,expenses,water,-62.76,1756.49
buyer_4,Marc,Andreu,1974-05-23,54922038Q,marc.andreu@brilliantapp.app,964991,ES19209587111785551517,5949.75,2022-03-07T11:25:46,Barcelona,expenses,electricity,-68.73,1687.76
buyer_4,Marc,Andreu,1974-05-23,54922038Q,marc.andreu@brilliantapp.app,964991,ES19209587111785551517,5949.75,2022-03-09T15:52:36,Barcelona,expenses,food,-105.17,1582.59
buyer_4,Marc,Andreu,1974-05-23,54922038Q,marc.andreu@brilliantapp.app,964991,ES19209587111785551517,5949.75,2022-03-11T08:27:41,Barcelona,expenses,food,-118.98,1463.61
buyer_4,Marc,Andreu,1974-05-23,54922038Q,marc.andreu@brilliantapp.app,964991,ES19209587111785551517,5949.75,2022-03-11T21:10:43,Barcelona,expenses,gifts,-143.23,1320.38
buyer_4,Marc,Andreu,1974-05-23,54922038Q,marc.andreu@brilliantapp.app,964991,ES19209587111785551517,5949.75,2022-03-11T23:58:06,Barcelona,expenses,children,-441.6,878.78
buyer_4,Marc,Andreu,1974-05-23,54922038Q,marc.andreu@brilliantapp.app,964991,ES19209587111785551517,5949.75,2022-03-12T12:27:28,Barcelona,expenses,cash,-100.0,778.78
buyer_4,Marc,Andreu,1974-05-23,54922038Q,marc.andreu@brilliantapp.app,964991,ES19209587111785551517,5949.75,2022-03-12T09:31:22,Barcelona,expenses,appliances,-332.66,446.12
buyer_4,Marc,Andreu,1974-05-23,54922038Q,marc.andreu@brilliantapp.app,964991,ES19209587111785551517,5949.75,2022-03-15T08:27:04,Barcelona,expenses,cash,-100.0,346.12
buyer_4,Marc,Andreu,1974-05-23,54922038Q,marc.andreu@brilliantapp.app,964991,ES19209587111785551517,5949.75,2022-03-15T23:29:09,Barcelona,expenses,repairs,-309.43,36.69
buyer_4,Marc,Andreu,1974-05-23,54922038Q,marc.andreu@brilliantapp.app,964991,ES19209587111785551517,5949.75,2022-03-15T18:47:49,Barcelona,expenses,children,-434.358,-397.67
buyer_4,Marc,Andreu,1974-05-23,54922038Q,marc.andreu@brilliantapp.app,964991,ES19209587111785551517,5949.75,2022-03-18T12:15:19,Barcelona,expenses,transport,-44.21,-441.88
buyer_4,Marc,Andreu,1974-05-23,54922038Q,marc.andreu@brilliantapp.app,964991,ES19209587111785551517,5949.75,2022-03-19T20:20:13,Barcelona,expenses,food,-73.01,-514.89
buyer_4,Marc,Andreu,1974-05-23,54922038Q,marc.andreu@brilliantapp.app,964991,ES19209587111785551517,5949.75,2022-03-19T20:38:48,Barcelona,expenses,cash,-100.0,-614.89
buyer_4,Marc,Andreu,1974-05-23,54922038Q,marc.andreu@brilliantapp.app,964991,ES19209587111785551517,5949.75,2022-03-20T13:59:33,Barcelona,expenses,leisure,-37.19,-652.08
buyer_4,Marc,Andreu,1974-05-23,54922038Q,marc.andreu@brilliantapp.app,964991,ES19209587111785551517,5949.75,2022-03-21T18:48:41,Barcelona,expenses,travel,-473.54,-1125.62
buyer_4,Marc,Andreu,1974-05-23,54922038Q,marc.andreu@brilliantapp.app,964991,ES19209587111785551517,5949.75,2022-03-22T08:23:37,Barcelona,expenses,food,-69.54,-1195.16
buyer_4,Marc,Andreu,1974-05-23,54922038Q,marc.andreu@brilliantapp.app,964991,ES19209587111785551517,5949.75,2022-03-24T17:21:34,Barcelona,expenses,food,-74.81,-1269.97
buyer_4,Marc,Andreu,1974-05-23,54922038Q,marc.andreu@brilliantapp.app,964991,ES19209587111785551517,5949.75,2022-03-24T16:32:54,Barcelona,expenses,education,-66.02,-1335.99
buyer_4,Marc,Andreu,1974-05-23,54922038Q,marc.andreu@brilliantapp.app,964991,ES19209587111785551517,5949.75,2022-03-25T14:57:53,Barcelona,expenses,transport,-42.49,-1378.48
buyer_4,Marc,Andreu,1974-05-23,54922038Q,marc.andreu@brilliantapp.app,964991,ES19209587111785551517,5949.75,2022-03-26T15:01:19,Barcelona,expenses,leisure,-36.26,-1414.74
buyer_4,Marc,Andreu,1974-05-23,54922038Q,marc.andreu@brilliantapp.app,964991,ES19209587111785551517,5949.75,2022-03-27T15:37:40,Barcelona,expenses,food,-75.88,-1490.62
buyer_4,Marc,Andreu,1974-05-23,54922038Q,marc.andreu@brilliantapp.app,964991,ES19209587111785551517,5949.75,2022-03-28T10:59:49,Barcelona,expenses,leisure,-25.38,-1516.0
buyer_4,Marc,Andreu,1974-05-23,54922038Q,marc.andreu@brilliantapp.app,964991,ES19209587111785551517,5949.75,2022-03-29T14:31:12,Barcelona,expenses,food,-121.96,-1637.96
buyer_4,Marc,Andreu,1974-05-23,54922038Q,marc.andreu@brilliantapp.app,964991,ES19209587111785551517,5949.75,2022-03-29T21:11:59,Barcelona,expenses,healthcare,-167.99,-1805.95
buyer_4,Marc,Andreu,1974-05-23,54922038Q,marc.andreu@brilliantapp.app,964991,ES19209587111785551517,5949.75,2022-03-31T15:52:39,Barcelona,expenses,food,-72.49,-1878.44
buyer_4,Marc,Andreu,1974-05-23,54922038Q,marc.andreu@brilliantapp.app,964991,ES19209587111785551517,5949.75,2022-04-01T17:45:45,Barcelona,incomes,salary,2832.82,954.38
buyer_4,Marc,Andreu,1974-05-23,54922038Q,marc.andreu@brilliantapp.app,964991,ES19209587111785551517,5949.75,2022-04-01T17:45:45,Barcelona,incomes,extra_income,514.74,1469.12
buyer_4,Marc,Andreu,1974-05-23,54922038Q,marc.andreu@brilliantapp.app,964991,ES19209587111785551517,5949.75,2022-04-01T16:25:58,Barcelona,expenses,repairs,-57.67,1411.45
buyer_4,Marc,Andreu,1974-05-23,54922038Q,marc.andreu@brilliantapp.app,964991,ES19209587111785551517,5949.75,2022-04-04T08:20:28,Barcelona,expenses,cash,-100.0,1311.45
buyer_4,Marc,Andreu,1974-05-23,54922038Q,marc.andreu@brilliantapp.app,964991,ES19209587111785551517,5949.75,2022-04-05T18:58:22,Barcelona,expenses,mortgage,-1458.7,-147.25
buyer_4,Marc,Andreu,1974-05-23,54922038Q,marc.andreu@brilliantapp.app,964991,ES19209587111785551517,5949.75,2022-04-05T15:58:16,Barcelona,expenses,electricity,-41.54,-188.79
buyer_4,Marc,Andreu,1974-05-23,54922038Q,marc.andreu@brilliantapp.app,964991,ES19209587111785551517,5949.75,2022-04-05T01:26:12,Barcelona,expenses,gas,-149.01,-337.8
buyer_4,Marc,Andreu,1974-05-23,54922038Q,marc.andreu@brilliantapp.app,964991,ES19209587111785551517,5949.75,2022-04-06T19:53:36,Barcelona,expenses,internet,-59.49,-397.29
buyer_4,Marc,Andreu,1974-05-23,54922038Q,marc.andreu@brilliantapp.app,964991,ES19209587111785551517,5949.75,2022-04-06T08:11:54,Barcelona,expenses,phone,-51.7,-448.99
buyer_4,Marc,Andreu,1974-05-23,54922038Q,marc.andreu@brilliantapp.app,964991,ES19209587111785551517,5949.75,2022-04-06T09:55:01,Barcelona,expenses,appliances,-349.25,-798.24
buyer_4,Marc,Andreu,1974-05-23,54922038Q,marc.andreu@brilliantapp.app,964991,ES19209587111785551517,5949.75,2022-04-06T15:38:16,Barcelona,expenses,children,-494.538,-1292.78
buyer_4,Marc,Andreu,1974-05-23,54922038Q,marc.andreu@brilliantapp.app,964991,ES19209587111785551517,5949.75,2022-04-07T16:07:27,Barcelona,expenses,electricity,-42.96,-1335.74
buyer_4,Marc,Andreu,1974-05-23,54922038Q,marc.andreu@brilliantapp.app,964991,ES19209587111785551517,5949.75,2022-04-07T17:35:44,Barcelona,expenses,phone,-51.07,-1386.81
buyer_4,Marc,Andreu,1974-05-23,54922038Q,marc.andreu@brilliantapp.app,964991,ES19209587111785551517,5949.75,2022-04-07T18:10:11,Barcelona,expenses,food,-119.62,-1506.43
buyer_4,Marc,Andreu,1974-05-23,54922038Q,marc.andreu@brilliantapp.app,964991,ES19209587111785551517,5949.75,2022-04-07T19:35:15,Barcelona,expenses,transport,-47.15,-1553.58
buyer_4,Marc,Andreu,1974-05-23,54922038Q,marc.andreu@brilliantapp.app,964991,ES19209587111785551517,5949.75,2022-04-08T08:37:19,Barcelona,expenses,water,-30.95,-1584.53
buyer_4,Marc,Andreu,1974-05-23,54922038Q,marc.andreu@brilliantapp.app,964991,ES19209587111785551517,5949.75,2022-04-08T17:11:22,Barcelona,expenses,transport,-41.31,-1625.84
buyer_4,Marc,Andreu,1974-05-23,54922038Q,marc.andreu@brilliantapp.app,964991,ES19209587111785551517,5949.75,2022-04-08T14:08:34,Barcelona,expenses,gifts,-634.43,-2260.27
buyer_4,Marc,Andreu,1974-05-23,54922038Q,marc.andreu@brilliantapp.app,964991,ES19209587111785551517,5949.75,2022-04-10T02:36:15,Barcelona,expenses,cash,-100.0,-2360.27
buyer_4,Marc,Andreu,1974-05-23,54922038Q,marc.andreu@brilliantapp.app,964991,ES19209587111785551517,5949.75,2022-04-12T23:38:14,Barcelona,expenses,cash,-100.0,-2460.27
buyer_4,Marc,Andreu,1974-05-23,54922038Q,marc.andreu@brilliantapp.app,964991,ES19209587111785551517,5949.75,2022-04-13T23:55:40,Barcelona,expenses,food,-107.43,-2567.7
buyer_4,Marc,Andreu,1974-05-23,54922038Q,marc.andreu@brilliantapp.app,964991,ES19209587111785551517,5949.75,2022-04-15T15:26:02,Barcelona,expenses,leisure,-75.9,-2643.6
buyer_4,Marc,Andreu,1974-05-23,54922038Q,marc.andreu@brilliantapp.app,964991,ES19209587111785551517,5949.75,2022-04-17T22:42:39,Barcelona,expenses,clothing,-153.44,-2797.04
buyer_4,Marc,Andreu,1974-05-23,54922038Q,marc.andreu@brilliantapp.app,964991,ES19209587111785551517,5949.75,2022-04-18T08:27:04,Barcelona,expenses,cash,-100.0,-2897.04
buyer_4,Marc,Andreu,1974-05-23,54922038Q,marc.andreu@brilliantapp.app,964991,ES19209587111785551517,5949.75,2022-04-19T13:22:00,Barcelona,expenses,transport,-73.53,-2970.57
buyer_4,Marc,Andreu,1974-05-23,54922038Q,marc.andreu@brilliantapp.app,964991,ES19209587111785551517,5949.75,2022-04-19T22:29:35,Barcelona,expenses,cash,-100.0,-3070.57
buyer_4,Marc,Andreu,1974-05-23,54922038Q,marc.andreu@brilliantapp.app,964991,ES19209587111785551517,5949.75,2022-04-21T15:21:27,Barcelona,expenses,food,-110.81,-3181.38
buyer_4,Marc,Andreu,1974-05-23,54922038Q,marc.andreu@brilliantapp.app,964991,ES19209587111785551517,5949.75,2022-04-21T19:20:11,Barcelona,expenses,leisure,-72.61,-3253.99
buyer_4,Marc,Andreu,1974-05-23,54922038Q,marc.andreu@brilliantapp.app,964991,ES19209587111785551517,5949.75,2022-04-22T15:51:22,Barcelona,expenses,cash,-100.0,-3353.99
buyer_4,Marc,Andreu,1974-05-23,54922038Q,marc.andreu@brilliantapp.app,964991,ES19209587111785551517,5949.75,2022-04-23T11:47:22,Barcelona,expenses,cash,-100.0,-3453.99
buyer_4,Marc,Andreu,1974-05-23,54922038Q,marc.andreu@brilliantapp.app,964991,ES19209587111785551517,5949.75,2022-04-24T08:20:23,Barcelona,expenses,food,-120.01,-3574.0
buyer_4,Marc,Andreu,1974-05-23,54922038Q,marc.andreu@brilliantapp.app,964991,ES19209587111785551517,5949.75,2022-04-24T20:57:32,Barcelona,expenses,repairs,-241.37,-3815.37
buyer_4,Marc,Andreu,1974-05-23,54922038Q,marc.andreu@brilliantapp.app,964991,ES19209587111785551517,5949.75,2022-04-27T12:45:12,Barcelona,expenses,leisure,-72.45,-3887.82
buyer_4,Marc,Andreu,1974-05-23,54922038Q,marc.andreu@brilliantapp.app,964991,ES19209587111785551517,5949.75,2022-04-28T15:34:52,Barcelona,expenses,food,-90.08,-3977.9
buyer_4,Marc,Andreu,1974-05-23,54922038Q,marc.andreu@brilliantapp.app,964991,ES19209587111785551517,5949.75,2022-04-29T15:58:15,Barcelona,expenses,leisure,-72.63,-4050.53
buyer_4,Marc,Andreu,1974-05-23,54922038Q,marc.andreu@brilliantapp.app,964991,ES19209587111785551517,5949.75,2022-04-29T20:34:30,Barcelona,expenses,gifts,-115.38,-4165.91
buyer_4,Marc,Andreu,1974-05-23,54922038Q,marc.andreu@brilliantapp.app,964991,ES19209587111785551517,5949.75,2022-04-30T15:55:45,Barcelona,expenses,cash,-100.0,-4265.91
buyer_4,Marc,Andreu,1974-05-23,54922038Q,marc.andreu@brilliantapp.app,964991,ES19209587111785551517,5949.75,2022-05-01T08:35:35,Barcelona,incomes,salary,2832.82,-1433.09
buyer_4,Marc,Andreu,1974-05-23,54922038Q,marc.andreu@brilliantapp.app,964991,ES19209587111785551517,5949.75,2022-05-01T09:42:33,Barcelona,expenses,food,-88.32,-1521.41
buyer_4,Marc,Andreu,1974-05-23,54922038Q,marc.andreu@brilliantapp.app,964991,ES19209587111785551517,5949.75,2022-05-01T22:08:44,Barcelona,expenses,repairs,-127.61,-1649.02
buyer_4,Marc,Andreu,1974-05-23,54922038Q,marc.andreu@brilliantapp.app,964991,ES19209587111785551517,5949.75,2022-05-01T23:32:31,Barcelona,expenses,car,-330.19,-1979.21
buyer_4,Marc,Andreu,1974-05-23,54922038Q,marc.andreu@brilliantapp.app,964991,ES19209587111785551517,5949.75,2022-05-04T12:06:39,Barcelona,expenses,healthcare,-138.44,-2117.65
buyer_4,Marc,Andreu,1974-05-23,54922038Q,marc.andreu@brilliantapp.app,964991,ES19209587111785551517,5949.75,2022-05-05T11:41:28,Barcelona,expenses,mortgage,-1458.7,-3576.35
buyer_4,Marc,Andreu,1974-05-23,54922038Q,marc.andreu@brilliantapp.app,964991,ES19209587111785551517,5949.75,2022-05-05T15:30:39,Barcelona,expenses,electricity,-54.47,-3630.82
buyer_4,Marc,Andreu,1974-05-23,54922038Q,marc.andreu@brilliantapp.app,964991,ES19209587111785551517,5949.75,2022-05-05T14:58:16,Barcelona,expenses,gas,-48.18,-3679.0
buyer_4,Marc,Andreu,1974-05-23,54922038Q,marc.andreu@brilliantapp.app,964991,ES19209587111785551517,5949.75,2022-05-05T17:29:12,Barcelona,expenses,phone,-56.5,-3735.5
buyer_4,Marc,Andreu,1974-05-23,54922038Q,marc.andreu@brilliantapp.app,964991,ES19209587111785551517,5949.75,2022-05-05T23:42:20,Barcelona,expenses,food,-76.64,-3812.14
buyer_4,Marc,Andreu,1974-05-23,54922038Q,marc.andreu@brilliantapp.app,964991,ES19209587111785551517,5949.75,2022-05-05T09:35:45,Barcelona,expenses,cash,-100.0,-3912.14
buyer_4,Marc,Andreu,1974-05-23,54922038Q,marc.andreu@brilliantapp.app,964991,ES19209587111785551517,5949.75,2022-05-06T07:18:47,Barcelona,expenses,water,-41.2,-3953.34
buyer_4,Marc,Andreu,1974-05-23,54922038Q,marc.andreu@brilliantapp.app,964991,ES19209587111785551517,5949.75,2022-05-06T08:34:02,Barcelona,expenses,food,-94.06,-4047.4
buyer_4,Marc,Andreu,1974-05-23,54922038Q,marc.andreu@brilliantapp.app,964991,ES19209587111785551517,5949.75,2022-05-06T21:39:35,Barcelona,expenses,repairs,-229.82,-4277.22
buyer_4,Marc,Andreu,1974-05-23,54922038Q,marc.andreu@brilliantapp.app,964991,ES19209587111785551517,5949.75,2022-05-07T10:55:37,Barcelona,expenses,water,-55.42,-4332.64
buyer_4,Marc,Andreu,1974-05-23,54922038Q,marc.andreu@brilliantapp.app,964991,ES19209587111785551517,5949.75,2022-05-07T18:39:18,Barcelona,expenses,internet,-59.49,-4392.13
buyer_4,Marc,Andreu,1974-05-23,54922038Q,marc.andreu@brilliantapp.app,964991,ES19209587111785551517,5949.75,2022-05-07T00:04:51,Barcelona,expenses,leisure,-48.74,-4440.87
buyer_4,Marc,Andreu,1974-05-23,54922038Q,marc.andreu@brilliantapp.app,964991,ES19209587111785551517,5949.75,2022-05-08T11:54:06,Barcelona,expenses,water,-38.5,-4479.37
buyer_4,Marc,Andreu,1974-05-23,54922038Q,marc.andreu@brilliantapp.app,964991,ES19209587111785551517,5949.75,2022-05-08T18:57:45,Barcelona,expenses,food,-105.01,-4584.38
buyer_4,Marc,Andreu,1974-05-23,54922038Q,marc.andreu@brilliantapp.app,964991,ES19209587111785551517,5949.75,2022-05-10T13:35:40,Barcelona,expenses,cash,-100.0,-4684.38
buyer_4,Marc,Andreu,1974-05-23,54922038Q,marc.andreu@brilliantapp.app,964991,ES19209587111785551517,5949.75,2022-05-11T23:10:56,Barcelona,expenses,healthcare,-98.35,-4782.73
buyer_4,Marc,Andreu,1974-05-23,54922038Q,marc.andreu@brilliantapp.app,964991,ES19209587111785551517,5949.75,2022-05-12T13:05:26,Barcelona,expenses,cash,-100.0,-4882.73
buyer_4,Marc,Andreu,1974-05-23,54922038Q,marc.andreu@brilliantapp.app,964991,ES19209587111785551517,5949.75,2022-05-12T19:49:46,Barcelona,expenses,children,-743.788,-5626.52
buyer_4,Marc,Andreu,1974-05-23,54922038Q,marc.andreu@brilliantapp.app,964991,ES19209587111785551517,5949.75,2022-05-13T07:43:29,Barcelona,expenses,leisure,-40.95,-5667.47
buyer_4,Marc,Andreu,1974-05-23,54922038Q,marc.andreu@brilliantapp.app,964991,ES19209587111785551517,5949.75,2022-05-14T20:10:03,Barcelona,expenses,leisure,-82.17,-5749.64
buyer_4,Marc,Andreu,1974-05-23,54922038Q,marc.andreu@brilliantapp.app,964991,ES19209587111785551517,5949.75,2022-05-14T00:54:50,Barcelona,expenses,clothing,-45.4,-5795.04
buyer_4,Marc,Andreu,1974-05-23,54922038Q,marc.andreu@brilliantapp.app,964991,ES19209587111785551517,5949.75,2022-05-15T16:37:43,Barcelona,expenses,cash,-100.0,-5895.04
buyer_4,Marc,Andreu,1974-05-23,54922038Q,marc.andreu@brilliantapp.app,964991,ES19209587111785551517,5949.75,2022-05-16T11:21:47,Barcelona,expenses,cash,-100.0,-5995.04
buyer_4,Marc,Andreu,1974-05-23,54922038Q,marc.andreu@brilliantapp.app,964991,ES19209587111785551517,5949.75,2022-05-17T23:20:00,Barcelona,expenses,leisure,-18.28,-6013.32
buyer_4,Marc,Andreu,1974-05-23,54922038Q,marc.andreu@brilliantapp.app,964991,ES19209587111785551517,5949.75,2022-05-18T08:43:55,Barcelona,expenses,food,-71.2,-6084.52
buyer_4,Marc,Andreu,1974-05-23,54922038Q,marc.andreu@brilliantapp.app,964991,ES19209587111785551517,5949.75,2022-05-20T15:07:57,Barcelona,expenses,food,-60.86,-6145.38
buyer_4,Marc,Andreu,1974-05-23,54922038Q,marc.andreu@brilliantapp.app,964991,ES19209587111785551517,5949.75,2022-05-20T19:46:01,Barcelona,expenses,clothing,-60.96,-6206.34
buyer_4,Marc,Andreu,1974-05-23,54922038Q,marc.andreu@brilliantapp.app,964991,ES19209587111785551517,5949.75,2022-05-23T08:47:22,Barcelona,expenses,children,-843.788,-7050.13
buyer_4,Marc,Andreu,1974-05-23,54922038Q,marc.andreu@brilliantapp.app,964991,ES19209587111785551517,5949.75,2022-05-24T09:03:54,Barcelona,expenses,cash,-100.0,-7150.13
buyer_4,Marc,Andreu,1974-05-23,54922038Q,marc.andreu@brilliantapp.app,964991,ES19209587111785551517,5949.75,2022-05-24T19:37:24,Barcelona,expenses,appliances,-329.33,-7479.46
buyer_4,Marc,Andreu,1974-05-23,54922038Q,marc.andreu@brilliantapp.app,964991,ES19209587111785551517,5949.75,2022-05-26T21:05:34,Barcelona,expenses,food,-82.76,-7562.22
buyer_4,Marc,Andreu,1974-05-23,54922038Q,marc.andreu@brilliantapp.app,964991,ES19209587111785551517,5949.75,2022-05-26T00:50:02,Barcelona,expenses,transport,-74.5,-7636.72
buyer_4,Marc,Andreu,1974-05-23,54922038Q,marc.andreu@brilliantapp.app,964991,ES19209587111785551517,5949.75,2022-05-27T18:33:28,Barcelona,expenses,cash,-100.0,-7736.72
buyer_4,Marc,Andreu,1974-05-23,54922038Q,marc.andreu@brilliantapp.app,964991,ES19209587111785551517,5949.75,2022-05-28T23:27:39,Barcelona,expenses,transport,-62.76,-7799.48
buyer_4,Marc,Andreu,1974-05-23,54922038Q,marc.andreu@brilliantapp.app,964991,ES19209587111785551517,5949.75,2022-05-29T17:50:52,Barcelona,expenses,appliances,-124.58,-7924.06
buyer_4,Marc,Andreu,1974-05-23,54922038Q,marc.andreu@brilliantapp.app,964991,ES19209587111785551517,5949.75,2022-05-30T11:34:29,Barcelona,expenses,leisure,-19.9,-7943.96
buyer_4,Marc,Andreu,1974-05-23,54922038Q,marc.andreu@brilliantapp.app,964991,ES19209587111785551517,5949.75,2022-05-30T10:37:22,Barcelona,expenses,healthcare,-153.27,-8097.23
buyer_4,Marc,Andreu,1974-05-23,54922038Q,marc.andreu@brilliantapp.app,964991,ES19209587111785551517,5949.75,2022-06-01T17:44:09,Barcelona,incomes,salary,2832.82,-5264.41
buyer_4,Marc,Andreu,1974-05-23,54922038Q,marc.andreu@brilliantapp.app,964991,ES19209587111785551517,5949.75,2022-06-01T17:44:09,Barcelona,incomes,salary_bonus,2134.06,-3130.35
buyer_4,Marc,Andreu,1974-05-23,54922038Q,marc.andreu@brilliantapp.app,964991,ES19209587111785551517,5949.75,2022-06-01T11:36:22,Barcelona,expenses,taxes,-2070.35,-5200.7
buyer_4,Marc,Andreu,1974-05-23,54922038Q,marc.andreu@brilliantapp.app,964991,ES19209587111785551517,5949.75,2022-06-01T21:37:31,Barcelona,expenses,insurance,-776.52,-5977.22
buyer_4,Marc,Andreu,1974-05-23,54922038Q,marc.andreu@brilliantapp.app,964991,ES19209587111785551517,5949.75,2022-06-02T11:42:16,Barcelona,expenses,cash,-100.0,-6077.22
buyer_4,Marc,Andreu,1974-05-23,54922038Q,marc.andreu@brilliantapp.app,964991,ES19209587111785551517,5949.75,2022-06-03T08:18:59,Barcelona,expenses,food,-82.21,-6159.43
buyer_4,Marc,Andreu,1974-05-23,54922038Q,marc.andreu@brilliantapp.app,964991,ES19209587111785551517,5949.75,2022-06-03T11:51:10,Barcelona,expenses,cash,-100.0,-6259.43
buyer_4,Marc,Andreu,1974-05-23,54922038Q,marc.andreu@brilliantapp.app,964991,ES19209587111785551517,5949.75,2022-06-03T18:32:42,Barcelona,expenses,gifts,-392.91,-6652.34
buyer_4,Marc,Andreu,1974-05-23,54922038Q,marc.andreu@brilliantapp.app,964991,ES19209587111785551517,5949.75,2022-06-04T09:36:39,Barcelona,expenses,transport,-57.94,-6710.28
buyer_4,Marc,Andreu,1974-05-23,54922038Q,marc.andreu@brilliantapp.app,964991,ES19209587111785551517,5949.75,2022-06-05T16:26:47,Barcelona,expenses,mortgage,-1458.7,-8168.98
buyer_4,Marc,Andreu,1974-05-23,54922038Q,marc.andreu@brilliantapp.app,964991,ES19209587111785551517,5949.75,2022-06-05T20:12:46,Barcelona,expenses,water,-56.47,-8225.45
buyer_4,Marc,Andreu,1974-05-23,54922038Q,marc.andreu@brilliantapp.app,964991,ES19209587111785551517,5949.75,2022-06-05T18:13:06,Barcelona,expenses,transport,-74.75,-8300.2
buyer_4,Marc,Andreu,1974-05-23,54922038Q,marc.andreu@brilliantapp.app,964991,ES19209587111785551517,5949.75,2022-06-05T03:37:28,Barcelona,expenses,repairs,-131.82,-8432.02
buyer_4,Marc,Andreu,1974-05-23,54922038Q,marc.andreu@brilliantapp.app,964991,ES19209587111785551517,5949.75,2022-06-06T13:49:45,Barcelona,expenses,water,-35.48,-8467.5
buyer_4,Marc,Andreu,1974-05-23,54922038Q,marc.andreu@brilliantapp.app,964991,ES19209587111785551517,5949.75,2022-06-06T19:08:25,Barcelona,expenses,internet,-59.49,-8526.99
buyer_4,Marc,Andreu,1974-05-23,54922038Q,marc.andreu@brilliantapp.app,964991,ES19209587111785551517,5949.75,2022-06-06T10:35:28,Barcelona,expenses,food,-70.09,-8597.08
buyer_4,Marc,Andreu,1974-05-23,54922038Q,marc.andreu@brilliantapp.app,964991,ES19209587111785551517,5949.75,2022-06-06T11:12:48,Barcelona,expenses,leisure,-79.97,-8677.05
buyer_4,Marc,Andreu,1974-05-23,54922038Q,marc.andreu@brilliantapp.app,964991,ES19209587111785551517,5949.75,2022-06-07T16:54:56,Barcelona,expenses,water,-49.22,-8726.27
buyer_4,Marc,Andreu,1974-05-23,54922038Q,marc.andreu@brilliantapp.app,964991,ES19209587111785551517,5949.75,2022-06-07T20:06:41,Barcelona,expenses,internet,-59.49,-8785.76
buyer_4,Marc,Andreu,1974-05-23,54922038Q,marc.andreu@brilliantapp.app,964991,ES19209587111785551517,5949.75,2022-06-07T06:59:10,Barcelona,expenses,phone,-47.02,-8832.78
buyer_4,Marc,Andreu,1974-05-23,54922038Q,marc.andreu@brilliantapp.app,964991,ES19209587111785551517,5949.75,2022-06-07T08:52:41,Barcelona,expenses,food,-81.26,-8914.04
buyer_4,Marc,Andreu,1974-05-23,54922038Q,marc.andreu@brilliantapp.app,964991,ES19209587111785551517,5949.75,2022-06-07T15:42:14,Barcelona,expenses,clothing,-113.2,-9027.24
buyer_4,Marc,Andreu,1974-05-23,54922038Q,marc.andreu@brilliantapp.app,964991,ES19209587111785551517,5949.75,2022-06-08T13:20:12,Barcelona,expenses,water,-55.02,-9082.26
buyer_4,Marc,Andreu,1974-05-23,54922038Q,marc.andreu@brilliantapp.app,964991,ES19209587111785551517,5949.75,2022-06-08T20:11:33,Barcelona,expenses,internet,-59.49,-9141.75
buyer_4,Marc,Andreu,1974-05-23,54922038Q,marc.andreu@brilliantapp.app,964991,ES19209587111785551517,5949.75,2022-06-09T10:17:32,Barcelona,expenses,cash,-100.0,-9241.75
buyer_4,Marc,Andreu,1974-05-23,54922038Q,marc.andreu@brilliantapp.app,964991,ES19209587111785551517,5949.75,2022-06-10T18:20:29,Barcelona,expenses,transport,-63.96,-9305.71
buyer_4,Marc,Andreu,1974-05-23,54922038Q,marc.andreu@brilliantapp.app,964991,ES19209587111785551517,5949.75,2022-06-10T19:10:29,Barcelona,expenses,appliances,-135.61,-9441.32
buyer_4,Marc,Andreu,1974-05-23,54922038Q,marc.andreu@brilliantapp.app,964991,ES19209587111785551517,5949.75,2022-06-13T15:40:44,Barcelona,expenses,repairs,-47.7,-9489.02
buyer_4,Marc,Andreu,1974-05-23,54922038Q,marc.andreu@brilliantapp.app,964991,ES19209587111785551517,5949.75,2022-06-14T16:53:26,Barcelona,expenses,transport,-72.09,-9561.11
buyer_4,Marc,Andreu,1974-05-23,54922038Q,marc.andreu@brilliantapp.app,964991,ES19209587111785551517,5949.75,2022-06-14T20:18:53,Barcelona,expenses,leisure,-78.04,-9639.15
buyer_4,Marc,Andreu,1974-05-23,54922038Q,marc.andreu@brilliantapp.app,964991,ES19209587111785551517,5949.75,2022-06-14T21:30:27,Barcelona,expenses,appliances,-342.38,-9981.53
buyer_4,Marc,Andreu,1974-05-23,54922038Q,marc.andreu@brilliantapp.app,964991,ES19209587111785551517,5949.75,2022-06-15T15:55:37,Barcelona,expenses,healthcare,-153.54,-10135.07
buyer_4,Marc,Andreu,1974-05-23,54922038Q,marc.andreu@brilliantapp.app,964991,ES19209587111785551517,5949.75,2022-06-16T16:14:27,Barcelona,expenses,cash,-100.0,-10235.07
buyer_4,Marc,Andreu,1974-05-23,54922038Q,marc.andreu@brilliantapp.app,964991,ES19209587111785551517,5949.75,2022-06-17T18:15:00,Barcelona,expenses,leisure,-36.57,-10271.64
buyer_4,Marc,Andreu,1974-05-23,54922038Q,marc.andreu@brilliantapp.app,964991,ES19209587111785551517,5949.75,2022-06-17T19:31:02,Barcelona,expenses,education,-43.34,-10314.98
buyer_4,Marc,Andreu,1974-05-23,54922038Q,marc.andreu@brilliantapp.app,964991,ES19209587111785551517,5949.75,2022-06-18T14:54:17,Barcelona,expenses,cash,-100.0,-10414.98
buyer_4,Marc,Andreu,1974-05-23,54922038Q,marc.andreu@brilliantapp.app,964991,ES19209587111785551517,5949.75,2022-06-19T19:05:58,Barcelona,expenses,cash,-100.0,-10514.98
buyer_4,Marc,Andreu,1974-05-23,54922038Q,marc.andreu@brilliantapp.app,964991,ES19209587111785551517,5949.75,2022-06-19T17:43:17,Barcelona,expenses,gifts,-452.02,-10967.0
buyer_4,Marc,Andreu,1974-05-23,54922038Q,marc.andreu@brilliantapp.app,964991,ES19209587111785551517,5949.75,2022-06-21T08:26:55,Barcelona,expenses,transport,-51.86,-11018.86
buyer_4,Marc,Andreu,1974-05-23,54922038Q,marc.andreu@brilliantapp.app,964991,ES19209587111785551517,5949.75,2022-06-21T08:18:56,Barcelona,expenses,appliances,-111.76,-11130.62
buyer_4,Marc,Andreu,1974-05-23,54922038Q,marc.andreu@brilliantapp.app,964991,ES19209587111785551517,5949.75,2022-06-25T09:59:48,Barcelona,expenses,leisure,-73.49,-11204.11
buyer_4,Marc,Andreu,1974-05-23,54922038Q,marc.andreu@brilliantapp.app,964991,ES19209587111785551517,5949.75,2022-06-27T19:00:51,Barcelona,expenses,leisure,-18.77,-11222.88
buyer_4,Marc,Andreu,1974-05-23,54922038Q,marc.andreu@brilliantapp.app,964991,ES19209587111785551517,5949.75,2022-06-27T11:18:22,Barcelona,expenses,gifts,-520.83,-11743.71
buyer_4,Marc,Andreu,1974-05-23,54922038Q,marc.andreu@brilliantapp.app,964991,ES19209587111785551517,5949.75,2022-06-28T10:48:31,Barcelona,expenses,cash,-100.0,-11843.71
buyer_4,Marc,Andreu,1974-05-23,54922038Q,marc.andreu@brilliantapp.app,964991,ES19209587111785551517,5949.75,2022-06-29T14:59:00,Barcelona,expenses,transport,-69.79,-11913.5
buyer_4,Marc,Andreu,1974-05-23,54922038Q,marc.andreu@brilliantapp.app,964991,ES19209587111785551517,5949.75,2022-06-29T02:57:42,Barcelona,expenses,car,-237.02,-12150.52
buyer_4,Marc,Andreu,1974-05-23,54922038Q,marc.andreu@brilliantapp.app,964991,ES19209587111785551517,5949.75,2022-06-30T17:18:02,Barcelona,expenses,food,-101.42,-12251.94
buyer_4,Marc,Andreu,1974-05-23,54922038Q,marc.andreu@brilliantapp.app,964991,ES19209587111785551517,5949.75,2022-07-01T17:27:38,Barcelona,incomes,salary,2832.82,-9419.12
buyer_4,Marc,Andreu,1974-05-23,54922038Q,marc.andreu@brilliantapp.app,964991,ES19209587111785551517,5949.75,2022-07-01T17:27:38,Barcelona,incomes,extra_income,514.74,-8904.38
buyer_4,Marc,Andreu,1974-05-23,54922038Q,marc.andreu@brilliantapp.app,964991,ES19209587111785551517,5949.75,2022-07-01T16:57:19,Barcelona,expenses,gifts,-217.99,-9122.37
buyer_4,Marc,Andreu,1974-05-23,54922038Q,marc.andreu@brilliantapp.app,964991,ES19209587111785551517,5949.75,2022-07-02T21:22:16,Barcelona,expenses,clothing,-133.9,-9256.27
buyer_4,Marc,Andreu,1974-05-23,54922038Q,marc.andreu@brilliantapp.app,964991,ES19209587111785551517,5949.75,2022-07-04T11:55:54,Barcelona,expenses,gifts,-528.58,-9784.85
buyer_4,Marc,Andreu,1974-05-23,54922038Q,marc.andreu@brilliantapp.app,964991,ES19209587111785551517,5949.75,2022-07-05T21:33:24,Barcelona,expenses,mortgage,-1458.7,-11243.55
buyer_4,Marc,Andreu,1974-05-23,54922038Q,marc.andreu@brilliantapp.app,964991,ES19209587111785551517,5949.75,2022-07-05T13:45:11,Barcelona,expenses,internet,-59.49,-11303.04
buyer_4,Marc,Andreu,1974-05-23,54922038Q,marc.andreu@brilliantapp.app,964991,ES19209587111785551517,5949.75,2022-07-05T18:49:17,Barcelona,expenses,food,-69.24,-11372.28
buyer_4,Marc,Andreu,1974-05-23,54922038Q,marc.andreu@brilliantapp.app,964991,ES19209587111785551517,5949.75,2022-07-06T00:53:01,Barcelona,expenses,internet,-59.49,-11431.77
buyer_4,Marc,Andreu,1974-05-23,54922038Q,marc.andreu@brilliantapp.app,964991,ES19209587111785551517,5949.75,2022-07-06T18:51:46,Barcelona,expenses,education,-68.13,-11499.9
buyer_4,Marc,Andreu,1974-05-23,54922038Q,marc.andreu@brilliantapp.app,964991,ES19209587111785551517,5949.75,2022-07-07T13:22:06,Barcelona,expenses,food,-62.07,-11561.97
buyer_4,Marc,Andreu,1974-05-23,54922038Q,marc.andreu@brilliantapp.app,964991,ES19209587111785551517,5949.75,2022-07-07T20:44:40,Barcelona,expenses,leisure,-34.38,-11596.35
buyer_4,Marc,Andreu,1974-05-23,54922038Q,marc.andreu@brilliantapp.app,964991,ES19209587111785551517,5949.75,2022-07-08T17:02:21,Barcelona,expenses,internet,-59.49,-11655.84
buyer_4,Marc,Andreu,1974-05-23,54922038Q,marc.andreu@brilliantapp.app,964991,ES19209587111785551517,5949.75,2022-07-08T14:22:39,Barcelona,expenses,phone,-62.8,-11718.64
buyer_4,Marc,Andreu,1974-05-23,54922038Q,marc.andreu@brilliantapp.app,964991,ES19209587111785551517,5949.75,2022-07-08T09:33:36,Barcelona,expenses,healthcare,-131.74,-11850.38
buyer_4,Marc,Andreu,1974-05-23,54922038Q,marc.andreu@brilliantapp.app,964991,ES19209587111785551517,5949.75,2022-07-10T23:10:57,Barcelona,expenses,transport,-58.5,-11908.88
buyer_4,Marc,Andreu,1974-05-23,54922038Q,marc.andreu@brilliantapp.app,964991,ES19209587111785551517,5949.75,2022-07-10T13:56:04,Barcelona,expenses,cash,-100.0,-12008.88
buyer_4,Marc,Andreu,1974-05-23,54922038Q,marc.andreu@brilliantapp.app,964991,ES19209587111785551517,5949.75,2022-07-11T19:59:19,Barcelona,expenses,cash,-100.0,-12108.88
buyer_4,Marc,Andreu,1974-05-23,54922038Q,marc.andreu@brilliantapp.app,964991,ES19209587111785551517,5949.75,2022-07-15T17:13:34,Barcelona,expenses,food,-71.33,-12180.21
buyer_4,Marc,Andreu,1974-05-23,54922038Q,marc.andreu@brilliantapp.app,964991,ES19209587111785551517,5949.75,2022-07-17T09:02:35,Barcelona,expenses,repairs,-193.08,-12373.29
buyer_4,Marc,Andreu,1974-05-23,54922038Q,marc.andreu@brilliantapp.app,964991,ES19209587111785551517,5949.75,2022-07-20T15:57:08,Barcelona,expenses,leisure,-30.2,-12403.49
buyer_4,Marc,Andreu,1974-05-23,54922038Q,marc.andreu@brilliantapp.app,964991,ES19209587111785551517,5949.75,2022-07-20T23:44:20,Barcelona,expenses,education,-64.95,-12468.44
buyer_4,Marc,Andreu,1974-05-23,54922038Q,marc.andreu@brilliantapp.app,964991,ES19209587111785551517,5949.75,2022-07-21T13:00:48,Barcelona,expenses,food,-91.99,-12560.43
buyer_4,Marc,Andreu,1974-05-23,54922038Q,marc.andreu@brilliantapp.app,964991,ES19209587111785551517,5949.75,2022-07-21T08:46:58,Barcelona,expenses,transport,-53.05,-12613.48
buyer_4,Marc,Andreu,1974-05-23,54922038Q,marc.andreu@brilliantapp.app,964991,ES19209587111785551517,5949.75,2022-07-22T22:10:21,Barcelona,expenses,education,-71.19,-12684.67
buyer_4,Marc,Andreu,1974-05-23,54922038Q,marc.andreu@brilliantapp.app,964991,ES19209587111785551517,5949.75,2022-07-24T20:04:57,Barcelona,expenses,transport,-55.08,-12739.75
buyer_4,Marc,Andreu,1974-05-23,54922038Q,marc.andreu@brilliantapp.app,964991,ES19209587111785551517,5949.75,2022-07-24T15:18:16,Barcelona,expenses,gifts,-424.8,-13164.55
buyer_4,Marc,Andreu,1974-05-23,54922038Q,marc.andreu@brilliantapp.app,964991,ES19209587111785551517,5949.75,2022-07-26T15:20:37,Barcelona,expenses,cash,-100.0,-13264.55
buyer_4,Marc,Andreu,1974-05-23,54922038Q,marc.andreu@brilliantapp.app,964991,ES19209587111785551517,5949.75,2022-07-27T13:38:20,Barcelona,expenses,transport,-67.0,-13331.55
buyer_4,Marc,Andreu,1974-05-23,54922038Q,marc.andreu@brilliantapp.app,964991,ES19209587111785551517,5949.75,2022-07-27T18:41:01,Barcelona,expenses,clothing,-133.46,-13465.01
buyer_4,Marc,Andreu,1974-05-23,54922038Q,marc.andreu@brilliantapp.app,964991,ES19209587111785551517,5949.75,2022-07-27T09:58:47,Barcelona,expenses,education,-57.72,-13522.73
buyer_4,Marc,Andreu,1974-05-23,54922038Q,marc.andreu@brilliantapp.app,964991,ES19209587111785551517,5949.75,2022-07-28T15:11:40,Barcelona,expenses,food,-123.23,-13645.96
buyer_4,Marc,Andreu,1974-05-23,54922038Q,marc.andreu@brilliantapp.app,964991,ES19209587111785551517,5949.75,2022-07-29T16:27:04,Barcelona,expenses,repairs,-281.0,-13926.96
buyer_4,Marc,Andreu,1974-05-23,54922038Q,marc.andreu@brilliantapp.app,964991,ES19209587111785551517,5949.75,2022-07-29T19:22:54,Barcelona,expenses,children,-562.788,-14489.75
buyer_4,Marc,Andreu,1974-05-23,54922038Q,marc.andreu@brilliantapp.app,964991,ES19209587111785551517,5949.75,2022-07-30T15:17:30,Barcelona,expenses,cash,-100.0,-14589.75
buyer_4,Marc,Andreu,1974-05-23,54922038Q,marc.andreu@brilliantapp.app,964991,ES19209587111785551517,5949.75,2022-08-01T14:46:37,Barcelona,incomes,salary,2832.82,-11756.93
buyer_4,Marc,Andreu,1974-05-23,54922038Q,marc.andreu@brilliantapp.app,964991,ES19209587111785551517,5949.75,2022-08-01T08:05:09,Barcelona,expenses,children,-843.788,-12600.72
buyer_4,Marc,Andreu,1974-05-23,54922038Q,marc.andreu@brilliantapp.app,964991,ES19209587111785551517,5949.75,2022-08-03T10:20:50,Barcelona,expenses,children,-504.24,-13104.96
buyer_4,Marc,Andreu,1974-05-23,54922038Q,marc.andreu@brilliantapp.app,964991,ES19209587111785551517,5949.75,2022-08-04T18:19:41,Barcelona,expenses,food,-99.23,-13204.19
buyer_4,Marc,Andreu,1974-05-23,54922038Q,marc.andreu@brilliantapp.app,964991,ES19209587111785551517,5949.75,2022-08-05T14:48:01,Barcelona,expenses,mortgage,-1458.7,-14662.89
buyer_4,Marc,Andreu,1974-05-23,54922038Q,marc.andreu@brilliantapp.app,964991,ES19209587111785551517,5949.75,2022-08-05T16:50:15,Barcelona,expenses,food,-89.27,-14752.16
buyer_4,Marc,Andreu,1974-05-23,54922038Q,marc.andreu@brilliantapp.app,964991,ES19209587111785551517,5949.75,2022-08-05T13:00:06,Barcelona,expenses,education,-55.16,-14807.32
buyer_4,Marc,Andreu,1974-05-23,54922038Q,marc.andreu@brilliantapp.app,964991,ES19209587111785551517,5949.75,2022-08-06T05:41:57,Barcelona,expenses,internet,-59.49,-14866.81
buyer_4,Marc,Andreu,1974-05-23,54922038Q,marc.andreu@brilliantapp.app,964991,ES19209587111785551517,5949.75,2022-08-06T16:37:04,Barcelona,expenses,transport,-75.64,-14942.45
buyer_4,Marc,Andreu,1974-05-23,54922038Q,marc.andreu@brilliantapp.app,964991,ES19209587111785551517,5949.75,2022-08-06T18:04:01,Barcelona,expenses,clothing,-52.78,-14995.23
buyer_4,Marc,Andreu,1974-05-23,54922038Q,marc.andreu@brilliantapp.app,964991,ES19209587111785551517,5949.75,2022-08-06T12:58:51,Barcelona,expenses,repairs,-91.59,-15086.82
buyer_4,Marc,Andreu,1974-05-23,54922038Q,marc.andreu@brilliantapp.app,964991,ES19209587111785551517,5949.75,2022-08-06T08:35:38,Barcelona,expenses,gifts,-253.48,-15340.3
buyer_4,Marc,Andreu,1974-05-23,54922038Q,marc.andreu@brilliantapp.app,964991,ES19209587111785551517,5949.75,2022-08-07T18:10:59,Barcelona,expenses,water,-42.19,-15382.49
buyer_4,Marc,Andreu,1974-05-23,54922038Q,marc.andreu@brilliantapp.app,964991,ES19209587111785551517,5949.75,2022-08-08T16:25:06,Barcelona,expenses,water,-37.34,-15419.83
buyer_4,Marc,Andreu,1974-05-23,54922038Q,marc.andreu@brilliantapp.app,964991,ES19209587111785551517,5949.75,2022-08-08T20:09:58,Barcelona,expenses,internet,-59.49,-15479.32
buyer_4,Marc,Andreu,1974-05-23,54922038Q,marc.andreu@brilliantapp.app,964991,ES19209587111785551517,5949.75,2022-08-09T16:18:54,Barcelona,expenses,appliances,-234.17,-15713.49
buyer_4,Marc,Andreu,1974-05-23,54922038Q,marc.andreu@brilliantapp.app,964991,ES19209587111785551517,5949.75,2022-08-10T21:06:18,Barcelona,expenses,clothing,-86.23,-15799.72
buyer_4,Marc,Andreu,1974-05-23,54922038Q,marc.andreu@brilliantapp.app,964991,ES19209587111785551517,5949.75,2022-08-13T16:41:58,Barcelona,expenses,food,-64.58,-15864.3
buyer_4,Marc,Andreu,1974-05-23,54922038Q,marc.andreu@brilliantapp.app,964991,ES19209587111785551517,5949.75,2022-08-14T11:00:53,Barcelona,expenses,transport,-53.39,-15917.69
buyer_4,Marc,Andreu,1974-05-23,54922038Q,marc.andreu@brilliantapp.app,964991,ES19209587111785551517,5949.75,2022-08-15T19:43:56,Barcelona,expenses,healthcare,-77.55,-15995.24
buyer_4,Marc,Andreu,1974-05-23,54922038Q,marc.andreu@brilliantapp.app,964991,ES19209587111785551517,5949.75,2022-08-18T14:15:07,Barcelona,expenses,appliances,-152.42,-16147.66
buyer_4,Marc,Andreu,1974-05-23,54922038Q,marc.andreu@brilliantapp.app,964991,ES19209587111785551517,5949.75,2022-08-20T09:22:11,Barcelona,expenses,education,-59.97,-16207.63
buyer_4,Marc,Andreu,1974-05-23,54922038Q,marc.andreu@brilliantapp.app,964991,ES19209587111785551517,5949.75,2022-08-21T09:51:01,Barcelona,expenses,leisure,-42.59,-16250.22
buyer_4,Marc,Andreu,1974-05-23,54922038Q,marc.andreu@brilliantapp.app,964991,ES19209587111785551517,5949.75,2022-08-22T04:55:02,Barcelona,expenses,food,-101.52,-16351.74
buyer_4,Marc,Andreu,1974-05-23,54922038Q,marc.andreu@brilliantapp.app,964991,ES19209587111785551517,5949.75,2022-08-24T10:09:39,Barcelona,expenses,transport,-85.06,-16436.8
buyer_4,Marc,Andreu,1974-05-23,54922038Q,marc.andreu@brilliantapp.app,964991,ES19209587111785551517,5949.75,2022-08-25T20:21:12,Barcelona,expenses,cash,-100.0,-16536.8
buyer_4,Marc,Andreu,1974-05-23,54922038Q,marc.andreu@brilliantapp.app,964991,ES19209587111785551517,5949.75,2022-08-26T02:51:51,Barcelona,expenses,food,-120.81,-16657.61
buyer_4,Marc,Andreu,1974-05-23,54922038Q,marc.andreu@brilliantapp.app,964991,ES19209587111785551517,5949.75,2022-08-28T15:29:38,Barcelona,expenses,transport,-71.22,-16728.83
buyer_4,Marc,Andreu,1974-05-23,54922038Q,marc.andreu@brilliantapp.app,964991,ES19209587111785551517,5949.75,2022-08-28T20:53:17,Barcelona,expenses,cash,-100.0,-16828.83
buyer_4,Marc,Andreu,1974-05-23,54922038Q,marc.andreu@brilliantapp.app,964991,ES19209587111785551517,5949.75,2022-09-01T18:29:39,Barcelona,incomes,salary,2832.82,-13996.01
buyer_4,Marc,Andreu,1974-05-23,54922038Q,marc.andreu@brilliantapp.app,964991,ES19209587111785551517,5949.75,2022-09-01T06:13:52,Barcelona,expenses,food,-95.14,-14091.15
buyer_4,Marc,Andreu,1974-05-23,54922038Q,marc.andreu@brilliantapp.app,964991,ES19209587111785551517,5949.75,2022-09-02T19:52:23,Barcelona,expenses,healthcare,-65.5,-14156.65
buyer_4,Marc,Andreu,1974-05-23,54922038Q,marc.andreu@brilliantapp.app,964991,ES19209587111785551517,5949.75,2022-09-05T14:11:16,Barcelona,expenses,mortgage,-1458.7,-15615.35
buyer_4,Marc,Andreu,1974-05-23,54922038Q,marc.andreu@brilliantapp.app,964991,ES19209587111785551517,5949.75,2022-09-05T15:18:01,Barcelona,expenses,electricity,-72.67,-15688.02
buyer_4,Marc,Andreu,1974-05-23,54922038Q,marc.andreu@brilliantapp.app,964991,ES19209587111785551517,5949.75,2022-09-05T20:16:59,Barcelona,expenses,food,-92.57,-15780.59
buyer_4,Marc,Andreu,1974-05-23,54922038Q,marc.andreu@brilliantapp.app,964991,ES19209587111785551517,5949.75,2022-09-05T09:36:29,Barcelona,expenses,leisure,-70.67,-15851.26
buyer_4,Marc,Andreu,1974-05-23,54922038Q,marc.andreu@brilliantapp.app,964991,ES19209587111785551517,5949.75,2022-09-06T08:29:57,Barcelona,expenses,water,-31.02,-15882.28
buyer_4,Marc,Andreu,1974-05-23,54922038Q,marc.andreu@brilliantapp.app,964991,ES19209587111785551517,5949.75,2022-09-06T05:10:10,Barcelona,expenses,internet,-59.49,-15941.77
buyer_4,Marc,Andreu,1974-05-23,54922038Q,marc.andreu@brilliantapp.app,964991,ES19209587111785551517,5949.75,2022-09-06T17:53:37,Barcelona,expenses,leisure,-56.28,-15998.05
buyer_4,Marc,Andreu,1974-05-23,54922038Q,marc.andreu@brilliantapp.app,964991,ES19209587111785551517,5949.75,2022-09-07T10:39:47,Barcelona,expenses,gas,-119.84,-16117.89
buyer_4,Marc,Andreu,1974-05-23,54922038Q,marc.andreu@brilliantapp.app,964991,ES19209587111785551517,5949.75,2022-09-07T08:16:23,Barcelona,expenses,transport,-65.55,-16183.44
buyer_4,Marc,Andreu,1974-05-23,54922038Q,marc.andreu@brilliantapp.app,964991,ES19209587111785551517,5949.75,2022-09-07T11:35:49,Barcelona,expenses,leisure,-58.91,-16242.35
buyer_4,Marc,Andreu,1974-05-23,54922038Q,marc.andreu@brilliantapp.app,964991,ES19209587111785551517,5949.75,2022-09-07T19:40:40,Barcelona,expenses,repairs,-247.24,-16489.59
buyer_4,Marc,Andreu,1974-05-23,54922038Q,marc.andreu@brilliantapp.app,964991,ES19209587111785551517,5949.75,2022-09-08T23:20:18,Barcelona,expenses,gas,-42.55,-16532.14
buyer_4,Marc,Andreu,1974-05-23,54922038Q,marc.andreu@brilliantapp.app,964991,ES19209587111785551517,5949.75,2022-09-08T00:36:11,Barcelona,expenses,cash,-100.0,-16632.14
buyer_4,Marc,Andreu,1974-05-23,54922038Q,marc.andreu@brilliantapp.app,964991,ES19209587111785551517,5949.75,2022-09-08T09:15:11,Barcelona,expenses,repairs,-41.37,-16673.51
buyer_4,Marc,Andreu,1974-05-23,54922038Q,marc.andreu@brilliantapp.app,964991,ES19209587111785551517,5949.75,2022-09-09T23:26:19,Barcelona,expenses,education,-48.79,-16722.3
buyer_4,Marc,Andreu,1974-05-23,54922038Q,marc.andreu@brilliantapp.app,964991,ES19209587111785551517,5949.75,2022-09-10T00:06:09,Barcelona,expenses,leisure,-77.73,-16800.03
buyer_4,Marc,Andreu,1974-05-23,54922038Q,marc.andreu@brilliantapp.app,964991,ES19209587111785551517,5949.75,2022-09-12T23:17:42,Barcelona,expenses,gifts,-504.14,-17304.17
buyer_4,Marc,Andreu,1974-05-23,54922038Q,marc.andreu@brilliantapp.app,964991,ES19209587111785551517,5949.75,2022-09-13T19:24:13,Barcelona,expenses,education,-63.8,-17367.97
buyer_4,Marc,Andreu,1974-05-23,54922038Q,marc.andreu@brilliantapp.app,964991,ES19209587111785551517,5949.75,2022-09-15T15:29:43,Barcelona,expenses,healthcare,-62.23,-17430.2
buyer_4,Marc,Andreu,1974-05-23,54922038Q,marc.andreu@brilliantapp.app,964991,ES19209587111785551517,5949.75,2022-09-15T13:47:01,Barcelona,expenses,cash,-100.0,-17530.2
buyer_4,Marc,Andreu,1974-05-23,54922038Q,marc.andreu@brilliantapp.app,964991,ES19209587111785551517,5949.75,2022-09-19T22:41:32,Barcelona,expenses,transport,-69.97,-17600.17
buyer_4,Marc,Andreu,1974-05-23,54922038Q,marc.andreu@brilliantapp.app,964991,ES19209587111785551517,5949.75,2022-09-19T18:26:59,Barcelona,expenses,repairs,-286.09,-17886.26
buyer_4,Marc,Andreu,1974-05-23,54922038Q,marc.andreu@brilliantapp.app,964991,ES19209587111785551517,5949.75,2022-09-21T11:48:20,Barcelona,expenses,transport,-72.92,-17959.18
buyer_4,Marc,Andreu,1974-05-23,54922038Q,marc.andreu@brilliantapp.app,964991,ES19209587111785551517,5949.75,2022-09-21T16:56:29,Barcelona,expenses,leisure,-22.09,-17981.27
buyer_4,Marc,Andreu,1974-05-23,54922038Q,marc.andreu@brilliantapp.app,964991,ES19209587111785551517,5949.75,2022-09-23T10:44:34,Barcelona,expenses,cash,-100.0,-18081.27
buyer_4,Marc,Andreu,1974-05-23,54922038Q,marc.andreu@brilliantapp.app,964991,ES19209587111785551517,5949.75,2022-09-26T20:45:18,Barcelona,expenses,leisure,-44.89,-18126.16
buyer_4,Marc,Andreu,1974-05-23,54922038Q,marc.andreu@brilliantapp.app,964991,ES19209587111785551517,5949.75,2022-09-27T22:02:54,Barcelona,expenses,repairs,-44.46,-18170.62
buyer_4,Marc,Andreu,1974-05-23,54922038Q,marc.andreu@brilliantapp.app,964991,ES19209587111785551517,5949.75,2022-09-30T15:13:11,Barcelona,expenses,food,-116.94,-18287.56
buyer_4,Marc,Andreu,1974-05-23,54922038Q,marc.andreu@brilliantapp.app,964991,ES19209587111785551517,5949.75,2022-09-30T16:09:00,Barcelona,expenses,leisure,-30.65,-18318.21
buyer_4,Marc,Andreu,1974-05-23,54922038Q,marc.andreu@brilliantapp.app,964991,ES19209587111785551517,5949.75,2022-10-01T07:17:13,Barcelona,incomes,salary,2832.82,-15485.39
buyer_4,Marc,Andreu,1974-05-23,54922038Q,marc.andreu@brilliantapp.app,964991,ES19209587111785551517,5949.75,2022-10-01T23:30:12,Barcelona,expenses,leisure,-31.88,-15517.27
buyer_4,Marc,Andreu,1974-05-23,54922038Q,marc.andreu@brilliantapp.app,964991,ES19209587111785551517,5949.75,2022-10-02T18:54:46,Barcelona,expenses,transport,-40.6,-15557.87
buyer_4,Marc,Andreu,1974-05-23,54922038Q,marc.andreu@brilliantapp.app,964991,ES19209587111785551517,5949.75,2022-10-03T14:25:33,Barcelona,expenses,transport,-72.75,-15630.62
buyer_4,Marc,Andreu,1974-05-23,54922038Q,marc.andreu@brilliantapp.app,964991,ES19209587111785551517,5949.75,2022-10-05T11:17:19,Barcelona,expenses,mortgage,-1458.7,-17089.32
buyer_4,Marc,Andreu,1974-05-23,54922038Q,marc.andreu@brilliantapp.app,964991,ES19209587111785551517,5949.75,2022-10-05T16:55:22,Barcelona,expenses,leisure,-73.97,-17163.29
buyer_4,Marc,Andreu,1974-05-23,54922038Q,marc.andreu@brilliantapp.app,964991,ES19209587111785551517,5949.75,2022-10-05T10:07:32,Barcelona,expenses,travel,-505.06,-17668.35
buyer_4,Marc,Andreu,1974-05-23,54922038Q,marc.andreu@brilliantapp.app,964991,ES19209587111785551517,5949.75,2022-10-06T16:05:54,Barcelona,expenses,gas,-126.42,-17794.77
buyer_4,Marc,Andreu,1974-05-23,54922038Q,marc.andreu@brilliantapp.app,964991,ES19209587111785551517,5949.75,2022-10-06T18:06:11,Barcelona,expenses,cash,-100.0,-17894.77
buyer_4,Marc,Andreu,1974-05-23,54922038Q,marc.andreu@brilliantapp.app,964991,ES19209587111785551517,5949.75,2022-10-07T03:25:23,Barcelona,expenses,internet,-59.49,-17954.26
buyer_4,Marc,Andreu,1974-05-23,54922038Q,marc.andreu@brilliantapp.app,964991,ES19209587111785551517,5949.75,2022-10-08T09:46:28,Barcelona,expenses,water,-55.55,-18009.81
buyer_4,Marc,Andreu,1974-05-23,54922038Q,marc.andreu@brilliantapp.app,964991,ES19209587111785551517,5949.75,2022-10-08T11:59:23,Barcelona,expenses,internet,-59.49,-18069.3
buyer_4,Marc,Andreu,1974-05-23,54922038Q,marc.andreu@brilliantapp.app,964991,ES19209587111785551517,5949.75,2022-10-08T16:35:56,Barcelona,expenses,cash,-100.0,-18169.3
buyer_4,Marc,Andreu,1974-05-23,54922038Q,marc.andreu@brilliantapp.app,964991,ES19209587111785551517,5949.75,2022-10-11T16:49:46,Barcelona,expenses,leisure,-58.39,-18227.69
buyer_4,Marc,Andreu,1974-05-23,54922038Q,marc.andreu@brilliantapp.app,964991,ES19209587111785551517,5949.75,2022-10-12T13:12:53,Barcelona,expenses,clothing,-123.43,-18351.12
buyer_4,Marc,Andreu,1974-05-23,54922038Q,marc.andreu@brilliantapp.app,964991,ES19209587111785551517,5949.75,2022-10-12T09:35:10,Barcelona,expenses,cash,-100.0,-18451.12
buyer_4,Marc,Andreu,1974-05-23,54922038Q,marc.andreu@brilliantapp.app,964991,ES19209587111785551517,5949.75,2022-10-15T14:57:08,Barcelona,expenses,food,-106.83,-18557.95
buyer_4,Marc,Andreu,1974-05-23,54922038Q,marc.andreu@brilliantapp.app,964991,ES19209587111785551517,5949.75,2022-10-16T23:06:31,Barcelona,expenses,cash,-100.0,-18657.95
buyer_4,Marc,Andreu,1974-05-23,54922038Q,marc.andreu@brilliantapp.app,964991,ES19209587111785551517,5949.75,2022-10-17T19:15:21,Barcelona,expenses,repairs,-152.43,-18810.38
buyer_4,Marc,Andreu,1974-05-23,54922038Q,marc.andreu@brilliantapp.app,964991,ES19209587111785551517,5949.75,2022-10-17T02:05:27,Barcelona,expenses,gifts,-103.49,-18913.87
buyer_4,Marc,Andreu,1974-05-23,54922038Q,marc.andreu@brilliantapp.app,964991,ES19209587111785551517,5949.75,2022-10-18T15:23:04,Barcelona,expenses,food,-71.13,-18985.0
buyer_4,Marc,Andreu,1974-05-23,54922038Q,marc.andreu@brilliantapp.app,964991,ES19209587111785551517,5949.75,2022-10-18T19:26:18,Barcelona,expenses,leisure,-57.04,-19042.04
buyer_4,Marc,Andreu,1974-05-23,54922038Q,marc.andreu@brilliantapp.app,964991,ES19209587111785551517,5949.75,2022-10-19T19:17:39,Barcelona,expenses,transport,-80.97,-19123.01
buyer_4,Marc,Andreu,1974-05-23,54922038Q,marc.andreu@brilliantapp.app,964991,ES19209587111785551517,5949.75,2022-10-22T08:42:17,Barcelona,expenses,cash,-100.0,-19223.01
buyer_4,Marc,Andreu,1974-05-23,54922038Q,marc.andreu@brilliantapp.app,964991,ES19209587111785551517,5949.75,2022-10-23T13:16:31,Barcelona,expenses,cash,-100.0,-19323.01
buyer_4,Marc,Andreu,1974-05-23,54922038Q,marc.andreu@brilliantapp.app,964991,ES19209587111785551517,5949.75,2022-10-24T18:51:30,Barcelona,expenses,gifts,-675.55,-19998.56
buyer_4,Marc,Andreu,1974-05-23,54922038Q,marc.andreu@brilliantapp.app,964991,ES19209587111785551517,5949.75,2022-10-26T11:12:32,Barcelona,expenses,healthcare,-121.46,-20120.02
buyer_4,Marc,Andreu,1974-05-23,54922038Q,marc.andreu@brilliantapp.app,964991,ES19209587111785551517,5949.75,2022-10-27T13:46:57,Barcelona,expenses,education,-45.77,-20165.79
buyer_4,Marc,Andreu,1974-05-23,54922038Q,marc.andreu@brilliantapp.app,964991,ES19209587111785551517,5949.75,2022-10-28T15:06:02,Barcelona,expenses,food,-81.92,-20247.71
buyer_4,Marc,Andreu,1974-05-23,54922038Q,marc.andreu@brilliantapp.app,964991,ES19209587111785551517,5949.75,2022-10-30T10:42:03,Barcelona,expenses,transport,-86.0,-20333.71
buyer_4,Marc,Andreu,1974-05-23,54922038Q,marc.andreu@brilliantapp.app,964991,ES19209587111785551517,5949.75,2022-10-30T17:51:15,Barcelona,expenses,leisure,-64.31,-20398.02
buyer_4,Marc,Andreu,1974-05-23,54922038Q,marc.andreu@brilliantapp.app,964991,ES19209587111785551517,5949.75,2022-10-31T10:47:24,Barcelona,expenses,appliances,-372.64,-20770.66
buyer_4,Marc,Andreu,1974-05-23,54922038Q,marc.andreu@brilliantapp.app,964991,ES19209587111785551517,5949.75,2022-11-01T10:57:30,Barcelona,incomes,salary,2832.82,-17937.84
buyer_4,Marc,Andreu,1974-05-23,54922038Q,marc.andreu@brilliantapp.app,964991,ES19209587111785551517,5949.75,2022-11-01T10:57:30,Barcelona,incomes,extra_income,514.74,-17423.1
buyer_4,Marc,Andreu,1974-05-23,54922038Q,marc.andreu@brilliantapp.app,964991,ES19209587111785551517,5949.75,2022-11-02T15:30:32,Barcelona,expenses,cash,-100.0,-17523.1
buyer_4,Marc,Andreu,1974-05-23,54922038Q,marc.andreu@brilliantapp.app,964991,ES19209587111785551517,5949.75,2022-11-03T09:42:27,Barcelona,expenses,cash,-100.0,-17623.1
buyer_4,Marc,Andreu,1974-05-23,54922038Q,marc.andreu@brilliantapp.app,964991,ES19209587111785551517,5949.75,2022-11-05T13:28:59,Barcelona,expenses,mortgage,-1458.7,-19081.8
buyer_4,Marc,Andreu,1974-05-23,54922038Q,marc.andreu@brilliantapp.app,964991,ES19209587111785551517,5949.75,2022-11-05T01:10:42,Barcelona,expenses,electricity,-30.24,-19112.04
buyer_4,Marc,Andreu,1974-05-23,54922038Q,marc.andreu@brilliantapp.app,964991,ES19209587111785551517,5949.75,2022-11-05T08:26:58,Barcelona,expenses,phone,-56.94,-19168.98
buyer_4,Marc,Andreu,1974-05-23,54922038Q,marc.andreu@brilliantapp.app,964991,ES19209587111785551517,5949.75,2022-11-06T13:30:33,Barcelona,expenses,leisure,-44.63,-19213.61
buyer_4,Marc,Andreu,1974-05-23,54922038Q,marc.andreu@brilliantapp.app,964991,ES19209587111785551517,5949.75,2022-11-06T02:29:48,Barcelona,expenses,gifts,-506.29,-19719.9
buyer_4,Marc,Andreu,1974-05-23,54922038Q,marc.andreu@brilliantapp.app,964991,ES19209587111785551517,5949.75,2022-11-07T03:24:00,Barcelona,expenses,phone,-63.64,-19783.54
buyer_4,Marc,Andreu,1974-05-23,54922038Q,marc.andreu@brilliantapp.app,964991,ES19209587111785551517,5949.75,2022-11-07T14:42:47,Barcelona,expenses,leisure,-41.04,-19824.58
buyer_4,Marc,Andreu,1974-05-23,54922038Q,marc.andreu@brilliantapp.app,964991,ES19209587111785551517,5949.75,2022-11-08T12:16:36,Barcelona,expenses,water,-58.48,-19883.06
buyer_4,Marc,Andreu,1974-05-23,54922038Q,marc.andreu@brilliantapp.app,964991,ES19209587111785551517,5949.75,2022-11-08T18:17:11,Barcelona,expenses,gas,-125.21,-20008.27
buyer_4,Marc,Andreu,1974-05-23,54922038Q,marc.andreu@brilliantapp.app,964991,ES19209587111785551517,5949.75,2022-11-10T06:49:05,Barcelona,expenses,leisure,-74.77,-20083.04
buyer_4,Marc,Andreu,1974-05-23,54922038Q,marc.andreu@brilliantapp.app,964991,ES19209587111785551517,5949.75,2022-11-13T22:20:51,Barcelona,expenses,healthcare,-152.22,-20235.26
buyer_4,Marc,Andreu,1974-05-23,54922038Q,marc.andreu@brilliantapp.app,964991,ES19209587111785551517,5949.75,2022-11-15T15:26:06,Barcelona,expenses,cash,-100.0,-20335.26
buyer_4,Marc,Andreu,1974-05-23,54922038Q,marc.andreu@brilliantapp.app,964991,ES19209587111785551517,5949.75,2022-11-18T14:11:59,Barcelona,expenses,clothing,-66.1,-20401.36
buyer_4,Marc,Andreu,1974-05-23,54922038Q,marc.andreu@brilliantapp.app,964991,ES19209587111785551517,5949.75,2022-11-20T09:54:27,Barcelona,expenses,food,-73.27,-20474.63
buyer_4,Marc,Andreu,1974-05-23,54922038Q,marc.andreu@brilliantapp.app,964991,ES19209587111785551517,5949.75,2022-11-21T10:40:58,Barcelona,expenses,transport,-85.88,-20560.51
buyer_4,Marc,Andreu,1974-05-23,54922038Q,marc.andreu@brilliantapp.app,964991,ES19209587111785551517,5949.75,2022-11-21T08:31:21,Barcelona,expenses,cash,-100.0,-20660.51
buyer_4,Marc,Andreu,1974-05-23,54922038Q,marc.andreu@brilliantapp.app,964991,ES19209587111785551517,5949.75,2022-11-21T22:10:03,Barcelona,expenses,repairs,-158.63,-20819.14
buyer_4,Marc,Andreu,1974-05-23,54922038Q,marc.andreu@brilliantapp.app,964991,ES19209587111785551517,5949.75,2022-11-22T02:30:01,Barcelona,expenses,leisure,-61.01,-20880.15
buyer_4,Marc,Andreu,1974-05-23,54922038Q,marc.andreu@brilliantapp.app,964991,ES19209587111785551517,5949.75,2022-11-23T19:10:22,Barcelona,expenses,repairs,-231.07,-21111.22
buyer_4,Marc,Andreu,1974-05-23,54922038Q,marc.andreu@brilliantapp.app,964991,ES19209587111785551517,5949.75,2022-11-25T18:53:11,Barcelona,expenses,cash,-100.0,-21211.22
buyer_4,Marc,Andreu,1974-05-23,54922038Q,marc.andreu@brilliantapp.app,964991,ES19209587111785551517,5949.75,2022-11-28T10:19:27,Barcelona,expenses,cash,-100.0,-21311.22
buyer_4,Marc,Andreu,1974-05-23,54922038Q,marc.andreu@brilliantapp.app,964991,ES19209587111785551517,5949.75,2022-11-28T15:05:31,Barcelona,expenses,repairs,-233.88,-21545.1
buyer_4,Marc,Andreu,1974-05-23,54922038Q,marc.andreu@brilliantapp.app,964991,ES19209587111785551517,5949.75,2022-11-29T14:19:51,Barcelona,expenses,transport,-57.89,-21602.99
buyer_4,Marc,Andreu,1974-05-23,54922038Q,marc.andreu@brilliantapp.app,964991,ES19209587111785551517,5949.75,2022-11-29T18:44:37,Barcelona,expenses,cash,-100.0,-21702.99
buyer_4,Marc,Andreu,1974-05-23,54922038Q,marc.andreu@brilliantapp.app,964991,ES19209587111785551517,5949.75,2022-11-30T13:19:10,Barcelona,expenses,food,-113.61,-21816.6
buyer_4,Marc,Andreu,1974-05-23,54922038Q,marc.andreu@brilliantapp.app,964991,ES19209587111785551517,5949.75,2022-12-01T17:12:30,Barcelona,incomes,salary,2832.82,-18983.78
buyer_4,Marc,Andreu,1974-05-23,54922038Q,marc.andreu@brilliantapp.app,964991,ES19209587111785551517,5949.75,2022-12-01T17:12:30,Barcelona,incomes,salary_bonus,1996.08,-16987.7
buyer_4,Marc,Andreu,1974-05-23,54922038Q,marc.andreu@brilliantapp.app,964991,ES19209587111785551517,5949.75,2022-12-04T08:28:33,Barcelona,expenses,cash,-100.0,-17087.7
buyer_4,Marc,Andreu,1974-05-23,54922038Q,marc.andreu@brilliantapp.app,964991,ES19209587111785551517,5949.75,2022-12-05T11:09:34,Barcelona,expenses,mortgage,-1458.7,-18546.4
buyer_4,Marc,Andreu,1974-05-23,54922038Q,marc.andreu@brilliantapp.app,964991,ES19209587111785551517,5949.75,2022-12-06T08:38:39,Barcelona,expenses,cash,-100.0,-18646.4
buyer_4,Marc,Andreu,1974-05-23,54922038Q,marc.andreu@brilliantapp.app,964991,ES19209587111785551517,5949.75,2022-12-07T17:32:56,Barcelona,expenses,water,-36.34,-18682.74
buyer_4,Marc,Andreu,1974-05-23,54922038Q,marc.andreu@brilliantapp.app,964991,ES19209587111785551517,5949.75,2022-12-07T19:01:38,Barcelona,expenses,repairs,-87.24,-18769.98
buyer_4,Marc,Andreu,1974-05-23,54922038Q,marc.andreu@brilliantapp.app,964991,ES19209587111785551517,5949.75,2022-12-08T18:27:21,Barcelona,expenses,phone,-53.85,-18823.83
buyer_4,Marc,Andreu,1974-05-23,54922038Q,marc.andreu@brilliantapp.app,964991,ES19209587111785551517,5949.75,2022-12-08T22:02:39,Barcelona,expenses,leisure,-45.69,-18869.52
buyer_4,Marc,Andreu,1974-05-23,54922038Q,marc.andreu@brilliantapp.app,964991,ES19209587111785551517,5949.75,2022-12-09T14:32:09,Barcelona,expenses,cash,-100.0,-18969.52
buyer_4,Marc,Andreu,1974-05-23,54922038Q,marc.andreu@brilliantapp.app,964991,ES19209587111785551517,5949.75,2022-12-10T12:51:59,Barcelona,expenses,repairs,-164.57,-19134.09
buyer_4,Marc,Andreu,1974-05-23,54922038Q,marc.andreu@brilliantapp.app,964991,ES19209587111785551517,5949.75,2022-12-12T19:25:00,Barcelona,expenses,food,-119.51,-19253.6
buyer_4,Marc,Andreu,1974-05-23,54922038Q,marc.andreu@brilliantapp.app,964991,ES19209587111785551517,5949.75,2022-12-13T10:16:04,Barcelona,expenses,cash,-100.0,-19353.6
buyer_4,Marc,Andreu,1974-05-23,54922038Q,marc.andreu@brilliantapp.app,964991,ES19209587111785551517,5949.75,2022-12-14T13:35:17,Barcelona,expenses,food,-79.33,-19432.93
buyer_4,Marc,Andreu,1974-05-23,54922038Q,marc.andreu@brilliantapp.app,964991,ES19209587111785551517,5949.75,2022-12-14T11:55:13,Barcelona,expenses,transport,-57.55,-19490.48
buyer_4,Marc,Andreu,1974-05-23,54922038Q,marc.andreu@brilliantapp.app,964991,ES19209587111785551517,5949.75,2022-12-15T14:09:04,Barcelona,expenses,education,-52.18,-19542.66
buyer_4,Marc,Andreu,1974-05-23,54922038Q,marc.andreu@brilliantapp.app,964991,ES19209587111785551517,5949.75,2022-12-16T15:22:58,Barcelona,expenses,cash,-100.0,-19642.66
buyer_4,Marc,Andreu,1974-05-23,54922038Q,marc.andreu@brilliantapp.app,964991,ES19209587111785551517,5949.75,2022-12-16T16:02:50,Barcelona,expenses,children,-743.788,-20386.45
buyer_4,Marc,Andreu,1974-05-23,54922038Q,marc.andreu@brilliantapp.app,964991,ES19209587111785551517,5949.75,2022-12-17T14:00:59,Barcelona,expenses,gifts,-304.22,-20690.67
buyer_4,Marc,Andreu,1974-05-23,54922038Q,marc.andreu@brilliantapp.app,964991,ES19209587111785551517,5949.75,2022-12-18T09:14:40,Barcelona,expenses,transport,-66.01,-20756.68
buyer_4,Marc,Andreu,1974-05-23,54922038Q,marc.andreu@brilliantapp.app,964991,ES19209587111785551517,5949.75,2022-12-19T15:27:55,Barcelona,expenses,clothing,-97.97,-20854.65
buyer_4,Marc,Andreu,1974-05-23,54922038Q,marc.andreu@brilliantapp.app,964991,ES19209587111785551517,5949.75,2022-12-21T18:16:24,Barcelona,expenses,transport,-52.89,-20907.54
buyer_4,Marc,Andreu,1974-05-23,54922038Q,marc.andreu@brilliantapp.app,964991,ES19209587111785551517,5949.75,2022-12-21T10:16:30,Barcelona,expenses,cash,-100.0,-21007.54
buyer_4,Marc,Andreu,1974-05-23,54922038Q,marc.andreu@brilliantapp.app,964991,ES19209587111785551517,5949.75,2022-12-23T08:42:01,Barcelona,expenses,cash,-100.0,-21107.54
buyer_4,Marc,Andreu,1974-05-23,54922038Q,marc.andreu@brilliantapp.app,964991,ES19209587111785551517,5949.75,2022-12-24T19:23:39,Barcelona,expenses,leisure,-62.63,-21170.17
buyer_4,Marc,Andreu,1974-05-23,54922038Q,marc.andreu@brilliantapp.app,964991,ES19209587111785551517,5949.75,2022-12-24T23:50:39,Barcelona,expenses,cash,-100.0,-21270.17
buyer_4,Marc,Andreu,1974-05-23,54922038Q,marc.andreu@brilliantapp.app,964991,ES19209587111785551517,5949.75,2022-12-25T08:46:52,Barcelona,expenses,transport,-40.88,-21311.05
buyer_4,Marc,Andreu,1974-05-23,54922038Q,marc.andreu@brilliantapp.app,964991,ES19209587111785551517,5949.75,2022-12-26T07:51:01,Barcelona,expenses,food,-112.92,-21423.97
buyer_4,Marc,Andreu,1974-05-23,54922038Q,marc.andreu@brilliantapp.app,964991,ES19209587111785551517,5949.75,2022-12-26T15:21:53,Barcelona,expenses,repairs,-267.81,-21691.78
buyer_4,Marc,Andreu,1974-05-23,54922038Q,marc.andreu@brilliantapp.app,964991,ES19209587111785551517,5949.75,2022-12-29T04:37:08,Barcelona,expenses,leisure,-43.47,-21735.25
buyer_4,Marc,Andreu,1974-05-23,54922038Q,marc.andreu@brilliantapp.app,964991,ES19209587111785551517,5949.75,2022-12-29T16:47:09,Barcelona,expenses,education,-49.91,-21785.16
buyer_4,Marc,Andreu,1974-05-23,54922038Q,marc.andreu@brilliantapp.app,964991,ES19209587111785551517,5949.75,2022-12-29T02:57:15,Barcelona,expenses,repairs,-38.66,-21823.82
buyer_4,Marc,Andreu,1974-05-23,54922038Q,marc.andreu@brilliantapp.app,964991,ES19209587111785551517,5949.75,2022-12-31T17:14:57,Barcelona,expenses,travel,-817.21,-22641.03
buyer_4,Marc,Andreu,1974-05-23,54922038Q,marc.andreu@brilliantapp.app,964991,ES19209587111785551517,5949.75,2022-12-31T13:32:27,Barcelona,expenses,children,-26.577999999999975,-22667.61
buyer_4,Marc,Andreu,1974-05-23,54922038Q,marc.andreu@brilliantapp.app,964991,ES19209587111785551517,5949.75,2023-01-01T09:08:04,Barcelona,incomes,salary,2920.57,-19747.04
buyer_4,Marc,Andreu,1974-05-23,54922038Q,marc.andreu@brilliantapp.app,964991,ES19209587111785551517,5949.75,2023-01-01T08:13:19,Barcelona,expenses,food,-95.88,-19842.92
buyer_4,Marc,Andreu,1974-05-23,54922038Q,marc.andreu@brilliantapp.app,964991,ES19209587111785551517,5949.75,2023-01-01T22:15:31,Barcelona,expenses,education,-66.08,-19909.0
buyer_4,Marc,Andreu,1974-05-23,54922038Q,marc.andreu@brilliantapp.app,964991,ES19209587111785551517,5949.75,2023-01-01T17:01:19,Barcelona,expenses,cash,-100.0,-20009.0
buyer_4,Marc,Andreu,1974-05-23,54922038Q,marc.andreu@brilliantapp.app,964991,ES19209587111785551517,5949.75,2023-01-02T15:13:08,Barcelona,expenses,clothing,-54.14,-20063.14
buyer_4,Marc,Andreu,1974-05-23,54922038Q,marc.andreu@brilliantapp.app,964991,ES19209587111785551517,5949.75,2023-01-02T23:11:01,Barcelona,expenses,gifts,-401.88,-20465.02
buyer_4,Marc,Andreu,1974-05-23,54922038Q,marc.andreu@brilliantapp.app,964991,ES19209587111785551517,5949.75,2023-01-03T12:46:59,Barcelona,expenses,food,-66.14,-20531.16
buyer_4,Marc,Andreu,1974-05-23,54922038Q,marc.andreu@brilliantapp.app,964991,ES19209587111785551517,5949.75,2023-01-04T13:20:02,Barcelona,expenses,food,-118.38,-20649.54
buyer_4,Marc,Andreu,1974-05-23,54922038Q,marc.andreu@brilliantapp.app,964991,ES19209587111785551517,5949.75,2023-01-04T11:55:16,Barcelona,expenses,repairs,-290.76,-20940.3
buyer_4,Marc,Andreu,1974-05-23,54922038Q,marc.andreu@brilliantapp.app,964991,ES19209587111785551517,5949.75,2023-01-05T23:57:26,Barcelona,expenses,mortgage,-1298.01,-22238.31
buyer_4,Marc,Andreu,1974-05-23,54922038Q,marc.andreu@brilliantapp.app,964991,ES19209587111785551517,5949.75,2023-01-05T12:49:21,Barcelona,expenses,water,-48.19,-22286.5
buyer_4,Marc,Andreu,1974-05-23,54922038Q,marc.andreu@brilliantapp.app,964991,ES19209587111785551517,5949.75,2023-01-05T17:01:58,Barcelona,expenses,leisure,-69.47,-22355.97
buyer_4,Marc,Andreu,1974-05-23,54922038Q,marc.andreu@brilliantapp.app,964991,ES19209587111785551517,5949.75,2023-01-05T09:27:23,Barcelona,expenses,cash,-100.0,-22455.97
buyer_4,Marc,Andreu,1974-05-23,54922038Q,marc.andreu@brilliantapp.app,964991,ES19209587111785551517,5949.75,2023-01-06T02:34:08,Barcelona,expenses,internet,-61.33,-22517.3
buyer_4,Marc,Andreu,1974-05-23,54922038Q,marc.andreu@brilliantapp.app,964991,ES19209587111785551517,5949.75,2023-01-06T12:32:11,Barcelona,expenses,food,-85.7,-22603.0
buyer_4,Marc,Andreu,1974-05-23,54922038Q,marc.andreu@brilliantapp.app,964991,ES19209587111785551517,5949.75,2023-01-06T18:40:14,Barcelona,expenses,leisure,-49.9,-22652.9
buyer_4,Marc,Andreu,1974-05-23,54922038Q,marc.andreu@brilliantapp.app,964991,ES19209587111785551517,5949.75,2023-01-06T11:06:57,Barcelona,expenses,appliances,-89.95,-22742.85
buyer_4,Marc,Andreu,1974-05-23,54922038Q,marc.andreu@brilliantapp.app,964991,ES19209587111785551517,5949.75,2023-01-06T08:04:00,Barcelona,expenses,repairs,-199.0,-22941.85
buyer_4,Marc,Andreu,1974-05-23,54922038Q,marc.andreu@brilliantapp.app,964991,ES19209587111785551517,5949.75,2023-01-07T14:01:24,Barcelona,expenses,internet,-61.33,-23003.18
buyer_4,Marc,Andreu,1974-05-23,54922038Q,marc.andreu@brilliantapp.app,964991,ES19209587111785551517,5949.75,2023-01-07T18:21:19,Barcelona,expenses,food,-101.68,-23104.86
buyer_4,Marc,Andreu,1974-05-23,54922038Q,marc.andreu@brilliantapp.app,964991,ES19209587111785551517,5949.75,2023-01-07T11:27:22,Barcelona,expenses,healthcare,-113.91,-23218.77
buyer_4,Marc,Andreu,1974-05-23,54922038Q,marc.andreu@brilliantapp.app,964991,ES19209587111785551517,5949.75,2023-01-08T20:23:22,Barcelona,expenses,water,-58.1,-23276.87
buyer_4,Marc,Andreu,1974-05-23,54922038Q,marc.andreu@brilliantapp.app,964991,ES19209587111785551517,5949.75,2023-01-08T19:34:04,Barcelona,expenses,healthcare,-175.33,-23452.2
buyer_4,Marc,Andreu,1974-05-23,54922038Q,marc.andreu@brilliantapp.app,964991,ES19209587111785551517,5949.75,2023-01-10T23:47:17,Barcelona,expenses,food,-78.89,-23531.09
buyer_4,Marc,Andreu,1974-05-23,54922038Q,marc.andreu@brilliantapp.app,964991,ES19209587111785551517,5949.75,2023-01-10T10:16:24,Barcelona,expenses,leisure,-51.42,-23582.51
buyer_4,Marc,Andreu,1974-05-23,54922038Q,marc.andreu@brilliantapp.app,964991,ES19209587111785551517,5949.75,2023-01-11T14:26:16,Barcelona,expenses,transport,-85.93,-23668.44
buyer_4,Marc,Andreu,1974-05-23,54922038Q,marc.andreu@brilliantapp.app,964991,ES19209587111785551517,5949.75,2023-01-11T22:08:47,Barcelona,expenses,healthcare,-66.11,-23734.55
buyer_4,Marc,Andreu,1974-05-23,54922038Q,marc.andreu@brilliantapp.app,964991,ES19209587111785551517,5949.75,2023-01-13T18:38:04,Barcelona,expenses,food,-90.3,-23824.85
buyer_4,Marc,Andreu,1974-05-23,54922038Q,marc.andreu@brilliantapp.app,964991,ES19209587111785551517,5949.75,2023-01-13T13:05:18,Barcelona,expenses,cash,-100.0,-23924.85
buyer_4,Marc,Andreu,1974-05-23,54922038Q,marc.andreu@brilliantapp.app,964991,ES19209587111785551517,5949.75,2023-01-14T13:52:57,Barcelona,expenses,cash,-100.0,-24024.85
buyer_4,Marc,Andreu,1974-05-23,54922038Q,marc.andreu@brilliantapp.app,964991,ES19209587111785551517,5949.75,2023-01-15T18:46:59,Barcelona,expenses,cash,-100.0,-24124.85
buyer_4,Marc,Andreu,1974-05-23,54922038Q,marc.andreu@brilliantapp.app,964991,ES19209587111785551517,5949.75,2023-01-17T05:56:54,Barcelona,expenses,cash,-100.0,-24224.85
buyer_4,Marc,Andreu,1974-05-23,54922038Q,marc.andreu@brilliantapp.app,964991,ES19209587111785551517,5949.75,2023-01-17T00:22:03,Barcelona,expenses,repairs,-177.24,-24402.09
buyer_4,Marc,Andreu,1974-05-23,54922038Q,marc.andreu@brilliantapp.app,964991,ES19209587111785551517,5949.75,2023-01-18T15:35:46,Barcelona,expenses,leisure,-37.23,-24439.32
buyer_4,Marc,Andreu,1974-05-23,54922038Q,marc.andreu@brilliantapp.app,964991,ES19209587111785551517,5949.75,2023-01-19T21:33:20,Barcelona,expenses,leisure,-63.18,-24502.5
buyer_4,Marc,Andreu,1974-05-23,54922038Q,marc.andreu@brilliantapp.app,964991,ES19209587111785551517,5949.75,2023-01-20T10:27:04,Barcelona,expenses,cash,-100.0,-24602.5
buyer_4,Marc,Andreu,1974-05-23,54922038Q,marc.andreu@brilliantapp.app,964991,ES19209587111785551517,5949.75,2023-01-21T17:34:00,Barcelona,expenses,food,-76.64,-24679.14
buyer_4,Marc,Andreu,1974-05-23,54922038Q,marc.andreu@brilliantapp.app,964991,ES19209587111785551517,5949.75,2023-01-21T12:10:58,Barcelona,expenses,transport,-52.35,-24731.49
buyer_4,Marc,Andreu,1974-05-23,54922038Q,marc.andreu@brilliantapp.app,964991,ES19209587111785551517,5949.75,2023-01-22T14:20:30,Barcelona,expenses,leisure,-61.02,-24792.51
buyer_4,Marc,Andreu,1974-05-23,54922038Q,marc.andreu@brilliantapp.app,964991,ES19209587111785551517,5949.75,2023-01-22T12:52:33,Barcelona,expenses,cash,-100.0,-24892.51
buyer_4,Marc,Andreu,1974-05-23,54922038Q,marc.andreu@brilliantapp.app,964991,ES19209587111785551517,5949.75,2023-01-22T20:41:00,Barcelona,expenses,children,-998.0408333333339,-25890.55
buyer_4,Marc,Andreu,1974-05-23,54922038Q,marc.andreu@brilliantapp.app,964991,ES19209587111785551517,5949.75,2023-01-23T18:48:39,Barcelona,expenses,repairs,-106.18,-25996.73
buyer_4,Marc,Andreu,1974-05-23,54922038Q,marc.andreu@brilliantapp.app,964991,ES19209587111785551517,5949.75,2023-01-24T14:33:18,Barcelona,expenses,leisure,-31.81,-26028.54
buyer_4,Marc,Andreu,1974-05-23,54922038Q,marc.andreu@brilliantapp.app,964991,ES19209587111785551517,5949.75,2023-01-24T18:21:05,Barcelona,expenses,gifts,-43.35,-26071.89
buyer_4,Marc,Andreu,1974-05-23,54922038Q,marc.andreu@brilliantapp.app,964991,ES19209587111785551517,5949.75,2023-01-24T19:53:27,Barcelona,expenses,children,-1083.9008333333338,-27155.79
buyer_4,Marc,Andreu,1974-05-23,54922038Q,marc.andreu@brilliantapp.app,964991,ES19209587111785551517,5949.75,2023-01-26T20:05:41,Barcelona,expenses,cash,-100.0,-27255.79
buyer_4,Marc,Andreu,1974-05-23,54922038Q,marc.andreu@brilliantapp.app,964991,ES19209587111785551517,5949.75,2023-01-28T21:55:34,Barcelona,expenses,food,-60.18,-27315.97
buyer_4,Marc,Andreu,1974-05-23,54922038Q,marc.andreu@brilliantapp.app,964991,ES19209587111785551517,5949.75,2023-01-28T20:21:38,Barcelona,expenses,gifts,-71.25,-27387.22
buyer_4,Marc,Andreu,1974-05-23,54922038Q,marc.andreu@brilliantapp.app,964991,ES19209587111785551517,5949.75,2023-01-29T19:01:04,Barcelona,expenses,food,-98.4,-27485.62
buyer_4,Marc,Andreu,1974-05-23,54922038Q,marc.andreu@brilliantapp.app,964991,ES19209587111785551517,5949.75,2023-01-30T18:47:36,Barcelona,expenses,food,-91.74,-27577.36
buyer_4,Marc,Andreu,1974-05-23,54922038Q,marc.andreu@brilliantapp.app,964991,ES19209587111785551517,5949.75,2023-01-31T19:52:08,Barcelona,expenses,cash,-100.0,-27677.36
buyer_4,Marc,Andreu,1974-05-23,54922038Q,marc.andreu@brilliantapp.app,964991,ES19209587111785551517,5949.75,2023-02-01T15:54:30,Barcelona,incomes,salary,2920.57,-24756.79
buyer_4,Marc,Andreu,1974-05-23,54922038Q,marc.andreu@brilliantapp.app,964991,ES19209587111785551517,5949.75,2023-02-01T11:47:21,Barcelona,expenses,cash,-100.0,-24856.79
buyer_4,Marc,Andreu,1974-05-23,54922038Q,marc.andreu@brilliantapp.app,964991,ES19209587111785551517,5949.75,2023-02-01T06:31:43,Barcelona,expenses,gifts,-773.35,-25630.14
buyer_4,Marc,Andreu,1974-05-23,54922038Q,marc.andreu@brilliantapp.app,964991,ES19209587111785551517,5949.75,2023-02-02T11:53:23,Barcelona,expenses,healthcare,-119.08,-25749.22
buyer_4,Marc,Andreu,1974-05-23,54922038Q,marc.andreu@brilliantapp.app,964991,ES19209587111785551517,5949.75,2023-02-02T08:50:52,Barcelona,expenses,gifts,-386.07,-26135.29
buyer_4,Marc,Andreu,1974-05-23,54922038Q,marc.andreu@brilliantapp.app,964991,ES19209587111785551517,5949.75,2023-02-03T10:35:07,Barcelona,expenses,food,-114.11,-26249.4
buyer_4,Marc,Andreu,1974-05-23,54922038Q,marc.andreu@brilliantapp.app,964991,ES19209587111785551517,5949.75,2023-02-04T08:21:36,Barcelona,expenses,transport,-42.91,-26292.31
buyer_4,Marc,Andreu,1974-05-23,54922038Q,marc.andreu@brilliantapp.app,964991,ES19209587111785551517,5949.75,2023-02-05T08:52:50,Barcelona,expenses,mortgage,-1298.01,-27590.32
buyer_4,Marc,Andreu,1974-05-23,54922038Q,marc.andreu@brilliantapp.app,964991,ES19209587111785551517,5949.75,2023-02-05T14:23:48,Barcelona,expenses,gas,-70.62,-27660.94
buyer_4,Marc,Andreu,1974-05-23,54922038Q,marc.andreu@brilliantapp.app,964991,ES19209587111785551517,5949.75,2023-02-05T21:18:01,Barcelona,expenses,transport,-47.28,-27708.22
buyer_4,Marc,Andreu,1974-05-23,54922038Q,marc.andreu@brilliantapp.app,964991,ES19209587111785551517,5949.75,2023-02-06T08:25:42,Barcelona,expenses,food,-93.58,-27801.8
buyer_4,Marc,Andreu,1974-05-23,54922038Q,marc.andreu@brilliantapp.app,964991,ES19209587111785551517,5949.75,2023-02-06T14:34:49,Barcelona,expenses,repairs,-169.77,-27971.57
buyer_4,Marc,Andreu,1974-05-23,54922038Q,marc.andreu@brilliantapp.app,964991,ES19209587111785551517,5949.75,2023-02-07T12:14:57,Barcelona,expenses,internet,-61.33,-28032.9
buyer_4,Marc,Andreu,1974-05-23,54922038Q,marc.andreu@brilliantapp.app,964991,ES19209587111785551517,5949.75,2023-02-08T12:53:27,Barcelona,expenses,gas,-85.75,-28118.65
buyer_4,Marc,Andreu,1974-05-23,54922038Q,marc.andreu@brilliantapp.app,964991,ES19209587111785551517,5949.75,2023-02-08T07:16:35,Barcelona,expenses,internet,-61.33,-28179.98
buyer_4,Marc,Andreu,1974-05-23,54922038Q,marc.andreu@brilliantapp.app,964991,ES19209587111785551517,5949.75,2023-02-08T15:13:29,Barcelona,expenses,food,-84.15,-28264.13
buyer_4,Marc,Andreu,1974-05-23,54922038Q,marc.andreu@brilliantapp.app,964991,ES19209587111785551517,5949.75,2023-02-09T21:26:06,Barcelona,expenses,repairs,-63.33,-28327.46
buyer_4,Marc,Andreu,1974-05-23,54922038Q,marc.andreu@brilliantapp.app,964991,ES19209587111785551517,5949.75,2023-02-10T02:23:35,Barcelona,expenses,leisure,-73.02,-28400.48
buyer_4,Marc,Andreu,1974-05-23,54922038Q,marc.andreu@brilliantapp.app,964991,ES19209587111785551517,5949.75,2023-02-11T19:48:05,Barcelona,expenses,transport,-42.64,-28443.12
buyer_4,Marc,Andreu,1974-05-23,54922038Q,marc.andreu@brilliantapp.app,964991,ES19209587111785551517,5949.75,2023-02-12T11:38:50,Barcelona,expenses,food,-86.2,-28529.32
buyer_4,Marc,Andreu,1974-05-23,54922038Q,marc.andreu@brilliantapp.app,964991,ES19209587111785551517,5949.75,2023-02-14T05:40:35,Barcelona,expenses,gifts,-759.48,-29288.8
buyer_4,Marc,Andreu,1974-05-23,54922038Q,marc.andreu@brilliantapp.app,964991,ES19209587111785551517,5949.75,2023-02-15T13:01:29,Barcelona,expenses,leisure,-77.69,-29366.49
buyer_4,Marc,Andreu,1974-05-23,54922038Q,marc.andreu@brilliantapp.app,964991,ES19209587111785551517,5949.75,2023-02-15T11:36:41,Barcelona,expenses,children,-968.64,-30335.13
buyer_4,Marc,Andreu,1974-05-23,54922038Q,marc.andreu@brilliantapp.app,964991,ES19209587111785551517,5949.75,2023-02-16T06:39:06,Barcelona,expenses,food,-94.01,-30429.14
buyer_4,Marc,Andreu,1974-05-23,54922038Q,marc.andreu@brilliantapp.app,964991,ES19209587111785551517,5949.75,2023-02-17T13:21:50,Barcelona,expenses,cash,-100.0,-30529.14
buyer_4,Marc,Andreu,1974-05-23,54922038Q,marc.andreu@brilliantapp.app,964991,ES19209587111785551517,5949.75,2023-02-19T17:27:18,Barcelona,expenses,appliances,-184.92,-30714.06
buyer_4,Marc,Andreu,1974-05-23,54922038Q,marc.andreu@brilliantapp.app,964991,ES19209587111785551517,5949.75,2023-02-20T11:33:57,Barcelona,expenses,cash,-100.0,-30814.06
buyer_4,Marc,Andreu,1974-05-23,54922038Q,marc.andreu@brilliantapp.app,964991,ES19209587111785551517,5949.75,2023-02-21T17:28:07,Barcelona,expenses,healthcare,-186.62,-31000.68
buyer_4,Marc,Andreu,1974-05-23,54922038Q,marc.andreu@brilliantapp.app,964991,ES19209587111785551517,5949.75,2023-02-21T05:28:53,Barcelona,expenses,cash,-100.0,-31100.68
buyer_4,Marc,Andreu,1974-05-23,54922038Q,marc.andreu@brilliantapp.app,964991,ES19209587111785551517,5949.75,2023-02-24T17:38:32,Barcelona,expenses,clothing,-118.21,-31218.89
buyer_4,Marc,Andreu,1974-05-23,54922038Q,marc.andreu@brilliantapp.app,964991,ES19209587111785551517,5949.75,2023-02-25T11:03:41,Barcelona,expenses,gifts,-655.77,-31874.66
buyer_4,Marc,Andreu,1974-05-23,54922038Q,marc.andreu@brilliantapp.app,964991,ES19209587111785551517,5949.75,2023-02-26T08:41:36,Barcelona,expenses,food,-92.74,-31967.4
buyer_4,Marc,Andreu,1974-05-23,54922038Q,marc.andreu@brilliantapp.app,964991,ES19209587111785551517,5949.75,2023-02-26T10:15:14,Barcelona,expenses,gifts,-840.73,-32808.13
buyer_4,Marc,Andreu,1974-05-23,54922038Q,marc.andreu@brilliantapp.app,964991,ES19209587111785551517,5949.75,2023-02-27T12:02:46,Barcelona,expenses,transport,-79.85,-32887.98
buyer_4,Marc,Andreu,1974-05-23,54922038Q,marc.andreu@brilliantapp.app,964991,ES19209587111785551517,5949.75,2023-02-27T14:05:00,Barcelona,expenses,leisure,-56.91,-32944.89
buyer_4,Marc,Andreu,1974-05-23,54922038Q,marc.andreu@brilliantapp.app,964991,ES19209587111785551517,5949.75,2023-02-27T08:27:40,Barcelona,expenses,cash,-100.0,-33044.89
buyer_4,Marc,Andreu,1974-05-23,54922038Q,marc.andreu@brilliantapp.app,964991,ES19209587111785551517,5949.75,2023-03-01T18:12:46,Barcelona,incomes,salary,2920.57,-30124.32
buyer_4,Marc,Andreu,1974-05-23,54922038Q,marc.andreu@brilliantapp.app,964991,ES19209587111785551517,5949.75,2023-03-01T18:12:46,Barcelona,incomes,extra_income,514.74,-29609.58
buyer_4,Marc,Andreu,1974-05-23,54922038Q,marc.andreu@brilliantapp.app,964991,ES19209587111785551517,5949.75,2023-03-01T20:18:57,Barcelona,expenses,children,-1159.060833333334,-30768.64
buyer_4,Marc,Andreu,1974-05-23,54922038Q,marc.andreu@brilliantapp.app,964991,ES19209587111785551517,5949.75,2023-03-02T12:43:17,Barcelona,expenses,education,-42.75,-30811.39
buyer_4,Marc,Andreu,1974-05-23,54922038Q,marc.andreu@brilliantapp.app,964991,ES19209587111785551517,5949.75,2023-03-02T18:39:03,Barcelona,expenses,appliances,-412.85,-31224.24
buyer_4,Marc,Andreu,1974-05-23,54922038Q,marc.andreu@brilliantapp.app,964991,ES19209587111785551517,5949.75,2023-03-03T15:25:29,Barcelona,expenses,transport,-53.78,-31278.02
buyer_4,Marc,Andreu,1974-05-23,54922038Q,marc.andreu@brilliantapp.app,964991,ES19209587111785551517,5949.75,2023-03-03T23:23:27,Barcelona,expenses,leisure,-72.86,-31350.88
buyer_4,Marc,Andreu,1974-05-23,54922038Q,marc.andreu@brilliantapp.app,964991,ES19209587111785551517,5949.75,2023-03-04T15:54:55,Barcelona,expenses,food,-81.71,-31432.59
buyer_4,Marc,Andreu,1974-05-23,54922038Q,marc.andreu@brilliantapp.app,964991,ES19209587111785551517,5949.75,2023-03-04T17:45:04,Barcelona,expenses,leisure,-46.67,-31479.26
buyer_4,Marc,Andreu,1974-05-23,54922038Q,marc.andreu@brilliantapp.app,964991,ES19209587111785551517,5949.75,2023-03-04T18:08:53,Barcelona,expenses,gifts,-339.03,-31818.29
buyer_4,Marc,Andreu,1974-05-23,54922038Q,marc.andreu@brilliantapp.app,964991,ES19209587111785551517,5949.75,2023-03-05T10:20:03,Barcelona,expenses,mortgage,-1298.01,-33116.3
buyer_4,Marc,Andreu,1974-05-23,54922038Q,marc.andreu@brilliantapp.app,964991,ES19209587111785551517,5949.75,2023-03-06T16:23:13,Barcelona,expenses,water,-36.89,-33153.19
buyer_4,Marc,Andreu,1974-05-23,54922038Q,marc.andreu@brilliantapp.app,964991,ES19209587111785551517,5949.75,2023-03-06T09:41:59,Barcelona,expenses,gas,-118.46,-33271.65
buyer_4,Marc,Andreu,1974-05-23,54922038Q,marc.andreu@brilliantapp.app,964991,ES19209587111785551517,5949.75,2023-03-06T14:29:19,Barcelona,expenses,gifts,-245.05,-33516.7
buyer_4,Marc,Andreu,1974-05-23,54922038Q,marc.andreu@brilliantapp.app,964991,ES19209587111785551517,5949.75,2023-03-07T22:46:30,Barcelona,expenses,internet,-61.33,-33578.03
buyer_4,Marc,Andreu,1974-05-23,54922038Q,marc.andreu@brilliantapp.app,964991,ES19209587111785551517,5949.75,2023-03-07T19:54:48,Barcelona,expenses,healthcare,-143.3,-33721.33
buyer_4,Marc,Andreu,1974-05-23,54922038Q,marc.andreu@brilliantapp.app,964991,ES19209587111785551517,5949.75,2023-03-08T12:12:22,Barcelona,expenses,water,-29.93,-33751.26
buyer_4,Marc,Andreu,1974-05-23,54922038Q,marc.andreu@brilliantapp.app,964991,ES19209587111785551517,5949.75,2023-03-08T21:26:50,Barcelona,expenses,electricity,-61.66,-33812.92
buyer_4,Marc,Andreu,1974-05-23,54922038Q,marc.andreu@brilliantapp.app,964991,ES19209587111785551517,5949.75,2023-03-08T06:46:51,Barcelona,expenses,phone,-52.84,-33865.76
buyer_4,Marc,Andreu,1974-05-23,54922038Q,marc.andreu@brilliantapp.app,964991,ES19209587111785551517,5949.75,2023-03-08T10:56:25,Barcelona,expenses,cash,-100.0,-33965.76
buyer_4,Marc,Andreu,1974-05-23,54922038Q,marc.andreu@brilliantapp.app,964991,ES19209587111785551517,5949.75,2023-03-09T12:31:09,Barcelona,expenses,food,-102.8,-34068.56
buyer_4,Marc,Andreu,1974-05-23,54922038Q,marc.andreu@brilliantapp.app,964991,ES19209587111785551517,5949.75,2023-03-09T12:36:50,Barcelona,expenses,repairs,-258.95,-34327.51
buyer_4,Marc,Andreu,1974-05-23,54922038Q,marc.andreu@brilliantapp.app,964991,ES19209587111785551517,5949.75,2023-03-12T03:20:41,Barcelona,expenses,food,-67.42,-34394.93
buyer_4,Marc,Andreu,1974-05-23,54922038Q,marc.andreu@brilliantapp.app,964991,ES19209587111785551517,5949.75,2023-03-12T15:06:53,Barcelona,expenses,cash,-100.0,-34494.93
buyer_4,Marc,Andreu,1974-05-23,54922038Q,marc.andreu@brilliantapp.app,964991,ES19209587111785551517,5949.75,2023-03-15T10:59:24,Barcelona,expenses,food,-108.74,-34603.67
buyer_4,Marc,Andreu,1974-05-23,54922038Q,marc.andreu@brilliantapp.app,964991,ES19209587111785551517,5949.75,2023-03-15T14:44:56,Barcelona,expenses,transport,-63.56,-34667.23
buyer_4,Marc,Andreu,1974-05-23,54922038Q,marc.andreu@brilliantapp.app,964991,ES19209587111785551517,5949.75,2023-03-15T01:20:26,Barcelona,expenses,clothing,-55.37,-34722.6
buyer_4,Marc,Andreu,1974-05-23,54922038Q,marc.andreu@brilliantapp.app,964991,ES19209587111785551517,5949.75,2023-03-17T08:06:00,Barcelona,expenses,cash,-100.0,-34822.6
buyer_4,Marc,Andreu,1974-05-23,54922038Q,marc.andreu@brilliantapp.app,964991,ES19209587111785551517,5949.75,2023-03-21T16:12:48,Barcelona,expenses,education,-74.12,-34896.72
buyer_4,Marc,Andreu,1974-05-23,54922038Q,marc.andreu@brilliantapp.app,964991,ES19209587111785551517,5949.75,2023-03-24T23:33:38,Barcelona,expenses,leisure,-41.43,-34938.15
buyer_4,Marc,Andreu,1974-05-23,54922038Q,marc.andreu@brilliantapp.app,964991,ES19209587111785551517,5949.75,2023-03-25T12:51:21,Barcelona,expenses,children,-1159.060833333334,-36097.21
buyer_4,Marc,Andreu,1974-05-23,54922038Q,marc.andreu@brilliantapp.app,964991,ES19209587111785551517,5949.75,2023-03-26T10:26:20,Barcelona,expenses,repairs,-47.3,-36144.51
buyer_4,Marc,Andreu,1974-05-23,54922038Q,marc.andreu@brilliantapp.app,964991,ES19209587111785551517,5949.75,2023-03-30T18:56:04,Barcelona,expenses,cash,-100.0,-36244.51
buyer_4,Marc,Andreu,1974-05-23,54922038Q,marc.andreu@brilliantapp.app,964991,ES19209587111785551517,5949.75,2023-03-31T13:46:07,Barcelona,expenses,healthcare,-42.85,-36287.36
buyer_4,Marc,Andreu,1974-05-23,54922038Q,marc.andreu@brilliantapp.app,964991,ES19209587111785551517,5949.75,2023-04-01T19:19:52,Barcelona,incomes,salary,2920.57,-33366.79
buyer_4,Marc,Andreu,1974-05-23,54922038Q,marc.andreu@brilliantapp.app,964991,ES19209587111785551517,5949.75,2023-04-01T08:43:10,Barcelona,expenses,clothing,-142.42,-33509.21
buyer_4,Marc,Andreu,1974-05-23,54922038Q,marc.andreu@brilliantapp.app,964991,ES19209587111785551517,5949.75,2023-04-04T18:22:31,Barcelona,expenses,leisure,-68.68,-33577.89
buyer_4,Marc,Andreu,1974-05-23,54922038Q,marc.andreu@brilliantapp.app,964991,ES19209587111785551517,5949.75,2023-04-04T12:57:02,Barcelona,expenses,education,-55.03,-33632.92
buyer_4,Marc,Andreu,1974-05-23,54922038Q,marc.andreu@brilliantapp.app,964991,ES19209587111785551517,5949.75,2023-04-05T21:52:46,Barcelona,expenses,mortgage,-1298.01,-34930.93
buyer_4,Marc,Andreu,1974-05-23,54922038Q,marc.andreu@brilliantapp.app,964991,ES19209587111785551517,5949.75,2023-04-05T15:29:18,Barcelona,expenses,appliances,-172.76,-35103.69
buyer_4,Marc,Andreu,1974-05-23,54922038Q,marc.andreu@brilliantapp.app,964991,ES19209587111785551517,5949.75,2023-04-06T05:33:40,Barcelona,expenses,water,-55.66,-35159.35
buyer_4,Marc,Andreu,1974-05-23,54922038Q,marc.andreu@brilliantapp.app,964991,ES19209587111785551517,5949.75,2023-04-06T19:45:51,Barcelona,expenses,electricity,-66.25,-35225.6
buyer_4,Marc,Andreu,1974-05-23,54922038Q,marc.andreu@brilliantapp.app,964991,ES19209587111785551517,5949.75,2023-04-06T19:26:23,Barcelona,expenses,phone,-49.32,-35274.92
buyer_4,Marc,Andreu,1974-05-23,54922038Q,marc.andreu@brilliantapp.app,964991,ES19209587111785551517,5949.75,2023-04-06T19:07:57,Barcelona,expenses,leisure,-40.49,-35315.41
buyer_4,Marc,Andreu,1974-05-23,54922038Q,marc.andreu@brilliantapp.app,964991,ES19209587111785551517,5949.75,2023-04-06T20:18:25,Barcelona,expenses,clothing,-127.32,-35442.73
buyer_4,Marc,Andreu,1974-05-23,54922038Q,marc.andreu@brilliantapp.app,964991,ES19209587111785551517,5949.75,2023-04-07T20:20:30,Barcelona,expenses,water,-53.14,-35495.87
buyer_4,Marc,Andreu,1974-05-23,54922038Q,marc.andreu@brilliantapp.app,964991,ES19209587111785551517,5949.75,2023-04-07T23:30:25,Barcelona,expenses,internet,-61.33,-35557.2
buyer_4,Marc,Andreu,1974-05-23,54922038Q,marc.andreu@brilliantapp.app,964991,ES19209587111785551517,5949.75,2023-04-07T12:01:48,Barcelona,expenses,transport,-59.31,-35616.51
buyer_4,Marc,Andreu,1974-05-23,54922038Q,marc.andreu@brilliantapp.app,964991,ES19209587111785551517,5949.75,2023-04-07T11:01:16,Barcelona,expenses,leisure,-73.94,-35690.45
buyer_4,Marc,Andreu,1974-05-23,54922038Q,marc.andreu@brilliantapp.app,964991,ES19209587111785551517,5949.75,2023-04-08T15:00:54,Barcelona,expenses,electricity,-94.78,-35785.23
buyer_4,Marc,Andreu,1974-05-23,54922038Q,marc.andreu@brilliantapp.app,964991,ES19209587111785551517,5949.75,2023-04-08T19:55:00,Barcelona,expenses,gas,-130.4,-35915.63
buyer_4,Marc,Andreu,1974-05-23,54922038Q,marc.andreu@brilliantapp.app,964991,ES19209587111785551517,5949.75,2023-04-08T09:31:13,Barcelona,expenses,internet,-61.33,-35976.96
buyer_4,Marc,Andreu,1974-05-23,54922038Q,marc.andreu@brilliantapp.app,964991,ES19209587111785551517,5949.75,2023-04-08T07:12:37,Barcelona,expenses,phone,-62.51,-36039.47
buyer_4,Marc,Andreu,1974-05-23,54922038Q,marc.andreu@brilliantapp.app,964991,ES19209587111785551517,5949.75,2023-04-10T12:41:33,Barcelona,expenses,leisure,-62.04,-36101.51
buyer_4,Marc,Andreu,1974-05-23,54922038Q,marc.andreu@brilliantapp.app,964991,ES19209587111785551517,5949.75,2023-04-14T18:13:32,Barcelona,expenses,leisure,-34.73,-36136.24
buyer_4,Marc,Andreu,1974-05-23,54922038Q,marc.andreu@brilliantapp.app,964991,ES19209587111785551517,5949.75,2023-04-16T20:14:57,Barcelona,expenses,clothing,-158.74,-36294.98
buyer_4,Marc,Andreu,1974-05-23,54922038Q,marc.andreu@brilliantapp.app,964991,ES19209587111785551517,5949.75,2023-04-19T21:54:51,Barcelona,expenses,leisure,-48.54,-36343.52
buyer_4,Marc,Andreu,1974-05-23,54922038Q,marc.andreu@brilliantapp.app,964991,ES19209587111785551517,5949.75,2023-04-21T10:58:39,Barcelona,expenses,healthcare,-55.04,-36398.56
buyer_4,Marc,Andreu,1974-05-23,54922038Q,marc.andreu@brilliantapp.app,964991,ES19209587111785551517,5949.75,2023-04-22T19:38:24,Barcelona,expenses,food,-117.98,-36516.54
buyer_4,Marc,Andreu,1974-05-23,54922038Q,marc.andreu@brilliantapp.app,964991,ES19209587111785551517,5949.75,2023-04-22T16:56:29,Barcelona,expenses,repairs,-183.0,-36699.54
buyer_4,Marc,Andreu,1974-05-23,54922038Q,marc.andreu@brilliantapp.app,964991,ES19209587111785551517,5949.75,2023-04-23T13:51:32,Barcelona,expenses,leisure,-26.27,-36725.81
buyer_4,Marc,Andreu,1974-05-23,54922038Q,marc.andreu@brilliantapp.app,964991,ES19209587111785551517,5949.75,2023-04-25T13:24:53,Barcelona,expenses,transport,-65.36,-36791.17
buyer_4,Marc,Andreu,1974-05-23,54922038Q,marc.andreu@brilliantapp.app,964991,ES19209587111785551517,5949.75,2023-04-25T20:38:36,Barcelona,expenses,repairs,-215.48,-37006.65
buyer_4,Marc,Andreu,1974-05-23,54922038Q,marc.andreu@brilliantapp.app,964991,ES19209587111785551517,5949.75,2023-04-26T13:28:25,Barcelona,expenses,transport,-52.24,-37058.89
buyer_4,Marc,Andreu,1974-05-23,54922038Q,marc.andreu@brilliantapp.app,964991,ES19209587111785551517,5949.75,2023-04-28T19:12:36,Barcelona,expenses,education,-61.92,-37120.81
buyer_4,Marc,Andreu,1974-05-23,54922038Q,marc.andreu@brilliantapp.app,964991,ES19209587111785551517,5949.75,2023-04-28T14:44:12,Barcelona,expenses,cash,-100.0,-37220.81
buyer_4,Marc,Andreu,1974-05-23,54922038Q,marc.andreu@brilliantapp.app,964991,ES19209587111785551517,5949.75,2023-04-30T16:35:28,Barcelona,expenses,cash,-100.0,-37320.81
buyer_4,Marc,Andreu,1974-05-23,54922038Q,marc.andreu@brilliantapp.app,964991,ES19209587111785551517,5949.75,2023-05-01T00:52:34,Barcelona,incomes,salary,2920.57,-34400.24
buyer_4,Marc,Andreu,1974-05-23,54922038Q,marc.andreu@brilliantapp.app,964991,ES19209587111785551517,5949.75,2023-05-01T10:54:22,Barcelona,expenses,food,-78.6,-34478.84
buyer_4,Marc,Andreu,1974-05-23,54922038Q,marc.andreu@brilliantapp.app,964991,ES19209587111785551517,5949.75,2023-05-04T17:47:50,Barcelona,expenses,transport,-67.62,-34546.46
buyer_4,Marc,Andreu,1974-05-23,54922038Q,marc.andreu@brilliantapp.app,964991,ES19209587111785551517,5949.75,2023-05-04T09:09:08,Barcelona,expenses,leisure,-35.42,-34581.88
buyer_4,Marc,Andreu,1974-05-23,54922038Q,marc.andreu@brilliantapp.app,964991,ES19209587111785551517,5949.75,2023-05-05T14:56:38,Barcelona,expenses,mortgage,-1298.01,-35879.89
buyer_4,Marc,Andreu,1974-05-23,54922038Q,marc.andreu@brilliantapp.app,964991,ES19209587111785551517,5949.75,2023-05-05T20:43:30,Barcelona,expenses,transport,-55.67,-35935.56
buyer_4,Marc,Andreu,1974-05-23,54922038Q,marc.andreu@brilliantapp.app,964991,ES19209587111785551517,5949.75,2023-05-06T20:51:06,Barcelona,expenses,gas,-145.48,-36081.04
buyer_4,Marc,Andreu,1974-05-23,54922038Q,marc.andreu@brilliantapp.app,964991,ES19209587111785551517,5949.75,2023-05-06T17:53:57,Barcelona,expenses,transport,-46.19,-36127.23
buyer_4,Marc,Andreu,1974-05-23,54922038Q,marc.andreu@brilliantapp.app,964991,ES19209587111785551517,5949.75,2023-05-07T05:25:08,Barcelona,expenses,water,-50.74,-36177.97
buyer_4,Marc,Andreu,1974-05-23,54922038Q,marc.andreu@brilliantapp.app,964991,ES19209587111785551517,5949.75,2023-05-07T12:11:53,Barcelona,expenses,gas,-164.46,-36342.43
buyer_4,Marc,Andreu,1974-05-23,54922038Q,marc.andreu@brilliantapp.app,964991,ES19209587111785551517,5949.75,2023-05-07T19:55:44,Barcelona,expenses,education,-75.19,-36417.62
buyer_4,Marc,Andreu,1974-05-23,54922038Q,marc.andreu@brilliantapp.app,964991,ES19209587111785551517,5949.75,2023-05-08T12:15:46,Barcelona,expenses,internet,-61.33,-36478.95
buyer_4,Marc,Andreu,1974-05-23,54922038Q,marc.andreu@brilliantapp.app,964991,ES19209587111785551517,5949.75,2023-05-09T18:45:01,Barcelona,expenses,car,-244.1,-36723.05
buyer_4,Marc,Andreu,1974-05-23,54922038Q,marc.andreu@brilliantapp.app,964991,ES19209587111785551517,5949.75,2023-05-11T20:03:10,Barcelona,expenses,transport,-60.07,-36783.12
buyer_4,Marc,Andreu,1974-05-23,54922038Q,marc.andreu@brilliantapp.app,964991,ES19209587111785551517,5949.75,2023-05-12T02:43:24,Barcelona,expenses,repairs,-103.19,-36886.31
buyer_4,Marc,Andreu,1974-05-23,54922038Q,marc.andreu@brilliantapp.app,964991,ES19209587111785551517,5949.75,2023-05-14T08:07:41,Barcelona,expenses,food,-105.72,-36992.03
buyer_4,Marc,Andreu,1974-05-23,54922038Q,marc.andreu@brilliantapp.app,964991,ES19209587111785551517,5949.75,2023-05-14T16:03:40,Barcelona,expenses,cash,-100.0,-37092.03
buyer_4,Marc,Andreu,1974-05-23,54922038Q,marc.andreu@brilliantapp.app,964991,ES19209587111785551517,5949.75,2023-05-15T18:45:55,Barcelona,expenses,food,-120.02,-37212.05
buyer_4,Marc,Andreu,1974-05-23,54922038Q,marc.andreu@brilliantapp.app,964991,ES19209587111785551517,5949.75,2023-05-15T08:48:04,Barcelona,expenses,repairs,-37.66,-37249.71
buyer_4,Marc,Andreu,1974-05-23,54922038Q,marc.andreu@brilliantapp.app,964991,ES19209587111785551517,5949.75,2023-05-17T13:14:04,Barcelona,expenses,transport,-78.22,-37327.93
buyer_4,Marc,Andreu,1974-05-23,54922038Q,marc.andreu@brilliantapp.app,964991,ES19209587111785551517,5949.75,2023-05-18T11:22:13,Barcelona,expenses,healthcare,-94.81,-37422.74
buyer_4,Marc,Andreu,1974-05-23,54922038Q,marc.andreu@brilliantapp.app,964991,ES19209587111785551517,5949.75,2023-05-19T13:19:00,Barcelona,expenses,leisure,-25.54,-37448.28
buyer_4,Marc,Andreu,1974-05-23,54922038Q,marc.andreu@brilliantapp.app,964991,ES19209587111785551517,5949.75,2023-05-19T17:24:09,Barcelona,expenses,gifts,-372.08,-37820.36
buyer_4,Marc,Andreu,1974-05-23,54922038Q,marc.andreu@brilliantapp.app,964991,ES19209587111785551517,5949.75,2023-05-19T08:56:42,Barcelona,expenses,car,-302.31,-38122.67
buyer_4,Marc,Andreu,1974-05-23,54922038Q,marc.andreu@brilliantapp.app,964991,ES19209587111785551517,5949.75,2023-05-20T16:23:38,Barcelona,expenses,leisure,-64.49,-38187.16
buyer_4,Marc,Andreu,1974-05-23,54922038Q,marc.andreu@brilliantapp.app,964991,ES19209587111785551517,5949.75,2023-05-22T17:20:30,Barcelona,expenses,cash,-100.0,-38287.16
buyer_4,Marc,Andreu,1974-05-23,54922038Q,marc.andreu@brilliantapp.app,964991,ES19209587111785551517,5949.75,2023-05-23T17:53:54,Barcelona,expenses,transport,-56.7,-38343.86
buyer_4,Marc,Andreu,1974-05-23,54922038Q,marc.andreu@brilliantapp.app,964991,ES19209587111785551517,5949.75,2023-05-25T17:19:41,Barcelona,expenses,gifts,-339.36,-38683.22
buyer_4,Marc,Andreu,1974-05-23,54922038Q,marc.andreu@brilliantapp.app,964991,ES19209587111785551517,5949.75,2023-05-26T08:38:27,Barcelona,expenses,education,-60.52,-38743.74
buyer_4,Marc,Andreu,1974-05-23,54922038Q,marc.andreu@brilliantapp.app,964991,ES19209587111785551517,5949.75,2023-05-28T17:18:51,Barcelona,expenses,food,-71.03,-38814.77
buyer_4,Marc,Andreu,1974-05-23,54922038Q,marc.andreu@brilliantapp.app,964991,ES19209587111785551517,5949.75,2023-05-29T23:43:44,Barcelona,expenses,transport,-88.74,-38903.51
buyer_4,Marc,Andreu,1974-05-23,54922038Q,marc.andreu@brilliantapp.app,964991,ES19209587111785551517,5949.75,2023-05-29T15:27:39,Barcelona,expenses,cash,-100.0,-39003.51
buyer_4,Marc,Andreu,1974-05-23,54922038Q,marc.andreu@brilliantapp.app,964991,ES19209587111785551517,5949.75,2023-05-30T13:37:18,Barcelona,expenses,leisure,-83.05,-39086.56
buyer_4,Marc,Andreu,1974-05-23,54922038Q,marc.andreu@brilliantapp.app,964991,ES19209587111785551517,5949.75,2023-05-31T07:14:47,Barcelona,expenses,cash,-100.0,-39186.56
buyer_4,Marc,Andreu,1974-05-23,54922038Q,marc.andreu@brilliantapp.app,964991,ES19209587111785551517,5949.75,2023-06-01T16:53:56,Barcelona,incomes,salary,2920.57,-36265.99
buyer_4,Marc,Andreu,1974-05-23,54922038Q,marc.andreu@brilliantapp.app,964991,ES19209587111785551517,5949.75,2023-06-01T16:53:56,Barcelona,incomes,salary_bonus,2061.2,-34204.79
buyer_4,Marc,Andreu,1974-05-23,54922038Q,marc.andreu@brilliantapp.app,964991,ES19209587111785551517,5949.75,2023-06-03T06:23:32,Barcelona,expenses,taxes,-1787.54,-35992.33
buyer_4,Marc,Andreu,1974-05-23,54922038Q,marc.andreu@brilliantapp.app,964991,ES19209587111785551517,5949.75,2023-06-03T08:13:07,Barcelona,expenses,insurance,-634.25,-36626.58
buyer_4,Marc,Andreu,1974-05-23,54922038Q,marc.andreu@brilliantapp.app,964991,ES19209587111785551517,5949.75,2023-06-03T10:37:57,Barcelona,expenses,education,-55.61,-36682.19
buyer_4,Marc,Andreu,1974-05-23,54922038Q,marc.andreu@brilliantapp.app,964991,ES19209587111785551517,5949.75,2023-06-05T16:06:35,Barcelona,expenses,mortgage,-1298.01,-37980.2
buyer_4,Marc,Andreu,1974-05-23,54922038Q,marc.andreu@brilliantapp.app,964991,ES19209587111785551517,5949.75,2023-06-06T04:52:35,Barcelona,expenses,electricity,-53.54,-38033.74
buyer_4,Marc,Andreu,1974-05-23,54922038Q,marc.andreu@brilliantapp.app,964991,ES19209587111785551517,5949.75,2023-06-06T16:06:59,Barcelona,expenses,phone,-54.57,-38088.31
buyer_4,Marc,Andreu,1974-05-23,54922038Q,marc.andreu@brilliantapp.app,964991,ES19209587111785551517,5949.75,2023-06-07T10:19:40,Barcelona,expenses,water,-58.32,-38146.63
buyer_4,Marc,Andreu,1974-05-23,54922038Q,marc.andreu@brilliantapp.app,964991,ES19209587111785551517,5949.75,2023-06-07T19:33:04,Barcelona,expenses,education,-66.33,-38212.96
buyer_4,Marc,Andreu,1974-05-23,54922038Q,marc.andreu@brilliantapp.app,964991,ES19209587111785551517,5949.75,2023-06-08T14:12:19,Barcelona,expenses,electricity,-44.32,-38257.28
buyer_4,Marc,Andreu,1974-05-23,54922038Q,marc.andreu@brilliantapp.app,964991,ES19209587111785551517,5949.75,2023-06-08T18:43:58,Barcelona,expenses,internet,-61.33,-38318.61
buyer_4,Marc,Andreu,1974-05-23,54922038Q,marc.andreu@brilliantapp.app,964991,ES19209587111785551517,5949.75,2023-06-08T10:16:59,Barcelona,expenses,cash,-100.0,-38418.61
buyer_4,Marc,Andreu,1974-05-23,54922038Q,marc.andreu@brilliantapp.app,964991,ES19209587111785551517,5949.75,2023-06-09T10:49:35,Barcelona,expenses,appliances,-382.46,-38801.07
buyer_4,Marc,Andreu,1974-05-23,54922038Q,marc.andreu@brilliantapp.app,964991,ES19209587111785551517,5949.75,2023-06-11T13:18:56,Barcelona,expenses,appliances,-360.07,-39161.14
buyer_4,Marc,Andreu,1974-05-23,54922038Q,marc.andreu@brilliantapp.app,964991,ES19209587111785551517,5949.75,2023-06-11T20:23:35,Barcelona,expenses,children,-675.12,-39836.26
buyer_4,Marc,Andreu,1974-05-23,54922038Q,marc.andreu@brilliantapp.app,964991,ES19209587111785551517,5949.75,2023-06-12T23:11:53,Barcelona,expenses,cash,-100.0,-39936.26
buyer_4,Marc,Andreu,1974-05-23,54922038Q,marc.andreu@brilliantapp.app,964991,ES19209587111785551517,5949.75,2023-06-15T04:07:18,Barcelona,expenses,cash,-100.0,-40036.26
buyer_4,Marc,Andreu,1974-05-23,54922038Q,marc.andreu@brilliantapp.app,964991,ES19209587111785551517,5949.75,2023-06-16T18:02:50,Barcelona,expenses,travel,-976.99,-41013.25
buyer_4,Marc,Andreu,1974-05-23,54922038Q,marc.andreu@brilliantapp.app,964991,ES19209587111785551517,5949.75,2023-06-17T02:23:41,Barcelona,expenses,repairs,-294.41,-41307.66
buyer_4,Marc,Andreu,1974-05-23,54922038Q,marc.andreu@brilliantapp.app,964991,ES19209587111785551517,5949.75,2023-06-18T13:09:21,Barcelona,expenses,leisure,-29.65,-41337.31
buyer_4,Marc,Andreu,1974-05-23,54922038Q,marc.andreu@brilliantapp.app,964991,ES19209587111785551517,5949.75,2023-06-20T11:09:05,Barcelona,expenses,food,-109.03,-41446.34
buyer_4,Marc,Andreu,1974-05-23,54922038Q,marc.andreu@brilliantapp.app,964991,ES19209587111785551517,5949.75,2023-06-20T14:52:06,Barcelona,expenses,repairs,-186.71,-41633.05
buyer_4,Marc,Andreu,1974-05-23,54922038Q,marc.andreu@brilliantapp.app,964991,ES19209587111785551517,5949.75,2023-06-22T20:23:40,Barcelona,expenses,clothing,-140.79,-41773.84
buyer_4,Marc,Andreu,1974-05-23,54922038Q,marc.andreu@brilliantapp.app,964991,ES19209587111785551517,5949.75,2023-06-23T05:52:51,Barcelona,expenses,transport,-50.37,-41824.21
buyer_4,Marc,Andreu,1974-05-23,54922038Q,marc.andreu@brilliantapp.app,964991,ES19209587111785551517,5949.75,2023-06-25T08:50:34,Barcelona,expenses,food,-68.74,-41892.95
buyer_4,Marc,Andreu,1974-05-23,54922038Q,marc.andreu@brilliantapp.app,964991,ES19209587111785551517,5949.75,2023-06-25T06:33:15,Barcelona,expenses,transport,-87.77,-41980.72
buyer_4,Marc,Andreu,1974-05-23,54922038Q,marc.andreu@brilliantapp.app,964991,ES19209587111785551517,5949.75,2023-06-25T09:41:09,Barcelona,expenses,clothing,-140.93,-42121.65
buyer_4,Marc,Andreu,1974-05-23,54922038Q,marc.andreu@brilliantapp.app,964991,ES19209587111785551517,5949.75,2023-06-25T15:39:43,Barcelona,expenses,repairs,-42.57,-42164.22
buyer_4,Marc,Andreu,1974-05-23,54922038Q,marc.andreu@brilliantapp.app,964991,ES19209587111785551517,5949.75,2023-06-26T17:03:26,Barcelona,expenses,transport,-46.59,-42210.81
buyer_4,Marc,Andreu,1974-05-23,54922038Q,marc.andreu@brilliantapp.app,964991,ES19209587111785551517,5949.75,2023-06-26T19:02:53,Barcelona,expenses,cash,-100.0,-42310.81
buyer_4,Marc,Andreu,1974-05-23,54922038Q,marc.andreu@brilliantapp.app,964991,ES19209587111785551517,5949.75,2023-06-27T18:14:05,Barcelona,expenses,transport,-61.15,-42371.96
buyer_4,Marc,Andreu,1974-05-23,54922038Q,marc.andreu@brilliantapp.app,964991,ES19209587111785551517,5949.75,2023-06-27T12:21:36,Barcelona,expenses,healthcare,-65.31,-42437.27
buyer_4,Marc,Andreu,1974-05-23,54922038Q,marc.andreu@brilliantapp.app,964991,ES19209587111785551517,5949.75,2023-06-27T08:38:01,Barcelona,expenses,cash,-100.0,-42537.27
buyer_4,Marc,Andreu,1974-05-23,54922038Q,marc.andreu@brilliantapp.app,964991,ES19209587111785551517,5949.75,2023-06-29T20:51:57,Barcelona,expenses,cash,-100.0,-42637.27
buyer_4,Marc,Andreu,1974-05-23,54922038Q,marc.andreu@brilliantapp.app,964991,ES19209587111785551517,5949.75,2023-06-29T06:30:11,Barcelona,expenses,repairs,-164.79,-42802.06
buyer_4,Marc,Andreu,1974-05-23,54922038Q,marc.andreu@brilliantapp.app,964991,ES19209587111785551517,5949.75,2023-06-29T08:42:05,Barcelona,expenses,gifts,-780.82,-43582.88
buyer_4,Marc,Andreu,1974-05-23,54922038Q,marc.andreu@brilliantapp.app,964991,ES19209587111785551517,5949.75,2023-06-30T17:02:38,Barcelona,expenses,cash,-100.0,-43682.88
buyer_4,Marc,Andreu,1974-05-23,54922038Q,marc.andreu@brilliantapp.app,964991,ES19209587111785551517,5949.75,2023-07-01T17:46:02,Barcelona,incomes,salary,2920.57,-40762.31
buyer_4,Marc,Andreu,1974-05-23,54922038Q,marc.andreu@brilliantapp.app,964991,ES19209587111785551517,5949.75,2023-07-01T17:46:02,Barcelona,incomes,extra_income,514.74,-40247.57
buyer_4,Marc,Andreu,1974-05-23,54922038Q,marc.andreu@brilliantapp.app,964991,ES19209587111785551517,5949.75,2023-07-01T20:22:31,Barcelona,expenses,food,-87.13,-40334.7
buyer_4,Marc,Andreu,1974-05-23,54922038Q,marc.andreu@brilliantapp.app,964991,ES19209587111785551517,5949.75,2023-07-01T16:14:28,Barcelona,expenses,leisure,-40.94,-40375.64
buyer_4,Marc,Andreu,1974-05-23,54922038Q,marc.andreu@brilliantapp.app,964991,ES19209587111785551517,5949.75,2023-07-05T10:58:19,Barcelona,expenses,mortgage,-1298.01,-41673.65
buyer_4,Marc,Andreu,1974-05-23,54922038Q,marc.andreu@brilliantapp.app,964991,ES19209587111785551517,5949.75,2023-07-06T03:01:06,Barcelona,expenses,electricity,-62.73,-41736.38
buyer_4,Marc,Andreu,1974-05-23,54922038Q,marc.andreu@brilliantapp.app,964991,ES19209587111785551517,5949.75,2023-07-06T17:17:15,Barcelona,expenses,leisure,-70.04,-41806.42
buyer_4,Marc,Andreu,1974-05-23,54922038Q,marc.andreu@brilliantapp.app,964991,ES19209587111785551517,5949.75,2023-07-07T00:39:02,Barcelona,expenses,gas,-104.56,-41910.98
buyer_4,Marc,Andreu,1974-05-23,54922038Q,marc.andreu@brilliantapp.app,964991,ES19209587111785551517,5949.75,2023-07-07T13:04:50,Barcelona,expenses,cash,-100.0,-42010.98
buyer_4,Marc,Andreu,1974-05-23,54922038Q,marc.andreu@brilliantapp.app,964991,ES19209587111785551517,5949.75,2023-07-08T09:01:08,Barcelona,expenses,gas,-85.07,-42096.05
buyer_4,Marc,Andreu,1974-05-23,54922038Q,marc.andreu@brilliantapp.app,964991,ES19209587111785551517,5949.75,2023-07-08T17:45:18,Barcelona,expenses,internet,-61.33,-42157.38
buyer_4,Marc,Andreu,1974-05-23,54922038Q,marc.andreu@brilliantapp.app,964991,ES19209587111785551517,5949.75,2023-07-08T18:00:05,Barcelona,expenses,phone,-56.88,-42214.26
buyer_4,Marc,Andreu,1974-05-23,54922038Q,marc.andreu@brilliantapp.app,964991,ES19209587111785551517,5949.75,2023-07-08T13:46:23,Barcelona,expenses,gifts,-649.76,-42864.02
buyer_4,Marc,Andreu,1974-05-23,54922038Q,marc.andreu@brilliantapp.app,964991,ES19209587111785551517,5949.75,2023-07-10T05:06:31,Barcelona,expenses,transport,-51.22,-42915.24
buyer_4,Marc,Andreu,1974-05-23,54922038Q,marc.andreu@brilliantapp.app,964991,ES19209587111785551517,5949.75,2023-07-12T13:00:27,Barcelona,expenses,repairs,-28.35,-42943.59
buyer_4,Marc,Andreu,1974-05-23,54922038Q,marc.andreu@brilliantapp.app,964991,ES19209587111785551517,5949.75,2023-07-12T21:33:40,Barcelona,expenses,children,-911.71,-43855.3
buyer_4,Marc,Andreu,1974-05-23,54922038Q,marc.andreu@brilliantapp.app,964991,ES19209587111785551517,5949.75,2023-07-13T09:33:32,Barcelona,expenses,leisure,-28.21,-43883.51
buyer_4,Marc,Andreu,1974-05-23,54922038Q,marc.andreu@brilliantapp.app,964991,ES19209587111785551517,5949.75,2023-07-13T00:56:39,Barcelona,expenses,clothing,-110.91,-43994.42
buyer_4,Marc,Andreu,1974-05-23,54922038Q,marc.andreu@brilliantapp.app,964991,ES19209587111785551517,5949.75,2023-07-13T22:12:58,Barcelona,expenses,education,-72.18,-44066.6
buyer_4,Marc,Andreu,1974-05-23,54922038Q,marc.andreu@brilliantapp.app,964991,ES19209587111785551517,5949.75,2023-07-14T15:39:37,Barcelona,expenses,leisure,-73.7,-44140.3
buyer_4,Marc,Andreu,1974-05-23,54922038Q,marc.andreu@brilliantapp.app,964991,ES19209587111785551517,5949.75,2023-07-14T10:03:47,Barcelona,expenses,clothing,-87.58,-44227.88
buyer_4,Marc,Andreu,1974-05-23,54922038Q,marc.andreu@brilliantapp.app,964991,ES19209587111785551517,5949.75,2023-07-18T16:15:17,Barcelona,expenses,gifts,-436.92,-44664.8
buyer_4,Marc,Andreu,1974-05-23,54922038Q,marc.andreu@brilliantapp.app,964991,ES19209587111785551517,5949.75,2023-07-19T09:07:00,Barcelona,expenses,education,-67.7,-44732.5
buyer_4,Marc,Andreu,1974-05-23,54922038Q,marc.andreu@brilliantapp.app,964991,ES19209587111785551517,5949.75,2023-07-20T05:53:32,Barcelona,expenses,food,-124.35,-44856.85
buyer_4,Marc,Andreu,1974-05-23,54922038Q,marc.andreu@brilliantapp.app,964991,ES19209587111785551517,5949.75,2023-07-25T13:12:52,Barcelona,expenses,cash,-100.0,-44956.85
buyer_4,Marc,Andreu,1974-05-23,54922038Q,marc.andreu@brilliantapp.app,964991,ES19209587111785551517,5949.75,2023-07-26T20:56:29,Barcelona,expenses,education,-68.1,-45024.95
buyer_4,Marc,Andreu,1974-05-23,54922038Q,marc.andreu@brilliantapp.app,964991,ES19209587111785551517,5949.75,2023-07-29T18:55:21,Barcelona,expenses,clothing,-47.85,-45072.8
buyer_4,Marc,Andreu,1974-05-23,54922038Q,marc.andreu@brilliantapp.app,964991,ES19209587111785551517,5949.75,2023-07-29T09:21:35,Barcelona,expenses,gifts,-241.57,-45314.37
buyer_4,Marc,Andreu,1974-05-23,54922038Q,marc.andreu@brilliantapp.app,964991,ES19209587111785551517,5949.75,2023-07-30T12:57:54,Barcelona,expenses,cash,-100.0,-45414.37
buyer_4,Marc,Andreu,1974-05-23,54922038Q,marc.andreu@brilliantapp.app,964991,ES19209587111785551517,5949.75,2023-07-30T15:04:03,Barcelona,expenses,travel,-777.32,-46191.69
buyer_4,Marc,Andreu,1974-05-23,54922038Q,marc.andreu@brilliantapp.app,964991,ES19209587111785551517,5949.75,2023-07-31T10:37:13,Barcelona,expenses,transport,-53.88,-46245.57
buyer_4,Marc,Andreu,1974-05-23,54922038Q,marc.andreu@brilliantapp.app,964991,ES19209587111785551517,5949.75,2023-07-31T18:12:30,Barcelona,expenses,cash,-100.0,-46345.57
buyer_4,Marc,Andreu,1974-05-23,54922038Q,marc.andreu@brilliantapp.app,964991,ES19209587111785551517,5949.75,2023-08-01T11:22:02,Barcelona,incomes,salary,2920.57,-43425.0
buyer_4,Marc,Andreu,1974-05-23,54922038Q,marc.andreu@brilliantapp.app,964991,ES19209587111785551517,5949.75,2023-08-01T11:14:17,Barcelona,expenses,leisure,-37.86,-43462.86
buyer_4,Marc,Andreu,1974-05-23,54922038Q,marc.andreu@brilliantapp.app,964991,ES19209587111785551517,5949.75,2023-08-02T04:59:11,Barcelona,expenses,repairs,-274.99,-43737.85
buyer_4,Marc,Andreu,1974-05-23,54922038Q,marc.andreu@brilliantapp.app,964991,ES19209587111785551517,5949.75,2023-08-02T11:37:14,Barcelona,expenses,children,-786.34,-44524.19
buyer_4,Marc,Andreu,1974-05-23,54922038Q,marc.andreu@brilliantapp.app,964991,ES19209587111785551517,5949.75,2023-08-03T20:53:47,Barcelona,expenses,children,-1118.5,-45642.69
buyer_4,Marc,Andreu,1974-05-23,54922038Q,marc.andreu@brilliantapp.app,964991,ES19209587111785551517,5949.75,2023-08-04T21:49:57,Barcelona,expenses,cash,-100.0,-45742.69
buyer_4,Marc,Andreu,1974-05-23,54922038Q,marc.andreu@brilliantapp.app,964991,ES19209587111785551517,5949.75,2023-08-05T14:13:04,Barcelona,expenses,mortgage,-1298.01,-47040.7
buyer_4,Marc,Andreu,1974-05-23,54922038Q,marc.andreu@brilliantapp.app,964991,ES19209587111785551517,5949.75,2023-08-05T12:17:19,Barcelona,expenses,water,-57.62,-47098.32
buyer_4,Marc,Andreu,1974-05-23,54922038Q,marc.andreu@brilliantapp.app,964991,ES19209587111785551517,5949.75,2023-08-06T20:59:06,Barcelona,expenses,electricity,-113.81,-47212.13
buyer_4,Marc,Andreu,1974-05-23,54922038Q,marc.andreu@brilliantapp.app,964991,ES19209587111785551517,5949.75,2023-08-07T16:58:43,Barcelona,expenses,water,-43.7,-47255.83
buyer_4,Marc,Andreu,1974-05-23,54922038Q,marc.andreu@brilliantapp.app,964991,ES19209587111785551517,5949.75,2023-08-07T19:06:53,Barcelona,expenses,gas,-105.33,-47361.16
buyer_4,Marc,Andreu,1974-05-23,54922038Q,marc.andreu@brilliantapp.app,964991,ES19209587111785551517,5949.75,2023-08-07T09:56:20,Barcelona,expenses,leisure,-72.62,-47433.78
buyer_4,Marc,Andreu,1974-05-23,54922038Q,marc.andreu@brilliantapp.app,964991,ES19209587111785551517,5949.75,2023-08-08T17:12:25,Barcelona,expenses,internet,-61.33,-47495.11
buyer_4,Marc,Andreu,1974-05-23,54922038Q,marc.andreu@brilliantapp.app,964991,ES19209587111785551517,5949.75,2023-08-10T16:24:06,Barcelona,expenses,appliances,-236.68,-47731.79
buyer_4,Marc,Andreu,1974-05-23,54922038Q,marc.andreu@brilliantapp.app,964991,ES19209587111785551517,5949.75,2023-08-11T20:43:59,Barcelona,expenses,food,-120.78,-47852.57
buyer_4,Marc,Andreu,1974-05-23,54922038Q,marc.andreu@brilliantapp.app,964991,ES19209587111785551517,5949.75,2023-08-11T15:40:44,Barcelona,expenses,cash,-100.0,-47952.57
buyer_4,Marc,Andreu,1974-05-23,54922038Q,marc.andreu@brilliantapp.app,964991,ES19209587111785551517,5949.75,2023-08-13T08:16:08,Barcelona,expenses,food,-89.5,-48042.07
buyer_4,Marc,Andreu,1974-05-23,54922038Q,marc.andreu@brilliantapp.app,964991,ES19209587111785551517,5949.75,2023-08-13T15:59:27,Barcelona,expenses,cash,-100.0,-48142.07
buyer_4,Marc,Andreu,1974-05-23,54922038Q,marc.andreu@brilliantapp.app,964991,ES19209587111785551517,5949.75,2023-08-14T09:25:05,Barcelona,expenses,leisure,-52.19,-48194.26
buyer_4,Marc,Andreu,1974-05-23,54922038Q,marc.andreu@brilliantapp.app,964991,ES19209587111785551517,5949.75,2023-08-15T08:06:20,Barcelona,expenses,leisure,-44.97,-48239.23
buyer_4,Marc,Andreu,1974-05-23,54922038Q,marc.andreu@brilliantapp.app,964991,ES19209587111785551517,5949.75,2023-08-15T12:28:55,Barcelona,expenses,cash,-100.0,-48339.23
buyer_4,Marc,Andreu,1974-05-23,54922038Q,marc.andreu@brilliantapp.app,964991,ES19209587111785551517,5949.75,2023-08-19T10:28:00,Barcelona,expenses,food,-100.4,-48439.63
buyer_4,Marc,Andreu,1974-05-23,54922038Q,marc.andreu@brilliantapp.app,964991,ES19209587111785551517,5949.75,2023-08-19T08:25:47,Barcelona,expenses,clothing,-73.81,-48513.44
buyer_4,Marc,Andreu,1974-05-23,54922038Q,marc.andreu@brilliantapp.app,964991,ES19209587111785551517,5949.75,2023-08-20T21:15:19,Barcelona,expenses,healthcare,-101.22,-48614.66
buyer_4,Marc,Andreu,1974-05-23,54922038Q,marc.andreu@brilliantapp.app,964991,ES19209587111785551517,5949.75,2023-08-21T22:50:32,Barcelona,expenses,cash,-100.0,-48714.66
buyer_4,Marc,Andreu,1974-05-23,54922038Q,marc.andreu@brilliantapp.app,964991,ES19209587111785551517,5949.75,2023-08-22T12:11:07,Barcelona,expenses,repairs,-300.4,-49015.06
buyer_4,Marc,Andreu,1974-05-23,54922038Q,marc.andreu@brilliantapp.app,964991,ES19209587111785551517,5949.75,2023-08-24T12:06:15,Barcelona,expenses,children,-1159.060833333334,-50174.12
buyer_4,Marc,Andreu,1974-05-23,54922038Q,marc.andreu@brilliantapp.app,964991,ES19209587111785551517,5949.75,2023-08-26T08:31:59,Barcelona,expenses,leisure,-63.18,-50237.3
buyer_4,Marc,Andreu,1974-05-23,54922038Q,marc.andreu@brilliantapp.app,964991,ES19209587111785551517,5949.75,2023-08-27T09:24:16,Barcelona,expenses,healthcare,-163.63,-50400.93
buyer_4,Marc,Andreu,1974-05-23,54922038Q,marc.andreu@brilliantapp.app,964991,ES19209587111785551517,5949.75,2023-08-28T13:27:43,Barcelona,expenses,leisure,-81.71,-50482.64
buyer_4,Marc,Andreu,1974-05-23,54922038Q,marc.andreu@brilliantapp.app,964991,ES19209587111785551517,5949.75,2023-08-28T17:04:21,Barcelona,expenses,gifts,-764.75,-51247.39
buyer_4,Marc,Andreu,1974-05-23,54922038Q,marc.andreu@brilliantapp.app,964991,ES19209587111785551517,5949.75,2023-08-29T19:05:41,Barcelona,expenses,children,-1159.060833333334,-52406.45
buyer_4,Marc,Andreu,1974-05-23,54922038Q,marc.andreu@brilliantapp.app,964991,ES19209587111785551517,5949.75,2023-08-30T20:38:30,Barcelona,expenses,children,-1159.060833333334,-53565.51
buyer_4,Marc,Andreu,1974-05-23,54922038Q,marc.andreu@brilliantapp.app,964991,ES19209587111785551517,5949.75,2023-09-01T18:26:41,Barcelona,incomes,salary,2920.57,-50644.94
buyer_4,Marc,Andreu,1974-05-23,54922038Q,marc.andreu@brilliantapp.app,964991,ES19209587111785551517,5949.75,2023-09-01T23:22:28,Barcelona,expenses,food,-80.2,-50725.14
buyer_4,Marc,Andreu,1974-05-23,54922038Q,marc.andreu@brilliantapp.app,964991,ES19209587111785551517,5949.75,2023-09-04T20:20:49,Barcelona,expenses,food,-118.24,-50843.38
buyer_4,Marc,Andreu,1974-05-23,54922038Q,marc.andreu@brilliantapp.app,964991,ES19209587111785551517,5949.75,2023-09-05T11:49:56,Barcelona,expenses,mortgage,-1298.01,-52141.39
buyer_4,Marc,Andreu,1974-05-23,54922038Q,marc.andreu@brilliantapp.app,964991,ES19209587111785551517,5949.75,2023-09-05T11:40:05,Barcelona,expenses,electricity,-113.78,-52255.17
buyer_4,Marc,Andreu,1974-05-23,54922038Q,marc.andreu@brilliantapp.app,964991,ES19209587111785551517,5949.75,2023-09-05T12:31:15,Barcelona,expenses,internet,-61.33,-52316.5
buyer_4,Marc,Andreu,1974-05-23,54922038Q,marc.andreu@brilliantapp.app,964991,ES19209587111785551517,5949.75,2023-09-06T12:39:50,Barcelona,expenses,water,-51.17,-52367.67
buyer_4,Marc,Andreu,1974-05-23,54922038Q,marc.andreu@brilliantapp.app,964991,ES19209587111785551517,5949.75,2023-09-06T11:26:14,Barcelona,expenses,electricity,-39.1,-52406.77
buyer_4,Marc,Andreu,1974-05-23,54922038Q,marc.andreu@brilliantapp.app,964991,ES19209587111785551517,5949.75,2023-09-06T10:29:23,Barcelona,expenses,appliances,-377.08,-52783.85
buyer_4,Marc,Andreu,1974-05-23,54922038Q,marc.andreu@brilliantapp.app,964991,ES19209587111785551517,5949.75,2023-09-07T11:10:00,Barcelona,expenses,gas,-85.52,-52869.37
buyer_4,Marc,Andreu,1974-05-23,54922038Q,marc.andreu@brilliantapp.app,964991,ES19209587111785551517,5949.75,2023-09-07T18:09:17,Barcelona,expenses,internet,-61.33,-52930.7
buyer_4,Marc,Andreu,1974-05-23,54922038Q,marc.andreu@brilliantapp.app,964991,ES19209587111785551517,5949.75,2023-09-07T12:00:50,Barcelona,expenses,gifts,-483.89,-53414.59
buyer_4,Marc,Andreu,1974-05-23,54922038Q,marc.andreu@brilliantapp.app,964991,ES19209587111785551517,5949.75,2023-09-08T17:34:29,Barcelona,expenses,food,-114.72,-53529.31
buyer_4,Marc,Andreu,1974-05-23,54922038Q,marc.andreu@brilliantapp.app,964991,ES19209587111785551517,5949.75,2023-09-08T18:44:17,Barcelona,expenses,repairs,-231.54,-53760.85
buyer_4,Marc,Andreu,1974-05-23,54922038Q,marc.andreu@brilliantapp.app,964991,ES19209587111785551517,5949.75,2023-09-10T08:51:12,Barcelona,expenses,children,-997.25,-54758.1
buyer_4,Marc,Andreu,1974-05-23,54922038Q,marc.andreu@brilliantapp.app,964991,ES19209587111785551517,5949.75,2023-09-11T16:27:30,Barcelona,expenses,repairs,-234.05,-54992.15
buyer_4,Marc,Andreu,1974-05-23,54922038Q,marc.andreu@brilliantapp.app,964991,ES19209587111785551517,5949.75,2023-09-13T13:45:26,Barcelona,expenses,clothing,-74.97,-55067.12
buyer_4,Marc,Andreu,1974-05-23,54922038Q,marc.andreu@brilliantapp.app,964991,ES19209587111785551517,5949.75,2023-09-14T09:57:45,Barcelona,expenses,leisure,-56.05,-55123.17
buyer_4,Marc,Andreu,1974-05-23,54922038Q,marc.andreu@brilliantapp.app,964991,ES19209587111785551517,5949.75,2023-09-15T08:46:05,Barcelona,expenses,food,-79.11,-55202.28
buyer_4,Marc,Andreu,1974-05-23,54922038Q,marc.andreu@brilliantapp.app,964991,ES19209587111785551517,5949.75,2023-09-15T05:27:12,Barcelona,expenses,leisure,-34.27,-55236.55
buyer_4,Marc,Andreu,1974-05-23,54922038Q,marc.andreu@brilliantapp.app,964991,ES19209587111785551517,5949.75,2023-09-15T09:40:20,Barcelona,expenses,cash,-100.0,-55336.55
buyer_4,Marc,Andreu,1974-05-23,54922038Q,marc.andreu@brilliantapp.app,964991,ES19209587111785551517,5949.75,2023-09-17T20:54:06,Barcelona,expenses,cash,-100.0,-55436.55
buyer_4,Marc,Andreu,1974-05-23,54922038Q,marc.andreu@brilliantapp.app,964991,ES19209587111785551517,5949.75,2023-09-20T10:43:00,Barcelona,expenses,healthcare,-115.64,-55552.19
buyer_4,Marc,Andreu,1974-05-23,54922038Q,marc.andreu@brilliantapp.app,964991,ES19209587111785551517,5949.75,2023-09-21T20:39:37,Barcelona,expenses,food,-76.48,-55628.67
buyer_4,Marc,Andreu,1974-05-23,54922038Q,marc.andreu@brilliantapp.app,964991,ES19209587111785551517,5949.75,2023-09-21T15:44:29,Barcelona,expenses,transport,-70.68,-55699.35
buyer_4,Marc,Andreu,1974-05-23,54922038Q,marc.andreu@brilliantapp.app,964991,ES19209587111785551517,5949.75,2023-09-21T17:35:43,Barcelona,expenses,repairs,-130.04,-55829.39
buyer_4,Marc,Andreu,1974-05-23,54922038Q,marc.andreu@brilliantapp.app,964991,ES19209587111785551517,5949.75,2023-09-23T15:21:52,Barcelona,expenses,clothing,-159.53,-55988.92
buyer_4,Marc,Andreu,1974-05-23,54922038Q,marc.andreu@brilliantapp.app,964991,ES19209587111785551517,5949.75,2023-09-26T14:02:45,Barcelona,expenses,transport,-47.88,-56036.8
buyer_4,Marc,Andreu,1974-05-23,54922038Q,marc.andreu@brilliantapp.app,964991,ES19209587111785551517,5949.75,2023-09-26T18:08:06,Barcelona,expenses,leisure,-52.35,-56089.15
buyer_4,Marc,Andreu,1974-05-23,54922038Q,marc.andreu@brilliantapp.app,964991,ES19209587111785551517,5949.75,2023-09-27T10:48:22,Barcelona,expenses,cash,-100.0,-56189.15
buyer_4,Marc,Andreu,1974-05-23,54922038Q,marc.andreu@brilliantapp.app,964991,ES19209587111785551517,5949.75,2023-09-27T21:58:26,Barcelona,expenses,gifts,-181.38,-56370.53
buyer_4,Marc,Andreu,1974-05-23,54922038Q,marc.andreu@brilliantapp.app,964991,ES19209587111785551517,5949.75,2023-09-28T02:03:30,Barcelona,expenses,food,-83.54,-56454.07
buyer_4,Marc,Andreu,1974-05-23,54922038Q,marc.andreu@brilliantapp.app,964991,ES19209587111785551517,5949.75,2023-09-28T08:43:31,Barcelona,expenses,transport,-58.12,-56512.19
buyer_4,Marc,Andreu,1974-05-23,54922038Q,marc.andreu@brilliantapp.app,964991,ES19209587111785551517,5949.75,2023-09-28T19:27:33,Barcelona,expenses,cash,-100.0,-56612.19
buyer_4,Marc,Andreu,1974-05-23,54922038Q,marc.andreu@brilliantapp.app,964991,ES19209587111785551517,5949.75,2023-09-29T10:42:17,Barcelona,expenses,travel,-452.55,-57064.74
buyer_4,Marc,Andreu,1974-05-23,54922038Q,marc.andreu@brilliantapp.app,964991,ES19209587111785551517,5949.75,2023-10-01T13:39:38,Barcelona,incomes,salary,2920.57,-54144.17
buyer_4,Marc,Andreu,1974-05-23,54922038Q,marc.andreu@brilliantapp.app,964991,ES19209587111785551517,5949.75,2023-10-01T13:39:38,Barcelona,incomes,extra_income,514.74,-53629.43
buyer_4,Marc,Andreu,1974-05-23,54922038Q,marc.andreu@brilliantapp.app,964991,ES19209587111785551517,5949.75,2023-10-02T14:58:02,Barcelona,expenses,children,-1067.47,-54696.9
buyer_4,Marc,Andreu,1974-05-23,54922038Q,marc.andreu@brilliantapp.app,964991,ES19209587111785551517,5949.75,2023-10-03T12:09:17,Barcelona,expenses,transport,-68.42,-54765.32
buyer_4,Marc,Andreu,1974-05-23,54922038Q,marc.andreu@brilliantapp.app,964991,ES19209587111785551517,5949.75,2023-10-03T14:07:21,Barcelona,expenses,leisure,-33.35,-54798.67
buyer_4,Marc,Andreu,1974-05-23,54922038Q,marc.andreu@brilliantapp.app,964991,ES19209587111785551517,5949.75,2023-10-03T09:03:44,Barcelona,expenses,cash,-100.0,-54898.67
buyer_4,Marc,Andreu,1974-05-23,54922038Q,marc.andreu@brilliantapp.app,964991,ES19209587111785551517,5949.75,2023-10-04T18:24:26,Barcelona,expenses,food,-91.97,-54990.64
buyer_4,Marc,Andreu,1974-05-23,54922038Q,marc.andreu@brilliantapp.app,964991,ES19209587111785551517,5949.75,2023-10-04T08:27:34,Barcelona,expenses,transport,-86.21,-55076.85
buyer_4,Marc,Andreu,1974-05-23,54922038Q,marc.andreu@brilliantapp.app,964991,ES19209587111785551517,5949.75,2023-10-04T11:17:44,Barcelona,expenses,repairs,-147.58,-55224.43
buyer_4,Marc,Andreu,1974-05-23,54922038Q,marc.andreu@brilliantapp.app,964991,ES19209587111785551517,5949.75,2023-10-04T12:38:22,Barcelona,expenses,gifts,-295.47,-55519.9
buyer_4,Marc,Andreu,1974-05-23,54922038Q,marc.andreu@brilliantapp.app,964991,ES19209587111785551517,5949.75,2023-10-05T22:24:10,Barcelona,expenses,mortgage,-1298.01,-56817.91
buyer_4,Marc,Andreu,1974-05-23,54922038Q,marc.andreu@brilliantapp.app,964991,ES19209587111785551517,5949.75,2023-10-05T15:10:07,Barcelona,expenses,electricity,-86.66,-56904.57
buyer_4,Marc,Andreu,1974-05-23,54922038Q,marc.andreu@brilliantapp.app,964991,ES19209587111785551517,5949.75,2023-10-05T14:52:46,Barcelona,expenses,cash,-100.0,-57004.57
buyer_4,Marc,Andreu,1974-05-23,54922038Q,marc.andreu@brilliantapp.app,964991,ES19209587111785551517,5949.75,2023-10-07T20:08:09,Barcelona,expenses,internet,-61.33,-57065.9
buyer_4,Marc,Andreu,1974-05-23,54922038Q,marc.andreu@brilliantapp.app,964991,ES19209587111785551517,5949.75,2023-10-07T22:47:56,Barcelona,expenses,leisure,-73.51,-57139.41
buyer_4,Marc,Andreu,1974-05-23,54922038Q,marc.andreu@brilliantapp.app,964991,ES19209587111785551517,5949.75,2023-10-07T19:10:51,Barcelona,expenses,healthcare,-122.86,-57262.27
buyer_4,Marc,Andreu,1974-05-23,54922038Q,marc.andreu@brilliantapp.app,964991,ES19209587111785551517,5949.75,2023-10-07T08:54:19,Barcelona,expenses,repairs,-55.73,-57318.0
buyer_4,Marc,Andreu,1974-05-23,54922038Q,marc.andreu@brilliantapp.app,964991,ES19209587111785551517,5949.75,2023-10-08T21:03:40,Barcelona,expenses,water,-58.42,-57376.42
buyer_4,Marc,Andreu,1974-05-23,54922038Q,marc.andreu@brilliantapp.app,964991,ES19209587111785551517,5949.75,2023-10-08T21:07:11,Barcelona,expenses,gas,-152.19,-57528.61
buyer_4,Marc,Andreu,1974-05-23,54922038Q,marc.andreu@brilliantapp.app,964991,ES19209587111785551517,5949.75,2023-10-11T09:04:09,Barcelona,expenses,gifts,-342.74,-57871.35
buyer_4,Marc,Andreu,1974-05-23,54922038Q,marc.andreu@brilliantapp.app,964991,ES19209587111785551517,5949.75,2023-10-12T07:54:35,Barcelona,expenses,food,-69.33,-57940.68
buyer_4,Marc,Andreu,1974-05-23,54922038Q,marc.andreu@brilliantapp.app,964991,ES19209587111785551517,5949.75,2023-10-13T14:39:42,Barcelona,expenses,cash,-100.0,-58040.68
buyer_4,Marc,Andreu,1974-05-23,54922038Q,marc.andreu@brilliantapp.app,964991,ES19209587111785551517,5949.75,2023-10-13T11:11:03,Barcelona,expenses,repairs,-71.88,-58112.56
buyer_4,Marc,Andreu,1974-05-23,54922038Q,marc.andreu@brilliantapp.app,964991,ES19209587111785551517,5949.75,2023-10-15T05:56:23,Barcelona,expenses,food,-67.56,-58180.12
buyer_4,Marc,Andreu,1974-05-23,54922038Q,marc.andreu@brilliantapp.app,964991,ES19209587111785551517,5949.75,2023-10-16T20:59:06,Barcelona,expenses,cash,-100.0,-58280.12
buyer_4,Marc,Andreu,1974-05-23,54922038Q,marc.andreu@brilliantapp.app,964991,ES19209587111785551517,5949.75,2023-10-20T19:16:15,Barcelona,expenses,food,-70.93,-58351.05
buyer_4,Marc,Andreu,1974-05-23,54922038Q,marc.andreu@brilliantapp.app,964991,ES19209587111785551517,5949.75,2023-10-20T18:03:57,Barcelona,expenses,transport,-80.73,-58431.78
buyer_4,Marc,Andreu,1974-05-23,54922038Q,marc.andreu@brilliantapp.app,964991,ES19209587111785551517,5949.75,2023-10-20T12:56:16,Barcelona,expenses,cash,-100.0,-58531.78
buyer_4,Marc,Andreu,1974-05-23,54922038Q,marc.andreu@brilliantapp.app,964991,ES19209587111785551517,5949.75,2023-10-21T23:58:31,Barcelona,expenses,transport,-61.52,-58593.3
buyer_4,Marc,Andreu,1974-05-23,54922038Q,marc.andreu@brilliantapp.app,964991,ES19209587111785551517,5949.75,2023-10-22T13:21:08,Barcelona,expenses,food,-112.76,-58706.06
buyer_4,Marc,Andreu,1974-05-23,54922038Q,marc.andreu@brilliantapp.app,964991,ES19209587111785551517,5949.75,2023-10-24T12:50:29,Barcelona,expenses,cash,-100.0,-58806.06
buyer_4,Marc,Andreu,1974-05-23,54922038Q,marc.andreu@brilliantapp.app,964991,ES19209587111785551517,5949.75,2023-10-25T13:12:26,Barcelona,expenses,gifts,-565.89,-59371.95
buyer_4,Marc,Andreu,1974-05-23,54922038Q,marc.andreu@brilliantapp.app,964991,ES19209587111785551517,5949.75,2023-10-27T16:51:35,Barcelona,expenses,food,-122.81,-59494.76
buyer_4,Marc,Andreu,1974-05-23,54922038Q,marc.andreu@brilliantapp.app,964991,ES19209587111785551517,5949.75,2023-10-29T15:00:43,Barcelona,expenses,cash,-100.0,-59594.76
buyer_4,Marc,Andreu,1974-05-23,54922038Q,marc.andreu@brilliantapp.app,964991,ES19209587111785551517,5949.75,2023-10-30T09:28:28,Barcelona,expenses,food,-76.02,-59670.78
buyer_4,Marc,Andreu,1974-05-23,54922038Q,marc.andreu@brilliantapp.app,964991,ES19209587111785551517,5949.75,2023-10-31T13:39:28,Barcelona,expenses,cash,-100.0,-59770.78
buyer_4,Marc,Andreu,1974-05-23,54922038Q,marc.andreu@brilliantapp.app,964991,ES19209587111785551517,5949.75,2023-11-01T10:55:32,Barcelona,incomes,salary,2920.57,-56850.21
buyer_4,Marc,Andreu,1974-05-23,54922038Q,marc.andreu@brilliantapp.app,964991,ES19209587111785551517,5949.75,2023-11-01T21:05:39,Barcelona,expenses,food,-117.29,-56967.5
buyer_4,Marc,Andreu,1974-05-23,54922038Q,marc.andreu@brilliantapp.app,964991,ES19209587111785551517,5949.75,2023-11-01T18:30:32,Barcelona,expenses,transport,-58.0,-57025.5
buyer_4,Marc,Andreu,1974-05-23,54922038Q,marc.andreu@brilliantapp.app,964991,ES19209587111785551517,5949.75,2023-11-01T10:44:14,Barcelona,expenses,cash,-100.0,-57125.5
buyer_4,Marc,Andreu,1974-05-23,54922038Q,marc.andreu@brilliantapp.app,964991,ES19209587111785551517,5949.75,2023-11-02T22:39:53,Barcelona,expenses,food,-75.54,-57201.04
buyer_4,Marc,Andreu,1974-05-23,54922038Q,marc.andreu@brilliantapp.app,964991,ES19209587111785551517,5949.75,2023-11-02T00:52:20,Barcelona,expenses,gifts,-544.44,-57745.48
buyer_4,Marc,Andreu,1974-05-23,54922038Q,marc.andreu@brilliantapp.app,964991,ES19209587111785551517,5949.75,2023-11-03T08:43:12,Barcelona,expenses,healthcare,-138.79,-57884.27
buyer_4,Marc,Andreu,1974-05-23,54922038Q,marc.andreu@brilliantapp.app,964991,ES19209587111785551517,5949.75,2023-11-04T16:30:54,Barcelona,expenses,gifts,-504.99,-58389.26
buyer_4,Marc,Andreu,1974-05-23,54922038Q,marc.andreu@brilliantapp.app,964991,ES19209587111785551517,5949.75,2023-11-05T14:07:52,Barcelona,expenses,mortgage,-1298.01,-59687.27
buyer_4,Marc,Andreu,1974-05-23,54922038Q,marc.andreu@brilliantapp.app,964991,ES19209587111785551517,5949.75,2023-11-06T16:18:34,Barcelona,expenses,cash,-100.0,-59787.27
buyer_4,Marc,Andreu,1974-05-23,54922038Q,marc.andreu@brilliantapp.app,964991,ES19209587111785551517,5949.75,2023-11-07T13:52:04,Barcelona,expenses,water,-65.44,-59852.71
buyer_4,Marc,Andreu,1974-05-23,54922038Q,marc.andreu@brilliantapp.app,964991,ES19209587111785551517,5949.75,2023-11-07T05:17:05,Barcelona,expenses,phone,-56.26,-59908.97
buyer_4,Marc,Andreu,1974-05-23,54922038Q,marc.andreu@brilliantapp.app,964991,ES19209587111785551517,5949.75,2023-11-08T22:23:03,Barcelona,expenses,water,-49.44,-59958.41
buyer_4,Marc,Andreu,1974-05-23,54922038Q,marc.andreu@brilliantapp.app,964991,ES19209587111785551517,5949.75,2023-11-08T15:35:54,Barcelona,expenses,gas,-133.25,-60091.66
buyer_4,Marc,Andreu,1974-05-23,54922038Q,marc.andreu@brilliantapp.app,964991,ES19209587111785551517,5949.75,2023-11-10T16:56:07,Barcelona,expenses,clothing,-123.71,-60215.37
buyer_4,Marc,Andreu,1974-05-23,54922038Q,marc.andreu@brilliantapp.app,964991,ES19209587111785551517,5949.75,2023-11-10T04:03:32,Barcelona,expenses,children,-1035.3508333333339,-61250.72
buyer_4,Marc,Andreu,1974-05-23,54922038Q,marc.andreu@brilliantapp.app,964991,ES19209587111785551517,5949.75,2023-11-12T20:24:10,Barcelona,expenses,healthcare,-40.56,-61291.28
buyer_4,Marc,Andreu,1974-05-23,54922038Q,marc.andreu@brilliantapp.app,964991,ES19209587111785551517,5949.75,2023-11-12T00:53:48,Barcelona,expenses,gifts,-804.07,-62095.35
buyer_4,Marc,Andreu,1974-05-23,54922038Q,marc.andreu@brilliantapp.app,964991,ES19209587111785551517,5949.75,2023-11-13T01:44:45,Barcelona,expenses,leisure,-41.01,-62136.36
buyer_4,Marc,Andreu,1974-05-23,54922038Q,marc.andreu@brilliantapp.app,964991,ES19209587111785551517,5949.75,2023-11-13T04:58:35,Barcelona,expenses,appliances,-96.47,-62232.83
buyer_4,Marc,Andreu,1974-05-23,54922038Q,marc.andreu@brilliantapp.app,964991,ES19209587111785551517,5949.75,2023-11-15T11:34:44,Barcelona,expenses,cash,-100.0,-62332.83
buyer_4,Marc,Andreu,1974-05-23,54922038Q,marc.andreu@brilliantapp.app,964991,ES19209587111785551517,5949.75,2023-11-17T17:59:44,Barcelona,expenses,cash,-100.0,-62432.83
buyer_4,Marc,Andreu,1974-05-23,54922038Q,marc.andreu@brilliantapp.app,964991,ES19209587111785551517,5949.75,2023-11-18T10:44:16,Barcelona,expenses,children,-1159.060833333334,-63591.89
buyer_4,Marc,Andreu,1974-05-23,54922038Q,marc.andreu@brilliantapp.app,964991,ES19209587111785551517,5949.75,2023-11-22T19:48:55,Barcelona,expenses,leisure,-60.44,-63652.33
buyer_4,Marc,Andreu,1974-05-23,54922038Q,marc.andreu@brilliantapp.app,964991,ES19209587111785551517,5949.75,2023-11-23T20:50:33,Barcelona,expenses,transport,-83.17,-63735.5
buyer_4,Marc,Andreu,1974-05-23,54922038Q,marc.andreu@brilliantapp.app,964991,ES19209587111785551517,5949.75,2023-11-23T09:21:23,Barcelona,expenses,leisure,-58.31,-63793.81
buyer_4,Marc,Andreu,1974-05-23,54922038Q,marc.andreu@brilliantapp.app,964991,ES19209587111785551517,5949.75,2023-11-26T16:58:07,Barcelona,expenses,food,-68.15,-63861.96
buyer_4,Marc,Andreu,1974-05-23,54922038Q,marc.andreu@brilliantapp.app,964991,ES19209587111785551517,5949.75,2023-11-26T19:32:27,Barcelona,expenses,leisure,-24.96,-63886.92
buyer_4,Marc,Andreu,1974-05-23,54922038Q,marc.andreu@brilliantapp.app,964991,ES19209587111785551517,5949.75,2023-11-26T08:13:29,Barcelona,expenses,car,-453.51,-64340.43
buyer_4,Marc,Andreu,1974-05-23,54922038Q,marc.andreu@brilliantapp.app,964991,ES19209587111785551517,5949.75,2023-11-28T18:12:26,Barcelona,expenses,cash,-100.0,-64440.43
buyer_4,Marc,Andreu,1974-05-23,54922038Q,marc.andreu@brilliantapp.app,964991,ES19209587111785551517,5949.75,2023-11-29T08:53:51,Barcelona,expenses,cash,-100.0,-64540.43
buyer_4,Marc,Andreu,1974-05-23,54922038Q,marc.andreu@brilliantapp.app,964991,ES19209587111785551517,5949.75,2023-12-01T15:48:14,Barcelona,incomes,salary,2920.57,-61619.86
buyer_4,Marc,Andreu,1974-05-23,54922038Q,marc.andreu@brilliantapp.app,964991,ES19209587111785551517,5949.75,2023-12-01T15:48:14,Barcelona,incomes,salary_bonus,2253.53,-59366.33
buyer_4,Marc,Andreu,1974-05-23,54922038Q,marc.andreu@brilliantapp.app,964991,ES19209587111785551517,5949.75,2023-12-02T18:28:46,Barcelona,expenses,food,-68.49,-59434.82
buyer_4,Marc,Andreu,1974-05-23,54922038Q,marc.andreu@brilliantapp.app,964991,ES19209587111785551517,5949.75,2023-12-02T08:38:18,Barcelona,expenses,education,-75.52,-59510.34
buyer_4,Marc,Andreu,1974-05-23,54922038Q,marc.andreu@brilliantapp.app,964991,ES19209587111785551517,5949.75,2023-12-03T11:40:33,Barcelona,expenses,cash,-100.0,-59610.34
buyer_4,Marc,Andreu,1974-05-23,54922038Q,marc.andreu@brilliantapp.app,964991,ES19209587111785551517,5949.75,2023-12-05T13:13:37,Barcelona,expenses,mortgage,-1298.01,-60908.35
buyer_4,Marc,Andreu,1974-05-23,54922038Q,marc.andreu@brilliantapp.app,964991,ES19209587111785551517,5949.75,2023-12-05T23:22:16,Barcelona,expenses,water,-53.5,-60961.85
buyer_4,Marc,Andreu,1974-05-23,54922038Q,marc.andreu@brilliantapp.app,964991,ES19209587111785551517,5949.75,2023-12-05T19:15:46,Barcelona,expenses,children,-920.35,-61882.2
buyer_4,Marc,Andreu,1974-05-23,54922038Q,marc.andreu@brilliantapp.app,964991,ES19209587111785551517,5949.75,2023-12-06T10:12:12,Barcelona,expenses,water,-52.04,-61934.24
buyer_4,Marc,Andreu,1974-05-23,54922038Q,marc.andreu@brilliantapp.app,964991,ES19209587111785551517,5949.75,2023-12-06T11:00:32,Barcelona,expenses,cash,-100.0,-62034.24
buyer_4,Marc,Andreu,1974-05-23,54922038Q,marc.andreu@brilliantapp.app,964991,ES19209587111785551517,5949.75,2023-12-06T10:24:32,Barcelona,expenses,repairs,-121.23,-62155.47
buyer_4,Marc,Andreu,1974-05-23,54922038Q,marc.andreu@brilliantapp.app,964991,ES19209587111785551517,5949.75,2023-12-07T18:55:00,Barcelona,expenses,gas,-54.47,-62209.94
buyer_4,Marc,Andreu,1974-05-23,54922038Q,marc.andreu@brilliantapp.app,964991,ES19209587111785551517,5949.75,2023-12-07T08:44:05,Barcelona,expenses,phone,-54.92,-62264.86
buyer_4,Marc,Andreu,1974-05-23,54922038Q,marc.andreu@brilliantapp.app,964991,ES19209587111785551517,5949.75,2023-12-07T11:59:19,Barcelona,expenses,cash,-100.0,-62364.86
buyer_4,Marc,Andreu,1974-05-23,54922038Q,marc.andreu@brilliantapp.app,964991,ES19209587111785551517,5949.75,2023-12-09T13:46:28,Barcelona,expenses,education,-45.4,-62410.26
buyer_4,Marc,Andreu,1974-05-23,54922038Q,marc.andreu@brilliantapp.app,964991,ES19209587111785551517,5949.75,2023-12-11T15:10:37,Barcelona,expenses,children,-1159.060833333334,-63569.32
buyer_4,Marc,Andreu,1974-05-23,54922038Q,marc.andreu@brilliantapp.app,964991,ES19209587111785551517,5949.75,2023-12-13T19:59:44,Barcelona,expenses,cash,-100.0,-63669.32
buyer_4,Marc,Andreu,1974-05-23,54922038Q,marc.andreu@brilliantapp.app,964991,ES19209587111785551517,5949.75,2023-12-14T08:25:24,Barcelona,expenses,cash,-100.0,-63769.32
buyer_4,Marc,Andreu,1974-05-23,54922038Q,marc.andreu@brilliantapp.app,964991,ES19209587111785551517,5949.75,2023-12-15T17:49:48,Barcelona,expenses,food,-80.01,-63849.33
buyer_4,Marc,Andreu,1974-05-23,54922038Q,marc.andreu@brilliantapp.app,964991,ES19209587111785551517,5949.75,2023-12-15T06:27:54,Barcelona,expenses,clothing,-114.25,-63963.58
buyer_4,Marc,Andreu,1974-05-23,54922038Q,marc.andreu@brilliantapp.app,964991,ES19209587111785551517,5949.75,2023-12-15T09:46:10,Barcelona,expenses,appliances,-99.07,-64062.65
buyer_4,Marc,Andreu,1974-05-23,54922038Q,marc.andreu@brilliantapp.app,964991,ES19209587111785551517,5949.75,2023-12-17T18:11:07,Barcelona,expenses,healthcare,-173.81,-64236.46
buyer_4,Marc,Andreu,1974-05-23,54922038Q,marc.andreu@brilliantapp.app,964991,ES19209587111785551517,5949.75,2023-12-17T16:27:16,Barcelona,expenses,cash,-100.0,-64336.46
buyer_4,Marc,Andreu,1974-05-23,54922038Q,marc.andreu@brilliantapp.app,964991,ES19209587111785551517,5949.75,2023-12-21T08:00:54,Barcelona,expenses,gifts,-764.25,-65100.71
buyer_4,Marc,Andreu,1974-05-23,54922038Q,marc.andreu@brilliantapp.app,964991,ES19209587111785551517,5949.75,2023-12-22T14:37:37,Barcelona,expenses,food,-77.69,-65178.4
buyer_4,Marc,Andreu,1974-05-23,54922038Q,marc.andreu@brilliantapp.app,964991,ES19209587111785551517,5949.75,2023-12-22T18:57:20,Barcelona,expenses,leisure,-64.46,-65242.86
buyer_4,Marc,Andreu,1974-05-23,54922038Q,marc.andreu@brilliantapp.app,964991,ES19209587111785551517,5949.75,2023-12-22T10:34:11,Barcelona,expenses,cash,-100.0,-65342.86
buyer_4,Marc,Andreu,1974-05-23,54922038Q,marc.andreu@brilliantapp.app,964991,ES19209587111785551517,5949.75,2023-12-24T16:54:42,Barcelona,expenses,food,-69.45,-65412.31
buyer_4,Marc,Andreu,1974-05-23,54922038Q,marc.andreu@brilliantapp.app,964991,ES19209587111785551517,5949.75,2023-12-26T13:21:47,Barcelona,expenses,leisure,-74.69,-65487.0
buyer_4,Marc,Andreu,1974-05-23,54922038Q,marc.andreu@brilliantapp.app,964991,ES19209587111785551517,5949.75,2023-12-27T09:21:46,Barcelona,expenses,transport,-48.37,-65535.37
buyer_4,Marc,Andreu,1974-05-23,54922038Q,marc.andreu@brilliantapp.app,964991,ES19209587111785551517,5949.75,2023-12-28T05:01:34,Barcelona,expenses,cash,-100.0,-65635.37
buyer_4,Marc,Andreu,1974-05-23,54922038Q,marc.andreu@brilliantapp.app,964991,ES19209587111785551517,5949.75,2023-12-31T20:27:38,Barcelona,expenses,leisure,-49.49,-65684.86
buyer_4,Marc,Andreu,1974-05-23,54922038Q,marc.andreu@brilliantapp.app,964991,ES19209587111785551517,5949.75,2024-01-01T16:49:26,Barcelona,incomes,salary,3019.55,-62665.31
buyer_4,Marc,Andreu,1974-05-23,54922038Q,marc.andreu@brilliantapp.app,964991,ES19209587111785551517,5949.75,2024-01-01T15:19:57,Barcelona,expenses,food,-64.34,-62729.65
buyer_4,Marc,Andreu,1974-05-23,54922038Q,marc.andreu@brilliantapp.app,964991,ES19209587111785551517,5949.75,2024-01-01T18:44:50,Barcelona,expenses,cash,-100.0,-62829.65
buyer_4,Marc,Andreu,1974-05-23,54922038Q,marc.andreu@brilliantapp.app,964991,ES19209587111785551517,5949.75,2024-01-05T15:07:10,Barcelona,expenses,mortgage,-1516.63,-64346.28
buyer_4,Marc,Andreu,1974-05-23,54922038Q,marc.andreu@brilliantapp.app,964991,ES19209587111785551517,5949.75,2024-01-05T17:51:15,Barcelona,expenses,water,-35.45,-64381.73
buyer_4,Marc,Andreu,1974-05-23,54922038Q,marc.andreu@brilliantapp.app,964991,ES19209587111785551517,5949.75,2024-01-05T12:29:28,Barcelona,expenses,electricity,-108.57,-64490.3
buyer_4,Marc,Andreu,1974-05-23,54922038Q,marc.andreu@brilliantapp.app,964991,ES19209587111785551517,5949.75,2024-01-05T13:03:10,Barcelona,expenses,gas,-150.03,-64640.33
buyer_4,Marc,Andreu,1974-05-23,54922038Q,marc.andreu@brilliantapp.app,964991,ES19209587111785551517,5949.75,2024-01-06T10:43:52,Barcelona,expenses,water,-42.07,-64682.4
buyer_4,Marc,Andreu,1974-05-23,54922038Q,marc.andreu@brilliantapp.app,964991,ES19209587111785551517,5949.75,2024-01-06T21:56:20,Barcelona,expenses,phone,-50.41,-64732.81
buyer_4,Marc,Andreu,1974-05-23,54922038Q,marc.andreu@brilliantapp.app,964991,ES19209587111785551517,5949.75,2024-01-07T17:03:55,Barcelona,expenses,clothing,-159.68,-64892.49
buyer_4,Marc,Andreu,1974-05-23,54922038Q,marc.andreu@brilliantapp.app,964991,ES19209587111785551517,5949.75,2024-01-07T09:40:25,Barcelona,expenses,cash,-100.0,-64992.49
buyer_4,Marc,Andreu,1974-05-23,54922038Q,marc.andreu@brilliantapp.app,964991,ES19209587111785551517,5949.75,2024-01-08T18:12:41,Barcelona,expenses,transport,-71.1,-65063.59
buyer_4,Marc,Andreu,1974-05-23,54922038Q,marc.andreu@brilliantapp.app,964991,ES19209587111785551517,5949.75,2024-01-09T21:23:42,Barcelona,expenses,food,-110.75,-65174.34
buyer_4,Marc,Andreu,1974-05-23,54922038Q,marc.andreu@brilliantapp.app,964991,ES19209587111785551517,5949.75,2024-01-10T18:43:10,Barcelona,expenses,cash,-100.0,-65274.34
buyer_4,Marc,Andreu,1974-05-23,54922038Q,marc.andreu@brilliantapp.app,964991,ES19209587111785551517,5949.75,2024-01-12T22:37:35,Barcelona,expenses,food,-103.13,-65377.47
buyer_4,Marc,Andreu,1974-05-23,54922038Q,marc.andreu@brilliantapp.app,964991,ES19209587111785551517,5949.75,2024-01-12T16:45:53,Barcelona,expenses,repairs,-168.46,-65545.93
buyer_4,Marc,Andreu,1974-05-23,54922038Q,marc.andreu@brilliantapp.app,964991,ES19209587111785551517,5949.75,2024-01-12T13:10:46,Barcelona,expenses,gifts,-101.58,-65647.51
buyer_4,Marc,Andreu,1974-05-23,54922038Q,marc.andreu@brilliantapp.app,964991,ES19209587111785551517,5949.75,2024-01-13T17:30:02,Barcelona,expenses,cash,-100.0,-65747.51
buyer_4,Marc,Andreu,1974-05-23,54922038Q,marc.andreu@brilliantapp.app,964991,ES19209587111785551517,5949.75,2024-01-14T20:21:15,Barcelona,expenses,food,-89.35,-65836.86
buyer_4,Marc,Andreu,1974-05-23,54922038Q,marc.andreu@brilliantapp.app,964991,ES19209587111785551517,5949.75,2024-01-14T20:39:51,Barcelona,expenses,gifts,-542.32,-66379.18
buyer_4,Marc,Andreu,1974-05-23,54922038Q,marc.andreu@brilliantapp.app,964991,ES19209587111785551517,5949.75,2024-01-16T12:16:17,Barcelona,expenses,cash,-100.0,-66479.18
buyer_4,Marc,Andreu,1974-05-23,54922038Q,marc.andreu@brilliantapp.app,964991,ES19209587111785551517,5949.75,2024-01-16T21:26:24,Barcelona,expenses,travel,-661.94,-67141.12
buyer_4,Marc,Andreu,1974-05-23,54922038Q,marc.andreu@brilliantapp.app,964991,ES19209587111785551517,5949.75,2024-01-16T17:31:39,Barcelona,expenses,children,-268.44375000000014,-67409.56
buyer_4,Marc,Andreu,1974-05-23,54922038Q,marc.andreu@brilliantapp.app,964991,ES19209587111785551517,5949.75,2024-01-18T05:21:10,Barcelona,expenses,clothing,-102.32,-67511.88
buyer_4,Marc,Andreu,1974-05-23,54922038Q,marc.andreu@brilliantapp.app,964991,ES19209587111785551517,5949.75,2024-01-19T20:57:43,Barcelona,expenses,cash,-100.0,-67611.88
buyer_4,Marc,Andreu,1974-05-23,54922038Q,marc.andreu@brilliantapp.app,964991,ES19209587111785551517,5949.75,2024-01-21T16:17:36,Barcelona,expenses,education,-76.84,-67688.72
buyer_4,Marc,Andreu,1974-05-23,54922038Q,marc.andreu@brilliantapp.app,964991,ES19209587111785551517,5949.75,2024-01-22T08:45:14,Barcelona,expenses,cash,-100.0,-67788.72
buyer_4,Marc,Andreu,1974-05-23,54922038Q,marc.andreu@brilliantapp.app,964991,ES19209587111785551517,5949.75,2024-01-22T16:21:50,Barcelona,expenses,gifts,-706.42,-68495.14
buyer_4,Marc,Andreu,1974-05-23,54922038Q,marc.andreu@brilliantapp.app,964991,ES19209587111785551517,5949.75,2024-01-23T18:01:52,Barcelona,expenses,transport,-67.92,-68563.06
buyer_4,Marc,Andreu,1974-05-23,54922038Q,marc.andreu@brilliantapp.app,964991,ES19209587111785551517,5949.75,2024-01-24T08:10:13,Barcelona,expenses,leisure,-48.11,-68611.17
buyer_4,Marc,Andreu,1974-05-23,54922038Q,marc.andreu@brilliantapp.app,964991,ES19209587111785551517,5949.75,2024-01-24T11:45:22,Barcelona,expenses,gifts,-252.95,-68864.12
buyer_4,Marc,Andreu,1974-05-23,54922038Q,marc.andreu@brilliantapp.app,964991,ES19209587111785551517,5949.75,2024-01-25T10:44:59,Barcelona,expenses,transport,-68.56,-68932.68
buyer_4,Marc,Andreu,1974-05-23,54922038Q,marc.andreu@brilliantapp.app,964991,ES19209587111785551517,5949.75,2024-01-25T17:19:24,Barcelona,expenses,education,-75.06,-69007.74
buyer_4,Marc,Andreu,1974-05-23,54922038Q,marc.andreu@brilliantapp.app,964991,ES19209587111785551517,5949.75,2024-01-26T17:10:33,Barcelona,expenses,leisure,-45.3,-69053.04
buyer_4,Marc,Andreu,1974-05-23,54922038Q,marc.andreu@brilliantapp.app,964991,ES19209587111785551517,5949.75,2024-01-26T07:53:32,Barcelona,expenses,cash,-100.0,-69153.04
buyer_4,Marc,Andreu,1974-05-23,54922038Q,marc.andreu@brilliantapp.app,964991,ES19209587111785551517,5949.75,2024-01-26T15:57:10,Barcelona,expenses,travel,-284.41,-69437.45
buyer_4,Marc,Andreu,1974-05-23,54922038Q,marc.andreu@brilliantapp.app,964991,ES19209587111785551517,5949.75,2024-01-26T19:50:47,Barcelona,expenses,gifts,-502.47,-69939.92
buyer_4,Marc,Andreu,1974-05-23,54922038Q,marc.andreu@brilliantapp.app,964991,ES19209587111785551517,5949.75,2024-01-27T17:00:03,Barcelona,expenses,education,-49.66,-69989.58
buyer_4,Marc,Andreu,1974-05-23,54922038Q,marc.andreu@brilliantapp.app,964991,ES19209587111785551517,5949.75,2024-01-29T09:42:22,Barcelona,expenses,repairs,-185.94,-70175.52
buyer_4,Marc,Andreu,1974-05-23,54922038Q,marc.andreu@brilliantapp.app,964991,ES19209587111785551517,5949.75,2024-01-30T17:32:03,Barcelona,expenses,food,-114.35,-70289.87
buyer_4,Marc,Andreu,1974-05-23,54922038Q,marc.andreu@brilliantapp.app,964991,ES19209587111785551517,5949.75,2024-01-31T06:32:37,Barcelona,expenses,cash,-100.0,-70389.87
buyer_4,Marc,Andreu,1974-05-23,54922038Q,marc.andreu@brilliantapp.app,964991,ES19209587111785551517,5949.75,2024-02-01T19:47:20,Barcelona,incomes,salary,3019.55,-67370.32
buyer_4,Marc,Andreu,1974-05-23,54922038Q,marc.andreu@brilliantapp.app,964991,ES19209587111785551517,5949.75,2024-02-01T19:47:20,Barcelona,incomes,extra_income,514.74,-66855.58
buyer_4,Marc,Andreu,1974-05-23,54922038Q,marc.andreu@brilliantapp.app,964991,ES19209587111785551517,5949.75,2024-02-02T08:38:00,Barcelona,expenses,transport,-44.8,-66900.38
buyer_4,Marc,Andreu,1974-05-23,54922038Q,marc.andreu@brilliantapp.app,964991,ES19209587111785551517,5949.75,2024-02-04T11:30:22,Barcelona,expenses,leisure,-18.63,-66919.01
buyer_4,Marc,Andreu,1974-05-23,54922038Q,marc.andreu@brilliantapp.app,964991,ES19209587111785551517,5949.75,2024-02-05T12:44:09,Barcelona,expenses,mortgage,-1516.63,-68435.64
buyer_4,Marc,Andreu,1974-05-23,54922038Q,marc.andreu@brilliantapp.app,964991,ES19209587111785551517,5949.75,2024-02-05T20:49:39,Barcelona,expenses,food,-119.63,-68555.27
buyer_4,Marc,Andreu,1974-05-23,54922038Q,marc.andreu@brilliantapp.app,964991,ES19209587111785551517,5949.75,2024-02-05T10:09:58,Barcelona,expenses,clothing,-145.3,-68700.57
buyer_4,Marc,Andreu,1974-05-23,54922038Q,marc.andreu@brilliantapp.app,964991,ES19209587111785551517,5949.75,2024-02-05T21:13:26,Barcelona,expenses,appliances,-390.35,-69090.92
buyer_4,Marc,Andreu,1974-05-23,54922038Q,marc.andreu@brilliantapp.app,964991,ES19209587111785551517,5949.75,2024-02-06T15:50:12,Barcelona,expenses,electricity,-52.63,-69143.55
buyer_4,Marc,Andreu,1974-05-23,54922038Q,marc.andreu@brilliantapp.app,964991,ES19209587111785551517,5949.75,2024-02-06T18:09:42,Barcelona,expenses,transport,-75.59,-69219.14
buyer_4,Marc,Andreu,1974-05-23,54922038Q,marc.andreu@brilliantapp.app,964991,ES19209587111785551517,5949.75,2024-02-07T13:12:56,Barcelona,expenses,gas,-80.36,-69299.5
buyer_4,Marc,Andreu,1974-05-23,54922038Q,marc.andreu@brilliantapp.app,964991,ES19209587111785551517,5949.75,2024-02-07T20:00:58,Barcelona,expenses,phone,-56.63,-69356.13
buyer_4,Marc,Andreu,1974-05-23,54922038Q,marc.andreu@brilliantapp.app,964991,ES19209587111785551517,5949.75,2024-02-07T15:32:20,Barcelona,expenses,travel,-816.31,-70172.44
buyer_4,Marc,Andreu,1974-05-23,54922038Q,marc.andreu@brilliantapp.app,964991,ES19209587111785551517,5949.75,2024-02-08T11:58:46,Barcelona,expenses,transport,-65.72,-70238.16
buyer_4,Marc,Andreu,1974-05-23,54922038Q,marc.andreu@brilliantapp.app,964991,ES19209587111785551517,5949.75,2024-02-08T13:18:19,Barcelona,expenses,leisure,-19.11,-70257.27
buyer_4,Marc,Andreu,1974-05-23,54922038Q,marc.andreu@brilliantapp.app,964991,ES19209587111785551517,5949.75,2024-02-08T16:43:11,Barcelona,expenses,cash,-100.0,-70357.27
buyer_4,Marc,Andreu,1974-05-23,54922038Q,marc.andreu@brilliantapp.app,964991,ES19209587111785551517,5949.75,2024-02-09T19:27:56,Barcelona,expenses,car,-520.33,-70877.6
buyer_4,Marc,Andreu,1974-05-23,54922038Q,marc.andreu@brilliantapp.app,964991,ES19209587111785551517,5949.75,2024-02-10T12:59:53,Barcelona,expenses,clothing,-94.43,-70972.03
buyer_4,Marc,Andreu,1974-05-23,54922038Q,marc.andreu@brilliantapp.app,964991,ES19209587111785551517,5949.75,2024-02-13T10:12:00,Barcelona,expenses,transport,-74.72,-71046.75
buyer_4,Marc,Andreu,1974-05-23,54922038Q,marc.andreu@brilliantapp.app,964991,ES19209587111785551517,5949.75,2024-02-13T21:57:56,Barcelona,expenses,education,-51.33,-71098.08
buyer_4,Marc,Andreu,1974-05-23,54922038Q,marc.andreu@brilliantapp.app,964991,ES19209587111785551517,5949.75,2024-02-13T17:14:06,Barcelona,expenses,travel,-512.46,-71610.54
buyer_4,Marc,Andreu,1974-05-23,54922038Q,marc.andreu@brilliantapp.app,964991,ES19209587111785551517,5949.75,2024-02-14T20:45:15,Barcelona,expenses,cash,-100.0,-71710.54
buyer_4,Marc,Andreu,1974-05-23,54922038Q,marc.andreu@brilliantapp.app,964991,ES19209587111785551517,5949.75,2024-02-18T17:45:56,Barcelona,expenses,food,-118.9,-71829.44
buyer_4,Marc,Andreu,1974-05-23,54922038Q,marc.andreu@brilliantapp.app,964991,ES19209587111785551517,5949.75,2024-02-22T11:04:57,Barcelona,expenses,education,-48.17,-71877.61
buyer_4,Marc,Andreu,1974-05-23,54922038Q,marc.andreu@brilliantapp.app,964991,ES19209587111785551517,5949.75,2024-02-23T01:17:20,Barcelona,expenses,cash,-100.0,-71977.61
buyer_4,Marc,Andreu,1974-05-23,54922038Q,marc.andreu@brilliantapp.app,964991,ES19209587111785551517,5949.75,2024-02-24T05:05:26,Barcelona,expenses,gifts,-802.6,-72780.21
buyer_4,Marc,Andreu,1974-05-23,54922038Q,marc.andreu@brilliantapp.app,964991,ES19209587111785551517,5949.75,2024-02-25T18:04:22,Barcelona,expenses,clothing,-98.6,-72878.81
buyer_4,Marc,Andreu,1974-05-23,54922038Q,marc.andreu@brilliantapp.app,964991,ES19209587111785551517,5949.75,2024-02-25T13:34:10,Barcelona,expenses,healthcare,-72.01,-72950.82
buyer_4,Marc,Andreu,1974-05-23,54922038Q,marc.andreu@brilliantapp.app,964991,ES19209587111785551517,5949.75,2024-02-27T09:17:28,Barcelona,expenses,food,-120.49,-73071.31
buyer_4,Marc,Andreu,1974-05-23,54922038Q,marc.andreu@brilliantapp.app,964991,ES19209587111785551517,5949.75,2024-02-27T15:28:42,Barcelona,expenses,gifts,-819.84,-73891.15
buyer_4,Marc,Andreu,1974-05-23,54922038Q,marc.andreu@brilliantapp.app,964991,ES19209587111785551517,5949.75,2024-03-01T16:47:19,Barcelona,incomes,salary,3019.55,-70871.6
buyer_4,Marc,Andreu,1974-05-23,54922038Q,marc.andreu@brilliantapp.app,964991,ES19209587111785551517,5949.75,2024-03-02T08:13:28,Barcelona,expenses,gifts,-702.74,-71574.34
buyer_4,Marc,Andreu,1974-05-23,54922038Q,marc.andreu@brilliantapp.app,964991,ES19209587111785551517,5949.75,2024-03-03T09:58:55,Barcelona,expenses,food,-96.16,-71670.5
buyer_4,Marc,Andreu,1974-05-23,54922038Q,marc.andreu@brilliantapp.app,964991,ES19209587111785551517,5949.75,2024-03-03T11:51:23,Barcelona,expenses,cash,-100.0,-71770.5
buyer_4,Marc,Andreu,1974-05-23,54922038Q,marc.andreu@brilliantapp.app,964991,ES19209587111785551517,5949.75,2024-03-04T19:20:58,Barcelona,expenses,cash,-100.0,-71870.5
buyer_4,Marc,Andreu,1974-05-23,54922038Q,marc.andreu@brilliantapp.app,964991,ES19209587111785551517,5949.75,2024-03-05T10:59:53,Barcelona,expenses,mortgage,-1516.63,-73387.13
buyer_4,Marc,Andreu,1974-05-23,54922038Q,marc.andreu@brilliantapp.app,964991,ES19209587111785551517,5949.75,2024-03-06T18:21:21,Barcelona,expenses,electricity,-108.7,-73495.83
buyer_4,Marc,Andreu,1974-05-23,54922038Q,marc.andreu@brilliantapp.app,964991,ES19209587111785551517,5949.75,2024-03-06T08:02:15,Barcelona,expenses,gas,-150.46,-73646.29
buyer_4,Marc,Andreu,1974-05-23,54922038Q,marc.andreu@brilliantapp.app,964991,ES19209587111785551517,5949.75,2024-03-06T12:49:06,Barcelona,expenses,internet,-63.41,-73709.7
buyer_4,Marc,Andreu,1974-05-23,54922038Q,marc.andreu@brilliantapp.app,964991,ES19209587111785551517,5949.75,2024-03-08T14:50:52,Barcelona,expenses,water,-34.03,-73743.73
buyer_4,Marc,Andreu,1974-05-23,54922038Q,marc.andreu@brilliantapp.app,964991,ES19209587111785551517,5949.75,2024-03-08T10:11:36,Barcelona,expenses,gas,-126.3,-73870.03
buyer_4,Marc,Andreu,1974-05-23,54922038Q,marc.andreu@brilliantapp.app,964991,ES19209587111785551517,5949.75,2024-03-08T10:51:11,Barcelona,expenses,food,-122.82,-73992.85
buyer_4,Marc,Andreu,1974-05-23,54922038Q,marc.andreu@brilliantapp.app,964991,ES19209587111785551517,5949.75,2024-03-10T14:23:36,Barcelona,expenses,cash,-100.0,-74092.85
buyer_4,Marc,Andreu,1974-05-23,54922038Q,marc.andreu@brilliantapp.app,964991,ES19209587111785551517,5949.75,2024-03-10T23:53:09,Barcelona,expenses,repairs,-100.75,-74193.6
buyer_4,Marc,Andreu,1974-05-23,54922038Q,marc.andreu@brilliantapp.app,964991,ES19209587111785551517,5949.75,2024-03-11T11:52:31,Barcelona,expenses,clothing,-76.11,-74269.71
buyer_4,Marc,Andreu,1974-05-23,54922038Q,marc.andreu@brilliantapp.app,964991,ES19209587111785551517,5949.75,2024-03-12T19:31:04,Barcelona,expenses,leisure,-73.63,-74343.34
buyer_4,Marc,Andreu,1974-05-23,54922038Q,marc.andreu@brilliantapp.app,964991,ES19209587111785551517,5949.75,2024-03-15T09:52:06,Barcelona,expenses,transport,-73.64,-74416.98
buyer_4,Marc,Andreu,1974-05-23,54922038Q,marc.andreu@brilliantapp.app,964991,ES19209587111785551517,5949.75,2024-03-15T21:57:39,Barcelona,expenses,cash,-100.0,-74516.98
buyer_4,Marc,Andreu,1974-05-23,54922038Q,marc.andreu@brilliantapp.app,964991,ES19209587111785551517,5949.75,2024-03-16T13:05:56,Barcelona,expenses,leisure,-80.84,-74597.82
buyer_4,Marc,Andreu,1974-05-23,54922038Q,marc.andreu@brilliantapp.app,964991,ES19209587111785551517,5949.75,2024-03-17T12:55:37,Barcelona,expenses,food,-87.97,-74685.79
buyer_4,Marc,Andreu,1974-05-23,54922038Q,marc.andreu@brilliantapp.app,964991,ES19209587111785551517,5949.75,2024-03-18T23:30:29,Barcelona,expenses,food,-70.81,-74756.6
buyer_4,Marc,Andreu,1974-05-23,54922038Q,marc.andreu@brilliantapp.app,964991,ES19209587111785551517,5949.75,2024-03-19T20:06:04,Barcelona,expenses,food,-86.75,-74843.35
buyer_4,Marc,Andreu,1974-05-23,54922038Q,marc.andreu@brilliantapp.app,964991,ES19209587111785551517,5949.75,2024-03-19T13:12:02,Barcelona,expenses,repairs,-91.96,-74935.31
buyer_4,Marc,Andreu,1974-05-23,54922038Q,marc.andreu@brilliantapp.app,964991,ES19209587111785551517,5949.75,2024-03-21T08:40:30,Barcelona,expenses,leisure,-82.07,-75017.38
buyer_4,Marc,Andreu,1974-05-23,54922038Q,marc.andreu@brilliantapp.app,964991,ES19209587111785551517,5949.75,2024-03-22T07:08:12,Barcelona,expenses,gifts,-329.7,-75347.08
buyer_4,Marc,Andreu,1974-05-23,54922038Q,marc.andreu@brilliantapp.app,964991,ES19209587111785551517,5949.75,2024-03-23T02:03:23,Barcelona,expenses,leisure,-55.0,-75402.08
buyer_4,Marc,Andreu,1974-05-23,54922038Q,marc.andreu@brilliantapp.app,964991,ES19209587111785551517,5949.75,2024-03-25T11:25:41,Barcelona,expenses,food,-61.15,-75463.23
buyer_4,Marc,Andreu,1974-05-23,54922038Q,marc.andreu@brilliantapp.app,964991,ES19209587111785551517,5949.75,2024-03-28T12:21:20,Barcelona,expenses,transport,-67.15,-75530.38
buyer_4,Marc,Andreu,1974-05-23,54922038Q,marc.andreu@brilliantapp.app,964991,ES19209587111785551517,5949.75,2024-03-28T18:15:17,Barcelona,expenses,cash,-100.0,-75630.38
buyer_4,Marc,Andreu,1974-05-23,54922038Q,marc.andreu@brilliantapp.app,964991,ES19209587111785551517,5949.75,2024-04-01T18:45:14,Barcelona,incomes,salary,3019.55,-72610.83
buyer_4,Marc,Andreu,1974-05-23,54922038Q,marc.andreu@brilliantapp.app,964991,ES19209587111785551517,5949.75,2024-04-01T18:52:57,Barcelona,expenses,transport,-80.56,-72691.39
buyer_4,Marc,Andreu,1974-05-23,54922038Q,marc.andreu@brilliantapp.app,964991,ES19209587111785551517,5949.75,2024-04-01T21:00:54,Barcelona,expenses,leisure,-35.76,-72727.15
buyer_4,Marc,Andreu,1974-05-23,54922038Q,marc.andreu@brilliantapp.app,964991,ES19209587111785551517,5949.75,2024-04-02T11:19:50,Barcelona,expenses,gifts,-302.38,-73029.53
buyer_4,Marc,Andreu,1974-05-23,54922038Q,marc.andreu@brilliantapp.app,964991,ES19209587111785551517,5949.75,2024-04-04T11:50:50,Barcelona,expenses,leisure,-69.88,-73099.41
buyer_4,Marc,Andreu,1974-05-23,54922038Q,marc.andreu@brilliantapp.app,964991,ES19209587111785551517,5949.75,2024-04-05T11:19:36,Barcelona,expenses,mortgage,-1516.63,-74616.04
buyer_4,Marc,Andreu,1974-05-23,54922038Q,marc.andreu@brilliantapp.app,964991,ES19209587111785551517,5949.75,2024-04-05T18:51:52,Barcelona,expenses,internet,-63.41,-74679.45
buyer_4,Marc,Andreu,1974-05-23,54922038Q,marc.andreu@brilliantapp.app,964991,ES19209587111785551517,5949.75,2024-04-05T05:10:25,Barcelona,expenses,clothing,-72.56,-74752.01
buyer_4,Marc,Andreu,1974-05-23,54922038Q,marc.andreu@brilliantapp.app,964991,ES19209587111785551517,5949.75,2024-04-05T10:03:44,Barcelona,expenses,repairs,-127.47,-74879.48
buyer_4,Marc,Andreu,1974-05-23,54922038Q,marc.andreu@brilliantapp.app,964991,ES19209587111785551517,5949.75,2024-04-05T08:02:27,Barcelona,expenses,gifts,-528.13,-75407.61
buyer_4,Marc,Andreu,1974-05-23,54922038Q,marc.andreu@brilliantapp.app,964991,ES19209587111785551517,5949.75,2024-04-06T14:34:13,Barcelona,expenses,phone,-45.41,-75453.02
buyer_4,Marc,Andreu,1974-05-23,54922038Q,marc.andreu@brilliantapp.app,964991,ES19209587111785551517,5949.75,2024-04-06T23:03:00,Barcelona,expenses,leisure,-60.6,-75513.62
buyer_4,Marc,Andreu,1974-05-23,54922038Q,marc.andreu@brilliantapp.app,964991,ES19209587111785551517,5949.75,2024-04-06T12:04:16,Barcelona,expenses,cash,-100.0,-75613.62
buyer_4,Marc,Andreu,1974-05-23,54922038Q,marc.andreu@brilliantapp.app,964991,ES19209587111785551517,5949.75,2024-04-07T13:14:04,Barcelona,expenses,children,-1030.3837500000002,-76644.0
buyer_4,Marc,Andreu,1974-05-23,54922038Q,marc.andreu@brilliantapp.app,964991,ES19209587111785551517,5949.75,2024-04-08T20:02:53,Barcelona,expenses,water,-35.73,-76679.73
buyer_4,Marc,Andreu,1974-05-23,54922038Q,marc.andreu@brilliantapp.app,964991,ES19209587111785551517,5949.75,2024-04-08T12:11:36,Barcelona,expenses,electricity,-92.31,-76772.04
buyer_4,Marc,Andreu,1974-05-23,54922038Q,marc.andreu@brilliantapp.app,964991,ES19209587111785551517,5949.75,2024-04-08T13:51:53,Barcelona,expenses,repairs,-54.64,-76826.68
buyer_4,Marc,Andreu,1974-05-23,54922038Q,marc.andreu@brilliantapp.app,964991,ES19209587111785551517,5949.75,2024-04-10T08:50:34,Barcelona,expenses,transport,-70.93,-76897.61
buyer_4,Marc,Andreu,1974-05-23,54922038Q,marc.andreu@brilliantapp.app,964991,ES19209587111785551517,5949.75,2024-04-10T08:52:01,Barcelona,expenses,appliances,-117.53,-77015.14
buyer_4,Marc,Andreu,1974-05-23,54922038Q,marc.andreu@brilliantapp.app,964991,ES19209587111785551517,5949.75,2024-04-12T17:30:31,Barcelona,expenses,food,-85.14,-77100.28
buyer_4,Marc,Andreu,1974-05-23,54922038Q,marc.andreu@brilliantapp.app,964991,ES19209587111785551517,5949.75,2024-04-12T00:32:25,Barcelona,expenses,transport,-87.6,-77187.88
buyer_4,Marc,Andreu,1974-05-23,54922038Q,marc.andreu@brilliantapp.app,964991,ES19209587111785551517,5949.75,2024-04-13T12:34:14,Barcelona,expenses,cash,-100.0,-77287.88
buyer_4,Marc,Andreu,1974-05-23,54922038Q,marc.andreu@brilliantapp.app,964991,ES19209587111785551517,5949.75,2024-04-14T11:47:14,Barcelona,expenses,cash,-100.0,-77387.88
buyer_4,Marc,Andreu,1974-05-23,54922038Q,marc.andreu@brilliantapp.app,964991,ES19209587111785551517,5949.75,2024-04-15T20:20:19,Barcelona,expenses,clothing,-121.84,-77509.72
buyer_4,Marc,Andreu,1974-05-23,54922038Q,marc.andreu@brilliantapp.app,964991,ES19209587111785551517,5949.75,2024-04-16T11:54:29,Barcelona,expenses,food,-113.8,-77623.52
buyer_4,Marc,Andreu,1974-05-23,54922038Q,marc.andreu@brilliantapp.app,964991,ES19209587111785551517,5949.75,2024-04-16T07:46:35,Barcelona,expenses,leisure,-70.88,-77694.4
buyer_4,Marc,Andreu,1974-05-23,54922038Q,marc.andreu@brilliantapp.app,964991,ES19209587111785551517,5949.75,2024-04-16T17:34:17,Barcelona,expenses,gifts,-190.92,-77885.32
buyer_4,Marc,Andreu,1974-05-23,54922038Q,marc.andreu@brilliantapp.app,964991,ES19209587111785551517,5949.75,2024-04-19T12:13:53,Barcelona,expenses,cash,-100.0,-77985.32
buyer_4,Marc,Andreu,1974-05-23,54922038Q,marc.andreu@brilliantapp.app,964991,ES19209587111785551517,5949.75,2024-04-21T08:23:06,Barcelona,expenses,clothing,-66.8,-78052.12
buyer_4,Marc,Andreu,1974-05-23,54922038Q,marc.andreu@brilliantapp.app,964991,ES19209587111785551517,5949.75,2024-04-24T16:42:44,Barcelona,expenses,food,-121.82,-78173.94
buyer_4,Marc,Andreu,1974-05-23,54922038Q,marc.andreu@brilliantapp.app,964991,ES19209587111785551517,5949.75,2024-04-24T18:23:56,Barcelona,expenses,transport,-88.11,-78262.05
buyer_4,Marc,Andreu,1974-05-23,54922038Q,marc.andreu@brilliantapp.app,964991,ES19209587111785551517,5949.75,2024-04-24T08:55:07,Barcelona,expenses,clothing,-146.03,-78408.08
buyer_4,Marc,Andreu,1974-05-23,54922038Q,marc.andreu@brilliantapp.app,964991,ES19209587111785551517,5949.75,2024-04-25T23:36:41,Barcelona,expenses,education,-59.47,-78467.55
buyer_4,Marc,Andreu,1974-05-23,54922038Q,marc.andreu@brilliantapp.app,964991,ES19209587111785551517,5949.75,2024-04-28T19:24:00,Barcelona,expenses,food,-123.55,-78591.1
buyer_4,Marc,Andreu,1974-05-23,54922038Q,marc.andreu@brilliantapp.app,964991,ES19209587111785551517,5949.75,2024-04-28T11:03:24,Barcelona,expenses,cash,-100.0,-78691.1
buyer_4,Marc,Andreu,1974-05-23,54922038Q,marc.andreu@brilliantapp.app,964991,ES19209587111785551517,5949.75,2024-04-29T16:05:27,Barcelona,expenses,food,-68.46,-78759.56
buyer_4,Marc,Andreu,1974-05-23,54922038Q,marc.andreu@brilliantapp.app,964991,ES19209587111785551517,5949.75,2024-04-30T14:10:59,Barcelona,expenses,clothing,-90.55,-78850.11
buyer_4,Marc,Andreu,1974-05-23,54922038Q,marc.andreu@brilliantapp.app,964991,ES19209587111785551517,5949.75,2024-05-01T16:59:06,Barcelona,incomes,salary,3019.55,-75830.56
buyer_4,Marc,Andreu,1974-05-23,54922038Q,marc.andreu@brilliantapp.app,964991,ES19209587111785551517,5949.75,2024-05-01T16:59:06,Barcelona,incomes,extra_income,514.74,-75315.82
buyer_4,Marc,Andreu,1974-05-23,54922038Q,marc.andreu@brilliantapp.app,964991,ES19209587111785551517,5949.75,2024-05-02T12:30:17,Barcelona,expenses,clothing,-88.35,-75404.17
buyer_4,Marc,Andreu,1974-05-23,54922038Q,marc.andreu@brilliantapp.app,964991,ES19209587111785551517,5949.75,2024-05-03T11:01:21,Barcelona,expenses,food,-117.49,-75521.66
buyer_4,Marc,Andreu,1974-05-23,54922038Q,marc.andreu@brilliantapp.app,964991,ES19209587111785551517,5949.75,2024-05-03T09:11:47,Barcelona,expenses,transport,-87.63,-75609.29
buyer_4,Marc,Andreu,1974-05-23,54922038Q,marc.andreu@brilliantapp.app,964991,ES19209587111785551517,5949.75,2024-05-04T23:24:29,Barcelona,expenses,transport,-61.99,-75671.28
buyer_4,Marc,Andreu,1974-05-23,54922038Q,marc.andreu@brilliantapp.app,964991,ES19209587111785551517,5949.75,2024-05-04T11:26:32,Barcelona,expenses,education,-78.52,-75749.8
buyer_4,Marc,Andreu,1974-05-23,54922038Q,marc.andreu@brilliantapp.app,964991,ES19209587111785551517,5949.75,2024-05-04T22:14:41,Barcelona,expenses,children,-544.37,-76294.17
buyer_4,Marc,Andreu,1974-05-23,54922038Q,marc.andreu@brilliantapp.app,964991,ES19209587111785551517,5949.75,2024-05-05T12:48:20,Barcelona,expenses,mortgage,-1516.63,-77810.8
buyer_4,Marc,Andreu,1974-05-23,54922038Q,marc.andreu@brilliantapp.app,964991,ES19209587111785551517,5949.75,2024-05-05T13:58:27,Barcelona,expenses,electricity,-60.86,-77871.66
buyer_4,Marc,Andreu,1974-05-23,54922038Q,marc.andreu@brilliantapp.app,964991,ES19209587111785551517,5949.75,2024-05-05T15:15:05,Barcelona,expenses,internet,-63.41,-77935.07
buyer_4,Marc,Andreu,1974-05-23,54922038Q,marc.andreu@brilliantapp.app,964991,ES19209587111785551517,5949.75,2024-05-05T09:25:31,Barcelona,expenses,cash,-100.0,-78035.07
buyer_4,Marc,Andreu,1974-05-23,54922038Q,marc.andreu@brilliantapp.app,964991,ES19209587111785551517,5949.75,2024-05-05T12:47:44,Barcelona,expenses,repairs,-304.3,-78339.37
buyer_4,Marc,Andreu,1974-05-23,54922038Q,marc.andreu@brilliantapp.app,964991,ES19209587111785551517,5949.75,2024-05-06T12:25:01,Barcelona,expenses,water,-58.81,-78398.18
buyer_4,Marc,Andreu,1974-05-23,54922038Q,marc.andreu@brilliantapp.app,964991,ES19209587111785551517,5949.75,2024-05-07T23:18:59,Barcelona,expenses,water,-60.99,-78459.17
buyer_4,Marc,Andreu,1974-05-23,54922038Q,marc.andreu@brilliantapp.app,964991,ES19209587111785551517,5949.75,2024-05-07T19:45:46,Barcelona,expenses,internet,-63.41,-78522.58
buyer_4,Marc,Andreu,1974-05-23,54922038Q,marc.andreu@brilliantapp.app,964991,ES19209587111785551517,5949.75,2024-05-08T08:17:09,Barcelona,expenses,water,-38.86,-78561.44
buyer_4,Marc,Andreu,1974-05-23,54922038Q,marc.andreu@brilliantapp.app,964991,ES19209587111785551517,5949.75,2024-05-08T16:09:05,Barcelona,expenses,electricity,-51.89,-78613.33
buyer_4,Marc,Andreu,1974-05-23,54922038Q,marc.andreu@brilliantapp.app,964991,ES19209587111785551517,5949.75,2024-05-11T19:42:38,Barcelona,expenses,food,-105.78,-78719.11
buyer_4,Marc,Andreu,1974-05-23,54922038Q,marc.andreu@brilliantapp.app,964991,ES19209587111785551517,5949.75,2024-05-11T12:54:58,Barcelona,expenses,leisure,-80.26,-78799.37
buyer_4,Marc,Andreu,1974-05-23,54922038Q,marc.andreu@brilliantapp.app,964991,ES19209587111785551517,5949.75,2024-05-11T10:08:01,Barcelona,expenses,repairs,-287.82,-79087.19
buyer_4,Marc,Andreu,1974-05-23,54922038Q,marc.andreu@brilliantapp.app,964991,ES19209587111785551517,5949.75,2024-05-13T19:30:34,Barcelona,expenses,leisure,-37.29,-79124.48
buyer_4,Marc,Andreu,1974-05-23,54922038Q,marc.andreu@brilliantapp.app,964991,ES19209587111785551517,5949.75,2024-05-13T14:41:08,Barcelona,expenses,cash,-100.0,-79224.48
buyer_4,Marc,Andreu,1974-05-23,54922038Q,marc.andreu@brilliantapp.app,964991,ES19209587111785551517,5949.75,2024-05-14T11:33:08,Barcelona,expenses,children,-676.13,-79900.61
buyer_4,Marc,Andreu,1974-05-23,54922038Q,marc.andreu@brilliantapp.app,964991,ES19209587111785551517,5949.75,2024-05-16T17:01:29,Barcelona,expenses,transport,-45.18,-79945.79
buyer_4,Marc,Andreu,1974-05-23,54922038Q,marc.andreu@brilliantapp.app,964991,ES19209587111785551517,5949.75,2024-05-19T08:22:55,Barcelona,expenses,leisure,-32.56,-79978.35
buyer_4,Marc,Andreu,1974-05-23,54922038Q,marc.andreu@brilliantapp.app,964991,ES19209587111785551517,5949.75,2024-05-19T19:41:30,Barcelona,expenses,cash,-100.0,-80078.35
buyer_4,Marc,Andreu,1974-05-23,54922038Q,marc.andreu@brilliantapp.app,964991,ES19209587111785551517,5949.75,2024-05-20T23:43:42,Barcelona,expenses,food,-104.03,-80182.38
buyer_4,Marc,Andreu,1974-05-23,54922038Q,marc.andreu@brilliantapp.app,964991,ES19209587111785551517,5949.75,2024-05-20T08:59:47,Barcelona,expenses,leisure,-38.32,-80220.7
buyer_4,Marc,Andreu,1974-05-23,54922038Q,marc.andreu@brilliantapp.app,964991,ES19209587111785551517,5949.75,2024-05-21T12:23:10,Barcelona,expenses,repairs,-276.66,-80497.36
buyer_4,Marc,Andreu,1974-05-23,54922038Q,marc.andreu@brilliantapp.app,964991,ES19209587111785551517,5949.75,2024-05-21T14:14:34,Barcelona,expenses,gifts,-97.71,-80595.07
buyer_4,Marc,Andreu,1974-05-23,54922038Q,marc.andreu@brilliantapp.app,964991,ES19209587111785551517,5949.75,2024-05-22T17:02:55,Barcelona,expenses,leisure,-83.59,-80678.66
buyer_4,Marc,Andreu,1974-05-23,54922038Q,marc.andreu@brilliantapp.app,964991,ES19209587111785551517,5949.75,2024-05-23T11:54:51,Barcelona,expenses,appliances,-177.05,-80855.71
buyer_4,Marc,Andreu,1974-05-23,54922038Q,marc.andreu@brilliantapp.app,964991,ES19209587111785551517,5949.75,2024-05-24T20:32:32,Barcelona,expenses,leisure,-75.89,-80931.6
buyer_4,Marc,Andreu,1974-05-23,54922038Q,marc.andreu@brilliantapp.app,964991,ES19209587111785551517,5949.75,2024-05-24T11:46:38,Barcelona,expenses,healthcare,-56.69,-80988.29
buyer_4,Marc,Andreu,1974-05-23,54922038Q,marc.andreu@brilliantapp.app,964991,ES19209587111785551517,5949.75,2024-05-25T19:31:44,Barcelona,expenses,leisure,-37.59,-81025.88
buyer_4,Marc,Andreu,1974-05-23,54922038Q,marc.andreu@brilliantapp.app,964991,ES19209587111785551517,5949.75,2024-05-29T18:21:09,Barcelona,expenses,leisure,-78.92,-81104.8
buyer_4,Marc,Andreu,1974-05-23,54922038Q,marc.andreu@brilliantapp.app,964991,ES19209587111785551517,5949.75,2024-05-29T21:37:52,Barcelona,expenses,children,-951.4637500000002,-82056.26
buyer_4,Marc,Andreu,1974-05-23,54922038Q,marc.andreu@brilliantapp.app,964991,ES19209587111785551517,5949.75,2024-05-30T14:12:47,Barcelona,expenses,leisure,-63.19,-82119.45
buyer_4,Marc,Andreu,1974-05-23,54922038Q,marc.andreu@brilliantapp.app,964991,ES19209587111785551517,5949.75,2024-05-31T18:45:19,Barcelona,expenses,transport,-69.25,-82188.7
buyer_4,Marc,Andreu,1974-05-23,54922038Q,marc.andreu@brilliantapp.app,964991,ES19209587111785551517,5949.75,2024-05-31T10:20:01,Barcelona,expenses,clothing,-111.72,-82300.42
buyer_4,Marc,Andreu,1974-05-23,54922038Q,marc.andreu@brilliantapp.app,964991,ES19209587111785551517,5949.75,2024-06-01T22:09:27,Barcelona,incomes,salary,3019.55,-79280.87
buyer_4,Marc,Andreu,1974-05-23,54922038Q,marc.andreu@brilliantapp.app,964991,ES19209587111785551517,5949.75,2024-06-01T22:09:27,Barcelona,incomes,salary_bonus,2206.94,-77073.93
buyer_4,Marc,Andreu,1974-05-23,54922038Q,marc.andreu@brilliantapp.app,964991,ES19209587111785551517,5949.75,2024-06-01T18:19:05,Barcelona,expenses,taxes,-2051.6,-79125.53
buyer_4,Marc,Andreu,1974-05-23,54922038Q,marc.andreu@brilliantapp.app,964991,ES19209587111785551517,5949.75,2024-06-01T17:36:38,Barcelona,expenses,insurance,-760.08,-79885.61
buyer_4,Marc,Andreu,1974-05-23,54922038Q,marc.andreu@brilliantapp.app,964991,ES19209587111785551517,5949.75,2024-06-01T12:20:27,Barcelona,expenses,cash,-100.0,-79985.61
buyer_4,Marc,Andreu,1974-05-23,54922038Q,marc.andreu@brilliantapp.app,964991,ES19209587111785551517,5949.75,2024-06-02T12:09:42,Barcelona,expenses,cash,-100.0,-80085.61
buyer_4,Marc,Andreu,1974-05-23,54922038Q,marc.andreu@brilliantapp.app,964991,ES19209587111785551517,5949.75,2024-06-03T12:34:07,Barcelona,expenses,clothing,-51.4,-80137.01
buyer_4,Marc,Andreu,1974-05-23,54922038Q,marc.andreu@brilliantapp.app,964991,ES19209587111785551517,5949.75,2024-06-03T14:29:43,Barcelona,expenses,repairs,-52.62,-80189.63
buyer_4,Marc,Andreu,1974-05-23,54922038Q,marc.andreu@brilliantapp.app,964991,ES19209587111785551517,5949.75,2024-06-04T18:24:47,Barcelona,expenses,food,-106.65,-80296.28
buyer_4,Marc,Andreu,1974-05-23,54922038Q,marc.andreu@brilliantapp.app,964991,ES19209587111785551517,5949.75,2024-06-04T18:16:27,Barcelona,expenses,transport,-64.22,-80360.5
buyer_4,Marc,Andreu,1974-05-23,54922038Q,marc.andreu@brilliantapp.app,964991,ES19209587111785551517,5949.75,2024-06-05T11:32:24,Barcelona,expenses,mortgage,-1516.63,-81877.13
buyer_4,Marc,Andreu,1974-05-23,54922038Q,marc.andreu@brilliantapp.app,964991,ES19209587111785551517,5949.75,2024-06-06T17:12:06,Barcelona,expenses,electricity,-57.43,-81934.56
buyer_4,Marc,Andreu,1974-05-23,54922038Q,marc.andreu@brilliantapp.app,964991,ES19209587111785551517,5949.75,2024-06-06T10:55:40,Barcelona,expenses,gas,-45.77,-81980.33
buyer_4,Marc,Andreu,1974-05-23,54922038Q,marc.andreu@brilliantapp.app,964991,ES19209587111785551517,5949.75,2024-06-06T04:29:07,Barcelona,expenses,phone,-55.87,-82036.2
buyer_4,Marc,Andreu,1974-05-23,54922038Q,marc.andreu@brilliantapp.app,964991,ES19209587111785551517,5949.75,2024-06-06T10:30:01,Barcelona,expenses,cash,-100.0,-82136.2
buyer_4,Marc,Andreu,1974-05-23,54922038Q,marc.andreu@brilliantapp.app,964991,ES19209587111785551517,5949.75,2024-06-07T09:33:20,Barcelona,expenses,repairs,-215.73,-82351.93
buyer_4,Marc,Andreu,1974-05-23,54922038Q,marc.andreu@brilliantapp.app,964991,ES19209587111785551517,5949.75,2024-06-07T11:34:21,Barcelona,expenses,children,-814.6537500000002,-83166.58
buyer_4,Marc,Andreu,1974-05-23,54922038Q,marc.andreu@brilliantapp.app,964991,ES19209587111785551517,5949.75,2024-06-08T15:41:58,Barcelona,expenses,leisure,-34.06,-83200.64
buyer_4,Marc,Andreu,1974-05-23,54922038Q,marc.andreu@brilliantapp.app,964991,ES19209587111785551517,5949.75,2024-06-09T02:54:41,Barcelona,expenses,transport,-77.86,-83278.5
buyer_4,Marc,Andreu,1974-05-23,54922038Q,marc.andreu@brilliantapp.app,964991,ES19209587111785551517,5949.75,2024-06-09T13:23:27,Barcelona,expenses,children,-952.5237500000002,-84231.02
buyer_4,Marc,Andreu,1974-05-23,54922038Q,marc.andreu@brilliantapp.app,964991,ES19209587111785551517,5949.75,2024-06-11T14:09:47,Barcelona,expenses,food,-101.16,-84332.18
buyer_4,Marc,Andreu,1974-05-23,54922038Q,marc.andreu@brilliantapp.app,964991,ES19209587111785551517,5949.75,2024-06-12T11:14:22,Barcelona,expenses,travel,-402.85,-84735.03
buyer_4,Marc,Andreu,1974-05-23,54922038Q,marc.andreu@brilliantapp.app,964991,ES19209587111785551517,5949.75,2024-06-13T23:54:45,Barcelona,expenses,children,-1030.3837500000002,-85765.41
buyer_4,Marc,Andreu,1974-05-23,54922038Q,marc.andreu@brilliantapp.app,964991,ES19209587111785551517,5949.75,2024-06-14T11:26:55,Barcelona,expenses,food,-106.13,-85871.54
buyer_4,Marc,Andreu,1974-05-23,54922038Q,marc.andreu@brilliantapp.app,964991,ES19209587111785551517,5949.75,2024-06-14T10:07:06,Barcelona,expenses,repairs,-137.38,-86008.92
buyer_4,Marc,Andreu,1974-05-23,54922038Q,marc.andreu@brilliantapp.app,964991,ES19209587111785551517,5949.75,2024-06-14T15:58:23,Barcelona,expenses,gifts,-678.44,-86687.36
buyer_4,Marc,Andreu,1974-05-23,54922038Q,marc.andreu@brilliantapp.app,964991,ES19209587111785551517,5949.75,2024-06-16T05:54:02,Barcelona,expenses,appliances,-389.65,-87077.01
buyer_4,Marc,Andreu,1974-05-23,54922038Q,marc.andreu@brilliantapp.app,964991,ES19209587111785551517,5949.75,2024-06-16T02:44:41,Barcelona,expenses,repairs,-196.86,-87273.87
buyer_4,Marc,Andreu,1974-05-23,54922038Q,marc.andreu@brilliantapp.app,964991,ES19209587111785551517,5949.75,2024-06-17T14:36:21,Barcelona,expenses,cash,-100.0,-87373.87
buyer_4,Marc,Andreu,1974-05-23,54922038Q,marc.andreu@brilliantapp.app,964991,ES19209587111785551517,5949.75,2024-06-19T09:53:18,Barcelona,expenses,gifts,-160.15,-87534.02
buyer_4,Marc,Andreu,1974-05-23,54922038Q,marc.andreu@brilliantapp.app,964991,ES19209587111785551517,5949.75,2024-06-21T21:13:10,Barcelona,expenses,appliances,-397.57,-87931.59
buyer_4,Marc,Andreu,1974-05-23,54922038Q,marc.andreu@brilliantapp.app,964991,ES19209587111785551517,5949.75,2024-06-23T19:58:39,Barcelona,expenses,transport,-41.3,-87972.89
buyer_4,Marc,Andreu,1974-05-23,54922038Q,marc.andreu@brilliantapp.app,964991,ES19209587111785551517,5949.75,2024-06-23T18:42:37,Barcelona,expenses,appliances,-165.12,-88138.01
buyer_4,Marc,Andreu,1974-05-23,54922038Q,marc.andreu@brilliantapp.app,964991,ES19209587111785551517,5949.75,2024-06-24T18:15:37,Barcelona,expenses,food,-94.62,-88232.63
buyer_4,Marc,Andreu,1974-05-23,54922038Q,marc.andreu@brilliantapp.app,964991,ES19209587111785551517,5949.75,2024-06-24T16:17:34,Barcelona,expenses,transport,-65.72,-88298.35
buyer_4,Marc,Andreu,1974-05-23,54922038Q,marc.andreu@brilliantapp.app,964991,ES19209587111785551517,5949.75,2024-06-25T13:26:39,Barcelona,expenses,education,-60.44,-88358.79
buyer_4,Marc,Andreu,1974-05-23,54922038Q,marc.andreu@brilliantapp.app,964991,ES19209587111785551517,5949.75,2024-06-26T23:49:40,Barcelona,expenses,leisure,-19.65,-88378.44
buyer_4,Marc,Andreu,1974-05-23,54922038Q,marc.andreu@brilliantapp.app,964991,ES19209587111785551517,5949.75,2024-06-29T12:05:41,Barcelona,expenses,gifts,-364.52,-88742.96
buyer_4,Marc,Andreu,1974-05-23,54922038Q,marc.andreu@brilliantapp.app,964991,ES19209587111785551517,5949.75,2024-07-01T19:20:05,Barcelona,incomes,salary,3019.55,-85723.41
buyer_4,Marc,Andreu,1974-05-23,54922038Q,marc.andreu@brilliantapp.app,964991,ES19209587111785551517,5949.75,2024-07-01T10:34:04,Barcelona,expenses,leisure,-45.77,-85769.18
buyer_4,Marc,Andreu,1974-05-23,54922038Q,marc.andreu@brilliantapp.app,964991,ES19209587111785551517,5949.75,2024-07-03T05:58:01,Barcelona,expenses,food,-85.3,-85854.48
buyer_4,Marc,Andreu,1974-05-23,54922038Q,marc.andreu@brilliantapp.app,964991,ES19209587111785551517,5949.75,2024-07-04T10:11:47,Barcelona,expenses,transport,-57.02,-85911.5
buyer_4,Marc,Andreu,1974-05-23,54922038Q,marc.andreu@brilliantapp.app,964991,ES19209587111785551517,5949.75,2024-07-05T09:46:24,Barcelona,expenses,mortgage,-1516.63,-87428.13
buyer_4,Marc,Andreu,1974-05-23,54922038Q,marc.andreu@brilliantapp.app,964991,ES19209587111785551517,5949.75,2024-07-05T14:03:19,Barcelona,expenses,gas,-110.73,-87538.86
buyer_4,Marc,Andreu,1974-05-23,54922038Q,marc.andreu@brilliantapp.app,964991,ES19209587111785551517,5949.75,2024-07-06T13:00:30,Barcelona,expenses,gas,-109.95,-87648.81
buyer_4,Marc,Andreu,1974-05-23,54922038Q,marc.andreu@brilliantapp.app,964991,ES19209587111785551517,5949.75,2024-07-06T09:07:03,Barcelona,expenses,phone,-58.13,-87706.94
buyer_4,Marc,Andreu,1974-05-23,54922038Q,marc.andreu@brilliantapp.app,964991,ES19209587111785551517,5949.75,2024-07-06T19:29:25,Barcelona,expenses,cash,-100.0,-87806.94
buyer_4,Marc,Andreu,1974-05-23,54922038Q,marc.andreu@brilliantapp.app,964991,ES19209587111785551517,5949.75,2024-07-07T20:16:46,Barcelona,expenses,gas,-126.02,-87932.96
buyer_4,Marc,Andreu,1974-05-23,54922038Q,marc.andreu@brilliantapp.app,964991,ES19209587111785551517,5949.75,2024-07-07T04:32:40,Barcelona,expenses,cash,-100.0,-88032.96
buyer_4,Marc,Andreu,1974-05-23,54922038Q,marc.andreu@brilliantapp.app,964991,ES19209587111785551517,5949.75,2024-07-10T10:59:30,Barcelona,expenses,leisure,-28.08,-88061.04
buyer_4,Marc,Andreu,1974-05-23,54922038Q,marc.andreu@brilliantapp.app,964991,ES19209587111785551517,5949.75,2024-07-12T23:35:37,Barcelona,expenses,food,-77.45,-88138.49
buyer_4,Marc,Andreu,1974-05-23,54922038Q,marc.andreu@brilliantapp.app,964991,ES19209587111785551517,5949.75,2024-07-13T08:20:26,Barcelona,expenses,cash,-100.0,-88238.49
buyer_4,Marc,Andreu,1974-05-23,54922038Q,marc.andreu@brilliantapp.app,964991,ES19209587111785551517,5949.75,2024-07-14T17:28:41,Barcelona,expenses,transport,-73.31,-88311.8
buyer_4,Marc,Andreu,1974-05-23,54922038Q,marc.andreu@brilliantapp.app,964991,ES19209587111785551517,5949.75,2024-07-15T08:58:01,Barcelona,expenses,cash,-100.0,-88411.8
buyer_4,Marc,Andreu,1974-05-23,54922038Q,marc.andreu@brilliantapp.app,964991,ES19209587111785551517,5949.75,2024-07-18T16:55:32,Barcelona,expenses,gifts,-484.96,-88896.76
buyer_4,Marc,Andreu,1974-05-23,54922038Q,marc.andreu@brilliantapp.app,964991,ES19209587111785551517,5949.75,2024-07-19T16:57:03,Barcelona,expenses,food,-85.53,-88982.29
buyer_4,Marc,Andreu,1974-05-23,54922038Q,marc.andreu@brilliantapp.app,964991,ES19209587111785551517,5949.75,2024-07-21T09:48:14,Barcelona,expenses,cash,-100.0,-89082.29
buyer_4,Marc,Andreu,1974-05-23,54922038Q,marc.andreu@brilliantapp.app,964991,ES19209587111785551517,5949.75,2024-07-22T19:29:10,Barcelona,expenses,food,-112.69,-89194.98
buyer_4,Marc,Andreu,1974-05-23,54922038Q,marc.andreu@brilliantapp.app,964991,ES19209587111785551517,5949.75,2024-07-26T15:21:10,Barcelona,expenses,appliances,-364.53,-89559.51
buyer_4,Marc,Andreu,1974-05-23,54922038Q,marc.andreu@brilliantapp.app,964991,ES19209587111785551517,5949.75,2024-07-26T10:17:51,Barcelona,expenses,repairs,-126.36,-89685.87
buyer_4,Marc,Andreu,1974-05-23,54922038Q,marc.andreu@brilliantapp.app,964991,ES19209587111785551517,5949.75,2024-07-27T15:20:28,Barcelona,expenses,food,-115.25,-89801.12
buyer_4,Marc,Andreu,1974-05-23,54922038Q,marc.andreu@brilliantapp.app,964991,ES19209587111785551517,5949.75,2024-07-27T09:11:38,Barcelona,expenses,cash,-100.0,-89901.12
buyer_4,Marc,Andreu,1974-05-23,54922038Q,marc.andreu@brilliantapp.app,964991,ES19209587111785551517,5949.75,2024-07-28T17:08:08,Barcelona,expenses,food,-114.68,-90015.8
buyer_4,Marc,Andreu,1974-05-23,54922038Q,marc.andreu@brilliantapp.app,964991,ES19209587111785551517,5949.75,2024-07-28T21:05:47,Barcelona,expenses,children,-915.7037500000001,-90931.5
buyer_4,Marc,Andreu,1974-05-23,54922038Q,marc.andreu@brilliantapp.app,964991,ES19209587111785551517,5949.75,2024-07-30T19:35:14,Barcelona,expenses,food,-110.88,-91042.38
buyer_4,Marc,Andreu,1974-05-23,54922038Q,marc.andreu@brilliantapp.app,964991,ES19209587111785551517,5949.75,2024-07-31T06:08:18,Barcelona,expenses,healthcare,-150.9,-91193.28
buyer_4,Marc,Andreu,1974-05-23,54922038Q,marc.andreu@brilliantapp.app,964991,ES19209587111785551517,5949.75,2024-08-01T09:44:22,Barcelona,incomes,salary,3019.55,-88173.73
buyer_4,Marc,Andreu,1974-05-23,54922038Q,marc.andreu@brilliantapp.app,964991,ES19209587111785551517,5949.75,2024-08-01T09:44:22,Barcelona,incomes,extra_income,514.74,-87658.99
buyer_4,Marc,Andreu,1974-05-23,54922038Q,marc.andreu@brilliantapp.app,964991,ES19209587111785551517,5949.75,2024-08-02T20:03:15,Barcelona,expenses,repairs,-112.45,-87771.44
buyer_4,Marc,Andreu,1974-05-23,54922038Q,marc.andreu@brilliantapp.app,964991,ES19209587111785551517,5949.75,2024-08-03T12:12:41,Barcelona,expenses,clothing,-117.31,-87888.75
buyer_4,Marc,Andreu,1974-05-23,54922038Q,marc.andreu@brilliantapp.app,964991,ES19209587111785551517,5949.75,2024-08-03T14:26:17,Barcelona,expenses,repairs,-63.38,-87952.13
buyer_4,Marc,Andreu,1974-05-23,54922038Q,marc.andreu@brilliantapp.app,964991,ES19209587111785551517,5949.75,2024-08-04T13:45:09,Barcelona,expenses,cash,-100.0,-88052.13
buyer_4,Marc,Andreu,1974-05-23,54922038Q,marc.andreu@brilliantapp.app,964991,ES19209587111785551517,5949.75,2024-08-05T10:31:10,Barcelona,expenses,mortgage,-1516.63,-89568.76
buyer_4,Marc,Andreu,1974-05-23,54922038Q,marc.andreu@brilliantapp.app,964991,ES19209587111785551517,5949.75,2024-08-05T19:20:26,Barcelona,expenses,phone,-54.58,-89623.34
buyer_4,Marc,Andreu,1974-05-23,54922038Q,marc.andreu@brilliantapp.app,964991,ES19209587111785551517,5949.75,2024-08-06T11:07:59,Barcelona,expenses,electricity,-123.06,-89746.4
buyer_4,Marc,Andreu,1974-05-23,54922038Q,marc.andreu@brilliantapp.app,964991,ES19209587111785551517,5949.75,2024-08-06T22:08:29,Barcelona,expenses,food,-92.89,-89839.29
buyer_4,Marc,Andreu,1974-05-23,54922038Q,marc.andreu@brilliantapp.app,964991,ES19209587111785551517,5949.75,2024-08-07T05:14:09,Barcelona,expenses,food,-113.2,-89952.49
buyer_4,Marc,Andreu,1974-05-23,54922038Q,marc.andreu@brilliantapp.app,964991,ES19209587111785551517,5949.75,2024-08-08T13:55:24,Barcelona,expenses,electricity,-51.99,-90004.48
buyer_4,Marc,Andreu,1974-05-23,54922038Q,marc.andreu@brilliantapp.app,964991,ES19209587111785551517,5949.75,2024-08-08T16:58:31,Barcelona,expenses,gas,-68.2,-90072.68
buyer_4,Marc,Andreu,1974-05-23,54922038Q,marc.andreu@brilliantapp.app,964991,ES19209587111785551517,5949.75,2024-08-08T12:28:05,Barcelona,expenses,phone,-51.46,-90124.14
buyer_4,Marc,Andreu,1974-05-23,54922038Q,marc.andreu@brilliantapp.app,964991,ES19209587111785551517,5949.75,2024-08-08T17:59:15,Barcelona,expenses,leisure,-31.76,-90155.9
buyer_4,Marc,Andreu,1974-05-23,54922038Q,marc.andreu@brilliantapp.app,964991,ES19209587111785551517,5949.75,2024-08-08T17:47:59,Barcelona,expenses,education,-73.59,-90229.49
buyer_4,Marc,Andreu,1974-05-23,54922038Q,marc.andreu@brilliantapp.app,964991,ES19209587111785551517,5949.75,2024-08-08T17:07:54,Barcelona,expenses,cash,-100.0,-90329.49
buyer_4,Marc,Andreu,1974-05-23,54922038Q,marc.andreu@brilliantapp.app,964991,ES19209587111785551517,5949.75,2024-08-10T18:08:32,Barcelona,expenses,food,-66.2,-90395.69
buyer_4,Marc,Andreu,1974-05-23,54922038Q,marc.andreu@brilliantapp.app,964991,ES19209587111785551517,5949.75,2024-08-10T05:19:09,Barcelona,expenses,repairs,-74.79,-90470.48
buyer_4,Marc,Andreu,1974-05-23,54922038Q,marc.andreu@brilliantapp.app,964991,ES19209587111785551517,5949.75,2024-08-11T20:42:09,Barcelona,expenses,cash,-100.0,-90570.48
buyer_4,Marc,Andreu,1974-05-23,54922038Q,marc.andreu@brilliantapp.app,964991,ES19209587111785551517,5949.75,2024-08-12T10:21:49,Barcelona,expenses,transport,-65.54,-90636.02
buyer_4,Marc,Andreu,1974-05-23,54922038Q,marc.andreu@brilliantapp.app,964991,ES19209587111785551517,5949.75,2024-08-12T17:30:01,Barcelona,expenses,children,-964.8437500000002,-91600.86
buyer_4,Marc,Andreu,1974-05-23,54922038Q,marc.andreu@brilliantapp.app,964991,ES19209587111785551517,5949.75,2024-08-13T20:04:52,Barcelona,expenses,food,-74.59,-91675.45
buyer_4,Marc,Andreu,1974-05-23,54922038Q,marc.andreu@brilliantapp.app,964991,ES19209587111785551517,5949.75,2024-08-13T12:51:55,Barcelona,expenses,leisure,-54.11,-91729.56
buyer_4,Marc,Andreu,1974-05-23,54922038Q,marc.andreu@brilliantapp.app,964991,ES19209587111785551517,5949.75,2024-08-15T11:14:28,Barcelona,expenses,food,-107.41,-91836.97
buyer_4,Marc,Andreu,1974-05-23,54922038Q,marc.andreu@brilliantapp.app,964991,ES19209587111785551517,5949.75,2024-08-15T16:28:15,Barcelona,expenses,cash,-100.0,-91936.97
buyer_4,Marc,Andreu,1974-05-23,54922038Q,marc.andreu@brilliantapp.app,964991,ES19209587111785551517,5949.75,2024-08-17T21:55:53,Barcelona,expenses,leisure,-58.53,-91995.5
buyer_4,Marc,Andreu,1974-05-23,54922038Q,marc.andreu@brilliantapp.app,964991,ES19209587111785551517,5949.75,2024-08-20T13:21:04,Barcelona,expenses,children,-1030.3837500000002,-93025.88
buyer_4,Marc,Andreu,1974-05-23,54922038Q,marc.andreu@brilliantapp.app,964991,ES19209587111785551517,5949.75,2024-08-21T14:25:40,Barcelona,expenses,repairs,-48.29,-93074.17
buyer_4,Marc,Andreu,1974-05-23,54922038Q,marc.andreu@brilliantapp.app,964991,ES19209587111785551517,5949.75,2024-08-22T14:28:48,Barcelona,expenses,cash,-100.0,-93174.17
buyer_4,Marc,Andreu,1974-05-23,54922038Q,marc.andreu@brilliantapp.app,964991,ES19209587111785551517,5949.75,2024-08-23T16:12:00,Barcelona,expenses,food,-115.45,-93289.62
buyer_4,Marc,Andreu,1974-05-23,54922038Q,marc.andreu@brilliantapp.app,964991,ES19209587111785551517,5949.75,2024-08-23T08:37:40,Barcelona,expenses,transport,-40.41,-93330.03
buyer_4,Marc,Andreu,1974-05-23,54922038Q,marc.andreu@brilliantapp.app,964991,ES19209587111785551517,5949.75,2024-08-23T23:42:50,Barcelona,expenses,leisure,-77.34,-93407.37
buyer_4,Marc,Andreu,1974-05-23,54922038Q,marc.andreu@brilliantapp.app,964991,ES19209587111785551517,5949.75,2024-08-24T18:29:20,Barcelona,expenses,food,-120.22,-93527.59
buyer_4,Marc,Andreu,1974-05-23,54922038Q,marc.andreu@brilliantapp.app,964991,ES19209587111785551517,5949.75,2024-08-24T08:48:49,Barcelona,expenses,gifts,-309.64,-93837.23
buyer_4,Marc,Andreu,1974-05-23,54922038Q,marc.andreu@brilliantapp.app,964991,ES19209587111785551517,5949.75,2024-08-27T16:09:19,Barcelona,expenses,cash,-100.0,-93937.23
buyer_4,Marc,Andreu,1974-05-23,54922038Q,marc.andreu@brilliantapp.app,964991,ES19209587111785551517,5949.75,2024-08-28T18:29:14,Barcelona,expenses,food,-122.55,-94059.78
buyer_4,Marc,Andreu,1974-05-23,54922038Q,marc.andreu@brilliantapp.app,964991,ES19209587111785551517,5949.75,2024-08-28T15:35:46,Barcelona,expenses,cash,-100.0,-94159.78
buyer_4,Marc,Andreu,1974-05-23,54922038Q,marc.andreu@brilliantapp.app,964991,ES19209587111785551517,5949.75,2024-08-29T20:22:22,Barcelona,expenses,leisure,-23.05,-94182.83
buyer_4,Marc,Andreu,1974-05-23,54922038Q,marc.andreu@brilliantapp.app,964991,ES19209587111785551517,5949.75,2024-08-31T18:01:12,Barcelona,expenses,food,-103.8,-94286.63
buyer_4,Marc,Andreu,1974-05-23,54922038Q,marc.andreu@brilliantapp.app,964991,ES19209587111785551517,5949.75,2024-08-31T04:38:37,Barcelona,expenses,leisure,-82.37,-94369.0
buyer_4,Marc,Andreu,1974-05-23,54922038Q,marc.andreu@brilliantapp.app,964991,ES19209587111785551517,5949.75,2024-08-31T16:05:17,Barcelona,expenses,healthcare,-54.08,-94423.08
buyer_4,Marc,Andreu,1974-05-23,54922038Q,marc.andreu@brilliantapp.app,964991,ES19209587111785551517,5949.75,2024-08-31T00:16:48,Barcelona,expenses,gifts,-662.71,-95085.79
buyer_4,Marc,Andreu,1974-05-23,54922038Q,marc.andreu@brilliantapp.app,964991,ES19209587111785551517,5949.75,2024-09-01T15:57:58,Barcelona,incomes,salary,3019.55,-92066.24
buyer_4,Marc,Andreu,1974-05-23,54922038Q,marc.andreu@brilliantapp.app,964991,ES19209587111785551517,5949.75,2024-09-01T11:24:41,Barcelona,expenses,cash,-100.0,-92166.24
buyer_4,Marc,Andreu,1974-05-23,54922038Q,marc.andreu@brilliantapp.app,964991,ES19209587111785551517,5949.75,2024-09-03T21:40:34,Barcelona,expenses,children,-879.26,-93045.5
buyer_4,Marc,Andreu,1974-05-23,54922038Q,marc.andreu@brilliantapp.app,964991,ES19209587111785551517,5949.75,2024-09-04T15:26:42,Barcelona,expenses,cash,-100.0,-93145.5
buyer_4,Marc,Andreu,1974-05-23,54922038Q,marc.andreu@brilliantapp.app,964991,ES19209587111785551517,5949.75,2024-09-05T16:15:42,Barcelona,expenses,mortgage,-1516.63,-94662.13
buyer_4,Marc,Andreu,1974-05-23,54922038Q,marc.andreu@brilliantapp.app,964991,ES19209587111785551517,5949.75,2024-09-05T11:31:44,Barcelona,expenses,electricity,-92.59,-94754.72
buyer_4,Marc,Andreu,1974-05-23,54922038Q,marc.andreu@brilliantapp.app,964991,ES19209587111785551517,5949.75,2024-09-05T23:57:12,Barcelona,expenses,gas,-160.46,-94915.18
buyer_4,Marc,Andreu,1974-05-23,54922038Q,marc.andreu@brilliantapp.app,964991,ES19209587111785551517,5949.75,2024-09-05T18:42:19,Barcelona,expenses,transport,-47.95,-94963.13
buyer_4,Marc,Andreu,1974-05-23,54922038Q,marc.andreu@brilliantapp.app,964991,ES19209587111785551517,5949.75,2024-09-06T19:34:32,Barcelona,expenses,internet,-63.41,-95026.54
buyer_4,Marc,Andreu,1974-05-23,54922038Q,marc.andreu@brilliantapp.app,964991,ES19209587111785551517,5949.75,2024-09-06T15:30:27,Barcelona,expenses,repairs,-275.79,-95302.33
buyer_4,Marc,Andreu,1974-05-23,54922038Q,marc.andreu@brilliantapp.app,964991,ES19209587111785551517,5949.75,2024-09-07T15:18:04,Barcelona,expenses,electricity,-87.66,-95389.99
buyer_4,Marc,Andreu,1974-05-23,54922038Q,marc.andreu@brilliantapp.app,964991,ES19209587111785551517,5949.75,2024-09-07T18:15:50,Barcelona,expenses,gas,-98.65,-95488.64
buyer_4,Marc,Andreu,1974-05-23,54922038Q,marc.andreu@brilliantapp.app,964991,ES19209587111785551517,5949.75,2024-09-08T16:02:11,Barcelona,expenses,water,-46.44,-95535.08
buyer_4,Marc,Andreu,1974-05-23,54922038Q,marc.andreu@brilliantapp.app,964991,ES19209587111785551517,5949.75,2024-09-08T07:20:37,Barcelona,expenses,electricity,-102.61,-95637.69
buyer_4,Marc,Andreu,1974-05-23,54922038Q,marc.andreu@brilliantapp.app,964991,ES19209587111785551517,5949.75,2024-09-08T13:33:33,Barcelona,expenses,internet,-63.41,-95701.1
buyer_4,Marc,Andreu,1974-05-23,54922038Q,marc.andreu@brilliantapp.app,964991,ES19209587111785551517,5949.75,2024-09-08T19:44:29,Barcelona,expenses,food,-113.45,-95814.55
buyer_4,Marc,Andreu,1974-05-23,54922038Q,marc.andreu@brilliantapp.app,964991,ES19209587111785551517,5949.75,2024-09-09T10:46:46,Barcelona,expenses,children,-1030.3837500000002,-96844.93
buyer_4,Marc,Andreu,1974-05-23,54922038Q,marc.andreu@brilliantapp.app,964991,ES19209587111785551517,5949.75,2024-09-10T11:25:37,Barcelona,expenses,travel,-637.25,-97482.18
buyer_4,Marc,Andreu,1974-05-23,54922038Q,marc.andreu@brilliantapp.app,964991,ES19209587111785551517,5949.75,2024-09-10T16:24:51,Barcelona,expenses,gifts,-80.53,-97562.71
buyer_4,Marc,Andreu,1974-05-23,54922038Q,marc.andreu@brilliantapp.app,964991,ES19209587111785551517,5949.75,2024-09-12T13:30:27,Barcelona,expenses,transport,-67.12,-97629.83
buyer_4,Marc,Andreu,1974-05-23,54922038Q,marc.andreu@brilliantapp.app,964991,ES19209587111785551517,5949.75,2024-09-13T13:47:38,Barcelona,expenses,transport,-73.77,-97703.6
buyer_4,Marc,Andreu,1974-05-23,54922038Q,marc.andreu@brilliantapp.app,964991,ES19209587111785551517,5949.75,2024-09-13T19:31:18,Barcelona,expenses,cash,-100.0,-97803.6
buyer_4,Marc,Andreu,1974-05-23,54922038Q,marc.andreu@brilliantapp.app,964991,ES19209587111785551517,5949.75,2024-09-14T15:33:15,Barcelona,expenses,repairs,-102.99,-97906.59
buyer_4,Marc,Andreu,1974-05-23,54922038Q,marc.andreu@brilliantapp.app,964991,ES19209587111785551517,5949.75,2024-09-15T17:10:42,Barcelona,expenses,food,-111.02,-98017.61
buyer_4,Marc,Andreu,1974-05-23,54922038Q,marc.andreu@brilliantapp.app,964991,ES19209587111785551517,5949.75,2024-09-15T08:23:16,Barcelona,expenses,healthcare,-148.22,-98165.83
buyer_4,Marc,Andreu,1974-05-23,54922038Q,marc.andreu@brilliantapp.app,964991,ES19209587111785551517,5949.75,2024-09-17T12:15:09,Barcelona,expenses,education,-45.91,-98211.74
buyer_4,Marc,Andreu,1974-05-23,54922038Q,marc.andreu@brilliantapp.app,964991,ES19209587111785551517,5949.75,2024-09-17T14:31:41,Barcelona,expenses,car,-419.63,-98631.37
buyer_4,Marc,Andreu,1974-05-23,54922038Q,marc.andreu@brilliantapp.app,964991,ES19209587111785551517,5949.75,2024-09-18T08:27:16,Barcelona,expenses,food,-78.69,-98710.06
buyer_4,Marc,Andreu,1974-05-23,54922038Q,marc.andreu@brilliantapp.app,964991,ES19209587111785551517,5949.75,2024-09-18T14:59:51,Barcelona,expenses,cash,-100.0,-98810.06
buyer_4,Marc,Andreu,1974-05-23,54922038Q,marc.andreu@brilliantapp.app,964991,ES19209587111785551517,5949.75,2024-09-21T18:47:19,Barcelona,expenses,transport,-88.52,-98898.58
buyer_4,Marc,Andreu,1974-05-23,54922038Q,marc.andreu@brilliantapp.app,964991,ES19209587111785551517,5949.75,2024-09-21T12:55:35,Barcelona,expenses,leisure,-52.0,-98950.58
buyer_4,Marc,Andreu,1974-05-23,54922038Q,marc.andreu@brilliantapp.app,964991,ES19209587111785551517,5949.75,2024-09-22T07:35:57,Barcelona,expenses,leisure,-46.13,-98996.71
buyer_4,Marc,Andreu,1974-05-23,54922038Q,marc.andreu@brilliantapp.app,964991,ES19209587111785551517,5949.75,2024-09-24T17:15:25,Barcelona,expenses,leisure,-31.38,-99028.09
buyer_4,Marc,Andreu,1974-05-23,54922038Q,marc.andreu@brilliantapp.app,964991,ES19209587111785551517,5949.75,2024-09-24T17:44:56,Barcelona,expenses,appliances,-236.28,-99264.37
buyer_4,Marc,Andreu,1974-05-23,54922038Q,marc.andreu@brilliantapp.app,964991,ES19209587111785551517,5949.75,2024-09-26T10:58:29,Barcelona,expenses,gifts,-478.93,-99743.3
buyer_4,Marc,Andreu,1974-05-23,54922038Q,marc.andreu@brilliantapp.app,964991,ES19209587111785551517,5949.75,2024-09-27T16:06:58,Barcelona,expenses,transport,-67.32,-99810.62
buyer_4,Marc,Andreu,1974-05-23,54922038Q,marc.andreu@brilliantapp.app,964991,ES19209587111785551517,5949.75,2024-09-27T05:52:52,Barcelona,expenses,clothing,-94.9,-99905.52
buyer_4,Marc,Andreu,1974-05-23,54922038Q,marc.andreu@brilliantapp.app,964991,ES19209587111785551517,5949.75,2024-09-28T15:56:34,Barcelona,expenses,food,-84.54,-99990.06
buyer_4,Marc,Andreu,1974-05-23,54922038Q,marc.andreu@brilliantapp.app,964991,ES19209587111785551517,5949.75,2024-09-28T17:38:40,Barcelona,expenses,education,-71.36,-100061.42
buyer_4,Marc,Andreu,1974-05-23,54922038Q,marc.andreu@brilliantapp.app,964991,ES19209587111785551517,5949.75,2024-09-29T17:27:15,Barcelona,expenses,cash,-100.0,-100161.42
buyer_4,Marc,Andreu,1974-05-23,54922038Q,marc.andreu@brilliantapp.app,964991,ES19209587111785551517,5949.75,2024-09-29T21:17:21,Barcelona,expenses,repairs,-75.87,-100237.29
buyer_4,Marc,Andreu,1974-05-23,54922038Q,marc.andreu@brilliantapp.app,964991,ES19209587111785551517,5949.75,2024-09-30T17:51:26,Barcelona,expenses,gifts,-847.16,-101084.45
buyer_4,Marc,Andreu,1974-05-23,54922038Q,marc.andreu@brilliantapp.app,964991,ES19209587111785551517,5949.75,2024-10-01T09:56:30,Barcelona,incomes,salary,3019.55,-98064.9
buyer_4,Marc,Andreu,1974-05-23,54922038Q,marc.andreu@brilliantapp.app,964991,ES19209587111785551517,5949.75,2024-10-03T08:53:16,Barcelona,expenses,cash,-100.0,-98164.9
buyer_4,Marc,Andreu,1974-05-23,54922038Q,marc.andreu@brilliantapp.app,964991,ES19209587111785551517,5949.75,2024-10-04T11:47:15,Barcelona,expenses,food,-107.09,-98271.99
buyer_4,Marc,Andreu,1974-05-23,54922038Q,marc.andreu@brilliantapp.app,964991,ES19209587111785551517,5949.75,2024-10-05T00:46:40,Barcelona,expenses,mortgage,-1516.63,-99788.62
buyer_4,Marc,Andreu,1974-05-23,54922038Q,marc.andreu@brilliantapp.app,964991,ES19209587111785551517,5949.75,2024-10-05T08:49:03,Barcelona,expenses,internet,-63.41,-99852.03
buyer_4,Marc,Andreu,1974-05-23,54922038Q,marc.andreu@brilliantapp.app,964991,ES19209587111785551517,5949.75,2024-10-05T14:44:47,Barcelona,expenses,phone,-50.38,-99902.41
buyer_4,Marc,Andreu,1974-05-23,54922038Q,marc.andreu@brilliantapp.app,964991,ES19209587111785551517,5949.75,2024-10-05T19:23:35,Barcelona,expenses,healthcare,-121.1,-100023.51
buyer_4,Marc,Andreu,1974-05-23,54922038Q,marc.andreu@brilliantapp.app,964991,ES19209587111785551517,5949.75,2024-10-06T11:25:01,Barcelona,expenses,water,-63.42,-100086.93
buyer_4,Marc,Andreu,1974-05-23,54922038Q,marc.andreu@brilliantapp.app,964991,ES19209587111785551517,5949.75,2024-10-06T11:48:28,Barcelona,expenses,phone,-55.0,-100141.93
buyer_4,Marc,Andreu,1974-05-23,54922038Q,marc.andreu@brilliantapp.app,964991,ES19209587111785551517,5949.75,2024-10-06T13:56:42,Barcelona,expenses,travel,-752.48,-100894.41
buyer_4,Marc,Andreu,1974-05-23,54922038Q,marc.andreu@brilliantapp.app,964991,ES19209587111785551517,5949.75,2024-10-07T15:36:20,Barcelona,expenses,phone,-61.98,-100956.39
buyer_4,Marc,Andreu,1974-05-23,54922038Q,marc.andreu@brilliantapp.app,964991,ES19209587111785551517,5949.75,2024-10-07T15:04:51,Barcelona,expenses,transport,-84.98,-101041.37
buyer_4,Marc,Andreu,1974-05-23,54922038Q,marc.andreu@brilliantapp.app,964991,ES19209587111785551517,5949.75,2024-10-08T11:42:36,Barcelona,expenses,phone,-56.52,-101097.89
buyer_4,Marc,Andreu,1974-05-23,54922038Q,marc.andreu@brilliantapp.app,964991,ES19209587111785551517,5949.75,2024-10-08T22:14:04,Barcelona,expenses,food,-93.05,-101190.94
buyer_4,Marc,Andreu,1974-05-23,54922038Q,marc.andreu@brilliantapp.app,964991,ES19209587111785551517,5949.75,2024-10-08T17:07:17,Barcelona,expenses,transport,-46.76,-101237.7
buyer_4,Marc,Andreu,1974-05-23,54922038Q,marc.andreu@brilliantapp.app,964991,ES19209587111785551517,5949.75,2024-10-08T10:29:16,Barcelona,expenses,gifts,-697.87,-101935.57
buyer_4,Marc,Andreu,1974-05-23,54922038Q,marc.andreu@brilliantapp.app,964991,ES19209587111785551517,5949.75,2024-10-09T20:50:12,Barcelona,expenses,healthcare,-112.28,-102047.85
buyer_4,Marc,Andreu,1974-05-23,54922038Q,marc.andreu@brilliantapp.app,964991,ES19209587111785551517,5949.75,2024-10-10T13:25:31,Barcelona,expenses,food,-63.76,-102111.61
buyer_4,Marc,Andreu,1974-05-23,54922038Q,marc.andreu@brilliantapp.app,964991,ES19209587111785551517,5949.75,2024-10-10T19:50:11,Barcelona,expenses,leisure,-38.24,-102149.85
buyer_4,Marc,Andreu,1974-05-23,54922038Q,marc.andreu@brilliantapp.app,964991,ES19209587111785551517,5949.75,2024-10-10T19:14:23,Barcelona,expenses,cash,-100.0,-102249.85
buyer_5,Sara,Urkiaga,1994-03-12,44623772T,sara.urkiaga@megaapp.tech,772687,ES92209532362570784285,1506.75,2022-01-01T13:25:41,Plentzia,incomes,salary,2480.08,3986.83
buyer_5,Sara,Urkiaga,1994-03-12,44623772T,sara.urkiaga@megaapp.tech,772687,ES92209532362570784285,1506.75,2022-01-01T13:25:41,Plentzia,incomes,salary_partner,2219.09,6205.92
buyer_5,Sara,Urkiaga,1994-03-12,44623772T,sara.urkiaga@megaapp.tech,772687,ES92209532362570784285,1506.75,2022-01-01T20:20:21,Plentzia,expenses,food,-116.09,6089.83
buyer_5,Sara,Urkiaga,1994-03-12,44623772T,sara.urkiaga@megaapp.tech,772687,ES92209532362570784285,1506.75,2022-01-01T16:55:45,Plentzia,expenses,transport,-54.65,6035.18
buyer_5,Sara,Urkiaga,1994-03-12,44623772T,sara.urkiaga@megaapp.tech,772687,ES92209532362570784285,1506.75,2022-01-01T19:40:43,Plentzia,expenses,leisure,-47.76,5987.42
buyer_5,Sara,Urkiaga,1994-03-12,44623772T,sara.urkiaga@megaapp.tech,772687,ES92209532362570784285,1506.75,2022-01-03T10:48:13,Plentzia,expenses,gifts,-544.36,5443.06
buyer_5,Sara,Urkiaga,1994-03-12,44623772T,sara.urkiaga@megaapp.tech,772687,ES92209532362570784285,1506.75,2022-01-05T19:26:26,Plentzia,expenses,mortgage,-2297.17,3145.89
buyer_5,Sara,Urkiaga,1994-03-12,44623772T,sara.urkiaga@megaapp.tech,772687,ES92209532362570784285,1506.75,2022-01-05T15:39:51,Plentzia,expenses,water,-93.56,3052.33
buyer_5,Sara,Urkiaga,1994-03-12,44623772T,sara.urkiaga@megaapp.tech,772687,ES92209532362570784285,1506.75,2022-01-06T16:36:13,Plentzia,expenses,water,-105.01,2947.32
buyer_5,Sara,Urkiaga,1994-03-12,44623772T,sara.urkiaga@megaapp.tech,772687,ES92209532362570784285,1506.75,2022-01-06T15:16:40,Plentzia,expenses,internet,-98.68,2848.64
buyer_5,Sara,Urkiaga,1994-03-12,44623772T,sara.urkiaga@megaapp.tech,772687,ES92209532362570784285,1506.75,2022-01-07T17:55:59,Plentzia,expenses,water,-77.7,2770.94
buyer_5,Sara,Urkiaga,1994-03-12,44623772T,sara.urkiaga@megaapp.tech,772687,ES92209532362570784285,1506.75,2022-01-07T00:49:02,Plentzia,expenses,education,-77.52,2693.42
buyer_5,Sara,Urkiaga,1994-03-12,44623772T,sara.urkiaga@megaapp.tech,772687,ES92209532362570784285,1506.75,2022-01-08T08:27:42,Plentzia,expenses,electricity,-117.29,2576.13
buyer_5,Sara,Urkiaga,1994-03-12,44623772T,sara.urkiaga@megaapp.tech,772687,ES92209532362570784285,1506.75,2022-01-10T15:36:12,Plentzia,expenses,food,-123.01,2453.12
buyer_5,Sara,Urkiaga,1994-03-12,44623772T,sara.urkiaga@megaapp.tech,772687,ES92209532362570784285,1506.75,2022-01-11T13:03:47,Plentzia,expenses,cash,-100.0,2353.12
buyer_5,Sara,Urkiaga,1994-03-12,44623772T,sara.urkiaga@megaapp.tech,772687,ES92209532362570784285,1506.75,2022-01-12T06:41:50,Plentzia,expenses,gifts,-260.54,2092.58
buyer_5,Sara,Urkiaga,1994-03-12,44623772T,sara.urkiaga@megaapp.tech,772687,ES92209532362570784285,1506.75,2022-01-13T13:45:50,Plentzia,expenses,gifts,-52.96,2039.62
buyer_5,Sara,Urkiaga,1994-03-12,44623772T,sara.urkiaga@megaapp.tech,772687,ES92209532362570784285,1506.75,2022-01-14T12:08:31,Plentzia,expenses,clothing,-58.49,1981.13
buyer_5,Sara,Urkiaga,1994-03-12,44623772T,sara.urkiaga@megaapp.tech,772687,ES92209532362570784285,1506.75,2022-01-17T17:09:32,Plentzia,expenses,food,-79.37,1901.76
buyer_5,Sara,Urkiaga,1994-03-12,44623772T,sara.urkiaga@megaapp.tech,772687,ES92209532362570784285,1506.75,2022-01-17T13:00:20,Plentzia,expenses,repairs,-249.43,1652.33
buyer_5,Sara,Urkiaga,1994-03-12,44623772T,sara.urkiaga@megaapp.tech,772687,ES92209532362570784285,1506.75,2022-01-19T21:52:31,Plentzia,expenses,gifts,-89.31,1563.02
buyer_5,Sara,Urkiaga,1994-03-12,44623772T,sara.urkiaga@megaapp.tech,772687,ES92209532362570784285,1506.75,2022-01-20T12:34:34,Plentzia,expenses,food,-119.79,1443.23
buyer_5,Sara,Urkiaga,1994-03-12,44623772T,sara.urkiaga@megaapp.tech,772687,ES92209532362570784285,1506.75,2022-01-20T09:10:59,Plentzia,expenses,appliances,-308.13,1135.1
buyer_5,Sara,Urkiaga,1994-03-12,44623772T,sara.urkiaga@megaapp.tech,772687,ES92209532362570784285,1506.75,2022-01-21T22:59:35,Plentzia,expenses,healthcare,-183.14,951.96
buyer_5,Sara,Urkiaga,1994-03-12,44623772T,sara.urkiaga@megaapp.tech,772687,ES92209532362570784285,1506.75,2022-01-21T22:30:28,Plentzia,expenses,cash,-100.0,851.96
buyer_5,Sara,Urkiaga,1994-03-12,44623772T,sara.urkiaga@megaapp.tech,772687,ES92209532362570784285,1506.75,2022-01-22T09:02:28,Plentzia,expenses,cash,-100.0,751.96
buyer_5,Sara,Urkiaga,1994-03-12,44623772T,sara.urkiaga@megaapp.tech,772687,ES92209532362570784285,1506.75,2022-01-23T06:49:06,Plentzia,expenses,cash,-100.0,651.96
buyer_5,Sara,Urkiaga,1994-03-12,44623772T,sara.urkiaga@megaapp.tech,772687,ES92209532362570784285,1506.75,2022-01-24T04:51:11,Plentzia,expenses,food,-93.37,558.59
buyer_5,Sara,Urkiaga,1994-03-12,44623772T,sara.urkiaga@megaapp.tech,772687,ES92209532362570784285,1506.75,2022-01-26T09:31:10,Plentzia,expenses,cash,-100.0,458.59
buyer_5,Sara,Urkiaga,1994-03-12,44623772T,sara.urkiaga@megaapp.tech,772687,ES92209532362570784285,1506.75,2022-01-27T10:51:17,Plentzia,expenses,leisure,-34.5,424.09
buyer_5,Sara,Urkiaga,1994-03-12,44623772T,sara.urkiaga@megaapp.tech,772687,ES92209532362570784285,1506.75,2022-01-27T13:36:41,Plentzia,expenses,education,-69.33,354.76
buyer_5,Sara,Urkiaga,1994-03-12,44623772T,sara.urkiaga@megaapp.tech,772687,ES92209532362570784285,1506.75,2022-01-28T15:16:09,Plentzia,expenses,repairs,-77.49,277.27
buyer_5,Sara,Urkiaga,1994-03-12,44623772T,sara.urkiaga@megaapp.tech,772687,ES92209532362570784285,1506.75,2022-01-30T07:22:41,Plentzia,expenses,appliances,-246.36,30.91
buyer_5,Sara,Urkiaga,1994-03-12,44623772T,sara.urkiaga@megaapp.tech,772687,ES92209532362570784285,1506.75,2022-01-31T18:56:57,Plentzia,expenses,education,-57.99,-27.08
buyer_5,Sara,Urkiaga,1994-03-12,44623772T,sara.urkiaga@megaapp.tech,772687,ES92209532362570784285,1506.75,2022-01-31T10:28:45,Plentzia,expenses,cash,-100.0,-127.08
buyer_5,Sara,Urkiaga,1994-03-12,44623772T,sara.urkiaga@megaapp.tech,772687,ES92209532362570784285,1506.75,2022-02-01T14:22:47,Plentzia,incomes,salary,2480.08,2353.0
buyer_5,Sara,Urkiaga,1994-03-12,44623772T,sara.urkiaga@megaapp.tech,772687,ES92209532362570784285,1506.75,2022-02-01T14:22:47,Plentzia,incomes,salary_partner,2219.09,4572.09
buyer_5,Sara,Urkiaga,1994-03-12,44623772T,sara.urkiaga@megaapp.tech,772687,ES92209532362570784285,1506.75,2022-02-01T16:17:27,Plentzia,expenses,cash,-100.0,4472.09
buyer_5,Sara,Urkiaga,1994-03-12,44623772T,sara.urkiaga@megaapp.tech,772687,ES92209532362570784285,1506.75,2022-02-04T12:09:23,Plentzia,expenses,gifts,-580.84,3891.25
buyer_5,Sara,Urkiaga,1994-03-12,44623772T,sara.urkiaga@megaapp.tech,772687,ES92209532362570784285,1506.75,2022-02-05T12:52:06,Plentzia,expenses,mortgage,-2297.17,1594.08
buyer_5,Sara,Urkiaga,1994-03-12,44623772T,sara.urkiaga@megaapp.tech,772687,ES92209532362570784285,1506.75,2022-02-05T00:20:28,Plentzia,expenses,leisure,-22.14,1571.94
buyer_5,Sara,Urkiaga,1994-03-12,44623772T,sara.urkiaga@megaapp.tech,772687,ES92209532362570784285,1506.75,2022-02-06T13:40:07,Plentzia,expenses,internet,-98.68,1473.26
buyer_5,Sara,Urkiaga,1994-03-12,44623772T,sara.urkiaga@megaapp.tech,772687,ES92209532362570784285,1506.75,2022-02-07T22:18:48,Plentzia,expenses,gas,-230.35,1242.91
buyer_5,Sara,Urkiaga,1994-03-12,44623772T,sara.urkiaga@megaapp.tech,772687,ES92209532362570784285,1506.75,2022-02-08T15:59:35,Plentzia,expenses,water,-53.53,1189.38
buyer_5,Sara,Urkiaga,1994-03-12,44623772T,sara.urkiaga@megaapp.tech,772687,ES92209532362570784285,1506.75,2022-02-08T19:41:11,Plentzia,expenses,internet,-98.68,1090.7
buyer_5,Sara,Urkiaga,1994-03-12,44623772T,sara.urkiaga@megaapp.tech,772687,ES92209532362570784285,1506.75,2022-02-09T09:06:03,Plentzia,expenses,clothing,-72.82,1017.88
buyer_5,Sara,Urkiaga,1994-03-12,44623772T,sara.urkiaga@megaapp.tech,772687,ES92209532362570784285,1506.75,2022-02-09T10:11:31,Plentzia,expenses,cash,-100.0,917.88
buyer_5,Sara,Urkiaga,1994-03-12,44623772T,sara.urkiaga@megaapp.tech,772687,ES92209532362570784285,1506.75,2022-02-12T23:37:55,Plentzia,expenses,food,-120.23,797.65
buyer_5,Sara,Urkiaga,1994-03-12,44623772T,sara.urkiaga@megaapp.tech,772687,ES92209532362570784285,1506.75,2022-02-12T22:00:46,Plentzia,expenses,clothing,-123.87,673.78
buyer_5,Sara,Urkiaga,1994-03-12,44623772T,sara.urkiaga@megaapp.tech,772687,ES92209532362570784285,1506.75,2022-02-13T12:23:41,Plentzia,expenses,transport,-48.84,624.94
buyer_5,Sara,Urkiaga,1994-03-12,44623772T,sara.urkiaga@megaapp.tech,772687,ES92209532362570784285,1506.75,2022-02-15T08:44:03,Plentzia,expenses,education,-61.05,563.89
buyer_5,Sara,Urkiaga,1994-03-12,44623772T,sara.urkiaga@megaapp.tech,772687,ES92209532362570784285,1506.75,2022-02-16T11:30:42,Plentzia,expenses,leisure,-42.94,520.95
buyer_5,Sara,Urkiaga,1994-03-12,44623772T,sara.urkiaga@megaapp.tech,772687,ES92209532362570784285,1506.75,2022-02-16T10:20:35,Plentzia,expenses,education,-49.37,471.58
buyer_5,Sara,Urkiaga,1994-03-12,44623772T,sara.urkiaga@megaapp.tech,772687,ES92209532362570784285,1506.75,2022-02-17T19:20:20,Plentzia,expenses,education,-76.56,395.02
buyer_5,Sara,Urkiaga,1994-03-12,44623772T,sara.urkiaga@megaapp.tech,772687,ES92209532362570784285,1506.75,2022-02-17T23:55:22,Plentzia,expenses,repairs,-102.78,292.24
buyer_5,Sara,Urkiaga,1994-03-12,44623772T,sara.urkiaga@megaapp.tech,772687,ES92209532362570784285,1506.75,2022-02-18T16:02:33,Plentzia,expenses,transport,-50.82,241.42
buyer_5,Sara,Urkiaga,1994-03-12,44623772T,sara.urkiaga@megaapp.tech,772687,ES92209532362570784285,1506.75,2022-02-18T10:02:43,Plentzia,expenses,clothing,-146.89,94.53
buyer_5,Sara,Urkiaga,1994-03-12,44623772T,sara.urkiaga@megaapp.tech,772687,ES92209532362570784285,1506.75,2022-02-18T20:53:19,Plentzia,expenses,travel,-307.89,-213.36
buyer_5,Sara,Urkiaga,1994-03-12,44623772T,sara.urkiaga@megaapp.tech,772687,ES92209532362570784285,1506.75,2022-02-21T21:20:14,Plentzia,expenses,healthcare,-181.56,-394.92
buyer_5,Sara,Urkiaga,1994-03-12,44623772T,sara.urkiaga@megaapp.tech,772687,ES92209532362570784285,1506.75,2022-02-21T18:50:27,Plentzia,expenses,cash,-100.0,-494.92
buyer_5,Sara,Urkiaga,1994-03-12,44623772T,sara.urkiaga@megaapp.tech,772687,ES92209532362570784285,1506.75,2022-02-24T04:08:18,Plentzia,expenses,cash,-100.0,-594.92
buyer_5,Sara,Urkiaga,1994-03-12,44623772T,sara.urkiaga@megaapp.tech,772687,ES92209532362570784285,1506.75,2022-02-25T17:52:35,Plentzia,expenses,cash,-100.0,-694.92
buyer_5,Sara,Urkiaga,1994-03-12,44623772T,sara.urkiaga@megaapp.tech,772687,ES92209532362570784285,1506.75,2022-02-26T19:26:47,Plentzia,expenses,food,-112.45,-807.37
buyer_5,Sara,Urkiaga,1994-03-12,44623772T,sara.urkiaga@megaapp.tech,772687,ES92209532362570784285,1506.75,2022-02-27T18:18:23,Plentzia,expenses,food,-70.16,-877.53
buyer_5,Sara,Urkiaga,1994-03-12,44623772T,sara.urkiaga@megaapp.tech,772687,ES92209532362570784285,1506.75,2022-03-01T17:17:31,Plentzia,incomes,salary,2480.08,1602.55
buyer_5,Sara,Urkiaga,1994-03-12,44623772T,sara.urkiaga@megaapp.tech,772687,ES92209532362570784285,1506.75,2022-03-01T17:17:31,Plentzia,incomes,salary_partner,2219.09,3821.64
buyer_5,Sara,Urkiaga,1994-03-12,44623772T,sara.urkiaga@megaapp.tech,772687,ES92209532362570784285,1506.75,2022-03-01T17:17:31,Plentzia,incomes,extra_income,471.47,4293.11
buyer_5,Sara,Urkiaga,1994-03-12,44623772T,sara.urkiaga@megaapp.tech,772687,ES92209532362570784285,1506.75,2022-03-02T14:29:33,Plentzia,expenses,food,-104.6,4188.51
buyer_5,Sara,Urkiaga,1994-03-12,44623772T,sara.urkiaga@megaapp.tech,772687,ES92209532362570784285,1506.75,2022-03-03T14:15:26,Plentzia,expenses,food,-104.54,4083.97
buyer_5,Sara,Urkiaga,1994-03-12,44623772T,sara.urkiaga@megaapp.tech,772687,ES92209532362570784285,1506.75,2022-03-03T16:15:07,Plentzia,expenses,appliances,-408.03,3675.94
buyer_5,Sara,Urkiaga,1994-03-12,44623772T,sara.urkiaga@megaapp.tech,772687,ES92209532362570784285,1506.75,2022-03-05T22:32:48,Plentzia,expenses,mortgage,-2297.17,1378.77
buyer_5,Sara,Urkiaga,1994-03-12,44623772T,sara.urkiaga@megaapp.tech,772687,ES92209532362570784285,1506.75,2022-03-05T15:00:54,Plentzia,expenses,water,-77.49,1301.28
buyer_5,Sara,Urkiaga,1994-03-12,44623772T,sara.urkiaga@megaapp.tech,772687,ES92209532362570784285,1506.75,2022-03-05T15:29:44,Plentzia,expenses,internet,-98.68,1202.6
buyer_5,Sara,Urkiaga,1994-03-12,44623772T,sara.urkiaga@megaapp.tech,772687,ES92209532362570784285,1506.75,2022-03-05T04:08:05,Plentzia,expenses,food,-99.3,1103.3
buyer_5,Sara,Urkiaga,1994-03-12,44623772T,sara.urkiaga@megaapp.tech,772687,ES92209532362570784285,1506.75,2022-03-05T18:46:42,Plentzia,expenses,education,-54.84,1048.46
buyer_5,Sara,Urkiaga,1994-03-12,44623772T,sara.urkiaga@megaapp.tech,772687,ES92209532362570784285,1506.75,2022-03-06T17:02:42,Plentzia,expenses,gas,-223.94,824.52
buyer_5,Sara,Urkiaga,1994-03-12,44623772T,sara.urkiaga@megaapp.tech,772687,ES92209532362570784285,1506.75,2022-03-07T17:19:14,Plentzia,expenses,internet,-98.68,725.84
buyer_5,Sara,Urkiaga,1994-03-12,44623772T,sara.urkiaga@megaapp.tech,772687,ES92209532362570784285,1506.75,2022-03-08T15:34:31,Plentzia,expenses,food,-110.03,615.81
buyer_5,Sara,Urkiaga,1994-03-12,44623772T,sara.urkiaga@megaapp.tech,772687,ES92209532362570784285,1506.75,2022-03-08T12:52:00,Plentzia,expenses,clothing,-103.35,512.46
buyer_5,Sara,Urkiaga,1994-03-12,44623772T,sara.urkiaga@megaapp.tech,772687,ES92209532362570784285,1506.75,2022-03-09T15:14:54,Plentzia,expenses,clothing,-73.43,439.03
buyer_5,Sara,Urkiaga,1994-03-12,44623772T,sara.urkiaga@megaapp.tech,772687,ES92209532362570784285,1506.75,2022-03-10T23:35:41,Plentzia,expenses,healthcare,-79.2,359.83
buyer_5,Sara,Urkiaga,1994-03-12,44623772T,sara.urkiaga@megaapp.tech,772687,ES92209532362570784285,1506.75,2022-03-12T16:43:07,Plentzia,expenses,transport,-77.56,282.27
buyer_5,Sara,Urkiaga,1994-03-12,44623772T,sara.urkiaga@megaapp.tech,772687,ES92209532362570784285,1506.75,2022-03-16T15:56:27,Plentzia,expenses,leisure,-32.5,249.77
buyer_5,Sara,Urkiaga,1994-03-12,44623772T,sara.urkiaga@megaapp.tech,772687,ES92209532362570784285,1506.75,2022-03-17T17:42:51,Plentzia,expenses,food,-64.43,185.34
buyer_5,Sara,Urkiaga,1994-03-12,44623772T,sara.urkiaga@megaapp.tech,772687,ES92209532362570784285,1506.75,2022-03-17T09:07:11,Plentzia,expenses,healthcare,-129.18,56.16
buyer_5,Sara,Urkiaga,1994-03-12,44623772T,sara.urkiaga@megaapp.tech,772687,ES92209532362570784285,1506.75,2022-03-17T21:56:38,Plentzia,expenses,cash,-100.0,-43.84
buyer_5,Sara,Urkiaga,1994-03-12,44623772T,sara.urkiaga@megaapp.tech,772687,ES92209532362570784285,1506.75,2022-03-18T11:12:56,Plentzia,expenses,transport,-54.17,-98.01
buyer_5,Sara,Urkiaga,1994-03-12,44623772T,sara.urkiaga@megaapp.tech,772687,ES92209532362570784285,1506.75,2022-03-18T14:57:24,Plentzia,expenses,travel,-579.51,-677.52
buyer_5,Sara,Urkiaga,1994-03-12,44623772T,sara.urkiaga@megaapp.tech,772687,ES92209532362570784285,1506.75,2022-03-19T12:00:59,Plentzia,expenses,leisure,-36.48,-714.0
buyer_5,Sara,Urkiaga,1994-03-12,44623772T,sara.urkiaga@megaapp.tech,772687,ES92209532362570784285,1506.75,2022-03-20T16:39:32,Plentzia,expenses,food,-100.97,-814.97
buyer_5,Sara,Urkiaga,1994-03-12,44623772T,sara.urkiaga@megaapp.tech,772687,ES92209532362570784285,1506.75,2022-03-20T13:33:47,Plentzia,expenses,leisure,-47.29,-862.26
buyer_5,Sara,Urkiaga,1994-03-12,44623772T,sara.urkiaga@megaapp.tech,772687,ES92209532362570784285,1506.75,2022-03-22T15:54:33,Plentzia,expenses,cash,-100.0,-962.26
buyer_5,Sara,Urkiaga,1994-03-12,44623772T,sara.urkiaga@megaapp.tech,772687,ES92209532362570784285,1506.75,2022-03-24T08:13:06,Plentzia,expenses,cash,-100.0,-1062.26
buyer_5,Sara,Urkiaga,1994-03-12,44623772T,sara.urkiaga@megaapp.tech,772687,ES92209532362570784285,1506.75,2022-03-25T17:00:42,Plentzia,expenses,food,-93.51,-1155.77
buyer_5,Sara,Urkiaga,1994-03-12,44623772T,sara.urkiaga@megaapp.tech,772687,ES92209532362570784285,1506.75,2022-03-27T18:48:49,Plentzia,expenses,transport,-69.67,-1225.44
buyer_5,Sara,Urkiaga,1994-03-12,44623772T,sara.urkiaga@megaapp.tech,772687,ES92209532362570784285,1506.75,2022-03-28T20:10:47,Plentzia,expenses,leisure,-45.91,-1271.35
buyer_5,Sara,Urkiaga,1994-03-12,44623772T,sara.urkiaga@megaapp.tech,772687,ES92209532362570784285,1506.75,2022-03-30T16:24:55,Plentzia,expenses,food,-95.6,-1366.95
buyer_5,Sara,Urkiaga,1994-03-12,44623772T,sara.urkiaga@megaapp.tech,772687,ES92209532362570784285,1506.75,2022-03-30T13:59:09,Plentzia,expenses,transport,-79.52,-1446.47
buyer_5,Sara,Urkiaga,1994-03-12,44623772T,sara.urkiaga@megaapp.tech,772687,ES92209532362570784285,1506.75,2022-03-31T10:42:00,Plentzia,expenses,healthcare,-149.22,-1595.69
buyer_5,Sara,Urkiaga,1994-03-12,44623772T,sara.urkiaga@megaapp.tech,772687,ES92209532362570784285,1506.75,2022-04-01T09:41:10,Plentzia,incomes,salary,2480.08,884.39
buyer_5,Sara,Urkiaga,1994-03-12,44623772T,sara.urkiaga@megaapp.tech,772687,ES92209532362570784285,1506.75,2022-04-01T09:41:10,Plentzia,incomes,salary_partner,2219.09,3103.48
buyer_5,Sara,Urkiaga,1994-03-12,44623772T,sara.urkiaga@megaapp.tech,772687,ES92209532362570784285,1506.75,2022-04-01T02:36:03,Plentzia,expenses,food,-87.98,3015.5
buyer_5,Sara,Urkiaga,1994-03-12,44623772T,sara.urkiaga@megaapp.tech,772687,ES92209532362570784285,1506.75,2022-04-01T21:31:05,Plentzia,expenses,cash,-100.0,2915.5
buyer_5,Sara,Urkiaga,1994-03-12,44623772T,sara.urkiaga@megaapp.tech,772687,ES92209532362570784285,1506.75,2022-04-02T12:32:54,Plentzia,expenses,transport,-78.24,2837.26
buyer_5,Sara,Urkiaga,1994-03-12,44623772T,sara.urkiaga@megaapp.tech,772687,ES92209532362570784285,1506.75,2022-04-02T19:07:53,Plentzia,expenses,cash,-100.0,2737.26
buyer_5,Sara,Urkiaga,1994-03-12,44623772T,sara.urkiaga@megaapp.tech,772687,ES92209532362570784285,1506.75,2022-04-03T10:05:44,Plentzia,expenses,cash,-100.0,2637.26
buyer_5,Sara,Urkiaga,1994-03-12,44623772T,sara.urkiaga@megaapp.tech,772687,ES92209532362570784285,1506.75,2022-04-04T13:41:17,Plentzia,expenses,transport,-85.94,2551.32
buyer_5,Sara,Urkiaga,1994-03-12,44623772T,sara.urkiaga@megaapp.tech,772687,ES92209532362570784285,1506.75,2022-04-05T21:45:07,Plentzia,expenses,mortgage,-2297.17,254.15
buyer_5,Sara,Urkiaga,1994-03-12,44623772T,sara.urkiaga@megaapp.tech,772687,ES92209532362570784285,1506.75,2022-04-05T18:09:37,Plentzia,expenses,internet,-98.68,155.47
buyer_5,Sara,Urkiaga,1994-03-12,44623772T,sara.urkiaga@megaapp.tech,772687,ES92209532362570784285,1506.75,2022-04-06T20:30:21,Plentzia,expenses,electricity,-108.79,46.68
buyer_5,Sara,Urkiaga,1994-03-12,44623772T,sara.urkiaga@megaapp.tech,772687,ES92209532362570784285,1506.75,2022-04-06T08:59:57,Plentzia,expenses,clothing,-89.69,-43.01
buyer_5,Sara,Urkiaga,1994-03-12,44623772T,sara.urkiaga@megaapp.tech,772687,ES92209532362570784285,1506.75,2022-04-07T00:56:18,Plentzia,expenses,gas,-233.21,-276.22
buyer_5,Sara,Urkiaga,1994-03-12,44623772T,sara.urkiaga@megaapp.tech,772687,ES92209532362570784285,1506.75,2022-04-07T08:08:09,Plentzia,expenses,internet,-98.68,-374.9
buyer_5,Sara,Urkiaga,1994-03-12,44623772T,sara.urkiaga@megaapp.tech,772687,ES92209532362570784285,1506.75,2022-04-07T17:58:56,Plentzia,expenses,education,-51.58,-426.48
buyer_5,Sara,Urkiaga,1994-03-12,44623772T,sara.urkiaga@megaapp.tech,772687,ES92209532362570784285,1506.75,2022-04-08T20:58:56,Plentzia,expenses,electricity,-96.9,-523.38
buyer_5,Sara,Urkiaga,1994-03-12,44623772T,sara.urkiaga@megaapp.tech,772687,ES92209532362570784285,1506.75,2022-04-08T13:04:40,Plentzia,expenses,gas,-134.96,-658.34
buyer_5,Sara,Urkiaga,1994-03-12,44623772T,sara.urkiaga@megaapp.tech,772687,ES92209532362570784285,1506.75,2022-04-09T11:23:00,Plentzia,expenses,cash,-100.0,-758.34
buyer_5,Sara,Urkiaga,1994-03-12,44623772T,sara.urkiaga@megaapp.tech,772687,ES92209532362570784285,1506.75,2022-04-12T08:09:23,Plentzia,expenses,clothing,-85.93,-844.27
buyer_5,Sara,Urkiaga,1994-03-12,44623772T,sara.urkiaga@megaapp.tech,772687,ES92209532362570784285,1506.75,2022-04-13T10:10:30,Plentzia,expenses,transport,-53.43,-897.7
buyer_5,Sara,Urkiaga,1994-03-12,44623772T,sara.urkiaga@megaapp.tech,772687,ES92209532362570784285,1506.75,2022-04-16T10:30:38,Plentzia,expenses,food,-75.96,-973.66
buyer_5,Sara,Urkiaga,1994-03-12,44623772T,sara.urkiaga@megaapp.tech,772687,ES92209532362570784285,1506.75,2022-04-16T20:38:26,Plentzia,expenses,clothing,-66.61,-1040.27
buyer_5,Sara,Urkiaga,1994-03-12,44623772T,sara.urkiaga@megaapp.tech,772687,ES92209532362570784285,1506.75,2022-04-18T15:00:54,Plentzia,expenses,cash,-100.0,-1140.27
buyer_5,Sara,Urkiaga,1994-03-12,44623772T,sara.urkiaga@megaapp.tech,772687,ES92209532362570784285,1506.75,2022-04-19T10:34:13,Plentzia,expenses,food,-120.51,-1260.78
buyer_5,Sara,Urkiaga,1994-03-12,44623772T,sara.urkiaga@megaapp.tech,772687,ES92209532362570784285,1506.75,2022-04-19T11:16:12,Plentzia,expenses,transport,-49.88,-1310.66
buyer_5,Sara,Urkiaga,1994-03-12,44623772T,sara.urkiaga@megaapp.tech,772687,ES92209532362570784285,1506.75,2022-04-19T11:39:43,Plentzia,expenses,cash,-100.0,-1410.66
buyer_5,Sara,Urkiaga,1994-03-12,44623772T,sara.urkiaga@megaapp.tech,772687,ES92209532362570784285,1506.75,2022-04-19T09:25:44,Plentzia,expenses,gifts,-231.1,-1641.76
buyer_5,Sara,Urkiaga,1994-03-12,44623772T,sara.urkiaga@megaapp.tech,772687,ES92209532362570784285,1506.75,2022-04-20T00:57:45,Plentzia,expenses,clothing,-108.37,-1750.13
buyer_5,Sara,Urkiaga,1994-03-12,44623772T,sara.urkiaga@megaapp.tech,772687,ES92209532362570784285,1506.75,2022-04-21T19:34:36,Plentzia,expenses,leisure,-58.49,-1808.62
buyer_5,Sara,Urkiaga,1994-03-12,44623772T,sara.urkiaga@megaapp.tech,772687,ES92209532362570784285,1506.75,2022-04-22T17:19:17,Plentzia,expenses,education,-54.94,-1863.56
buyer_5,Sara,Urkiaga,1994-03-12,44623772T,sara.urkiaga@megaapp.tech,772687,ES92209532362570784285,1506.75,2022-04-25T18:17:31,Plentzia,expenses,education,-48.04,-1911.6
buyer_5,Sara,Urkiaga,1994-03-12,44623772T,sara.urkiaga@megaapp.tech,772687,ES92209532362570784285,1506.75,2022-04-26T13:59:17,Plentzia,expenses,gifts,-626.16,-2537.76
buyer_5,Sara,Urkiaga,1994-03-12,44623772T,sara.urkiaga@megaapp.tech,772687,ES92209532362570784285,1506.75,2022-04-27T19:26:29,Plentzia,expenses,leisure,-28.77,-2566.53
buyer_5,Sara,Urkiaga,1994-03-12,44623772T,sara.urkiaga@megaapp.tech,772687,ES92209532362570784285,1506.75,2022-04-27T14:29:19,Plentzia,expenses,cash,-100.0,-2666.53
buyer_5,Sara,Urkiaga,1994-03-12,44623772T,sara.urkiaga@megaapp.tech,772687,ES92209532362570784285,1506.75,2022-04-28T17:26:58,Plentzia,expenses,leisure,-62.46,-2728.99
buyer_5,Sara,Urkiaga,1994-03-12,44623772T,sara.urkiaga@megaapp.tech,772687,ES92209532362570784285,1506.75,2022-04-30T17:27:24,Plentzia,expenses,food,-66.41,-2795.4
buyer_5,Sara,Urkiaga,1994-03-12,44623772T,sara.urkiaga@megaapp.tech,772687,ES92209532362570784285,1506.75,2022-05-01T17:14:48,Plentzia,incomes,salary,2480.08,-315.32
buyer_5,Sara,Urkiaga,1994-03-12,44623772T,sara.urkiaga@megaapp.tech,772687,ES92209532362570784285,1506.75,2022-05-01T17:14:48,Plentzia,incomes,salary_partner,2219.09,1903.77
buyer_5,Sara,Urkiaga,1994-03-12,44623772T,sara.urkiaga@megaapp.tech,772687,ES92209532362570784285,1506.75,2022-05-01T05:36:25,Plentzia,expenses,cash,-100.0,1803.77
buyer_5,Sara,Urkiaga,1994-03-12,44623772T,sara.urkiaga@megaapp.tech,772687,ES92209532362570784285,1506.75,2022-05-02T17:38:08,Plentzia,expenses,leisure,-19.21,1784.56
buyer_5,Sara,Urkiaga,1994-03-12,44623772T,sara.urkiaga@megaapp.tech,772687,ES92209532362570784285,1506.75,2022-05-02T08:43:22,Plentzia,expenses,clothing,-64.85,1719.71
buyer_5,Sara,Urkiaga,1994-03-12,44623772T,sara.urkiaga@megaapp.tech,772687,ES92209532362570784285,1506.75,2022-05-04T09:56:10,Plentzia,expenses,transport,-57.25,1662.46
buyer_5,Sara,Urkiaga,1994-03-12,44623772T,sara.urkiaga@megaapp.tech,772687,ES92209532362570784285,1506.75,2022-05-05T17:19:30,Plentzia,expenses,mortgage,-2297.17,-634.71
buyer_5,Sara,Urkiaga,1994-03-12,44623772T,sara.urkiaga@megaapp.tech,772687,ES92209532362570784285,1506.75,2022-05-05T17:28:58,Plentzia,expenses,gas,-100.8,-735.51
buyer_5,Sara,Urkiaga,1994-03-12,44623772T,sara.urkiaga@megaapp.tech,772687,ES92209532362570784285,1506.75,2022-05-05T19:10:29,Plentzia,expenses,leisure,-36.61,-772.12
buyer_5,Sara,Urkiaga,1994-03-12,44623772T,sara.urkiaga@megaapp.tech,772687,ES92209532362570784285,1506.75,2022-05-06T17:01:31,Plentzia,expenses,water,-101.16,-873.28
buyer_5,Sara,Urkiaga,1994-03-12,44623772T,sara.urkiaga@megaapp.tech,772687,ES92209532362570784285,1506.75,2022-05-06T08:51:49,Plentzia,expenses,gas,-72.59,-945.87
buyer_5,Sara,Urkiaga,1994-03-12,44623772T,sara.urkiaga@megaapp.tech,772687,ES92209532362570784285,1506.75,2022-05-07T14:08:51,Plentzia,expenses,water,-71.31,-1017.18
buyer_5,Sara,Urkiaga,1994-03-12,44623772T,sara.urkiaga@megaapp.tech,772687,ES92209532362570784285,1506.75,2022-05-08T10:30:35,Plentzia,expenses,gas,-240.66,-1257.84
buyer_5,Sara,Urkiaga,1994-03-12,44623772T,sara.urkiaga@megaapp.tech,772687,ES92209532362570784285,1506.75,2022-05-09T11:41:30,Plentzia,expenses,food,-105.78,-1363.62
buyer_5,Sara,Urkiaga,1994-03-12,44623772T,sara.urkiaga@megaapp.tech,772687,ES92209532362570784285,1506.75,2022-05-11T17:36:33,Plentzia,expenses,food,-123.13,-1486.75
buyer_5,Sara,Urkiaga,1994-03-12,44623772T,sara.urkiaga@megaapp.tech,772687,ES92209532362570784285,1506.75,2022-05-14T17:23:27,Plentzia,expenses,transport,-41.99,-1528.74
buyer_5,Sara,Urkiaga,1994-03-12,44623772T,sara.urkiaga@megaapp.tech,772687,ES92209532362570784285,1506.75,2022-05-14T08:06:39,Plentzia,expenses,gifts,-158.78,-1687.52
buyer_5,Sara,Urkiaga,1994-03-12,44623772T,sara.urkiaga@megaapp.tech,772687,ES92209532362570784285,1506.75,2022-05-16T20:55:44,Plentzia,expenses,repairs,-33.44,-1720.96
buyer_5,Sara,Urkiaga,1994-03-12,44623772T,sara.urkiaga@megaapp.tech,772687,ES92209532362570784285,1506.75,2022-05-16T08:17:19,Plentzia,expenses,gifts,-263.26,-1984.22
buyer_5,Sara,Urkiaga,1994-03-12,44623772T,sara.urkiaga@megaapp.tech,772687,ES92209532362570784285,1506.75,2022-05-20T11:48:53,Plentzia,expenses,food,-123.18,-2107.4
buyer_5,Sara,Urkiaga,1994-03-12,44623772T,sara.urkiaga@megaapp.tech,772687,ES92209532362570784285,1506.75,2022-05-21T16:44:56,Plentzia,expenses,transport,-45.59,-2152.99
buyer_5,Sara,Urkiaga,1994-03-12,44623772T,sara.urkiaga@megaapp.tech,772687,ES92209532362570784285,1506.75,2022-05-23T12:04:48,Plentzia,expenses,food,-63.59,-2216.58
buyer_5,Sara,Urkiaga,1994-03-12,44623772T,sara.urkiaga@megaapp.tech,772687,ES92209532362570784285,1506.75,2022-05-25T20:25:44,Plentzia,expenses,healthcare,-150.0,-2366.58
buyer_5,Sara,Urkiaga,1994-03-12,44623772T,sara.urkiaga@megaapp.tech,772687,ES92209532362570784285,1506.75,2022-05-25T09:35:57,Plentzia,expenses,repairs,-233.42,-2600.0
buyer_5,Sara,Urkiaga,1994-03-12,44623772T,sara.urkiaga@megaapp.tech,772687,ES92209532362570784285,1506.75,2022-05-25T15:55:28,Plentzia,expenses,gifts,-88.93,-2688.93
buyer_5,Sara,Urkiaga,1994-03-12,44623772T,sara.urkiaga@megaapp.tech,772687,ES92209532362570784285,1506.75,2022-05-27T09:29:02,Plentzia,expenses,repairs,-252.2,-2941.13
buyer_5,Sara,Urkiaga,1994-03-12,44623772T,sara.urkiaga@megaapp.tech,772687,ES92209532362570784285,1506.75,2022-05-28T10:51:15,Plentzia,expenses,cash,-100.0,-3041.13
buyer_5,Sara,Urkiaga,1994-03-12,44623772T,sara.urkiaga@megaapp.tech,772687,ES92209532362570784285,1506.75,2022-05-31T10:45:35,Plentzia,expenses,clothing,-129.07,-3170.2
buyer_5,Sara,Urkiaga,1994-03-12,44623772T,sara.urkiaga@megaapp.tech,772687,ES92209532362570784285,1506.75,2022-06-01T20:08:46,Plentzia,incomes,salary,2480.08,-690.12
buyer_5,Sara,Urkiaga,1994-03-12,44623772T,sara.urkiaga@megaapp.tech,772687,ES92209532362570784285,1506.75,2022-06-01T20:08:46,Plentzia,incomes,salary_partner,2219.09,1528.97
buyer_5,Sara,Urkiaga,1994-03-12,44623772T,sara.urkiaga@megaapp.tech,772687,ES92209532362570784285,1506.75,2022-06-01T20:08:46,Plentzia,incomes,extra_income,471.47,2000.44
buyer_5,Sara,Urkiaga,1994-03-12,44623772T,sara.urkiaga@megaapp.tech,772687,ES92209532362570784285,1506.75,2022-06-01T20:08:46,Plentzia,incomes,salary_bonus,1950.29,3950.73
buyer_5,Sara,Urkiaga,1994-03-12,44623772T,sara.urkiaga@megaapp.tech,772687,ES92209532362570784285,1506.75,2022-06-01T20:08:46,Plentzia,incomes,salary_partner_bonus,1693.23,5643.96
buyer_5,Sara,Urkiaga,1994-03-12,44623772T,sara.urkiaga@megaapp.tech,772687,ES92209532362570784285,1506.75,2022-06-01T12:17:27,Plentzia,expenses,taxes,-3966.13,1677.83
buyer_5,Sara,Urkiaga,1994-03-12,44623772T,sara.urkiaga@megaapp.tech,772687,ES92209532362570784285,1506.75,2022-06-01T17:15:25,Plentzia,expenses,insurance,-897.38,780.45
buyer_5,Sara,Urkiaga,1994-03-12,44623772T,sara.urkiaga@megaapp.tech,772687,ES92209532362570784285,1506.75,2022-06-03T14:23:00,Plentzia,expenses,gifts,-592.15,188.3
buyer_5,Sara,Urkiaga,1994-03-12,44623772T,sara.urkiaga@megaapp.tech,772687,ES92209532362570784285,1506.75,2022-06-04T11:13:12,Plentzia,expenses,food,-124.52,63.78
buyer_5,Sara,Urkiaga,1994-03-12,44623772T,sara.urkiaga@megaapp.tech,772687,ES92209532362570784285,1506.75,2022-06-04T12:14:24,Plentzia,expenses,leisure,-45.18,18.6
buyer_5,Sara,Urkiaga,1994-03-12,44623772T,sara.urkiaga@megaapp.tech,772687,ES92209532362570784285,1506.75,2022-06-05T09:57:49,Plentzia,expenses,mortgage,-2297.17,-2278.57
buyer_5,Sara,Urkiaga,1994-03-12,44623772T,sara.urkiaga@megaapp.tech,772687,ES92209532362570784285,1506.75,2022-06-05T05:16:11,Plentzia,expenses,water,-56.95,-2335.52
buyer_5,Sara,Urkiaga,1994-03-12,44623772T,sara.urkiaga@megaapp.tech,772687,ES92209532362570784285,1506.75,2022-06-05T17:22:33,Plentzia,expenses,internet,-98.68,-2434.2
buyer_5,Sara,Urkiaga,1994-03-12,44623772T,sara.urkiaga@megaapp.tech,772687,ES92209532362570784285,1506.75,2022-06-05T17:45:07,Plentzia,expenses,transport,-65.89,-2500.09
buyer_5,Sara,Urkiaga,1994-03-12,44623772T,sara.urkiaga@megaapp.tech,772687,ES92209532362570784285,1506.75,2022-06-07T08:28:15,Plentzia,expenses,food,-86.25,-2586.34
buyer_5,Sara,Urkiaga,1994-03-12,44623772T,sara.urkiaga@megaapp.tech,772687,ES92209532362570784285,1506.75,2022-06-07T10:15:49,Plentzia,expenses,cash,-100.0,-2686.34
buyer_5,Sara,Urkiaga,1994-03-12,44623772T,sara.urkiaga@megaapp.tech,772687,ES92209532362570784285,1506.75,2022-06-07T19:29:42,Plentzia,expenses,gifts,-149.16,-2835.5
buyer_5,Sara,Urkiaga,1994-03-12,44623772T,sara.urkiaga@megaapp.tech,772687,ES92209532362570784285,1506.75,2022-06-08T19:25:03,Plentzia,expenses,electricity,-83.24,-2918.74
buyer_5,Sara,Urkiaga,1994-03-12,44623772T,sara.urkiaga@megaapp.tech,772687,ES92209532362570784285,1506.75,2022-06-08T14:53:39,Plentzia,expenses,gas,-145.95,-3064.69
buyer_5,Sara,Urkiaga,1994-03-12,44623772T,sara.urkiaga@megaapp.tech,772687,ES92209532362570784285,1506.75,2022-06-08T17:02:00,Plentzia,expenses,phone,-102.59,-3167.28
buyer_5,Sara,Urkiaga,1994-03-12,44623772T,sara.urkiaga@megaapp.tech,772687,ES92209532362570784285,1506.75,2022-06-08T08:27:41,Plentzia,expenses,transport,-56.88,-3224.16
buyer_5,Sara,Urkiaga,1994-03-12,44623772T,sara.urkiaga@megaapp.tech,772687,ES92209532362570784285,1506.75,2022-06-13T21:58:09,Plentzia,expenses,food,-72.68,-3296.84
buyer_5,Sara,Urkiaga,1994-03-12,44623772T,sara.urkiaga@megaapp.tech,772687,ES92209532362570784285,1506.75,2022-06-15T17:11:31,Plentzia,expenses,gifts,-362.83,-3659.67
buyer_5,Sara,Urkiaga,1994-03-12,44623772T,sara.urkiaga@megaapp.tech,772687,ES92209532362570784285,1506.75,2022-06-17T15:12:57,Plentzia,expenses,transport,-50.25,-3709.92
buyer_5,Sara,Urkiaga,1994-03-12,44623772T,sara.urkiaga@megaapp.tech,772687,ES92209532362570784285,1506.75,2022-06-17T15:46:31,Plentzia,expenses,leisure,-68.45,-3778.37
buyer_5,Sara,Urkiaga,1994-03-12,44623772T,sara.urkiaga@megaapp.tech,772687,ES92209532362570784285,1506.75,2022-06-17T15:05:33,Plentzia,expenses,travel,-344.2,-4122.57
buyer_5,Sara,Urkiaga,1994-03-12,44623772T,sara.urkiaga@megaapp.tech,772687,ES92209532362570784285,1506.75,2022-06-19T16:12:51,Plentzia,expenses,food,-94.24,-4216.81
buyer_5,Sara,Urkiaga,1994-03-12,44623772T,sara.urkiaga@megaapp.tech,772687,ES92209532362570784285,1506.75,2022-06-19T16:13:42,Plentzia,expenses,leisure,-74.06,-4290.87
buyer_5,Sara,Urkiaga,1994-03-12,44623772T,sara.urkiaga@megaapp.tech,772687,ES92209532362570784285,1506.75,2022-06-20T16:32:47,Plentzia,expenses,leisure,-33.95,-4324.82
buyer_5,Sara,Urkiaga,1994-03-12,44623772T,sara.urkiaga@megaapp.tech,772687,ES92209532362570784285,1506.75,2022-06-21T09:14:57,Plentzia,expenses,transport,-72.45,-4397.27
buyer_5,Sara,Urkiaga,1994-03-12,44623772T,sara.urkiaga@megaapp.tech,772687,ES92209532362570784285,1506.75,2022-06-21T18:14:30,Plentzia,expenses,gifts,-115.07,-4512.34
buyer_5,Sara,Urkiaga,1994-03-12,44623772T,sara.urkiaga@megaapp.tech,772687,ES92209532362570784285,1506.75,2022-06-22T20:52:44,Plentzia,expenses,transport,-55.08,-4567.42
buyer_5,Sara,Urkiaga,1994-03-12,44623772T,sara.urkiaga@megaapp.tech,772687,ES92209532362570784285,1506.75,2022-06-23T09:29:49,Plentzia,expenses,transport,-43.81,-4611.23
buyer_5,Sara,Urkiaga,1994-03-12,44623772T,sara.urkiaga@megaapp.tech,772687,ES92209532362570784285,1506.75,2022-06-24T13:49:25,Plentzia,expenses,transport,-64.18,-4675.41
buyer_5,Sara,Urkiaga,1994-03-12,44623772T,sara.urkiaga@megaapp.tech,772687,ES92209532362570784285,1506.75,2022-06-25T12:33:50,Plentzia,expenses,food,-105.18,-4780.59
buyer_5,Sara,Urkiaga,1994-03-12,44623772T,sara.urkiaga@megaapp.tech,772687,ES92209532362570784285,1506.75,2022-06-26T10:48:54,Plentzia,expenses,transport,-80.91,-4861.5
buyer_5,Sara,Urkiaga,1994-03-12,44623772T,sara.urkiaga@megaapp.tech,772687,ES92209532362570784285,1506.75,2022-06-26T12:36:38,Plentzia,expenses,leisure,-70.33,-4931.83
buyer_5,Sara,Urkiaga,1994-03-12,44623772T,sara.urkiaga@megaapp.tech,772687,ES92209532362570784285,1506.75,2022-06-26T16:10:08,Plentzia,expenses,clothing,-96.46,-5028.29
buyer_5,Sara,Urkiaga,1994-03-12,44623772T,sara.urkiaga@megaapp.tech,772687,ES92209532362570784285,1506.75,2022-06-26T11:42:06,Plentzia,expenses,cash,-100.0,-5128.29
buyer_5,Sara,Urkiaga,1994-03-12,44623772T,sara.urkiaga@megaapp.tech,772687,ES92209532362570784285,1506.75,2022-06-27T16:41:23,Plentzia,expenses,healthcare,-169.96,-5298.25
buyer_5,Sara,Urkiaga,1994-03-12,44623772T,sara.urkiaga@megaapp.tech,772687,ES92209532362570784285,1506.75,2022-06-28T19:12:41,Plentzia,expenses,food,-107.81,-5406.06
buyer_5,Sara,Urkiaga,1994-03-12,44623772T,sara.urkiaga@megaapp.tech,772687,ES92209532362570784285,1506.75,2022-06-28T15:23:52,Plentzia,expenses,cash,-100.0,-5506.06
buyer_5,Sara,Urkiaga,1994-03-12,44623772T,sara.urkiaga@megaapp.tech,772687,ES92209532362570784285,1506.75,2022-06-29T11:15:22,Plentzia,expenses,food,-65.25,-5571.31
buyer_5,Sara,Urkiaga,1994-03-12,44623772T,sara.urkiaga@megaapp.tech,772687,ES92209532362570784285,1506.75,2022-06-29T17:15:46,Plentzia,expenses,transport,-60.32,-5631.63
buyer_5,Sara,Urkiaga,1994-03-12,44623772T,sara.urkiaga@megaapp.tech,772687,ES92209532362570784285,1506.75,2022-07-01T13:29:28,Plentzia,incomes,salary,2480.08,-3151.55
buyer_5,Sara,Urkiaga,1994-03-12,44623772T,sara.urkiaga@megaapp.tech,772687,ES92209532362570784285,1506.75,2022-07-01T13:29:28,Plentzia,incomes,salary_partner,2219.09,-932.46
buyer_5,Sara,Urkiaga,1994-03-12,44623772T,sara.urkiaga@megaapp.tech,772687,ES92209532362570784285,1506.75,2022-07-02T08:56:19,Plentzia,expenses,transport,-71.06,-1003.52
buyer_5,Sara,Urkiaga,1994-03-12,44623772T,sara.urkiaga@megaapp.tech,772687,ES92209532362570784285,1506.75,2022-07-02T12:03:51,Plentzia,expenses,appliances,-191.43,-1194.95
buyer_5,Sara,Urkiaga,1994-03-12,44623772T,sara.urkiaga@megaapp.tech,772687,ES92209532362570784285,1506.75,2022-07-05T16:18:43,Plentzia,expenses,mortgage,-2297.17,-3492.12
buyer_5,Sara,Urkiaga,1994-03-12,44623772T,sara.urkiaga@megaapp.tech,772687,ES92209532362570784285,1506.75,2022-07-05T19:54:17,Plentzia,expenses,water,-64.27,-3556.39
buyer_5,Sara,Urkiaga,1994-03-12,44623772T,sara.urkiaga@megaapp.tech,772687,ES92209532362570784285,1506.75,2022-07-08T16:47:07,Plentzia,expenses,water,-94.97,-3651.36
buyer_5,Sara,Urkiaga,1994-03-12,44623772T,sara.urkiaga@megaapp.tech,772687,ES92209532362570784285,1506.75,2022-07-08T08:01:31,Plentzia,expenses,electricity,-121.5,-3772.86
buyer_5,Sara,Urkiaga,1994-03-12,44623772T,sara.urkiaga@megaapp.tech,772687,ES92209532362570784285,1506.75,2022-07-08T17:37:29,Plentzia,expenses,gas,-99.38,-3872.24
buyer_5,Sara,Urkiaga,1994-03-12,44623772T,sara.urkiaga@megaapp.tech,772687,ES92209532362570784285,1506.75,2022-07-08T14:49:41,Plentzia,expenses,cash,-100.0,-3972.24
buyer_5,Sara,Urkiaga,1994-03-12,44623772T,sara.urkiaga@megaapp.tech,772687,ES92209532362570784285,1506.75,2022-07-09T08:48:16,Plentzia,expenses,food,-123.28,-4095.52
buyer_5,Sara,Urkiaga,1994-03-12,44623772T,sara.urkiaga@megaapp.tech,772687,ES92209532362570784285,1506.75,2022-07-09T12:35:33,Plentzia,expenses,cash,-100.0,-4195.52
buyer_5,Sara,Urkiaga,1994-03-12,44623772T,sara.urkiaga@megaapp.tech,772687,ES92209532362570784285,1506.75,2022-07-10T12:56:08,Plentzia,expenses,food,-71.75,-4267.27
buyer_5,Sara,Urkiaga,1994-03-12,44623772T,sara.urkiaga@megaapp.tech,772687,ES92209532362570784285,1506.75,2022-07-11T13:15:19,Plentzia,expenses,cash,-100.0,-4367.27
buyer_5,Sara,Urkiaga,1994-03-12,44623772T,sara.urkiaga@megaapp.tech,772687,ES92209532362570784285,1506.75,2022-07-11T16:04:09,Plentzia,expenses,gifts,-66.72,-4433.99
buyer_5,Sara,Urkiaga,1994-03-12,44623772T,sara.urkiaga@megaapp.tech,772687,ES92209532362570784285,1506.75,2022-07-16T20:35:54,Plentzia,expenses,gifts,-186.62,-4620.61
buyer_5,Sara,Urkiaga,1994-03-12,44623772T,sara.urkiaga@megaapp.tech,772687,ES92209532362570784285,1506.75,2022-07-18T20:04:39,Plentzia,expenses,healthcare,-151.95,-4772.56
buyer_5,Sara,Urkiaga,1994-03-12,44623772T,sara.urkiaga@megaapp.tech,772687,ES92209532362570784285,1506.75,2022-07-18T09:55:02,Plentzia,expenses,cash,-100.0,-4872.56
buyer_5,Sara,Urkiaga,1994-03-12,44623772T,sara.urkiaga@megaapp.tech,772687,ES92209532362570784285,1506.75,2022-07-19T17:54:34,Plentzia,expenses,leisure,-83.04,-4955.6
buyer_5,Sara,Urkiaga,1994-03-12,44623772T,sara.urkiaga@megaapp.tech,772687,ES92209532362570784285,1506.75,2022-07-20T11:06:30,Plentzia,expenses,food,-116.89,-5072.49
buyer_5,Sara,Urkiaga,1994-03-12,44623772T,sara.urkiaga@megaapp.tech,772687,ES92209532362570784285,1506.75,2022-07-22T03:52:45,Plentzia,expenses,leisure,-83.35,-5155.84
buyer_5,Sara,Urkiaga,1994-03-12,44623772T,sara.urkiaga@megaapp.tech,772687,ES92209532362570784285,1506.75,2022-07-22T18:58:17,Plentzia,expenses,gifts,-412.32,-5568.16
buyer_5,Sara,Urkiaga,1994-03-12,44623772T,sara.urkiaga@megaapp.tech,772687,ES92209532362570784285,1506.75,2022-07-23T11:36:01,Plentzia,expenses,clothing,-97.78,-5665.94
buyer_5,Sara,Urkiaga,1994-03-12,44623772T,sara.urkiaga@megaapp.tech,772687,ES92209532362570784285,1506.75,2022-07-23T15:17:48,Plentzia,expenses,healthcare,-102.03,-5767.97
buyer_5,Sara,Urkiaga,1994-03-12,44623772T,sara.urkiaga@megaapp.tech,772687,ES92209532362570784285,1506.75,2022-07-24T10:20:24,Plentzia,expenses,leisure,-27.5,-5795.47
buyer_5,Sara,Urkiaga,1994-03-12,44623772T,sara.urkiaga@megaapp.tech,772687,ES92209532362570784285,1506.75,2022-07-25T19:44:21,Plentzia,expenses,leisure,-55.16,-5850.63
buyer_5,Sara,Urkiaga,1994-03-12,44623772T,sara.urkiaga@megaapp.tech,772687,ES92209532362570784285,1506.75,2022-07-25T16:31:10,Plentzia,expenses,cash,-100.0,-5950.63
buyer_5,Sara,Urkiaga,1994-03-12,44623772T,sara.urkiaga@megaapp.tech,772687,ES92209532362570784285,1506.75,2022-07-27T03:57:20,Plentzia,expenses,cash,-100.0,-6050.63
buyer_5,Sara,Urkiaga,1994-03-12,44623772T,sara.urkiaga@megaapp.tech,772687,ES92209532362570784285,1506.75,2022-07-29T16:08:58,Plentzia,expenses,travel,-466.93,-6517.56
buyer_5,Sara,Urkiaga,1994-03-12,44623772T,sara.urkiaga@megaapp.tech,772687,ES92209532362570784285,1506.75,2022-07-29T11:35:07,Plentzia,expenses,repairs,-86.77,-6604.33
buyer_5,Sara,Urkiaga,1994-03-12,44623772T,sara.urkiaga@megaapp.tech,772687,ES92209532362570784285,1506.75,2022-08-01T12:40:37,Plentzia,incomes,salary,2480.08,-4124.25
buyer_5,Sara,Urkiaga,1994-03-12,44623772T,sara.urkiaga@megaapp.tech,772687,ES92209532362570784285,1506.75,2022-08-01T12:40:37,Plentzia,incomes,salary_partner,2219.09,-1905.16
buyer_5,Sara,Urkiaga,1994-03-12,44623772T,sara.urkiaga@megaapp.tech,772687,ES92209532362570784285,1506.75,2022-08-02T21:49:48,Plentzia,expenses,transport,-48.36,-1953.52
buyer_5,Sara,Urkiaga,1994-03-12,44623772T,sara.urkiaga@megaapp.tech,772687,ES92209532362570784285,1506.75,2022-08-02T17:18:38,Plentzia,expenses,leisure,-75.22,-2028.74
buyer_5,Sara,Urkiaga,1994-03-12,44623772T,sara.urkiaga@megaapp.tech,772687,ES92209532362570784285,1506.75,2022-08-02T11:46:46,Plentzia,expenses,clothing,-45.79,-2074.53
buyer_5,Sara,Urkiaga,1994-03-12,44623772T,sara.urkiaga@megaapp.tech,772687,ES92209532362570784285,1506.75,2022-08-02T17:56:19,Plentzia,expenses,healthcare,-92.93,-2167.46
buyer_5,Sara,Urkiaga,1994-03-12,44623772T,sara.urkiaga@megaapp.tech,772687,ES92209532362570784285,1506.75,2022-08-02T09:58:24,Plentzia,expenses,gifts,-303.02,-2470.48
buyer_5,Sara,Urkiaga,1994-03-12,44623772T,sara.urkiaga@megaapp.tech,772687,ES92209532362570784285,1506.75,2022-08-05T11:12:57,Plentzia,expenses,mortgage,-2297.17,-4767.65
buyer_5,Sara,Urkiaga,1994-03-12,44623772T,sara.urkiaga@megaapp.tech,772687,ES92209532362570784285,1506.75,2022-08-05T10:32:10,Plentzia,expenses,gas,-70.51,-4838.16
buyer_5,Sara,Urkiaga,1994-03-12,44623772T,sara.urkiaga@megaapp.tech,772687,ES92209532362570784285,1506.75,2022-08-05T17:29:04,Plentzia,expenses,internet,-98.68,-4936.84
buyer_5,Sara,Urkiaga,1994-03-12,44623772T,sara.urkiaga@megaapp.tech,772687,ES92209532362570784285,1506.75,2022-08-06T10:14:50,Plentzia,expenses,water,-57.33,-4994.17
buyer_5,Sara,Urkiaga,1994-03-12,44623772T,sara.urkiaga@megaapp.tech,772687,ES92209532362570784285,1506.75,2022-08-06T17:29:15,Plentzia,expenses,cash,-100.0,-5094.17
buyer_5,Sara,Urkiaga,1994-03-12,44623772T,sara.urkiaga@megaapp.tech,772687,ES92209532362570784285,1506.75,2022-08-07T09:53:12,Plentzia,expenses,phone,-105.62,-5199.79
buyer_5,Sara,Urkiaga,1994-03-12,44623772T,sara.urkiaga@megaapp.tech,772687,ES92209532362570784285,1506.75,2022-08-08T18:35:31,Plentzia,expenses,food,-79.41,-5279.2
buyer_5,Sara,Urkiaga,1994-03-12,44623772T,sara.urkiaga@megaapp.tech,772687,ES92209532362570784285,1506.75,2022-08-09T08:38:49,Plentzia,expenses,leisure,-81.83,-5361.03
buyer_5,Sara,Urkiaga,1994-03-12,44623772T,sara.urkiaga@megaapp.tech,772687,ES92209532362570784285,1506.75,2022-08-10T15:48:51,Plentzia,expenses,appliances,-325.47,-5686.5
buyer_5,Sara,Urkiaga,1994-03-12,44623772T,sara.urkiaga@megaapp.tech,772687,ES92209532362570784285,1506.75,2022-08-11T08:03:46,Plentzia,expenses,food,-98.22,-5784.72
buyer_5,Sara,Urkiaga,1994-03-12,44623772T,sara.urkiaga@megaapp.tech,772687,ES92209532362570784285,1506.75,2022-08-13T10:55:20,Plentzia,expenses,transport,-58.75,-5843.47
buyer_5,Sara,Urkiaga,1994-03-12,44623772T,sara.urkiaga@megaapp.tech,772687,ES92209532362570784285,1506.75,2022-08-13T22:00:21,Plentzia,expenses,repairs,-244.69,-6088.16
buyer_5,Sara,Urkiaga,1994-03-12,44623772T,sara.urkiaga@megaapp.tech,772687,ES92209532362570784285,1506.75,2022-08-14T04:40:41,Plentzia,expenses,transport,-62.19,-6150.35
buyer_5,Sara,Urkiaga,1994-03-12,44623772T,sara.urkiaga@megaapp.tech,772687,ES92209532362570784285,1506.75,2022-08-14T18:21:57,Plentzia,expenses,education,-74.61,-6224.96
buyer_5,Sara,Urkiaga,1994-03-12,44623772T,sara.urkiaga@megaapp.tech,772687,ES92209532362570784285,1506.75,2022-08-15T20:58:32,Plentzia,expenses,repairs,-40.69,-6265.65
buyer_5,Sara,Urkiaga,1994-03-12,44623772T,sara.urkiaga@megaapp.tech,772687,ES92209532362570784285,1506.75,2022-08-16T06:14:38,Plentzia,expenses,food,-91.67,-6357.32
buyer_5,Sara,Urkiaga,1994-03-12,44623772T,sara.urkiaga@megaapp.tech,772687,ES92209532362570784285,1506.75,2022-08-18T17:51:13,Plentzia,expenses,food,-66.15,-6423.47
buyer_5,Sara,Urkiaga,1994-03-12,44623772T,sara.urkiaga@megaapp.tech,772687,ES92209532362570784285,1506.75,2022-08-19T11:56:01,Plentzia,expenses,appliances,-178.46,-6601.93
buyer_5,Sara,Urkiaga,1994-03-12,44623772T,sara.urkiaga@megaapp.tech,772687,ES92209532362570784285,1506.75,2022-08-20T16:52:22,Plentzia,expenses,gifts,-190.46,-6792.39
buyer_5,Sara,Urkiaga,1994-03-12,44623772T,sara.urkiaga@megaapp.tech,772687,ES92209532362570784285,1506.75,2022-08-24T11:17:38,Plentzia,expenses,leisure,-46.27,-6838.66
buyer_5,Sara,Urkiaga,1994-03-12,44623772T,sara.urkiaga@megaapp.tech,772687,ES92209532362570784285,1506.75,2022-08-26T13:50:40,Plentzia,expenses,transport,-66.81,-6905.47
buyer_5,Sara,Urkiaga,1994-03-12,44623772T,sara.urkiaga@megaapp.tech,772687,ES92209532362570784285,1506.75,2022-08-27T20:55:11,Plentzia,expenses,transport,-45.65,-6951.12
buyer_5,Sara,Urkiaga,1994-03-12,44623772T,sara.urkiaga@megaapp.tech,772687,ES92209532362570784285,1506.75,2022-08-27T14:23:24,Plentzia,expenses,cash,-100.0,-7051.12
buyer_5,Sara,Urkiaga,1994-03-12,44623772T,sara.urkiaga@megaapp.tech,772687,ES92209532362570784285,1506.75,2022-08-31T04:54:13,Plentzia,expenses,food,-92.01,-7143.13
buyer_5,Sara,Urkiaga,1994-03-12,44623772T,sara.urkiaga@megaapp.tech,772687,ES92209532362570784285,1506.75,2022-08-31T14:57:28,Plentzia,expenses,education,-49.27,-7192.4
buyer_5,Sara,Urkiaga,1994-03-12,44623772T,sara.urkiaga@megaapp.tech,772687,ES92209532362570784285,1506.75,2022-08-31T16:45:50,Plentzia,expenses,cash,-100.0,-7292.4
buyer_5,Sara,Urkiaga,1994-03-12,44623772T,sara.urkiaga@megaapp.tech,772687,ES92209532362570784285,1506.75,2022-09-01T14:47:06,Plentzia,incomes,salary,2480.08,-4812.32
buyer_5,Sara,Urkiaga,1994-03-12,44623772T,sara.urkiaga@megaapp.tech,772687,ES92209532362570784285,1506.75,2022-09-01T14:47:06,Plentzia,incomes,salary_partner,2219.09,-2593.23
buyer_5,Sara,Urkiaga,1994-03-12,44623772T,sara.urkiaga@megaapp.tech,772687,ES92209532362570784285,1506.75,2022-09-01T13:08:24,Plentzia,expenses,cash,-100.0,-2693.23
buyer_5,Sara,Urkiaga,1994-03-12,44623772T,sara.urkiaga@megaapp.tech,772687,ES92209532362570784285,1506.75,2022-09-03T19:15:26,Plentzia,expenses,food,-108.44,-2801.67
buyer_5,Sara,Urkiaga,1994-03-12,44623772T,sara.urkiaga@megaapp.tech,772687,ES92209532362570784285,1506.75,2022-09-03T08:51:49,Plentzia,expenses,leisure,-51.66,-2853.33
buyer_5,Sara,Urkiaga,1994-03-12,44623772T,sara.urkiaga@megaapp.tech,772687,ES92209532362570784285,1506.75,2022-09-05T11:03:12,Plentzia,expenses,mortgage,-2297.17,-5150.5
buyer_5,Sara,Urkiaga,1994-03-12,44623772T,sara.urkiaga@megaapp.tech,772687,ES92209532362570784285,1506.75,2022-09-06T13:48:26,Plentzia,expenses,cash,-100.0,-5250.5
buyer_5,Sara,Urkiaga,1994-03-12,44623772T,sara.urkiaga@megaapp.tech,772687,ES92209532362570784285,1506.75,2022-09-07T10:56:46,Plentzia,expenses,water,-82.8,-5333.3
buyer_5,Sara,Urkiaga,1994-03-12,44623772T,sara.urkiaga@megaapp.tech,772687,ES92209532362570784285,1506.75,2022-09-07T00:50:12,Plentzia,expenses,food,-73.95,-5407.25
buyer_5,Sara,Urkiaga,1994-03-12,44623772T,sara.urkiaga@megaapp.tech,772687,ES92209532362570784285,1506.75,2022-09-08T10:47:18,Plentzia,expenses,gas,-170.42,-5577.67
buyer_5,Sara,Urkiaga,1994-03-12,44623772T,sara.urkiaga@megaapp.tech,772687,ES92209532362570784285,1506.75,2022-09-09T15:00:40,Plentzia,expenses,repairs,-78.2,-5655.87
buyer_5,Sara,Urkiaga,1994-03-12,44623772T,sara.urkiaga@megaapp.tech,772687,ES92209532362570784285,1506.75,2022-09-10T16:03:57,Plentzia,expenses,repairs,-83.32,-5739.19
buyer_5,Sara,Urkiaga,1994-03-12,44623772T,sara.urkiaga@megaapp.tech,772687,ES92209532362570784285,1506.75,2022-09-13T15:31:42,Plentzia,expenses,cash,-100.0,-5839.19
buyer_5,Sara,Urkiaga,1994-03-12,44623772T,sara.urkiaga@megaapp.tech,772687,ES92209532362570784285,1506.75,2022-09-14T16:05:47,Plentzia,expenses,cash,-100.0,-5939.19
buyer_5,Sara,Urkiaga,1994-03-12,44623772T,sara.urkiaga@megaapp.tech,772687,ES92209532362570784285,1506.75,2022-09-17T14:20:01,Plentzia,expenses,clothing,-127.75,-6066.94
buyer_5,Sara,Urkiaga,1994-03-12,44623772T,sara.urkiaga@megaapp.tech,772687,ES92209532362570784285,1506.75,2022-09-17T09:56:23,Plentzia,expenses,repairs,-135.07,-6202.01
buyer_5,Sara,Urkiaga,1994-03-12,44623772T,sara.urkiaga@megaapp.tech,772687,ES92209532362570784285,1506.75,2022-09-18T17:45:52,Plentzia,expenses,cash,-100.0,-6302.01
buyer_5,Sara,Urkiaga,1994-03-12,44623772T,sara.urkiaga@megaapp.tech,772687,ES92209532362570784285,1506.75,2022-09-18T20:03:33,Plentzia,expenses,repairs,-231.57,-6533.58
buyer_5,Sara,Urkiaga,1994-03-12,44623772T,sara.urkiaga@megaapp.tech,772687,ES92209532362570784285,1506.75,2022-09-19T16:51:44,Plentzia,expenses,education,-43.3,-6576.88
buyer_5,Sara,Urkiaga,1994-03-12,44623772T,sara.urkiaga@megaapp.tech,772687,ES92209532362570784285,1506.75,2022-09-20T19:26:04,Plentzia,expenses,food,-108.34,-6685.22
buyer_5,Sara,Urkiaga,1994-03-12,44623772T,sara.urkiaga@megaapp.tech,772687,ES92209532362570784285,1506.75,2022-09-20T09:57:37,Plentzia,expenses,leisure,-66.76,-6751.98
buyer_5,Sara,Urkiaga,1994-03-12,44623772T,sara.urkiaga@megaapp.tech,772687,ES92209532362570784285,1506.75,2022-09-22T23:31:48,Plentzia,expenses,leisure,-74.53,-6826.51
buyer_5,Sara,Urkiaga,1994-03-12,44623772T,sara.urkiaga@megaapp.tech,772687,ES92209532362570784285,1506.75,2022-09-22T11:38:08,Plentzia,expenses,gifts,-443.66,-7270.17
buyer_5,Sara,Urkiaga,1994-03-12,44623772T,sara.urkiaga@megaapp.tech,772687,ES92209532362570784285,1506.75,2022-09-23T09:58:35,Plentzia,expenses,transport,-83.51,-7353.68
buyer_5,Sara,Urkiaga,1994-03-12,44623772T,sara.urkiaga@megaapp.tech,772687,ES92209532362570784285,1506.75,2022-09-25T11:50:28,Plentzia,expenses,cash,-100.0,-7453.68
buyer_5,Sara,Urkiaga,1994-03-12,44623772T,sara.urkiaga@megaapp.tech,772687,ES92209532362570784285,1506.75,2022-09-27T12:56:55,Plentzia,expenses,repairs,-108.09,-7561.77
buyer_5,Sara,Urkiaga,1994-03-12,44623772T,sara.urkiaga@megaapp.tech,772687,ES92209532362570784285,1506.75,2022-09-28T11:12:42,Plentzia,expenses,food,-97.8,-7659.57
buyer_5,Sara,Urkiaga,1994-03-12,44623772T,sara.urkiaga@megaapp.tech,772687,ES92209532362570784285,1506.75,2022-09-30T20:53:42,Plentzia,expenses,cash,-100.0,-7759.57
buyer_5,Sara,Urkiaga,1994-03-12,44623772T,sara.urkiaga@megaapp.tech,772687,ES92209532362570784285,1506.75,2022-10-01T12:20:48,Plentzia,incomes,salary,2480.08,-5279.49
buyer_5,Sara,Urkiaga,1994-03-12,44623772T,sara.urkiaga@megaapp.tech,772687,ES92209532362570784285,1506.75,2022-10-01T12:20:48,Plentzia,incomes,salary_partner,2219.09,-3060.4
buyer_5,Sara,Urkiaga,1994-03-12,44623772T,sara.urkiaga@megaapp.tech,772687,ES92209532362570784285,1506.75,2022-10-01T12:20:48,Plentzia,incomes,extra_income,471.47,-2588.93
buyer_5,Sara,Urkiaga,1994-03-12,44623772T,sara.urkiaga@megaapp.tech,772687,ES92209532362570784285,1506.75,2022-10-02T08:57:14,Plentzia,expenses,repairs,-223.03,-2811.96
buyer_5,Sara,Urkiaga,1994-03-12,44623772T,sara.urkiaga@megaapp.tech,772687,ES92209532362570784285,1506.75,2022-10-04T20:05:12,Plentzia,expenses,leisure,-37.69,-2849.65
buyer_5,Sara,Urkiaga,1994-03-12,44623772T,sara.urkiaga@megaapp.tech,772687,ES92209532362570784285,1506.75,2022-10-05T06:23:40,Plentzia,expenses,mortgage,-2297.17,-5146.82
buyer_5,Sara,Urkiaga,1994-03-12,44623772T,sara.urkiaga@megaapp.tech,772687,ES92209532362570784285,1506.75,2022-10-05T20:52:45,Plentzia,expenses,water,-76.54,-5223.36
buyer_5,Sara,Urkiaga,1994-03-12,44623772T,sara.urkiaga@megaapp.tech,772687,ES92209532362570784285,1506.75,2022-10-05T11:57:00,Plentzia,expenses,leisure,-39.31,-5262.67
buyer_5,Sara,Urkiaga,1994-03-12,44623772T,sara.urkiaga@megaapp.tech,772687,ES92209532362570784285,1506.75,2022-10-06T19:46:00,Plentzia,expenses,gas,-112.75,-5375.42
buyer_5,Sara,Urkiaga,1994-03-12,44623772T,sara.urkiaga@megaapp.tech,772687,ES92209532362570784285,1506.75,2022-10-06T11:05:26,Plentzia,expenses,food,-101.57,-5476.99
buyer_5,Sara,Urkiaga,1994-03-12,44623772T,sara.urkiaga@megaapp.tech,772687,ES92209532362570784285,1506.75,2022-10-07T09:13:30,Plentzia,expenses,leisure,-41.86,-5518.85
buyer_5,Sara,Urkiaga,1994-03-12,44623772T,sara.urkiaga@megaapp.tech,772687,ES92209532362570784285,1506.75,2022-10-07T19:49:12,Plentzia,expenses,education,-43.54,-5562.39
buyer_5,Sara,Urkiaga,1994-03-12,44623772T,sara.urkiaga@megaapp.tech,772687,ES92209532362570784285,1506.75,2022-10-09T21:03:21,Plentzia,expenses,food,-72.29,-5634.68
buyer_5,Sara,Urkiaga,1994-03-12,44623772T,sara.urkiaga@megaapp.tech,772687,ES92209532362570784285,1506.75,2022-10-09T18:31:58,Plentzia,expenses,leisure,-83.14,-5717.82
buyer_5,Sara,Urkiaga,1994-03-12,44623772T,sara.urkiaga@megaapp.tech,772687,ES92209532362570784285,1506.75,2022-10-09T08:04:21,Plentzia,expenses,cash,-100.0,-5817.82
buyer_5,Sara,Urkiaga,1994-03-12,44623772T,sara.urkiaga@megaapp.tech,772687,ES92209532362570784285,1506.75,2022-10-10T02:17:32,Plentzia,expenses,cash,-100.0,-5917.82
buyer_5,Sara,Urkiaga,1994-03-12,44623772T,sara.urkiaga@megaapp.tech,772687,ES92209532362570784285,1506.75,2022-10-11T18:35:42,Plentzia,expenses,transport,-62.93,-5980.75
buyer_5,Sara,Urkiaga,1994-03-12,44623772T,sara.urkiaga@megaapp.tech,772687,ES92209532362570784285,1506.75,2022-10-13T20:18:57,Plentzia,expenses,transport,-70.45,-6051.2
buyer_5,Sara,Urkiaga,1994-03-12,44623772T,sara.urkiaga@megaapp.tech,772687,ES92209532362570784285,1506.75,2022-10-13T11:11:33,Plentzia,expenses,cash,-100.0,-6151.2
buyer_5,Sara,Urkiaga,1994-03-12,44623772T,sara.urkiaga@megaapp.tech,772687,ES92209532362570784285,1506.75,2022-10-14T09:40:24,Plentzia,expenses,cash,-100.0,-6251.2
buyer_5,Sara,Urkiaga,1994-03-12,44623772T,sara.urkiaga@megaapp.tech,772687,ES92209532362570784285,1506.75,2022-10-15T09:31:03,Plentzia,expenses,healthcare,-45.97,-6297.17
buyer_5,Sara,Urkiaga,1994-03-12,44623772T,sara.urkiaga@megaapp.tech,772687,ES92209532362570784285,1506.75,2022-10-16T15:52:20,Plentzia,expenses,food,-70.65,-6367.82
buyer_5,Sara,Urkiaga,1994-03-12,44623772T,sara.urkiaga@megaapp.tech,772687,ES92209532362570784285,1506.75,2022-10-16T15:48:05,Plentzia,expenses,healthcare,-165.57,-6533.39
buyer_5,Sara,Urkiaga,1994-03-12,44623772T,sara.urkiaga@megaapp.tech,772687,ES92209532362570784285,1506.75,2022-10-16T17:38:50,Plentzia,expenses,cash,-100.0,-6633.39
buyer_5,Sara,Urkiaga,1994-03-12,44623772T,sara.urkiaga@megaapp.tech,772687,ES92209532362570784285,1506.75,2022-10-17T22:11:54,Plentzia,expenses,cash,-100.0,-6733.39
buyer_5,Sara,Urkiaga,1994-03-12,44623772T,sara.urkiaga@megaapp.tech,772687,ES92209532362570784285,1506.75,2022-10-21T11:52:21,Plentzia,expenses,food,-69.0,-6802.39
buyer_5,Sara,Urkiaga,1994-03-12,44623772T,sara.urkiaga@megaapp.tech,772687,ES92209532362570784285,1506.75,2022-10-23T22:57:32,Plentzia,expenses,gifts,-473.04,-7275.43
buyer_5,Sara,Urkiaga,1994-03-12,44623772T,sara.urkiaga@megaapp.tech,772687,ES92209532362570784285,1506.75,2022-10-24T11:34:15,Plentzia,expenses,leisure,-47.88,-7323.31
buyer_5,Sara,Urkiaga,1994-03-12,44623772T,sara.urkiaga@megaapp.tech,772687,ES92209532362570784285,1506.75,2022-10-24T17:54:36,Plentzia,expenses,cash,-100.0,-7423.31
buyer_5,Sara,Urkiaga,1994-03-12,44623772T,sara.urkiaga@megaapp.tech,772687,ES92209532362570784285,1506.75,2022-10-26T22:22:23,Plentzia,expenses,healthcare,-87.36,-7510.67
buyer_5,Sara,Urkiaga,1994-03-12,44623772T,sara.urkiaga@megaapp.tech,772687,ES92209532362570784285,1506.75,2022-10-26T21:55:56,Plentzia,expenses,cash,-100.0,-7610.67
buyer_5,Sara,Urkiaga,1994-03-12,44623772T,sara.urkiaga@megaapp.tech,772687,ES92209532362570784285,1506.75,2022-10-27T20:24:10,Plentzia,expenses,repairs,-65.5,-7676.17
buyer_5,Sara,Urkiaga,1994-03-12,44623772T,sara.urkiaga@megaapp.tech,772687,ES92209532362570784285,1506.75,2022-10-28T11:13:39,Plentzia,expenses,education,-75.23,-7751.4
buyer_5,Sara,Urkiaga,1994-03-12,44623772T,sara.urkiaga@megaapp.tech,772687,ES92209532362570784285,1506.75,2022-10-29T17:33:22,Plentzia,expenses,leisure,-80.03,-7831.43
buyer_5,Sara,Urkiaga,1994-03-12,44623772T,sara.urkiaga@megaapp.tech,772687,ES92209532362570784285,1506.75,2022-10-30T16:51:43,Plentzia,expenses,clothing,-117.12,-7948.55
buyer_5,Sara,Urkiaga,1994-03-12,44623772T,sara.urkiaga@megaapp.tech,772687,ES92209532362570784285,1506.75,2022-11-01T18:45:39,Plentzia,incomes,salary,2480.08,-5468.47
buyer_5,Sara,Urkiaga,1994-03-12,44623772T,sara.urkiaga@megaapp.tech,772687,ES92209532362570784285,1506.75,2022-11-01T18:45:39,Plentzia,incomes,salary_partner,2219.09,-3249.38
buyer_5,Sara,Urkiaga,1994-03-12,44623772T,sara.urkiaga@megaapp.tech,772687,ES92209532362570784285,1506.75,2022-11-01T09:36:37,Plentzia,expenses,cash,-100.0,-3349.38
buyer_5,Sara,Urkiaga,1994-03-12,44623772T,sara.urkiaga@megaapp.tech,772687,ES92209532362570784285,1506.75,2022-11-02T19:24:45,Plentzia,expenses,leisure,-74.46,-3423.84
buyer_5,Sara,Urkiaga,1994-03-12,44623772T,sara.urkiaga@megaapp.tech,772687,ES92209532362570784285,1506.75,2022-11-04T15:11:50,Plentzia,expenses,clothing,-120.78,-3544.62
buyer_5,Sara,Urkiaga,1994-03-12,44623772T,sara.urkiaga@megaapp.tech,772687,ES92209532362570784285,1506.75,2022-11-04T17:39:41,Plentzia,expenses,education,-78.92,-3623.54
buyer_5,Sara,Urkiaga,1994-03-12,44623772T,sara.urkiaga@megaapp.tech,772687,ES92209532362570784285,1506.75,2022-11-05T13:27:40,Plentzia,expenses,mortgage,-2297.17,-5920.71
buyer_5,Sara,Urkiaga,1994-03-12,44623772T,sara.urkiaga@megaapp.tech,772687,ES92209532362570784285,1506.75,2022-11-05T09:48:22,Plentzia,expenses,internet,-98.68,-6019.39
buyer_5,Sara,Urkiaga,1994-03-12,44623772T,sara.urkiaga@megaapp.tech,772687,ES92209532362570784285,1506.75,2022-11-05T11:04:04,Plentzia,expenses,repairs,-124.75,-6144.14
buyer_5,Sara,Urkiaga,1994-03-12,44623772T,sara.urkiaga@megaapp.tech,772687,ES92209532362570784285,1506.75,2022-11-05T19:37:11,Plentzia,expenses,gifts,-530.13,-6674.27
buyer_5,Sara,Urkiaga,1994-03-12,44623772T,sara.urkiaga@megaapp.tech,772687,ES92209532362570784285,1506.75,2022-11-06T23:26:38,Plentzia,expenses,leisure,-23.48,-6697.75
buyer_5,Sara,Urkiaga,1994-03-12,44623772T,sara.urkiaga@megaapp.tech,772687,ES92209532362570784285,1506.75,2022-11-06T21:44:58,Plentzia,expenses,repairs,-220.92,-6918.67
buyer_5,Sara,Urkiaga,1994-03-12,44623772T,sara.urkiaga@megaapp.tech,772687,ES92209532362570784285,1506.75,2022-11-07T15:44:50,Plentzia,expenses,water,-87.78,-7006.45
buyer_5,Sara,Urkiaga,1994-03-12,44623772T,sara.urkiaga@megaapp.tech,772687,ES92209532362570784285,1506.75,2022-11-07T19:23:14,Plentzia,expenses,gas,-228.06,-7234.51
buyer_5,Sara,Urkiaga,1994-03-12,44623772T,sara.urkiaga@megaapp.tech,772687,ES92209532362570784285,1506.75,2022-11-07T23:27:13,Plentzia,expenses,food,-123.18,-7357.69
buyer_5,Sara,Urkiaga,1994-03-12,44623772T,sara.urkiaga@megaapp.tech,772687,ES92209532362570784285,1506.75,2022-11-09T00:59:33,Plentzia,expenses,cash,-100.0,-7457.69
buyer_5,Sara,Urkiaga,1994-03-12,44623772T,sara.urkiaga@megaapp.tech,772687,ES92209532362570784285,1506.75,2022-11-09T16:49:29,Plentzia,expenses,gifts,-150.3,-7607.99
buyer_5,Sara,Urkiaga,1994-03-12,44623772T,sara.urkiaga@megaapp.tech,772687,ES92209532362570784285,1506.75,2022-11-10T18:20:21,Plentzia,expenses,leisure,-42.4,-7650.39
buyer_5,Sara,Urkiaga,1994-03-12,44623772T,sara.urkiaga@megaapp.tech,772687,ES92209532362570784285,1506.75,2022-11-11T10:28:28,Plentzia,expenses,leisure,-67.75,-7718.14
buyer_5,Sara,Urkiaga,1994-03-12,44623772T,sara.urkiaga@megaapp.tech,772687,ES92209532362570784285,1506.75,2022-11-13T19:25:22,Plentzia,expenses,gifts,-82.68,-7800.82
buyer_5,Sara,Urkiaga,1994-03-12,44623772T,sara.urkiaga@megaapp.tech,772687,ES92209532362570784285,1506.75,2022-11-14T00:36:00,Plentzia,expenses,transport,-76.63,-7877.45
buyer_5,Sara,Urkiaga,1994-03-12,44623772T,sara.urkiaga@megaapp.tech,772687,ES92209532362570784285,1506.75,2022-11-16T08:16:51,Plentzia,expenses,leisure,-37.97,-7915.42
buyer_5,Sara,Urkiaga,1994-03-12,44623772T,sara.urkiaga@megaapp.tech,772687,ES92209532362570784285,1506.75,2022-11-16T13:43:09,Plentzia,expenses,cash,-100.0,-8015.42
buyer_5,Sara,Urkiaga,1994-03-12,44623772T,sara.urkiaga@megaapp.tech,772687,ES92209532362570784285,1506.75,2022-11-17T13:13:50,Plentzia,expenses,food,-118.3,-8133.72
buyer_5,Sara,Urkiaga,1994-03-12,44623772T,sara.urkiaga@megaapp.tech,772687,ES92209532362570784285,1506.75,2022-11-18T10:39:18,Plentzia,expenses,repairs,-147.28,-8281.0
buyer_5,Sara,Urkiaga,1994-03-12,44623772T,sara.urkiaga@megaapp.tech,772687,ES92209532362570784285,1506.75,2022-11-20T18:43:09,Plentzia,expenses,leisure,-22.98,-8303.98
buyer_5,Sara,Urkiaga,1994-03-12,44623772T,sara.urkiaga@megaapp.tech,772687,ES92209532362570784285,1506.75,2022-11-20T17:01:28,Plentzia,expenses,education,-54.51,-8358.49
buyer_5,Sara,Urkiaga,1994-03-12,44623772T,sara.urkiaga@megaapp.tech,772687,ES92209532362570784285,1506.75,2022-11-21T22:05:21,Plentzia,expenses,transport,-42.75,-8401.24
buyer_5,Sara,Urkiaga,1994-03-12,44623772T,sara.urkiaga@megaapp.tech,772687,ES92209532362570784285,1506.75,2022-11-22T19:07:24,Plentzia,expenses,food,-113.01,-8514.25
buyer_5,Sara,Urkiaga,1994-03-12,44623772T,sara.urkiaga@megaapp.tech,772687,ES92209532362570784285,1506.75,2022-11-24T22:42:57,Plentzia,expenses,repairs,-102.08,-8616.33
buyer_5,Sara,Urkiaga,1994-03-12,44623772T,sara.urkiaga@megaapp.tech,772687,ES92209532362570784285,1506.75,2022-11-26T16:09:05,Plentzia,expenses,leisure,-47.61,-8663.94
buyer_5,Sara,Urkiaga,1994-03-12,44623772T,sara.urkiaga@megaapp.tech,772687,ES92209532362570784285,1506.75,2022-11-26T23:15:56,Plentzia,expenses,cash,-100.0,-8763.94
buyer_5,Sara,Urkiaga,1994-03-12,44623772T,sara.urkiaga@megaapp.tech,772687,ES92209532362570784285,1506.75,2022-11-28T11:37:51,Plentzia,expenses,appliances,-90.65,-8854.59
buyer_5,Sara,Urkiaga,1994-03-12,44623772T,sara.urkiaga@megaapp.tech,772687,ES92209532362570784285,1506.75,2022-11-29T02:14:17,Plentzia,expenses,leisure,-46.42,-8901.01
buyer_5,Sara,Urkiaga,1994-03-12,44623772T,sara.urkiaga@megaapp.tech,772687,ES92209532362570784285,1506.75,2022-11-29T16:47:55,Plentzia,expenses,repairs,-39.51,-8940.52
buyer_5,Sara,Urkiaga,1994-03-12,44623772T,sara.urkiaga@megaapp.tech,772687,ES92209532362570784285,1506.75,2022-11-30T14:58:36,Plentzia,expenses,gifts,-224.04,-9164.56
buyer_5,Sara,Urkiaga,1994-03-12,44623772T,sara.urkiaga@megaapp.tech,772687,ES92209532362570784285,1506.75,2022-12-01T13:15:19,Plentzia,incomes,salary,2480.08,-6684.48
buyer_5,Sara,Urkiaga,1994-03-12,44623772T,sara.urkiaga@megaapp.tech,772687,ES92209532362570784285,1506.75,2022-12-01T13:15:19,Plentzia,incomes,salary_partner,2219.09,-4465.39
buyer_5,Sara,Urkiaga,1994-03-12,44623772T,sara.urkiaga@megaapp.tech,772687,ES92209532362570784285,1506.75,2022-12-01T13:15:19,Plentzia,incomes,salary_bonus,1982.79,-2482.6
buyer_5,Sara,Urkiaga,1994-03-12,44623772T,sara.urkiaga@megaapp.tech,772687,ES92209532362570784285,1506.75,2022-12-01T13:15:19,Plentzia,incomes,salary_partner_bonus,1620.74,-861.86
buyer_5,Sara,Urkiaga,1994-03-12,44623772T,sara.urkiaga@megaapp.tech,772687,ES92209532362570784285,1506.75,2022-12-01T11:05:54,Plentzia,expenses,repairs,-331.71,-1193.57
buyer_5,Sara,Urkiaga,1994-03-12,44623772T,sara.urkiaga@megaapp.tech,772687,ES92209532362570784285,1506.75,2022-12-03T14:52:45,Plentzia,expenses,food,-79.11,-1272.68
buyer_5,Sara,Urkiaga,1994-03-12,44623772T,sara.urkiaga@megaapp.tech,772687,ES92209532362570784285,1506.75,2022-12-05T15:21:45,Plentzia,expenses,mortgage,-2297.17,-3569.85
buyer_5,Sara,Urkiaga,1994-03-12,44623772T,sara.urkiaga@megaapp.tech,772687,ES92209532362570784285,1506.75,2022-12-05T13:25:33,Plentzia,expenses,transport,-55.67,-3625.52
buyer_5,Sara,Urkiaga,1994-03-12,44623772T,sara.urkiaga@megaapp.tech,772687,ES92209532362570784285,1506.75,2022-12-05T10:58:17,Plentzia,expenses,gifts,-532.17,-4157.69
buyer_5,Sara,Urkiaga,1994-03-12,44623772T,sara.urkiaga@megaapp.tech,772687,ES92209532362570784285,1506.75,2022-12-06T11:04:34,Plentzia,expenses,internet,-98.68,-4256.37
buyer_5,Sara,Urkiaga,1994-03-12,44623772T,sara.urkiaga@megaapp.tech,772687,ES92209532362570784285,1506.75,2022-12-06T17:40:32,Plentzia,expenses,phone,-75.37,-4331.74
buyer_5,Sara,Urkiaga,1994-03-12,44623772T,sara.urkiaga@megaapp.tech,772687,ES92209532362570784285,1506.75,2022-12-08T08:31:06,Plentzia,expenses,electricity,-173.1,-4504.84
buyer_5,Sara,Urkiaga,1994-03-12,44623772T,sara.urkiaga@megaapp.tech,772687,ES92209532362570784285,1506.75,2022-12-10T09:27:48,Plentzia,expenses,clothing,-137.39,-4642.23
buyer_5,Sara,Urkiaga,1994-03-12,44623772T,sara.urkiaga@megaapp.tech,772687,ES92209532362570784285,1506.75,2022-12-12T13:30:52,Plentzia,expenses,cash,-100.0,-4742.23
buyer_5,Sara,Urkiaga,1994-03-12,44623772T,sara.urkiaga@megaapp.tech,772687,ES92209532362570784285,1506.75,2022-12-13T22:11:58,Plentzia,expenses,appliances,-407.29,-5149.52
buyer_5,Sara,Urkiaga,1994-03-12,44623772T,sara.urkiaga@megaapp.tech,772687,ES92209532362570784285,1506.75,2022-12-14T15:16:26,Plentzia,expenses,transport,-50.1,-5199.62
buyer_5,Sara,Urkiaga,1994-03-12,44623772T,sara.urkiaga@megaapp.tech,772687,ES92209532362570784285,1506.75,2022-12-15T14:21:22,Plentzia,expenses,education,-63.34,-5262.96
buyer_5,Sara,Urkiaga,1994-03-12,44623772T,sara.urkiaga@megaapp.tech,772687,ES92209532362570784285,1506.75,2022-12-16T17:04:48,Plentzia,expenses,appliances,-412.51,-5675.47
buyer_5,Sara,Urkiaga,1994-03-12,44623772T,sara.urkiaga@megaapp.tech,772687,ES92209532362570784285,1506.75,2022-12-17T12:16:26,Plentzia,expenses,food,-118.79,-5794.26
buyer_5,Sara,Urkiaga,1994-03-12,44623772T,sara.urkiaga@megaapp.tech,772687,ES92209532362570784285,1506.75,2022-12-17T17:17:53,Plentzia,expenses,leisure,-26.78,-5821.04
buyer_5,Sara,Urkiaga,1994-03-12,44623772T,sara.urkiaga@megaapp.tech,772687,ES92209532362570784285,1506.75,2022-12-17T20:15:50,Plentzia,expenses,education,-46.57,-5867.61
buyer_5,Sara,Urkiaga,1994-03-12,44623772T,sara.urkiaga@megaapp.tech,772687,ES92209532362570784285,1506.75,2022-12-18T08:39:16,Plentzia,expenses,transport,-49.57,-5917.18
buyer_5,Sara,Urkiaga,1994-03-12,44623772T,sara.urkiaga@megaapp.tech,772687,ES92209532362570784285,1506.75,2022-12-19T08:32:43,Plentzia,expenses,food,-116.63,-6033.81
buyer_5,Sara,Urkiaga,1994-03-12,44623772T,sara.urkiaga@megaapp.tech,772687,ES92209532362570784285,1506.75,2022-12-20T16:34:17,Plentzia,expenses,cash,-100.0,-6133.81
buyer_5,Sara,Urkiaga,1994-03-12,44623772T,sara.urkiaga@megaapp.tech,772687,ES92209532362570784285,1506.75,2022-12-21T19:59:23,Plentzia,expenses,education,-61.46,-6195.27
buyer_5,Sara,Urkiaga,1994-03-12,44623772T,sara.urkiaga@megaapp.tech,772687,ES92209532362570784285,1506.75,2022-12-21T20:06:08,Plentzia,expenses,cash,-100.0,-6295.27
buyer_5,Sara,Urkiaga,1994-03-12,44623772T,sara.urkiaga@megaapp.tech,772687,ES92209532362570784285,1506.75,2022-12-22T10:09:02,Plentzia,expenses,food,-118.46,-6413.73
buyer_5,Sara,Urkiaga,1994-03-12,44623772T,sara.urkiaga@megaapp.tech,772687,ES92209532362570784285,1506.75,2022-12-23T11:26:41,Plentzia,expenses,cash,-100.0,-6513.73
buyer_5,Sara,Urkiaga,1994-03-12,44623772T,sara.urkiaga@megaapp.tech,772687,ES92209532362570784285,1506.75,2022-12-24T10:35:56,Plentzia,expenses,cash,-100.0,-6613.73
buyer_5,Sara,Urkiaga,1994-03-12,44623772T,sara.urkiaga@megaapp.tech,772687,ES92209532362570784285,1506.75,2022-12-25T10:24:25,Plentzia,expenses,food,-111.53,-6725.26
buyer_5,Sara,Urkiaga,1994-03-12,44623772T,sara.urkiaga@megaapp.tech,772687,ES92209532362570784285,1506.75,2022-12-25T12:16:44,Plentzia,expenses,leisure,-68.42,-6793.68
buyer_5,Sara,Urkiaga,1994-03-12,44623772T,sara.urkiaga@megaapp.tech,772687,ES92209532362570784285,1506.75,2022-12-26T09:03:14,Plentzia,expenses,leisure,-56.88,-6850.56
buyer_5,Sara,Urkiaga,1994-03-12,44623772T,sara.urkiaga@megaapp.tech,772687,ES92209532362570784285,1506.75,2022-12-27T23:17:15,Plentzia,expenses,food,-101.09,-6951.65
buyer_5,Sara,Urkiaga,1994-03-12,44623772T,sara.urkiaga@megaapp.tech,772687,ES92209532362570784285,1506.75,2022-12-29T00:51:29,Plentzia,expenses,leisure,-56.64,-7008.29
buyer_5,Sara,Urkiaga,1994-03-12,44623772T,sara.urkiaga@megaapp.tech,772687,ES92209532362570784285,1506.75,2022-12-29T16:16:22,Plentzia,expenses,healthcare,-75.99,-7084.28
buyer_5,Sara,Urkiaga,1994-03-12,44623772T,sara.urkiaga@megaapp.tech,772687,ES92209532362570784285,1506.75,2022-12-29T12:36:32,Plentzia,expenses,cash,-100.0,-7184.28
buyer_5,Sara,Urkiaga,1994-03-12,44623772T,sara.urkiaga@megaapp.tech,772687,ES92209532362570784285,1506.75,2022-12-30T14:21:31,Plentzia,expenses,appliances,-357.34,-7541.62
buyer_5,Sara,Urkiaga,1994-03-12,44623772T,sara.urkiaga@megaapp.tech,772687,ES92209532362570784285,1506.75,2022-12-31T12:27:33,Plentzia,expenses,cash,-100.0,-7641.62
buyer_5,Sara,Urkiaga,1994-03-12,44623772T,sara.urkiaga@megaapp.tech,772687,ES92209532362570784285,1506.75,2023-01-01T20:34:05,Plentzia,incomes,salary,2570.6,-5071.02
buyer_5,Sara,Urkiaga,1994-03-12,44623772T,sara.urkiaga@megaapp.tech,772687,ES92209532362570784285,1506.75,2023-01-01T20:34:05,Plentzia,incomes,salary_partner,2300.08,-2770.94
buyer_5,Sara,Urkiaga,1994-03-12,44623772T,sara.urkiaga@megaapp.tech,772687,ES92209532362570784285,1506.75,2023-01-01T20:34:05,Plentzia,incomes,extra_income,471.47,-2299.47
buyer_5,Sara,Urkiaga,1994-03-12,44623772T,sara.urkiaga@megaapp.tech,772687,ES92209532362570784285,1506.75,2023-01-01T11:40:34,Plentzia,expenses,food,-74.63,-2374.1
buyer_5,Sara,Urkiaga,1994-03-12,44623772T,sara.urkiaga@megaapp.tech,772687,ES92209532362570784285,1506.75,2023-01-02T12:17:14,Plentzia,expenses,food,-124.71,-2498.81
buyer_5,Sara,Urkiaga,1994-03-12,44623772T,sara.urkiaga@megaapp.tech,772687,ES92209532362570784285,1506.75,2023-01-05T14:32:50,Plentzia,expenses,mortgage,-1951.2,-4450.01
buyer_5,Sara,Urkiaga,1994-03-12,44623772T,sara.urkiaga@megaapp.tech,772687,ES92209532362570784285,1506.75,2023-01-05T05:25:53,Plentzia,expenses,electricity,-200.82,-4650.83
buyer_5,Sara,Urkiaga,1994-03-12,44623772T,sara.urkiaga@megaapp.tech,772687,ES92209532362570784285,1506.75,2023-01-05T03:36:20,Plentzia,expenses,phone,-95.44,-4746.27
buyer_5,Sara,Urkiaga,1994-03-12,44623772T,sara.urkiaga@megaapp.tech,772687,ES92209532362570784285,1506.75,2023-01-06T14:47:02,Plentzia,expenses,electricity,-128.67,-4874.94
buyer_5,Sara,Urkiaga,1994-03-12,44623772T,sara.urkiaga@megaapp.tech,772687,ES92209532362570784285,1506.75,2023-01-07T11:23:04,Plentzia,expenses,gas,-134.78,-5009.72
buyer_5,Sara,Urkiaga,1994-03-12,44623772T,sara.urkiaga@megaapp.tech,772687,ES92209532362570784285,1506.75,2023-01-08T14:18:14,Plentzia,expenses,electricity,-141.56,-5151.28
buyer_5,Sara,Urkiaga,1994-03-12,44623772T,sara.urkiaga@megaapp.tech,772687,ES92209532362570784285,1506.75,2023-01-08T16:27:03,Plentzia,expenses,food,-83.0,-5234.28
buyer_5,Sara,Urkiaga,1994-03-12,44623772T,sara.urkiaga@megaapp.tech,772687,ES92209532362570784285,1506.75,2023-01-08T12:43:30,Plentzia,expenses,transport,-87.81,-5322.09
buyer_5,Sara,Urkiaga,1994-03-12,44623772T,sara.urkiaga@megaapp.tech,772687,ES92209532362570784285,1506.75,2023-01-10T16:04:18,Plentzia,expenses,cash,-100.0,-5422.09
buyer_5,Sara,Urkiaga,1994-03-12,44623772T,sara.urkiaga@megaapp.tech,772687,ES92209532362570784285,1506.75,2023-01-11T13:32:50,Plentzia,expenses,travel,-615.38,-6037.47
buyer_5,Sara,Urkiaga,1994-03-12,44623772T,sara.urkiaga@megaapp.tech,772687,ES92209532362570784285,1506.75,2023-01-12T09:48:05,Plentzia,expenses,food,-97.64,-6135.11
buyer_5,Sara,Urkiaga,1994-03-12,44623772T,sara.urkiaga@megaapp.tech,772687,ES92209532362570784285,1506.75,2023-01-13T16:51:38,Plentzia,expenses,leisure,-41.7,-6176.81
buyer_5,Sara,Urkiaga,1994-03-12,44623772T,sara.urkiaga@megaapp.tech,772687,ES92209532362570784285,1506.75,2023-01-16T19:09:30,Plentzia,expenses,gifts,-675.16,-6851.97
buyer_5,Sara,Urkiaga,1994-03-12,44623772T,sara.urkiaga@megaapp.tech,772687,ES92209532362570784285,1506.75,2023-01-18T17:13:19,Plentzia,expenses,cash,-100.0,-6951.97
buyer_5,Sara,Urkiaga,1994-03-12,44623772T,sara.urkiaga@megaapp.tech,772687,ES92209532362570784285,1506.75,2023-01-19T12:47:24,Plentzia,expenses,transport,-49.04,-7001.01
buyer_5,Sara,Urkiaga,1994-03-12,44623772T,sara.urkiaga@megaapp.tech,772687,ES92209532362570784285,1506.75,2023-01-19T14:43:13,Plentzia,expenses,leisure,-71.1,-7072.11
buyer_5,Sara,Urkiaga,1994-03-12,44623772T,sara.urkiaga@megaapp.tech,772687,ES92209532362570784285,1506.75,2023-01-19T20:10:48,Plentzia,expenses,gifts,-749.68,-7821.79
buyer_5,Sara,Urkiaga,1994-03-12,44623772T,sara.urkiaga@megaapp.tech,772687,ES92209532362570784285,1506.75,2023-01-21T15:04:29,Plentzia,expenses,food,-113.73,-7935.52
buyer_5,Sara,Urkiaga,1994-03-12,44623772T,sara.urkiaga@megaapp.tech,772687,ES92209532362570784285,1506.75,2023-01-21T20:52:36,Plentzia,expenses,repairs,-151.04,-8086.56
buyer_5,Sara,Urkiaga,1994-03-12,44623772T,sara.urkiaga@megaapp.tech,772687,ES92209532362570784285,1506.75,2023-01-23T15:59:25,Plentzia,expenses,transport,-67.33,-8153.89
buyer_5,Sara,Urkiaga,1994-03-12,44623772T,sara.urkiaga@megaapp.tech,772687,ES92209532362570784285,1506.75,2023-01-24T08:34:51,Plentzia,expenses,cash,-100.0,-8253.89
buyer_5,Sara,Urkiaga,1994-03-12,44623772T,sara.urkiaga@megaapp.tech,772687,ES92209532362570784285,1506.75,2023-01-24T09:53:10,Plentzia,expenses,appliances,-100.29,-8354.18
buyer_5,Sara,Urkiaga,1994-03-12,44623772T,sara.urkiaga@megaapp.tech,772687,ES92209532362570784285,1506.75,2023-01-25T19:19:21,Plentzia,expenses,transport,-61.92,-8416.1
buyer_5,Sara,Urkiaga,1994-03-12,44623772T,sara.urkiaga@megaapp.tech,772687,ES92209532362570784285,1506.75,2023-01-25T21:08:03,Plentzia,expenses,cash,-100.0,-8516.1
buyer_5,Sara,Urkiaga,1994-03-12,44623772T,sara.urkiaga@megaapp.tech,772687,ES92209532362570784285,1506.75,2023-01-25T11:08:13,Plentzia,expenses,gifts,-566.32,-9082.42
buyer_5,Sara,Urkiaga,1994-03-12,44623772T,sara.urkiaga@megaapp.tech,772687,ES92209532362570784285,1506.75,2023-01-28T16:43:36,Plentzia,expenses,food,-104.52,-9186.94
buyer_5,Sara,Urkiaga,1994-03-12,44623772T,sara.urkiaga@megaapp.tech,772687,ES92209532362570784285,1506.75,2023-01-28T08:40:42,Plentzia,expenses,transport,-84.29,-9271.23
buyer_5,Sara,Urkiaga,1994-03-12,44623772T,sara.urkiaga@megaapp.tech,772687,ES92209532362570784285,1506.75,2023-01-31T04:23:53,Plentzia,expenses,food,-85.97,-9357.2
buyer_5,Sara,Urkiaga,1994-03-12,44623772T,sara.urkiaga@megaapp.tech,772687,ES92209532362570784285,1506.75,2023-01-31T20:00:55,Plentzia,expenses,gifts,-720.71,-10077.91
buyer_5,Sara,Urkiaga,1994-03-12,44623772T,sara.urkiaga@megaapp.tech,772687,ES92209532362570784285,1506.75,2023-02-01T09:23:41,Plentzia,incomes,salary,2570.6,-7507.31
buyer_5,Sara,Urkiaga,1994-03-12,44623772T,sara.urkiaga@megaapp.tech,772687,ES92209532362570784285,1506.75,2023-02-01T09:23:41,Plentzia,incomes,salary_partner,2300.08,-5207.23
buyer_5,Sara,Urkiaga,1994-03-12,44623772T,sara.urkiaga@megaapp.tech,772687,ES92209532362570784285,1506.75,2023-02-01T23:35:46,Plentzia,expenses,transport,-40.78,-5248.01
buyer_5,Sara,Urkiaga,1994-03-12,44623772T,sara.urkiaga@megaapp.tech,772687,ES92209532362570784285,1506.75,2023-02-02T15:04:59,Plentzia,expenses,transport,-51.42,-5299.43
buyer_5,Sara,Urkiaga,1994-03-12,44623772T,sara.urkiaga@megaapp.tech,772687,ES92209532362570784285,1506.75,2023-02-02T02:16:35,Plentzia,expenses,leisure,-52.31,-5351.74
buyer_5,Sara,Urkiaga,1994-03-12,44623772T,sara.urkiaga@megaapp.tech,772687,ES92209532362570784285,1506.75,2023-02-03T16:22:23,Plentzia,expenses,appliances,-283.9,-5635.64
buyer_5,Sara,Urkiaga,1994-03-12,44623772T,sara.urkiaga@megaapp.tech,772687,ES92209532362570784285,1506.75,2023-02-04T10:03:25,Plentzia,expenses,food,-124.02,-5759.66
buyer_5,Sara,Urkiaga,1994-03-12,44623772T,sara.urkiaga@megaapp.tech,772687,ES92209532362570784285,1506.75,2023-02-05T18:53:39,Plentzia,expenses,mortgage,-1951.2,-7710.86
buyer_5,Sara,Urkiaga,1994-03-12,44623772T,sara.urkiaga@megaapp.tech,772687,ES92209532362570784285,1506.75,2023-02-05T16:50:54,Plentzia,expenses,gas,-195.97,-7906.83
buyer_5,Sara,Urkiaga,1994-03-12,44623772T,sara.urkiaga@megaapp.tech,772687,ES92209532362570784285,1506.75,2023-02-05T20:56:20,Plentzia,expenses,food,-103.25,-8010.08
buyer_5,Sara,Urkiaga,1994-03-12,44623772T,sara.urkiaga@megaapp.tech,772687,ES92209532362570784285,1506.75,2023-02-05T15:58:07,Plentzia,expenses,travel,-774.49,-8784.57
buyer_5,Sara,Urkiaga,1994-03-12,44623772T,sara.urkiaga@megaapp.tech,772687,ES92209532362570784285,1506.75,2023-02-06T13:09:28,Plentzia,expenses,gas,-247.36,-9031.93
buyer_5,Sara,Urkiaga,1994-03-12,44623772T,sara.urkiaga@megaapp.tech,772687,ES92209532362570784285,1506.75,2023-02-07T14:39:28,Plentzia,expenses,internet,-102.28,-9134.21
buyer_5,Sara,Urkiaga,1994-03-12,44623772T,sara.urkiaga@megaapp.tech,772687,ES92209532362570784285,1506.75,2023-02-07T15:25:04,Plentzia,expenses,phone,-76.22,-9210.43
buyer_5,Sara,Urkiaga,1994-03-12,44623772T,sara.urkiaga@megaapp.tech,772687,ES92209532362570784285,1506.75,2023-02-07T17:11:56,Plentzia,expenses,transport,-59.97,-9270.4
buyer_5,Sara,Urkiaga,1994-03-12,44623772T,sara.urkiaga@megaapp.tech,772687,ES92209532362570784285,1506.75,2023-02-07T14:14:38,Plentzia,expenses,clothing,-64.23,-9334.63
buyer_5,Sara,Urkiaga,1994-03-12,44623772T,sara.urkiaga@megaapp.tech,772687,ES92209532362570784285,1506.75,2023-02-07T18:45:34,Plentzia,expenses,repairs,-142.52,-9477.15
buyer_5,Sara,Urkiaga,1994-03-12,44623772T,sara.urkiaga@megaapp.tech,772687,ES92209532362570784285,1506.75,2023-02-08T11:45:36,Plentzia,expenses,cash,-100.0,-9577.15
buyer_5,Sara,Urkiaga,1994-03-12,44623772T,sara.urkiaga@megaapp.tech,772687,ES92209532362570784285,1506.75,2023-02-10T13:42:41,Plentzia,expenses,cash,-100.0,-9677.15
buyer_5,Sara,Urkiaga,1994-03-12,44623772T,sara.urkiaga@megaapp.tech,772687,ES92209532362570784285,1506.75,2023-02-12T18:13:52,Plentzia,expenses,appliances,-135.73,-9812.88
buyer_5,Sara,Urkiaga,1994-03-12,44623772T,sara.urkiaga@megaapp.tech,772687,ES92209532362570784285,1506.75,2023-02-13T19:58:48,Plentzia,expenses,cash,-100.0,-9912.88
buyer_5,Sara,Urkiaga,1994-03-12,44623772T,sara.urkiaga@megaapp.tech,772687,ES92209532362570784285,1506.75,2023-02-14T11:56:40,Plentzia,expenses,food,-116.97,-10029.85
buyer_5,Sara,Urkiaga,1994-03-12,44623772T,sara.urkiaga@megaapp.tech,772687,ES92209532362570784285,1506.75,2023-02-15T20:00:35,Plentzia,expenses,leisure,-67.13,-10096.98
buyer_5,Sara,Urkiaga,1994-03-12,44623772T,sara.urkiaga@megaapp.tech,772687,ES92209532362570784285,1506.75,2023-02-16T16:00:45,Plentzia,expenses,cash,-100.0,-10196.98
buyer_5,Sara,Urkiaga,1994-03-12,44623772T,sara.urkiaga@megaapp.tech,772687,ES92209532362570784285,1506.75,2023-02-18T23:18:43,Plentzia,expenses,food,-82.82,-10279.8
buyer_5,Sara,Urkiaga,1994-03-12,44623772T,sara.urkiaga@megaapp.tech,772687,ES92209532362570784285,1506.75,2023-02-21T19:59:49,Plentzia,expenses,cash,-100.0,-10379.8
buyer_5,Sara,Urkiaga,1994-03-12,44623772T,sara.urkiaga@megaapp.tech,772687,ES92209532362570784285,1506.75,2023-02-21T14:41:04,Plentzia,expenses,gifts,-73.34,-10453.14
buyer_5,Sara,Urkiaga,1994-03-12,44623772T,sara.urkiaga@megaapp.tech,772687,ES92209532362570784285,1506.75,2023-02-22T16:51:02,Plentzia,expenses,healthcare,-174.51,-10627.65
buyer_5,Sara,Urkiaga,1994-03-12,44623772T,sara.urkiaga@megaapp.tech,772687,ES92209532362570784285,1506.75,2023-02-23T19:05:16,Plentzia,expenses,food,-107.54,-10735.19
buyer_5,Sara,Urkiaga,1994-03-12,44623772T,sara.urkiaga@megaapp.tech,772687,ES92209532362570784285,1506.75,2023-02-23T23:07:11,Plentzia,expenses,leisure,-43.59,-10778.78
buyer_5,Sara,Urkiaga,1994-03-12,44623772T,sara.urkiaga@megaapp.tech,772687,ES92209532362570784285,1506.75,2023-02-24T00:46:28,Plentzia,expenses,cash,-100.0,-10878.78
buyer_5,Sara,Urkiaga,1994-03-12,44623772T,sara.urkiaga@megaapp.tech,772687,ES92209532362570784285,1506.75,2023-02-25T23:56:36,Plentzia,expenses,education,-69.65,-10948.43
buyer_5,Sara,Urkiaga,1994-03-12,44623772T,sara.urkiaga@megaapp.tech,772687,ES92209532362570784285,1506.75,2023-02-26T15:44:04,Plentzia,expenses,leisure,-48.45,-10996.88
buyer_5,Sara,Urkiaga,1994-03-12,44623772T,sara.urkiaga@megaapp.tech,772687,ES92209532362570784285,1506.75,2023-02-26T12:55:34,Plentzia,expenses,cash,-100.0,-11096.88
buyer_5,Sara,Urkiaga,1994-03-12,44623772T,sara.urkiaga@megaapp.tech,772687,ES92209532362570784285,1506.75,2023-02-27T14:54:48,Plentzia,expenses,food,-98.24,-11195.12
buyer_5,Sara,Urkiaga,1994-03-12,44623772T,sara.urkiaga@megaapp.tech,772687,ES92209532362570784285,1506.75,2023-02-27T11:30:45,Plentzia,expenses,cash,-100.0,-11295.12
buyer_5,Sara,Urkiaga,1994-03-12,44623772T,sara.urkiaga@megaapp.tech,772687,ES92209532362570784285,1506.75,2023-02-27T14:38:18,Plentzia,expenses,repairs,-164.99,-11460.11
buyer_5,Sara,Urkiaga,1994-03-12,44623772T,sara.urkiaga@megaapp.tech,772687,ES92209532362570784285,1506.75,2023-02-28T14:01:11,Plentzia,expenses,food,-73.38,-11533.49
buyer_5,Sara,Urkiaga,1994-03-12,44623772T,sara.urkiaga@megaapp.tech,772687,ES92209532362570784285,1506.75,2023-02-28T23:23:48,Plentzia,expenses,clothing,-156.93,-11690.42
buyer_5,Sara,Urkiaga,1994-03-12,44623772T,sara.urkiaga@megaapp.tech,772687,ES92209532362570784285,1506.75,2023-03-01T09:04:13,Plentzia,incomes,salary,2570.6,-9119.82
buyer_5,Sara,Urkiaga,1994-03-12,44623772T,sara.urkiaga@megaapp.tech,772687,ES92209532362570784285,1506.75,2023-03-01T09:04:13,Plentzia,incomes,salary_partner,2300.08,-6819.74
buyer_5,Sara,Urkiaga,1994-03-12,44623772T,sara.urkiaga@megaapp.tech,772687,ES92209532362570784285,1506.75,2023-03-01T08:51:01,Plentzia,expenses,transport,-68.33,-6888.07
buyer_5,Sara,Urkiaga,1994-03-12,44623772T,sara.urkiaga@megaapp.tech,772687,ES92209532362570784285,1506.75,2023-03-01T12:26:47,Plentzia,expenses,healthcare,-113.22,-7001.29
buyer_5,Sara,Urkiaga,1994-03-12,44623772T,sara.urkiaga@megaapp.tech,772687,ES92209532362570784285,1506.75,2023-03-01T11:09:52,Plentzia,expenses,repairs,-142.56,-7143.85
buyer_5,Sara,Urkiaga,1994-03-12,44623772T,sara.urkiaga@megaapp.tech,772687,ES92209532362570784285,1506.75,2023-03-04T10:35:57,Plentzia,expenses,cash,-100.0,-7243.85
buyer_5,Sara,Urkiaga,1994-03-12,44623772T,sara.urkiaga@megaapp.tech,772687,ES92209532362570784285,1506.75,2023-03-05T11:25:30,Plentzia,expenses,mortgage,-1951.2,-9195.05
buyer_5,Sara,Urkiaga,1994-03-12,44623772T,sara.urkiaga@megaapp.tech,772687,ES92209532362570784285,1506.75,2023-03-05T16:10:06,Plentzia,expenses,internet,-102.28,-9297.33
buyer_5,Sara,Urkiaga,1994-03-12,44623772T,sara.urkiaga@megaapp.tech,772687,ES92209532362570784285,1506.75,2023-03-05T09:43:11,Plentzia,expenses,food,-118.89,-9416.22
buyer_5,Sara,Urkiaga,1994-03-12,44623772T,sara.urkiaga@megaapp.tech,772687,ES92209532362570784285,1506.75,2023-03-06T19:59:19,Plentzia,expenses,water,-95.19,-9511.41
buyer_5,Sara,Urkiaga,1994-03-12,44623772T,sara.urkiaga@megaapp.tech,772687,ES92209532362570784285,1506.75,2023-03-06T12:18:33,Plentzia,expenses,phone,-73.83,-9585.24
buyer_5,Sara,Urkiaga,1994-03-12,44623772T,sara.urkiaga@megaapp.tech,772687,ES92209532362570784285,1506.75,2023-03-06T18:54:54,Plentzia,expenses,transport,-77.8,-9663.04
buyer_5,Sara,Urkiaga,1994-03-12,44623772T,sara.urkiaga@megaapp.tech,772687,ES92209532362570784285,1506.75,2023-03-07T16:51:09,Plentzia,expenses,water,-95.77,-9758.81
buyer_5,Sara,Urkiaga,1994-03-12,44623772T,sara.urkiaga@megaapp.tech,772687,ES92209532362570784285,1506.75,2023-03-07T09:50:29,Plentzia,expenses,electricity,-156.41,-9915.22
buyer_5,Sara,Urkiaga,1994-03-12,44623772T,sara.urkiaga@megaapp.tech,772687,ES92209532362570784285,1506.75,2023-03-07T16:45:52,Plentzia,expenses,internet,-102.28,-10017.5
buyer_5,Sara,Urkiaga,1994-03-12,44623772T,sara.urkiaga@megaapp.tech,772687,ES92209532362570784285,1506.75,2023-03-08T21:16:29,Plentzia,expenses,phone,-91.84,-10109.34
buyer_5,Sara,Urkiaga,1994-03-12,44623772T,sara.urkiaga@megaapp.tech,772687,ES92209532362570784285,1506.75,2023-03-10T13:50:05,Plentzia,expenses,leisure,-60.72,-10170.06
buyer_5,Sara,Urkiaga,1994-03-12,44623772T,sara.urkiaga@megaapp.tech,772687,ES92209532362570784285,1506.75,2023-03-12T17:22:31,Plentzia,expenses,education,-45.04,-10215.1
buyer_5,Sara,Urkiaga,1994-03-12,44623772T,sara.urkiaga@megaapp.tech,772687,ES92209532362570784285,1506.75,2023-03-15T14:43:02,Plentzia,expenses,leisure,-27.96,-10243.06
buyer_5,Sara,Urkiaga,1994-03-12,44623772T,sara.urkiaga@megaapp.tech,772687,ES92209532362570784285,1506.75,2023-03-16T22:49:11,Plentzia,expenses,food,-72.43,-10315.49
buyer_5,Sara,Urkiaga,1994-03-12,44623772T,sara.urkiaga@megaapp.tech,772687,ES92209532362570784285,1506.75,2023-03-18T10:46:21,Plentzia,expenses,cash,-100.0,-10415.49
buyer_5,Sara,Urkiaga,1994-03-12,44623772T,sara.urkiaga@megaapp.tech,772687,ES92209532362570784285,1506.75,2023-03-20T19:33:26,Plentzia,expenses,transport,-66.86,-10482.35
buyer_5,Sara,Urkiaga,1994-03-12,44623772T,sara.urkiaga@megaapp.tech,772687,ES92209532362570784285,1506.75,2023-03-21T08:09:40,Plentzia,expenses,food,-83.28,-10565.63
buyer_5,Sara,Urkiaga,1994-03-12,44623772T,sara.urkiaga@megaapp.tech,772687,ES92209532362570784285,1506.75,2023-03-25T20:25:34,Plentzia,expenses,leisure,-26.79,-10592.42
buyer_5,Sara,Urkiaga,1994-03-12,44623772T,sara.urkiaga@megaapp.tech,772687,ES92209532362570784285,1506.75,2023-03-25T10:27:32,Plentzia,expenses,repairs,-209.76,-10802.18
buyer_5,Sara,Urkiaga,1994-03-12,44623772T,sara.urkiaga@megaapp.tech,772687,ES92209532362570784285,1506.75,2023-03-26T08:17:47,Plentzia,expenses,cash,-100.0,-10902.18
buyer_5,Sara,Urkiaga,1994-03-12,44623772T,sara.urkiaga@megaapp.tech,772687,ES92209532362570784285,1506.75,2023-03-26T10:40:10,Plentzia,expenses,repairs,-154.59,-11056.77
buyer_5,Sara,Urkiaga,1994-03-12,44623772T,sara.urkiaga@megaapp.tech,772687,ES92209532362570784285,1506.75,2023-03-27T20:31:24,Plentzia,expenses,food,-113.29,-11170.06
buyer_5,Sara,Urkiaga,1994-03-12,44623772T,sara.urkiaga@megaapp.tech,772687,ES92209532362570784285,1506.75,2023-03-27T15:38:21,Plentzia,expenses,appliances,-226.95,-11397.01
buyer_5,Sara,Urkiaga,1994-03-12,44623772T,sara.urkiaga@megaapp.tech,772687,ES92209532362570784285,1506.75,2023-03-27T05:44:16,Plentzia,expenses,repairs,-286.91,-11683.92
buyer_5,Sara,Urkiaga,1994-03-12,44623772T,sara.urkiaga@megaapp.tech,772687,ES92209532362570784285,1506.75,2023-03-30T10:34:40,Plentzia,expenses,cash,-100.0,-11783.92
buyer_5,Sara,Urkiaga,1994-03-12,44623772T,sara.urkiaga@megaapp.tech,772687,ES92209532362570784285,1506.75,2023-03-31T20:16:34,Plentzia,expenses,cash,-100.0,-11883.92
buyer_5,Sara,Urkiaga,1994-03-12,44623772T,sara.urkiaga@megaapp.tech,772687,ES92209532362570784285,1506.75,2023-03-31T16:51:44,Plentzia,expenses,appliances,-122.74,-12006.66
buyer_5,Sara,Urkiaga,1994-03-12,44623772T,sara.urkiaga@megaapp.tech,772687,ES92209532362570784285,1506.75,2023-04-01T13:36:05,Plentzia,incomes,salary,2570.6,-9436.06
buyer_5,Sara,Urkiaga,1994-03-12,44623772T,sara.urkiaga@megaapp.tech,772687,ES92209532362570784285,1506.75,2023-04-01T13:36:05,Plentzia,incomes,salary_partner,2300.08,-7135.98
buyer_5,Sara,Urkiaga,1994-03-12,44623772T,sara.urkiaga@megaapp.tech,772687,ES92209532362570784285,1506.75,2023-04-01T13:36:05,Plentzia,incomes,extra_income,471.47,-6664.51
buyer_5,Sara,Urkiaga,1994-03-12,44623772T,sara.urkiaga@megaapp.tech,772687,ES92209532362570784285,1506.75,2023-04-01T02:59:37,Plentzia,expenses,cash,-100.0,-6764.51
buyer_5,Sara,Urkiaga,1994-03-12,44623772T,sara.urkiaga@megaapp.tech,772687,ES92209532362570784285,1506.75,2023-04-04T08:33:23,Plentzia,expenses,transport,-86.08,-6850.59
buyer_5,Sara,Urkiaga,1994-03-12,44623772T,sara.urkiaga@megaapp.tech,772687,ES92209532362570784285,1506.75,2023-04-04T08:25:08,Plentzia,expenses,gifts,-409.72,-7260.31
buyer_5,Sara,Urkiaga,1994-03-12,44623772T,sara.urkiaga@megaapp.tech,772687,ES92209532362570784285,1506.75,2023-04-05T17:25:10,Plentzia,expenses,mortgage,-1951.2,-9211.51
buyer_5,Sara,Urkiaga,1994-03-12,44623772T,sara.urkiaga@megaapp.tech,772687,ES92209532362570784285,1506.75,2023-04-05T14:19:25,Plentzia,expenses,water,-83.38,-9294.89
buyer_5,Sara,Urkiaga,1994-03-12,44623772T,sara.urkiaga@megaapp.tech,772687,ES92209532362570784285,1506.75,2023-04-05T16:01:38,Plentzia,expenses,gas,-180.0,-9474.89
buyer_5,Sara,Urkiaga,1994-03-12,44623772T,sara.urkiaga@megaapp.tech,772687,ES92209532362570784285,1506.75,2023-04-05T19:01:23,Plentzia,expenses,internet,-102.28,-9577.17
buyer_5,Sara,Urkiaga,1994-03-12,44623772T,sara.urkiaga@megaapp.tech,772687,ES92209532362570784285,1506.75,2023-04-05T17:02:39,Plentzia,expenses,phone,-84.1,-9661.27
buyer_5,Sara,Urkiaga,1994-03-12,44623772T,sara.urkiaga@megaapp.tech,772687,ES92209532362570784285,1506.75,2023-04-06T09:23:48,Plentzia,expenses,electricity,-200.75,-9862.02
buyer_5,Sara,Urkiaga,1994-03-12,44623772T,sara.urkiaga@megaapp.tech,772687,ES92209532362570784285,1506.75,2023-04-06T23:29:19,Plentzia,expenses,gas,-86.13,-9948.15
buyer_5,Sara,Urkiaga,1994-03-12,44623772T,sara.urkiaga@megaapp.tech,772687,ES92209532362570784285,1506.75,2023-04-06T20:12:59,Plentzia,expenses,phone,-73.13,-10021.28
buyer_5,Sara,Urkiaga,1994-03-12,44623772T,sara.urkiaga@megaapp.tech,772687,ES92209532362570784285,1506.75,2023-04-07T08:15:30,Plentzia,expenses,gas,-106.96,-10128.24
buyer_5,Sara,Urkiaga,1994-03-12,44623772T,sara.urkiaga@megaapp.tech,772687,ES92209532362570784285,1506.75,2023-04-07T09:11:13,Plentzia,expenses,gifts,-574.82,-10703.06
buyer_5,Sara,Urkiaga,1994-03-12,44623772T,sara.urkiaga@megaapp.tech,772687,ES92209532362570784285,1506.75,2023-04-08T14:03:26,Plentzia,expenses,internet,-102.28,-10805.34
buyer_5,Sara,Urkiaga,1994-03-12,44623772T,sara.urkiaga@megaapp.tech,772687,ES92209532362570784285,1506.75,2023-04-08T01:26:39,Plentzia,expenses,food,-72.57,-10877.91
buyer_5,Sara,Urkiaga,1994-03-12,44623772T,sara.urkiaga@megaapp.tech,772687,ES92209532362570784285,1506.75,2023-04-08T21:45:33,Plentzia,expenses,transport,-40.79,-10918.7
buyer_5,Sara,Urkiaga,1994-03-12,44623772T,sara.urkiaga@megaapp.tech,772687,ES92209532362570784285,1506.75,2023-04-08T16:29:08,Plentzia,expenses,leisure,-24.6,-10943.3
buyer_5,Sara,Urkiaga,1994-03-12,44623772T,sara.urkiaga@megaapp.tech,772687,ES92209532362570784285,1506.75,2023-04-10T09:39:23,Plentzia,expenses,cash,-100.0,-11043.3
buyer_5,Sara,Urkiaga,1994-03-12,44623772T,sara.urkiaga@megaapp.tech,772687,ES92209532362570784285,1506.75,2023-04-11T08:31:24,Plentzia,expenses,leisure,-72.71,-11116.01
buyer_5,Sara,Urkiaga,1994-03-12,44623772T,sara.urkiaga@megaapp.tech,772687,ES92209532362570784285,1506.75,2023-04-14T09:00:58,Plentzia,expenses,cash,-100.0,-11216.01
buyer_5,Sara,Urkiaga,1994-03-12,44623772T,sara.urkiaga@megaapp.tech,772687,ES92209532362570784285,1506.75,2023-04-14T10:50:25,Plentzia,expenses,repairs,-30.75,-11246.76
buyer_5,Sara,Urkiaga,1994-03-12,44623772T,sara.urkiaga@megaapp.tech,772687,ES92209532362570784285,1506.75,2023-04-15T13:17:51,Plentzia,expenses,food,-124.67,-11371.43
buyer_5,Sara,Urkiaga,1994-03-12,44623772T,sara.urkiaga@megaapp.tech,772687,ES92209532362570784285,1506.75,2023-04-16T19:39:28,Plentzia,expenses,cash,-100.0,-11471.43
buyer_5,Sara,Urkiaga,1994-03-12,44623772T,sara.urkiaga@megaapp.tech,772687,ES92209532362570784285,1506.75,2023-04-18T14:21:39,Plentzia,expenses,education,-44.13,-11515.56
buyer_5,Sara,Urkiaga,1994-03-12,44623772T,sara.urkiaga@megaapp.tech,772687,ES92209532362570784285,1506.75,2023-04-19T09:07:20,Plentzia,expenses,transport,-51.34,-11566.9
buyer_5,Sara,Urkiaga,1994-03-12,44623772T,sara.urkiaga@megaapp.tech,772687,ES92209532362570784285,1506.75,2023-04-19T22:40:30,Plentzia,expenses,cash,-100.0,-11666.9
buyer_5,Sara,Urkiaga,1994-03-12,44623772T,sara.urkiaga@megaapp.tech,772687,ES92209532362570784285,1506.75,2023-04-21T08:33:10,Plentzia,expenses,food,-113.45,-11780.35
buyer_5,Sara,Urkiaga,1994-03-12,44623772T,sara.urkiaga@megaapp.tech,772687,ES92209532362570784285,1506.75,2023-04-23T12:16:31,Plentzia,expenses,transport,-56.02,-11836.37
buyer_5,Sara,Urkiaga,1994-03-12,44623772T,sara.urkiaga@megaapp.tech,772687,ES92209532362570784285,1506.75,2023-04-24T21:12:41,Plentzia,expenses,food,-62.08,-11898.45
buyer_5,Sara,Urkiaga,1994-03-12,44623772T,sara.urkiaga@megaapp.tech,772687,ES92209532362570784285,1506.75,2023-04-24T20:38:27,Plentzia,expenses,transport,-73.41,-11971.86
buyer_5,Sara,Urkiaga,1994-03-12,44623772T,sara.urkiaga@megaapp.tech,772687,ES92209532362570784285,1506.75,2023-04-25T12:49:00,Plentzia,expenses,food,-94.74,-12066.6
buyer_5,Sara,Urkiaga,1994-03-12,44623772T,sara.urkiaga@megaapp.tech,772687,ES92209532362570784285,1506.75,2023-04-25T19:42:47,Plentzia,expenses,cash,-100.0,-12166.6
buyer_5,Sara,Urkiaga,1994-03-12,44623772T,sara.urkiaga@megaapp.tech,772687,ES92209532362570784285,1506.75,2023-04-25T12:40:00,Plentzia,expenses,gifts,-402.55,-12569.15
buyer_5,Sara,Urkiaga,1994-03-12,44623772T,sara.urkiaga@megaapp.tech,772687,ES92209532362570784285,1506.75,2023-04-26T19:50:23,Plentzia,expenses,repairs,-293.99,-12863.14
buyer_5,Sara,Urkiaga,1994-03-12,44623772T,sara.urkiaga@megaapp.tech,772687,ES92209532362570784285,1506.75,2023-04-27T19:59:31,Plentzia,expenses,food,-63.35,-12926.49
buyer_5,Sara,Urkiaga,1994-03-12,44623772T,sara.urkiaga@megaapp.tech,772687,ES92209532362570784285,1506.75,2023-04-30T15:26:47,Plentzia,expenses,food,-71.36,-12997.85
buyer_5,Sara,Urkiaga,1994-03-12,44623772T,sara.urkiaga@megaapp.tech,772687,ES92209532362570784285,1506.75,2023-04-30T14:47:04,Plentzia,expenses,transport,-63.99,-13061.84
buyer_5,Sara,Urkiaga,1994-03-12,44623772T,sara.urkiaga@megaapp.tech,772687,ES92209532362570784285,1506.75,2023-05-01T19:51:19,Plentzia,incomes,salary,2570.6,-10491.24
buyer_5,Sara,Urkiaga,1994-03-12,44623772T,sara.urkiaga@megaapp.tech,772687,ES92209532362570784285,1506.75,2023-05-01T19:51:19,Plentzia,incomes,salary_partner,2300.08,-8191.16
buyer_5,Sara,Urkiaga,1994-03-12,44623772T,sara.urkiaga@megaapp.tech,772687,ES92209532362570784285,1506.75,2023-05-02T13:04:25,Plentzia,expenses,leisure,-25.86,-8217.02
buyer_5,Sara,Urkiaga,1994-03-12,44623772T,sara.urkiaga@megaapp.tech,772687,ES92209532362570784285,1506.75,2023-05-03T10:48:36,Plentzia,expenses,transport,-44.93,-8261.95
buyer_5,Sara,Urkiaga,1994-03-12,44623772T,sara.urkiaga@megaapp.tech,772687,ES92209532362570784285,1506.75,2023-05-03T22:21:08,Plentzia,expenses,healthcare,-76.11,-8338.06
buyer_5,Sara,Urkiaga,1994-03-12,44623772T,sara.urkiaga@megaapp.tech,772687,ES92209532362570784285,1506.75,2023-05-05T04:21:10,Plentzia,expenses,mortgage,-1951.2,-10289.26
buyer_5,Sara,Urkiaga,1994-03-12,44623772T,sara.urkiaga@megaapp.tech,772687,ES92209532362570784285,1506.75,2023-05-05T13:36:48,Plentzia,expenses,healthcare,-93.11,-10382.37
buyer_5,Sara,Urkiaga,1994-03-12,44623772T,sara.urkiaga@megaapp.tech,772687,ES92209532362570784285,1506.75,2023-05-06T18:27:26,Plentzia,expenses,electricity,-150.3,-10532.67
buyer_5,Sara,Urkiaga,1994-03-12,44623772T,sara.urkiaga@megaapp.tech,772687,ES92209532362570784285,1506.75,2023-05-06T15:57:34,Plentzia,expenses,gas,-117.8,-10650.47
buyer_5,Sara,Urkiaga,1994-03-12,44623772T,sara.urkiaga@megaapp.tech,772687,ES92209532362570784285,1506.75,2023-05-06T15:21:41,Plentzia,expenses,phone,-86.65,-10737.12
buyer_5,Sara,Urkiaga,1994-03-12,44623772T,sara.urkiaga@megaapp.tech,772687,ES92209532362570784285,1506.75,2023-05-06T20:48:52,Plentzia,expenses,leisure,-31.64,-10768.76
buyer_5,Sara,Urkiaga,1994-03-12,44623772T,sara.urkiaga@megaapp.tech,772687,ES92209532362570784285,1506.75,2023-05-07T19:29:08,Plentzia,expenses,electricity,-218.39,-10987.15
buyer_5,Sara,Urkiaga,1994-03-12,44623772T,sara.urkiaga@megaapp.tech,772687,ES92209532362570784285,1506.75,2023-05-08T17:27:00,Plentzia,expenses,gas,-141.98,-11129.13
buyer_5,Sara,Urkiaga,1994-03-12,44623772T,sara.urkiaga@megaapp.tech,772687,ES92209532362570784285,1506.75,2023-05-09T19:02:53,Plentzia,expenses,food,-65.98,-11195.11
buyer_5,Sara,Urkiaga,1994-03-12,44623772T,sara.urkiaga@megaapp.tech,772687,ES92209532362570784285,1506.75,2023-05-09T19:27:21,Plentzia,expenses,repairs,-34.83,-11229.94
buyer_5,Sara,Urkiaga,1994-03-12,44623772T,sara.urkiaga@megaapp.tech,772687,ES92209532362570784285,1506.75,2023-05-10T18:15:49,Plentzia,expenses,appliances,-153.1,-11383.04
buyer_5,Sara,Urkiaga,1994-03-12,44623772T,sara.urkiaga@megaapp.tech,772687,ES92209532362570784285,1506.75,2023-05-13T20:33:49,Plentzia,expenses,cash,-100.0,-11483.04
buyer_5,Sara,Urkiaga,1994-03-12,44623772T,sara.urkiaga@megaapp.tech,772687,ES92209532362570784285,1506.75,2023-05-13T23:49:04,Plentzia,expenses,repairs,-213.44,-11696.48
buyer_5,Sara,Urkiaga,1994-03-12,44623772T,sara.urkiaga@megaapp.tech,772687,ES92209532362570784285,1506.75,2023-05-14T13:17:25,Plentzia,expenses,repairs,-174.45,-11870.93
buyer_5,Sara,Urkiaga,1994-03-12,44623772T,sara.urkiaga@megaapp.tech,772687,ES92209532362570784285,1506.75,2023-05-15T16:36:21,Plentzia,expenses,leisure,-28.58,-11899.51
buyer_5,Sara,Urkiaga,1994-03-12,44623772T,sara.urkiaga@megaapp.tech,772687,ES92209532362570784285,1506.75,2023-05-15T14:41:48,Plentzia,expenses,clothing,-45.93,-11945.44
buyer_5,Sara,Urkiaga,1994-03-12,44623772T,sara.urkiaga@megaapp.tech,772687,ES92209532362570784285,1506.75,2023-05-15T13:45:26,Plentzia,expenses,cash,-100.0,-12045.44
buyer_5,Sara,Urkiaga,1994-03-12,44623772T,sara.urkiaga@megaapp.tech,772687,ES92209532362570784285,1506.75,2023-05-15T23:00:58,Plentzia,expenses,gifts,-447.14,-12492.58
buyer_5,Sara,Urkiaga,1994-03-12,44623772T,sara.urkiaga@megaapp.tech,772687,ES92209532362570784285,1506.75,2023-05-17T00:39:14,Plentzia,expenses,food,-73.08,-12565.66
buyer_5,Sara,Urkiaga,1994-03-12,44623772T,sara.urkiaga@megaapp.tech,772687,ES92209532362570784285,1506.75,2023-05-17T07:41:22,Plentzia,expenses,transport,-46.05,-12611.71
buyer_5,Sara,Urkiaga,1994-03-12,44623772T,sara.urkiaga@megaapp.tech,772687,ES92209532362570784285,1506.75,2023-05-18T10:09:44,Plentzia,expenses,healthcare,-93.52,-12705.23
buyer_5,Sara,Urkiaga,1994-03-12,44623772T,sara.urkiaga@megaapp.tech,772687,ES92209532362570784285,1506.75,2023-05-18T15:38:07,Plentzia,expenses,cash,-100.0,-12805.23
buyer_5,Sara,Urkiaga,1994-03-12,44623772T,sara.urkiaga@megaapp.tech,772687,ES92209532362570784285,1506.75,2023-05-19T08:56:18,Plentzia,expenses,cash,-100.0,-12905.23
buyer_5,Sara,Urkiaga,1994-03-12,44623772T,sara.urkiaga@megaapp.tech,772687,ES92209532362570784285,1506.75,2023-05-21T09:48:55,Plentzia,expenses,leisure,-66.77,-12972.0
buyer_5,Sara,Urkiaga,1994-03-12,44623772T,sara.urkiaga@megaapp.tech,772687,ES92209532362570784285,1506.75,2023-05-22T01:28:05,Plentzia,expenses,healthcare,-87.81,-13059.81
buyer_5,Sara,Urkiaga,1994-03-12,44623772T,sara.urkiaga@megaapp.tech,772687,ES92209532362570784285,1506.75,2023-05-23T08:09:02,Plentzia,expenses,clothing,-118.2,-13178.01
buyer_5,Sara,Urkiaga,1994-03-12,44623772T,sara.urkiaga@megaapp.tech,772687,ES92209532362570784285,1506.75,2023-05-26T10:07:51,Plentzia,expenses,repairs,-223.61,-13401.62
buyer_5,Sara,Urkiaga,1994-03-12,44623772T,sara.urkiaga@megaapp.tech,772687,ES92209532362570784285,1506.75,2023-05-27T12:16:07,Plentzia,expenses,transport,-77.28,-13478.9
buyer_5,Sara,Urkiaga,1994-03-12,44623772T,sara.urkiaga@megaapp.tech,772687,ES92209532362570784285,1506.75,2023-05-27T18:07:25,Plentzia,expenses,travel,-371.56,-13850.46
buyer_5,Sara,Urkiaga,1994-03-12,44623772T,sara.urkiaga@megaapp.tech,772687,ES92209532362570784285,1506.75,2023-05-31T20:47:43,Plentzia,expenses,leisure,-81.2,-13931.66
buyer_5,Sara,Urkiaga,1994-03-12,44623772T,sara.urkiaga@megaapp.tech,772687,ES92209532362570784285,1506.75,2023-05-31T18:04:09,Plentzia,expenses,cash,-100.0,-14031.66
buyer_5,Sara,Urkiaga,1994-03-12,44623772T,sara.urkiaga@megaapp.tech,772687,ES92209532362570784285,1506.75,2023-06-01T19:22:35,Plentzia,incomes,salary,2570.6,-11461.06
buyer_5,Sara,Urkiaga,1994-03-12,44623772T,sara.urkiaga@megaapp.tech,772687,ES92209532362570784285,1506.75,2023-06-01T19:22:35,Plentzia,incomes,salary_partner,2300.08,-9160.98
buyer_5,Sara,Urkiaga,1994-03-12,44623772T,sara.urkiaga@megaapp.tech,772687,ES92209532362570784285,1506.75,2023-06-01T19:22:35,Plentzia,incomes,salary_bonus,1840.47,-7320.51
buyer_5,Sara,Urkiaga,1994-03-12,44623772T,sara.urkiaga@megaapp.tech,772687,ES92209532362570784285,1506.75,2023-06-01T19:22:35,Plentzia,incomes,salary_partner_bonus,1778.8,-5541.71
buyer_5,Sara,Urkiaga,1994-03-12,44623772T,sara.urkiaga@megaapp.tech,772687,ES92209532362570784285,1506.75,2023-06-01T19:10:31,Plentzia,expenses,leisure,-43.31,-5585.02
buyer_5,Sara,Urkiaga,1994-03-12,44623772T,sara.urkiaga@megaapp.tech,772687,ES92209532362570784285,1506.75,2023-06-01T18:02:02,Plentzia,expenses,clothing,-143.47,-5728.49
buyer_5,Sara,Urkiaga,1994-03-12,44623772T,sara.urkiaga@megaapp.tech,772687,ES92209532362570784285,1506.75,2023-06-02T10:44:33,Plentzia,expenses,taxes,-3585.45,-9313.94
buyer_5,Sara,Urkiaga,1994-03-12,44623772T,sara.urkiaga@megaapp.tech,772687,ES92209532362570784285,1506.75,2023-06-02T19:47:42,Plentzia,expenses,insurance,-1012.16,-10326.1
buyer_5,Sara,Urkiaga,1994-03-12,44623772T,sara.urkiaga@megaapp.tech,772687,ES92209532362570784285,1506.75,2023-06-02T11:15:45,Plentzia,expenses,leisure,-40.91,-10367.01
buyer_5,Sara,Urkiaga,1994-03-12,44623772T,sara.urkiaga@megaapp.tech,772687,ES92209532362570784285,1506.75,2023-06-04T15:58:24,Plentzia,expenses,leisure,-65.49,-10432.5
buyer_5,Sara,Urkiaga,1994-03-12,44623772T,sara.urkiaga@megaapp.tech,772687,ES92209532362570784285,1506.75,2023-06-05T15:42:34,Plentzia,expenses,mortgage,-1951.2,-12383.7
buyer_5,Sara,Urkiaga,1994-03-12,44623772T,sara.urkiaga@megaapp.tech,772687,ES92209532362570784285,1506.75,2023-06-05T18:06:43,Plentzia,expenses,internet,-102.28,-12485.98
buyer_5,Sara,Urkiaga,1994-03-12,44623772T,sara.urkiaga@megaapp.tech,772687,ES92209532362570784285,1506.75,2023-06-05T21:28:59,Plentzia,expenses,phone,-86.12,-12572.1
buyer_5,Sara,Urkiaga,1994-03-12,44623772T,sara.urkiaga@megaapp.tech,772687,ES92209532362570784285,1506.75,2023-06-05T23:32:56,Plentzia,expenses,gifts,-667.23,-13239.33
buyer_5,Sara,Urkiaga,1994-03-12,44623772T,sara.urkiaga@megaapp.tech,772687,ES92209532362570784285,1506.75,2023-06-06T14:05:11,Plentzia,expenses,electricity,-84.57,-13323.9
buyer_5,Sara,Urkiaga,1994-03-12,44623772T,sara.urkiaga@megaapp.tech,772687,ES92209532362570784285,1506.75,2023-06-06T16:25:01,Plentzia,expenses,gas,-138.34,-13462.24
buyer_5,Sara,Urkiaga,1994-03-12,44623772T,sara.urkiaga@megaapp.tech,772687,ES92209532362570784285,1506.75,2023-06-06T18:59:25,Plentzia,expenses,clothing,-103.91,-13566.15
buyer_5,Sara,Urkiaga,1994-03-12,44623772T,sara.urkiaga@megaapp.tech,772687,ES92209532362570784285,1506.75,2023-06-08T17:33:34,Plentzia,expenses,education,-78.41,-13644.56
buyer_5,Sara,Urkiaga,1994-03-12,44623772T,sara.urkiaga@megaapp.tech,772687,ES92209532362570784285,1506.75,2023-06-09T16:23:00,Plentzia,expenses,transport,-50.35,-13694.91
buyer_5,Sara,Urkiaga,1994-03-12,44623772T,sara.urkiaga@megaapp.tech,772687,ES92209532362570784285,1506.75,2023-06-09T08:25:39,Plentzia,expenses,repairs,-109.84,-13804.75
buyer_5,Sara,Urkiaga,1994-03-12,44623772T,sara.urkiaga@megaapp.tech,772687,ES92209532362570784285,1506.75,2023-06-11T17:57:47,Plentzia,expenses,gifts,-300.33,-14105.08
buyer_5,Sara,Urkiaga,1994-03-12,44623772T,sara.urkiaga@megaapp.tech,772687,ES92209532362570784285,1506.75,2023-06-12T08:07:21,Plentzia,expenses,cash,-100.0,-14205.08
buyer_5,Sara,Urkiaga,1994-03-12,44623772T,sara.urkiaga@megaapp.tech,772687,ES92209532362570784285,1506.75,2023-06-14T15:36:04,Plentzia,expenses,leisure,-61.01,-14266.09
buyer_5,Sara,Urkiaga,1994-03-12,44623772T,sara.urkiaga@megaapp.tech,772687,ES92209532362570784285,1506.75,2023-06-15T16:52:37,Plentzia,expenses,cash,-100.0,-14366.09
buyer_5,Sara,Urkiaga,1994-03-12,44623772T,sara.urkiaga@megaapp.tech,772687,ES92209532362570784285,1506.75,2023-06-17T09:49:44,Plentzia,expenses,healthcare,-174.14,-14540.23
buyer_5,Sara,Urkiaga,1994-03-12,44623772T,sara.urkiaga@megaapp.tech,772687,ES92209532362570784285,1506.75,2023-06-17T16:51:39,Plentzia,expenses,cash,-100.0,-14640.23
buyer_5,Sara,Urkiaga,1994-03-12,44623772T,sara.urkiaga@megaapp.tech,772687,ES92209532362570784285,1506.75,2023-06-18T16:42:25,Plentzia,expenses,clothing,-107.15,-14747.38
buyer_5,Sara,Urkiaga,1994-03-12,44623772T,sara.urkiaga@megaapp.tech,772687,ES92209532362570784285,1506.75,2023-06-20T19:34:18,Plentzia,expenses,healthcare,-159.61,-14906.99
buyer_5,Sara,Urkiaga,1994-03-12,44623772T,sara.urkiaga@megaapp.tech,772687,ES92209532362570784285,1506.75,2023-06-21T19:41:55,Plentzia,expenses,transport,-66.03,-14973.02
buyer_5,Sara,Urkiaga,1994-03-12,44623772T,sara.urkiaga@megaapp.tech,772687,ES92209532362570784285,1506.75,2023-06-22T20:47:54,Plentzia,expenses,cash,-100.0,-15073.02
buyer_5,Sara,Urkiaga,1994-03-12,44623772T,sara.urkiaga@megaapp.tech,772687,ES92209532362570784285,1506.75,2023-06-23T12:01:46,Plentzia,expenses,leisure,-53.5,-15126.52
buyer_5,Sara,Urkiaga,1994-03-12,44623772T,sara.urkiaga@megaapp.tech,772687,ES92209532362570784285,1506.75,2023-06-23T16:13:27,Plentzia,expenses,cash,-100.0,-15226.52
buyer_5,Sara,Urkiaga,1994-03-12,44623772T,sara.urkiaga@megaapp.tech,772687,ES92209532362570784285,1506.75,2023-06-25T12:47:59,Plentzia,expenses,leisure,-81.2,-15307.72
buyer_5,Sara,Urkiaga,1994-03-12,44623772T,sara.urkiaga@megaapp.tech,772687,ES92209532362570784285,1506.75,2023-06-29T17:17:17,Plentzia,expenses,food,-105.28,-15413.0
buyer_5,Sara,Urkiaga,1994-03-12,44623772T,sara.urkiaga@megaapp.tech,772687,ES92209532362570784285,1506.75,2023-06-30T10:29:57,Plentzia,expenses,cash,-100.0,-15513.0
buyer_5,Sara,Urkiaga,1994-03-12,44623772T,sara.urkiaga@megaapp.tech,772687,ES92209532362570784285,1506.75,2023-06-30T14:52:43,Plentzia,expenses,gifts,-488.47,-16001.47
buyer_5,Sara,Urkiaga,1994-03-12,44623772T,sara.urkiaga@megaapp.tech,772687,ES92209532362570784285,1506.75,2023-07-01T14:49:26,Plentzia,incomes,salary,2570.6,-13430.87
buyer_5,Sara,Urkiaga,1994-03-12,44623772T,sara.urkiaga@megaapp.tech,772687,ES92209532362570784285,1506.75,2023-07-01T14:49:26,Plentzia,incomes,salary_partner,2300.08,-11130.79
buyer_5,Sara,Urkiaga,1994-03-12,44623772T,sara.urkiaga@megaapp.tech,772687,ES92209532362570784285,1506.75,2023-07-01T10:11:17,Plentzia,expenses,leisure,-32.71,-11163.5
buyer_5,Sara,Urkiaga,1994-03-12,44623772T,sara.urkiaga@megaapp.tech,772687,ES92209532362570784285,1506.75,2023-07-01T10:59:51,Plentzia,expenses,cash,-100.0,-11263.5
buyer_5,Sara,Urkiaga,1994-03-12,44623772T,sara.urkiaga@megaapp.tech,772687,ES92209532362570784285,1506.75,2023-07-04T11:34:29,Plentzia,expenses,food,-103.34,-11366.84
buyer_5,Sara,Urkiaga,1994-03-12,44623772T,sara.urkiaga@megaapp.tech,772687,ES92209532362570784285,1506.75,2023-07-05T19:59:56,Plentzia,expenses,mortgage,-1951.2,-13318.04
buyer_5,Sara,Urkiaga,1994-03-12,44623772T,sara.urkiaga@megaapp.tech,772687,ES92209532362570784285,1506.75,2023-07-05T12:52:13,Plentzia,expenses,gas,-109.68,-13427.72
buyer_5,Sara,Urkiaga,1994-03-12,44623772T,sara.urkiaga@megaapp.tech,772687,ES92209532362570784285,1506.75,2023-07-06T00:14:54,Plentzia,expenses,electricity,-88.95,-13516.67
buyer_5,Sara,Urkiaga,1994-03-12,44623772T,sara.urkiaga@megaapp.tech,772687,ES92209532362570784285,1506.75,2023-07-06T17:20:11,Plentzia,expenses,internet,-102.28,-13618.95
buyer_5,Sara,Urkiaga,1994-03-12,44623772T,sara.urkiaga@megaapp.tech,772687,ES92209532362570784285,1506.75,2023-07-07T13:58:48,Plentzia,expenses,internet,-102.28,-13721.23
buyer_5,Sara,Urkiaga,1994-03-12,44623772T,sara.urkiaga@megaapp.tech,772687,ES92209532362570784285,1506.75,2023-07-07T11:45:15,Plentzia,expenses,food,-101.15,-13822.38
buyer_5,Sara,Urkiaga,1994-03-12,44623772T,sara.urkiaga@megaapp.tech,772687,ES92209532362570784285,1506.75,2023-07-08T19:13:12,Plentzia,expenses,cash,-100.0,-13922.38
buyer_5,Sara,Urkiaga,1994-03-12,44623772T,sara.urkiaga@megaapp.tech,772687,ES92209532362570784285,1506.75,2023-07-11T11:00:35,Plentzia,expenses,cash,-100.0,-14022.38
buyer_5,Sara,Urkiaga,1994-03-12,44623772T,sara.urkiaga@megaapp.tech,772687,ES92209532362570784285,1506.75,2023-07-12T21:14:48,Plentzia,expenses,transport,-46.93,-14069.31
buyer_5,Sara,Urkiaga,1994-03-12,44623772T,sara.urkiaga@megaapp.tech,772687,ES92209532362570784285,1506.75,2023-07-13T13:40:15,Plentzia,expenses,food,-98.46,-14167.77
buyer_5,Sara,Urkiaga,1994-03-12,44623772T,sara.urkiaga@megaapp.tech,772687,ES92209532362570784285,1506.75,2023-07-14T10:25:37,Plentzia,expenses,repairs,-232.35,-14400.12
buyer_5,Sara,Urkiaga,1994-03-12,44623772T,sara.urkiaga@megaapp.tech,772687,ES92209532362570784285,1506.75,2023-07-15T13:16:36,Plentzia,expenses,food,-64.38,-14464.5
buyer_5,Sara,Urkiaga,1994-03-12,44623772T,sara.urkiaga@megaapp.tech,772687,ES92209532362570784285,1506.75,2023-07-15T08:54:28,Plentzia,expenses,repairs,-169.01,-14633.51
buyer_5,Sara,Urkiaga,1994-03-12,44623772T,sara.urkiaga@megaapp.tech,772687,ES92209532362570784285,1506.75,2023-07-19T17:14:38,Plentzia,expenses,cash,-100.0,-14733.51
buyer_5,Sara,Urkiaga,1994-03-12,44623772T,sara.urkiaga@megaapp.tech,772687,ES92209532362570784285,1506.75,2023-07-21T07:33:30,Plentzia,expenses,food,-101.29,-14834.8
buyer_5,Sara,Urkiaga,1994-03-12,44623772T,sara.urkiaga@megaapp.tech,772687,ES92209532362570784285,1506.75,2023-07-22T20:34:05,Plentzia,expenses,gifts,-547.85,-15382.65
buyer_5,Sara,Urkiaga,1994-03-12,44623772T,sara.urkiaga@megaapp.tech,772687,ES92209532362570784285,1506.75,2023-07-23T18:22:23,Plentzia,expenses,cash,-100.0,-15482.65
buyer_5,Sara,Urkiaga,1994-03-12,44623772T,sara.urkiaga@megaapp.tech,772687,ES92209532362570784285,1506.75,2023-07-25T16:03:50,Plentzia,expenses,clothing,-78.68,-15561.33
buyer_5,Sara,Urkiaga,1994-03-12,44623772T,sara.urkiaga@megaapp.tech,772687,ES92209532362570784285,1506.75,2023-07-29T10:09:25,Plentzia,expenses,education,-66.89,-15628.22
buyer_5,Sara,Urkiaga,1994-03-12,44623772T,sara.urkiaga@megaapp.tech,772687,ES92209532362570784285,1506.75,2023-07-29T11:45:05,Plentzia,expenses,gifts,-674.61,-16302.83
buyer_5,Sara,Urkiaga,1994-03-12,44623772T,sara.urkiaga@megaapp.tech,772687,ES92209532362570784285,1506.75,2023-07-31T12:14:44,Plentzia,expenses,transport,-81.86,-16384.69
buyer_5,Sara,Urkiaga,1994-03-12,44623772T,sara.urkiaga@megaapp.tech,772687,ES92209532362570784285,1506.75,2023-07-31T16:58:30,Plentzia,expenses,education,-69.48,-16454.17
buyer_5,Sara,Urkiaga,1994-03-12,44623772T,sara.urkiaga@megaapp.tech,772687,ES92209532362570784285,1506.75,2023-08-01T19:40:32,Plentzia,incomes,salary,2570.6,-13883.57
buyer_5,Sara,Urkiaga,1994-03-12,44623772T,sara.urkiaga@megaapp.tech,772687,ES92209532362570784285,1506.75,2023-08-01T19:40:32,Plentzia,incomes,salary_partner,2300.08,-11583.49
buyer_5,Sara,Urkiaga,1994-03-12,44623772T,sara.urkiaga@megaapp.tech,772687,ES92209532362570784285,1506.75,2023-08-01T19:40:32,Plentzia,incomes,extra_income,471.47,-11112.02
buyer_5,Sara,Urkiaga,1994-03-12,44623772T,sara.urkiaga@megaapp.tech,772687,ES92209532362570784285,1506.75,2023-08-01T13:20:17,Plentzia,expenses,cash,-100.0,-11212.02
buyer_5,Sara,Urkiaga,1994-03-12,44623772T,sara.urkiaga@megaapp.tech,772687,ES92209532362570784285,1506.75,2023-08-01T11:58:13,Plentzia,expenses,gifts,-745.29,-11957.31
buyer_5,Sara,Urkiaga,1994-03-12,44623772T,sara.urkiaga@megaapp.tech,772687,ES92209532362570784285,1506.75,2023-08-02T12:42:37,Plentzia,expenses,repairs,-73.67,-12030.98
buyer_5,Sara,Urkiaga,1994-03-12,44623772T,sara.urkiaga@megaapp.tech,772687,ES92209532362570784285,1506.75,2023-08-04T09:44:46,Plentzia,expenses,education,-54.39,-12085.37
buyer_5,Sara,Urkiaga,1994-03-12,44623772T,sara.urkiaga@megaapp.tech,772687,ES92209532362570784285,1506.75,2023-08-04T17:57:27,Plentzia,expenses,repairs,-269.23,-12354.6
buyer_5,Sara,Urkiaga,1994-03-12,44623772T,sara.urkiaga@megaapp.tech,772687,ES92209532362570784285,1506.75,2023-08-05T16:26:06,Plentzia,expenses,mortgage,-1951.2,-14305.8
buyer_5,Sara,Urkiaga,1994-03-12,44623772T,sara.urkiaga@megaapp.tech,772687,ES92209532362570784285,1506.75,2023-08-07T11:26:34,Plentzia,expenses,gifts,-576.23,-14882.03
buyer_5,Sara,Urkiaga,1994-03-12,44623772T,sara.urkiaga@megaapp.tech,772687,ES92209532362570784285,1506.75,2023-08-08T12:01:06,Plentzia,expenses,gas,-278.39,-15160.42
buyer_5,Sara,Urkiaga,1994-03-12,44623772T,sara.urkiaga@megaapp.tech,772687,ES92209532362570784285,1506.75,2023-08-08T12:13:03,Plentzia,expenses,food,-66.48,-15226.9
buyer_5,Sara,Urkiaga,1994-03-12,44623772T,sara.urkiaga@megaapp.tech,772687,ES92209532362570784285,1506.75,2023-08-08T18:45:28,Plentzia,expenses,gifts,-186.35,-15413.25
buyer_5,Sara,Urkiaga,1994-03-12,44623772T,sara.urkiaga@megaapp.tech,772687,ES92209532362570784285,1506.75,2023-08-09T09:51:36,Plentzia,expenses,clothing,-143.68,-15556.93
buyer_5,Sara,Urkiaga,1994-03-12,44623772T,sara.urkiaga@megaapp.tech,772687,ES92209532362570784285,1506.75,2023-08-09T10:25:09,Plentzia,expenses,appliances,-324.14,-15881.07
buyer_5,Sara,Urkiaga,1994-03-12,44623772T,sara.urkiaga@megaapp.tech,772687,ES92209532362570784285,1506.75,2023-08-10T18:54:16,Plentzia,expenses,transport,-89.27,-15970.34
buyer_5,Sara,Urkiaga,1994-03-12,44623772T,sara.urkiaga@megaapp.tech,772687,ES92209532362570784285,1506.75,2023-08-11T23:16:20,Plentzia,expenses,transport,-54.51,-16024.85
buyer_5,Sara,Urkiaga,1994-03-12,44623772T,sara.urkiaga@megaapp.tech,772687,ES92209532362570784285,1506.75,2023-08-11T20:18:36,Plentzia,expenses,gifts,-164.1,-16188.95
buyer_5,Sara,Urkiaga,1994-03-12,44623772T,sara.urkiaga@megaapp.tech,772687,ES92209532362570784285,1506.75,2023-08-12T11:43:57,Plentzia,expenses,transport,-72.3,-16261.25
buyer_5,Sara,Urkiaga,1994-03-12,44623772T,sara.urkiaga@megaapp.tech,772687,ES92209532362570784285,1506.75,2023-08-12T11:31:34,Plentzia,expenses,travel,-752.42,-17013.67
buyer_5,Sara,Urkiaga,1994-03-12,44623772T,sara.urkiaga@megaapp.tech,772687,ES92209532362570784285,1506.75,2023-08-13T14:58:30,Plentzia,expenses,cash,-100.0,-17113.67
buyer_5,Sara,Urkiaga,1994-03-12,44623772T,sara.urkiaga@megaapp.tech,772687,ES92209532362570784285,1506.75,2023-08-14T15:01:00,Plentzia,expenses,cash,-100.0,-17213.67
buyer_5,Sara,Urkiaga,1994-03-12,44623772T,sara.urkiaga@megaapp.tech,772687,ES92209532362570784285,1506.75,2023-08-15T09:41:04,Plentzia,expenses,food,-94.69,-17308.36
buyer_5,Sara,Urkiaga,1994-03-12,44623772T,sara.urkiaga@megaapp.tech,772687,ES92209532362570784285,1506.75,2023-08-16T13:02:17,Plentzia,expenses,leisure,-60.78,-17369.14
buyer_5,Sara,Urkiaga,1994-03-12,44623772T,sara.urkiaga@megaapp.tech,772687,ES92209532362570784285,1506.75,2023-08-22T13:43:39,Plentzia,expenses,food,-68.76,-17437.9
buyer_5,Sara,Urkiaga,1994-03-12,44623772T,sara.urkiaga@megaapp.tech,772687,ES92209532362570784285,1506.75,2023-08-23T08:29:27,Plentzia,expenses,food,-60.16,-17498.06
buyer_5,Sara,Urkiaga,1994-03-12,44623772T,sara.urkiaga@megaapp.tech,772687,ES92209532362570784285,1506.75,2023-08-23T13:34:11,Plentzia,expenses,cash,-100.0,-17598.06
buyer_5,Sara,Urkiaga,1994-03-12,44623772T,sara.urkiaga@megaapp.tech,772687,ES92209532362570784285,1506.75,2023-08-26T15:50:55,Plentzia,expenses,food,-115.38,-17713.44
buyer_5,Sara,Urkiaga,1994-03-12,44623772T,sara.urkiaga@megaapp.tech,772687,ES92209532362570784285,1506.75,2023-08-27T13:38:56,Plentzia,expenses,food,-96.68,-17810.12
buyer_5,Sara,Urkiaga,1994-03-12,44623772T,sara.urkiaga@megaapp.tech,772687,ES92209532362570784285,1506.75,2023-08-27T12:00:31,Plentzia,expenses,transport,-50.68,-17860.8
buyer_5,Sara,Urkiaga,1994-03-12,44623772T,sara.urkiaga@megaapp.tech,772687,ES92209532362570784285,1506.75,2023-08-28T19:12:29,Plentzia,expenses,food,-96.38,-17957.18
buyer_5,Sara,Urkiaga,1994-03-12,44623772T,sara.urkiaga@megaapp.tech,772687,ES92209532362570784285,1506.75,2023-08-30T09:54:46,Plentzia,expenses,repairs,-213.17,-18170.35
buyer_5,Sara,Urkiaga,1994-03-12,44623772T,sara.urkiaga@megaapp.tech,772687,ES92209532362570784285,1506.75,2023-08-31T12:18:06,Plentzia,expenses,food,-74.13,-18244.48
buyer_5,Sara,Urkiaga,1994-03-12,44623772T,sara.urkiaga@megaapp.tech,772687,ES92209532362570784285,1506.75,2023-08-31T20:43:35,Plentzia,expenses,cash,-100.0,-18344.48
buyer_5,Sara,Urkiaga,1994-03-12,44623772T,sara.urkiaga@megaapp.tech,772687,ES92209532362570784285,1506.75,2023-09-01T13:45:49,Plentzia,incomes,salary,2570.6,-15773.88
buyer_5,Sara,Urkiaga,1994-03-12,44623772T,sara.urkiaga@megaapp.tech,772687,ES92209532362570784285,1506.75,2023-09-01T13:45:49,Plentzia,incomes,salary_partner,2300.08,-13473.8
buyer_5,Sara,Urkiaga,1994-03-12,44623772T,sara.urkiaga@megaapp.tech,772687,ES92209532362570784285,1506.75,2023-09-03T08:48:35,Plentzia,expenses,transport,-57.76,-13531.56
buyer_5,Sara,Urkiaga,1994-03-12,44623772T,sara.urkiaga@megaapp.tech,772687,ES92209532362570784285,1506.75,2023-09-05T11:21:11,Plentzia,expenses,mortgage,-1951.2,-15482.76
buyer_5,Sara,Urkiaga,1994-03-12,44623772T,sara.urkiaga@megaapp.tech,772687,ES92209532362570784285,1506.75,2023-09-05T10:06:00,Plentzia,expenses,internet,-102.28,-15585.04
buyer_5,Sara,Urkiaga,1994-03-12,44623772T,sara.urkiaga@megaapp.tech,772687,ES92209532362570784285,1506.75,2023-09-05T19:22:13,Plentzia,expenses,cash,-100.0,-15685.04
buyer_5,Sara,Urkiaga,1994-03-12,44623772T,sara.urkiaga@megaapp.tech,772687,ES92209532362570784285,1506.75,2023-09-06T14:56:32,Plentzia,expenses,water,-84.35,-15769.39
buyer_5,Sara,Urkiaga,1994-03-12,44623772T,sara.urkiaga@megaapp.tech,772687,ES92209532362570784285,1506.75,2023-09-06T19:51:30,Plentzia,expenses,gas,-117.27,-15886.66
buyer_5,Sara,Urkiaga,1994-03-12,44623772T,sara.urkiaga@megaapp.tech,772687,ES92209532362570784285,1506.75,2023-09-06T17:35:10,Plentzia,expenses,internet,-102.28,-15988.94
buyer_5,Sara,Urkiaga,1994-03-12,44623772T,sara.urkiaga@megaapp.tech,772687,ES92209532362570784285,1506.75,2023-09-06T09:33:00,Plentzia,expenses,leisure,-28.0,-16016.94
buyer_5,Sara,Urkiaga,1994-03-12,44623772T,sara.urkiaga@megaapp.tech,772687,ES92209532362570784285,1506.75,2023-09-06T14:19:54,Plentzia,expenses,repairs,-262.66,-16279.6
buyer_5,Sara,Urkiaga,1994-03-12,44623772T,sara.urkiaga@megaapp.tech,772687,ES92209532362570784285,1506.75,2023-09-07T13:38:50,Plentzia,expenses,phone,-88.12,-16367.72
buyer_5,Sara,Urkiaga,1994-03-12,44623772T,sara.urkiaga@megaapp.tech,772687,ES92209532362570784285,1506.75,2023-09-07T16:20:23,Plentzia,expenses,gifts,-60.83,-16428.55
buyer_5,Sara,Urkiaga,1994-03-12,44623772T,sara.urkiaga@megaapp.tech,772687,ES92209532362570784285,1506.75,2023-09-08T18:21:39,Plentzia,expenses,internet,-102.28,-16530.83
buyer_5,Sara,Urkiaga,1994-03-12,44623772T,sara.urkiaga@megaapp.tech,772687,ES92209532362570784285,1506.75,2023-09-08T03:20:21,Plentzia,expenses,phone,-104.08,-16634.91
buyer_5,Sara,Urkiaga,1994-03-12,44623772T,sara.urkiaga@megaapp.tech,772687,ES92209532362570784285,1506.75,2023-09-09T23:20:15,Plentzia,expenses,repairs,-78.68,-16713.59
buyer_5,Sara,Urkiaga,1994-03-12,44623772T,sara.urkiaga@megaapp.tech,772687,ES92209532362570784285,1506.75,2023-09-12T16:27:01,Plentzia,expenses,cash,-100.0,-16813.59
buyer_5,Sara,Urkiaga,1994-03-12,44623772T,sara.urkiaga@megaapp.tech,772687,ES92209532362570784285,1506.75,2023-09-13T19:51:37,Plentzia,expenses,food,-104.94,-16918.53
buyer_5,Sara,Urkiaga,1994-03-12,44623772T,sara.urkiaga@megaapp.tech,772687,ES92209532362570784285,1506.75,2023-09-13T16:49:21,Plentzia,expenses,transport,-81.19,-16999.72
buyer_5,Sara,Urkiaga,1994-03-12,44623772T,sara.urkiaga@megaapp.tech,772687,ES92209532362570784285,1506.75,2023-09-13T19:10:32,Plentzia,expenses,cash,-100.0,-17099.72
buyer_5,Sara,Urkiaga,1994-03-12,44623772T,sara.urkiaga@megaapp.tech,772687,ES92209532362570784285,1506.75,2023-09-14T20:52:27,Plentzia,expenses,repairs,-196.83,-17296.55
buyer_5,Sara,Urkiaga,1994-03-12,44623772T,sara.urkiaga@megaapp.tech,772687,ES92209532362570784285,1506.75,2023-09-15T23:22:16,Plentzia,expenses,cash,-100.0,-17396.55
buyer_5,Sara,Urkiaga,1994-03-12,44623772T,sara.urkiaga@megaapp.tech,772687,ES92209532362570784285,1506.75,2023-09-17T18:14:36,Plentzia,expenses,appliances,-173.2,-17569.75
buyer_5,Sara,Urkiaga,1994-03-12,44623772T,sara.urkiaga@megaapp.tech,772687,ES92209532362570784285,1506.75,2023-09-22T10:41:02,Plentzia,expenses,leisure,-60.35,-17630.1
buyer_5,Sara,Urkiaga,1994-03-12,44623772T,sara.urkiaga@megaapp.tech,772687,ES92209532362570784285,1506.75,2023-09-22T17:35:43,Plentzia,expenses,education,-73.07,-17703.17
buyer_5,Sara,Urkiaga,1994-03-12,44623772T,sara.urkiaga@megaapp.tech,772687,ES92209532362570784285,1506.75,2023-09-25T17:23:01,Plentzia,expenses,clothing,-82.79,-17785.96
buyer_5,Sara,Urkiaga,1994-03-12,44623772T,sara.urkiaga@megaapp.tech,772687,ES92209532362570784285,1506.75,2023-09-25T17:31:10,Plentzia,expenses,education,-65.31,-17851.27
buyer_5,Sara,Urkiaga,1994-03-12,44623772T,sara.urkiaga@megaapp.tech,772687,ES92209532362570784285,1506.75,2023-09-26T23:31:56,Plentzia,expenses,food,-113.63,-17964.9
buyer_5,Sara,Urkiaga,1994-03-12,44623772T,sara.urkiaga@megaapp.tech,772687,ES92209532362570784285,1506.75,2023-09-27T18:20:27,Plentzia,expenses,clothing,-88.74,-18053.64
buyer_5,Sara,Urkiaga,1994-03-12,44623772T,sara.urkiaga@megaapp.tech,772687,ES92209532362570784285,1506.75,2023-09-30T15:39:05,Plentzia,expenses,cash,-100.0,-18153.64
buyer_5,Sara,Urkiaga,1994-03-12,44623772T,sara.urkiaga@megaapp.tech,772687,ES92209532362570784285,1506.75,2023-10-01T14:48:50,Plentzia,incomes,salary,2570.6,-15583.04
buyer_5,Sara,Urkiaga,1994-03-12,44623772T,sara.urkiaga@megaapp.tech,772687,ES92209532362570784285,1506.75,2023-10-01T14:48:50,Plentzia,incomes,salary_partner,2300.08,-13282.96
buyer_5,Sara,Urkiaga,1994-03-12,44623772T,sara.urkiaga@megaapp.tech,772687,ES92209532362570784285,1506.75,2023-10-01T11:38:17,Plentzia,expenses,healthcare,-132.36,-13415.32
buyer_5,Sara,Urkiaga,1994-03-12,44623772T,sara.urkiaga@megaapp.tech,772687,ES92209532362570784285,1506.75,2023-10-03T09:26:30,Plentzia,expenses,cash,-100.0,-13515.32
buyer_5,Sara,Urkiaga,1994-03-12,44623772T,sara.urkiaga@megaapp.tech,772687,ES92209532362570784285,1506.75,2023-10-05T17:17:15,Plentzia,expenses,mortgage,-1951.2,-15466.52
buyer_5,Sara,Urkiaga,1994-03-12,44623772T,sara.urkiaga@megaapp.tech,772687,ES92209532362570784285,1506.75,2023-10-06T19:02:35,Plentzia,expenses,water,-108.24,-15574.76
buyer_5,Sara,Urkiaga,1994-03-12,44623772T,sara.urkiaga@megaapp.tech,772687,ES92209532362570784285,1506.75,2023-10-06T17:12:00,Plentzia,expenses,cash,-100.0,-15674.76
buyer_5,Sara,Urkiaga,1994-03-12,44623772T,sara.urkiaga@megaapp.tech,772687,ES92209532362570784285,1506.75,2023-10-07T08:55:00,Plentzia,expenses,healthcare,-181.26,-15856.02
buyer_5,Sara,Urkiaga,1994-03-12,44623772T,sara.urkiaga@megaapp.tech,772687,ES92209532362570784285,1506.75,2023-10-08T19:07:32,Plentzia,expenses,electricity,-84.18,-15940.2
buyer_5,Sara,Urkiaga,1994-03-12,44623772T,sara.urkiaga@megaapp.tech,772687,ES92209532362570784285,1506.75,2023-10-08T08:00:43,Plentzia,expenses,gas,-114.24,-16054.44
buyer_5,Sara,Urkiaga,1994-03-12,44623772T,sara.urkiaga@megaapp.tech,772687,ES92209532362570784285,1506.75,2023-10-08T16:43:22,Plentzia,expenses,leisure,-80.89,-16135.33
buyer_5,Sara,Urkiaga,1994-03-12,44623772T,sara.urkiaga@megaapp.tech,772687,ES92209532362570784285,1506.75,2023-10-09T13:06:32,Plentzia,expenses,food,-71.3,-16206.63
buyer_5,Sara,Urkiaga,1994-03-12,44623772T,sara.urkiaga@megaapp.tech,772687,ES92209532362570784285,1506.75,2023-10-09T17:01:14,Plentzia,expenses,cash,-100.0,-16306.63
buyer_5,Sara,Urkiaga,1994-03-12,44623772T,sara.urkiaga@megaapp.tech,772687,ES92209532362570784285,1506.75,2023-10-10T08:08:53,Plentzia,expenses,repairs,-278.9,-16585.53
buyer_5,Sara,Urkiaga,1994-03-12,44623772T,sara.urkiaga@megaapp.tech,772687,ES92209532362570784285,1506.75,2023-10-13T14:49:08,Plentzia,expenses,repairs,-41.91,-16627.44
buyer_5,Sara,Urkiaga,1994-03-12,44623772T,sara.urkiaga@megaapp.tech,772687,ES92209532362570784285,1506.75,2023-10-14T14:19:00,Plentzia,expenses,transport,-47.3,-16674.74
buyer_5,Sara,Urkiaga,1994-03-12,44623772T,sara.urkiaga@megaapp.tech,772687,ES92209532362570784285,1506.75,2023-10-15T13:30:28,Plentzia,expenses,transport,-59.46,-16734.2
buyer_5,Sara,Urkiaga,1994-03-12,44623772T,sara.urkiaga@megaapp.tech,772687,ES92209532362570784285,1506.75,2023-10-15T07:17:28,Plentzia,expenses,cash,-100.0,-16834.2
buyer_5,Sara,Urkiaga,1994-03-12,44623772T,sara.urkiaga@megaapp.tech,772687,ES92209532362570784285,1506.75,2023-10-16T16:11:31,Plentzia,expenses,food,-92.16,-16926.36
buyer_5,Sara,Urkiaga,1994-03-12,44623772T,sara.urkiaga@megaapp.tech,772687,ES92209532362570784285,1506.75,2023-10-19T17:06:19,Plentzia,expenses,transport,-42.4,-16968.76
buyer_5,Sara,Urkiaga,1994-03-12,44623772T,sara.urkiaga@megaapp.tech,772687,ES92209532362570784285,1506.75,2023-10-21T09:35:21,Plentzia,expenses,food,-97.87,-17066.63
buyer_5,Sara,Urkiaga,1994-03-12,44623772T,sara.urkiaga@megaapp.tech,772687,ES92209532362570784285,1506.75,2023-10-21T03:38:46,Plentzia,expenses,transport,-50.71,-17117.34
buyer_5,Sara,Urkiaga,1994-03-12,44623772T,sara.urkiaga@megaapp.tech,772687,ES92209532362570784285,1506.75,2023-10-21T20:42:11,Plentzia,expenses,gifts,-303.74,-17421.08
buyer_5,Sara,Urkiaga,1994-03-12,44623772T,sara.urkiaga@megaapp.tech,772687,ES92209532362570784285,1506.75,2023-10-22T18:43:34,Plentzia,expenses,appliances,-376.9,-17797.98
buyer_5,Sara,Urkiaga,1994-03-12,44623772T,sara.urkiaga@megaapp.tech,772687,ES92209532362570784285,1506.75,2023-10-24T11:25:07,Plentzia,expenses,repairs,-331.59,-18129.57
buyer_5,Sara,Urkiaga,1994-03-12,44623772T,sara.urkiaga@megaapp.tech,772687,ES92209532362570784285,1506.75,2023-10-26T15:54:31,Plentzia,expenses,transport,-81.32,-18210.89
buyer_5,Sara,Urkiaga,1994-03-12,44623772T,sara.urkiaga@megaapp.tech,772687,ES92209532362570784285,1506.75,2023-10-26T11:40:14,Plentzia,expenses,education,-59.31,-18270.2
buyer_5,Sara,Urkiaga,1994-03-12,44623772T,sara.urkiaga@megaapp.tech,772687,ES92209532362570784285,1506.75,2023-10-28T13:31:01,Plentzia,expenses,transport,-52.03,-18322.23
buyer_5,Sara,Urkiaga,1994-03-12,44623772T,sara.urkiaga@megaapp.tech,772687,ES92209532362570784285,1506.75,2023-10-28T13:18:31,Plentzia,expenses,healthcare,-182.29,-18504.52
buyer_5,Sara,Urkiaga,1994-03-12,44623772T,sara.urkiaga@megaapp.tech,772687,ES92209532362570784285,1506.75,2023-10-31T10:52:31,Plentzia,expenses,leisure,-79.0,-18583.52
buyer_5,Sara,Urkiaga,1994-03-12,44623772T,sara.urkiaga@megaapp.tech,772687,ES92209532362570784285,1506.75,2023-11-01T15:29:01,Plentzia,incomes,salary,2570.6,-16012.92
buyer_5,Sara,Urkiaga,1994-03-12,44623772T,sara.urkiaga@megaapp.tech,772687,ES92209532362570784285,1506.75,2023-11-01T15:29:01,Plentzia,incomes,salary_partner,2300.08,-13712.84
buyer_5,Sara,Urkiaga,1994-03-12,44623772T,sara.urkiaga@megaapp.tech,772687,ES92209532362570784285,1506.75,2023-11-01T15:29:01,Plentzia,incomes,extra_income,471.47,-13241.37
buyer_5,Sara,Urkiaga,1994-03-12,44623772T,sara.urkiaga@megaapp.tech,772687,ES92209532362570784285,1506.75,2023-11-01T13:26:42,Plentzia,expenses,food,-86.77,-13328.14
buyer_5,Sara,Urkiaga,1994-03-12,44623772T,sara.urkiaga@megaapp.tech,772687,ES92209532362570784285,1506.75,2023-11-02T14:07:12,Plentzia,expenses,food,-116.46,-13444.6
buyer_5,Sara,Urkiaga,1994-03-12,44623772T,sara.urkiaga@megaapp.tech,772687,ES92209532362570784285,1506.75,2023-11-03T20:06:55,Plentzia,expenses,transport,-50.36,-13494.96
buyer_5,Sara,Urkiaga,1994-03-12,44623772T,sara.urkiaga@megaapp.tech,772687,ES92209532362570784285,1506.75,2023-11-03T20:08:52,Plentzia,expenses,cash,-100.0,-13594.96
buyer_5,Sara,Urkiaga,1994-03-12,44623772T,sara.urkiaga@megaapp.tech,772687,ES92209532362570784285,1506.75,2023-11-03T12:37:56,Plentzia,expenses,repairs,-197.54,-13792.5
buyer_5,Sara,Urkiaga,1994-03-12,44623772T,sara.urkiaga@megaapp.tech,772687,ES92209532362570784285,1506.75,2023-11-04T15:44:25,Plentzia,expenses,food,-89.35,-13881.85
buyer_5,Sara,Urkiaga,1994-03-12,44623772T,sara.urkiaga@megaapp.tech,772687,ES92209532362570784285,1506.75,2023-11-04T20:18:49,Plentzia,expenses,healthcare,-47.88,-13929.73
buyer_5,Sara,Urkiaga,1994-03-12,44623772T,sara.urkiaga@megaapp.tech,772687,ES92209532362570784285,1506.75,2023-11-04T23:52:04,Plentzia,expenses,cash,-100.0,-14029.73
buyer_5,Sara,Urkiaga,1994-03-12,44623772T,sara.urkiaga@megaapp.tech,772687,ES92209532362570784285,1506.75,2023-11-05T20:33:02,Plentzia,expenses,mortgage,-1951.2,-15980.93
buyer_5,Sara,Urkiaga,1994-03-12,44623772T,sara.urkiaga@megaapp.tech,772687,ES92209532362570784285,1506.75,2023-11-05T16:15:34,Plentzia,expenses,internet,-102.28,-16083.21
buyer_5,Sara,Urkiaga,1994-03-12,44623772T,sara.urkiaga@megaapp.tech,772687,ES92209532362570784285,1506.75,2023-11-06T10:30:46,Plentzia,expenses,phone,-80.13,-16163.34
buyer_5,Sara,Urkiaga,1994-03-12,44623772T,sara.urkiaga@megaapp.tech,772687,ES92209532362570784285,1506.75,2023-11-06T09:18:31,Plentzia,expenses,leisure,-50.05,-16213.39
buyer_5,Sara,Urkiaga,1994-03-12,44623772T,sara.urkiaga@megaapp.tech,772687,ES92209532362570784285,1506.75,2023-11-06T06:37:05,Plentzia,expenses,appliances,-377.32,-16590.71
buyer_5,Sara,Urkiaga,1994-03-12,44623772T,sara.urkiaga@megaapp.tech,772687,ES92209532362570784285,1506.75,2023-11-08T15:11:50,Plentzia,expenses,transport,-62.93,-16653.64
buyer_5,Sara,Urkiaga,1994-03-12,44623772T,sara.urkiaga@megaapp.tech,772687,ES92209532362570784285,1506.75,2023-11-09T13:08:03,Plentzia,expenses,food,-81.68,-16735.32
buyer_5,Sara,Urkiaga,1994-03-12,44623772T,sara.urkiaga@megaapp.tech,772687,ES92209532362570784285,1506.75,2023-11-09T15:11:23,Plentzia,expenses,cash,-100.0,-16835.32
buyer_5,Sara,Urkiaga,1994-03-12,44623772T,sara.urkiaga@megaapp.tech,772687,ES92209532362570784285,1506.75,2023-11-13T18:55:47,Plentzia,expenses,transport,-88.17,-16923.49
buyer_5,Sara,Urkiaga,1994-03-12,44623772T,sara.urkiaga@megaapp.tech,772687,ES92209532362570784285,1506.75,2023-11-13T12:13:25,Plentzia,expenses,leisure,-72.91,-16996.4
buyer_5,Sara,Urkiaga,1994-03-12,44623772T,sara.urkiaga@megaapp.tech,772687,ES92209532362570784285,1506.75,2023-11-14T10:32:59,Plentzia,expenses,cash,-100.0,-17096.4
buyer_5,Sara,Urkiaga,1994-03-12,44623772T,sara.urkiaga@megaapp.tech,772687,ES92209532362570784285,1506.75,2023-11-14T15:32:28,Plentzia,expenses,repairs,-289.92,-17386.32
buyer_5,Sara,Urkiaga,1994-03-12,44623772T,sara.urkiaga@megaapp.tech,772687,ES92209532362570784285,1506.75,2023-11-15T15:08:47,Plentzia,expenses,food,-98.66,-17484.98
buyer_5,Sara,Urkiaga,1994-03-12,44623772T,sara.urkiaga@megaapp.tech,772687,ES92209532362570784285,1506.75,2023-11-15T10:01:24,Plentzia,expenses,travel,-304.9,-17789.88
buyer_5,Sara,Urkiaga,1994-03-12,44623772T,sara.urkiaga@megaapp.tech,772687,ES92209532362570784285,1506.75,2023-11-18T18:46:46,Plentzia,expenses,transport,-43.21,-17833.09
buyer_5,Sara,Urkiaga,1994-03-12,44623772T,sara.urkiaga@megaapp.tech,772687,ES92209532362570784285,1506.75,2023-11-19T21:57:00,Plentzia,expenses,cash,-100.0,-17933.09
buyer_5,Sara,Urkiaga,1994-03-12,44623772T,sara.urkiaga@megaapp.tech,772687,ES92209532362570784285,1506.75,2023-11-20T09:09:54,Plentzia,expenses,cash,-100.0,-18033.09
buyer_5,Sara,Urkiaga,1994-03-12,44623772T,sara.urkiaga@megaapp.tech,772687,ES92209532362570784285,1506.75,2023-11-21T11:02:10,Plentzia,expenses,leisure,-26.75,-18059.84
buyer_5,Sara,Urkiaga,1994-03-12,44623772T,sara.urkiaga@megaapp.tech,772687,ES92209532362570784285,1506.75,2023-11-22T15:13:41,Plentzia,expenses,transport,-67.09,-18126.93
buyer_5,Sara,Urkiaga,1994-03-12,44623772T,sara.urkiaga@megaapp.tech,772687,ES92209532362570784285,1506.75,2023-11-22T13:10:53,Plentzia,expenses,appliances,-346.72,-18473.65
buyer_5,Sara,Urkiaga,1994-03-12,44623772T,sara.urkiaga@megaapp.tech,772687,ES92209532362570784285,1506.75,2023-11-23T20:23:26,Plentzia,expenses,repairs,-148.57,-18622.22
buyer_5,Sara,Urkiaga,1994-03-12,44623772T,sara.urkiaga@megaapp.tech,772687,ES92209532362570784285,1506.75,2023-11-24T19:41:26,Plentzia,expenses,transport,-80.53,-18702.75
buyer_5,Sara,Urkiaga,1994-03-12,44623772T,sara.urkiaga@megaapp.tech,772687,ES92209532362570784285,1506.75,2023-11-24T21:44:10,Plentzia,expenses,healthcare,-64.12,-18766.87
buyer_5,Sara,Urkiaga,1994-03-12,44623772T,sara.urkiaga@megaapp.tech,772687,ES92209532362570784285,1506.75,2023-11-28T12:34:20,Plentzia,expenses,education,-63.89,-18830.76
buyer_5,Sara,Urkiaga,1994-03-12,44623772T,sara.urkiaga@megaapp.tech,772687,ES92209532362570784285,1506.75,2023-11-28T18:46:09,Plentzia,expenses,cash,-100.0,-18930.76
buyer_5,Sara,Urkiaga,1994-03-12,44623772T,sara.urkiaga@megaapp.tech,772687,ES92209532362570784285,1506.75,2023-12-01T07:02:40,Plentzia,incomes,salary,2570.6,-16360.16
buyer_5,Sara,Urkiaga,1994-03-12,44623772T,sara.urkiaga@megaapp.tech,772687,ES92209532362570784285,1506.75,2023-12-01T07:02:40,Plentzia,incomes,salary_partner,2300.08,-14060.08
buyer_5,Sara,Urkiaga,1994-03-12,44623772T,sara.urkiaga@megaapp.tech,772687,ES92209532362570784285,1506.75,2023-12-01T07:02:40,Plentzia,incomes,salary_bonus,1836.42,-12223.66
buyer_5,Sara,Urkiaga,1994-03-12,44623772T,sara.urkiaga@megaapp.tech,772687,ES92209532362570784285,1506.75,2023-12-01T07:02:40,Plentzia,incomes,salary_partner_bonus,1724.17,-10499.49
buyer_5,Sara,Urkiaga,1994-03-12,44623772T,sara.urkiaga@megaapp.tech,772687,ES92209532362570784285,1506.75,2023-12-03T00:55:07,Plentzia,expenses,transport,-70.13,-10569.62
buyer_5,Sara,Urkiaga,1994-03-12,44623772T,sara.urkiaga@megaapp.tech,772687,ES92209532362570784285,1506.75,2023-12-04T10:27:00,Plentzia,expenses,food,-66.16,-10635.78
buyer_5,Sara,Urkiaga,1994-03-12,44623772T,sara.urkiaga@megaapp.tech,772687,ES92209532362570784285,1506.75,2023-12-05T10:40:54,Plentzia,expenses,mortgage,-1951.2,-12586.98
buyer_5,Sara,Urkiaga,1994-03-12,44623772T,sara.urkiaga@megaapp.tech,772687,ES92209532362570784285,1506.75,2023-12-05T18:38:04,Plentzia,expenses,water,-83.06,-12670.04
buyer_5,Sara,Urkiaga,1994-03-12,44623772T,sara.urkiaga@megaapp.tech,772687,ES92209532362570784285,1506.75,2023-12-05T08:52:16,Plentzia,expenses,internet,-102.28,-12772.32
buyer_5,Sara,Urkiaga,1994-03-12,44623772T,sara.urkiaga@megaapp.tech,772687,ES92209532362570784285,1506.75,2023-12-05T15:43:22,Plentzia,expenses,food,-95.97,-12868.29
buyer_5,Sara,Urkiaga,1994-03-12,44623772T,sara.urkiaga@megaapp.tech,772687,ES92209532362570784285,1506.75,2023-12-06T14:29:38,Plentzia,expenses,internet,-102.28,-12970.57
buyer_5,Sara,Urkiaga,1994-03-12,44623772T,sara.urkiaga@megaapp.tech,772687,ES92209532362570784285,1506.75,2023-12-07T08:26:11,Plentzia,expenses,water,-108.31,-13078.88
buyer_5,Sara,Urkiaga,1994-03-12,44623772T,sara.urkiaga@megaapp.tech,772687,ES92209532362570784285,1506.75,2023-12-07T21:22:09,Plentzia,expenses,gas,-191.11,-13269.99
buyer_5,Sara,Urkiaga,1994-03-12,44623772T,sara.urkiaga@megaapp.tech,772687,ES92209532362570784285,1506.75,2023-12-07T13:05:42,Plentzia,expenses,internet,-102.28,-13372.27
buyer_5,Sara,Urkiaga,1994-03-12,44623772T,sara.urkiaga@megaapp.tech,772687,ES92209532362570784285,1506.75,2023-12-07T02:00:17,Plentzia,expenses,phone,-75.71,-13447.98
buyer_5,Sara,Urkiaga,1994-03-12,44623772T,sara.urkiaga@megaapp.tech,772687,ES92209532362570784285,1506.75,2023-12-07T14:19:06,Plentzia,expenses,leisure,-81.8,-13529.78
buyer_5,Sara,Urkiaga,1994-03-12,44623772T,sara.urkiaga@megaapp.tech,772687,ES92209532362570784285,1506.75,2023-12-08T14:31:41,Plentzia,expenses,electricity,-212.64,-13742.42
buyer_5,Sara,Urkiaga,1994-03-12,44623772T,sara.urkiaga@megaapp.tech,772687,ES92209532362570784285,1506.75,2023-12-08T09:46:35,Plentzia,expenses,internet,-102.28,-13844.7
buyer_5,Sara,Urkiaga,1994-03-12,44623772T,sara.urkiaga@megaapp.tech,772687,ES92209532362570784285,1506.75,2023-12-08T20:03:27,Plentzia,expenses,food,-68.09,-13912.79
buyer_5,Sara,Urkiaga,1994-03-12,44623772T,sara.urkiaga@megaapp.tech,772687,ES92209532362570784285,1506.75,2023-12-09T15:23:22,Plentzia,expenses,food,-73.36,-13986.15
buyer_5,Sara,Urkiaga,1994-03-12,44623772T,sara.urkiaga@megaapp.tech,772687,ES92209532362570784285,1506.75,2023-12-09T14:59:40,Plentzia,expenses,clothing,-50.33,-14036.48
buyer_5,Sara,Urkiaga,1994-03-12,44623772T,sara.urkiaga@megaapp.tech,772687,ES92209532362570784285,1506.75,2023-12-11T12:58:15,Plentzia,expenses,food,-95.38,-14131.86
buyer_5,Sara,Urkiaga,1994-03-12,44623772T,sara.urkiaga@megaapp.tech,772687,ES92209532362570784285,1506.75,2023-12-11T08:10:45,Plentzia,expenses,transport,-83.29,-14215.15
buyer_5,Sara,Urkiaga,1994-03-12,44623772T,sara.urkiaga@megaapp.tech,772687,ES92209532362570784285,1506.75,2023-12-11T13:09:39,Plentzia,expenses,healthcare,-125.02,-14340.17
buyer_5,Sara,Urkiaga,1994-03-12,44623772T,sara.urkiaga@megaapp.tech,772687,ES92209532362570784285,1506.75,2023-12-12T18:00:52,Plentzia,expenses,leisure,-47.8,-14387.97
buyer_5,Sara,Urkiaga,1994-03-12,44623772T,sara.urkiaga@megaapp.tech,772687,ES92209532362570784285,1506.75,2023-12-12T12:26:23,Plentzia,expenses,cash,-100.0,-14487.97
buyer_5,Sara,Urkiaga,1994-03-12,44623772T,sara.urkiaga@megaapp.tech,772687,ES92209532362570784285,1506.75,2023-12-13T13:10:41,Plentzia,expenses,education,-44.5,-14532.47
buyer_5,Sara,Urkiaga,1994-03-12,44623772T,sara.urkiaga@megaapp.tech,772687,ES92209532362570784285,1506.75,2023-12-15T16:08:43,Plentzia,expenses,healthcare,-79.96,-14612.43
buyer_5,Sara,Urkiaga,1994-03-12,44623772T,sara.urkiaga@megaapp.tech,772687,ES92209532362570784285,1506.75,2023-12-16T13:50:44,Plentzia,expenses,food,-71.0,-14683.43
buyer_5,Sara,Urkiaga,1994-03-12,44623772T,sara.urkiaga@megaapp.tech,772687,ES92209532362570784285,1506.75,2023-12-18T09:09:19,Plentzia,expenses,food,-76.14,-14759.57
buyer_5,Sara,Urkiaga,1994-03-12,44623772T,sara.urkiaga@megaapp.tech,772687,ES92209532362570784285,1506.75,2023-12-21T10:14:53,Plentzia,expenses,cash,-100.0,-14859.57
buyer_5,Sara,Urkiaga,1994-03-12,44623772T,sara.urkiaga@megaapp.tech,772687,ES92209532362570784285,1506.75,2023-12-26T12:50:36,Plentzia,expenses,transport,-68.98,-14928.55
buyer_5,Sara,Urkiaga,1994-03-12,44623772T,sara.urkiaga@megaapp.tech,772687,ES92209532362570784285,1506.75,2023-12-28T08:18:12,Plentzia,expenses,leisure,-48.58,-14977.13
buyer_5,Sara,Urkiaga,1994-03-12,44623772T,sara.urkiaga@megaapp.tech,772687,ES92209532362570784285,1506.75,2023-12-28T08:13:51,Plentzia,expenses,repairs,-186.32,-15163.45
buyer_5,Sara,Urkiaga,1994-03-12,44623772T,sara.urkiaga@megaapp.tech,772687,ES92209532362570784285,1506.75,2023-12-31T20:02:02,Plentzia,expenses,cash,-100.0,-15263.45
buyer_5,Sara,Urkiaga,1994-03-12,44623772T,sara.urkiaga@megaapp.tech,772687,ES92209532362570784285,1506.75,2024-01-01T10:19:06,Plentzia,incomes,salary,2658.63,-12604.82
buyer_5,Sara,Urkiaga,1994-03-12,44623772T,sara.urkiaga@megaapp.tech,772687,ES92209532362570784285,1506.75,2024-01-01T10:19:06,Plentzia,incomes,salary_partner,2378.85,-10225.97
buyer_5,Sara,Urkiaga,1994-03-12,44623772T,sara.urkiaga@megaapp.tech,772687,ES92209532362570784285,1506.75,2024-01-01T12:05:13,Plentzia,expenses,leisure,-38.65,-10264.62
buyer_5,Sara,Urkiaga,1994-03-12,44623772T,sara.urkiaga@megaapp.tech,772687,ES92209532362570784285,1506.75,2024-01-02T00:33:36,Plentzia,expenses,leisure,-18.88,-10283.5
buyer_5,Sara,Urkiaga,1994-03-12,44623772T,sara.urkiaga@megaapp.tech,772687,ES92209532362570784285,1506.75,2024-01-03T11:49:59,Plentzia,expenses,cash,-100.0,-10383.5
buyer_5,Sara,Urkiaga,1994-03-12,44623772T,sara.urkiaga@megaapp.tech,772687,ES92209532362570784285,1506.75,2024-01-04T11:46:55,Plentzia,expenses,cash,-100.0,-10483.5
buyer_5,Sara,Urkiaga,1994-03-12,44623772T,sara.urkiaga@megaapp.tech,772687,ES92209532362570784285,1506.75,2024-01-05T23:55:09,Plentzia,expenses,mortgage,-2604.95,-13088.45
buyer_5,Sara,Urkiaga,1994-03-12,44623772T,sara.urkiaga@megaapp.tech,772687,ES92209532362570784285,1506.75,2024-01-05T16:22:01,Plentzia,expenses,clothing,-95.56,-13184.01
buyer_5,Sara,Urkiaga,1994-03-12,44623772T,sara.urkiaga@megaapp.tech,772687,ES92209532362570784285,1506.75,2024-01-05T13:27:56,Plentzia,expenses,cash,-100.0,-13284.01
buyer_5,Sara,Urkiaga,1994-03-12,44623772T,sara.urkiaga@megaapp.tech,772687,ES92209532362570784285,1506.75,2024-01-06T04:20:08,Plentzia,expenses,electricity,-172.23,-13456.24
buyer_5,Sara,Urkiaga,1994-03-12,44623772T,sara.urkiaga@megaapp.tech,772687,ES92209532362570784285,1506.75,2024-01-06T17:18:36,Plentzia,expenses,food,-89.16,-13545.4
buyer_5,Sara,Urkiaga,1994-03-12,44623772T,sara.urkiaga@megaapp.tech,772687,ES92209532362570784285,1506.75,2024-01-06T11:49:05,Plentzia,expenses,travel,-462.82,-14008.22
buyer_5,Sara,Urkiaga,1994-03-12,44623772T,sara.urkiaga@megaapp.tech,772687,ES92209532362570784285,1506.75,2024-01-07T14:57:50,Plentzia,expenses,gas,-225.42,-14233.64
buyer_5,Sara,Urkiaga,1994-03-12,44623772T,sara.urkiaga@megaapp.tech,772687,ES92209532362570784285,1506.75,2024-01-07T13:43:17,Plentzia,expenses,phone,-76.92,-14310.56
buyer_5,Sara,Urkiaga,1994-03-12,44623772T,sara.urkiaga@megaapp.tech,772687,ES92209532362570784285,1506.75,2024-01-08T19:18:50,Plentzia,expenses,gifts,-574.83,-14885.39
buyer_5,Sara,Urkiaga,1994-03-12,44623772T,sara.urkiaga@megaapp.tech,772687,ES92209532362570784285,1506.75,2024-01-09T18:22:48,Plentzia,expenses,food,-105.14,-14990.53
buyer_5,Sara,Urkiaga,1994-03-12,44623772T,sara.urkiaga@megaapp.tech,772687,ES92209532362570784285,1506.75,2024-01-10T11:20:40,Plentzia,expenses,repairs,-27.34,-15017.87
buyer_5,Sara,Urkiaga,1994-03-12,44623772T,sara.urkiaga@megaapp.tech,772687,ES92209532362570784285,1506.75,2024-01-12T18:35:13,Plentzia,expenses,cash,-100.0,-15117.87
buyer_5,Sara,Urkiaga,1994-03-12,44623772T,sara.urkiaga@megaapp.tech,772687,ES92209532362570784285,1506.75,2024-01-14T20:38:42,Plentzia,expenses,gifts,-588.15,-15706.02
buyer_5,Sara,Urkiaga,1994-03-12,44623772T,sara.urkiaga@megaapp.tech,772687,ES92209532362570784285,1506.75,2024-01-16T17:26:15,Plentzia,expenses,food,-100.21,-15806.23
buyer_5,Sara,Urkiaga,1994-03-12,44623772T,sara.urkiaga@megaapp.tech,772687,ES92209532362570784285,1506.75,2024-01-21T12:27:14,Plentzia,expenses,food,-64.21,-15870.44
buyer_5,Sara,Urkiaga,1994-03-12,44623772T,sara.urkiaga@megaapp.tech,772687,ES92209532362570784285,1506.75,2024-01-22T01:14:40,Plentzia,expenses,cash,-100.0,-15970.44
buyer_5,Sara,Urkiaga,1994-03-12,44623772T,sara.urkiaga@megaapp.tech,772687,ES92209532362570784285,1506.75,2024-01-24T09:45:46,Plentzia,expenses,clothing,-151.56,-16122.0
buyer_5,Sara,Urkiaga,1994-03-12,44623772T,sara.urkiaga@megaapp.tech,772687,ES92209532362570784285,1506.75,2024-01-25T19:04:13,Plentzia,expenses,transport,-50.23,-16172.23
buyer_5,Sara,Urkiaga,1994-03-12,44623772T,sara.urkiaga@megaapp.tech,772687,ES92209532362570784285,1506.75,2024-01-25T08:15:44,Plentzia,expenses,leisure,-76.44,-16248.67
buyer_5,Sara,Urkiaga,1994-03-12,44623772T,sara.urkiaga@megaapp.tech,772687,ES92209532362570784285,1506.75,2024-01-26T09:17:24,Plentzia,expenses,transport,-76.94,-16325.61
buyer_5,Sara,Urkiaga,1994-03-12,44623772T,sara.urkiaga@megaapp.tech,772687,ES92209532362570784285,1506.75,2024-01-26T22:14:22,Plentzia,expenses,cash,-100.0,-16425.61
buyer_5,Sara,Urkiaga,1994-03-12,44623772T,sara.urkiaga@megaapp.tech,772687,ES92209532362570784285,1506.75,2024-01-27T11:31:53,Plentzia,expenses,cash,-100.0,-16525.61
buyer_5,Sara,Urkiaga,1994-03-12,44623772T,sara.urkiaga@megaapp.tech,772687,ES92209532362570784285,1506.75,2024-01-29T05:42:46,Plentzia,expenses,food,-69.24,-16594.85
buyer_5,Sara,Urkiaga,1994-03-12,44623772T,sara.urkiaga@megaapp.tech,772687,ES92209532362570784285,1506.75,2024-01-30T14:05:18,Plentzia,expenses,healthcare,-119.35,-16714.2
buyer_5,Sara,Urkiaga,1994-03-12,44623772T,sara.urkiaga@megaapp.tech,772687,ES92209532362570784285,1506.75,2024-01-30T12:54:59,Plentzia,expenses,education,-67.08,-16781.28
buyer_5,Sara,Urkiaga,1994-03-12,44623772T,sara.urkiaga@megaapp.tech,772687,ES92209532362570784285,1506.75,2024-01-31T18:52:24,Plentzia,expenses,repairs,-255.44,-17036.72
buyer_5,Sara,Urkiaga,1994-03-12,44623772T,sara.urkiaga@megaapp.tech,772687,ES92209532362570784285,1506.75,2024-02-01T17:35:08,Plentzia,incomes,salary,2658.63,-14378.09
buyer_5,Sara,Urkiaga,1994-03-12,44623772T,sara.urkiaga@megaapp.tech,772687,ES92209532362570784285,1506.75,2024-02-01T17:35:08,Plentzia,incomes,salary_partner,2378.85,-11999.24
buyer_5,Sara,Urkiaga,1994-03-12,44623772T,sara.urkiaga@megaapp.tech,772687,ES92209532362570784285,1506.75,2024-02-04T14:40:55,Plentzia,expenses,cash,-100.0,-12099.24
buyer_5,Sara,Urkiaga,1994-03-12,44623772T,sara.urkiaga@megaapp.tech,772687,ES92209532362570784285,1506.75,2024-02-05T10:10:25,Plentzia,expenses,mortgage,-2604.95,-14704.19
buyer_5,Sara,Urkiaga,1994-03-12,44623772T,sara.urkiaga@megaapp.tech,772687,ES92209532362570784285,1506.75,2024-02-05T10:44:48,Plentzia,expenses,internet,-105.79,-14809.98
buyer_5,Sara,Urkiaga,1994-03-12,44623772T,sara.urkiaga@megaapp.tech,772687,ES92209532362570784285,1506.75,2024-02-06T19:06:42,Plentzia,expenses,transport,-43.61,-14853.59
buyer_5,Sara,Urkiaga,1994-03-12,44623772T,sara.urkiaga@megaapp.tech,772687,ES92209532362570784285,1506.75,2024-02-07T15:25:54,Plentzia,expenses,gas,-226.31,-15079.9
buyer_5,Sara,Urkiaga,1994-03-12,44623772T,sara.urkiaga@megaapp.tech,772687,ES92209532362570784285,1506.75,2024-02-07T18:39:53,Plentzia,expenses,internet,-105.79,-15185.69
buyer_5,Sara,Urkiaga,1994-03-12,44623772T,sara.urkiaga@megaapp.tech,772687,ES92209532362570784285,1506.75,2024-02-07T15:24:48,Plentzia,expenses,transport,-58.48,-15244.17
buyer_5,Sara,Urkiaga,1994-03-12,44623772T,sara.urkiaga@megaapp.tech,772687,ES92209532362570784285,1506.75,2024-02-08T19:23:17,Plentzia,expenses,electricity,-75.08,-15319.25
buyer_5,Sara,Urkiaga,1994-03-12,44623772T,sara.urkiaga@megaapp.tech,772687,ES92209532362570784285,1506.75,2024-02-08T10:32:25,Plentzia,expenses,internet,-105.79,-15425.04
buyer_5,Sara,Urkiaga,1994-03-12,44623772T,sara.urkiaga@megaapp.tech,772687,ES92209532362570784285,1506.75,2024-02-08T17:12:05,Plentzia,expenses,leisure,-38.43,-15463.47
buyer_5,Sara,Urkiaga,1994-03-12,44623772T,sara.urkiaga@megaapp.tech,772687,ES92209532362570784285,1506.75,2024-02-08T14:26:43,Plentzia,expenses,travel,-382.97,-15846.44
buyer_5,Sara,Urkiaga,1994-03-12,44623772T,sara.urkiaga@megaapp.tech,772687,ES92209532362570784285,1506.75,2024-02-11T19:08:31,Plentzia,expenses,clothing,-77.13,-15923.57
buyer_5,Sara,Urkiaga,1994-03-12,44623772T,sara.urkiaga@megaapp.tech,772687,ES92209532362570784285,1506.75,2024-02-11T10:23:32,Plentzia,expenses,appliances,-235.63,-16159.2
buyer_5,Sara,Urkiaga,1994-03-12,44623772T,sara.urkiaga@megaapp.tech,772687,ES92209532362570784285,1506.75,2024-02-12T19:38:30,Plentzia,expenses,clothing,-79.02,-16238.22
buyer_5,Sara,Urkiaga,1994-03-12,44623772T,sara.urkiaga@megaapp.tech,772687,ES92209532362570784285,1506.75,2024-02-13T14:48:09,Plentzia,expenses,cash,-100.0,-16338.22
buyer_5,Sara,Urkiaga,1994-03-12,44623772T,sara.urkiaga@megaapp.tech,772687,ES92209532362570784285,1506.75,2024-02-14T16:15:53,Plentzia,expenses,cash,-100.0,-16438.22
buyer_5,Sara,Urkiaga,1994-03-12,44623772T,sara.urkiaga@megaapp.tech,772687,ES92209532362570784285,1506.75,2024-02-17T08:08:07,Plentzia,expenses,food,-108.01,-16546.23
buyer_5,Sara,Urkiaga,1994-03-12,44623772T,sara.urkiaga@megaapp.tech,772687,ES92209532362570784285,1506.75,2024-02-17T19:17:22,Plentzia,expenses,transport,-62.07,-16608.3
buyer_5,Sara,Urkiaga,1994-03-12,44623772T,sara.urkiaga@megaapp.tech,772687,ES92209532362570784285,1506.75,2024-02-17T20:24:29,Plentzia,expenses,leisure,-51.85,-16660.15
buyer_5,Sara,Urkiaga,1994-03-12,44623772T,sara.urkiaga@megaapp.tech,772687,ES92209532362570784285,1506.75,2024-02-18T19:52:55,Plentzia,expenses,education,-48.05,-16708.2
buyer_5,Sara,Urkiaga,1994-03-12,44623772T,sara.urkiaga@megaapp.tech,772687,ES92209532362570784285,1506.75,2024-02-18T11:56:31,Plentzia,expenses,cash,-100.0,-16808.2
buyer_5,Sara,Urkiaga,1994-03-12,44623772T,sara.urkiaga@megaapp.tech,772687,ES92209532362570784285,1506.75,2024-02-19T00:41:59,Plentzia,expenses,repairs,-144.94,-16953.14
buyer_5,Sara,Urkiaga,1994-03-12,44623772T,sara.urkiaga@megaapp.tech,772687,ES92209532362570784285,1506.75,2024-02-21T10:41:02,Plentzia,expenses,healthcare,-122.22,-17075.36
buyer_5,Sara,Urkiaga,1994-03-12,44623772T,sara.urkiaga@megaapp.tech,772687,ES92209532362570784285,1506.75,2024-02-21T14:09:00,Plentzia,expenses,appliances,-226.87,-17302.23
buyer_5,Sara,Urkiaga,1994-03-12,44623772T,sara.urkiaga@megaapp.tech,772687,ES92209532362570784285,1506.75,2024-02-23T11:54:16,Plentzia,expenses,food,-99.93,-17402.16
buyer_5,Sara,Urkiaga,1994-03-12,44623772T,sara.urkiaga@megaapp.tech,772687,ES92209532362570784285,1506.75,2024-02-24T18:39:04,Plentzia,expenses,cash,-100.0,-17502.16
buyer_5,Sara,Urkiaga,1994-03-12,44623772T,sara.urkiaga@megaapp.tech,772687,ES92209532362570784285,1506.75,2024-02-24T12:21:10,Plentzia,expenses,gifts,-534.09,-18036.25
buyer_5,Sara,Urkiaga,1994-03-12,44623772T,sara.urkiaga@megaapp.tech,772687,ES92209532362570784285,1506.75,2024-02-25T10:12:29,Plentzia,expenses,cash,-100.0,-18136.25
buyer_5,Sara,Urkiaga,1994-03-12,44623772T,sara.urkiaga@megaapp.tech,772687,ES92209532362570784285,1506.75,2024-02-27T22:07:18,Plentzia,expenses,cash,-100.0,-18236.25
buyer_5,Sara,Urkiaga,1994-03-12,44623772T,sara.urkiaga@megaapp.tech,772687,ES92209532362570784285,1506.75,2024-02-27T14:05:55,Plentzia,expenses,gifts,-534.09,-18770.34
buyer_5,Sara,Urkiaga,1994-03-12,44623772T,sara.urkiaga@megaapp.tech,772687,ES92209532362570784285,1506.75,2024-02-29T06:40:03,Plentzia,expenses,clothing,-114.57,-18884.91
buyer_5,Sara,Urkiaga,1994-03-12,44623772T,sara.urkiaga@megaapp.tech,772687,ES92209532362570784285,1506.75,2024-02-29T19:54:55,Plentzia,expenses,gifts,-588.89,-19473.8
buyer_5,Sara,Urkiaga,1994-03-12,44623772T,sara.urkiaga@megaapp.tech,772687,ES92209532362570784285,1506.75,2024-03-01T03:38:40,Plentzia,incomes,salary,2658.63,-16815.17
buyer_5,Sara,Urkiaga,1994-03-12,44623772T,sara.urkiaga@megaapp.tech,772687,ES92209532362570784285,1506.75,2024-03-01T03:38:40,Plentzia,incomes,salary_partner,2378.85,-14436.32
buyer_5,Sara,Urkiaga,1994-03-12,44623772T,sara.urkiaga@megaapp.tech,772687,ES92209532362570784285,1506.75,2024-03-01T03:38:40,Plentzia,incomes,extra_income,471.47,-13964.85
buyer_5,Sara,Urkiaga,1994-03-12,44623772T,sara.urkiaga@megaapp.tech,772687,ES92209532362570784285,1506.75,2024-03-01T19:19:01,Plentzia,expenses,food,-109.9,-14074.75
buyer_5,Sara,Urkiaga,1994-03-12,44623772T,sara.urkiaga@megaapp.tech,772687,ES92209532362570784285,1506.75,2024-03-03T19:49:37,Plentzia,expenses,cash,-100.0,-14174.75
buyer_5,Sara,Urkiaga,1994-03-12,44623772T,sara.urkiaga@megaapp.tech,772687,ES92209532362570784285,1506.75,2024-03-05T09:13:07,Plentzia,expenses,mortgage,-2604.95,-16779.7
buyer_5,Sara,Urkiaga,1994-03-12,44623772T,sara.urkiaga@megaapp.tech,772687,ES92209532362570784285,1506.75,2024-03-05T12:28:36,Plentzia,expenses,gas,-121.24,-16900.94
buyer_5,Sara,Urkiaga,1994-03-12,44623772T,sara.urkiaga@megaapp.tech,772687,ES92209532362570784285,1506.75,2024-03-05T21:32:58,Plentzia,expenses,phone,-98.39,-16999.33
buyer_5,Sara,Urkiaga,1994-03-12,44623772T,sara.urkiaga@megaapp.tech,772687,ES92209532362570784285,1506.75,2024-03-06T10:28:47,Plentzia,expenses,electricity,-87.74,-17087.07
buyer_5,Sara,Urkiaga,1994-03-12,44623772T,sara.urkiaga@megaapp.tech,772687,ES92209532362570784285,1506.75,2024-03-07T14:14:49,Plentzia,expenses,water,-107.93,-17195.0
buyer_5,Sara,Urkiaga,1994-03-12,44623772T,sara.urkiaga@megaapp.tech,772687,ES92209532362570784285,1506.75,2024-03-07T14:19:51,Plentzia,expenses,electricity,-160.03,-17355.03
buyer_5,Sara,Urkiaga,1994-03-12,44623772T,sara.urkiaga@megaapp.tech,772687,ES92209532362570784285,1506.75,2024-03-08T18:29:12,Plentzia,expenses,water,-77.37,-17432.4
buyer_5,Sara,Urkiaga,1994-03-12,44623772T,sara.urkiaga@megaapp.tech,772687,ES92209532362570784285,1506.75,2024-03-10T18:49:15,Plentzia,expenses,food,-78.81,-17511.21
buyer_5,Sara,Urkiaga,1994-03-12,44623772T,sara.urkiaga@megaapp.tech,772687,ES92209532362570784285,1506.75,2024-03-11T08:38:22,Plentzia,expenses,repairs,-242.26,-17753.47
buyer_5,Sara,Urkiaga,1994-03-12,44623772T,sara.urkiaga@megaapp.tech,772687,ES92209532362570784285,1506.75,2024-03-12T12:31:15,Plentzia,expenses,food,-85.54,-17839.01
buyer_5,Sara,Urkiaga,1994-03-12,44623772T,sara.urkiaga@megaapp.tech,772687,ES92209532362570784285,1506.75,2024-03-15T15:50:04,Plentzia,expenses,cash,-100.0,-17939.01
buyer_5,Sara,Urkiaga,1994-03-12,44623772T,sara.urkiaga@megaapp.tech,772687,ES92209532362570784285,1506.75,2024-03-16T11:09:09,Plentzia,expenses,healthcare,-132.5,-18071.51
buyer_5,Sara,Urkiaga,1994-03-12,44623772T,sara.urkiaga@megaapp.tech,772687,ES92209532362570784285,1506.75,2024-03-18T00:44:34,Plentzia,expenses,clothing,-71.35,-18142.86
buyer_5,Sara,Urkiaga,1994-03-12,44623772T,sara.urkiaga@megaapp.tech,772687,ES92209532362570784285,1506.75,2024-03-21T01:41:17,Plentzia,expenses,food,-76.14,-18219.0
buyer_5,Sara,Urkiaga,1994-03-12,44623772T,sara.urkiaga@megaapp.tech,772687,ES92209532362570784285,1506.75,2024-03-24T11:24:57,Plentzia,expenses,gifts,-390.48,-18609.48
buyer_5,Sara,Urkiaga,1994-03-12,44623772T,sara.urkiaga@megaapp.tech,772687,ES92209532362570784285,1506.75,2024-03-25T10:41:24,Plentzia,expenses,food,-105.96,-18715.44
buyer_5,Sara,Urkiaga,1994-03-12,44623772T,sara.urkiaga@megaapp.tech,772687,ES92209532362570784285,1506.75,2024-03-25T12:09:01,Plentzia,expenses,healthcare,-122.73,-18838.17
buyer_5,Sara,Urkiaga,1994-03-12,44623772T,sara.urkiaga@megaapp.tech,772687,ES92209532362570784285,1506.75,2024-03-25T15:57:35,Plentzia,expenses,repairs,-69.31,-18907.48
buyer_5,Sara,Urkiaga,1994-03-12,44623772T,sara.urkiaga@megaapp.tech,772687,ES92209532362570784285,1506.75,2024-03-29T14:55:52,Plentzia,expenses,leisure,-62.61,-18970.09
buyer_5,Sara,Urkiaga,1994-03-12,44623772T,sara.urkiaga@megaapp.tech,772687,ES92209532362570784285,1506.75,2024-03-30T10:32:12,Plentzia,expenses,transport,-82.81,-19052.9
buyer_5,Sara,Urkiaga,1994-03-12,44623772T,sara.urkiaga@megaapp.tech,772687,ES92209532362570784285,1506.75,2024-03-30T05:03:01,Plentzia,expenses,healthcare,-162.78,-19215.68
buyer_5,Sara,Urkiaga,1994-03-12,44623772T,sara.urkiaga@megaapp.tech,772687,ES92209532362570784285,1506.75,2024-03-31T15:30:50,Plentzia,expenses,appliances,-160.47,-19376.15
buyer_5,Sara,Urkiaga,1994-03-12,44623772T,sara.urkiaga@megaapp.tech,772687,ES92209532362570784285,1506.75,2024-04-01T13:08:48,Plentzia,incomes,salary,2658.63,-16717.52
buyer_5,Sara,Urkiaga,1994-03-12,44623772T,sara.urkiaga@megaapp.tech,772687,ES92209532362570784285,1506.75,2024-04-01T13:08:48,Plentzia,incomes,salary_partner,2378.85,-14338.67
buyer_5,Sara,Urkiaga,1994-03-12,44623772T,sara.urkiaga@megaapp.tech,772687,ES92209532362570784285,1506.75,2024-04-03T10:32:25,Plentzia,expenses,cash,-100.0,-14438.67
buyer_5,Sara,Urkiaga,1994-03-12,44623772T,sara.urkiaga@megaapp.tech,772687,ES92209532362570784285,1506.75,2024-04-04T13:33:34,Plentzia,expenses,education,-68.59,-14507.26
buyer_5,Sara,Urkiaga,1994-03-12,44623772T,sara.urkiaga@megaapp.tech,772687,ES92209532362570784285,1506.75,2024-04-04T09:14:02,Plentzia,expenses,cash,-100.0,-14607.26
buyer_5,Sara,Urkiaga,1994-03-12,44623772T,sara.urkiaga@megaapp.tech,772687,ES92209532362570784285,1506.75,2024-04-05T18:15:56,Plentzia,expenses,mortgage,-2604.95,-17212.21
buyer_5,Sara,Urkiaga,1994-03-12,44623772T,sara.urkiaga@megaapp.tech,772687,ES92209532362570784285,1506.75,2024-04-06T14:32:37,Plentzia,expenses,water,-64.98,-17277.19
buyer_5,Sara,Urkiaga,1994-03-12,44623772T,sara.urkiaga@megaapp.tech,772687,ES92209532362570784285,1506.75,2024-04-06T19:22:56,Plentzia,expenses,phone,-99.96,-17377.15
buyer_5,Sara,Urkiaga,1994-03-12,44623772T,sara.urkiaga@megaapp.tech,772687,ES92209532362570784285,1506.75,2024-04-06T10:49:19,Plentzia,expenses,leisure,-79.56,-17456.71
buyer_5,Sara,Urkiaga,1994-03-12,44623772T,sara.urkiaga@megaapp.tech,772687,ES92209532362570784285,1506.75,2024-04-07T10:19:42,Plentzia,expenses,electricity,-54.84,-17511.55
buyer_5,Sara,Urkiaga,1994-03-12,44623772T,sara.urkiaga@megaapp.tech,772687,ES92209532362570784285,1506.75,2024-04-07T15:39:58,Plentzia,expenses,gas,-163.44,-17674.99
buyer_5,Sara,Urkiaga,1994-03-12,44623772T,sara.urkiaga@megaapp.tech,772687,ES92209532362570784285,1506.75,2024-04-07T16:07:37,Plentzia,expenses,internet,-105.79,-17780.78
buyer_5,Sara,Urkiaga,1994-03-12,44623772T,sara.urkiaga@megaapp.tech,772687,ES92209532362570784285,1506.75,2024-04-07T18:51:51,Plentzia,expenses,gifts,-754.76,-18535.54
buyer_5,Sara,Urkiaga,1994-03-12,44623772T,sara.urkiaga@megaapp.tech,772687,ES92209532362570784285,1506.75,2024-04-08T13:08:48,Plentzia,expenses,phone,-112.54,-18648.08
buyer_5,Sara,Urkiaga,1994-03-12,44623772T,sara.urkiaga@megaapp.tech,772687,ES92209532362570784285,1506.75,2024-04-11T18:12:37,Plentzia,expenses,cash,-100.0,-18748.08
buyer_5,Sara,Urkiaga,1994-03-12,44623772T,sara.urkiaga@megaapp.tech,772687,ES92209532362570784285,1506.75,2024-04-12T21:50:58,Plentzia,expenses,transport,-65.27,-18813.35
buyer_5,Sara,Urkiaga,1994-03-12,44623772T,sara.urkiaga@megaapp.tech,772687,ES92209532362570784285,1506.75,2024-04-15T13:55:47,Plentzia,expenses,cash,-100.0,-18913.35
buyer_5,Sara,Urkiaga,1994-03-12,44623772T,sara.urkiaga@megaapp.tech,772687,ES92209532362570784285,1506.75,2024-04-15T00:54:51,Plentzia,expenses,appliances,-332.83,-19246.18
buyer_5,Sara,Urkiaga,1994-03-12,44623772T,sara.urkiaga@megaapp.tech,772687,ES92209532362570784285,1506.75,2024-04-17T11:32:24,Plentzia,expenses,leisure,-53.58,-19299.76
buyer_5,Sara,Urkiaga,1994-03-12,44623772T,sara.urkiaga@megaapp.tech,772687,ES92209532362570784285,1506.75,2024-04-17T13:51:59,Plentzia,expenses,cash,-100.0,-19399.76
buyer_5,Sara,Urkiaga,1994-03-12,44623772T,sara.urkiaga@megaapp.tech,772687,ES92209532362570784285,1506.75,2024-04-19T19:52:13,Plentzia,expenses,transport,-49.26,-19449.02
buyer_5,Sara,Urkiaga,1994-03-12,44623772T,sara.urkiaga@megaapp.tech,772687,ES92209532362570784285,1506.75,2024-04-24T10:46:59,Plentzia,expenses,food,-117.98,-19567.0
buyer_5,Sara,Urkiaga,1994-03-12,44623772T,sara.urkiaga@megaapp.tech,772687,ES92209532362570784285,1506.75,2024-04-24T02:04:44,Plentzia,expenses,cash,-100.0,-19667.0
buyer_5,Sara,Urkiaga,1994-03-12,44623772T,sara.urkiaga@megaapp.tech,772687,ES92209532362570784285,1506.75,2024-04-27T18:49:54,Plentzia,expenses,transport,-79.92,-19746.92
buyer_5,Sara,Urkiaga,1994-03-12,44623772T,sara.urkiaga@megaapp.tech,772687,ES92209532362570784285,1506.75,2024-04-27T14:55:34,Plentzia,expenses,repairs,-294.29,-20041.21
buyer_5,Sara,Urkiaga,1994-03-12,44623772T,sara.urkiaga@megaapp.tech,772687,ES92209532362570784285,1506.75,2024-04-29T19:50:38,Plentzia,expenses,repairs,-225.64,-20266.85
buyer_5,Sara,Urkiaga,1994-03-12,44623772T,sara.urkiaga@megaapp.tech,772687,ES92209532362570784285,1506.75,2024-05-01T13:49:28,Plentzia,incomes,salary,2658.63,-17608.22
buyer_5,Sara,Urkiaga,1994-03-12,44623772T,sara.urkiaga@megaapp.tech,772687,ES92209532362570784285,1506.75,2024-05-01T13:49:28,Plentzia,incomes,salary_partner,2378.85,-15229.37
buyer_5,Sara,Urkiaga,1994-03-12,44623772T,sara.urkiaga@megaapp.tech,772687,ES92209532362570784285,1506.75,2024-05-01T00:59:28,Plentzia,expenses,leisure,-60.39,-15289.76
buyer_5,Sara,Urkiaga,1994-03-12,44623772T,sara.urkiaga@megaapp.tech,772687,ES92209532362570784285,1506.75,2024-05-01T01:01:22,Plentzia,expenses,repairs,-34.53,-15324.29
buyer_5,Sara,Urkiaga,1994-03-12,44623772T,sara.urkiaga@megaapp.tech,772687,ES92209532362570784285,1506.75,2024-05-02T14:59:35,Plentzia,expenses,education,-60.7,-15384.99
buyer_5,Sara,Urkiaga,1994-03-12,44623772T,sara.urkiaga@megaapp.tech,772687,ES92209532362570784285,1506.75,2024-05-03T14:32:45,Plentzia,expenses,food,-61.34,-15446.33
buyer_5,Sara,Urkiaga,1994-03-12,44623772T,sara.urkiaga@megaapp.tech,772687,ES92209532362570784285,1506.75,2024-05-04T11:55:06,Plentzia,expenses,appliances,-275.24,-15721.57
buyer_5,Sara,Urkiaga,1994-03-12,44623772T,sara.urkiaga@megaapp.tech,772687,ES92209532362570784285,1506.75,2024-05-05T08:08:39,Plentzia,expenses,mortgage,-2604.95,-18326.52
buyer_5,Sara,Urkiaga,1994-03-12,44623772T,sara.urkiaga@megaapp.tech,772687,ES92209532362570784285,1506.75,2024-05-05T16:11:26,Plentzia,expenses,internet,-105.79,-18432.31
buyer_5,Sara,Urkiaga,1994-03-12,44623772T,sara.urkiaga@megaapp.tech,772687,ES92209532362570784285,1506.75,2024-05-05T10:55:10,Plentzia,expenses,repairs,-274.25,-18706.56
buyer_5,Sara,Urkiaga,1994-03-12,44623772T,sara.urkiaga@megaapp.tech,772687,ES92209532362570784285,1506.75,2024-05-06T12:39:47,Plentzia,expenses,internet,-105.79,-18812.35
buyer_5,Sara,Urkiaga,1994-03-12,44623772T,sara.urkiaga@megaapp.tech,772687,ES92209532362570784285,1506.75,2024-05-07T22:26:15,Plentzia,expenses,gas,-255.92,-19068.27
buyer_5,Sara,Urkiaga,1994-03-12,44623772T,sara.urkiaga@megaapp.tech,772687,ES92209532362570784285,1506.75,2024-05-07T22:03:37,Plentzia,expenses,food,-94.13,-19162.4
buyer_5,Sara,Urkiaga,1994-03-12,44623772T,sara.urkiaga@megaapp.tech,772687,ES92209532362570784285,1506.75,2024-05-07T16:17:23,Plentzia,expenses,repairs,-321.68,-19484.08
buyer_5,Sara,Urkiaga,1994-03-12,44623772T,sara.urkiaga@megaapp.tech,772687,ES92209532362570784285,1506.75,2024-05-08T13:42:36,Plentzia,expenses,water,-108.33,-19592.41
buyer_5,Sara,Urkiaga,1994-03-12,44623772T,sara.urkiaga@megaapp.tech,772687,ES92209532362570784285,1506.75,2024-05-08T23:06:49,Plentzia,expenses,gas,-177.93,-19770.34
buyer_5,Sara,Urkiaga,1994-03-12,44623772T,sara.urkiaga@megaapp.tech,772687,ES92209532362570784285,1506.75,2024-05-09T08:02:23,Plentzia,expenses,food,-102.38,-19872.72
buyer_5,Sara,Urkiaga,1994-03-12,44623772T,sara.urkiaga@megaapp.tech,772687,ES92209532362570784285,1506.75,2024-05-09T09:11:23,Plentzia,expenses,transport,-88.68,-19961.4
buyer_5,Sara,Urkiaga,1994-03-12,44623772T,sara.urkiaga@megaapp.tech,772687,ES92209532362570784285,1506.75,2024-05-10T23:17:03,Plentzia,expenses,transport,-54.17,-20015.57
buyer_5,Sara,Urkiaga,1994-03-12,44623772T,sara.urkiaga@megaapp.tech,772687,ES92209532362570784285,1506.75,2024-05-14T18:49:05,Plentzia,expenses,cash,-100.0,-20115.57
buyer_5,Sara,Urkiaga,1994-03-12,44623772T,sara.urkiaga@megaapp.tech,772687,ES92209532362570784285,1506.75,2024-05-14T06:18:47,Plentzia,expenses,repairs,-74.94,-20190.51
buyer_5,Sara,Urkiaga,1994-03-12,44623772T,sara.urkiaga@megaapp.tech,772687,ES92209532362570784285,1506.75,2024-05-15T09:55:07,Plentzia,expenses,food,-93.76,-20284.27
buyer_5,Sara,Urkiaga,1994-03-12,44623772T,sara.urkiaga@megaapp.tech,772687,ES92209532362570784285,1506.75,2024-05-15T16:04:12,Plentzia,expenses,transport,-89.82,-20374.09
buyer_5,Sara,Urkiaga,1994-03-12,44623772T,sara.urkiaga@megaapp.tech,772687,ES92209532362570784285,1506.75,2024-05-15T08:21:14,Plentzia,expenses,leisure,-29.06,-20403.15
buyer_5,Sara,Urkiaga,1994-03-12,44623772T,sara.urkiaga@megaapp.tech,772687,ES92209532362570784285,1506.75,2024-05-16T08:20:38,Plentzia,expenses,food,-72.75,-20475.9
buyer_5,Sara,Urkiaga,1994-03-12,44623772T,sara.urkiaga@megaapp.tech,772687,ES92209532362570784285,1506.75,2024-05-18T13:16:34,Plentzia,expenses,cash,-100.0,-20575.9
buyer_5,Sara,Urkiaga,1994-03-12,44623772T,sara.urkiaga@megaapp.tech,772687,ES92209532362570784285,1506.75,2024-05-19T18:00:26,Plentzia,expenses,leisure,-38.43,-20614.33
buyer_5,Sara,Urkiaga,1994-03-12,44623772T,sara.urkiaga@megaapp.tech,772687,ES92209532362570784285,1506.75,2024-05-20T16:01:50,Plentzia,expenses,leisure,-55.9,-20670.23
buyer_5,Sara,Urkiaga,1994-03-12,44623772T,sara.urkiaga@megaapp.tech,772687,ES92209532362570784285,1506.75,2024-05-20T17:02:20,Plentzia,expenses,clothing,-52.06,-20722.29
buyer_5,Sara,Urkiaga,1994-03-12,44623772T,sara.urkiaga@megaapp.tech,772687,ES92209532362570784285,1506.75,2024-05-21T13:08:37,Plentzia,expenses,food,-124.1,-20846.39
buyer_5,Sara,Urkiaga,1994-03-12,44623772T,sara.urkiaga@megaapp.tech,772687,ES92209532362570784285,1506.75,2024-05-21T10:30:00,Plentzia,expenses,leisure,-35.72,-20882.11
buyer_5,Sara,Urkiaga,1994-03-12,44623772T,sara.urkiaga@megaapp.tech,772687,ES92209532362570784285,1506.75,2024-05-22T23:45:51,Plentzia,expenses,cash,-100.0,-20982.11
buyer_5,Sara,Urkiaga,1994-03-12,44623772T,sara.urkiaga@megaapp.tech,772687,ES92209532362570784285,1506.75,2024-05-22T19:28:02,Plentzia,expenses,gifts,-58.53,-21040.64
buyer_5,Sara,Urkiaga,1994-03-12,44623772T,sara.urkiaga@megaapp.tech,772687,ES92209532362570784285,1506.75,2024-05-23T01:40:13,Plentzia,expenses,food,-113.56,-21154.2
buyer_5,Sara,Urkiaga,1994-03-12,44623772T,sara.urkiaga@megaapp.tech,772687,ES92209532362570784285,1506.75,2024-05-26T17:12:00,Plentzia,expenses,repairs,-40.18,-21194.38
buyer_5,Sara,Urkiaga,1994-03-12,44623772T,sara.urkiaga@megaapp.tech,772687,ES92209532362570784285,1506.75,2024-05-28T20:29:15,Plentzia,expenses,food,-95.24,-21289.62
buyer_5,Sara,Urkiaga,1994-03-12,44623772T,sara.urkiaga@megaapp.tech,772687,ES92209532362570784285,1506.75,2024-05-28T23:27:16,Plentzia,expenses,travel,-576.72,-21866.34
buyer_5,Sara,Urkiaga,1994-03-12,44623772T,sara.urkiaga@megaapp.tech,772687,ES92209532362570784285,1506.75,2024-05-28T17:36:40,Plentzia,expenses,gifts,-48.87,-21915.21
buyer_5,Sara,Urkiaga,1994-03-12,44623772T,sara.urkiaga@megaapp.tech,772687,ES92209532362570784285,1506.75,2024-05-30T19:18:46,Plentzia,expenses,food,-70.23,-21985.44
buyer_5,Sara,Urkiaga,1994-03-12,44623772T,sara.urkiaga@megaapp.tech,772687,ES92209532362570784285,1506.75,2024-05-30T16:30:40,Plentzia,expenses,leisure,-74.36,-22059.8
buyer_5,Sara,Urkiaga,1994-03-12,44623772T,sara.urkiaga@megaapp.tech,772687,ES92209532362570784285,1506.75,2024-05-31T11:14:31,Plentzia,expenses,transport,-42.18,-22101.98
buyer_5,Sara,Urkiaga,1994-03-12,44623772T,sara.urkiaga@megaapp.tech,772687,ES92209532362570784285,1506.75,2024-06-01T09:22:39,Plentzia,incomes,salary,2658.63,-19443.35
buyer_5,Sara,Urkiaga,1994-03-12,44623772T,sara.urkiaga@megaapp.tech,772687,ES92209532362570784285,1506.75,2024-06-01T09:22:39,Plentzia,incomes,salary_partner,2378.85,-17064.5
buyer_5,Sara,Urkiaga,1994-03-12,44623772T,sara.urkiaga@megaapp.tech,772687,ES92209532362570784285,1506.75,2024-06-01T09:22:39,Plentzia,incomes,extra_income,471.47,-16593.03
buyer_5,Sara,Urkiaga,1994-03-12,44623772T,sara.urkiaga@megaapp.tech,772687,ES92209532362570784285,1506.75,2024-06-01T09:22:39,Plentzia,incomes,salary_bonus,1922.0,-14671.03
buyer_5,Sara,Urkiaga,1994-03-12,44623772T,sara.urkiaga@megaapp.tech,772687,ES92209532362570784285,1506.75,2024-06-01T09:22:39,Plentzia,incomes,salary_partner_bonus,1813.61,-12857.42
buyer_5,Sara,Urkiaga,1994-03-12,44623772T,sara.urkiaga@megaapp.tech,772687,ES92209532362570784285,1506.75,2024-06-01T10:37:46,Plentzia,expenses,food,-101.17,-12958.59
buyer_5,Sara,Urkiaga,1994-03-12,44623772T,sara.urkiaga@megaapp.tech,772687,ES92209532362570784285,1506.75,2024-06-01T16:04:26,Plentzia,expenses,healthcare,-124.2,-13082.79
buyer_5,Sara,Urkiaga,1994-03-12,44623772T,sara.urkiaga@megaapp.tech,772687,ES92209532362570784285,1506.75,2024-06-01T10:34:17,Plentzia,expenses,cash,-100.0,-13182.79
buyer_5,Sara,Urkiaga,1994-03-12,44623772T,sara.urkiaga@megaapp.tech,772687,ES92209532362570784285,1506.75,2024-06-02T12:55:28,Plentzia,expenses,cash,-100.0,-13282.79
buyer_5,Sara,Urkiaga,1994-03-12,44623772T,sara.urkiaga@megaapp.tech,772687,ES92209532362570784285,1506.75,2024-06-03T17:38:26,Plentzia,expenses,taxes,-4136.06,-17418.85
buyer_5,Sara,Urkiaga,1994-03-12,44623772T,sara.urkiaga@megaapp.tech,772687,ES92209532362570784285,1506.75,2024-06-03T15:05:35,Plentzia,expenses,insurance,-1377.46,-18796.31
buyer_5,Sara,Urkiaga,1994-03-12,44623772T,sara.urkiaga@megaapp.tech,772687,ES92209532362570784285,1506.75,2024-06-03T07:29:22,Plentzia,expenses,repairs,-168.45,-18964.76
buyer_5,Sara,Urkiaga,1994-03-12,44623772T,sara.urkiaga@megaapp.tech,772687,ES92209532362570784285,1506.75,2024-06-05T09:04:08,Plentzia,expenses,mortgage,-2604.95,-21569.71
buyer_5,Sara,Urkiaga,1994-03-12,44623772T,sara.urkiaga@megaapp.tech,772687,ES92209532362570784285,1506.75,2024-06-05T20:29:25,Plentzia,expenses,food,-92.26,-21661.97
buyer_5,Sara,Urkiaga,1994-03-12,44623772T,sara.urkiaga@megaapp.tech,772687,ES92209532362570784285,1506.75,2024-06-06T15:24:07,Plentzia,expenses,water,-63.76,-21725.73
buyer_5,Sara,Urkiaga,1994-03-12,44623772T,sara.urkiaga@megaapp.tech,772687,ES92209532362570784285,1506.75,2024-06-06T12:11:00,Plentzia,expenses,internet,-105.79,-21831.52
buyer_5,Sara,Urkiaga,1994-03-12,44623772T,sara.urkiaga@megaapp.tech,772687,ES92209532362570784285,1506.75,2024-06-06T01:45:51,Plentzia,expenses,phone,-97.46,-21928.98
buyer_5,Sara,Urkiaga,1994-03-12,44623772T,sara.urkiaga@megaapp.tech,772687,ES92209532362570784285,1506.75,2024-06-07T18:52:12,Plentzia,expenses,electricity,-194.7,-22123.68
buyer_5,Sara,Urkiaga,1994-03-12,44623772T,sara.urkiaga@megaapp.tech,772687,ES92209532362570784285,1506.75,2024-06-07T10:52:50,Plentzia,expenses,gas,-104.77,-22228.45
buyer_5,Sara,Urkiaga,1994-03-12,44623772T,sara.urkiaga@megaapp.tech,772687,ES92209532362570784285,1506.75,2024-06-07T12:45:30,Plentzia,expenses,internet,-105.79,-22334.24
buyer_5,Sara,Urkiaga,1994-03-12,44623772T,sara.urkiaga@megaapp.tech,772687,ES92209532362570784285,1506.75,2024-06-07T20:49:59,Plentzia,expenses,food,-94.15,-22428.39
buyer_5,Sara,Urkiaga,1994-03-12,44623772T,sara.urkiaga@megaapp.tech,772687,ES92209532362570784285,1506.75,2024-06-07T10:28:48,Plentzia,expenses,clothing,-85.78,-22514.17
buyer_5,Sara,Urkiaga,1994-03-12,44623772T,sara.urkiaga@megaapp.tech,772687,ES92209532362570784285,1506.75,2024-06-09T21:22:11,Plentzia,expenses,food,-69.66,-22583.83
buyer_5,Sara,Urkiaga,1994-03-12,44623772T,sara.urkiaga@megaapp.tech,772687,ES92209532362570784285,1506.75,2024-06-11T10:02:16,Plentzia,expenses,clothing,-118.07,-22701.9
buyer_5,Sara,Urkiaga,1994-03-12,44623772T,sara.urkiaga@megaapp.tech,772687,ES92209532362570784285,1506.75,2024-06-12T11:22:32,Plentzia,expenses,gifts,-204.87,-22906.77
buyer_5,Sara,Urkiaga,1994-03-12,44623772T,sara.urkiaga@megaapp.tech,772687,ES92209532362570784285,1506.75,2024-06-16T20:02:42,Plentzia,expenses,transport,-89.29,-22996.06
buyer_5,Sara,Urkiaga,1994-03-12,44623772T,sara.urkiaga@megaapp.tech,772687,ES92209532362570784285,1506.75,2024-06-16T17:11:39,Plentzia,expenses,clothing,-108.59,-23104.65
buyer_5,Sara,Urkiaga,1994-03-12,44623772T,sara.urkiaga@megaapp.tech,772687,ES92209532362570784285,1506.75,2024-06-16T10:23:58,Plentzia,expenses,healthcare,-43.12,-23147.77
buyer_5,Sara,Urkiaga,1994-03-12,44623772T,sara.urkiaga@megaapp.tech,772687,ES92209532362570784285,1506.75,2024-06-17T09:49:04,Plentzia,expenses,gifts,-42.1,-23189.87
buyer_5,Sara,Urkiaga,1994-03-12,44623772T,sara.urkiaga@megaapp.tech,772687,ES92209532362570784285,1506.75,2024-06-18T13:21:23,Plentzia,expenses,food,-105.5,-23295.37
buyer_5,Sara,Urkiaga,1994-03-12,44623772T,sara.urkiaga@megaapp.tech,772687,ES92209532362570784285,1506.75,2024-06-19T20:03:53,Plentzia,expenses,leisure,-22.92,-23318.29
buyer_5,Sara,Urkiaga,1994-03-12,44623772T,sara.urkiaga@megaapp.tech,772687,ES92209532362570784285,1506.75,2024-06-19T16:23:27,Plentzia,expenses,cash,-100.0,-23418.29
buyer_5,Sara,Urkiaga,1994-03-12,44623772T,sara.urkiaga@megaapp.tech,772687,ES92209532362570784285,1506.75,2024-06-19T19:44:42,Plentzia,expenses,repairs,-258.54,-23676.83
buyer_5,Sara,Urkiaga,1994-03-12,44623772T,sara.urkiaga@megaapp.tech,772687,ES92209532362570784285,1506.75,2024-06-23T17:18:08,Plentzia,expenses,education,-43.12,-23719.95
buyer_5,Sara,Urkiaga,1994-03-12,44623772T,sara.urkiaga@megaapp.tech,772687,ES92209532362570784285,1506.75,2024-06-24T16:17:35,Plentzia,expenses,leisure,-54.19,-23774.14
buyer_5,Sara,Urkiaga,1994-03-12,44623772T,sara.urkiaga@megaapp.tech,772687,ES92209532362570784285,1506.75,2024-06-25T08:42:08,Plentzia,expenses,travel,-495.55,-24269.69
buyer_5,Sara,Urkiaga,1994-03-12,44623772T,sara.urkiaga@megaapp.tech,772687,ES92209532362570784285,1506.75,2024-06-26T09:30:46,Plentzia,expenses,transport,-79.17,-24348.86
buyer_5,Sara,Urkiaga,1994-03-12,44623772T,sara.urkiaga@megaapp.tech,772687,ES92209532362570784285,1506.75,2024-06-28T08:21:20,Plentzia,expenses,leisure,-40.85,-24389.71
buyer_5,Sara,Urkiaga,1994-03-12,44623772T,sara.urkiaga@megaapp.tech,772687,ES92209532362570784285,1506.75,2024-06-29T17:04:17,Plentzia,expenses,education,-47.65,-24437.36
buyer_5,Sara,Urkiaga,1994-03-12,44623772T,sara.urkiaga@megaapp.tech,772687,ES92209532362570784285,1506.75,2024-06-30T17:34:01,Plentzia,expenses,leisure,-45.91,-24483.27
buyer_5,Sara,Urkiaga,1994-03-12,44623772T,sara.urkiaga@megaapp.tech,772687,ES92209532362570784285,1506.75,2024-07-01T02:23:39,Plentzia,incomes,salary,2658.63,-21824.64
buyer_5,Sara,Urkiaga,1994-03-12,44623772T,sara.urkiaga@megaapp.tech,772687,ES92209532362570784285,1506.75,2024-07-01T02:23:39,Plentzia,incomes,salary_partner,2378.85,-19445.79
buyer_5,Sara,Urkiaga,1994-03-12,44623772T,sara.urkiaga@megaapp.tech,772687,ES92209532362570784285,1506.75,2024-07-02T14:25:30,Plentzia,expenses,repairs,-30.28,-19476.07
buyer_5,Sara,Urkiaga,1994-03-12,44623772T,sara.urkiaga@megaapp.tech,772687,ES92209532362570784285,1506.75,2024-07-03T01:55:42,Plentzia,expenses,clothing,-159.24,-19635.31
buyer_5,Sara,Urkiaga,1994-03-12,44623772T,sara.urkiaga@megaapp.tech,772687,ES92209532362570784285,1506.75,2024-07-03T15:32:56,Plentzia,expenses,education,-70.21,-19705.52
buyer_5,Sara,Urkiaga,1994-03-12,44623772T,sara.urkiaga@megaapp.tech,772687,ES92209532362570784285,1506.75,2024-07-04T11:05:45,Plentzia,expenses,leisure,-20.35,-19725.87
buyer_5,Sara,Urkiaga,1994-03-12,44623772T,sara.urkiaga@megaapp.tech,772687,ES92209532362570784285,1506.75,2024-07-04T19:12:59,Plentzia,expenses,repairs,-320.72,-20046.59
buyer_5,Sara,Urkiaga,1994-03-12,44623772T,sara.urkiaga@megaapp.tech,772687,ES92209532362570784285,1506.75,2024-07-05T12:13:40,Plentzia,expenses,mortgage,-2604.95,-22651.54
buyer_5,Sara,Urkiaga,1994-03-12,44623772T,sara.urkiaga@megaapp.tech,772687,ES92209532362570784285,1506.75,2024-07-05T16:18:01,Plentzia,expenses,electricity,-152.93,-22804.47
buyer_5,Sara,Urkiaga,1994-03-12,44623772T,sara.urkiaga@megaapp.tech,772687,ES92209532362570784285,1506.75,2024-07-05T19:42:15,Plentzia,expenses,phone,-75.95,-22880.42
buyer_5,Sara,Urkiaga,1994-03-12,44623772T,sara.urkiaga@megaapp.tech,772687,ES92209532362570784285,1506.75,2024-07-05T20:37:06,Plentzia,expenses,transport,-86.81,-22967.23
buyer_5,Sara,Urkiaga,1994-03-12,44623772T,sara.urkiaga@megaapp.tech,772687,ES92209532362570784285,1506.75,2024-07-05T14:16:03,Plentzia,expenses,clothing,-133.29,-23100.52
buyer_5,Sara,Urkiaga,1994-03-12,44623772T,sara.urkiaga@megaapp.tech,772687,ES92209532362570784285,1506.75,2024-07-06T05:26:16,Plentzia,expenses,leisure,-75.4,-23175.92
buyer_5,Sara,Urkiaga,1994-03-12,44623772T,sara.urkiaga@megaapp.tech,772687,ES92209532362570784285,1506.75,2024-07-07T16:23:55,Plentzia,expenses,water,-83.02,-23258.94
buyer_5,Sara,Urkiaga,1994-03-12,44623772T,sara.urkiaga@megaapp.tech,772687,ES92209532362570784285,1506.75,2024-07-07T18:17:54,Plentzia,expenses,food,-109.98,-23368.92
buyer_5,Sara,Urkiaga,1994-03-12,44623772T,sara.urkiaga@megaapp.tech,772687,ES92209532362570784285,1506.75,2024-07-08T13:18:53,Plentzia,expenses,water,-95.56,-23464.48
buyer_5,Sara,Urkiaga,1994-03-12,44623772T,sara.urkiaga@megaapp.tech,772687,ES92209532362570784285,1506.75,2024-07-08T12:53:55,Plentzia,expenses,gas,-118.43,-23582.91
buyer_5,Sara,Urkiaga,1994-03-12,44623772T,sara.urkiaga@megaapp.tech,772687,ES92209532362570784285,1506.75,2024-07-08T20:03:26,Plentzia,expenses,leisure,-80.36,-23663.27
buyer_5,Sara,Urkiaga,1994-03-12,44623772T,sara.urkiaga@megaapp.tech,772687,ES92209532362570784285,1506.75,2024-07-08T08:20:44,Plentzia,expenses,gifts,-122.3,-23785.57
buyer_5,Sara,Urkiaga,1994-03-12,44623772T,sara.urkiaga@megaapp.tech,772687,ES92209532362570784285,1506.75,2024-07-09T23:03:19,Plentzia,expenses,leisure,-36.94,-23822.51
buyer_5,Sara,Urkiaga,1994-03-12,44623772T,sara.urkiaga@megaapp.tech,772687,ES92209532362570784285,1506.75,2024-07-10T09:44:04,Plentzia,expenses,food,-72.82,-23895.33
buyer_5,Sara,Urkiaga,1994-03-12,44623772T,sara.urkiaga@megaapp.tech,772687,ES92209532362570784285,1506.75,2024-07-10T11:30:01,Plentzia,expenses,cash,-100.0,-23995.33
buyer_5,Sara,Urkiaga,1994-03-12,44623772T,sara.urkiaga@megaapp.tech,772687,ES92209532362570784285,1506.75,2024-07-13T11:40:51,Plentzia,expenses,cash,-100.0,-24095.33
buyer_5,Sara,Urkiaga,1994-03-12,44623772T,sara.urkiaga@megaapp.tech,772687,ES92209532362570784285,1506.75,2024-07-14T17:47:43,Plentzia,expenses,food,-68.22,-24163.55
buyer_5,Sara,Urkiaga,1994-03-12,44623772T,sara.urkiaga@megaapp.tech,772687,ES92209532362570784285,1506.75,2024-07-14T08:54:16,Plentzia,expenses,leisure,-63.28,-24226.83
buyer_5,Sara,Urkiaga,1994-03-12,44623772T,sara.urkiaga@megaapp.tech,772687,ES92209532362570784285,1506.75,2024-07-14T18:11:08,Plentzia,expenses,repairs,-179.51,-24406.34
buyer_5,Sara,Urkiaga,1994-03-12,44623772T,sara.urkiaga@megaapp.tech,772687,ES92209532362570784285,1506.75,2024-07-16T20:35:18,Plentzia,expenses,repairs,-178.88,-24585.22
buyer_5,Sara,Urkiaga,1994-03-12,44623772T,sara.urkiaga@megaapp.tech,772687,ES92209532362570784285,1506.75,2024-07-18T14:54:05,Plentzia,expenses,transport,-75.23,-24660.45
buyer_5,Sara,Urkiaga,1994-03-12,44623772T,sara.urkiaga@megaapp.tech,772687,ES92209532362570784285,1506.75,2024-07-18T08:51:45,Plentzia,expenses,leisure,-55.83,-24716.28
buyer_5,Sara,Urkiaga,1994-03-12,44623772T,sara.urkiaga@megaapp.tech,772687,ES92209532362570784285,1506.75,2024-07-19T15:45:26,Plentzia,expenses,food,-89.86,-24806.14
buyer_5,Sara,Urkiaga,1994-03-12,44623772T,sara.urkiaga@megaapp.tech,772687,ES92209532362570784285,1506.75,2024-07-19T04:22:59,Plentzia,expenses,education,-76.18,-24882.32
buyer_5,Sara,Urkiaga,1994-03-12,44623772T,sara.urkiaga@megaapp.tech,772687,ES92209532362570784285,1506.75,2024-07-20T15:56:30,Plentzia,expenses,transport,-66.11,-24948.43
buyer_5,Sara,Urkiaga,1994-03-12,44623772T,sara.urkiaga@megaapp.tech,772687,ES92209532362570784285,1506.75,2024-07-21T08:42:57,Plentzia,expenses,leisure,-72.85,-25021.28
buyer_5,Sara,Urkiaga,1994-03-12,44623772T,sara.urkiaga@megaapp.tech,772687,ES92209532362570784285,1506.75,2024-07-23T10:00:32,Plentzia,expenses,education,-55.94,-25077.22
buyer_5,Sara,Urkiaga,1994-03-12,44623772T,sara.urkiaga@megaapp.tech,772687,ES92209532362570784285,1506.75,2024-07-24T04:39:10,Plentzia,expenses,food,-115.96,-25193.18
buyer_5,Sara,Urkiaga,1994-03-12,44623772T,sara.urkiaga@megaapp.tech,772687,ES92209532362570784285,1506.75,2024-07-24T11:29:20,Plentzia,expenses,healthcare,-177.71,-25370.89
buyer_5,Sara,Urkiaga,1994-03-12,44623772T,sara.urkiaga@megaapp.tech,772687,ES92209532362570784285,1506.75,2024-07-25T12:43:08,Plentzia,expenses,food,-99.69,-25470.58
buyer_5,Sara,Urkiaga,1994-03-12,44623772T,sara.urkiaga@megaapp.tech,772687,ES92209532362570784285,1506.75,2024-07-25T08:35:08,Plentzia,expenses,appliances,-167.79,-25638.37
buyer_5,Sara,Urkiaga,1994-03-12,44623772T,sara.urkiaga@megaapp.tech,772687,ES92209532362570784285,1506.75,2024-07-27T18:38:18,Plentzia,expenses,healthcare,-81.85,-25720.22
buyer_5,Sara,Urkiaga,1994-03-12,44623772T,sara.urkiaga@megaapp.tech,772687,ES92209532362570784285,1506.75,2024-07-28T17:03:47,Plentzia,expenses,repairs,-192.53,-25912.75
buyer_5,Sara,Urkiaga,1994-03-12,44623772T,sara.urkiaga@megaapp.tech,772687,ES92209532362570784285,1506.75,2024-08-01T19:42:03,Plentzia,incomes,salary,2658.63,-23254.12
buyer_5,Sara,Urkiaga,1994-03-12,44623772T,sara.urkiaga@megaapp.tech,772687,ES92209532362570784285,1506.75,2024-08-01T19:42:03,Plentzia,incomes,salary_partner,2378.85,-20875.27
buyer_5,Sara,Urkiaga,1994-03-12,44623772T,sara.urkiaga@megaapp.tech,772687,ES92209532362570784285,1506.75,2024-08-01T17:02:17,Plentzia,expenses,transport,-52.08,-20927.35
buyer_5,Sara,Urkiaga,1994-03-12,44623772T,sara.urkiaga@megaapp.tech,772687,ES92209532362570784285,1506.75,2024-08-01T02:36:24,Plentzia,expenses,cash,-100.0,-21027.35
buyer_5,Sara,Urkiaga,1994-03-12,44623772T,sara.urkiaga@megaapp.tech,772687,ES92209532362570784285,1506.75,2024-08-01T19:02:02,Plentzia,expenses,gifts,-374.81,-21402.16
buyer_5,Sara,Urkiaga,1994-03-12,44623772T,sara.urkiaga@megaapp.tech,772687,ES92209532362570784285,1506.75,2024-08-04T13:44:46,Plentzia,expenses,food,-108.6,-21510.76
buyer_5,Sara,Urkiaga,1994-03-12,44623772T,sara.urkiaga@megaapp.tech,772687,ES92209532362570784285,1506.75,2024-08-05T18:10:48,Plentzia,expenses,mortgage,-2604.95,-24115.71
buyer_5,Sara,Urkiaga,1994-03-12,44623772T,sara.urkiaga@megaapp.tech,772687,ES92209532362570784285,1506.75,2024-08-05T18:13:39,Plentzia,expenses,phone,-101.77,-24217.48
buyer_5,Sara,Urkiaga,1994-03-12,44623772T,sara.urkiaga@megaapp.tech,772687,ES92209532362570784285,1506.75,2024-08-06T19:42:54,Plentzia,expenses,cash,-100.0,-24317.48
buyer_5,Sara,Urkiaga,1994-03-12,44623772T,sara.urkiaga@megaapp.tech,772687,ES92209532362570784285,1506.75,2024-08-07T18:30:19,Plentzia,expenses,electricity,-210.65,-24528.13
buyer_5,Sara,Urkiaga,1994-03-12,44623772T,sara.urkiaga@megaapp.tech,772687,ES92209532362570784285,1506.75,2024-08-07T18:20:02,Plentzia,expenses,gas,-148.94,-24677.07
buyer_5,Sara,Urkiaga,1994-03-12,44623772T,sara.urkiaga@megaapp.tech,772687,ES92209532362570784285,1506.75,2024-08-07T08:58:15,Plentzia,expenses,leisure,-60.57,-24737.64
buyer_5,Sara,Urkiaga,1994-03-12,44623772T,sara.urkiaga@megaapp.tech,772687,ES92209532362570784285,1506.75,2024-08-07T15:38:59,Plentzia,expenses,repairs,-130.64,-24868.28
buyer_5,Sara,Urkiaga,1994-03-12,44623772T,sara.urkiaga@megaapp.tech,772687,ES92209532362570784285,1506.75,2024-08-08T16:22:28,Plentzia,expenses,electricity,-184.1,-25052.38
buyer_5,Sara,Urkiaga,1994-03-12,44623772T,sara.urkiaga@megaapp.tech,772687,ES92209532362570784285,1506.75,2024-08-08T07:49:47,Plentzia,expenses,internet,-105.79,-25158.17
buyer_5,Sara,Urkiaga,1994-03-12,44623772T,sara.urkiaga@megaapp.tech,772687,ES92209532362570784285,1506.75,2024-08-08T14:46:28,Plentzia,expenses,transport,-65.37,-25223.54
buyer_5,Sara,Urkiaga,1994-03-12,44623772T,sara.urkiaga@megaapp.tech,772687,ES92209532362570784285,1506.75,2024-08-10T19:46:57,Plentzia,expenses,transport,-88.9,-25312.44
buyer_5,Sara,Urkiaga,1994-03-12,44623772T,sara.urkiaga@megaapp.tech,772687,ES92209532362570784285,1506.75,2024-08-16T23:35:40,Plentzia,expenses,clothing,-68.12,-25380.56
buyer_5,Sara,Urkiaga,1994-03-12,44623772T,sara.urkiaga@megaapp.tech,772687,ES92209532362570784285,1506.75,2024-08-17T09:51:14,Plentzia,expenses,leisure,-27.0,-25407.56
buyer_5,Sara,Urkiaga,1994-03-12,44623772T,sara.urkiaga@megaapp.tech,772687,ES92209532362570784285,1506.75,2024-08-19T08:26:31,Plentzia,expenses,repairs,-317.2,-25724.76
buyer_5,Sara,Urkiaga,1994-03-12,44623772T,sara.urkiaga@megaapp.tech,772687,ES92209532362570784285,1506.75,2024-08-20T15:09:43,Plentzia,expenses,leisure,-48.6,-25773.36
buyer_5,Sara,Urkiaga,1994-03-12,44623772T,sara.urkiaga@megaapp.tech,772687,ES92209532362570784285,1506.75,2024-08-20T04:07:45,Plentzia,expenses,education,-71.27,-25844.63
buyer_5,Sara,Urkiaga,1994-03-12,44623772T,sara.urkiaga@megaapp.tech,772687,ES92209532362570784285,1506.75,2024-08-20T18:23:30,Plentzia,expenses,gifts,-527.48,-26372.11
buyer_5,Sara,Urkiaga,1994-03-12,44623772T,sara.urkiaga@megaapp.tech,772687,ES92209532362570784285,1506.75,2024-08-21T11:30:44,Plentzia,expenses,transport,-71.01,-26443.12
buyer_5,Sara,Urkiaga,1994-03-12,44623772T,sara.urkiaga@megaapp.tech,772687,ES92209532362570784285,1506.75,2024-08-25T22:07:19,Plentzia,expenses,cash,-100.0,-26543.12
buyer_5,Sara,Urkiaga,1994-03-12,44623772T,sara.urkiaga@megaapp.tech,772687,ES92209532362570784285,1506.75,2024-08-26T09:10:00,Plentzia,expenses,transport,-60.37,-26603.49
buyer_5,Sara,Urkiaga,1994-03-12,44623772T,sara.urkiaga@megaapp.tech,772687,ES92209532362570784285,1506.75,2024-08-26T07:45:38,Plentzia,expenses,leisure,-22.93,-26626.42
buyer_5,Sara,Urkiaga,1994-03-12,44623772T,sara.urkiaga@megaapp.tech,772687,ES92209532362570784285,1506.75,2024-08-26T19:14:04,Plentzia,expenses,gifts,-589.69,-27216.11
buyer_5,Sara,Urkiaga,1994-03-12,44623772T,sara.urkiaga@megaapp.tech,772687,ES92209532362570784285,1506.75,2024-08-27T13:19:57,Plentzia,expenses,cash,-100.0,-27316.11
buyer_5,Sara,Urkiaga,1994-03-12,44623772T,sara.urkiaga@megaapp.tech,772687,ES92209532362570784285,1506.75,2024-08-28T08:03:39,Plentzia,expenses,food,-78.79,-27394.9
buyer_5,Sara,Urkiaga,1994-03-12,44623772T,sara.urkiaga@megaapp.tech,772687,ES92209532362570784285,1506.75,2024-08-28T13:25:29,Plentzia,expenses,cash,-100.0,-27494.9
buyer_5,Sara,Urkiaga,1994-03-12,44623772T,sara.urkiaga@megaapp.tech,772687,ES92209532362570784285,1506.75,2024-08-29T21:30:33,Plentzia,expenses,cash,-100.0,-27594.9
buyer_5,Sara,Urkiaga,1994-03-12,44623772T,sara.urkiaga@megaapp.tech,772687,ES92209532362570784285,1506.75,2024-08-30T13:49:13,Plentzia,expenses,food,-81.45,-27676.35
buyer_5,Sara,Urkiaga,1994-03-12,44623772T,sara.urkiaga@megaapp.tech,772687,ES92209532362570784285,1506.75,2024-08-30T16:34:55,Plentzia,expenses,leisure,-50.31,-27726.66
buyer_5,Sara,Urkiaga,1994-03-12,44623772T,sara.urkiaga@megaapp.tech,772687,ES92209532362570784285,1506.75,2024-09-01T17:46:11,Plentzia,incomes,salary,2658.63,-25068.03
buyer_5,Sara,Urkiaga,1994-03-12,44623772T,sara.urkiaga@megaapp.tech,772687,ES92209532362570784285,1506.75,2024-09-01T17:46:11,Plentzia,incomes,salary_partner,2378.85,-22689.18
buyer_5,Sara,Urkiaga,1994-03-12,44623772T,sara.urkiaga@megaapp.tech,772687,ES92209532362570784285,1506.75,2024-09-03T13:38:41,Plentzia,expenses,leisure,-21.89,-22711.07
buyer_5,Sara,Urkiaga,1994-03-12,44623772T,sara.urkiaga@megaapp.tech,772687,ES92209532362570784285,1506.75,2024-09-05T17:41:42,Plentzia,expenses,mortgage,-2604.95,-25316.02
buyer_5,Sara,Urkiaga,1994-03-12,44623772T,sara.urkiaga@megaapp.tech,772687,ES92209532362570784285,1506.75,2024-09-05T17:54:26,Plentzia,expenses,gas,-191.04,-25507.06
buyer_5,Sara,Urkiaga,1994-03-12,44623772T,sara.urkiaga@megaapp.tech,772687,ES92209532362570784285,1506.75,2024-09-06T14:55:12,Plentzia,expenses,water,-91.7,-25598.76
buyer_5,Sara,Urkiaga,1994-03-12,44623772T,sara.urkiaga@megaapp.tech,772687,ES92209532362570784285,1506.75,2024-09-06T12:57:36,Plentzia,expenses,electricity,-150.26,-25749.02
buyer_5,Sara,Urkiaga,1994-03-12,44623772T,sara.urkiaga@megaapp.tech,772687,ES92209532362570784285,1506.75,2024-09-06T13:56:00,Plentzia,expenses,internet,-105.79,-25854.81
buyer_5,Sara,Urkiaga,1994-03-12,44623772T,sara.urkiaga@megaapp.tech,772687,ES92209532362570784285,1506.75,2024-09-06T18:22:51,Plentzia,expenses,transport,-55.81,-25910.62
buyer_5,Sara,Urkiaga,1994-03-12,44623772T,sara.urkiaga@megaapp.tech,772687,ES92209532362570784285,1506.75,2024-09-07T20:11:39,Plentzia,expenses,water,-78.08,-25988.7
buyer_5,Sara,Urkiaga,1994-03-12,44623772T,sara.urkiaga@megaapp.tech,772687,ES92209532362570784285,1506.75,2024-09-07T22:31:56,Plentzia,expenses,gas,-215.36,-26204.06
buyer_5,Sara,Urkiaga,1994-03-12,44623772T,sara.urkiaga@megaapp.tech,772687,ES92209532362570784285,1506.75,2024-09-07T14:35:19,Plentzia,expenses,cash,-100.0,-26304.06
buyer_5,Sara,Urkiaga,1994-03-12,44623772T,sara.urkiaga@megaapp.tech,772687,ES92209532362570784285,1506.75,2024-09-07T09:38:16,Plentzia,expenses,appliances,-292.68,-26596.74
buyer_5,Sara,Urkiaga,1994-03-12,44623772T,sara.urkiaga@megaapp.tech,772687,ES92209532362570784285,1506.75,2024-09-08T08:43:08,Plentzia,expenses,water,-85.95,-26682.69
buyer_5,Sara,Urkiaga,1994-03-12,44623772T,sara.urkiaga@megaapp.tech,772687,ES92209532362570784285,1506.75,2024-09-08T15:27:33,Plentzia,expenses,electricity,-95.54,-26778.23
buyer_5,Sara,Urkiaga,1994-03-12,44623772T,sara.urkiaga@megaapp.tech,772687,ES92209532362570784285,1506.75,2024-09-10T08:46:33,Plentzia,expenses,clothing,-108.01,-26886.24
buyer_5,Sara,Urkiaga,1994-03-12,44623772T,sara.urkiaga@megaapp.tech,772687,ES92209532362570784285,1506.75,2024-09-10T08:43:35,Plentzia,expenses,appliances,-395.6,-27281.84
buyer_5,Sara,Urkiaga,1994-03-12,44623772T,sara.urkiaga@megaapp.tech,772687,ES92209532362570784285,1506.75,2024-09-11T20:24:25,Plentzia,expenses,clothing,-100.58,-27382.42
buyer_5,Sara,Urkiaga,1994-03-12,44623772T,sara.urkiaga@megaapp.tech,772687,ES92209532362570784285,1506.75,2024-09-12T22:33:26,Plentzia,expenses,gifts,-89.38,-27471.8
buyer_5,Sara,Urkiaga,1994-03-12,44623772T,sara.urkiaga@megaapp.tech,772687,ES92209532362570784285,1506.75,2024-09-13T12:08:43,Plentzia,expenses,food,-100.15,-27571.95
buyer_5,Sara,Urkiaga,1994-03-12,44623772T,sara.urkiaga@megaapp.tech,772687,ES92209532362570784285,1506.75,2024-09-14T17:17:42,Plentzia,expenses,leisure,-50.79,-27622.74
buyer_5,Sara,Urkiaga,1994-03-12,44623772T,sara.urkiaga@megaapp.tech,772687,ES92209532362570784285,1506.75,2024-09-14T03:02:08,Plentzia,expenses,cash,-100.0,-27722.74
buyer_5,Sara,Urkiaga,1994-03-12,44623772T,sara.urkiaga@megaapp.tech,772687,ES92209532362570784285,1506.75,2024-09-15T17:13:21,Plentzia,expenses,leisure,-30.42,-27753.16
buyer_5,Sara,Urkiaga,1994-03-12,44623772T,sara.urkiaga@megaapp.tech,772687,ES92209532362570784285,1506.75,2024-09-17T20:07:15,Plentzia,expenses,food,-107.14,-27860.3
buyer_5,Sara,Urkiaga,1994-03-12,44623772T,sara.urkiaga@megaapp.tech,772687,ES92209532362570784285,1506.75,2024-09-17T18:04:00,Plentzia,expenses,transport,-76.96,-27937.26
buyer_5,Sara,Urkiaga,1994-03-12,44623772T,sara.urkiaga@megaapp.tech,772687,ES92209532362570784285,1506.75,2024-09-17T14:13:27,Plentzia,expenses,leisure,-38.24,-27975.5
buyer_5,Sara,Urkiaga,1994-03-12,44623772T,sara.urkiaga@megaapp.tech,772687,ES92209532362570784285,1506.75,2024-09-17T11:26:28,Plentzia,expenses,education,-50.25,-28025.75
buyer_5,Sara,Urkiaga,1994-03-12,44623772T,sara.urkiaga@megaapp.tech,772687,ES92209532362570784285,1506.75,2024-09-21T14:37:27,Plentzia,expenses,food,-79.62,-28105.37
buyer_5,Sara,Urkiaga,1994-03-12,44623772T,sara.urkiaga@megaapp.tech,772687,ES92209532362570784285,1506.75,2024-09-24T13:54:56,Plentzia,expenses,food,-74.98,-28180.35
buyer_5,Sara,Urkiaga,1994-03-12,44623772T,sara.urkiaga@megaapp.tech,772687,ES92209532362570784285,1506.75,2024-09-24T12:50:51,Plentzia,expenses,leisure,-39.05,-28219.4
buyer_5,Sara,Urkiaga,1994-03-12,44623772T,sara.urkiaga@megaapp.tech,772687,ES92209532362570784285,1506.75,2024-09-25T02:34:09,Plentzia,expenses,food,-64.71,-28284.11
buyer_5,Sara,Urkiaga,1994-03-12,44623772T,sara.urkiaga@megaapp.tech,772687,ES92209532362570784285,1506.75,2024-09-25T09:04:23,Plentzia,expenses,education,-64.77,-28348.88
buyer_5,Sara,Urkiaga,1994-03-12,44623772T,sara.urkiaga@megaapp.tech,772687,ES92209532362570784285,1506.75,2024-09-26T09:24:20,Plentzia,expenses,transport,-61.3,-28410.18
buyer_5,Sara,Urkiaga,1994-03-12,44623772T,sara.urkiaga@megaapp.tech,772687,ES92209532362570784285,1506.75,2024-09-27T19:46:55,Plentzia,expenses,clothing,-104.96,-28515.14
buyer_5,Sara,Urkiaga,1994-03-12,44623772T,sara.urkiaga@megaapp.tech,772687,ES92209532362570784285,1506.75,2024-09-28T01:49:21,Plentzia,expenses,appliances,-386.38,-28901.52
buyer_5,Sara,Urkiaga,1994-03-12,44623772T,sara.urkiaga@megaapp.tech,772687,ES92209532362570784285,1506.75,2024-09-30T10:25:25,Plentzia,expenses,cash,-100.0,-29001.52
buyer_5,Sara,Urkiaga,1994-03-12,44623772T,sara.urkiaga@megaapp.tech,772687,ES92209532362570784285,1506.75,2024-10-01T10:14:42,Plentzia,incomes,salary,2658.63,-26342.89
buyer_5,Sara,Urkiaga,1994-03-12,44623772T,sara.urkiaga@megaapp.tech,772687,ES92209532362570784285,1506.75,2024-10-01T10:14:42,Plentzia,incomes,salary_partner,2378.85,-23964.04
buyer_5,Sara,Urkiaga,1994-03-12,44623772T,sara.urkiaga@megaapp.tech,772687,ES92209532362570784285,1506.75,2024-10-01T10:14:42,Plentzia,incomes,extra_income,471.47,-23492.57
buyer_5,Sara,Urkiaga,1994-03-12,44623772T,sara.urkiaga@megaapp.tech,772687,ES92209532362570784285,1506.75,2024-10-01T13:30:59,Plentzia,expenses,food,-78.35,-23570.92
buyer_5,Sara,Urkiaga,1994-03-12,44623772T,sara.urkiaga@megaapp.tech,772687,ES92209532362570784285,1506.75,2024-10-04T16:35:01,Plentzia,expenses,transport,-51.28,-23622.2
buyer_5,Sara,Urkiaga,1994-03-12,44623772T,sara.urkiaga@megaapp.tech,772687,ES92209532362570784285,1506.75,2024-10-04T10:59:43,Plentzia,expenses,cash,-100.0,-23722.2
buyer_5,Sara,Urkiaga,1994-03-12,44623772T,sara.urkiaga@megaapp.tech,772687,ES92209532362570784285,1506.75,2024-10-05T16:14:01,Plentzia,expenses,mortgage,-2604.95,-26327.15
buyer_5,Sara,Urkiaga,1994-03-12,44623772T,sara.urkiaga@megaapp.tech,772687,ES92209532362570784285,1506.75,2024-10-05T05:11:35,Plentzia,expenses,internet,-105.79,-26432.94
buyer_5,Sara,Urkiaga,1994-03-12,44623772T,sara.urkiaga@megaapp.tech,772687,ES92209532362570784285,1506.75,2024-10-06T08:30:03,Plentzia,expenses,electricity,-75.87,-26508.81
buyer_5,Sara,Urkiaga,1994-03-12,44623772T,sara.urkiaga@megaapp.tech,772687,ES92209532362570784285,1506.75,2024-10-06T12:04:37,Plentzia,expenses,gas,-287.81,-26796.62
buyer_5,Sara,Urkiaga,1994-03-12,44623772T,sara.urkiaga@megaapp.tech,772687,ES92209532362570784285,1506.75,2024-10-06T01:47:55,Plentzia,expenses,internet,-105.79,-26902.41
buyer_5,Sara,Urkiaga,1994-03-12,44623772T,sara.urkiaga@megaapp.tech,772687,ES92209532362570784285,1506.75,2024-10-06T20:31:18,Plentzia,expenses,phone,-79.24,-26981.65
buyer_5,Sara,Urkiaga,1994-03-12,44623772T,sara.urkiaga@megaapp.tech,772687,ES92209532362570784285,1506.75,2024-10-07T17:15:24,Plentzia,expenses,gas,-254.36,-27236.01
buyer_5,Sara,Urkiaga,1994-03-12,44623772T,sara.urkiaga@megaapp.tech,772687,ES92209532362570784285,1506.75,2024-10-07T23:15:46,Plentzia,expenses,phone,-100.01,-27336.02
buyer_5,Sara,Urkiaga,1994-03-12,44623772T,sara.urkiaga@megaapp.tech,772687,ES92209532362570784285,1506.75,2024-10-07T19:15:26,Plentzia,expenses,gifts,-70.22,-27406.24
buyer_5,Sara,Urkiaga,1994-03-12,44623772T,sara.urkiaga@megaapp.tech,772687,ES92209532362570784285,1506.75,2024-10-08T02:14:03,Plentzia,expenses,electricity,-199.55,-27605.79
buyer_5,Sara,Urkiaga,1994-03-12,44623772T,sara.urkiaga@megaapp.tech,772687,ES92209532362570784285,1506.75,2024-10-08T13:19:22,Plentzia,expenses,leisure,-53.58,-27659.37
buyer_5,Sara,Urkiaga,1994-03-12,44623772T,sara.urkiaga@megaapp.tech,772687,ES92209532362570784285,1506.75,2024-10-08T15:34:32,Plentzia,expenses,appliances,-217.22,-27876.59
buyer_5,Sara,Urkiaga,1994-03-12,44623772T,sara.urkiaga@megaapp.tech,772687,ES92209532362570784285,1506.75,2024-10-09T15:29:30,Plentzia,expenses,gifts,-463.15,-28339.74
buyer_5,Sara,Urkiaga,1994-03-12,44623772T,sara.urkiaga@megaapp.tech,772687,ES92209532362570784285,1506.75,2024-10-10T18:38:42,Plentzia,expenses,leisure,-20.93,-28360.67
buyer_6,Manuel,Díez,1979-02-14,54911168W,manuel.diez@coolcode.digital,606978,ES48209543417824685298,1248.06,2022-01-01T15:52:51,Valladolid,incomes,salary,2529.12,3777.18
buyer_6,Manuel,Díez,1979-02-14,54911168W,manuel.diez@coolcode.digital,606978,ES48209543417824685298,1248.06,2022-01-01T20:02:20,Valladolid,expenses,transport,-82.03,3695.15
buyer_6,Manuel,Díez,1979-02-14,54911168W,manuel.diez@coolcode.digital,606978,ES48209543417824685298,1248.06,2022-01-03T10:18:44,Valladolid,expenses,transport,-64.85,3630.3
buyer_6,Manuel,Díez,1979-02-14,54911168W,manuel.diez@coolcode.digital,606978,ES48209543417824685298,1248.06,2022-01-03T11:24:52,Valladolid,expenses,cash,-100.0,3530.3
buyer_6,Manuel,Díez,1979-02-14,54911168W,manuel.diez@coolcode.digital,606978,ES48209543417824685298,1248.06,2022-01-04T20:44:53,Valladolid,expenses,transport,-49.75,3480.55
buyer_6,Manuel,Díez,1979-02-14,54911168W,manuel.diez@coolcode.digital,606978,ES48209543417824685298,1248.06,2022-01-05T18:04:14,Valladolid,expenses,mortgage,-1029.57,2450.98
buyer_6,Manuel,Díez,1979-02-14,54911168W,manuel.diez@coolcode.digital,606978,ES48209543417824685298,1248.06,2022-01-05T14:19:28,Valladolid,expenses,phone,-48.06,2402.92
buyer_6,Manuel,Díez,1979-02-14,54911168W,manuel.diez@coolcode.digital,606978,ES48209543417824685298,1248.06,2022-01-06T15:06:18,Valladolid,expenses,electricity,-68.61,2334.31
buyer_6,Manuel,Díez,1979-02-14,54911168W,manuel.diez@coolcode.digital,606978,ES48209543417824685298,1248.06,2022-01-06T16:40:48,Valladolid,expenses,food,-86.63,2247.68
buyer_6,Manuel,Díez,1979-02-14,54911168W,manuel.diez@coolcode.digital,606978,ES48209543417824685298,1248.06,2022-01-06T18:59:59,Valladolid,expenses,gifts,-685.17,1562.51
buyer_6,Manuel,Díez,1979-02-14,54911168W,manuel.diez@coolcode.digital,606978,ES48209543417824685298,1248.06,2022-01-07T07:10:19,Valladolid,expenses,water,-50.82,1511.69
buyer_6,Manuel,Díez,1979-02-14,54911168W,manuel.diez@coolcode.digital,606978,ES48209543417824685298,1248.06,2022-01-07T11:54:07,Valladolid,expenses,internet,-53.11,1458.58
buyer_6,Manuel,Díez,1979-02-14,54911168W,manuel.diez@coolcode.digital,606978,ES48209543417824685298,1248.06,2022-01-08T14:46:18,Valladolid,expenses,water,-53.72,1404.86
buyer_6,Manuel,Díez,1979-02-14,54911168W,manuel.diez@coolcode.digital,606978,ES48209543417824685298,1248.06,2022-01-09T00:50:27,Valladolid,expenses,food,-96.75,1308.11
buyer_6,Manuel,Díez,1979-02-14,54911168W,manuel.diez@coolcode.digital,606978,ES48209543417824685298,1248.06,2022-01-09T12:46:33,Valladolid,expenses,leisure,-61.67,1246.44
buyer_6,Manuel,Díez,1979-02-14,54911168W,manuel.diez@coolcode.digital,606978,ES48209543417824685298,1248.06,2022-01-11T12:03:07,Valladolid,expenses,food,-61.1,1185.34
buyer_6,Manuel,Díez,1979-02-14,54911168W,manuel.diez@coolcode.digital,606978,ES48209543417824685298,1248.06,2022-01-14T18:21:06,Valladolid,expenses,food,-72.4,1112.94
buyer_6,Manuel,Díez,1979-02-14,54911168W,manuel.diez@coolcode.digital,606978,ES48209543417824685298,1248.06,2022-01-15T09:01:54,Valladolid,expenses,leisure,-41.93,1071.01
buyer_6,Manuel,Díez,1979-02-14,54911168W,manuel.diez@coolcode.digital,606978,ES48209543417824685298,1248.06,2022-01-15T09:13:26,Valladolid,expenses,cash,-100.0,971.01
buyer_6,Manuel,Díez,1979-02-14,54911168W,manuel.diez@coolcode.digital,606978,ES48209543417824685298,1248.06,2022-01-16T17:03:46,Valladolid,expenses,cash,-100.0,871.01
buyer_6,Manuel,Díez,1979-02-14,54911168W,manuel.diez@coolcode.digital,606978,ES48209543417824685298,1248.06,2022-01-16T16:47:23,Valladolid,expenses,repairs,-316.88,554.13
buyer_6,Manuel,Díez,1979-02-14,54911168W,manuel.diez@coolcode.digital,606978,ES48209543417824685298,1248.06,2022-01-16T20:34:47,Valladolid,expenses,gifts,-812.53,-258.4
buyer_6,Manuel,Díez,1979-02-14,54911168W,manuel.diez@coolcode.digital,606978,ES48209543417824685298,1248.06,2022-01-18T13:55:36,Valladolid,expenses,cash,-100.0,-358.4
buyer_6,Manuel,Díez,1979-02-14,54911168W,manuel.diez@coolcode.digital,606978,ES48209543417824685298,1248.06,2022-01-19T20:13:19,Valladolid,expenses,clothing,-108.24,-466.64
buyer_6,Manuel,Díez,1979-02-14,54911168W,manuel.diez@coolcode.digital,606978,ES48209543417824685298,1248.06,2022-01-19T23:32:30,Valladolid,expenses,cash,-100.0,-566.64
buyer_6,Manuel,Díez,1979-02-14,54911168W,manuel.diez@coolcode.digital,606978,ES48209543417824685298,1248.06,2022-01-21T18:05:34,Valladolid,expenses,food,-96.97,-663.61
buyer_6,Manuel,Díez,1979-02-14,54911168W,manuel.diez@coolcode.digital,606978,ES48209543417824685298,1248.06,2022-01-21T22:54:48,Valladolid,expenses,leisure,-20.32,-683.93
buyer_6,Manuel,Díez,1979-02-14,54911168W,manuel.diez@coolcode.digital,606978,ES48209543417824685298,1248.06,2022-01-22T22:06:07,Valladolid,expenses,transport,-59.38,-743.31
buyer_6,Manuel,Díez,1979-02-14,54911168W,manuel.diez@coolcode.digital,606978,ES48209543417824685298,1248.06,2022-01-23T12:43:34,Valladolid,expenses,food,-104.79,-848.1
buyer_6,Manuel,Díez,1979-02-14,54911168W,manuel.diez@coolcode.digital,606978,ES48209543417824685298,1248.06,2022-01-23T08:32:29,Valladolid,expenses,clothing,-94.09,-942.19
buyer_6,Manuel,Díez,1979-02-14,54911168W,manuel.diez@coolcode.digital,606978,ES48209543417824685298,1248.06,2022-01-24T16:15:45,Valladolid,expenses,transport,-71.18,-1013.37
buyer_6,Manuel,Díez,1979-02-14,54911168W,manuel.diez@coolcode.digital,606978,ES48209543417824685298,1248.06,2022-01-24T16:56:58,Valladolid,expenses,leisure,-50.44,-1063.81
buyer_6,Manuel,Díez,1979-02-14,54911168W,manuel.diez@coolcode.digital,606978,ES48209543417824685298,1248.06,2022-01-25T16:58:14,Valladolid,expenses,leisure,-56.25,-1120.06
buyer_6,Manuel,Díez,1979-02-14,54911168W,manuel.diez@coolcode.digital,606978,ES48209543417824685298,1248.06,2022-01-27T18:41:22,Valladolid,expenses,transport,-76.44,-1196.5
buyer_6,Manuel,Díez,1979-02-14,54911168W,manuel.diez@coolcode.digital,606978,ES48209543417824685298,1248.06,2022-01-28T01:41:19,Valladolid,expenses,leisure,-64.35,-1260.85
buyer_6,Manuel,Díez,1979-02-14,54911168W,manuel.diez@coolcode.digital,606978,ES48209543417824685298,1248.06,2022-01-28T20:30:17,Valladolid,expenses,education,-49.52,-1310.37
buyer_6,Manuel,Díez,1979-02-14,54911168W,manuel.diez@coolcode.digital,606978,ES48209543417824685298,1248.06,2022-01-29T10:22:38,Valladolid,expenses,gifts,-487.43,-1797.8
buyer_6,Manuel,Díez,1979-02-14,54911168W,manuel.diez@coolcode.digital,606978,ES48209543417824685298,1248.06,2022-02-01T14:50:30,Valladolid,incomes,salary,2529.12,731.32
buyer_6,Manuel,Díez,1979-02-14,54911168W,manuel.diez@coolcode.digital,606978,ES48209543417824685298,1248.06,2022-02-02T15:32:01,Valladolid,expenses,leisure,-37.61,693.71
buyer_6,Manuel,Díez,1979-02-14,54911168W,manuel.diez@coolcode.digital,606978,ES48209543417824685298,1248.06,2022-02-03T12:14:41,Valladolid,expenses,transport,-49.24,644.47
buyer_6,Manuel,Díez,1979-02-14,54911168W,manuel.diez@coolcode.digital,606978,ES48209543417824685298,1248.06,2022-02-04T18:40:02,Valladolid,expenses,food,-63.3,581.17
buyer_6,Manuel,Díez,1979-02-14,54911168W,manuel.diez@coolcode.digital,606978,ES48209543417824685298,1248.06,2022-02-04T20:14:30,Valladolid,expenses,education,-74.43,506.74
buyer_6,Manuel,Díez,1979-02-14,54911168W,manuel.diez@coolcode.digital,606978,ES48209543417824685298,1248.06,2022-02-04T04:41:23,Valladolid,expenses,gifts,-360.62,146.12
buyer_6,Manuel,Díez,1979-02-14,54911168W,manuel.diez@coolcode.digital,606978,ES48209543417824685298,1248.06,2022-02-05T16:32:33,Valladolid,expenses,mortgage,-1029.57,-883.45
buyer_6,Manuel,Díez,1979-02-14,54911168W,manuel.diez@coolcode.digital,606978,ES48209543417824685298,1248.06,2022-02-05T19:50:10,Valladolid,expenses,phone,-41.3,-924.75
buyer_6,Manuel,Díez,1979-02-14,54911168W,manuel.diez@coolcode.digital,606978,ES48209543417824685298,1248.06,2022-02-05T19:15:59,Valladolid,expenses,repairs,-35.58,-960.33
buyer_6,Manuel,Díez,1979-02-14,54911168W,manuel.diez@coolcode.digital,606978,ES48209543417824685298,1248.06,2022-02-06T14:13:46,Valladolid,expenses,water,-26.85,-987.18
buyer_6,Manuel,Díez,1979-02-14,54911168W,manuel.diez@coolcode.digital,606978,ES48209543417824685298,1248.06,2022-02-06T19:24:11,Valladolid,expenses,gas,-92.36,-1079.54
buyer_6,Manuel,Díez,1979-02-14,54911168W,manuel.diez@coolcode.digital,606978,ES48209543417824685298,1248.06,2022-02-06T08:27:46,Valladolid,expenses,internet,-53.11,-1132.65
buyer_6,Manuel,Díez,1979-02-14,54911168W,manuel.diez@coolcode.digital,606978,ES48209543417824685298,1248.06,2022-02-06T13:48:34,Valladolid,expenses,education,-47.88,-1180.53
buyer_6,Manuel,Díez,1979-02-14,54911168W,manuel.diez@coolcode.digital,606978,ES48209543417824685298,1248.06,2022-02-07T04:40:13,Valladolid,expenses,water,-38.49,-1219.02
buyer_6,Manuel,Díez,1979-02-14,54911168W,manuel.diez@coolcode.digital,606978,ES48209543417824685298,1248.06,2022-02-07T00:52:01,Valladolid,expenses,electricity,-55.82,-1274.84
buyer_6,Manuel,Díez,1979-02-14,54911168W,manuel.diez@coolcode.digital,606978,ES48209543417824685298,1248.06,2022-02-07T18:05:29,Valladolid,expenses,phone,-47.34,-1322.18
buyer_6,Manuel,Díez,1979-02-14,54911168W,manuel.diez@coolcode.digital,606978,ES48209543417824685298,1248.06,2022-02-08T11:04:07,Valladolid,expenses,gas,-63.32,-1385.5
buyer_6,Manuel,Díez,1979-02-14,54911168W,manuel.diez@coolcode.digital,606978,ES48209543417824685298,1248.06,2022-02-08T18:14:57,Valladolid,expenses,leisure,-55.33,-1440.83
buyer_6,Manuel,Díez,1979-02-14,54911168W,manuel.diez@coolcode.digital,606978,ES48209543417824685298,1248.06,2022-02-09T14:47:28,Valladolid,expenses,food,-124.39,-1565.22
buyer_6,Manuel,Díez,1979-02-14,54911168W,manuel.diez@coolcode.digital,606978,ES48209543417824685298,1248.06,2022-02-10T11:52:47,Valladolid,expenses,leisure,-77.47,-1642.69
buyer_6,Manuel,Díez,1979-02-14,54911168W,manuel.diez@coolcode.digital,606978,ES48209543417824685298,1248.06,2022-02-12T08:08:00,Valladolid,expenses,clothing,-89.57,-1732.26
buyer_6,Manuel,Díez,1979-02-14,54911168W,manuel.diez@coolcode.digital,606978,ES48209543417824685298,1248.06,2022-02-12T21:46:11,Valladolid,expenses,cash,-100.0,-1832.26
buyer_6,Manuel,Díez,1979-02-14,54911168W,manuel.diez@coolcode.digital,606978,ES48209543417824685298,1248.06,2022-02-12T09:16:19,Valladolid,expenses,appliances,-409.12,-2241.38
buyer_6,Manuel,Díez,1979-02-14,54911168W,manuel.diez@coolcode.digital,606978,ES48209543417824685298,1248.06,2022-02-13T10:02:41,Valladolid,expenses,repairs,-50.6,-2291.98
buyer_6,Manuel,Díez,1979-02-14,54911168W,manuel.diez@coolcode.digital,606978,ES48209543417824685298,1248.06,2022-02-13T16:40:09,Valladolid,expenses,gifts,-237.29,-2529.27
buyer_6,Manuel,Díez,1979-02-14,54911168W,manuel.diez@coolcode.digital,606978,ES48209543417824685298,1248.06,2022-02-14T18:44:27,Valladolid,expenses,food,-77.26,-2606.53
buyer_6,Manuel,Díez,1979-02-14,54911168W,manuel.diez@coolcode.digital,606978,ES48209543417824685298,1248.06,2022-02-14T17:56:25,Valladolid,expenses,clothing,-85.17,-2691.7
buyer_6,Manuel,Díez,1979-02-14,54911168W,manuel.diez@coolcode.digital,606978,ES48209543417824685298,1248.06,2022-02-16T20:42:25,Valladolid,expenses,transport,-81.06,-2772.76
buyer_6,Manuel,Díez,1979-02-14,54911168W,manuel.diez@coolcode.digital,606978,ES48209543417824685298,1248.06,2022-02-19T23:01:38,Valladolid,expenses,clothing,-99.61,-2872.37
buyer_6,Manuel,Díez,1979-02-14,54911168W,manuel.diez@coolcode.digital,606978,ES48209543417824685298,1248.06,2022-02-21T20:10:18,Valladolid,expenses,clothing,-122.43,-2994.8
buyer_6,Manuel,Díez,1979-02-14,54911168W,manuel.diez@coolcode.digital,606978,ES48209543417824685298,1248.06,2022-02-22T17:41:15,Valladolid,expenses,food,-106.2,-3101.0
buyer_6,Manuel,Díez,1979-02-14,54911168W,manuel.diez@coolcode.digital,606978,ES48209543417824685298,1248.06,2022-02-22T02:25:22,Valladolid,expenses,leisure,-26.67,-3127.67
buyer_6,Manuel,Díez,1979-02-14,54911168W,manuel.diez@coolcode.digital,606978,ES48209543417824685298,1248.06,2022-02-23T20:49:17,Valladolid,expenses,cash,-100.0,-3227.67
buyer_6,Manuel,Díez,1979-02-14,54911168W,manuel.diez@coolcode.digital,606978,ES48209543417824685298,1248.06,2022-02-23T04:43:39,Valladolid,expenses,gifts,-577.05,-3804.72
buyer_6,Manuel,Díez,1979-02-14,54911168W,manuel.diez@coolcode.digital,606978,ES48209543417824685298,1248.06,2022-02-24T14:39:33,Valladolid,expenses,cash,-100.0,-3904.72
buyer_6,Manuel,Díez,1979-02-14,54911168W,manuel.diez@coolcode.digital,606978,ES48209543417824685298,1248.06,2022-02-25T18:15:32,Valladolid,expenses,travel,-543.58,-4448.3
buyer_6,Manuel,Díez,1979-02-14,54911168W,manuel.diez@coolcode.digital,606978,ES48209543417824685298,1248.06,2022-02-27T10:06:36,Valladolid,expenses,transport,-65.58,-4513.88
buyer_6,Manuel,Díez,1979-02-14,54911168W,manuel.diez@coolcode.digital,606978,ES48209543417824685298,1248.06,2022-02-28T11:15:54,Valladolid,expenses,transport,-89.0,-4602.88
buyer_6,Manuel,Díez,1979-02-14,54911168W,manuel.diez@coolcode.digital,606978,ES48209543417824685298,1248.06,2022-03-01T20:11:18,Valladolid,incomes,salary,2529.12,-2073.76
buyer_6,Manuel,Díez,1979-02-14,54911168W,manuel.diez@coolcode.digital,606978,ES48209543417824685298,1248.06,2022-03-01T19:26:15,Valladolid,expenses,food,-86.45,-2160.21
buyer_6,Manuel,Díez,1979-02-14,54911168W,manuel.diez@coolcode.digital,606978,ES48209543417824685298,1248.06,2022-03-01T13:58:16,Valladolid,expenses,transport,-47.1,-2207.31
buyer_6,Manuel,Díez,1979-02-14,54911168W,manuel.diez@coolcode.digital,606978,ES48209543417824685298,1248.06,2022-03-03T08:48:27,Valladolid,expenses,gifts,-165.56,-2372.87
buyer_6,Manuel,Díez,1979-02-14,54911168W,manuel.diez@coolcode.digital,606978,ES48209543417824685298,1248.06,2022-03-05T10:03:34,Valladolid,expenses,mortgage,-1029.57,-3402.44
buyer_6,Manuel,Díez,1979-02-14,54911168W,manuel.diez@coolcode.digital,606978,ES48209543417824685298,1248.06,2022-03-05T20:27:31,Valladolid,expenses,gas,-120.99,-3523.43
buyer_6,Manuel,Díez,1979-02-14,54911168W,manuel.diez@coolcode.digital,606978,ES48209543417824685298,1248.06,2022-03-05T12:02:15,Valladolid,expenses,transport,-85.07,-3608.5
buyer_6,Manuel,Díez,1979-02-14,54911168W,manuel.diez@coolcode.digital,606978,ES48209543417824685298,1248.06,2022-03-05T23:56:15,Valladolid,expenses,cash,-100.0,-3708.5
buyer_6,Manuel,Díez,1979-02-14,54911168W,manuel.diez@coolcode.digital,606978,ES48209543417824685298,1248.06,2022-03-06T16:01:13,Valladolid,expenses,water,-29.69,-3738.19
buyer_6,Manuel,Díez,1979-02-14,54911168W,manuel.diez@coolcode.digital,606978,ES48209543417824685298,1248.06,2022-03-07T12:30:29,Valladolid,expenses,gas,-61.47,-3799.66
buyer_6,Manuel,Díez,1979-02-14,54911168W,manuel.diez@coolcode.digital,606978,ES48209543417824685298,1248.06,2022-03-07T14:58:10,Valladolid,expenses,internet,-53.11,-3852.77
buyer_6,Manuel,Díez,1979-02-14,54911168W,manuel.diez@coolcode.digital,606978,ES48209543417824685298,1248.06,2022-03-07T14:25:57,Valladolid,expenses,repairs,-284.56,-4137.33
buyer_6,Manuel,Díez,1979-02-14,54911168W,manuel.diez@coolcode.digital,606978,ES48209543417824685298,1248.06,2022-03-10T20:32:48,Valladolid,expenses,food,-114.16,-4251.49
buyer_6,Manuel,Díez,1979-02-14,54911168W,manuel.diez@coolcode.digital,606978,ES48209543417824685298,1248.06,2022-03-11T13:54:43,Valladolid,expenses,food,-97.68,-4349.17
buyer_6,Manuel,Díez,1979-02-14,54911168W,manuel.diez@coolcode.digital,606978,ES48209543417824685298,1248.06,2022-03-12T09:24:07,Valladolid,expenses,healthcare,-118.1,-4467.27
buyer_6,Manuel,Díez,1979-02-14,54911168W,manuel.diez@coolcode.digital,606978,ES48209543417824685298,1248.06,2022-03-13T19:54:43,Valladolid,expenses,repairs,-322.47,-4789.74
buyer_6,Manuel,Díez,1979-02-14,54911168W,manuel.diez@coolcode.digital,606978,ES48209543417824685298,1248.06,2022-03-14T14:43:36,Valladolid,expenses,leisure,-44.89,-4834.63
buyer_6,Manuel,Díez,1979-02-14,54911168W,manuel.diez@coolcode.digital,606978,ES48209543417824685298,1248.06,2022-03-15T19:20:46,Valladolid,expenses,food,-108.96,-4943.59
buyer_6,Manuel,Díez,1979-02-14,54911168W,manuel.diez@coolcode.digital,606978,ES48209543417824685298,1248.06,2022-03-17T20:01:44,Valladolid,expenses,repairs,-107.48,-5051.07
buyer_6,Manuel,Díez,1979-02-14,54911168W,manuel.diez@coolcode.digital,606978,ES48209543417824685298,1248.06,2022-03-20T09:05:21,Valladolid,expenses,food,-60.79,-5111.86
buyer_6,Manuel,Díez,1979-02-14,54911168W,manuel.diez@coolcode.digital,606978,ES48209543417824685298,1248.06,2022-03-20T11:41:51,Valladolid,expenses,education,-76.51,-5188.37
buyer_6,Manuel,Díez,1979-02-14,54911168W,manuel.diez@coolcode.digital,606978,ES48209543417824685298,1248.06,2022-03-22T11:43:19,Valladolid,expenses,education,-73.43,-5261.8
buyer_6,Manuel,Díez,1979-02-14,54911168W,manuel.diez@coolcode.digital,606978,ES48209543417824685298,1248.06,2022-03-24T05:40:23,Valladolid,expenses,food,-120.45,-5382.25
buyer_6,Manuel,Díez,1979-02-14,54911168W,manuel.diez@coolcode.digital,606978,ES48209543417824685298,1248.06,2022-03-24T20:30:05,Valladolid,expenses,cash,-100.0,-5482.25
buyer_6,Manuel,Díez,1979-02-14,54911168W,manuel.diez@coolcode.digital,606978,ES48209543417824685298,1248.06,2022-03-26T18:19:58,Valladolid,expenses,food,-86.58,-5568.83
buyer_6,Manuel,Díez,1979-02-14,54911168W,manuel.diez@coolcode.digital,606978,ES48209543417824685298,1248.06,2022-03-27T14:38:39,Valladolid,expenses,cash,-100.0,-5668.83
buyer_6,Manuel,Díez,1979-02-14,54911168W,manuel.diez@coolcode.digital,606978,ES48209543417824685298,1248.06,2022-03-27T10:22:05,Valladolid,expenses,repairs,-131.07,-5799.9
buyer_6,Manuel,Díez,1979-02-14,54911168W,manuel.diez@coolcode.digital,606978,ES48209543417824685298,1248.06,2022-03-29T13:26:07,Valladolid,expenses,leisure,-80.41,-5880.31
buyer_6,Manuel,Díez,1979-02-14,54911168W,manuel.diez@coolcode.digital,606978,ES48209543417824685298,1248.06,2022-03-30T17:17:07,Valladolid,expenses,cash,-100.0,-5980.31
buyer_6,Manuel,Díez,1979-02-14,54911168W,manuel.diez@coolcode.digital,606978,ES48209543417824685298,1248.06,2022-03-31T19:31:31,Valladolid,expenses,food,-89.23,-6069.54
buyer_6,Manuel,Díez,1979-02-14,54911168W,manuel.diez@coolcode.digital,606978,ES48209543417824685298,1248.06,2022-04-01T11:00:34,Valladolid,incomes,salary,2529.12,-3540.42
buyer_6,Manuel,Díez,1979-02-14,54911168W,manuel.diez@coolcode.digital,606978,ES48209543417824685298,1248.06,2022-04-01T11:00:34,Valladolid,incomes,extra_income,387.19,-3153.23
buyer_6,Manuel,Díez,1979-02-14,54911168W,manuel.diez@coolcode.digital,606978,ES48209543417824685298,1248.06,2022-04-01T12:27:28,Valladolid,expenses,food,-105.65,-3258.88
buyer_6,Manuel,Díez,1979-02-14,54911168W,manuel.diez@coolcode.digital,606978,ES48209543417824685298,1248.06,2022-04-01T12:01:21,Valladolid,expenses,education,-75.87,-3334.75
buyer_6,Manuel,Díez,1979-02-14,54911168W,manuel.diez@coolcode.digital,606978,ES48209543417824685298,1248.06,2022-04-02T16:42:18,Valladolid,expenses,repairs,-181.45,-3516.2
buyer_6,Manuel,Díez,1979-02-14,54911168W,manuel.diez@coolcode.digital,606978,ES48209543417824685298,1248.06,2022-04-03T14:12:38,Valladolid,expenses,cash,-100.0,-3616.2
buyer_6,Manuel,Díez,1979-02-14,54911168W,manuel.diez@coolcode.digital,606978,ES48209543417824685298,1248.06,2022-04-04T09:09:35,Valladolid,expenses,education,-54.14,-3670.34
buyer_6,Manuel,Díez,1979-02-14,54911168W,manuel.diez@coolcode.digital,606978,ES48209543417824685298,1248.06,2022-04-05T08:35:12,Valladolid,expenses,mortgage,-1029.57,-4699.91
buyer_6,Manuel,Díez,1979-02-14,54911168W,manuel.diez@coolcode.digital,606978,ES48209543417824685298,1248.06,2022-04-06T19:11:59,Valladolid,expenses,water,-45.05,-4744.96
buyer_6,Manuel,Díez,1979-02-14,54911168W,manuel.diez@coolcode.digital,606978,ES48209543417824685298,1248.06,2022-04-06T14:08:26,Valladolid,expenses,electricity,-55.75,-4800.71
buyer_6,Manuel,Díez,1979-02-14,54911168W,manuel.diez@coolcode.digital,606978,ES48209543417824685298,1248.06,2022-04-06T19:11:50,Valladolid,expenses,cash,-100.0,-4900.71
buyer_6,Manuel,Díez,1979-02-14,54911168W,manuel.diez@coolcode.digital,606978,ES48209543417824685298,1248.06,2022-04-06T19:08:10,Valladolid,expenses,travel,-862.95,-5763.66
buyer_6,Manuel,Díez,1979-02-14,54911168W,manuel.diez@coolcode.digital,606978,ES48209543417824685298,1248.06,2022-04-08T15:34:01,Valladolid,expenses,electricity,-99.84,-5863.5
buyer_6,Manuel,Díez,1979-02-14,54911168W,manuel.diez@coolcode.digital,606978,ES48209543417824685298,1248.06,2022-04-08T19:02:23,Valladolid,expenses,transport,-77.91,-5941.41
buyer_6,Manuel,Díez,1979-02-14,54911168W,manuel.diez@coolcode.digital,606978,ES48209543417824685298,1248.06,2022-04-08T18:17:11,Valladolid,expenses,repairs,-265.99,-6207.4
buyer_6,Manuel,Díez,1979-02-14,54911168W,manuel.diez@coolcode.digital,606978,ES48209543417824685298,1248.06,2022-04-09T09:45:56,Valladolid,expenses,food,-93.27,-6300.67
buyer_6,Manuel,Díez,1979-02-14,54911168W,manuel.diez@coolcode.digital,606978,ES48209543417824685298,1248.06,2022-04-10T10:33:00,Valladolid,expenses,food,-119.97,-6420.64
buyer_6,Manuel,Díez,1979-02-14,54911168W,manuel.diez@coolcode.digital,606978,ES48209543417824685298,1248.06,2022-04-13T15:14:14,Valladolid,expenses,healthcare,-146.06,-6566.7
buyer_6,Manuel,Díez,1979-02-14,54911168W,manuel.diez@coolcode.digital,606978,ES48209543417824685298,1248.06,2022-04-15T10:12:02,Valladolid,expenses,leisure,-41.57,-6608.27
buyer_6,Manuel,Díez,1979-02-14,54911168W,manuel.diez@coolcode.digital,606978,ES48209543417824685298,1248.06,2022-04-15T23:27:45,Valladolid,expenses,clothing,-102.33,-6710.6
buyer_6,Manuel,Díez,1979-02-14,54911168W,manuel.diez@coolcode.digital,606978,ES48209543417824685298,1248.06,2022-04-15T15:48:48,Valladolid,expenses,cash,-100.0,-6810.6
buyer_6,Manuel,Díez,1979-02-14,54911168W,manuel.diez@coolcode.digital,606978,ES48209543417824685298,1248.06,2022-04-15T12:34:35,Valladolid,expenses,appliances,-408.81,-7219.41
buyer_6,Manuel,Díez,1979-02-14,54911168W,manuel.diez@coolcode.digital,606978,ES48209543417824685298,1248.06,2022-04-16T15:03:35,Valladolid,expenses,education,-71.91,-7291.32
buyer_6,Manuel,Díez,1979-02-14,54911168W,manuel.diez@coolcode.digital,606978,ES48209543417824685298,1248.06,2022-04-16T14:03:49,Valladolid,expenses,cash,-100.0,-7391.32
buyer_6,Manuel,Díez,1979-02-14,54911168W,manuel.diez@coolcode.digital,606978,ES48209543417824685298,1248.06,2022-04-16T18:03:07,Valladolid,expenses,appliances,-299.26,-7690.58
buyer_6,Manuel,Díez,1979-02-14,54911168W,manuel.diez@coolcode.digital,606978,ES48209543417824685298,1248.06,2022-04-16T16:04:47,Valladolid,expenses,gifts,-356.31,-8046.89
buyer_6,Manuel,Díez,1979-02-14,54911168W,manuel.diez@coolcode.digital,606978,ES48209543417824685298,1248.06,2022-04-18T19:18:15,Valladolid,expenses,food,-66.61,-8113.5
buyer_6,Manuel,Díez,1979-02-14,54911168W,manuel.diez@coolcode.digital,606978,ES48209543417824685298,1248.06,2022-04-18T17:15:56,Valladolid,expenses,leisure,-34.89,-8148.39
buyer_6,Manuel,Díez,1979-02-14,54911168W,manuel.diez@coolcode.digital,606978,ES48209543417824685298,1248.06,2022-04-20T16:47:20,Valladolid,expenses,healthcare,-170.92,-8319.31
buyer_6,Manuel,Díez,1979-02-14,54911168W,manuel.diez@coolcode.digital,606978,ES48209543417824685298,1248.06,2022-04-21T21:15:12,Valladolid,expenses,cash,-100.0,-8419.31
buyer_6,Manuel,Díez,1979-02-14,54911168W,manuel.diez@coolcode.digital,606978,ES48209543417824685298,1248.06,2022-04-21T23:38:41,Valladolid,expenses,repairs,-293.73,-8713.04
buyer_6,Manuel,Díez,1979-02-14,54911168W,manuel.diez@coolcode.digital,606978,ES48209543417824685298,1248.06,2022-04-25T15:58:47,Valladolid,expenses,food,-97.32,-8810.36
buyer_6,Manuel,Díez,1979-02-14,54911168W,manuel.diez@coolcode.digital,606978,ES48209543417824685298,1248.06,2022-04-25T18:58:44,Valladolid,expenses,leisure,-43.75,-8854.11
buyer_6,Manuel,Díez,1979-02-14,54911168W,manuel.diez@coolcode.digital,606978,ES48209543417824685298,1248.06,2022-04-25T10:37:41,Valladolid,expenses,cash,-100.0,-8954.11
buyer_6,Manuel,Díez,1979-02-14,54911168W,manuel.diez@coolcode.digital,606978,ES48209543417824685298,1248.06,2022-04-28T15:57:54,Valladolid,expenses,food,-97.39,-9051.5
buyer_6,Manuel,Díez,1979-02-14,54911168W,manuel.diez@coolcode.digital,606978,ES48209543417824685298,1248.06,2022-04-29T05:10:51,Valladolid,expenses,leisure,-73.99,-9125.49
buyer_6,Manuel,Díez,1979-02-14,54911168W,manuel.diez@coolcode.digital,606978,ES48209543417824685298,1248.06,2022-04-30T18:37:04,Valladolid,expenses,food,-65.92,-9191.41
buyer_6,Manuel,Díez,1979-02-14,54911168W,manuel.diez@coolcode.digital,606978,ES48209543417824685298,1248.06,2022-04-30T15:13:32,Valladolid,expenses,gifts,-231.75,-9423.16
buyer_6,Manuel,Díez,1979-02-14,54911168W,manuel.diez@coolcode.digital,606978,ES48209543417824685298,1248.06,2022-05-01T12:31:11,Valladolid,incomes,salary,2529.12,-6894.04
buyer_6,Manuel,Díez,1979-02-14,54911168W,manuel.diez@coolcode.digital,606978,ES48209543417824685298,1248.06,2022-05-01T05:03:40,Valladolid,expenses,food,-71.18,-6965.22
buyer_6,Manuel,Díez,1979-02-14,54911168W,manuel.diez@coolcode.digital,606978,ES48209543417824685298,1248.06,2022-05-01T11:31:12,Valladolid,expenses,leisure,-33.12,-6998.34
buyer_6,Manuel,Díez,1979-02-14,54911168W,manuel.diez@coolcode.digital,606978,ES48209543417824685298,1248.06,2022-05-01T01:28:40,Valladolid,expenses,gifts,-516.75,-7515.09
buyer_6,Manuel,Díez,1979-02-14,54911168W,manuel.diez@coolcode.digital,606978,ES48209543417824685298,1248.06,2022-05-03T17:05:52,Valladolid,expenses,cash,-100.0,-7615.09
buyer_6,Manuel,Díez,1979-02-14,54911168W,manuel.diez@coolcode.digital,606978,ES48209543417824685298,1248.06,2022-05-03T10:00:33,Valladolid,expenses,travel,-367.25,-7982.34
buyer_6,Manuel,Díez,1979-02-14,54911168W,manuel.diez@coolcode.digital,606978,ES48209543417824685298,1248.06,2022-05-04T16:45:19,Valladolid,expenses,transport,-54.99,-8037.33
buyer_6,Manuel,Díez,1979-02-14,54911168W,manuel.diez@coolcode.digital,606978,ES48209543417824685298,1248.06,2022-05-04T10:31:37,Valladolid,expenses,education,-68.82,-8106.15
buyer_6,Manuel,Díez,1979-02-14,54911168W,manuel.diez@coolcode.digital,606978,ES48209543417824685298,1248.06,2022-05-05T19:25:20,Valladolid,expenses,mortgage,-1029.57,-9135.72
buyer_6,Manuel,Díez,1979-02-14,54911168W,manuel.diez@coolcode.digital,606978,ES48209543417824685298,1248.06,2022-05-05T16:42:30,Valladolid,expenses,electricity,-104.09,-9239.81
buyer_6,Manuel,Díez,1979-02-14,54911168W,manuel.diez@coolcode.digital,606978,ES48209543417824685298,1248.06,2022-05-05T17:13:41,Valladolid,expenses,clothing,-65.52,-9305.33
buyer_6,Manuel,Díez,1979-02-14,54911168W,manuel.diez@coolcode.digital,606978,ES48209543417824685298,1248.06,2022-05-06T14:06:05,Valladolid,expenses,water,-52.56,-9357.89
buyer_6,Manuel,Díez,1979-02-14,54911168W,manuel.diez@coolcode.digital,606978,ES48209543417824685298,1248.06,2022-05-06T14:21:32,Valladolid,expenses,electricity,-106.52,-9464.41
buyer_6,Manuel,Díez,1979-02-14,54911168W,manuel.diez@coolcode.digital,606978,ES48209543417824685298,1248.06,2022-05-06T08:03:40,Valladolid,expenses,gas,-81.74,-9546.15
buyer_6,Manuel,Díez,1979-02-14,54911168W,manuel.diez@coolcode.digital,606978,ES48209543417824685298,1248.06,2022-05-06T16:46:18,Valladolid,expenses,transport,-48.78,-9594.93
buyer_6,Manuel,Díez,1979-02-14,54911168W,manuel.diez@coolcode.digital,606978,ES48209543417824685298,1248.06,2022-05-07T08:22:11,Valladolid,expenses,gifts,-773.14,-10368.07
buyer_6,Manuel,Díez,1979-02-14,54911168W,manuel.diez@coolcode.digital,606978,ES48209543417824685298,1248.06,2022-05-08T21:43:05,Valladolid,expenses,gas,-108.79,-10476.86
buyer_6,Manuel,Díez,1979-02-14,54911168W,manuel.diez@coolcode.digital,606978,ES48209543417824685298,1248.06,2022-05-08T19:15:02,Valladolid,expenses,food,-75.42,-10552.28
buyer_6,Manuel,Díez,1979-02-14,54911168W,manuel.diez@coolcode.digital,606978,ES48209543417824685298,1248.06,2022-05-09T17:30:10,Valladolid,expenses,cash,-100.0,-10652.28
buyer_6,Manuel,Díez,1979-02-14,54911168W,manuel.diez@coolcode.digital,606978,ES48209543417824685298,1248.06,2022-05-11T20:06:21,Valladolid,expenses,healthcare,-102.64,-10754.92
buyer_6,Manuel,Díez,1979-02-14,54911168W,manuel.diez@coolcode.digital,606978,ES48209543417824685298,1248.06,2022-05-13T08:21:36,Valladolid,expenses,transport,-46.44,-10801.36
buyer_6,Manuel,Díez,1979-02-14,54911168W,manuel.diez@coolcode.digital,606978,ES48209543417824685298,1248.06,2022-05-13T18:19:23,Valladolid,expenses,cash,-100.0,-10901.36
buyer_6,Manuel,Díez,1979-02-14,54911168W,manuel.diez@coolcode.digital,606978,ES48209543417824685298,1248.06,2022-05-14T14:23:04,Valladolid,expenses,leisure,-41.33,-10942.69
buyer_6,Manuel,Díez,1979-02-14,54911168W,manuel.diez@coolcode.digital,606978,ES48209543417824685298,1248.06,2022-05-17T05:01:11,Valladolid,expenses,transport,-58.37,-11001.06
buyer_6,Manuel,Díez,1979-02-14,54911168W,manuel.diez@coolcode.digital,606978,ES48209543417824685298,1248.06,2022-05-17T02:04:52,Valladolid,expenses,cash,-100.0,-11101.06
buyer_6,Manuel,Díez,1979-02-14,54911168W,manuel.diez@coolcode.digital,606978,ES48209543417824685298,1248.06,2022-05-19T05:21:19,Valladolid,expenses,cash,-100.0,-11201.06
buyer_6,Manuel,Díez,1979-02-14,54911168W,manuel.diez@coolcode.digital,606978,ES48209543417824685298,1248.06,2022-05-19T08:57:08,Valladolid,expenses,gifts,-115.26,-11316.32
buyer_6,Manuel,Díez,1979-02-14,54911168W,manuel.diez@coolcode.digital,606978,ES48209543417824685298,1248.06,2022-05-20T14:52:06,Valladolid,expenses,cash,-100.0,-11416.32
buyer_6,Manuel,Díez,1979-02-14,54911168W,manuel.diez@coolcode.digital,606978,ES48209543417824685298,1248.06,2022-05-23T13:45:01,Valladolid,expenses,food,-98.5,-11514.82
buyer_6,Manuel,Díez,1979-02-14,54911168W,manuel.diez@coolcode.digital,606978,ES48209543417824685298,1248.06,2022-05-23T13:44:27,Valladolid,expenses,cash,-100.0,-11614.82
buyer_6,Manuel,Díez,1979-02-14,54911168W,manuel.diez@coolcode.digital,606978,ES48209543417824685298,1248.06,2022-05-24T14:40:59,Valladolid,expenses,transport,-59.56,-11674.38
buyer_6,Manuel,Díez,1979-02-14,54911168W,manuel.diez@coolcode.digital,606978,ES48209543417824685298,1248.06,2022-05-24T19:03:49,Valladolid,expenses,cash,-100.0,-11774.38
buyer_6,Manuel,Díez,1979-02-14,54911168W,manuel.diez@coolcode.digital,606978,ES48209543417824685298,1248.06,2022-05-25T16:33:26,Valladolid,expenses,gifts,-804.46,-12578.84
buyer_6,Manuel,Díez,1979-02-14,54911168W,manuel.diez@coolcode.digital,606978,ES48209543417824685298,1248.06,2022-05-27T12:21:25,Valladolid,expenses,cash,-100.0,-12678.84
buyer_6,Manuel,Díez,1979-02-14,54911168W,manuel.diez@coolcode.digital,606978,ES48209543417824685298,1248.06,2022-05-28T17:22:23,Valladolid,expenses,gifts,-675.06,-13353.9
buyer_6,Manuel,Díez,1979-02-14,54911168W,manuel.diez@coolcode.digital,606978,ES48209543417824685298,1248.06,2022-05-29T16:05:17,Valladolid,expenses,food,-93.3,-13447.2
buyer_6,Manuel,Díez,1979-02-14,54911168W,manuel.diez@coolcode.digital,606978,ES48209543417824685298,1248.06,2022-06-01T20:25:40,Valladolid,incomes,salary,2529.12,-10918.08
buyer_6,Manuel,Díez,1979-02-14,54911168W,manuel.diez@coolcode.digital,606978,ES48209543417824685298,1248.06,2022-06-01T20:25:40,Valladolid,incomes,salary_bonus,1771.58,-9146.5
buyer_6,Manuel,Díez,1979-02-14,54911168W,manuel.diez@coolcode.digital,606978,ES48209543417824685298,1248.06,2022-06-01T15:05:59,Valladolid,expenses,taxes,-1833.03,-10979.53
buyer_6,Manuel,Díez,1979-02-14,54911168W,manuel.diez@coolcode.digital,606978,ES48209543417824685298,1248.06,2022-06-01T13:23:07,Valladolid,expenses,insurance,-471.23,-11450.76
buyer_6,Manuel,Díez,1979-02-14,54911168W,manuel.diez@coolcode.digital,606978,ES48209543417824685298,1248.06,2022-06-03T19:47:52,Valladolid,expenses,transport,-59.77,-11510.53
buyer_6,Manuel,Díez,1979-02-14,54911168W,manuel.diez@coolcode.digital,606978,ES48209543417824685298,1248.06,2022-06-04T14:28:09,Valladolid,expenses,food,-106.75,-11617.28
buyer_6,Manuel,Díez,1979-02-14,54911168W,manuel.diez@coolcode.digital,606978,ES48209543417824685298,1248.06,2022-06-05T14:05:02,Valladolid,expenses,mortgage,-1029.57,-12646.85
buyer_6,Manuel,Díez,1979-02-14,54911168W,manuel.diez@coolcode.digital,606978,ES48209543417824685298,1248.06,2022-06-05T17:59:49,Valladolid,expenses,electricity,-36.81,-12683.66
buyer_6,Manuel,Díez,1979-02-14,54911168W,manuel.diez@coolcode.digital,606978,ES48209543417824685298,1248.06,2022-06-05T10:25:05,Valladolid,expenses,internet,-53.11,-12736.77
buyer_6,Manuel,Díez,1979-02-14,54911168W,manuel.diez@coolcode.digital,606978,ES48209543417824685298,1248.06,2022-06-05T14:06:11,Valladolid,expenses,food,-72.3,-12809.07
buyer_6,Manuel,Díez,1979-02-14,54911168W,manuel.diez@coolcode.digital,606978,ES48209543417824685298,1248.06,2022-06-05T06:54:24,Valladolid,expenses,repairs,-195.25,-13004.32
buyer_6,Manuel,Díez,1979-02-14,54911168W,manuel.diez@coolcode.digital,606978,ES48209543417824685298,1248.06,2022-06-06T18:50:29,Valladolid,expenses,internet,-53.11,-13057.43
buyer_6,Manuel,Díez,1979-02-14,54911168W,manuel.diez@coolcode.digital,606978,ES48209543417824685298,1248.06,2022-06-06T18:44:18,Valladolid,expenses,repairs,-149.63,-13207.06
buyer_6,Manuel,Díez,1979-02-14,54911168W,manuel.diez@coolcode.digital,606978,ES48209543417824685298,1248.06,2022-06-07T19:12:55,Valladolid,expenses,water,-27.66,-13234.72
buyer_6,Manuel,Díez,1979-02-14,54911168W,manuel.diez@coolcode.digital,606978,ES48209543417824685298,1248.06,2022-06-07T20:29:13,Valladolid,expenses,electricity,-105.72,-13340.44
buyer_6,Manuel,Díez,1979-02-14,54911168W,manuel.diez@coolcode.digital,606978,ES48209543417824685298,1248.06,2022-06-07T16:32:34,Valladolid,expenses,food,-83.27,-13423.71
buyer_6,Manuel,Díez,1979-02-14,54911168W,manuel.diez@coolcode.digital,606978,ES48209543417824685298,1248.06,2022-06-08T18:21:58,Valladolid,expenses,gas,-121.47,-13545.18
buyer_6,Manuel,Díez,1979-02-14,54911168W,manuel.diez@coolcode.digital,606978,ES48209543417824685298,1248.06,2022-06-10T18:54:54,Valladolid,expenses,repairs,-131.99,-13677.17
buyer_6,Manuel,Díez,1979-02-14,54911168W,manuel.diez@coolcode.digital,606978,ES48209543417824685298,1248.06,2022-06-11T17:52:54,Valladolid,expenses,food,-93.14,-13770.31
buyer_6,Manuel,Díez,1979-02-14,54911168W,manuel.diez@coolcode.digital,606978,ES48209543417824685298,1248.06,2022-06-11T18:27:41,Valladolid,expenses,cash,-100.0,-13870.31
buyer_6,Manuel,Díez,1979-02-14,54911168W,manuel.diez@coolcode.digital,606978,ES48209543417824685298,1248.06,2022-06-15T22:46:40,Valladolid,expenses,leisure,-46.33,-13916.64
buyer_6,Manuel,Díez,1979-02-14,54911168W,manuel.diez@coolcode.digital,606978,ES48209543417824685298,1248.06,2022-06-16T08:17:19,Valladolid,expenses,healthcare,-165.78,-14082.42
buyer_6,Manuel,Díez,1979-02-14,54911168W,manuel.diez@coolcode.digital,606978,ES48209543417824685298,1248.06,2022-06-16T09:28:32,Valladolid,expenses,repairs,-253.71,-14336.13
buyer_6,Manuel,Díez,1979-02-14,54911168W,manuel.diez@coolcode.digital,606978,ES48209543417824685298,1248.06,2022-06-17T19:52:15,Valladolid,expenses,education,-76.73,-14412.86
buyer_6,Manuel,Díez,1979-02-14,54911168W,manuel.diez@coolcode.digital,606978,ES48209543417824685298,1248.06,2022-06-17T14:05:35,Valladolid,expenses,appliances,-321.46,-14734.32
buyer_6,Manuel,Díez,1979-02-14,54911168W,manuel.diez@coolcode.digital,606978,ES48209543417824685298,1248.06,2022-06-18T08:04:18,Valladolid,expenses,food,-107.47,-14841.79
buyer_6,Manuel,Díez,1979-02-14,54911168W,manuel.diez@coolcode.digital,606978,ES48209543417824685298,1248.06,2022-06-20T17:26:15,Valladolid,expenses,leisure,-70.37,-14912.16
buyer_6,Manuel,Díez,1979-02-14,54911168W,manuel.diez@coolcode.digital,606978,ES48209543417824685298,1248.06,2022-06-20T15:06:33,Valladolid,expenses,cash,-100.0,-15012.16
buyer_6,Manuel,Díez,1979-02-14,54911168W,manuel.diez@coolcode.digital,606978,ES48209543417824685298,1248.06,2022-06-22T18:19:38,Valladolid,expenses,repairs,-207.84,-15220.0
buyer_6,Manuel,Díez,1979-02-14,54911168W,manuel.diez@coolcode.digital,606978,ES48209543417824685298,1248.06,2022-06-25T15:03:32,Valladolid,expenses,cash,-100.0,-15320.0
buyer_6,Manuel,Díez,1979-02-14,54911168W,manuel.diez@coolcode.digital,606978,ES48209543417824685298,1248.06,2022-06-27T20:36:29,Valladolid,expenses,clothing,-75.6,-15395.6
buyer_6,Manuel,Díez,1979-02-14,54911168W,manuel.diez@coolcode.digital,606978,ES48209543417824685298,1248.06,2022-06-27T18:08:51,Valladolid,expenses,cash,-100.0,-15495.6
buyer_6,Manuel,Díez,1979-02-14,54911168W,manuel.diez@coolcode.digital,606978,ES48209543417824685298,1248.06,2022-06-27T10:20:50,Valladolid,expenses,appliances,-352.52,-15848.12
buyer_6,Manuel,Díez,1979-02-14,54911168W,manuel.diez@coolcode.digital,606978,ES48209543417824685298,1248.06,2022-07-01T20:06:32,Valladolid,incomes,salary,2529.12,-13319.0
buyer_6,Manuel,Díez,1979-02-14,54911168W,manuel.diez@coolcode.digital,606978,ES48209543417824685298,1248.06,2022-07-01T13:01:44,Valladolid,expenses,leisure,-73.02,-13392.02
buyer_6,Manuel,Díez,1979-02-14,54911168W,manuel.diez@coolcode.digital,606978,ES48209543417824685298,1248.06,2022-07-01T10:34:32,Valladolid,expenses,cash,-100.0,-13492.02
buyer_6,Manuel,Díez,1979-02-14,54911168W,manuel.diez@coolcode.digital,606978,ES48209543417824685298,1248.06,2022-07-04T15:23:17,Valladolid,expenses,clothing,-54.1,-13546.12
buyer_6,Manuel,Díez,1979-02-14,54911168W,manuel.diez@coolcode.digital,606978,ES48209543417824685298,1248.06,2022-07-04T10:08:26,Valladolid,expenses,cash,-100.0,-13646.12
buyer_6,Manuel,Díez,1979-02-14,54911168W,manuel.diez@coolcode.digital,606978,ES48209543417824685298,1248.06,2022-07-05T14:01:20,Valladolid,expenses,mortgage,-1029.57,-14675.69
buyer_6,Manuel,Díez,1979-02-14,54911168W,manuel.diez@coolcode.digital,606978,ES48209543417824685298,1248.06,2022-07-05T13:12:42,Valladolid,expenses,water,-40.78,-14716.47
buyer_6,Manuel,Díez,1979-02-14,54911168W,manuel.diez@coolcode.digital,606978,ES48209543417824685298,1248.06,2022-07-05T05:57:53,Valladolid,expenses,gas,-112.5,-14828.97
buyer_6,Manuel,Díez,1979-02-14,54911168W,manuel.diez@coolcode.digital,606978,ES48209543417824685298,1248.06,2022-07-05T20:34:07,Valladolid,expenses,internet,-53.11,-14882.08
buyer_6,Manuel,Díez,1979-02-14,54911168W,manuel.diez@coolcode.digital,606978,ES48209543417824685298,1248.06,2022-07-05T23:51:32,Valladolid,expenses,phone,-55.38,-14937.46
buyer_6,Manuel,Díez,1979-02-14,54911168W,manuel.diez@coolcode.digital,606978,ES48209543417824685298,1248.06,2022-07-06T13:39:21,Valladolid,expenses,water,-43.16,-14980.62
buyer_6,Manuel,Díez,1979-02-14,54911168W,manuel.diez@coolcode.digital,606978,ES48209543417824685298,1248.06,2022-07-06T10:07:00,Valladolid,expenses,electricity,-110.57,-15091.19
buyer_6,Manuel,Díez,1979-02-14,54911168W,manuel.diez@coolcode.digital,606978,ES48209543417824685298,1248.06,2022-07-06T16:12:46,Valladolid,expenses,leisure,-27.6,-15118.79
buyer_6,Manuel,Díez,1979-02-14,54911168W,manuel.diez@coolcode.digital,606978,ES48209543417824685298,1248.06,2022-07-07T11:04:46,Valladolid,expenses,electricity,-111.2,-15229.99
buyer_6,Manuel,Díez,1979-02-14,54911168W,manuel.diez@coolcode.digital,606978,ES48209543417824685298,1248.06,2022-07-07T10:59:21,Valladolid,expenses,cash,-100.0,-15329.99
buyer_6,Manuel,Díez,1979-02-14,54911168W,manuel.diez@coolcode.digital,606978,ES48209543417824685298,1248.06,2022-07-07T18:41:47,Valladolid,expenses,gifts,-572.27,-15902.26
buyer_6,Manuel,Díez,1979-02-14,54911168W,manuel.diez@coolcode.digital,606978,ES48209543417824685298,1248.06,2022-07-08T19:38:08,Valladolid,expenses,phone,-44.29,-15946.55
buyer_6,Manuel,Díez,1979-02-14,54911168W,manuel.diez@coolcode.digital,606978,ES48209543417824685298,1248.06,2022-07-08T18:02:23,Valladolid,expenses,transport,-57.24,-16003.79
buyer_6,Manuel,Díez,1979-02-14,54911168W,manuel.diez@coolcode.digital,606978,ES48209543417824685298,1248.06,2022-07-09T03:41:28,Valladolid,expenses,education,-78.3,-16082.09
buyer_6,Manuel,Díez,1979-02-14,54911168W,manuel.diez@coolcode.digital,606978,ES48209543417824685298,1248.06,2022-07-10T15:27:39,Valladolid,expenses,cash,-100.0,-16182.09
buyer_6,Manuel,Díez,1979-02-14,54911168W,manuel.diez@coolcode.digital,606978,ES48209543417824685298,1248.06,2022-07-11T11:44:26,Valladolid,expenses,cash,-100.0,-16282.09
buyer_6,Manuel,Díez,1979-02-14,54911168W,manuel.diez@coolcode.digital,606978,ES48209543417824685298,1248.06,2022-07-14T15:50:55,Valladolid,expenses,transport,-74.03,-16356.12
buyer_6,Manuel,Díez,1979-02-14,54911168W,manuel.diez@coolcode.digital,606978,ES48209543417824685298,1248.06,2022-07-15T08:44:04,Valladolid,expenses,cash,-100.0,-16456.12
buyer_6,Manuel,Díez,1979-02-14,54911168W,manuel.diez@coolcode.digital,606978,ES48209543417824685298,1248.06,2022-07-16T09:34:38,Valladolid,expenses,transport,-68.19,-16524.31
buyer_6,Manuel,Díez,1979-02-14,54911168W,manuel.diez@coolcode.digital,606978,ES48209543417824685298,1248.06,2022-07-16T14:00:30,Valladolid,expenses,clothing,-70.67,-16594.98
buyer_6,Manuel,Díez,1979-02-14,54911168W,manuel.diez@coolcode.digital,606978,ES48209543417824685298,1248.06,2022-07-17T19:32:44,Valladolid,expenses,cash,-100.0,-16694.98
buyer_6,Manuel,Díez,1979-02-14,54911168W,manuel.diez@coolcode.digital,606978,ES48209543417824685298,1248.06,2022-07-18T14:52:33,Valladolid,expenses,leisure,-34.05,-16729.03
buyer_6,Manuel,Díez,1979-02-14,54911168W,manuel.diez@coolcode.digital,606978,ES48209543417824685298,1248.06,2022-07-18T18:41:11,Valladolid,expenses,repairs,-149.36,-16878.39
buyer_6,Manuel,Díez,1979-02-14,54911168W,manuel.diez@coolcode.digital,606978,ES48209543417824685298,1248.06,2022-07-19T19:45:32,Valladolid,expenses,travel,-964.05,-17842.44
buyer_6,Manuel,Díez,1979-02-14,54911168W,manuel.diez@coolcode.digital,606978,ES48209543417824685298,1248.06,2022-07-20T12:07:42,Valladolid,expenses,cash,-100.0,-17942.44
buyer_6,Manuel,Díez,1979-02-14,54911168W,manuel.diez@coolcode.digital,606978,ES48209543417824685298,1248.06,2022-07-20T20:24:58,Valladolid,expenses,gifts,-618.17,-18560.61
buyer_6,Manuel,Díez,1979-02-14,54911168W,manuel.diez@coolcode.digital,606978,ES48209543417824685298,1248.06,2022-07-22T21:20:42,Valladolid,expenses,leisure,-73.1,-18633.71
buyer_6,Manuel,Díez,1979-02-14,54911168W,manuel.diez@coolcode.digital,606978,ES48209543417824685298,1248.06,2022-07-25T20:21:08,Valladolid,expenses,transport,-80.1,-18713.81
buyer_6,Manuel,Díez,1979-02-14,54911168W,manuel.diez@coolcode.digital,606978,ES48209543417824685298,1248.06,2022-07-26T08:12:18,Valladolid,expenses,clothing,-87.47,-18801.28
buyer_6,Manuel,Díez,1979-02-14,54911168W,manuel.diez@coolcode.digital,606978,ES48209543417824685298,1248.06,2022-07-27T16:04:30,Valladolid,expenses,food,-95.9,-18897.18
buyer_6,Manuel,Díez,1979-02-14,54911168W,manuel.diez@coolcode.digital,606978,ES48209543417824685298,1248.06,2022-07-28T13:11:15,Valladolid,expenses,transport,-49.68,-18946.86
buyer_6,Manuel,Díez,1979-02-14,54911168W,manuel.diez@coolcode.digital,606978,ES48209543417824685298,1248.06,2022-07-31T01:16:08,Valladolid,expenses,cash,-100.0,-19046.86
buyer_6,Manuel,Díez,1979-02-14,54911168W,manuel.diez@coolcode.digital,606978,ES48209543417824685298,1248.06,2022-07-31T14:37:17,Valladolid,expenses,appliances,-291.15,-19338.01
buyer_6,Manuel,Díez,1979-02-14,54911168W,manuel.diez@coolcode.digital,606978,ES48209543417824685298,1248.06,2022-08-01T21:13:42,Valladolid,incomes,salary,2529.12,-16808.89
buyer_6,Manuel,Díez,1979-02-14,54911168W,manuel.diez@coolcode.digital,606978,ES48209543417824685298,1248.06,2022-08-01T21:13:42,Valladolid,incomes,extra_income,387.19,-16421.7
buyer_6,Manuel,Díez,1979-02-14,54911168W,manuel.diez@coolcode.digital,606978,ES48209543417824685298,1248.06,2022-08-02T18:46:19,Valladolid,expenses,clothing,-131.98,-16553.68
buyer_6,Manuel,Díez,1979-02-14,54911168W,manuel.diez@coolcode.digital,606978,ES48209543417824685298,1248.06,2022-08-04T13:54:13,Valladolid,expenses,food,-93.53,-16647.21
buyer_6,Manuel,Díez,1979-02-14,54911168W,manuel.diez@coolcode.digital,606978,ES48209543417824685298,1248.06,2022-08-04T14:00:54,Valladolid,expenses,cash,-100.0,-16747.21
buyer_6,Manuel,Díez,1979-02-14,54911168W,manuel.diez@coolcode.digital,606978,ES48209543417824685298,1248.06,2022-08-05T16:10:55,Valladolid,expenses,mortgage,-1029.57,-17776.78
buyer_6,Manuel,Díez,1979-02-14,54911168W,manuel.diez@coolcode.digital,606978,ES48209543417824685298,1248.06,2022-08-05T08:27:42,Valladolid,expenses,electricity,-48.83,-17825.61
buyer_6,Manuel,Díez,1979-02-14,54911168W,manuel.diez@coolcode.digital,606978,ES48209543417824685298,1248.06,2022-08-05T13:07:52,Valladolid,expenses,food,-66.61,-17892.22
buyer_6,Manuel,Díez,1979-02-14,54911168W,manuel.diez@coolcode.digital,606978,ES48209543417824685298,1248.06,2022-08-06T18:49:02,Valladolid,expenses,food,-73.42,-17965.64
buyer_6,Manuel,Díez,1979-02-14,54911168W,manuel.diez@coolcode.digital,606978,ES48209543417824685298,1248.06,2022-08-06T16:23:03,Valladolid,expenses,cash,-100.0,-18065.64
buyer_6,Manuel,Díez,1979-02-14,54911168W,manuel.diez@coolcode.digital,606978,ES48209543417824685298,1248.06,2022-08-07T19:45:15,Valladolid,expenses,healthcare,-69.84,-18135.48
buyer_6,Manuel,Díez,1979-02-14,54911168W,manuel.diez@coolcode.digital,606978,ES48209543417824685298,1248.06,2022-08-09T17:16:59,Valladolid,expenses,cash,-100.0,-18235.48
buyer_6,Manuel,Díez,1979-02-14,54911168W,manuel.diez@coolcode.digital,606978,ES48209543417824685298,1248.06,2022-08-09T11:37:19,Valladolid,expenses,gifts,-637.94,-18873.42
buyer_6,Manuel,Díez,1979-02-14,54911168W,manuel.diez@coolcode.digital,606978,ES48209543417824685298,1248.06,2022-08-11T17:52:09,Valladolid,expenses,food,-117.5,-18990.92
buyer_6,Manuel,Díez,1979-02-14,54911168W,manuel.diez@coolcode.digital,606978,ES48209543417824685298,1248.06,2022-08-12T08:51:24,Valladolid,expenses,transport,-70.7,-19061.62
buyer_6,Manuel,Díez,1979-02-14,54911168W,manuel.diez@coolcode.digital,606978,ES48209543417824685298,1248.06,2022-08-15T11:13:30,Valladolid,expenses,food,-101.79,-19163.41
buyer_6,Manuel,Díez,1979-02-14,54911168W,manuel.diez@coolcode.digital,606978,ES48209543417824685298,1248.06,2022-08-15T15:28:08,Valladolid,expenses,leisure,-72.09,-19235.5
buyer_6,Manuel,Díez,1979-02-14,54911168W,manuel.diez@coolcode.digital,606978,ES48209543417824685298,1248.06,2022-08-16T20:26:55,Valladolid,expenses,leisure,-47.9,-19283.4
buyer_6,Manuel,Díez,1979-02-14,54911168W,manuel.diez@coolcode.digital,606978,ES48209543417824685298,1248.06,2022-08-16T08:50:33,Valladolid,expenses,appliances,-303.29,-19586.69
buyer_6,Manuel,Díez,1979-02-14,54911168W,manuel.diez@coolcode.digital,606978,ES48209543417824685298,1248.06,2022-08-19T20:43:20,Valladolid,expenses,transport,-88.28,-19674.97
buyer_6,Manuel,Díez,1979-02-14,54911168W,manuel.diez@coolcode.digital,606978,ES48209543417824685298,1248.06,2022-08-20T20:06:09,Valladolid,expenses,food,-99.28,-19774.25
buyer_6,Manuel,Díez,1979-02-14,54911168W,manuel.diez@coolcode.digital,606978,ES48209543417824685298,1248.06,2022-08-20T11:16:44,Valladolid,expenses,leisure,-49.23,-19823.48
buyer_6,Manuel,Díez,1979-02-14,54911168W,manuel.diez@coolcode.digital,606978,ES48209543417824685298,1248.06,2022-08-20T16:59:18,Valladolid,expenses,gifts,-141.78,-19965.26
buyer_6,Manuel,Díez,1979-02-14,54911168W,manuel.diez@coolcode.digital,606978,ES48209543417824685298,1248.06,2022-08-24T15:13:44,Valladolid,expenses,food,-78.81,-20044.07
buyer_6,Manuel,Díez,1979-02-14,54911168W,manuel.diez@coolcode.digital,606978,ES48209543417824685298,1248.06,2022-08-24T13:25:37,Valladolid,expenses,cash,-100.0,-20144.07
buyer_6,Manuel,Díez,1979-02-14,54911168W,manuel.diez@coolcode.digital,606978,ES48209543417824685298,1248.06,2022-08-25T15:11:13,Valladolid,expenses,food,-116.94,-20261.01
buyer_6,Manuel,Díez,1979-02-14,54911168W,manuel.diez@coolcode.digital,606978,ES48209543417824685298,1248.06,2022-08-26T22:09:32,Valladolid,expenses,cash,-100.0,-20361.01
buyer_6,Manuel,Díez,1979-02-14,54911168W,manuel.diez@coolcode.digital,606978,ES48209543417824685298,1248.06,2022-08-29T12:00:17,Valladolid,expenses,cash,-100.0,-20461.01
buyer_6,Manuel,Díez,1979-02-14,54911168W,manuel.diez@coolcode.digital,606978,ES48209543417824685298,1248.06,2022-08-30T19:23:16,Valladolid,expenses,healthcare,-106.63,-20567.64
buyer_6,Manuel,Díez,1979-02-14,54911168W,manuel.diez@coolcode.digital,606978,ES48209543417824685298,1248.06,2022-08-30T18:00:07,Valladolid,expenses,education,-52.57,-20620.21
buyer_6,Manuel,Díez,1979-02-14,54911168W,manuel.diez@coolcode.digital,606978,ES48209543417824685298,1248.06,2022-08-30T16:04:43,Valladolid,expenses,repairs,-294.01,-20914.22
buyer_6,Manuel,Díez,1979-02-14,54911168W,manuel.diez@coolcode.digital,606978,ES48209543417824685298,1248.06,2022-08-31T14:33:11,Valladolid,expenses,transport,-63.52,-20977.74
buyer_6,Manuel,Díez,1979-02-14,54911168W,manuel.diez@coolcode.digital,606978,ES48209543417824685298,1248.06,2022-08-31T09:13:43,Valladolid,expenses,leisure,-47.38,-21025.12
buyer_6,Manuel,Díez,1979-02-14,54911168W,manuel.diez@coolcode.digital,606978,ES48209543417824685298,1248.06,2022-09-01T23:32:59,Valladolid,incomes,salary,2529.12,-18496.0
buyer_6,Manuel,Díez,1979-02-14,54911168W,manuel.diez@coolcode.digital,606978,ES48209543417824685298,1248.06,2022-09-01T18:11:42,Valladolid,expenses,transport,-41.61,-18537.61
buyer_6,Manuel,Díez,1979-02-14,54911168W,manuel.diez@coolcode.digital,606978,ES48209543417824685298,1248.06,2022-09-01T08:53:25,Valladolid,expenses,clothing,-55.82,-18593.43
buyer_6,Manuel,Díez,1979-02-14,54911168W,manuel.diez@coolcode.digital,606978,ES48209543417824685298,1248.06,2022-09-03T13:23:04,Valladolid,expenses,cash,-100.0,-18693.43
buyer_6,Manuel,Díez,1979-02-14,54911168W,manuel.diez@coolcode.digital,606978,ES48209543417824685298,1248.06,2022-09-04T16:22:09,Valladolid,expenses,food,-66.37,-18759.8
buyer_6,Manuel,Díez,1979-02-14,54911168W,manuel.diez@coolcode.digital,606978,ES48209543417824685298,1248.06,2022-09-05T18:24:46,Valladolid,expenses,mortgage,-1029.57,-19789.37
buyer_6,Manuel,Díez,1979-02-14,54911168W,manuel.diez@coolcode.digital,606978,ES48209543417824685298,1248.06,2022-09-06T13:38:55,Valladolid,expenses,water,-26.57,-19815.94
buyer_6,Manuel,Díez,1979-02-14,54911168W,manuel.diez@coolcode.digital,606978,ES48209543417824685298,1248.06,2022-09-06T18:08:50,Valladolid,expenses,gas,-83.43,-19899.37
buyer_6,Manuel,Díez,1979-02-14,54911168W,manuel.diez@coolcode.digital,606978,ES48209543417824685298,1248.06,2022-09-06T12:56:36,Valladolid,expenses,internet,-53.11,-19952.48
buyer_6,Manuel,Díez,1979-02-14,54911168W,manuel.diez@coolcode.digital,606978,ES48209543417824685298,1248.06,2022-09-06T12:54:50,Valladolid,expenses,phone,-48.42,-20000.9
buyer_6,Manuel,Díez,1979-02-14,54911168W,manuel.diez@coolcode.digital,606978,ES48209543417824685298,1248.06,2022-09-06T18:00:38,Valladolid,expenses,transport,-71.53,-20072.43
buyer_6,Manuel,Díez,1979-02-14,54911168W,manuel.diez@coolcode.digital,606978,ES48209543417824685298,1248.06,2022-09-06T16:54:35,Valladolid,expenses,leisure,-20.93,-20093.36
buyer_6,Manuel,Díez,1979-02-14,54911168W,manuel.diez@coolcode.digital,606978,ES48209543417824685298,1248.06,2022-09-07T12:21:36,Valladolid,expenses,water,-31.16,-20124.52
buyer_6,Manuel,Díez,1979-02-14,54911168W,manuel.diez@coolcode.digital,606978,ES48209543417824685298,1248.06,2022-09-07T10:17:17,Valladolid,expenses,electricity,-44.48,-20169.0
buyer_6,Manuel,Díez,1979-02-14,54911168W,manuel.diez@coolcode.digital,606978,ES48209543417824685298,1248.06,2022-09-07T15:16:21,Valladolid,expenses,gas,-95.05,-20264.05
buyer_6,Manuel,Díez,1979-02-14,54911168W,manuel.diez@coolcode.digital,606978,ES48209543417824685298,1248.06,2022-09-07T08:39:01,Valladolid,expenses,internet,-53.11,-20317.16
buyer_6,Manuel,Díez,1979-02-14,54911168W,manuel.diez@coolcode.digital,606978,ES48209543417824685298,1248.06,2022-09-08T11:31:10,Valladolid,expenses,phone,-51.41,-20368.57
buyer_6,Manuel,Díez,1979-02-14,54911168W,manuel.diez@coolcode.digital,606978,ES48209543417824685298,1248.06,2022-09-08T16:43:41,Valladolid,expenses,leisure,-26.47,-20395.04
buyer_6,Manuel,Díez,1979-02-14,54911168W,manuel.diez@coolcode.digital,606978,ES48209543417824685298,1248.06,2022-09-09T19:52:23,Valladolid,expenses,healthcare,-106.28,-20501.32
buyer_6,Manuel,Díez,1979-02-14,54911168W,manuel.diez@coolcode.digital,606978,ES48209543417824685298,1248.06,2022-09-09T20:59:46,Valladolid,expenses,gifts,-797.1,-21298.42
buyer_6,Manuel,Díez,1979-02-14,54911168W,manuel.diez@coolcode.digital,606978,ES48209543417824685298,1248.06,2022-09-10T18:07:02,Valladolid,expenses,cash,-100.0,-21398.42
buyer_6,Manuel,Díez,1979-02-14,54911168W,manuel.diez@coolcode.digital,606978,ES48209543417824685298,1248.06,2022-09-11T08:48:22,Valladolid,expenses,food,-79.42,-21477.84
buyer_6,Manuel,Díez,1979-02-14,54911168W,manuel.diez@coolcode.digital,606978,ES48209543417824685298,1248.06,2022-09-11T14:55:08,Valladolid,expenses,education,-50.42,-21528.26
buyer_6,Manuel,Díez,1979-02-14,54911168W,manuel.diez@coolcode.digital,606978,ES48209543417824685298,1248.06,2022-09-12T08:01:19,Valladolid,expenses,cash,-100.0,-21628.26
buyer_6,Manuel,Díez,1979-02-14,54911168W,manuel.diez@coolcode.digital,606978,ES48209543417824685298,1248.06,2022-09-13T11:30:49,Valladolid,expenses,leisure,-60.32,-21688.58
buyer_6,Manuel,Díez,1979-02-14,54911168W,manuel.diez@coolcode.digital,606978,ES48209543417824685298,1248.06,2022-09-14T08:57:46,Valladolid,expenses,appliances,-258.74,-21947.32
buyer_6,Manuel,Díez,1979-02-14,54911168W,manuel.diez@coolcode.digital,606978,ES48209543417824685298,1248.06,2022-09-17T12:26:06,Valladolid,expenses,clothing,-49.24,-21996.56
buyer_6,Manuel,Díez,1979-02-14,54911168W,manuel.diez@coolcode.digital,606978,ES48209543417824685298,1248.06,2022-09-17T11:49:39,Valladolid,expenses,education,-42.8,-22039.36
buyer_6,Manuel,Díez,1979-02-14,54911168W,manuel.diez@coolcode.digital,606978,ES48209543417824685298,1248.06,2022-09-18T10:30:54,Valladolid,expenses,transport,-82.98,-22122.34
buyer_6,Manuel,Díez,1979-02-14,54911168W,manuel.diez@coolcode.digital,606978,ES48209543417824685298,1248.06,2022-09-19T10:00:18,Valladolid,expenses,food,-70.21,-22192.55
buyer_6,Manuel,Díez,1979-02-14,54911168W,manuel.diez@coolcode.digital,606978,ES48209543417824685298,1248.06,2022-09-25T15:04:49,Valladolid,expenses,cash,-100.0,-22292.55
buyer_6,Manuel,Díez,1979-02-14,54911168W,manuel.diez@coolcode.digital,606978,ES48209543417824685298,1248.06,2022-09-26T16:01:58,Valladolid,expenses,food,-88.15,-22380.7
buyer_6,Manuel,Díez,1979-02-14,54911168W,manuel.diez@coolcode.digital,606978,ES48209543417824685298,1248.06,2022-09-26T16:01:47,Valladolid,expenses,education,-57.81,-22438.51
buyer_6,Manuel,Díez,1979-02-14,54911168W,manuel.diez@coolcode.digital,606978,ES48209543417824685298,1248.06,2022-09-27T20:56:42,Valladolid,expenses,food,-93.07,-22531.58
buyer_6,Manuel,Díez,1979-02-14,54911168W,manuel.diez@coolcode.digital,606978,ES48209543417824685298,1248.06,2022-09-27T12:43:43,Valladolid,expenses,leisure,-28.51,-22560.09
buyer_6,Manuel,Díez,1979-02-14,54911168W,manuel.diez@coolcode.digital,606978,ES48209543417824685298,1248.06,2022-09-27T11:48:59,Valladolid,expenses,repairs,-44.19,-22604.28
buyer_6,Manuel,Díez,1979-02-14,54911168W,manuel.diez@coolcode.digital,606978,ES48209543417824685298,1248.06,2022-09-28T19:11:40,Valladolid,expenses,leisure,-54.26,-22658.54
buyer_6,Manuel,Díez,1979-02-14,54911168W,manuel.diez@coolcode.digital,606978,ES48209543417824685298,1248.06,2022-09-30T08:45:38,Valladolid,expenses,transport,-84.16,-22742.7
buyer_6,Manuel,Díez,1979-02-14,54911168W,manuel.diez@coolcode.digital,606978,ES48209543417824685298,1248.06,2022-09-30T21:02:43,Valladolid,expenses,gifts,-295.39,-23038.09
buyer_6,Manuel,Díez,1979-02-14,54911168W,manuel.diez@coolcode.digital,606978,ES48209543417824685298,1248.06,2022-10-01T11:42:50,Valladolid,incomes,salary,2529.12,-20508.97
buyer_6,Manuel,Díez,1979-02-14,54911168W,manuel.diez@coolcode.digital,606978,ES48209543417824685298,1248.06,2022-10-02T04:36:16,Valladolid,expenses,food,-97.23,-20606.2
buyer_6,Manuel,Díez,1979-02-14,54911168W,manuel.diez@coolcode.digital,606978,ES48209543417824685298,1248.06,2022-10-02T08:37:19,Valladolid,expenses,cash,-100.0,-20706.2
buyer_6,Manuel,Díez,1979-02-14,54911168W,manuel.diez@coolcode.digital,606978,ES48209543417824685298,1248.06,2022-10-03T14:19:52,Valladolid,expenses,clothing,-90.18,-20796.38
buyer_6,Manuel,Díez,1979-02-14,54911168W,manuel.diez@coolcode.digital,606978,ES48209543417824685298,1248.06,2022-10-04T18:40:22,Valladolid,expenses,cash,-100.0,-20896.38
buyer_6,Manuel,Díez,1979-02-14,54911168W,manuel.diez@coolcode.digital,606978,ES48209543417824685298,1248.06,2022-10-05T10:00:00,Valladolid,expenses,mortgage,-1029.57,-21925.95
buyer_6,Manuel,Díez,1979-02-14,54911168W,manuel.diez@coolcode.digital,606978,ES48209543417824685298,1248.06,2022-10-05T08:04:04,Valladolid,expenses,gas,-130.64,-22056.59
buyer_6,Manuel,Díez,1979-02-14,54911168W,manuel.diez@coolcode.digital,606978,ES48209543417824685298,1248.06,2022-10-05T13:53:54,Valladolid,expenses,phone,-40.23,-22096.82
buyer_6,Manuel,Díez,1979-02-14,54911168W,manuel.diez@coolcode.digital,606978,ES48209543417824685298,1248.06,2022-10-05T08:38:36,Valladolid,expenses,leisure,-43.41,-22140.23
buyer_6,Manuel,Díez,1979-02-14,54911168W,manuel.diez@coolcode.digital,606978,ES48209543417824685298,1248.06,2022-10-06T14:50:38,Valladolid,expenses,water,-44.11,-22184.34
buyer_6,Manuel,Díez,1979-02-14,54911168W,manuel.diez@coolcode.digital,606978,ES48209543417824685298,1248.06,2022-10-06T15:35:10,Valladolid,expenses,phone,-44.32,-22228.66
buyer_6,Manuel,Díez,1979-02-14,54911168W,manuel.diez@coolcode.digital,606978,ES48209543417824685298,1248.06,2022-10-07T15:32:49,Valladolid,expenses,gas,-138.59,-22367.25
buyer_6,Manuel,Díez,1979-02-14,54911168W,manuel.diez@coolcode.digital,606978,ES48209543417824685298,1248.06,2022-10-07T19:00:17,Valladolid,expenses,leisure,-51.85,-22419.1
buyer_6,Manuel,Díez,1979-02-14,54911168W,manuel.diez@coolcode.digital,606978,ES48209543417824685298,1248.06,2022-10-08T13:26:38,Valladolid,expenses,phone,-52.66,-22471.76
buyer_6,Manuel,Díez,1979-02-14,54911168W,manuel.diez@coolcode.digital,606978,ES48209543417824685298,1248.06,2022-10-09T12:43:24,Valladolid,expenses,food,-105.21,-22576.97
buyer_6,Manuel,Díez,1979-02-14,54911168W,manuel.diez@coolcode.digital,606978,ES48209543417824685298,1248.06,2022-10-09T12:20:55,Valladolid,expenses,cash,-100.0,-22676.97
buyer_6,Manuel,Díez,1979-02-14,54911168W,manuel.diez@coolcode.digital,606978,ES48209543417824685298,1248.06,2022-10-12T20:36:04,Valladolid,expenses,appliances,-342.03,-23019.0
buyer_6,Manuel,Díez,1979-02-14,54911168W,manuel.diez@coolcode.digital,606978,ES48209543417824685298,1248.06,2022-10-12T19:51:09,Valladolid,expenses,repairs,-163.41,-23182.41
buyer_6,Manuel,Díez,1979-02-14,54911168W,manuel.diez@coolcode.digital,606978,ES48209543417824685298,1248.06,2022-10-14T20:53:14,Valladolid,expenses,cash,-100.0,-23282.41
buyer_6,Manuel,Díez,1979-02-14,54911168W,manuel.diez@coolcode.digital,606978,ES48209543417824685298,1248.06,2022-10-15T17:19:29,Valladolid,expenses,clothing,-148.82,-23431.23
buyer_6,Manuel,Díez,1979-02-14,54911168W,manuel.diez@coolcode.digital,606978,ES48209543417824685298,1248.06,2022-10-16T21:43:46,Valladolid,expenses,transport,-43.66,-23474.89
buyer_6,Manuel,Díez,1979-02-14,54911168W,manuel.diez@coolcode.digital,606978,ES48209543417824685298,1248.06,2022-10-16T09:42:48,Valladolid,expenses,repairs,-180.37,-23655.26
buyer_6,Manuel,Díez,1979-02-14,54911168W,manuel.diez@coolcode.digital,606978,ES48209543417824685298,1248.06,2022-10-17T17:22:39,Valladolid,expenses,leisure,-43.63,-23698.89
buyer_6,Manuel,Díez,1979-02-14,54911168W,manuel.diez@coolcode.digital,606978,ES48209543417824685298,1248.06,2022-10-17T22:09:07,Valladolid,expenses,healthcare,-47.32,-23746.21
buyer_6,Manuel,Díez,1979-02-14,54911168W,manuel.diez@coolcode.digital,606978,ES48209543417824685298,1248.06,2022-10-20T14:16:30,Valladolid,expenses,transport,-54.22,-23800.43
buyer_6,Manuel,Díez,1979-02-14,54911168W,manuel.diez@coolcode.digital,606978,ES48209543417824685298,1248.06,2022-10-21T20:52:20,Valladolid,expenses,transport,-59.14,-23859.57
buyer_6,Manuel,Díez,1979-02-14,54911168W,manuel.diez@coolcode.digital,606978,ES48209543417824685298,1248.06,2022-10-21T08:15:17,Valladolid,expenses,cash,-100.0,-23959.57
buyer_6,Manuel,Díez,1979-02-14,54911168W,manuel.diez@coolcode.digital,606978,ES48209543417824685298,1248.06,2022-10-22T21:25:15,Valladolid,expenses,gifts,-344.24,-24303.81
buyer_6,Manuel,Díez,1979-02-14,54911168W,manuel.diez@coolcode.digital,606978,ES48209543417824685298,1248.06,2022-10-23T23:46:36,Valladolid,expenses,food,-64.46,-24368.27
buyer_6,Manuel,Díez,1979-02-14,54911168W,manuel.diez@coolcode.digital,606978,ES48209543417824685298,1248.06,2022-10-23T16:18:05,Valladolid,expenses,leisure,-58.74,-24427.01
buyer_6,Manuel,Díez,1979-02-14,54911168W,manuel.diez@coolcode.digital,606978,ES48209543417824685298,1248.06,2022-10-24T14:57:54,Valladolid,expenses,gifts,-148.34,-24575.35
buyer_6,Manuel,Díez,1979-02-14,54911168W,manuel.diez@coolcode.digital,606978,ES48209543417824685298,1248.06,2022-10-25T09:33:39,Valladolid,expenses,gifts,-408.16,-24983.51
buyer_6,Manuel,Díez,1979-02-14,54911168W,manuel.diez@coolcode.digital,606978,ES48209543417824685298,1248.06,2022-10-27T03:52:47,Valladolid,expenses,food,-122.85,-25106.36
buyer_6,Manuel,Díez,1979-02-14,54911168W,manuel.diez@coolcode.digital,606978,ES48209543417824685298,1248.06,2022-10-27T08:58:14,Valladolid,expenses,leisure,-43.59,-25149.95
buyer_6,Manuel,Díez,1979-02-14,54911168W,manuel.diez@coolcode.digital,606978,ES48209543417824685298,1248.06,2022-10-28T08:41:47,Valladolid,expenses,food,-123.01,-25272.96
buyer_6,Manuel,Díez,1979-02-14,54911168W,manuel.diez@coolcode.digital,606978,ES48209543417824685298,1248.06,2022-10-29T08:37:49,Valladolid,expenses,food,-97.09,-25370.05
buyer_6,Manuel,Díez,1979-02-14,54911168W,manuel.diez@coolcode.digital,606978,ES48209543417824685298,1248.06,2022-10-29T20:46:32,Valladolid,expenses,leisure,-84.92,-25454.97
buyer_6,Manuel,Díez,1979-02-14,54911168W,manuel.diez@coolcode.digital,606978,ES48209543417824685298,1248.06,2022-10-29T11:38:52,Valladolid,expenses,healthcare,-99.29,-25554.26
buyer_6,Manuel,Díez,1979-02-14,54911168W,manuel.diez@coolcode.digital,606978,ES48209543417824685298,1248.06,2022-10-30T08:12:22,Valladolid,expenses,food,-79.54,-25633.8
buyer_6,Manuel,Díez,1979-02-14,54911168W,manuel.diez@coolcode.digital,606978,ES48209543417824685298,1248.06,2022-11-01T09:14:41,Valladolid,incomes,salary,2529.12,-23104.68
buyer_6,Manuel,Díez,1979-02-14,54911168W,manuel.diez@coolcode.digital,606978,ES48209543417824685298,1248.06,2022-11-02T13:07:28,Valladolid,expenses,healthcare,-46.35,-23151.03
buyer_6,Manuel,Díez,1979-02-14,54911168W,manuel.diez@coolcode.digital,606978,ES48209543417824685298,1248.06,2022-11-02T09:31:18,Valladolid,expenses,cash,-100.0,-23251.03
buyer_6,Manuel,Díez,1979-02-14,54911168W,manuel.diez@coolcode.digital,606978,ES48209543417824685298,1248.06,2022-11-04T13:55:49,Valladolid,expenses,transport,-77.0,-23328.03
buyer_6,Manuel,Díez,1979-02-14,54911168W,manuel.diez@coolcode.digital,606978,ES48209543417824685298,1248.06,2022-11-05T19:37:52,Valladolid,expenses,mortgage,-1029.57,-24357.6
buyer_6,Manuel,Díez,1979-02-14,54911168W,manuel.diez@coolcode.digital,606978,ES48209543417824685298,1248.06,2022-11-05T14:41:05,Valladolid,expenses,phone,-40.43,-24398.03
buyer_6,Manuel,Díez,1979-02-14,54911168W,manuel.diez@coolcode.digital,606978,ES48209543417824685298,1248.06,2022-11-06T08:26:28,Valladolid,expenses,water,-42.08,-24440.11
buyer_6,Manuel,Díez,1979-02-14,54911168W,manuel.diez@coolcode.digital,606978,ES48209543417824685298,1248.06,2022-11-06T17:02:50,Valladolid,expenses,electricity,-70.85,-24510.96
buyer_6,Manuel,Díez,1979-02-14,54911168W,manuel.diez@coolcode.digital,606978,ES48209543417824685298,1248.06,2022-11-07T19:02:29,Valladolid,expenses,internet,-53.11,-24564.07
buyer_6,Manuel,Díez,1979-02-14,54911168W,manuel.diez@coolcode.digital,606978,ES48209543417824685298,1248.06,2022-11-07T19:22:55,Valladolid,expenses,leisure,-63.04,-24627.11
buyer_6,Manuel,Díez,1979-02-14,54911168W,manuel.diez@coolcode.digital,606978,ES48209543417824685298,1248.06,2022-11-07T15:44:45,Valladolid,expenses,cash,-100.0,-24727.11
buyer_6,Manuel,Díez,1979-02-14,54911168W,manuel.diez@coolcode.digital,606978,ES48209543417824685298,1248.06,2022-11-08T08:32:29,Valladolid,expenses,electricity,-106.7,-24833.81
buyer_6,Manuel,Díez,1979-02-14,54911168W,manuel.diez@coolcode.digital,606978,ES48209543417824685298,1248.06,2022-11-08T10:24:34,Valladolid,expenses,internet,-53.11,-24886.92
buyer_6,Manuel,Díez,1979-02-14,54911168W,manuel.diez@coolcode.digital,606978,ES48209543417824685298,1248.06,2022-11-10T14:48:45,Valladolid,expenses,food,-111.83,-24998.75
buyer_6,Manuel,Díez,1979-02-14,54911168W,manuel.diez@coolcode.digital,606978,ES48209543417824685298,1248.06,2022-11-10T17:31:39,Valladolid,expenses,education,-64.2,-25062.95
buyer_6,Manuel,Díez,1979-02-14,54911168W,manuel.diez@coolcode.digital,606978,ES48209543417824685298,1248.06,2022-11-13T13:16:02,Valladolid,expenses,cash,-100.0,-25162.95
buyer_6,Manuel,Díez,1979-02-14,54911168W,manuel.diez@coolcode.digital,606978,ES48209543417824685298,1248.06,2022-11-14T15:47:57,Valladolid,expenses,clothing,-108.74,-25271.69
buyer_6,Manuel,Díez,1979-02-14,54911168W,manuel.diez@coolcode.digital,606978,ES48209543417824685298,1248.06,2022-11-14T22:05:37,Valladolid,expenses,repairs,-324.22,-25595.91
buyer_6,Manuel,Díez,1979-02-14,54911168W,manuel.diez@coolcode.digital,606978,ES48209543417824685298,1248.06,2022-11-14T12:41:03,Valladolid,expenses,gifts,-269.39,-25865.3
buyer_6,Manuel,Díez,1979-02-14,54911168W,manuel.diez@coolcode.digital,606978,ES48209543417824685298,1248.06,2022-11-15T09:35:14,Valladolid,expenses,cash,-100.0,-25965.3
buyer_6,Manuel,Díez,1979-02-14,54911168W,manuel.diez@coolcode.digital,606978,ES48209543417824685298,1248.06,2022-11-19T08:02:14,Valladolid,expenses,clothing,-154.32,-26119.62
buyer_6,Manuel,Díez,1979-02-14,54911168W,manuel.diez@coolcode.digital,606978,ES48209543417824685298,1248.06,2022-11-19T09:39:02,Valladolid,expenses,healthcare,-71.51,-26191.13
buyer_6,Manuel,Díez,1979-02-14,54911168W,manuel.diez@coolcode.digital,606978,ES48209543417824685298,1248.06,2022-11-23T16:19:31,Valladolid,expenses,leisure,-35.05,-26226.18
buyer_6,Manuel,Díez,1979-02-14,54911168W,manuel.diez@coolcode.digital,606978,ES48209543417824685298,1248.06,2022-11-25T11:25:49,Valladolid,expenses,transport,-70.62,-26296.8
buyer_6,Manuel,Díez,1979-02-14,54911168W,manuel.diez@coolcode.digital,606978,ES48209543417824685298,1248.06,2022-11-25T08:46:48,Valladolid,expenses,cash,-100.0,-26396.8
buyer_6,Manuel,Díez,1979-02-14,54911168W,manuel.diez@coolcode.digital,606978,ES48209543417824685298,1248.06,2022-11-25T15:59:04,Valladolid,expenses,repairs,-276.9,-26673.7
buyer_6,Manuel,Díez,1979-02-14,54911168W,manuel.diez@coolcode.digital,606978,ES48209543417824685298,1248.06,2022-11-26T18:54:06,Valladolid,expenses,repairs,-192.25,-26865.95
buyer_6,Manuel,Díez,1979-02-14,54911168W,manuel.diez@coolcode.digital,606978,ES48209543417824685298,1248.06,2022-11-27T11:18:45,Valladolid,expenses,cash,-100.0,-26965.95
buyer_6,Manuel,Díez,1979-02-14,54911168W,manuel.diez@coolcode.digital,606978,ES48209543417824685298,1248.06,2022-11-28T11:20:02,Valladolid,expenses,repairs,-102.18,-27068.13
buyer_6,Manuel,Díez,1979-02-14,54911168W,manuel.diez@coolcode.digital,606978,ES48209543417824685298,1248.06,2022-11-29T20:22:23,Valladolid,expenses,food,-112.6,-27180.73
buyer_6,Manuel,Díez,1979-02-14,54911168W,manuel.diez@coolcode.digital,606978,ES48209543417824685298,1248.06,2022-12-01T15:36:05,Valladolid,incomes,salary,2529.12,-24651.61
buyer_6,Manuel,Díez,1979-02-14,54911168W,manuel.diez@coolcode.digital,606978,ES48209543417824685298,1248.06,2022-12-01T15:36:05,Valladolid,incomes,extra_income,387.19,-24264.42
buyer_6,Manuel,Díez,1979-02-14,54911168W,manuel.diez@coolcode.digital,606978,ES48209543417824685298,1248.06,2022-12-01T15:36:05,Valladolid,incomes,salary_bonus,1890.62,-22373.8
buyer_6,Manuel,Díez,1979-02-14,54911168W,manuel.diez@coolcode.digital,606978,ES48209543417824685298,1248.06,2022-12-01T18:10:05,Valladolid,expenses,cash,-100.0,-22473.8
buyer_6,Manuel,Díez,1979-02-14,54911168W,manuel.diez@coolcode.digital,606978,ES48209543417824685298,1248.06,2022-12-02T15:42:20,Valladolid,expenses,gifts,-795.83,-23269.63
buyer_6,Manuel,Díez,1979-02-14,54911168W,manuel.diez@coolcode.digital,606978,ES48209543417824685298,1248.06,2022-12-05T18:47:13,Valladolid,expenses,mortgage,-1029.57,-24299.2
buyer_6,Manuel,Díez,1979-02-14,54911168W,manuel.diez@coolcode.digital,606978,ES48209543417824685298,1248.06,2022-12-05T12:06:20,Valladolid,expenses,clothing,-152.26,-24451.46
buyer_6,Manuel,Díez,1979-02-14,54911168W,manuel.diez@coolcode.digital,606978,ES48209543417824685298,1248.06,2022-12-06T02:01:01,Valladolid,expenses,water,-28.48,-24479.94
buyer_6,Manuel,Díez,1979-02-14,54911168W,manuel.diez@coolcode.digital,606978,ES48209543417824685298,1248.06,2022-12-06T14:29:18,Valladolid,expenses,internet,-53.11,-24533.05
buyer_6,Manuel,Díez,1979-02-14,54911168W,manuel.diez@coolcode.digital,606978,ES48209543417824685298,1248.06,2022-12-06T15:05:34,Valladolid,expenses,phone,-46.35,-24579.4
buyer_6,Manuel,Díez,1979-02-14,54911168W,manuel.diez@coolcode.digital,606978,ES48209543417824685298,1248.06,2022-12-06T12:47:12,Valladolid,expenses,cash,-100.0,-24679.4
buyer_6,Manuel,Díez,1979-02-14,54911168W,manuel.diez@coolcode.digital,606978,ES48209543417824685298,1248.06,2022-12-07T08:39:32,Valladolid,expenses,phone,-44.22,-24723.62
buyer_6,Manuel,Díez,1979-02-14,54911168W,manuel.diez@coolcode.digital,606978,ES48209543417824685298,1248.06,2022-12-07T14:52:23,Valladolid,expenses,healthcare,-182.5,-24906.12
buyer_6,Manuel,Díez,1979-02-14,54911168W,manuel.diez@coolcode.digital,606978,ES48209543417824685298,1248.06,2022-12-07T09:45:12,Valladolid,expenses,cash,-100.0,-25006.12
buyer_6,Manuel,Díez,1979-02-14,54911168W,manuel.diez@coolcode.digital,606978,ES48209543417824685298,1248.06,2022-12-11T07:41:44,Valladolid,expenses,appliances,-215.56,-25221.68
buyer_6,Manuel,Díez,1979-02-14,54911168W,manuel.diez@coolcode.digital,606978,ES48209543417824685298,1248.06,2022-12-15T15:26:57,Valladolid,expenses,education,-58.42,-25280.1
buyer_6,Manuel,Díez,1979-02-14,54911168W,manuel.diez@coolcode.digital,606978,ES48209543417824685298,1248.06,2022-12-17T17:01:51,Valladolid,expenses,food,-119.31,-25399.41
buyer_6,Manuel,Díez,1979-02-14,54911168W,manuel.diez@coolcode.digital,606978,ES48209543417824685298,1248.06,2022-12-18T19:16:01,Valladolid,expenses,leisure,-81.68,-25481.09
buyer_6,Manuel,Díez,1979-02-14,54911168W,manuel.diez@coolcode.digital,606978,ES48209543417824685298,1248.06,2022-12-20T12:45:50,Valladolid,expenses,cash,-100.0,-25581.09
buyer_6,Manuel,Díez,1979-02-14,54911168W,manuel.diez@coolcode.digital,606978,ES48209543417824685298,1248.06,2022-12-20T02:50:27,Valladolid,expenses,appliances,-227.59,-25808.68
buyer_6,Manuel,Díez,1979-02-14,54911168W,manuel.diez@coolcode.digital,606978,ES48209543417824685298,1248.06,2022-12-21T15:46:59,Valladolid,expenses,cash,-100.0,-25908.68
buyer_6,Manuel,Díez,1979-02-14,54911168W,manuel.diez@coolcode.digital,606978,ES48209543417824685298,1248.06,2022-12-23T13:49:27,Valladolid,expenses,transport,-40.62,-25949.3
buyer_6,Manuel,Díez,1979-02-14,54911168W,manuel.diez@coolcode.digital,606978,ES48209543417824685298,1248.06,2022-12-25T19:29:52,Valladolid,expenses,healthcare,-120.78,-26070.08
buyer_6,Manuel,Díez,1979-02-14,54911168W,manuel.diez@coolcode.digital,606978,ES48209543417824685298,1248.06,2022-12-28T15:09:13,Valladolid,expenses,cash,-100.0,-26170.08
buyer_6,Manuel,Díez,1979-02-14,54911168W,manuel.diez@coolcode.digital,606978,ES48209543417824685298,1248.06,2022-12-28T21:42:10,Valladolid,expenses,gifts,-444.4,-26614.48
buyer_6,Manuel,Díez,1979-02-14,54911168W,manuel.diez@coolcode.digital,606978,ES48209543417824685298,1248.06,2022-12-29T13:37:12,Valladolid,expenses,leisure,-38.03,-26652.51
buyer_6,Manuel,Díez,1979-02-14,54911168W,manuel.diez@coolcode.digital,606978,ES48209543417824685298,1248.06,2022-12-29T19:47:00,Valladolid,expenses,repairs,-245.08,-26897.59
buyer_6,Manuel,Díez,1979-02-14,54911168W,manuel.diez@coolcode.digital,606978,ES48209543417824685298,1248.06,2022-12-30T20:39:02,Valladolid,expenses,transport,-81.29,-26978.88
buyer_6,Manuel,Díez,1979-02-14,54911168W,manuel.diez@coolcode.digital,606978,ES48209543417824685298,1248.06,2022-12-30T16:39:22,Valladolid,expenses,appliances,-320.45,-27299.33
buyer_6,Manuel,Díez,1979-02-14,54911168W,manuel.diez@coolcode.digital,606978,ES48209543417824685298,1248.06,2023-01-01T14:02:27,Valladolid,incomes,salary,2598.89,-24700.44
buyer_6,Manuel,Díez,1979-02-14,54911168W,manuel.diez@coolcode.digital,606978,ES48209543417824685298,1248.06,2023-01-02T09:34:48,Valladolid,expenses,appliances,-237.42,-24937.86
buyer_6,Manuel,Díez,1979-02-14,54911168W,manuel.diez@coolcode.digital,606978,ES48209543417824685298,1248.06,2023-01-03T00:06:59,Valladolid,expenses,repairs,-199.03,-25136.89
buyer_6,Manuel,Díez,1979-02-14,54911168W,manuel.diez@coolcode.digital,606978,ES48209543417824685298,1248.06,2023-01-04T10:55:40,Valladolid,expenses,leisure,-26.75,-25163.64
buyer_6,Manuel,Díez,1979-02-14,54911168W,manuel.diez@coolcode.digital,606978,ES48209543417824685298,1248.06,2023-01-05T15:25:24,Valladolid,expenses,mortgage,-982.85,-26146.49
buyer_6,Manuel,Díez,1979-02-14,54911168W,manuel.diez@coolcode.digital,606978,ES48209543417824685298,1248.06,2023-01-05T16:24:06,Valladolid,expenses,cash,-100.0,-26246.49
buyer_6,Manuel,Díez,1979-02-14,54911168W,manuel.diez@coolcode.digital,606978,ES48209543417824685298,1248.06,2023-01-06T14:07:58,Valladolid,expenses,water,-39.93,-26286.42
buyer_6,Manuel,Díez,1979-02-14,54911168W,manuel.diez@coolcode.digital,606978,ES48209543417824685298,1248.06,2023-01-06T14:09:06,Valladolid,expenses,internet,-54.58,-26341.0
buyer_6,Manuel,Díez,1979-02-14,54911168W,manuel.diez@coolcode.digital,606978,ES48209543417824685298,1248.06,2023-01-06T19:19:55,Valladolid,expenses,transport,-70.0,-26411.0
buyer_6,Manuel,Díez,1979-02-14,54911168W,manuel.diez@coolcode.digital,606978,ES48209543417824685298,1248.06,2023-01-07T10:40:29,Valladolid,expenses,gas,-62.42,-26473.42
buyer_6,Manuel,Díez,1979-02-14,54911168W,manuel.diez@coolcode.digital,606978,ES48209543417824685298,1248.06,2023-01-07T16:22:41,Valladolid,expenses,leisure,-66.85,-26540.27
buyer_6,Manuel,Díez,1979-02-14,54911168W,manuel.diez@coolcode.digital,606978,ES48209543417824685298,1248.06,2023-01-08T19:00:36,Valladolid,expenses,gas,-55.75,-26596.02
buyer_6,Manuel,Díez,1979-02-14,54911168W,manuel.diez@coolcode.digital,606978,ES48209543417824685298,1248.06,2023-01-08T09:21:54,Valladolid,expenses,internet,-54.58,-26650.6
buyer_6,Manuel,Díez,1979-02-14,54911168W,manuel.diez@coolcode.digital,606978,ES48209543417824685298,1248.06,2023-01-09T11:25:08,Valladolid,expenses,food,-116.48,-26767.08
buyer_6,Manuel,Díez,1979-02-14,54911168W,manuel.diez@coolcode.digital,606978,ES48209543417824685298,1248.06,2023-01-09T11:21:23,Valladolid,expenses,clothing,-45.24,-26812.32
buyer_6,Manuel,Díez,1979-02-14,54911168W,manuel.diez@coolcode.digital,606978,ES48209543417824685298,1248.06,2023-01-10T13:40:45,Valladolid,expenses,cash,-100.0,-26912.32
buyer_6,Manuel,Díez,1979-02-14,54911168W,manuel.diez@coolcode.digital,606978,ES48209543417824685298,1248.06,2023-01-13T20:21:11,Valladolid,expenses,cash,-100.0,-27012.32
buyer_6,Manuel,Díez,1979-02-14,54911168W,manuel.diez@coolcode.digital,606978,ES48209543417824685298,1248.06,2023-01-13T01:35:59,Valladolid,expenses,gifts,-314.24,-27326.56
buyer_6,Manuel,Díez,1979-02-14,54911168W,manuel.diez@coolcode.digital,606978,ES48209543417824685298,1248.06,2023-01-14T18:07:49,Valladolid,expenses,leisure,-61.48,-27388.04
buyer_6,Manuel,Díez,1979-02-14,54911168W,manuel.diez@coolcode.digital,606978,ES48209543417824685298,1248.06,2023-01-14T19:19:38,Valladolid,expenses,healthcare,-112.51,-27500.55
buyer_6,Manuel,Díez,1979-02-14,54911168W,manuel.diez@coolcode.digital,606978,ES48209543417824685298,1248.06,2023-01-16T15:07:11,Valladolid,expenses,transport,-43.43,-27543.98
buyer_6,Manuel,Díez,1979-02-14,54911168W,manuel.diez@coolcode.digital,606978,ES48209543417824685298,1248.06,2023-01-16T15:02:02,Valladolid,expenses,leisure,-64.13,-27608.11
buyer_6,Manuel,Díez,1979-02-14,54911168W,manuel.diez@coolcode.digital,606978,ES48209543417824685298,1248.06,2023-01-17T17:28:26,Valladolid,expenses,clothing,-76.71,-27684.82
buyer_6,Manuel,Díez,1979-02-14,54911168W,manuel.diez@coolcode.digital,606978,ES48209543417824685298,1248.06,2023-01-24T22:52:07,Valladolid,expenses,leisure,-66.8,-27751.62
buyer_6,Manuel,Díez,1979-02-14,54911168W,manuel.diez@coolcode.digital,606978,ES48209543417824685298,1248.06,2023-01-25T06:23:40,Valladolid,expenses,healthcare,-94.13,-27845.75
buyer_6,Manuel,Díez,1979-02-14,54911168W,manuel.diez@coolcode.digital,606978,ES48209543417824685298,1248.06,2023-01-27T08:10:41,Valladolid,expenses,leisure,-42.8,-27888.55
buyer_6,Manuel,Díez,1979-02-14,54911168W,manuel.diez@coolcode.digital,606978,ES48209543417824685298,1248.06,2023-01-28T15:54:54,Valladolid,expenses,cash,-100.0,-27988.55
buyer_6,Manuel,Díez,1979-02-14,54911168W,manuel.diez@coolcode.digital,606978,ES48209543417824685298,1248.06,2023-01-31T12:52:17,Valladolid,expenses,food,-63.96,-28052.51
buyer_6,Manuel,Díez,1979-02-14,54911168W,manuel.diez@coolcode.digital,606978,ES48209543417824685298,1248.06,2023-01-31T09:03:20,Valladolid,expenses,transport,-53.71,-28106.22
buyer_6,Manuel,Díez,1979-02-14,54911168W,manuel.diez@coolcode.digital,606978,ES48209543417824685298,1248.06,2023-02-01T03:25:02,Valladolid,incomes,salary,2598.89,-25507.33
buyer_6,Manuel,Díez,1979-02-14,54911168W,manuel.diez@coolcode.digital,606978,ES48209543417824685298,1248.06,2023-02-01T01:30:08,Valladolid,expenses,cash,-100.0,-25607.33
buyer_6,Manuel,Díez,1979-02-14,54911168W,manuel.diez@coolcode.digital,606978,ES48209543417824685298,1248.06,2023-02-03T18:23:18,Valladolid,expenses,food,-96.79,-25704.12
buyer_6,Manuel,Díez,1979-02-14,54911168W,manuel.diez@coolcode.digital,606978,ES48209543417824685298,1248.06,2023-02-05T09:46:56,Valladolid,expenses,mortgage,-982.85,-26686.97
buyer_6,Manuel,Díez,1979-02-14,54911168W,manuel.diez@coolcode.digital,606978,ES48209543417824685298,1248.06,2023-02-05T16:54:04,Valladolid,expenses,gas,-83.0,-26769.97
buyer_6,Manuel,Díez,1979-02-14,54911168W,manuel.diez@coolcode.digital,606978,ES48209543417824685298,1248.06,2023-02-05T23:21:42,Valladolid,expenses,internet,-54.58,-26824.55
buyer_6,Manuel,Díez,1979-02-14,54911168W,manuel.diez@coolcode.digital,606978,ES48209543417824685298,1248.06,2023-02-05T08:46:59,Valladolid,expenses,phone,-43.39,-26867.94
buyer_6,Manuel,Díez,1979-02-14,54911168W,manuel.diez@coolcode.digital,606978,ES48209543417824685298,1248.06,2023-02-05T16:27:36,Valladolid,expenses,cash,-100.0,-26967.94
buyer_6,Manuel,Díez,1979-02-14,54911168W,manuel.diez@coolcode.digital,606978,ES48209543417824685298,1248.06,2023-02-06T10:26:54,Valladolid,expenses,phone,-43.91,-27011.85
buyer_6,Manuel,Díez,1979-02-14,54911168W,manuel.diez@coolcode.digital,606978,ES48209543417824685298,1248.06,2023-02-06T14:38:44,Valladolid,expenses,cash,-100.0,-27111.85
buyer_6,Manuel,Díez,1979-02-14,54911168W,manuel.diez@coolcode.digital,606978,ES48209543417824685298,1248.06,2023-02-07T03:28:49,Valladolid,expenses,gas,-63.06,-27174.91
buyer_6,Manuel,Díez,1979-02-14,54911168W,manuel.diez@coolcode.digital,606978,ES48209543417824685298,1248.06,2023-02-07T16:11:32,Valladolid,expenses,phone,-54.31,-27229.22
buyer_6,Manuel,Díez,1979-02-14,54911168W,manuel.diez@coolcode.digital,606978,ES48209543417824685298,1248.06,2023-02-07T10:31:01,Valladolid,expenses,cash,-100.0,-27329.22
buyer_6,Manuel,Díez,1979-02-14,54911168W,manuel.diez@coolcode.digital,606978,ES48209543417824685298,1248.06,2023-02-08T09:52:13,Valladolid,expenses,gas,-129.87,-27459.09
buyer_6,Manuel,Díez,1979-02-14,54911168W,manuel.diez@coolcode.digital,606978,ES48209543417824685298,1248.06,2023-02-08T10:25:18,Valladolid,expenses,phone,-47.31,-27506.4
buyer_6,Manuel,Díez,1979-02-14,54911168W,manuel.diez@coolcode.digital,606978,ES48209543417824685298,1248.06,2023-02-08T22:13:02,Valladolid,expenses,gifts,-449.55,-27955.95
buyer_6,Manuel,Díez,1979-02-14,54911168W,manuel.diez@coolcode.digital,606978,ES48209543417824685298,1248.06,2023-02-10T13:18:10,Valladolid,expenses,education,-74.21,-28030.16
buyer_6,Manuel,Díez,1979-02-14,54911168W,manuel.diez@coolcode.digital,606978,ES48209543417824685298,1248.06,2023-02-11T11:51:18,Valladolid,expenses,transport,-80.6,-28110.76
buyer_6,Manuel,Díez,1979-02-14,54911168W,manuel.diez@coolcode.digital,606978,ES48209543417824685298,1248.06,2023-02-11T18:39:47,Valladolid,expenses,leisure,-38.25,-28149.01
buyer_6,Manuel,Díez,1979-02-14,54911168W,manuel.diez@coolcode.digital,606978,ES48209543417824685298,1248.06,2023-02-12T23:51:11,Valladolid,expenses,transport,-57.31,-28206.32
buyer_6,Manuel,Díez,1979-02-14,54911168W,manuel.diez@coolcode.digital,606978,ES48209543417824685298,1248.06,2023-02-12T14:35:07,Valladolid,expenses,leisure,-47.92,-28254.24
buyer_6,Manuel,Díez,1979-02-14,54911168W,manuel.diez@coolcode.digital,606978,ES48209543417824685298,1248.06,2023-02-13T08:59:57,Valladolid,expenses,food,-93.46,-28347.7
buyer_6,Manuel,Díez,1979-02-14,54911168W,manuel.diez@coolcode.digital,606978,ES48209543417824685298,1248.06,2023-02-14T09:25:42,Valladolid,expenses,cash,-100.0,-28447.7
buyer_6,Manuel,Díez,1979-02-14,54911168W,manuel.diez@coolcode.digital,606978,ES48209543417824685298,1248.06,2023-02-15T17:16:55,Valladolid,expenses,cash,-100.0,-28547.7
buyer_6,Manuel,Díez,1979-02-14,54911168W,manuel.diez@coolcode.digital,606978,ES48209543417824685298,1248.06,2023-02-15T16:05:38,Valladolid,expenses,repairs,-68.24,-28615.94
buyer_6,Manuel,Díez,1979-02-14,54911168W,manuel.diez@coolcode.digital,606978,ES48209543417824685298,1248.06,2023-02-16T22:07:23,Valladolid,expenses,education,-70.68,-28686.62
buyer_6,Manuel,Díez,1979-02-14,54911168W,manuel.diez@coolcode.digital,606978,ES48209543417824685298,1248.06,2023-02-16T09:36:50,Valladolid,expenses,gifts,-597.49,-29284.11
buyer_6,Manuel,Díez,1979-02-14,54911168W,manuel.diez@coolcode.digital,606978,ES48209543417824685298,1248.06,2023-02-17T20:59:52,Valladolid,expenses,leisure,-59.3,-29343.41
buyer_6,Manuel,Díez,1979-02-14,54911168W,manuel.diez@coolcode.digital,606978,ES48209543417824685298,1248.06,2023-02-17T23:27:34,Valladolid,expenses,appliances,-390.56,-29733.97
buyer_6,Manuel,Díez,1979-02-14,54911168W,manuel.diez@coolcode.digital,606978,ES48209543417824685298,1248.06,2023-02-18T01:01:10,Valladolid,expenses,education,-55.35,-29789.32
buyer_6,Manuel,Díez,1979-02-14,54911168W,manuel.diez@coolcode.digital,606978,ES48209543417824685298,1248.06,2023-02-20T12:28:59,Valladolid,expenses,transport,-43.15,-29832.47
buyer_6,Manuel,Díez,1979-02-14,54911168W,manuel.diez@coolcode.digital,606978,ES48209543417824685298,1248.06,2023-02-20T19:25:43,Valladolid,expenses,cash,-100.0,-29932.47
buyer_6,Manuel,Díez,1979-02-14,54911168W,manuel.diez@coolcode.digital,606978,ES48209543417824685298,1248.06,2023-02-21T10:39:23,Valladolid,expenses,education,-52.88,-29985.35
buyer_6,Manuel,Díez,1979-02-14,54911168W,manuel.diez@coolcode.digital,606978,ES48209543417824685298,1248.06,2023-02-22T10:01:17,Valladolid,expenses,leisure,-44.4,-30029.75
buyer_6,Manuel,Díez,1979-02-14,54911168W,manuel.diez@coolcode.digital,606978,ES48209543417824685298,1248.06,2023-02-26T14:12:34,Valladolid,expenses,repairs,-303.99,-30333.74
buyer_6,Manuel,Díez,1979-02-14,54911168W,manuel.diez@coolcode.digital,606978,ES48209543417824685298,1248.06,2023-03-01T18:34:47,Valladolid,incomes,salary,2598.89,-27734.85
buyer_6,Manuel,Díez,1979-02-14,54911168W,manuel.diez@coolcode.digital,606978,ES48209543417824685298,1248.06,2023-03-01T10:54:11,Valladolid,expenses,food,-81.11,-27815.96
buyer_6,Manuel,Díez,1979-02-14,54911168W,manuel.diez@coolcode.digital,606978,ES48209543417824685298,1248.06,2023-03-01T13:04:17,Valladolid,expenses,clothing,-45.69,-27861.65
buyer_6,Manuel,Díez,1979-02-14,54911168W,manuel.diez@coolcode.digital,606978,ES48209543417824685298,1248.06,2023-03-02T18:40:35,Valladolid,expenses,gifts,-502.44,-28364.09
buyer_6,Manuel,Díez,1979-02-14,54911168W,manuel.diez@coolcode.digital,606978,ES48209543417824685298,1248.06,2023-03-03T10:48:58,Valladolid,expenses,leisure,-51.46,-28415.55
buyer_6,Manuel,Díez,1979-02-14,54911168W,manuel.diez@coolcode.digital,606978,ES48209543417824685298,1248.06,2023-03-05T19:38:16,Valladolid,expenses,mortgage,-982.85,-29398.4
buyer_6,Manuel,Díez,1979-02-14,54911168W,manuel.diez@coolcode.digital,606978,ES48209543417824685298,1248.06,2023-03-05T18:15:27,Valladolid,expenses,internet,-54.58,-29452.98
buyer_6,Manuel,Díez,1979-02-14,54911168W,manuel.diez@coolcode.digital,606978,ES48209543417824685298,1248.06,2023-03-07T11:13:44,Valladolid,expenses,water,-37.88,-29490.86
buyer_6,Manuel,Díez,1979-02-14,54911168W,manuel.diez@coolcode.digital,606978,ES48209543417824685298,1248.06,2023-03-07T20:16:22,Valladolid,expenses,electricity,-102.59,-29593.45
buyer_6,Manuel,Díez,1979-02-14,54911168W,manuel.diez@coolcode.digital,606978,ES48209543417824685298,1248.06,2023-03-08T12:28:33,Valladolid,expenses,gas,-90.95,-29684.4
buyer_6,Manuel,Díez,1979-02-14,54911168W,manuel.diez@coolcode.digital,606978,ES48209543417824685298,1248.06,2023-03-08T09:09:17,Valladolid,expenses,education,-44.65,-29729.05
buyer_6,Manuel,Díez,1979-02-14,54911168W,manuel.diez@coolcode.digital,606978,ES48209543417824685298,1248.06,2023-03-08T10:54:12,Valladolid,expenses,gifts,-383.2,-30112.25
buyer_6,Manuel,Díez,1979-02-14,54911168W,manuel.diez@coolcode.digital,606978,ES48209543417824685298,1248.06,2023-03-11T19:25:22,Valladolid,expenses,cash,-100.0,-30212.25
buyer_6,Manuel,Díez,1979-02-14,54911168W,manuel.diez@coolcode.digital,606978,ES48209543417824685298,1248.06,2023-03-13T15:16:02,Valladolid,expenses,cash,-100.0,-30312.25
buyer_6,Manuel,Díez,1979-02-14,54911168W,manuel.diez@coolcode.digital,606978,ES48209543417824685298,1248.06,2023-03-14T21:55:43,Valladolid,expenses,food,-74.08,-30386.33
buyer_6,Manuel,Díez,1979-02-14,54911168W,manuel.diez@coolcode.digital,606978,ES48209543417824685298,1248.06,2023-03-17T10:44:51,Valladolid,expenses,food,-113.58,-30499.91
buyer_6,Manuel,Díez,1979-02-14,54911168W,manuel.diez@coolcode.digital,606978,ES48209543417824685298,1248.06,2023-03-17T16:34:14,Valladolid,expenses,gifts,-688.36,-31188.27
buyer_6,Manuel,Díez,1979-02-14,54911168W,manuel.diez@coolcode.digital,606978,ES48209543417824685298,1248.06,2023-03-21T11:44:43,Valladolid,expenses,healthcare,-185.3,-31373.57
buyer_6,Manuel,Díez,1979-02-14,54911168W,manuel.diez@coolcode.digital,606978,ES48209543417824685298,1248.06,2023-03-22T08:21:55,Valladolid,expenses,transport,-84.46,-31458.03
buyer_6,Manuel,Díez,1979-02-14,54911168W,manuel.diez@coolcode.digital,606978,ES48209543417824685298,1248.06,2023-03-22T16:48:02,Valladolid,expenses,healthcare,-171.16,-31629.19
buyer_6,Manuel,Díez,1979-02-14,54911168W,manuel.diez@coolcode.digital,606978,ES48209543417824685298,1248.06,2023-03-23T18:02:21,Valladolid,expenses,cash,-100.0,-31729.19
buyer_6,Manuel,Díez,1979-02-14,54911168W,manuel.diez@coolcode.digital,606978,ES48209543417824685298,1248.06,2023-03-25T09:42:52,Valladolid,expenses,leisure,-51.66,-31780.85
buyer_6,Manuel,Díez,1979-02-14,54911168W,manuel.diez@coolcode.digital,606978,ES48209543417824685298,1248.06,2023-03-26T10:30:24,Valladolid,expenses,repairs,-63.84,-31844.69
buyer_6,Manuel,Díez,1979-02-14,54911168W,manuel.diez@coolcode.digital,606978,ES48209543417824685298,1248.06,2023-03-27T11:09:12,Valladolid,expenses,food,-123.49,-31968.18
buyer_6,Manuel,Díez,1979-02-14,54911168W,manuel.diez@coolcode.digital,606978,ES48209543417824685298,1248.06,2023-03-27T19:45:23,Valladolid,expenses,clothing,-80.88,-32049.06
buyer_6,Manuel,Díez,1979-02-14,54911168W,manuel.diez@coolcode.digital,606978,ES48209543417824685298,1248.06,2023-03-27T00:23:51,Valladolid,expenses,cash,-100.0,-32149.06
buyer_6,Manuel,Díez,1979-02-14,54911168W,manuel.diez@coolcode.digital,606978,ES48209543417824685298,1248.06,2023-03-29T16:17:08,Valladolid,expenses,transport,-41.1,-32190.16
buyer_6,Manuel,Díez,1979-02-14,54911168W,manuel.diez@coolcode.digital,606978,ES48209543417824685298,1248.06,2023-03-29T15:11:27,Valladolid,expenses,cash,-100.0,-32290.16
buyer_6,Manuel,Díez,1979-02-14,54911168W,manuel.diez@coolcode.digital,606978,ES48209543417824685298,1248.06,2023-03-30T09:52:53,Valladolid,expenses,repairs,-165.23,-32455.39
buyer_6,Manuel,Díez,1979-02-14,54911168W,manuel.diez@coolcode.digital,606978,ES48209543417824685298,1248.06,2023-03-31T13:54:14,Valladolid,expenses,leisure,-52.26,-32507.65
buyer_6,Manuel,Díez,1979-02-14,54911168W,manuel.diez@coolcode.digital,606978,ES48209543417824685298,1248.06,2023-03-31T20:51:20,Valladolid,expenses,cash,-100.0,-32607.65
buyer_6,Manuel,Díez,1979-02-14,54911168W,manuel.diez@coolcode.digital,606978,ES48209543417824685298,1248.06,2023-04-01T08:56:45,Valladolid,incomes,salary,2598.89,-30008.76
buyer_6,Manuel,Díez,1979-02-14,54911168W,manuel.diez@coolcode.digital,606978,ES48209543417824685298,1248.06,2023-04-01T08:56:45,Valladolid,incomes,extra_income,387.19,-29621.57
buyer_6,Manuel,Díez,1979-02-14,54911168W,manuel.diez@coolcode.digital,606978,ES48209543417824685298,1248.06,2023-04-01T21:58:43,Valladolid,expenses,cash,-100.0,-29721.57
buyer_6,Manuel,Díez,1979-02-14,54911168W,manuel.diez@coolcode.digital,606978,ES48209543417824685298,1248.06,2023-04-03T22:40:14,Valladolid,expenses,leisure,-46.27,-29767.84
buyer_6,Manuel,Díez,1979-02-14,54911168W,manuel.diez@coolcode.digital,606978,ES48209543417824685298,1248.06,2023-04-04T11:02:39,Valladolid,expenses,transport,-88.97,-29856.81
buyer_6,Manuel,Díez,1979-02-14,54911168W,manuel.diez@coolcode.digital,606978,ES48209543417824685298,1248.06,2023-04-05T16:08:48,Valladolid,expenses,mortgage,-982.85,-30839.66
buyer_6,Manuel,Díez,1979-02-14,54911168W,manuel.diez@coolcode.digital,606978,ES48209543417824685298,1248.06,2023-04-05T12:10:43,Valladolid,expenses,gas,-108.95,-30948.61
buyer_6,Manuel,Díez,1979-02-14,54911168W,manuel.diez@coolcode.digital,606978,ES48209543417824685298,1248.06,2023-04-06T10:17:49,Valladolid,expenses,phone,-40.78,-30989.39
buyer_6,Manuel,Díez,1979-02-14,54911168W,manuel.diez@coolcode.digital,606978,ES48209543417824685298,1248.06,2023-04-06T01:01:46,Valladolid,expenses,cash,-100.0,-31089.39
buyer_6,Manuel,Díez,1979-02-14,54911168W,manuel.diez@coolcode.digital,606978,ES48209543417824685298,1248.06,2023-04-06T08:25:44,Valladolid,expenses,repairs,-310.55,-31399.94
buyer_6,Manuel,Díez,1979-02-14,54911168W,manuel.diez@coolcode.digital,606978,ES48209543417824685298,1248.06,2023-04-07T09:52:56,Valladolid,expenses,electricity,-106.57,-31506.51
buyer_6,Manuel,Díez,1979-02-14,54911168W,manuel.diez@coolcode.digital,606978,ES48209543417824685298,1248.06,2023-04-08T20:15:39,Valladolid,expenses,phone,-55.19,-31561.7
buyer_6,Manuel,Díez,1979-02-14,54911168W,manuel.diez@coolcode.digital,606978,ES48209543417824685298,1248.06,2023-04-09T18:35:53,Valladolid,expenses,leisure,-41.31,-31603.01
buyer_6,Manuel,Díez,1979-02-14,54911168W,manuel.diez@coolcode.digital,606978,ES48209543417824685298,1248.06,2023-04-11T10:23:38,Valladolid,expenses,healthcare,-121.77,-31724.78
buyer_6,Manuel,Díez,1979-02-14,54911168W,manuel.diez@coolcode.digital,606978,ES48209543417824685298,1248.06,2023-04-11T19:41:05,Valladolid,expenses,appliances,-243.31,-31968.09
buyer_6,Manuel,Díez,1979-02-14,54911168W,manuel.diez@coolcode.digital,606978,ES48209543417824685298,1248.06,2023-04-13T17:28:49,Valladolid,expenses,appliances,-383.32,-32351.41
buyer_6,Manuel,Díez,1979-02-14,54911168W,manuel.diez@coolcode.digital,606978,ES48209543417824685298,1248.06,2023-04-17T21:27:59,Valladolid,expenses,transport,-64.23,-32415.64
buyer_6,Manuel,Díez,1979-02-14,54911168W,manuel.diez@coolcode.digital,606978,ES48209543417824685298,1248.06,2023-04-19T13:28:33,Valladolid,expenses,appliances,-184.81,-32600.45
buyer_6,Manuel,Díez,1979-02-14,54911168W,manuel.diez@coolcode.digital,606978,ES48209543417824685298,1248.06,2023-04-20T21:52:21,Valladolid,expenses,cash,-100.0,-32700.45
buyer_6,Manuel,Díez,1979-02-14,54911168W,manuel.diez@coolcode.digital,606978,ES48209543417824685298,1248.06,2023-04-20T14:13:38,Valladolid,expenses,repairs,-264.93,-32965.38
buyer_6,Manuel,Díez,1979-02-14,54911168W,manuel.diez@coolcode.digital,606978,ES48209543417824685298,1248.06,2023-04-25T08:26:23,Valladolid,expenses,food,-68.93,-33034.31
buyer_6,Manuel,Díez,1979-02-14,54911168W,manuel.diez@coolcode.digital,606978,ES48209543417824685298,1248.06,2023-04-26T10:51:12,Valladolid,expenses,transport,-67.33,-33101.64
buyer_6,Manuel,Díez,1979-02-14,54911168W,manuel.diez@coolcode.digital,606978,ES48209543417824685298,1248.06,2023-04-27T20:02:13,Valladolid,expenses,leisure,-43.33,-33144.97
buyer_6,Manuel,Díez,1979-02-14,54911168W,manuel.diez@coolcode.digital,606978,ES48209543417824685298,1248.06,2023-04-28T08:20:04,Valladolid,expenses,leisure,-26.21,-33171.18
buyer_6,Manuel,Díez,1979-02-14,54911168W,manuel.diez@coolcode.digital,606978,ES48209543417824685298,1248.06,2023-04-29T10:27:07,Valladolid,expenses,food,-122.86,-33294.04
buyer_6,Manuel,Díez,1979-02-14,54911168W,manuel.diez@coolcode.digital,606978,ES48209543417824685298,1248.06,2023-04-30T18:51:36,Valladolid,expenses,food,-109.52,-33403.56
buyer_6,Manuel,Díez,1979-02-14,54911168W,manuel.diez@coolcode.digital,606978,ES48209543417824685298,1248.06,2023-04-30T17:24:46,Valladolid,expenses,appliances,-260.53,-33664.09
buyer_6,Manuel,Díez,1979-02-14,54911168W,manuel.diez@coolcode.digital,606978,ES48209543417824685298,1248.06,2023-04-30T18:19:54,Valladolid,expenses,repairs,-209.86,-33873.95
buyer_6,Manuel,Díez,1979-02-14,54911168W,manuel.diez@coolcode.digital,606978,ES48209543417824685298,1248.06,2023-05-01T19:14:07,Valladolid,incomes,salary,2598.89,-31275.06
buyer_6,Manuel,Díez,1979-02-14,54911168W,manuel.diez@coolcode.digital,606978,ES48209543417824685298,1248.06,2023-05-05T05:07:44,Valladolid,expenses,mortgage,-982.85,-32257.91
buyer_6,Manuel,Díez,1979-02-14,54911168W,manuel.diez@coolcode.digital,606978,ES48209543417824685298,1248.06,2023-05-05T20:02:35,Valladolid,expenses,water,-49.41,-32307.32
buyer_6,Manuel,Díez,1979-02-14,54911168W,manuel.diez@coolcode.digital,606978,ES48209543417824685298,1248.06,2023-05-05T12:38:09,Valladolid,expenses,phone,-52.11,-32359.43
buyer_6,Manuel,Díez,1979-02-14,54911168W,manuel.diez@coolcode.digital,606978,ES48209543417824685298,1248.06,2023-05-05T10:43:22,Valladolid,expenses,food,-120.26,-32479.69
buyer_6,Manuel,Díez,1979-02-14,54911168W,manuel.diez@coolcode.digital,606978,ES48209543417824685298,1248.06,2023-05-05T20:56:21,Valladolid,expenses,transport,-89.03,-32568.72
buyer_6,Manuel,Díez,1979-02-14,54911168W,manuel.diez@coolcode.digital,606978,ES48209543417824685298,1248.06,2023-05-06T14:11:14,Valladolid,expenses,phone,-55.5,-32624.22
buyer_6,Manuel,Díez,1979-02-14,54911168W,manuel.diez@coolcode.digital,606978,ES48209543417824685298,1248.06,2023-05-07T19:25:31,Valladolid,expenses,water,-40.95,-32665.17
buyer_6,Manuel,Díez,1979-02-14,54911168W,manuel.diez@coolcode.digital,606978,ES48209543417824685298,1248.06,2023-05-07T14:33:54,Valladolid,expenses,gas,-71.97,-32737.14
buyer_6,Manuel,Díez,1979-02-14,54911168W,manuel.diez@coolcode.digital,606978,ES48209543417824685298,1248.06,2023-05-08T10:32:48,Valladolid,expenses,water,-55.32,-32792.46
buyer_6,Manuel,Díez,1979-02-14,54911168W,manuel.diez@coolcode.digital,606978,ES48209543417824685298,1248.06,2023-05-09T17:15:05,Valladolid,expenses,appliances,-377.99,-33170.45
buyer_6,Manuel,Díez,1979-02-14,54911168W,manuel.diez@coolcode.digital,606978,ES48209543417824685298,1248.06,2023-05-10T21:32:57,Valladolid,expenses,leisure,-41.96,-33212.41
buyer_6,Manuel,Díez,1979-02-14,54911168W,manuel.diez@coolcode.digital,606978,ES48209543417824685298,1248.06,2023-05-11T12:24:40,Valladolid,expenses,transport,-61.69,-33274.1
buyer_6,Manuel,Díez,1979-02-14,54911168W,manuel.diez@coolcode.digital,606978,ES48209543417824685298,1248.06,2023-05-11T20:43:31,Valladolid,expenses,leisure,-31.71,-33305.81
buyer_6,Manuel,Díez,1979-02-14,54911168W,manuel.diez@coolcode.digital,606978,ES48209543417824685298,1248.06,2023-05-12T10:26:06,Valladolid,expenses,food,-68.95,-33374.76
buyer_6,Manuel,Díez,1979-02-14,54911168W,manuel.diez@coolcode.digital,606978,ES48209543417824685298,1248.06,2023-05-12T13:04:54,Valladolid,expenses,gifts,-386.14,-33760.9
buyer_6,Manuel,Díez,1979-02-14,54911168W,manuel.diez@coolcode.digital,606978,ES48209543417824685298,1248.06,2023-05-13T08:42:12,Valladolid,expenses,food,-86.58,-33847.48
buyer_6,Manuel,Díez,1979-02-14,54911168W,manuel.diez@coolcode.digital,606978,ES48209543417824685298,1248.06,2023-05-14T17:05:20,Valladolid,expenses,leisure,-49.07,-33896.55
buyer_6,Manuel,Díez,1979-02-14,54911168W,manuel.diez@coolcode.digital,606978,ES48209543417824685298,1248.06,2023-05-17T14:07:29,Valladolid,expenses,appliances,-266.47,-34163.02
buyer_6,Manuel,Díez,1979-02-14,54911168W,manuel.diez@coolcode.digital,606978,ES48209543417824685298,1248.06,2023-05-18T09:23:44,Valladolid,expenses,travel,-1334.53,-35497.55
buyer_6,Manuel,Díez,1979-02-14,54911168W,manuel.diez@coolcode.digital,606978,ES48209543417824685298,1248.06,2023-05-19T08:28:36,Valladolid,expenses,food,-72.15,-35569.7
buyer_6,Manuel,Díez,1979-02-14,54911168W,manuel.diez@coolcode.digital,606978,ES48209543417824685298,1248.06,2023-05-20T17:40:23,Valladolid,expenses,clothing,-158.57,-35728.27
buyer_6,Manuel,Díez,1979-02-14,54911168W,manuel.diez@coolcode.digital,606978,ES48209543417824685298,1248.06,2023-05-21T18:50:17,Valladolid,expenses,leisure,-75.62,-35803.89
buyer_6,Manuel,Díez,1979-02-14,54911168W,manuel.diez@coolcode.digital,606978,ES48209543417824685298,1248.06,2023-05-22T10:23:15,Valladolid,expenses,transport,-61.59,-35865.48
buyer_6,Manuel,Díez,1979-02-14,54911168W,manuel.diez@coolcode.digital,606978,ES48209543417824685298,1248.06,2023-05-23T19:33:57,Valladolid,expenses,transport,-85.32,-35950.8
buyer_6,Manuel,Díez,1979-02-14,54911168W,manuel.diez@coolcode.digital,606978,ES48209543417824685298,1248.06,2023-05-24T13:37:37,Valladolid,expenses,food,-114.24,-36065.04
buyer_6,Manuel,Díez,1979-02-14,54911168W,manuel.diez@coolcode.digital,606978,ES48209543417824685298,1248.06,2023-05-24T19:27:00,Valladolid,expenses,leisure,-33.16,-36098.2
buyer_6,Manuel,Díez,1979-02-14,54911168W,manuel.diez@coolcode.digital,606978,ES48209543417824685298,1248.06,2023-05-25T20:07:13,Valladolid,expenses,cash,-100.0,-36198.2
buyer_6,Manuel,Díez,1979-02-14,54911168W,manuel.diez@coolcode.digital,606978,ES48209543417824685298,1248.06,2023-05-26T13:46:32,Valladolid,expenses,cash,-100.0,-36298.2
buyer_6,Manuel,Díez,1979-02-14,54911168W,manuel.diez@coolcode.digital,606978,ES48209543417824685298,1248.06,2023-05-27T02:49:06,Valladolid,expenses,food,-90.86,-36389.06
buyer_6,Manuel,Díez,1979-02-14,54911168W,manuel.diez@coolcode.digital,606978,ES48209543417824685298,1248.06,2023-05-28T16:03:10,Valladolid,expenses,food,-68.17,-36457.23
buyer_6,Manuel,Díez,1979-02-14,54911168W,manuel.diez@coolcode.digital,606978,ES48209543417824685298,1248.06,2023-05-29T17:28:35,Valladolid,expenses,repairs,-130.42,-36587.65
buyer_6,Manuel,Díez,1979-02-14,54911168W,manuel.diez@coolcode.digital,606978,ES48209543417824685298,1248.06,2023-06-01T20:34:29,Valladolid,incomes,salary,2598.89,-33988.76
buyer_6,Manuel,Díez,1979-02-14,54911168W,manuel.diez@coolcode.digital,606978,ES48209543417824685298,1248.06,2023-06-01T20:34:29,Valladolid,incomes,salary_bonus,2025.48,-31963.28
buyer_6,Manuel,Díez,1979-02-14,54911168W,manuel.diez@coolcode.digital,606978,ES48209543417824685298,1248.06,2023-06-02T13:46:16,Valladolid,expenses,taxes,-2302.48,-34265.76
buyer_6,Manuel,Díez,1979-02-14,54911168W,manuel.diez@coolcode.digital,606978,ES48209543417824685298,1248.06,2023-06-02T08:40:32,Valladolid,expenses,insurance,-390.94,-34656.7
buyer_6,Manuel,Díez,1979-02-14,54911168W,manuel.diez@coolcode.digital,606978,ES48209543417824685298,1248.06,2023-06-02T10:07:51,Valladolid,expenses,leisure,-44.35,-34701.05
buyer_6,Manuel,Díez,1979-02-14,54911168W,manuel.diez@coolcode.digital,606978,ES48209543417824685298,1248.06,2023-06-04T14:34:20,Valladolid,expenses,food,-89.28,-34790.33
buyer_6,Manuel,Díez,1979-02-14,54911168W,manuel.diez@coolcode.digital,606978,ES48209543417824685298,1248.06,2023-06-04T15:12:54,Valladolid,expenses,repairs,-97.49,-34887.82
buyer_6,Manuel,Díez,1979-02-14,54911168W,manuel.diez@coolcode.digital,606978,ES48209543417824685298,1248.06,2023-06-05T15:37:01,Valladolid,expenses,mortgage,-982.85,-35870.67
buyer_6,Manuel,Díez,1979-02-14,54911168W,manuel.diez@coolcode.digital,606978,ES48209543417824685298,1248.06,2023-06-05T08:59:47,Valladolid,expenses,internet,-54.58,-35925.25
buyer_6,Manuel,Díez,1979-02-14,54911168W,manuel.diez@coolcode.digital,606978,ES48209543417824685298,1248.06,2023-06-06T10:27:50,Valladolid,expenses,phone,-45.78,-35971.03
buyer_6,Manuel,Díez,1979-02-14,54911168W,manuel.diez@coolcode.digital,606978,ES48209543417824685298,1248.06,2023-06-07T11:33:58,Valladolid,expenses,electricity,-35.26,-36006.29
buyer_6,Manuel,Díez,1979-02-14,54911168W,manuel.diez@coolcode.digital,606978,ES48209543417824685298,1248.06,2023-06-07T12:03:43,Valladolid,expenses,gifts,-746.42,-36752.71
buyer_6,Manuel,Díez,1979-02-14,54911168W,manuel.diez@coolcode.digital,606978,ES48209543417824685298,1248.06,2023-06-09T09:26:38,Valladolid,expenses,transport,-75.02,-36827.73
buyer_6,Manuel,Díez,1979-02-14,54911168W,manuel.diez@coolcode.digital,606978,ES48209543417824685298,1248.06,2023-06-09T11:18:25,Valladolid,expenses,healthcare,-98.24,-36925.97
buyer_6,Manuel,Díez,1979-02-14,54911168W,manuel.diez@coolcode.digital,606978,ES48209543417824685298,1248.06,2023-06-10T20:39:08,Valladolid,expenses,transport,-77.02,-37002.99
buyer_6,Manuel,Díez,1979-02-14,54911168W,manuel.diez@coolcode.digital,606978,ES48209543417824685298,1248.06,2023-06-15T22:40:47,Valladolid,expenses,healthcare,-121.36,-37124.35
buyer_6,Manuel,Díez,1979-02-14,54911168W,manuel.diez@coolcode.digital,606978,ES48209543417824685298,1248.06,2023-06-17T20:10:06,Valladolid,expenses,food,-74.85,-37199.2
buyer_6,Manuel,Díez,1979-02-14,54911168W,manuel.diez@coolcode.digital,606978,ES48209543417824685298,1248.06,2023-06-19T16:25:34,Valladolid,expenses,food,-124.36,-37323.56
buyer_6,Manuel,Díez,1979-02-14,54911168W,manuel.diez@coolcode.digital,606978,ES48209543417824685298,1248.06,2023-06-19T14:38:33,Valladolid,expenses,transport,-41.16,-37364.72
buyer_6,Manuel,Díez,1979-02-14,54911168W,manuel.diez@coolcode.digital,606978,ES48209543417824685298,1248.06,2023-06-19T22:00:08,Valladolid,expenses,leisure,-55.58,-37420.3
buyer_6,Manuel,Díez,1979-02-14,54911168W,manuel.diez@coolcode.digital,606978,ES48209543417824685298,1248.06,2023-06-20T13:44:15,Valladolid,expenses,food,-97.22,-37517.52
buyer_6,Manuel,Díez,1979-02-14,54911168W,manuel.diez@coolcode.digital,606978,ES48209543417824685298,1248.06,2023-06-21T10:31:04,Valladolid,expenses,food,-98.51,-37616.03
buyer_6,Manuel,Díez,1979-02-14,54911168W,manuel.diez@coolcode.digital,606978,ES48209543417824685298,1248.06,2023-06-21T14:09:12,Valladolid,expenses,gifts,-225.75,-37841.78
buyer_6,Manuel,Díez,1979-02-14,54911168W,manuel.diez@coolcode.digital,606978,ES48209543417824685298,1248.06,2023-06-24T12:43:01,Valladolid,expenses,repairs,-136.94,-37978.72
buyer_6,Manuel,Díez,1979-02-14,54911168W,manuel.diez@coolcode.digital,606978,ES48209543417824685298,1248.06,2023-06-25T12:02:21,Valladolid,expenses,repairs,-29.61,-38008.33
buyer_6,Manuel,Díez,1979-02-14,54911168W,manuel.diez@coolcode.digital,606978,ES48209543417824685298,1248.06,2023-06-26T17:55:36,Valladolid,expenses,clothing,-70.05,-38078.38
buyer_6,Manuel,Díez,1979-02-14,54911168W,manuel.diez@coolcode.digital,606978,ES48209543417824685298,1248.06,2023-06-27T20:08:38,Valladolid,expenses,transport,-47.77,-38126.15
buyer_6,Manuel,Díez,1979-02-14,54911168W,manuel.diez@coolcode.digital,606978,ES48209543417824685298,1248.06,2023-06-28T15:03:34,Valladolid,expenses,transport,-81.9,-38208.05
buyer_6,Manuel,Díez,1979-02-14,54911168W,manuel.diez@coolcode.digital,606978,ES48209543417824685298,1248.06,2023-06-28T11:05:30,Valladolid,expenses,education,-46.24,-38254.29
buyer_6,Manuel,Díez,1979-02-14,54911168W,manuel.diez@coolcode.digital,606978,ES48209543417824685298,1248.06,2023-06-29T11:27:32,Valladolid,expenses,food,-90.79,-38345.08
buyer_6,Manuel,Díez,1979-02-14,54911168W,manuel.diez@coolcode.digital,606978,ES48209543417824685298,1248.06,2023-06-29T13:53:11,Valladolid,expenses,clothing,-84.16,-38429.24
buyer_6,Manuel,Díez,1979-02-14,54911168W,manuel.diez@coolcode.digital,606978,ES48209543417824685298,1248.06,2023-06-30T13:03:19,Valladolid,expenses,gifts,-607.69,-39036.93
buyer_6,Manuel,Díez,1979-02-14,54911168W,manuel.diez@coolcode.digital,606978,ES48209543417824685298,1248.06,2023-07-01T17:08:38,Valladolid,incomes,salary,2598.89,-36438.04
buyer_6,Manuel,Díez,1979-02-14,54911168W,manuel.diez@coolcode.digital,606978,ES48209543417824685298,1248.06,2023-07-01T17:08:38,Valladolid,incomes,extra_income,387.19,-36050.85
buyer_6,Manuel,Díez,1979-02-14,54911168W,manuel.diez@coolcode.digital,606978,ES48209543417824685298,1248.06,2023-07-02T08:59:06,Valladolid,expenses,gifts,-200.47,-36251.32
buyer_6,Manuel,Díez,1979-02-14,54911168W,manuel.diez@coolcode.digital,606978,ES48209543417824685298,1248.06,2023-07-04T09:02:58,Valladolid,expenses,clothing,-58.99,-36310.31
buyer_6,Manuel,Díez,1979-02-14,54911168W,manuel.diez@coolcode.digital,606978,ES48209543417824685298,1248.06,2023-07-05T11:54:35,Valladolid,expenses,mortgage,-982.85,-37293.16
buyer_6,Manuel,Díez,1979-02-14,54911168W,manuel.diez@coolcode.digital,606978,ES48209543417824685298,1248.06,2023-07-05T22:55:30,Valladolid,expenses,transport,-57.96,-37351.12
buyer_6,Manuel,Díez,1979-02-14,54911168W,manuel.diez@coolcode.digital,606978,ES48209543417824685298,1248.06,2023-07-05T22:11:32,Valladolid,expenses,leisure,-78.1,-37429.22
buyer_6,Manuel,Díez,1979-02-14,54911168W,manuel.diez@coolcode.digital,606978,ES48209543417824685298,1248.06,2023-07-06T10:49:07,Valladolid,expenses,food,-83.46,-37512.68
buyer_6,Manuel,Díez,1979-02-14,54911168W,manuel.diez@coolcode.digital,606978,ES48209543417824685298,1248.06,2023-07-06T15:45:07,Valladolid,expenses,travel,-1144.48,-38657.16
buyer_6,Manuel,Díez,1979-02-14,54911168W,manuel.diez@coolcode.digital,606978,ES48209543417824685298,1248.06,2023-07-07T13:11:06,Valladolid,expenses,electricity,-107.57,-38764.73
buyer_6,Manuel,Díez,1979-02-14,54911168W,manuel.diez@coolcode.digital,606978,ES48209543417824685298,1248.06,2023-07-07T16:18:37,Valladolid,expenses,internet,-54.58,-38819.31
buyer_6,Manuel,Díez,1979-02-14,54911168W,manuel.diez@coolcode.digital,606978,ES48209543417824685298,1248.06,2023-07-08T14:53:37,Valladolid,expenses,internet,-54.58,-38873.89
buyer_6,Manuel,Díez,1979-02-14,54911168W,manuel.diez@coolcode.digital,606978,ES48209543417824685298,1248.06,2023-07-09T13:47:04,Valladolid,expenses,leisure,-69.5,-38943.39
buyer_6,Manuel,Díez,1979-02-14,54911168W,manuel.diez@coolcode.digital,606978,ES48209543417824685298,1248.06,2023-07-12T08:26:11,Valladolid,expenses,transport,-89.9,-39033.29
buyer_6,Manuel,Díez,1979-02-14,54911168W,manuel.diez@coolcode.digital,606978,ES48209543417824685298,1248.06,2023-07-12T10:29:38,Valladolid,expenses,repairs,-78.42,-39111.71
buyer_6,Manuel,Díez,1979-02-14,54911168W,manuel.diez@coolcode.digital,606978,ES48209543417824685298,1248.06,2023-07-13T08:11:33,Valladolid,expenses,healthcare,-131.01,-39242.72
buyer_6,Manuel,Díez,1979-02-14,54911168W,manuel.diez@coolcode.digital,606978,ES48209543417824685298,1248.06,2023-07-14T17:37:45,Valladolid,expenses,repairs,-51.13,-39293.85
buyer_6,Manuel,Díez,1979-02-14,54911168W,manuel.diez@coolcode.digital,606978,ES48209543417824685298,1248.06,2023-07-15T16:52:37,Valladolid,expenses,transport,-81.01,-39374.86
buyer_6,Manuel,Díez,1979-02-14,54911168W,manuel.diez@coolcode.digital,606978,ES48209543417824685298,1248.06,2023-07-16T18:44:10,Valladolid,expenses,appliances,-357.68,-39732.54
buyer_6,Manuel,Díez,1979-02-14,54911168W,manuel.diez@coolcode.digital,606978,ES48209543417824685298,1248.06,2023-07-17T16:57:54,Valladolid,expenses,food,-98.6,-39831.14
buyer_6,Manuel,Díez,1979-02-14,54911168W,manuel.diez@coolcode.digital,606978,ES48209543417824685298,1248.06,2023-07-17T18:35:04,Valladolid,expenses,clothing,-117.34,-39948.48
buyer_6,Manuel,Díez,1979-02-14,54911168W,manuel.diez@coolcode.digital,606978,ES48209543417824685298,1248.06,2023-07-18T22:37:43,Valladolid,expenses,food,-77.34,-40025.82
buyer_6,Manuel,Díez,1979-02-14,54911168W,manuel.diez@coolcode.digital,606978,ES48209543417824685298,1248.06,2023-07-19T16:20:42,Valladolid,expenses,food,-76.45,-40102.27
buyer_6,Manuel,Díez,1979-02-14,54911168W,manuel.diez@coolcode.digital,606978,ES48209543417824685298,1248.06,2023-07-19T10:11:11,Valladolid,expenses,appliances,-344.01,-40446.28
buyer_6,Manuel,Díez,1979-02-14,54911168W,manuel.diez@coolcode.digital,606978,ES48209543417824685298,1248.06,2023-07-22T15:21:02,Valladolid,expenses,food,-104.33,-40550.61
buyer_6,Manuel,Díez,1979-02-14,54911168W,manuel.diez@coolcode.digital,606978,ES48209543417824685298,1248.06,2023-07-23T20:29:03,Valladolid,expenses,food,-115.28,-40665.89
buyer_6,Manuel,Díez,1979-02-14,54911168W,manuel.diez@coolcode.digital,606978,ES48209543417824685298,1248.06,2023-07-26T12:37:20,Valladolid,expenses,gifts,-755.13,-41421.02
buyer_6,Manuel,Díez,1979-02-14,54911168W,manuel.diez@coolcode.digital,606978,ES48209543417824685298,1248.06,2023-07-27T09:12:07,Valladolid,expenses,food,-76.37,-41497.39
buyer_6,Manuel,Díez,1979-02-14,54911168W,manuel.diez@coolcode.digital,606978,ES48209543417824685298,1248.06,2023-07-28T14:12:38,Valladolid,expenses,transport,-71.49,-41568.88
buyer_6,Manuel,Díez,1979-02-14,54911168W,manuel.diez@coolcode.digital,606978,ES48209543417824685298,1248.06,2023-07-30T15:31:27,Valladolid,expenses,food,-70.63,-41639.51
buyer_6,Manuel,Díez,1979-02-14,54911168W,manuel.diez@coolcode.digital,606978,ES48209543417824685298,1248.06,2023-07-30T17:15:47,Valladolid,expenses,leisure,-61.83,-41701.34
buyer_6,Manuel,Díez,1979-02-14,54911168W,manuel.diez@coolcode.digital,606978,ES48209543417824685298,1248.06,2023-08-01T12:37:03,Valladolid,incomes,salary,2598.89,-39102.45
buyer_6,Manuel,Díez,1979-02-14,54911168W,manuel.diez@coolcode.digital,606978,ES48209543417824685298,1248.06,2023-08-01T12:07:25,Valladolid,expenses,healthcare,-138.9,-39241.35
buyer_6,Manuel,Díez,1979-02-14,54911168W,manuel.diez@coolcode.digital,606978,ES48209543417824685298,1248.06,2023-08-02T16:00:53,Valladolid,expenses,cash,-100.0,-39341.35
buyer_6,Manuel,Díez,1979-02-14,54911168W,manuel.diez@coolcode.digital,606978,ES48209543417824685298,1248.06,2023-08-04T17:02:59,Valladolid,expenses,leisure,-33.74,-39375.09
buyer_6,Manuel,Díez,1979-02-14,54911168W,manuel.diez@coolcode.digital,606978,ES48209543417824685298,1248.06,2023-08-05T12:31:40,Valladolid,expenses,mortgage,-982.85,-40357.94
buyer_6,Manuel,Díez,1979-02-14,54911168W,manuel.diez@coolcode.digital,606978,ES48209543417824685298,1248.06,2023-08-07T18:19:41,Valladolid,expenses,internet,-54.58,-40412.52
buyer_6,Manuel,Díez,1979-02-14,54911168W,manuel.diez@coolcode.digital,606978,ES48209543417824685298,1248.06,2023-08-07T20:38:14,Valladolid,expenses,cash,-100.0,-40512.52
buyer_6,Manuel,Díez,1979-02-14,54911168W,manuel.diez@coolcode.digital,606978,ES48209543417824685298,1248.06,2023-08-08T17:11:51,Valladolid,expenses,electricity,-44.21,-40556.73
buyer_6,Manuel,Díez,1979-02-14,54911168W,manuel.diez@coolcode.digital,606978,ES48209543417824685298,1248.06,2023-08-08T19:59:05,Valladolid,expenses,internet,-54.58,-40611.31
buyer_6,Manuel,Díez,1979-02-14,54911168W,manuel.diez@coolcode.digital,606978,ES48209543417824685298,1248.06,2023-08-08T17:59:00,Valladolid,expenses,phone,-56.19,-40667.5
buyer_6,Manuel,Díez,1979-02-14,54911168W,manuel.diez@coolcode.digital,606978,ES48209543417824685298,1248.06,2023-08-08T18:34:15,Valladolid,expenses,leisure,-37.11,-40704.61
buyer_6,Manuel,Díez,1979-02-14,54911168W,manuel.diez@coolcode.digital,606978,ES48209543417824685298,1248.06,2023-08-08T15:38:06,Valladolid,expenses,education,-76.67,-40781.28
buyer_6,Manuel,Díez,1979-02-14,54911168W,manuel.diez@coolcode.digital,606978,ES48209543417824685298,1248.06,2023-08-10T12:34:46,Valladolid,expenses,transport,-43.84,-40825.12
buyer_6,Manuel,Díez,1979-02-14,54911168W,manuel.diez@coolcode.digital,606978,ES48209543417824685298,1248.06,2023-08-11T09:47:12,Valladolid,expenses,gifts,-490.72,-41315.84
buyer_6,Manuel,Díez,1979-02-14,54911168W,manuel.diez@coolcode.digital,606978,ES48209543417824685298,1248.06,2023-08-13T14:14:13,Valladolid,expenses,leisure,-62.53,-41378.37
buyer_6,Manuel,Díez,1979-02-14,54911168W,manuel.diez@coolcode.digital,606978,ES48209543417824685298,1248.06,2023-08-16T13:28:23,Valladolid,expenses,food,-65.66,-41444.03
buyer_6,Manuel,Díez,1979-02-14,54911168W,manuel.diez@coolcode.digital,606978,ES48209543417824685298,1248.06,2023-08-16T09:49:07,Valladolid,expenses,leisure,-27.97,-41472.0
buyer_6,Manuel,Díez,1979-02-14,54911168W,manuel.diez@coolcode.digital,606978,ES48209543417824685298,1248.06,2023-08-16T10:49:10,Valladolid,expenses,cash,-100.0,-41572.0
buyer_6,Manuel,Díez,1979-02-14,54911168W,manuel.diez@coolcode.digital,606978,ES48209543417824685298,1248.06,2023-08-18T09:56:46,Valladolid,expenses,cash,-100.0,-41672.0
buyer_6,Manuel,Díez,1979-02-14,54911168W,manuel.diez@coolcode.digital,606978,ES48209543417824685298,1248.06,2023-08-20T13:06:36,Valladolid,expenses,food,-86.34,-41758.34
buyer_6,Manuel,Díez,1979-02-14,54911168W,manuel.diez@coolcode.digital,606978,ES48209543417824685298,1248.06,2023-08-20T22:23:31,Valladolid,expenses,clothing,-50.52,-41808.86
buyer_6,Manuel,Díez,1979-02-14,54911168W,manuel.diez@coolcode.digital,606978,ES48209543417824685298,1248.06,2023-08-21T11:24:10,Valladolid,expenses,food,-123.32,-41932.18
buyer_6,Manuel,Díez,1979-02-14,54911168W,manuel.diez@coolcode.digital,606978,ES48209543417824685298,1248.06,2023-08-21T17:45:15,Valladolid,expenses,cash,-100.0,-42032.18
buyer_6,Manuel,Díez,1979-02-14,54911168W,manuel.diez@coolcode.digital,606978,ES48209543417824685298,1248.06,2023-08-21T16:38:20,Valladolid,expenses,repairs,-80.78,-42112.96
buyer_6,Manuel,Díez,1979-02-14,54911168W,manuel.diez@coolcode.digital,606978,ES48209543417824685298,1248.06,2023-08-23T20:05:26,Valladolid,expenses,food,-78.05,-42191.01
buyer_6,Manuel,Díez,1979-02-14,54911168W,manuel.diez@coolcode.digital,606978,ES48209543417824685298,1248.06,2023-08-23T12:59:04,Valladolid,expenses,gifts,-561.97,-42752.98
buyer_6,Manuel,Díez,1979-02-14,54911168W,manuel.diez@coolcode.digital,606978,ES48209543417824685298,1248.06,2023-08-24T19:14:06,Valladolid,expenses,cash,-100.0,-42852.98
buyer_6,Manuel,Díez,1979-02-14,54911168W,manuel.diez@coolcode.digital,606978,ES48209543417824685298,1248.06,2023-08-25T08:31:08,Valladolid,expenses,cash,-100.0,-42952.98
buyer_6,Manuel,Díez,1979-02-14,54911168W,manuel.diez@coolcode.digital,606978,ES48209543417824685298,1248.06,2023-08-26T18:09:00,Valladolid,expenses,education,-51.18,-43004.16
buyer_6,Manuel,Díez,1979-02-14,54911168W,manuel.diez@coolcode.digital,606978,ES48209543417824685298,1248.06,2023-08-27T20:36:48,Valladolid,expenses,leisure,-42.06,-43046.22
buyer_6,Manuel,Díez,1979-02-14,54911168W,manuel.diez@coolcode.digital,606978,ES48209543417824685298,1248.06,2023-08-30T23:14:27,Valladolid,expenses,food,-84.19,-43130.41
buyer_6,Manuel,Díez,1979-02-14,54911168W,manuel.diez@coolcode.digital,606978,ES48209543417824685298,1248.06,2023-08-30T14:33:16,Valladolid,expenses,transport,-55.47,-43185.88
buyer_6,Manuel,Díez,1979-02-14,54911168W,manuel.diez@coolcode.digital,606978,ES48209543417824685298,1248.06,2023-08-30T15:01:38,Valladolid,expenses,cash,-100.0,-43285.88
buyer_6,Manuel,Díez,1979-02-14,54911168W,manuel.diez@coolcode.digital,606978,ES48209543417824685298,1248.06,2023-08-31T06:08:45,Valladolid,expenses,food,-112.1,-43397.98
buyer_6,Manuel,Díez,1979-02-14,54911168W,manuel.diez@coolcode.digital,606978,ES48209543417824685298,1248.06,2023-08-31T13:58:33,Valladolid,expenses,leisure,-36.34,-43434.32
buyer_6,Manuel,Díez,1979-02-14,54911168W,manuel.diez@coolcode.digital,606978,ES48209543417824685298,1248.06,2023-08-31T19:59:09,Valladolid,expenses,repairs,-198.93,-43633.25
buyer_6,Manuel,Díez,1979-02-14,54911168W,manuel.diez@coolcode.digital,606978,ES48209543417824685298,1248.06,2023-09-01T13:47:33,Valladolid,incomes,salary,2598.89,-41034.36
buyer_6,Manuel,Díez,1979-02-14,54911168W,manuel.diez@coolcode.digital,606978,ES48209543417824685298,1248.06,2023-09-02T14:02:04,Valladolid,expenses,healthcare,-151.81,-41186.17
buyer_6,Manuel,Díez,1979-02-14,54911168W,manuel.diez@coolcode.digital,606978,ES48209543417824685298,1248.06,2023-09-03T22:06:31,Valladolid,expenses,food,-72.13,-41258.3
buyer_6,Manuel,Díez,1979-02-14,54911168W,manuel.diez@coolcode.digital,606978,ES48209543417824685298,1248.06,2023-09-03T09:46:40,Valladolid,expenses,leisure,-45.0,-41303.3
buyer_6,Manuel,Díez,1979-02-14,54911168W,manuel.diez@coolcode.digital,606978,ES48209543417824685298,1248.06,2023-09-04T12:04:35,Valladolid,expenses,repairs,-65.51,-41368.81
buyer_6,Manuel,Díez,1979-02-14,54911168W,manuel.diez@coolcode.digital,606978,ES48209543417824685298,1248.06,2023-09-05T21:41:29,Valladolid,expenses,mortgage,-982.85,-42351.66
buyer_6,Manuel,Díez,1979-02-14,54911168W,manuel.diez@coolcode.digital,606978,ES48209543417824685298,1248.06,2023-09-05T12:25:43,Valladolid,expenses,phone,-55.93,-42407.59
buyer_6,Manuel,Díez,1979-02-14,54911168W,manuel.diez@coolcode.digital,606978,ES48209543417824685298,1248.06,2023-09-05T08:17:28,Valladolid,expenses,leisure,-27.25,-42434.84
buyer_6,Manuel,Díez,1979-02-14,54911168W,manuel.diez@coolcode.digital,606978,ES48209543417824685298,1248.06,2023-09-05T20:37:25,Valladolid,expenses,cash,-100.0,-42534.84
buyer_6,Manuel,Díez,1979-02-14,54911168W,manuel.diez@coolcode.digital,606978,ES48209543417824685298,1248.06,2023-09-06T22:42:28,Valladolid,expenses,repairs,-290.72,-42825.56
buyer_6,Manuel,Díez,1979-02-14,54911168W,manuel.diez@coolcode.digital,606978,ES48209543417824685298,1248.06,2023-09-07T20:18:04,Valladolid,expenses,electricity,-104.02,-42929.58
buyer_6,Manuel,Díez,1979-02-14,54911168W,manuel.diez@coolcode.digital,606978,ES48209543417824685298,1248.06,2023-09-07T18:34:38,Valladolid,expenses,gifts,-92.18,-43021.76
buyer_6,Manuel,Díez,1979-02-14,54911168W,manuel.diez@coolcode.digital,606978,ES48209543417824685298,1248.06,2023-09-08T06:09:18,Valladolid,expenses,internet,-54.58,-43076.34
buyer_6,Manuel,Díez,1979-02-14,54911168W,manuel.diez@coolcode.digital,606978,ES48209543417824685298,1248.06,2023-09-11T22:47:27,Valladolid,expenses,gifts,-356.02,-43432.36
buyer_6,Manuel,Díez,1979-02-14,54911168W,manuel.diez@coolcode.digital,606978,ES48209543417824685298,1248.06,2023-09-12T19:41:13,Valladolid,expenses,food,-68.26,-43500.62
buyer_6,Manuel,Díez,1979-02-14,54911168W,manuel.diez@coolcode.digital,606978,ES48209543417824685298,1248.06,2023-09-12T09:42:20,Valladolid,expenses,repairs,-211.1,-43711.72
buyer_6,Manuel,Díez,1979-02-14,54911168W,manuel.diez@coolcode.digital,606978,ES48209543417824685298,1248.06,2023-09-14T11:30:53,Valladolid,expenses,food,-68.9,-43780.62
buyer_6,Manuel,Díez,1979-02-14,54911168W,manuel.diez@coolcode.digital,606978,ES48209543417824685298,1248.06,2023-09-14T20:44:03,Valladolid,expenses,education,-60.8,-43841.42
buyer_6,Manuel,Díez,1979-02-14,54911168W,manuel.diez@coolcode.digital,606978,ES48209543417824685298,1248.06,2023-09-15T23:10:09,Valladolid,expenses,cash,-100.0,-43941.42
buyer_6,Manuel,Díez,1979-02-14,54911168W,manuel.diez@coolcode.digital,606978,ES48209543417824685298,1248.06,2023-09-15T12:06:47,Valladolid,expenses,appliances,-173.97,-44115.39
buyer_6,Manuel,Díez,1979-02-14,54911168W,manuel.diez@coolcode.digital,606978,ES48209543417824685298,1248.06,2023-09-16T12:09:56,Valladolid,expenses,food,-116.9,-44232.29
buyer_6,Manuel,Díez,1979-02-14,54911168W,manuel.diez@coolcode.digital,606978,ES48209543417824685298,1248.06,2023-09-18T20:42:18,Valladolid,expenses,cash,-100.0,-44332.29
buyer_6,Manuel,Díez,1979-02-14,54911168W,manuel.diez@coolcode.digital,606978,ES48209543417824685298,1248.06,2023-09-19T22:26:04,Valladolid,expenses,transport,-62.68,-44394.97
buyer_6,Manuel,Díez,1979-02-14,54911168W,manuel.diez@coolcode.digital,606978,ES48209543417824685298,1248.06,2023-09-20T19:50:55,Valladolid,expenses,education,-78.33,-44473.3
buyer_6,Manuel,Díez,1979-02-14,54911168W,manuel.diez@coolcode.digital,606978,ES48209543417824685298,1248.06,2023-09-20T07:23:36,Valladolid,expenses,cash,-100.0,-44573.3
buyer_6,Manuel,Díez,1979-02-14,54911168W,manuel.diez@coolcode.digital,606978,ES48209543417824685298,1248.06,2023-09-23T00:36:37,Valladolid,expenses,food,-70.0,-44643.3
buyer_6,Manuel,Díez,1979-02-14,54911168W,manuel.diez@coolcode.digital,606978,ES48209543417824685298,1248.06,2023-09-24T23:58:35,Valladolid,expenses,leisure,-43.38,-44686.68
buyer_6,Manuel,Díez,1979-02-14,54911168W,manuel.diez@coolcode.digital,606978,ES48209543417824685298,1248.06,2023-09-25T12:22:14,Valladolid,expenses,transport,-44.16,-44730.84
buyer_6,Manuel,Díez,1979-02-14,54911168W,manuel.diez@coolcode.digital,606978,ES48209543417824685298,1248.06,2023-09-25T17:46:49,Valladolid,expenses,leisure,-35.4,-44766.24
buyer_6,Manuel,Díez,1979-02-14,54911168W,manuel.diez@coolcode.digital,606978,ES48209543417824685298,1248.06,2023-09-26T10:42:34,Valladolid,expenses,leisure,-20.97,-44787.21
buyer_6,Manuel,Díez,1979-02-14,54911168W,manuel.diez@coolcode.digital,606978,ES48209543417824685298,1248.06,2023-09-26T15:32:19,Valladolid,expenses,cash,-100.0,-44887.21
buyer_6,Manuel,Díez,1979-02-14,54911168W,manuel.diez@coolcode.digital,606978,ES48209543417824685298,1248.06,2023-09-30T10:12:10,Valladolid,expenses,leisure,-61.8,-44949.01
buyer_6,Manuel,Díez,1979-02-14,54911168W,manuel.diez@coolcode.digital,606978,ES48209543417824685298,1248.06,2023-09-30T13:35:04,Valladolid,expenses,cash,-100.0,-45049.01
buyer_6,Manuel,Díez,1979-02-14,54911168W,manuel.diez@coolcode.digital,606978,ES48209543417824685298,1248.06,2023-10-01T09:41:49,Valladolid,incomes,salary,2598.89,-42450.12
buyer_6,Manuel,Díez,1979-02-14,54911168W,manuel.diez@coolcode.digital,606978,ES48209543417824685298,1248.06,2023-10-01T09:41:49,Valladolid,incomes,extra_income,387.19,-42062.93
buyer_6,Manuel,Díez,1979-02-14,54911168W,manuel.diez@coolcode.digital,606978,ES48209543417824685298,1248.06,2023-10-01T13:30:37,Valladolid,expenses,travel,-1054.48,-43117.41
buyer_6,Manuel,Díez,1979-02-14,54911168W,manuel.diez@coolcode.digital,606978,ES48209543417824685298,1248.06,2023-10-02T15:20:34,Valladolid,expenses,healthcare,-165.38,-43282.79
buyer_6,Manuel,Díez,1979-02-14,54911168W,manuel.diez@coolcode.digital,606978,ES48209543417824685298,1248.06,2023-10-03T19:03:51,Valladolid,expenses,healthcare,-89.69,-43372.48
buyer_6,Manuel,Díez,1979-02-14,54911168W,manuel.diez@coolcode.digital,606978,ES48209543417824685298,1248.06,2023-10-04T13:14:13,Valladolid,expenses,clothing,-97.47,-43469.95
buyer_6,Manuel,Díez,1979-02-14,54911168W,manuel.diez@coolcode.digital,606978,ES48209543417824685298,1248.06,2023-10-05T16:31:55,Valladolid,expenses,mortgage,-982.85,-44452.8
buyer_6,Manuel,Díez,1979-02-14,54911168W,manuel.diez@coolcode.digital,606978,ES48209543417824685298,1248.06,2023-10-05T05:08:41,Valladolid,expenses,electricity,-73.49,-44526.29
buyer_6,Manuel,Díez,1979-02-14,54911168W,manuel.diez@coolcode.digital,606978,ES48209543417824685298,1248.06,2023-10-05T23:28:20,Valladolid,expenses,internet,-54.58,-44580.87
buyer_6,Manuel,Díez,1979-02-14,54911168W,manuel.diez@coolcode.digital,606978,ES48209543417824685298,1248.06,2023-10-05T19:11:32,Valladolid,expenses,leisure,-23.6,-44604.47
buyer_6,Manuel,Díez,1979-02-14,54911168W,manuel.diez@coolcode.digital,606978,ES48209543417824685298,1248.06,2023-10-06T19:54:26,Valladolid,expenses,internet,-54.58,-44659.05
buyer_6,Manuel,Díez,1979-02-14,54911168W,manuel.diez@coolcode.digital,606978,ES48209543417824685298,1248.06,2023-10-07T07:13:35,Valladolid,expenses,internet,-54.58,-44713.63
buyer_6,Manuel,Díez,1979-02-14,54911168W,manuel.diez@coolcode.digital,606978,ES48209543417824685298,1248.06,2023-10-07T17:43:42,Valladolid,expenses,phone,-39.13,-44752.76
buyer_6,Manuel,Díez,1979-02-14,54911168W,manuel.diez@coolcode.digital,606978,ES48209543417824685298,1248.06,2023-10-08T10:07:14,Valladolid,expenses,leisure,-68.44,-44821.2
buyer_6,Manuel,Díez,1979-02-14,54911168W,manuel.diez@coolcode.digital,606978,ES48209543417824685298,1248.06,2023-10-09T08:18:45,Valladolid,expenses,food,-104.08,-44925.28
buyer_6,Manuel,Díez,1979-02-14,54911168W,manuel.diez@coolcode.digital,606978,ES48209543417824685298,1248.06,2023-10-09T19:32:53,Valladolid,expenses,repairs,-131.55,-45056.83
buyer_6,Manuel,Díez,1979-02-14,54911168W,manuel.diez@coolcode.digital,606978,ES48209543417824685298,1248.06,2023-10-11T20:08:13,Valladolid,expenses,clothing,-149.26,-45206.09
buyer_6,Manuel,Díez,1979-02-14,54911168W,manuel.diez@coolcode.digital,606978,ES48209543417824685298,1248.06,2023-10-13T14:54:26,Valladolid,expenses,cash,-100.0,-45306.09
buyer_6,Manuel,Díez,1979-02-14,54911168W,manuel.diez@coolcode.digital,606978,ES48209543417824685298,1248.06,2023-10-14T14:54:06,Valladolid,expenses,cash,-100.0,-45406.09
buyer_6,Manuel,Díez,1979-02-14,54911168W,manuel.diez@coolcode.digital,606978,ES48209543417824685298,1248.06,2023-10-15T12:04:42,Valladolid,expenses,healthcare,-86.78,-45492.87
buyer_6,Manuel,Díez,1979-02-14,54911168W,manuel.diez@coolcode.digital,606978,ES48209543417824685298,1248.06,2023-10-16T20:54:06,Valladolid,expenses,leisure,-72.06,-45564.93
buyer_6,Manuel,Díez,1979-02-14,54911168W,manuel.diez@coolcode.digital,606978,ES48209543417824685298,1248.06,2023-10-16T20:21:23,Valladolid,expenses,cash,-100.0,-45664.93
buyer_6,Manuel,Díez,1979-02-14,54911168W,manuel.diez@coolcode.digital,606978,ES48209543417824685298,1248.06,2023-10-17T17:45:13,Valladolid,expenses,food,-107.87,-45772.8
buyer_6,Manuel,Díez,1979-02-14,54911168W,manuel.diez@coolcode.digital,606978,ES48209543417824685298,1248.06,2023-10-17T17:49:20,Valladolid,expenses,education,-49.28,-45822.08
buyer_6,Manuel,Díez,1979-02-14,54911168W,manuel.diez@coolcode.digital,606978,ES48209543417824685298,1248.06,2023-10-19T08:22:45,Valladolid,expenses,transport,-41.55,-45863.63
buyer_6,Manuel,Díez,1979-02-14,54911168W,manuel.diez@coolcode.digital,606978,ES48209543417824685298,1248.06,2023-10-20T08:15:15,Valladolid,expenses,transport,-79.2,-45942.83
buyer_6,Manuel,Díez,1979-02-14,54911168W,manuel.diez@coolcode.digital,606978,ES48209543417824685298,1248.06,2023-10-21T09:25:03,Valladolid,expenses,food,-97.87,-46040.7
buyer_6,Manuel,Díez,1979-02-14,54911168W,manuel.diez@coolcode.digital,606978,ES48209543417824685298,1248.06,2023-10-22T20:40:53,Valladolid,expenses,appliances,-333.3,-46374.0
buyer_6,Manuel,Díez,1979-02-14,54911168W,manuel.diez@coolcode.digital,606978,ES48209543417824685298,1248.06,2023-10-23T18:54:18,Valladolid,expenses,transport,-49.14,-46423.14
buyer_6,Manuel,Díez,1979-02-14,54911168W,manuel.diez@coolcode.digital,606978,ES48209543417824685298,1248.06,2023-10-23T08:25:46,Valladolid,expenses,appliances,-357.42,-46780.56
buyer_6,Manuel,Díez,1979-02-14,54911168W,manuel.diez@coolcode.digital,606978,ES48209543417824685298,1248.06,2023-10-25T19:04:39,Valladolid,expenses,appliances,-216.37,-46996.93
buyer_6,Manuel,Díez,1979-02-14,54911168W,manuel.diez@coolcode.digital,606978,ES48209543417824685298,1248.06,2023-10-26T20:41:18,Valladolid,expenses,transport,-65.32,-47062.25
buyer_6,Manuel,Díez,1979-02-14,54911168W,manuel.diez@coolcode.digital,606978,ES48209543417824685298,1248.06,2023-10-26T14:25:42,Valladolid,expenses,cash,-100.0,-47162.25
buyer_6,Manuel,Díez,1979-02-14,54911168W,manuel.diez@coolcode.digital,606978,ES48209543417824685298,1248.06,2023-10-27T23:56:17,Valladolid,expenses,leisure,-46.42,-47208.67
buyer_6,Manuel,Díez,1979-02-14,54911168W,manuel.diez@coolcode.digital,606978,ES48209543417824685298,1248.06,2023-10-30T16:47:08,Valladolid,expenses,food,-73.5,-47282.17
buyer_6,Manuel,Díez,1979-02-14,54911168W,manuel.diez@coolcode.digital,606978,ES48209543417824685298,1248.06,2023-10-30T19:31:42,Valladolid,expenses,leisure,-77.53,-47359.7
buyer_6,Manuel,Díez,1979-02-14,54911168W,manuel.diez@coolcode.digital,606978,ES48209543417824685298,1248.06,2023-10-30T16:08:11,Valladolid,expenses,cash,-100.0,-47459.7
buyer_6,Manuel,Díez,1979-02-14,54911168W,manuel.diez@coolcode.digital,606978,ES48209543417824685298,1248.06,2023-10-31T12:52:49,Valladolid,expenses,cash,-100.0,-47559.7
buyer_6,Manuel,Díez,1979-02-14,54911168W,manuel.diez@coolcode.digital,606978,ES48209543417824685298,1248.06,2023-11-01T18:30:04,Valladolid,incomes,salary,2598.89,-44960.81
buyer_6,Manuel,Díez,1979-02-14,54911168W,manuel.diez@coolcode.digital,606978,ES48209543417824685298,1248.06,2023-11-01T14:58:08,Valladolid,expenses,leisure,-34.52,-44995.33
buyer_6,Manuel,Díez,1979-02-14,54911168W,manuel.diez@coolcode.digital,606978,ES48209543417824685298,1248.06,2023-11-01T08:02:58,Valladolid,expenses,gifts,-703.59,-45698.92
buyer_6,Manuel,Díez,1979-02-14,54911168W,manuel.diez@coolcode.digital,606978,ES48209543417824685298,1248.06,2023-11-02T09:41:15,Valladolid,expenses,gifts,-282.33,-45981.25
buyer_6,Manuel,Díez,1979-02-14,54911168W,manuel.diez@coolcode.digital,606978,ES48209543417824685298,1248.06,2023-11-04T16:02:14,Valladolid,expenses,cash,-100.0,-46081.25
buyer_6,Manuel,Díez,1979-02-14,54911168W,manuel.diez@coolcode.digital,606978,ES48209543417824685298,1248.06,2023-11-05T16:21:36,Valladolid,expenses,mortgage,-982.85,-47064.1
buyer_6,Manuel,Díez,1979-02-14,54911168W,manuel.diez@coolcode.digital,606978,ES48209543417824685298,1248.06,2023-11-06T11:08:43,Valladolid,expenses,gas,-120.55,-47184.65
buyer_6,Manuel,Díez,1979-02-14,54911168W,manuel.diez@coolcode.digital,606978,ES48209543417824685298,1248.06,2023-11-06T01:21:06,Valladolid,expenses,phone,-51.08,-47235.73
buyer_6,Manuel,Díez,1979-02-14,54911168W,manuel.diez@coolcode.digital,606978,ES48209543417824685298,1248.06,2023-11-06T14:20:08,Valladolid,expenses,transport,-56.01,-47291.74
buyer_6,Manuel,Díez,1979-02-14,54911168W,manuel.diez@coolcode.digital,606978,ES48209543417824685298,1248.06,2023-11-07T04:41:51,Valladolid,expenses,electricity,-86.64,-47378.38
buyer_6,Manuel,Díez,1979-02-14,54911168W,manuel.diez@coolcode.digital,606978,ES48209543417824685298,1248.06,2023-11-07T08:12:05,Valladolid,expenses,healthcare,-152.06,-47530.44
buyer_6,Manuel,Díez,1979-02-14,54911168W,manuel.diez@coolcode.digital,606978,ES48209543417824685298,1248.06,2023-11-07T09:03:32,Valladolid,expenses,appliances,-146.31,-47676.75
buyer_6,Manuel,Díez,1979-02-14,54911168W,manuel.diez@coolcode.digital,606978,ES48209543417824685298,1248.06,2023-11-08T22:33:35,Valladolid,expenses,water,-30.77,-47707.52
buyer_6,Manuel,Díez,1979-02-14,54911168W,manuel.diez@coolcode.digital,606978,ES48209543417824685298,1248.06,2023-11-09T16:56:22,Valladolid,expenses,food,-118.27,-47825.79
buyer_6,Manuel,Díez,1979-02-14,54911168W,manuel.diez@coolcode.digital,606978,ES48209543417824685298,1248.06,2023-11-11T13:30:29,Valladolid,expenses,leisure,-76.09,-47901.88
buyer_6,Manuel,Díez,1979-02-14,54911168W,manuel.diez@coolcode.digital,606978,ES48209543417824685298,1248.06,2023-11-11T21:59:56,Valladolid,expenses,cash,-100.0,-48001.88
buyer_6,Manuel,Díez,1979-02-14,54911168W,manuel.diez@coolcode.digital,606978,ES48209543417824685298,1248.06,2023-11-12T19:15:12,Valladolid,expenses,food,-110.6,-48112.48
buyer_6,Manuel,Díez,1979-02-14,54911168W,manuel.diez@coolcode.digital,606978,ES48209543417824685298,1248.06,2023-11-12T16:17:47,Valladolid,expenses,cash,-100.0,-48212.48
buyer_6,Manuel,Díez,1979-02-14,54911168W,manuel.diez@coolcode.digital,606978,ES48209543417824685298,1248.06,2023-11-14T11:54:48,Valladolid,expenses,transport,-84.05,-48296.53
buyer_6,Manuel,Díez,1979-02-14,54911168W,manuel.diez@coolcode.digital,606978,ES48209543417824685298,1248.06,2023-11-16T10:41:15,Valladolid,expenses,food,-83.63,-48380.16
buyer_6,Manuel,Díez,1979-02-14,54911168W,manuel.diez@coolcode.digital,606978,ES48209543417824685298,1248.06,2023-11-17T11:28:58,Valladolid,expenses,leisure,-60.02,-48440.18
buyer_6,Manuel,Díez,1979-02-14,54911168W,manuel.diez@coolcode.digital,606978,ES48209543417824685298,1248.06,2023-11-20T15:49:02,Valladolid,expenses,appliances,-418.53,-48858.71
buyer_6,Manuel,Díez,1979-02-14,54911168W,manuel.diez@coolcode.digital,606978,ES48209543417824685298,1248.06,2023-11-21T13:13:51,Valladolid,expenses,food,-109.8,-48968.51
buyer_6,Manuel,Díez,1979-02-14,54911168W,manuel.diez@coolcode.digital,606978,ES48209543417824685298,1248.06,2023-11-22T16:42:20,Valladolid,expenses,food,-64.31,-49032.82
buyer_6,Manuel,Díez,1979-02-14,54911168W,manuel.diez@coolcode.digital,606978,ES48209543417824685298,1248.06,2023-11-23T22:06:45,Valladolid,expenses,cash,-100.0,-49132.82
buyer_6,Manuel,Díez,1979-02-14,54911168W,manuel.diez@coolcode.digital,606978,ES48209543417824685298,1248.06,2023-11-24T16:17:47,Valladolid,expenses,leisure,-82.7,-49215.52
buyer_6,Manuel,Díez,1979-02-14,54911168W,manuel.diez@coolcode.digital,606978,ES48209543417824685298,1248.06,2023-11-24T13:41:18,Valladolid,expenses,travel,-716.44,-49931.96
buyer_6,Manuel,Díez,1979-02-14,54911168W,manuel.diez@coolcode.digital,606978,ES48209543417824685298,1248.06,2023-11-25T18:09:02,Valladolid,expenses,food,-84.64,-50016.6
buyer_6,Manuel,Díez,1979-02-14,54911168W,manuel.diez@coolcode.digital,606978,ES48209543417824685298,1248.06,2023-11-26T16:08:34,Valladolid,expenses,food,-60.09,-50076.69
buyer_6,Manuel,Díez,1979-02-14,54911168W,manuel.diez@coolcode.digital,606978,ES48209543417824685298,1248.06,2023-11-26T14:16:30,Valladolid,expenses,cash,-100.0,-50176.69
buyer_6,Manuel,Díez,1979-02-14,54911168W,manuel.diez@coolcode.digital,606978,ES48209543417824685298,1248.06,2023-11-29T16:17:37,Valladolid,expenses,leisure,-41.73,-50218.42
buyer_6,Manuel,Díez,1979-02-14,54911168W,manuel.diez@coolcode.digital,606978,ES48209543417824685298,1248.06,2023-11-30T14:36:42,Valladolid,expenses,transport,-67.94,-50286.36
buyer_6,Manuel,Díez,1979-02-14,54911168W,manuel.diez@coolcode.digital,606978,ES48209543417824685298,1248.06,2023-11-30T18:56:47,Valladolid,expenses,leisure,-20.88,-50307.24
buyer_6,Manuel,Díez,1979-02-14,54911168W,manuel.diez@coolcode.digital,606978,ES48209543417824685298,1248.06,2023-12-01T10:23:33,Valladolid,incomes,salary,2598.89,-47708.35
buyer_6,Manuel,Díez,1979-02-14,54911168W,manuel.diez@coolcode.digital,606978,ES48209543417824685298,1248.06,2023-12-01T10:23:33,Valladolid,incomes,salary_bonus,1885.62,-45822.73
buyer_6,Manuel,Díez,1979-02-14,54911168W,manuel.diez@coolcode.digital,606978,ES48209543417824685298,1248.06,2023-12-01T19:47:46,Valladolid,expenses,clothing,-83.4,-45906.13
buyer_6,Manuel,Díez,1979-02-14,54911168W,manuel.diez@coolcode.digital,606978,ES48209543417824685298,1248.06,2023-12-02T10:25:13,Valladolid,expenses,transport,-62.36,-45968.49
buyer_6,Manuel,Díez,1979-02-14,54911168W,manuel.diez@coolcode.digital,606978,ES48209543417824685298,1248.06,2023-12-02T15:44:23,Valladolid,expenses,cash,-100.0,-46068.49
buyer_6,Manuel,Díez,1979-02-14,54911168W,manuel.diez@coolcode.digital,606978,ES48209543417824685298,1248.06,2023-12-02T16:24:22,Valladolid,expenses,repairs,-81.61,-46150.1
buyer_6,Manuel,Díez,1979-02-14,54911168W,manuel.diez@coolcode.digital,606978,ES48209543417824685298,1248.06,2023-12-03T09:07:52,Valladolid,expenses,cash,-100.0,-46250.1
buyer_6,Manuel,Díez,1979-02-14,54911168W,manuel.diez@coolcode.digital,606978,ES48209543417824685298,1248.06,2023-12-03T17:17:32,Valladolid,expenses,gifts,-777.15,-47027.25
buyer_6,Manuel,Díez,1979-02-14,54911168W,manuel.diez@coolcode.digital,606978,ES48209543417824685298,1248.06,2023-12-04T08:49:56,Valladolid,expenses,food,-84.13,-47111.38
buyer_6,Manuel,Díez,1979-02-14,54911168W,manuel.diez@coolcode.digital,606978,ES48209543417824685298,1248.06,2023-12-05T13:34:35,Valladolid,expenses,mortgage,-982.85,-48094.23
buyer_6,Manuel,Díez,1979-02-14,54911168W,manuel.diez@coolcode.digital,606978,ES48209543417824685298,1248.06,2023-12-05T15:16:24,Valladolid,expenses,water,-38.92,-48133.15
buyer_6,Manuel,Díez,1979-02-14,54911168W,manuel.diez@coolcode.digital,606978,ES48209543417824685298,1248.06,2023-12-05T20:34:44,Valladolid,expenses,education,-70.04,-48203.19
buyer_6,Manuel,Díez,1979-02-14,54911168W,manuel.diez@coolcode.digital,606978,ES48209543417824685298,1248.06,2023-12-05T14:00:50,Valladolid,expenses,appliances,-126.84,-48330.03
buyer_6,Manuel,Díez,1979-02-14,54911168W,manuel.diez@coolcode.digital,606978,ES48209543417824685298,1248.06,2023-12-06T11:18:09,Valladolid,expenses,electricity,-36.29,-48366.32
buyer_6,Manuel,Díez,1979-02-14,54911168W,manuel.diez@coolcode.digital,606978,ES48209543417824685298,1248.06,2023-12-06T23:30:51,Valladolid,expenses,phone,-53.79,-48420.11
buyer_6,Manuel,Díez,1979-02-14,54911168W,manuel.diez@coolcode.digital,606978,ES48209543417824685298,1248.06,2023-12-07T12:36:16,Valladolid,expenses,water,-47.34,-48467.45
buyer_6,Manuel,Díez,1979-02-14,54911168W,manuel.diez@coolcode.digital,606978,ES48209543417824685298,1248.06,2023-12-08T10:42:50,Valladolid,expenses,water,-46.38,-48513.83
buyer_6,Manuel,Díez,1979-02-14,54911168W,manuel.diez@coolcode.digital,606978,ES48209543417824685298,1248.06,2023-12-08T12:00:34,Valladolid,expenses,internet,-54.58,-48568.41
buyer_6,Manuel,Díez,1979-02-14,54911168W,manuel.diez@coolcode.digital,606978,ES48209543417824685298,1248.06,2023-12-08T19:01:29,Valladolid,expenses,phone,-51.64,-48620.05
buyer_6,Manuel,Díez,1979-02-14,54911168W,manuel.diez@coolcode.digital,606978,ES48209543417824685298,1248.06,2023-12-12T11:37:20,Valladolid,expenses,transport,-74.88,-48694.93
buyer_6,Manuel,Díez,1979-02-14,54911168W,manuel.diez@coolcode.digital,606978,ES48209543417824685298,1248.06,2023-12-15T06:42:09,Valladolid,expenses,leisure,-73.21,-48768.14
buyer_6,Manuel,Díez,1979-02-14,54911168W,manuel.diez@coolcode.digital,606978,ES48209543417824685298,1248.06,2023-12-21T13:17:13,Valladolid,expenses,food,-119.44,-48887.58
buyer_6,Manuel,Díez,1979-02-14,54911168W,manuel.diez@coolcode.digital,606978,ES48209543417824685298,1248.06,2023-12-21T10:46:56,Valladolid,expenses,cash,-100.0,-48987.58
buyer_6,Manuel,Díez,1979-02-14,54911168W,manuel.diez@coolcode.digital,606978,ES48209543417824685298,1248.06,2023-12-22T09:55:15,Valladolid,expenses,repairs,-201.88,-49189.46
buyer_6,Manuel,Díez,1979-02-14,54911168W,manuel.diez@coolcode.digital,606978,ES48209543417824685298,1248.06,2023-12-24T20:28:24,Valladolid,expenses,gifts,-192.1,-49381.56
buyer_6,Manuel,Díez,1979-02-14,54911168W,manuel.diez@coolcode.digital,606978,ES48209543417824685298,1248.06,2023-12-25T15:38:41,Valladolid,expenses,repairs,-329.48,-49711.04
buyer_6,Manuel,Díez,1979-02-14,54911168W,manuel.diez@coolcode.digital,606978,ES48209543417824685298,1248.06,2023-12-26T19:07:42,Valladolid,expenses,travel,-863.87,-50574.91
buyer_6,Manuel,Díez,1979-02-14,54911168W,manuel.diez@coolcode.digital,606978,ES48209543417824685298,1248.06,2023-12-28T16:39:31,Valladolid,expenses,transport,-81.49,-50656.4
buyer_6,Manuel,Díez,1979-02-14,54911168W,manuel.diez@coolcode.digital,606978,ES48209543417824685298,1248.06,2023-12-30T11:54:34,Valladolid,expenses,leisure,-23.89,-50680.29
buyer_6,Manuel,Díez,1979-02-14,54911168W,manuel.diez@coolcode.digital,606978,ES48209543417824685298,1248.06,2023-12-31T15:05:58,Valladolid,expenses,leisure,-75.27,-50755.56
buyer_6,Manuel,Díez,1979-02-14,54911168W,manuel.diez@coolcode.digital,606978,ES48209543417824685298,1248.06,2023-12-31T14:31:52,Valladolid,expenses,clothing,-140.33,-50895.89
buyer_6,Manuel,Díez,1979-02-14,54911168W,manuel.diez@coolcode.digital,606978,ES48209543417824685298,1248.06,2024-01-01T18:01:00,Valladolid,incomes,salary,2689.51,-48206.38
buyer_6,Manuel,Díez,1979-02-14,54911168W,manuel.diez@coolcode.digital,606978,ES48209543417824685298,1248.06,2024-01-01T20:24:14,Valladolid,expenses,cash,-100.0,-48306.38
buyer_6,Manuel,Díez,1979-02-14,54911168W,manuel.diez@coolcode.digital,606978,ES48209543417824685298,1248.06,2024-01-02T19:14:41,Valladolid,expenses,food,-111.41,-48417.79
buyer_6,Manuel,Díez,1979-02-14,54911168W,manuel.diez@coolcode.digital,606978,ES48209543417824685298,1248.06,2024-01-04T23:19:53,Valladolid,expenses,cash,-100.0,-48517.79
buyer_6,Manuel,Díez,1979-02-14,54911168W,manuel.diez@coolcode.digital,606978,ES48209543417824685298,1248.06,2024-01-05T16:58:52,Valladolid,expenses,mortgage,-1455.09,-49972.88
buyer_6,Manuel,Díez,1979-02-14,54911168W,manuel.diez@coolcode.digital,606978,ES48209543417824685298,1248.06,2024-01-05T13:13:49,Valladolid,expenses,gas,-82.21,-50055.09
buyer_6,Manuel,Díez,1979-02-14,54911168W,manuel.diez@coolcode.digital,606978,ES48209543417824685298,1248.06,2024-01-06T02:05:17,Valladolid,expenses,internet,-56.48,-50111.57
buyer_6,Manuel,Díez,1979-02-14,54911168W,manuel.diez@coolcode.digital,606978,ES48209543417824685298,1248.06,2024-01-06T08:15:11,Valladolid,expenses,food,-62.17,-50173.74
buyer_6,Manuel,Díez,1979-02-14,54911168W,manuel.diez@coolcode.digital,606978,ES48209543417824685298,1248.06,2024-01-07T17:47:16,Valladolid,expenses,gas,-51.8,-50225.54
buyer_6,Manuel,Díez,1979-02-14,54911168W,manuel.diez@coolcode.digital,606978,ES48209543417824685298,1248.06,2024-01-07T13:36:58,Valladolid,expenses,internet,-56.48,-50282.02
buyer_6,Manuel,Díez,1979-02-14,54911168W,manuel.diez@coolcode.digital,606978,ES48209543417824685298,1248.06,2024-01-07T10:26:06,Valladolid,expenses,phone,-58.72,-50340.74
buyer_6,Manuel,Díez,1979-02-14,54911168W,manuel.diez@coolcode.digital,606978,ES48209543417824685298,1248.06,2024-01-07T09:25:34,Valladolid,expenses,leisure,-65.22,-50405.96
buyer_6,Manuel,Díez,1979-02-14,54911168W,manuel.diez@coolcode.digital,606978,ES48209543417824685298,1248.06,2024-01-08T11:55:45,Valladolid,expenses,gas,-128.51,-50534.47
buyer_6,Manuel,Díez,1979-02-14,54911168W,manuel.diez@coolcode.digital,606978,ES48209543417824685298,1248.06,2024-01-08T11:47:24,Valladolid,expenses,phone,-48.02,-50582.49
buyer_6,Manuel,Díez,1979-02-14,54911168W,manuel.diez@coolcode.digital,606978,ES48209543417824685298,1248.06,2024-01-08T13:59:54,Valladolid,expenses,leisure,-19.33,-50601.82
buyer_6,Manuel,Díez,1979-02-14,54911168W,manuel.diez@coolcode.digital,606978,ES48209543417824685298,1248.06,2024-01-11T19:05:36,Valladolid,expenses,appliances,-81.76,-50683.58
buyer_6,Manuel,Díez,1979-02-14,54911168W,manuel.diez@coolcode.digital,606978,ES48209543417824685298,1248.06,2024-01-14T03:10:52,Valladolid,expenses,cash,-100.0,-50783.58
buyer_6,Manuel,Díez,1979-02-14,54911168W,manuel.diez@coolcode.digital,606978,ES48209543417824685298,1248.06,2024-01-16T22:49:38,Valladolid,expenses,food,-112.44,-50896.02
buyer_6,Manuel,Díez,1979-02-14,54911168W,manuel.diez@coolcode.digital,606978,ES48209543417824685298,1248.06,2024-01-19T20:30:27,Valladolid,expenses,clothing,-71.07,-50967.09
buyer_6,Manuel,Díez,1979-02-14,54911168W,manuel.diez@coolcode.digital,606978,ES48209543417824685298,1248.06,2024-01-19T20:58:50,Valladolid,expenses,cash,-100.0,-51067.09
buyer_6,Manuel,Díez,1979-02-14,54911168W,manuel.diez@coolcode.digital,606978,ES48209543417824685298,1248.06,2024-01-25T14:38:22,Valladolid,expenses,transport,-65.69,-51132.78
buyer_6,Manuel,Díez,1979-02-14,54911168W,manuel.diez@coolcode.digital,606978,ES48209543417824685298,1248.06,2024-01-26T11:18:00,Valladolid,expenses,cash,-100.0,-51232.78
buyer_6,Manuel,Díez,1979-02-14,54911168W,manuel.diez@coolcode.digital,606978,ES48209543417824685298,1248.06,2024-01-27T12:41:31,Valladolid,expenses,repairs,-110.12,-51342.9
buyer_6,Manuel,Díez,1979-02-14,54911168W,manuel.diez@coolcode.digital,606978,ES48209543417824685298,1248.06,2024-01-28T11:46:00,Valladolid,expenses,food,-115.56,-51458.46
buyer_6,Manuel,Díez,1979-02-14,54911168W,manuel.diez@coolcode.digital,606978,ES48209543417824685298,1248.06,2024-01-28T18:47:11,Valladolid,expenses,cash,-100.0,-51558.46
buyer_6,Manuel,Díez,1979-02-14,54911168W,manuel.diez@coolcode.digital,606978,ES48209543417824685298,1248.06,2024-01-29T17:38:12,Valladolid,expenses,leisure,-28.58,-51587.04
buyer_6,Manuel,Díez,1979-02-14,54911168W,manuel.diez@coolcode.digital,606978,ES48209543417824685298,1248.06,2024-02-01T10:33:44,Valladolid,incomes,salary,2689.51,-48897.53
buyer_6,Manuel,Díez,1979-02-14,54911168W,manuel.diez@coolcode.digital,606978,ES48209543417824685298,1248.06,2024-02-01T10:33:44,Valladolid,incomes,extra_income,387.19,-48510.34
buyer_6,Manuel,Díez,1979-02-14,54911168W,manuel.diez@coolcode.digital,606978,ES48209543417824685298,1248.06,2024-02-02T13:23:18,Valladolid,expenses,leisure,-64.82,-48575.16
buyer_6,Manuel,Díez,1979-02-14,54911168W,manuel.diez@coolcode.digital,606978,ES48209543417824685298,1248.06,2024-02-02T20:50:30,Valladolid,expenses,gifts,-461.71,-49036.87
buyer_6,Manuel,Díez,1979-02-14,54911168W,manuel.diez@coolcode.digital,606978,ES48209543417824685298,1248.06,2024-02-05T20:46:51,Valladolid,expenses,mortgage,-1455.09,-50491.96
buyer_6,Manuel,Díez,1979-02-14,54911168W,manuel.diez@coolcode.digital,606978,ES48209543417824685298,1248.06,2024-02-05T12:07:29,Valladolid,expenses,phone,-44.44,-50536.4
buyer_6,Manuel,Díez,1979-02-14,54911168W,manuel.diez@coolcode.digital,606978,ES48209543417824685298,1248.06,2024-02-05T15:56:34,Valladolid,expenses,gifts,-418.78,-50955.18
buyer_6,Manuel,Díez,1979-02-14,54911168W,manuel.diez@coolcode.digital,606978,ES48209543417824685298,1248.06,2024-02-07T09:22:48,Valladolid,expenses,gas,-88.07,-51043.25
buyer_6,Manuel,Díez,1979-02-14,54911168W,manuel.diez@coolcode.digital,606978,ES48209543417824685298,1248.06,2024-02-07T10:12:15,Valladolid,expenses,internet,-56.48,-51099.73
buyer_6,Manuel,Díez,1979-02-14,54911168W,manuel.diez@coolcode.digital,606978,ES48209543417824685298,1248.06,2024-02-07T10:22:20,Valladolid,expenses,appliances,-189.73,-51289.46
buyer_6,Manuel,Díez,1979-02-14,54911168W,manuel.diez@coolcode.digital,606978,ES48209543417824685298,1248.06,2024-02-08T14:29:38,Valladolid,expenses,water,-51.39,-51340.85
buyer_6,Manuel,Díez,1979-02-14,54911168W,manuel.diez@coolcode.digital,606978,ES48209543417824685298,1248.06,2024-02-08T16:10:49,Valladolid,expenses,electricity,-100.73,-51441.58
buyer_6,Manuel,Díez,1979-02-14,54911168W,manuel.diez@coolcode.digital,606978,ES48209543417824685298,1248.06,2024-02-08T12:30:06,Valladolid,expenses,food,-123.84,-51565.42
buyer_6,Manuel,Díez,1979-02-14,54911168W,manuel.diez@coolcode.digital,606978,ES48209543417824685298,1248.06,2024-02-08T17:10:14,Valladolid,expenses,leisure,-25.99,-51591.41
buyer_6,Manuel,Díez,1979-02-14,54911168W,manuel.diez@coolcode.digital,606978,ES48209543417824685298,1248.06,2024-02-09T21:59:32,Valladolid,expenses,cash,-100.0,-51691.41
buyer_6,Manuel,Díez,1979-02-14,54911168W,manuel.diez@coolcode.digital,606978,ES48209543417824685298,1248.06,2024-02-10T15:50:28,Valladolid,expenses,cash,-100.0,-51791.41
buyer_6,Manuel,Díez,1979-02-14,54911168W,manuel.diez@coolcode.digital,606978,ES48209543417824685298,1248.06,2024-02-11T13:12:07,Valladolid,expenses,cash,-100.0,-51891.41
buyer_6,Manuel,Díez,1979-02-14,54911168W,manuel.diez@coolcode.digital,606978,ES48209543417824685298,1248.06,2024-02-12T06:58:26,Valladolid,expenses,food,-61.73,-51953.14
buyer_6,Manuel,Díez,1979-02-14,54911168W,manuel.diez@coolcode.digital,606978,ES48209543417824685298,1248.06,2024-02-13T11:32:17,Valladolid,expenses,education,-49.12,-52002.26
buyer_6,Manuel,Díez,1979-02-14,54911168W,manuel.diez@coolcode.digital,606978,ES48209543417824685298,1248.06,2024-02-15T16:46:46,Valladolid,expenses,leisure,-71.57,-52073.83
buyer_6,Manuel,Díez,1979-02-14,54911168W,manuel.diez@coolcode.digital,606978,ES48209543417824685298,1248.06,2024-02-16T17:16:56,Valladolid,expenses,food,-108.86,-52182.69
buyer_6,Manuel,Díez,1979-02-14,54911168W,manuel.diez@coolcode.digital,606978,ES48209543417824685298,1248.06,2024-02-17T09:53:07,Valladolid,expenses,transport,-56.29,-52238.98
buyer_6,Manuel,Díez,1979-02-14,54911168W,manuel.diez@coolcode.digital,606978,ES48209543417824685298,1248.06,2024-02-18T09:53:25,Valladolid,expenses,transport,-85.8,-52324.78
buyer_6,Manuel,Díez,1979-02-14,54911168W,manuel.diez@coolcode.digital,606978,ES48209543417824685298,1248.06,2024-02-20T12:54:09,Valladolid,expenses,cash,-100.0,-52424.78
buyer_6,Manuel,Díez,1979-02-14,54911168W,manuel.diez@coolcode.digital,606978,ES48209543417824685298,1248.06,2024-02-21T12:55:16,Valladolid,expenses,repairs,-288.42,-52713.2
buyer_6,Manuel,Díez,1979-02-14,54911168W,manuel.diez@coolcode.digital,606978,ES48209543417824685298,1248.06,2024-02-21T12:40:35,Valladolid,expenses,gifts,-351.82,-53065.02
buyer_6,Manuel,Díez,1979-02-14,54911168W,manuel.diez@coolcode.digital,606978,ES48209543417824685298,1248.06,2024-02-23T09:22:24,Valladolid,expenses,food,-60.61,-53125.63
buyer_6,Manuel,Díez,1979-02-14,54911168W,manuel.diez@coolcode.digital,606978,ES48209543417824685298,1248.06,2024-02-23T12:58:21,Valladolid,expenses,healthcare,-142.4,-53268.03
buyer_6,Manuel,Díez,1979-02-14,54911168W,manuel.diez@coolcode.digital,606978,ES48209543417824685298,1248.06,2024-02-24T11:12:33,Valladolid,expenses,food,-98.75,-53366.78
buyer_6,Manuel,Díez,1979-02-14,54911168W,manuel.diez@coolcode.digital,606978,ES48209543417824685298,1248.06,2024-02-26T16:42:15,Valladolid,expenses,gifts,-339.73,-53706.51
buyer_6,Manuel,Díez,1979-02-14,54911168W,manuel.diez@coolcode.digital,606978,ES48209543417824685298,1248.06,2024-02-27T02:34:08,Valladolid,expenses,leisure,-58.53,-53765.04
buyer_6,Manuel,Díez,1979-02-14,54911168W,manuel.diez@coolcode.digital,606978,ES48209543417824685298,1248.06,2024-02-27T16:55:09,Valladolid,expenses,cash,-100.0,-53865.04
buyer_6,Manuel,Díez,1979-02-14,54911168W,manuel.diez@coolcode.digital,606978,ES48209543417824685298,1248.06,2024-02-28T19:18:34,Valladolid,expenses,cash,-100.0,-53965.04
buyer_6,Manuel,Díez,1979-02-14,54911168W,manuel.diez@coolcode.digital,606978,ES48209543417824685298,1248.06,2024-03-01T10:33:50,Valladolid,incomes,salary,2689.51,-51275.53
buyer_6,Manuel,Díez,1979-02-14,54911168W,manuel.diez@coolcode.digital,606978,ES48209543417824685298,1248.06,2024-03-03T14:08:56,Valladolid,expenses,food,-77.5,-51353.03
buyer_6,Manuel,Díez,1979-02-14,54911168W,manuel.diez@coolcode.digital,606978,ES48209543417824685298,1248.06,2024-03-04T14:23:59,Valladolid,expenses,transport,-40.76,-51393.79
buyer_6,Manuel,Díez,1979-02-14,54911168W,manuel.diez@coolcode.digital,606978,ES48209543417824685298,1248.06,2024-03-04T17:58:15,Valladolid,expenses,leisure,-68.14,-51461.93
buyer_6,Manuel,Díez,1979-02-14,54911168W,manuel.diez@coolcode.digital,606978,ES48209543417824685298,1248.06,2024-03-04T15:46:07,Valladolid,expenses,repairs,-46.78,-51508.71
buyer_6,Manuel,Díez,1979-02-14,54911168W,manuel.diez@coolcode.digital,606978,ES48209543417824685298,1248.06,2024-03-05T18:13:57,Valladolid,expenses,mortgage,-1455.09,-52963.8
buyer_6,Manuel,Díez,1979-02-14,54911168W,manuel.diez@coolcode.digital,606978,ES48209543417824685298,1248.06,2024-03-05T16:16:47,Valladolid,expenses,clothing,-94.36,-53058.16
buyer_6,Manuel,Díez,1979-02-14,54911168W,manuel.diez@coolcode.digital,606978,ES48209543417824685298,1248.06,2024-03-06T17:18:48,Valladolid,expenses,electricity,-43.62,-53101.78
buyer_6,Manuel,Díez,1979-02-14,54911168W,manuel.diez@coolcode.digital,606978,ES48209543417824685298,1248.06,2024-03-06T15:03:10,Valladolid,expenses,food,-99.16,-53200.94
buyer_6,Manuel,Díez,1979-02-14,54911168W,manuel.diez@coolcode.digital,606978,ES48209543417824685298,1248.06,2024-03-06T13:23:19,Valladolid,expenses,gifts,-112.94,-53313.88
buyer_6,Manuel,Díez,1979-02-14,54911168W,manuel.diez@coolcode.digital,606978,ES48209543417824685298,1248.06,2024-03-07T16:33:28,Valladolid,expenses,water,-53.65,-53367.53
buyer_6,Manuel,Díez,1979-02-14,54911168W,manuel.diez@coolcode.digital,606978,ES48209543417824685298,1248.06,2024-03-07T09:36:10,Valladolid,expenses,transport,-81.68,-53449.21
buyer_6,Manuel,Díez,1979-02-14,54911168W,manuel.diez@coolcode.digital,606978,ES48209543417824685298,1248.06,2024-03-08T14:53:02,Valladolid,expenses,leisure,-28.8,-53478.01
buyer_6,Manuel,Díez,1979-02-14,54911168W,manuel.diez@coolcode.digital,606978,ES48209543417824685298,1248.06,2024-03-09T11:51:49,Valladolid,expenses,leisure,-24.73,-53502.74
buyer_6,Manuel,Díez,1979-02-14,54911168W,manuel.diez@coolcode.digital,606978,ES48209543417824685298,1248.06,2024-03-10T01:02:42,Valladolid,expenses,transport,-68.91,-53571.65
buyer_6,Manuel,Díez,1979-02-14,54911168W,manuel.diez@coolcode.digital,606978,ES48209543417824685298,1248.06,2024-03-10T12:50:44,Valladolid,expenses,cash,-100.0,-53671.65
buyer_6,Manuel,Díez,1979-02-14,54911168W,manuel.diez@coolcode.digital,606978,ES48209543417824685298,1248.06,2024-03-12T13:58:06,Valladolid,expenses,leisure,-22.19,-53693.84
buyer_6,Manuel,Díez,1979-02-14,54911168W,manuel.diez@coolcode.digital,606978,ES48209543417824685298,1248.06,2024-03-12T18:01:07,Valladolid,expenses,education,-45.55,-53739.39
buyer_6,Manuel,Díez,1979-02-14,54911168W,manuel.diez@coolcode.digital,606978,ES48209543417824685298,1248.06,2024-03-13T08:13:04,Valladolid,expenses,cash,-100.0,-53839.39
buyer_6,Manuel,Díez,1979-02-14,54911168W,manuel.diez@coolcode.digital,606978,ES48209543417824685298,1248.06,2024-03-13T12:01:21,Valladolid,expenses,travel,-689.3,-54528.69
buyer_6,Manuel,Díez,1979-02-14,54911168W,manuel.diez@coolcode.digital,606978,ES48209543417824685298,1248.06,2024-03-13T17:31:49,Valladolid,expenses,appliances,-92.45,-54621.14
buyer_6,Manuel,Díez,1979-02-14,54911168W,manuel.diez@coolcode.digital,606978,ES48209543417824685298,1248.06,2024-03-14T14:50:40,Valladolid,expenses,clothing,-65.26,-54686.4
buyer_6,Manuel,Díez,1979-02-14,54911168W,manuel.diez@coolcode.digital,606978,ES48209543417824685298,1248.06,2024-03-15T08:33:29,Valladolid,expenses,transport,-77.04,-54763.44
buyer_6,Manuel,Díez,1979-02-14,54911168W,manuel.diez@coolcode.digital,606978,ES48209543417824685298,1248.06,2024-03-15T08:46:17,Valladolid,expenses,cash,-100.0,-54863.44
buyer_6,Manuel,Díez,1979-02-14,54911168W,manuel.diez@coolcode.digital,606978,ES48209543417824685298,1248.06,2024-03-16T20:09:42,Valladolid,expenses,cash,-100.0,-54963.44
buyer_6,Manuel,Díez,1979-02-14,54911168W,manuel.diez@coolcode.digital,606978,ES48209543417824685298,1248.06,2024-03-17T17:17:28,Valladolid,expenses,clothing,-120.8,-55084.24
buyer_6,Manuel,Díez,1979-02-14,54911168W,manuel.diez@coolcode.digital,606978,ES48209543417824685298,1248.06,2024-03-17T18:35:49,Valladolid,expenses,cash,-100.0,-55184.24
buyer_6,Manuel,Díez,1979-02-14,54911168W,manuel.diez@coolcode.digital,606978,ES48209543417824685298,1248.06,2024-03-18T23:07:10,Valladolid,expenses,food,-84.63,-55268.87
buyer_6,Manuel,Díez,1979-02-14,54911168W,manuel.diez@coolcode.digital,606978,ES48209543417824685298,1248.06,2024-03-23T00:27:51,Valladolid,expenses,leisure,-70.87,-55339.74
buyer_6,Manuel,Díez,1979-02-14,54911168W,manuel.diez@coolcode.digital,606978,ES48209543417824685298,1248.06,2024-03-26T15:38:38,Valladolid,expenses,healthcare,-123.13,-55462.87
buyer_6,Manuel,Díez,1979-02-14,54911168W,manuel.diez@coolcode.digital,606978,ES48209543417824685298,1248.06,2024-03-26T19:07:23,Valladolid,expenses,cash,-100.0,-55562.87
buyer_6,Manuel,Díez,1979-02-14,54911168W,manuel.diez@coolcode.digital,606978,ES48209543417824685298,1248.06,2024-03-30T18:38:45,Valladolid,expenses,transport,-85.45,-55648.32
buyer_6,Manuel,Díez,1979-02-14,54911168W,manuel.diez@coolcode.digital,606978,ES48209543417824685298,1248.06,2024-03-31T20:52:23,Valladolid,expenses,transport,-79.89,-55728.21
buyer_6,Manuel,Díez,1979-02-14,54911168W,manuel.diez@coolcode.digital,606978,ES48209543417824685298,1248.06,2024-04-01T11:52:37,Valladolid,incomes,salary,2689.51,-53038.7
buyer_6,Manuel,Díez,1979-02-14,54911168W,manuel.diez@coolcode.digital,606978,ES48209543417824685298,1248.06,2024-04-01T12:33:15,Valladolid,expenses,leisure,-64.77,-53103.47
buyer_6,Manuel,Díez,1979-02-14,54911168W,manuel.diez@coolcode.digital,606978,ES48209543417824685298,1248.06,2024-04-02T23:05:28,Valladolid,expenses,food,-120.02,-53223.49
buyer_6,Manuel,Díez,1979-02-14,54911168W,manuel.diez@coolcode.digital,606978,ES48209543417824685298,1248.06,2024-04-04T12:48:26,Valladolid,expenses,food,-109.5,-53332.99
buyer_6,Manuel,Díez,1979-02-14,54911168W,manuel.diez@coolcode.digital,606978,ES48209543417824685298,1248.06,2024-04-04T05:42:03,Valladolid,expenses,transport,-59.32,-53392.31
buyer_6,Manuel,Díez,1979-02-14,54911168W,manuel.diez@coolcode.digital,606978,ES48209543417824685298,1248.06,2024-04-05T10:38:52,Valladolid,expenses,mortgage,-1455.09,-54847.4
buyer_6,Manuel,Díez,1979-02-14,54911168W,manuel.diez@coolcode.digital,606978,ES48209543417824685298,1248.06,2024-04-05T10:20:40,Valladolid,expenses,travel,-835.95,-55683.35
buyer_6,Manuel,Díez,1979-02-14,54911168W,manuel.diez@coolcode.digital,606978,ES48209543417824685298,1248.06,2024-04-06T21:03:51,Valladolid,expenses,food,-113.38,-55796.73
buyer_6,Manuel,Díez,1979-02-14,54911168W,manuel.diez@coolcode.digital,606978,ES48209543417824685298,1248.06,2024-04-07T13:13:29,Valladolid,expenses,internet,-56.48,-55853.21
buyer_6,Manuel,Díez,1979-02-14,54911168W,manuel.diez@coolcode.digital,606978,ES48209543417824685298,1248.06,2024-04-07T14:19:46,Valladolid,expenses,phone,-55.29,-55908.5
buyer_6,Manuel,Díez,1979-02-14,54911168W,manuel.diez@coolcode.digital,606978,ES48209543417824685298,1248.06,2024-04-08T10:04:16,Valladolid,expenses,transport,-89.79,-55998.29
buyer_6,Manuel,Díez,1979-02-14,54911168W,manuel.diez@coolcode.digital,606978,ES48209543417824685298,1248.06,2024-04-09T21:18:51,Valladolid,expenses,food,-63.23,-56061.52
buyer_6,Manuel,Díez,1979-02-14,54911168W,manuel.diez@coolcode.digital,606978,ES48209543417824685298,1248.06,2024-04-09T09:28:16,Valladolid,expenses,healthcare,-121.33,-56182.85
buyer_6,Manuel,Díez,1979-02-14,54911168W,manuel.diez@coolcode.digital,606978,ES48209543417824685298,1248.06,2024-04-09T12:22:31,Valladolid,expenses,repairs,-189.3,-56372.15
buyer_6,Manuel,Díez,1979-02-14,54911168W,manuel.diez@coolcode.digital,606978,ES48209543417824685298,1248.06,2024-04-12T14:31:14,Valladolid,expenses,cash,-100.0,-56472.15
buyer_6,Manuel,Díez,1979-02-14,54911168W,manuel.diez@coolcode.digital,606978,ES48209543417824685298,1248.06,2024-04-14T20:07:40,Valladolid,expenses,appliances,-378.17,-56850.32
buyer_6,Manuel,Díez,1979-02-14,54911168W,manuel.diez@coolcode.digital,606978,ES48209543417824685298,1248.06,2024-04-15T17:19:37,Valladolid,expenses,food,-104.29,-56954.61
buyer_6,Manuel,Díez,1979-02-14,54911168W,manuel.diez@coolcode.digital,606978,ES48209543417824685298,1248.06,2024-04-15T16:05:16,Valladolid,expenses,gifts,-210.76,-57165.37
buyer_6,Manuel,Díez,1979-02-14,54911168W,manuel.diez@coolcode.digital,606978,ES48209543417824685298,1248.06,2024-04-16T06:04:16,Valladolid,expenses,appliances,-418.04,-57583.41
buyer_6,Manuel,Díez,1979-02-14,54911168W,manuel.diez@coolcode.digital,606978,ES48209543417824685298,1248.06,2024-04-17T08:37:33,Valladolid,expenses,transport,-50.91,-57634.32
buyer_6,Manuel,Díez,1979-02-14,54911168W,manuel.diez@coolcode.digital,606978,ES48209543417824685298,1248.06,2024-04-19T20:10:31,Valladolid,expenses,cash,-100.0,-57734.32
buyer_6,Manuel,Díez,1979-02-14,54911168W,manuel.diez@coolcode.digital,606978,ES48209543417824685298,1248.06,2024-04-20T19:45:23,Valladolid,expenses,education,-75.02,-57809.34
buyer_6,Manuel,Díez,1979-02-14,54911168W,manuel.diez@coolcode.digital,606978,ES48209543417824685298,1248.06,2024-04-21T15:35:36,Valladolid,expenses,transport,-65.27,-57874.61
buyer_6,Manuel,Díez,1979-02-14,54911168W,manuel.diez@coolcode.digital,606978,ES48209543417824685298,1248.06,2024-04-23T08:37:40,Valladolid,expenses,food,-88.13,-57962.74
buyer_6,Manuel,Díez,1979-02-14,54911168W,manuel.diez@coolcode.digital,606978,ES48209543417824685298,1248.06,2024-04-25T10:20:45,Valladolid,expenses,gifts,-441.9,-58404.64
buyer_6,Manuel,Díez,1979-02-14,54911168W,manuel.diez@coolcode.digital,606978,ES48209543417824685298,1248.06,2024-04-27T11:20:38,Valladolid,expenses,food,-90.98,-58495.62
buyer_6,Manuel,Díez,1979-02-14,54911168W,manuel.diez@coolcode.digital,606978,ES48209543417824685298,1248.06,2024-04-27T18:15:01,Valladolid,expenses,appliances,-384.05,-58879.67
buyer_6,Manuel,Díez,1979-02-14,54911168W,manuel.diez@coolcode.digital,606978,ES48209543417824685298,1248.06,2024-04-28T13:02:43,Valladolid,expenses,transport,-47.61,-58927.28
buyer_6,Manuel,Díez,1979-02-14,54911168W,manuel.diez@coolcode.digital,606978,ES48209543417824685298,1248.06,2024-05-01T13:30:14,Valladolid,incomes,salary,2689.51,-56237.77
buyer_6,Manuel,Díez,1979-02-14,54911168W,manuel.diez@coolcode.digital,606978,ES48209543417824685298,1248.06,2024-05-01T13:30:14,Valladolid,incomes,extra_income,387.19,-55850.58
buyer_6,Manuel,Díez,1979-02-14,54911168W,manuel.diez@coolcode.digital,606978,ES48209543417824685298,1248.06,2024-05-03T14:34:53,Valladolid,expenses,cash,-100.0,-55950.58
buyer_6,Manuel,Díez,1979-02-14,54911168W,manuel.diez@coolcode.digital,606978,ES48209543417824685298,1248.06,2024-05-04T12:35:29,Valladolid,expenses,repairs,-61.73,-56012.31
buyer_6,Manuel,Díez,1979-02-14,54911168W,manuel.diez@coolcode.digital,606978,ES48209543417824685298,1248.06,2024-05-05T12:22:17,Valladolid,expenses,mortgage,-1455.09,-57467.4
buyer_6,Manuel,Díez,1979-02-14,54911168W,manuel.diez@coolcode.digital,606978,ES48209543417824685298,1248.06,2024-05-05T21:32:58,Valladolid,expenses,water,-56.1,-57523.5
buyer_6,Manuel,Díez,1979-02-14,54911168W,manuel.diez@coolcode.digital,606978,ES48209543417824685298,1248.06,2024-05-05T16:16:36,Valladolid,expenses,internet,-56.48,-57579.98
buyer_6,Manuel,Díez,1979-02-14,54911168W,manuel.diez@coolcode.digital,606978,ES48209543417824685298,1248.06,2024-05-05T12:58:56,Valladolid,expenses,leisure,-60.18,-57640.16
buyer_6,Manuel,Díez,1979-02-14,54911168W,manuel.diez@coolcode.digital,606978,ES48209543417824685298,1248.06,2024-05-05T22:40:54,Valladolid,expenses,gifts,-305.43,-57945.59
buyer_6,Manuel,Díez,1979-02-14,54911168W,manuel.diez@coolcode.digital,606978,ES48209543417824685298,1248.06,2024-05-06T20:04:22,Valladolid,expenses,gas,-74.95,-58020.54
buyer_6,Manuel,Díez,1979-02-14,54911168W,manuel.diez@coolcode.digital,606978,ES48209543417824685298,1248.06,2024-05-06T15:49:25,Valladolid,expenses,internet,-56.48,-58077.02
buyer_6,Manuel,Díez,1979-02-14,54911168W,manuel.diez@coolcode.digital,606978,ES48209543417824685298,1248.06,2024-05-06T15:05:31,Valladolid,expenses,cash,-100.0,-58177.02
buyer_6,Manuel,Díez,1979-02-14,54911168W,manuel.diez@coolcode.digital,606978,ES48209543417824685298,1248.06,2024-05-07T10:13:07,Valladolid,expenses,gas,-49.31,-58226.33
buyer_6,Manuel,Díez,1979-02-14,54911168W,manuel.diez@coolcode.digital,606978,ES48209543417824685298,1248.06,2024-05-07T21:41:58,Valladolid,expenses,phone,-52.06,-58278.39
buyer_6,Manuel,Díez,1979-02-14,54911168W,manuel.diez@coolcode.digital,606978,ES48209543417824685298,1248.06,2024-05-07T20:54:23,Valladolid,expenses,cash,-100.0,-58378.39
buyer_6,Manuel,Díez,1979-02-14,54911168W,manuel.diez@coolcode.digital,606978,ES48209543417824685298,1248.06,2024-05-08T15:53:17,Valladolid,expenses,gas,-96.82,-58475.21
buyer_6,Manuel,Díez,1979-02-14,54911168W,manuel.diez@coolcode.digital,606978,ES48209543417824685298,1248.06,2024-05-08T08:33:47,Valladolid,expenses,phone,-51.24,-58526.45
buyer_6,Manuel,Díez,1979-02-14,54911168W,manuel.diez@coolcode.digital,606978,ES48209543417824685298,1248.06,2024-05-09T13:54:26,Valladolid,expenses,leisure,-52.12,-58578.57
buyer_6,Manuel,Díez,1979-02-14,54911168W,manuel.diez@coolcode.digital,606978,ES48209543417824685298,1248.06,2024-05-11T23:03:56,Valladolid,expenses,cash,-100.0,-58678.57
buyer_6,Manuel,Díez,1979-02-14,54911168W,manuel.diez@coolcode.digital,606978,ES48209543417824685298,1248.06,2024-05-11T08:00:25,Valladolid,expenses,gifts,-298.49,-58977.06
buyer_6,Manuel,Díez,1979-02-14,54911168W,manuel.diez@coolcode.digital,606978,ES48209543417824685298,1248.06,2024-05-13T14:45:56,Valladolid,expenses,food,-69.22,-59046.28
buyer_6,Manuel,Díez,1979-02-14,54911168W,manuel.diez@coolcode.digital,606978,ES48209543417824685298,1248.06,2024-05-13T09:47:58,Valladolid,expenses,gifts,-627.43,-59673.71
buyer_6,Manuel,Díez,1979-02-14,54911168W,manuel.diez@coolcode.digital,606978,ES48209543417824685298,1248.06,2024-05-18T16:14:54,Valladolid,expenses,leisure,-75.53,-59749.24
buyer_6,Manuel,Díez,1979-02-14,54911168W,manuel.diez@coolcode.digital,606978,ES48209543417824685298,1248.06,2024-05-18T23:19:30,Valladolid,expenses,cash,-100.0,-59849.24
buyer_6,Manuel,Díez,1979-02-14,54911168W,manuel.diez@coolcode.digital,606978,ES48209543417824685298,1248.06,2024-05-20T10:40:11,Valladolid,expenses,food,-88.89,-59938.13
buyer_6,Manuel,Díez,1979-02-14,54911168W,manuel.diez@coolcode.digital,606978,ES48209543417824685298,1248.06,2024-05-22T19:33:36,Valladolid,expenses,cash,-100.0,-60038.13
buyer_6,Manuel,Díez,1979-02-14,54911168W,manuel.diez@coolcode.digital,606978,ES48209543417824685298,1248.06,2024-05-22T09:24:30,Valladolid,expenses,repairs,-72.23,-60110.36
buyer_6,Manuel,Díez,1979-02-14,54911168W,manuel.diez@coolcode.digital,606978,ES48209543417824685298,1248.06,2024-05-23T08:30:44,Valladolid,expenses,leisure,-40.84,-60151.2
buyer_6,Manuel,Díez,1979-02-14,54911168W,manuel.diez@coolcode.digital,606978,ES48209543417824685298,1248.06,2024-05-23T16:42:21,Valladolid,expenses,education,-51.91,-60203.11
buyer_6,Manuel,Díez,1979-02-14,54911168W,manuel.diez@coolcode.digital,606978,ES48209543417824685298,1248.06,2024-05-27T16:28:59,Valladolid,expenses,food,-116.58,-60319.69
buyer_6,Manuel,Díez,1979-02-14,54911168W,manuel.diez@coolcode.digital,606978,ES48209543417824685298,1248.06,2024-06-01T13:16:39,Valladolid,incomes,salary,2689.51,-57630.18
buyer_6,Manuel,Díez,1979-02-14,54911168W,manuel.diez@coolcode.digital,606978,ES48209543417824685298,1248.06,2024-06-01T13:16:39,Valladolid,incomes,salary_bonus,2103.45,-55526.73
buyer_6,Manuel,Díez,1979-02-14,54911168W,manuel.diez@coolcode.digital,606978,ES48209543417824685298,1248.06,2024-06-01T15:02:25,Valladolid,expenses,taxes,-2069.34,-57596.07
buyer_6,Manuel,Díez,1979-02-14,54911168W,manuel.diez@coolcode.digital,606978,ES48209543417824685298,1248.06,2024-06-01T15:54:02,Valladolid,expenses,insurance,-642.59,-58238.66
buyer_6,Manuel,Díez,1979-02-14,54911168W,manuel.diez@coolcode.digital,606978,ES48209543417824685298,1248.06,2024-06-02T23:15:19,Valladolid,expenses,food,-81.22,-58319.88
buyer_6,Manuel,Díez,1979-02-14,54911168W,manuel.diez@coolcode.digital,606978,ES48209543417824685298,1248.06,2024-06-03T11:58:12,Valladolid,expenses,food,-115.35,-58435.23
buyer_6,Manuel,Díez,1979-02-14,54911168W,manuel.diez@coolcode.digital,606978,ES48209543417824685298,1248.06,2024-06-04T08:53:35,Valladolid,expenses,transport,-48.46,-58483.69
buyer_6,Manuel,Díez,1979-02-14,54911168W,manuel.diez@coolcode.digital,606978,ES48209543417824685298,1248.06,2024-06-05T13:39:10,Valladolid,expenses,mortgage,-1455.09,-59938.78
buyer_6,Manuel,Díez,1979-02-14,54911168W,manuel.diez@coolcode.digital,606978,ES48209543417824685298,1248.06,2024-06-05T15:10:05,Valladolid,expenses,electricity,-110.92,-60049.7
buyer_6,Manuel,Díez,1979-02-14,54911168W,manuel.diez@coolcode.digital,606978,ES48209543417824685298,1248.06,2024-06-05T13:08:19,Valladolid,expenses,cash,-100.0,-60149.7
buyer_6,Manuel,Díez,1979-02-14,54911168W,manuel.diez@coolcode.digital,606978,ES48209543417824685298,1248.06,2024-06-06T17:05:25,Valladolid,expenses,water,-41.68,-60191.38
buyer_6,Manuel,Díez,1979-02-14,54911168W,manuel.diez@coolcode.digital,606978,ES48209543417824685298,1248.06,2024-06-06T15:28:34,Valladolid,expenses,phone,-48.2,-60239.58
buyer_6,Manuel,Díez,1979-02-14,54911168W,manuel.diez@coolcode.digital,606978,ES48209543417824685298,1248.06,2024-06-07T12:39:28,Valladolid,expenses,electricity,-99.6,-60339.18
buyer_6,Manuel,Díez,1979-02-14,54911168W,manuel.diez@coolcode.digital,606978,ES48209543417824685298,1248.06,2024-06-07T01:42:48,Valladolid,expenses,healthcare,-97.12,-60436.3
buyer_6,Manuel,Díez,1979-02-14,54911168W,manuel.diez@coolcode.digital,606978,ES48209543417824685298,1248.06,2024-06-08T18:08:20,Valladolid,expenses,gas,-132.32,-60568.62
buyer_6,Manuel,Díez,1979-02-14,54911168W,manuel.diez@coolcode.digital,606978,ES48209543417824685298,1248.06,2024-06-08T12:32:02,Valladolid,expenses,food,-92.16,-60660.78
buyer_6,Manuel,Díez,1979-02-14,54911168W,manuel.diez@coolcode.digital,606978,ES48209543417824685298,1248.06,2024-06-10T14:40:23,Valladolid,expenses,education,-58.78,-60719.56
buyer_6,Manuel,Díez,1979-02-14,54911168W,manuel.diez@coolcode.digital,606978,ES48209543417824685298,1248.06,2024-06-12T21:58:38,Valladolid,expenses,food,-68.68,-60788.24
buyer_6,Manuel,Díez,1979-02-14,54911168W,manuel.diez@coolcode.digital,606978,ES48209543417824685298,1248.06,2024-06-12T17:39:57,Valladolid,expenses,leisure,-32.26,-60820.5
buyer_6,Manuel,Díez,1979-02-14,54911168W,manuel.diez@coolcode.digital,606978,ES48209543417824685298,1248.06,2024-06-13T09:44:39,Valladolid,expenses,cash,-100.0,-60920.5
buyer_6,Manuel,Díez,1979-02-14,54911168W,manuel.diez@coolcode.digital,606978,ES48209543417824685298,1248.06,2024-06-14T18:36:26,Valladolid,expenses,leisure,-36.4,-60956.9
buyer_6,Manuel,Díez,1979-02-14,54911168W,manuel.diez@coolcode.digital,606978,ES48209543417824685298,1248.06,2024-06-15T10:16:43,Valladolid,expenses,transport,-50.61,-61007.51
buyer_6,Manuel,Díez,1979-02-14,54911168W,manuel.diez@coolcode.digital,606978,ES48209543417824685298,1248.06,2024-06-17T04:25:28,Valladolid,expenses,healthcare,-98.0,-61105.51
buyer_6,Manuel,Díez,1979-02-14,54911168W,manuel.diez@coolcode.digital,606978,ES48209543417824685298,1248.06,2024-06-17T18:23:32,Valladolid,expenses,gifts,-184.75,-61290.26
buyer_6,Manuel,Díez,1979-02-14,54911168W,manuel.diez@coolcode.digital,606978,ES48209543417824685298,1248.06,2024-06-19T20:00:04,Valladolid,expenses,clothing,-108.63,-61398.89
buyer_6,Manuel,Díez,1979-02-14,54911168W,manuel.diez@coolcode.digital,606978,ES48209543417824685298,1248.06,2024-06-19T20:25:54,Valladolid,expenses,cash,-100.0,-61498.89
buyer_6,Manuel,Díez,1979-02-14,54911168W,manuel.diez@coolcode.digital,606978,ES48209543417824685298,1248.06,2024-06-20T10:02:17,Valladolid,expenses,repairs,-138.71,-61637.6
buyer_6,Manuel,Díez,1979-02-14,54911168W,manuel.diez@coolcode.digital,606978,ES48209543417824685298,1248.06,2024-06-23T23:17:43,Valladolid,expenses,leisure,-35.65,-61673.25
buyer_6,Manuel,Díez,1979-02-14,54911168W,manuel.diez@coolcode.digital,606978,ES48209543417824685298,1248.06,2024-06-24T18:02:55,Valladolid,expenses,transport,-65.44,-61738.69
buyer_6,Manuel,Díez,1979-02-14,54911168W,manuel.diez@coolcode.digital,606978,ES48209543417824685298,1248.06,2024-06-24T21:03:33,Valladolid,expenses,repairs,-210.95,-61949.64
buyer_6,Manuel,Díez,1979-02-14,54911168W,manuel.diez@coolcode.digital,606978,ES48209543417824685298,1248.06,2024-06-25T15:34:17,Valladolid,expenses,gifts,-598.66,-62548.3
buyer_6,Manuel,Díez,1979-02-14,54911168W,manuel.diez@coolcode.digital,606978,ES48209543417824685298,1248.06,2024-06-26T15:46:02,Valladolid,expenses,education,-62.81,-62611.11
buyer_6,Manuel,Díez,1979-02-14,54911168W,manuel.diez@coolcode.digital,606978,ES48209543417824685298,1248.06,2024-06-27T20:18:43,Valladolid,expenses,food,-100.34,-62711.45
buyer_6,Manuel,Díez,1979-02-14,54911168W,manuel.diez@coolcode.digital,606978,ES48209543417824685298,1248.06,2024-06-27T11:14:01,Valladolid,expenses,transport,-62.73,-62774.18
buyer_6,Manuel,Díez,1979-02-14,54911168W,manuel.diez@coolcode.digital,606978,ES48209543417824685298,1248.06,2024-06-28T14:36:21,Valladolid,expenses,transport,-57.56,-62831.74
buyer_6,Manuel,Díez,1979-02-14,54911168W,manuel.diez@coolcode.digital,606978,ES48209543417824685298,1248.06,2024-06-29T21:49:02,Valladolid,expenses,education,-53.78,-62885.52
buyer_6,Manuel,Díez,1979-02-14,54911168W,manuel.diez@coolcode.digital,606978,ES48209543417824685298,1248.06,2024-06-30T16:54:12,Valladolid,expenses,leisure,-47.04,-62932.56
buyer_6,Manuel,Díez,1979-02-14,54911168W,manuel.diez@coolcode.digital,606978,ES48209543417824685298,1248.06,2024-07-01T17:16:24,Valladolid,incomes,salary,2689.51,-60243.05
buyer_6,Manuel,Díez,1979-02-14,54911168W,manuel.diez@coolcode.digital,606978,ES48209543417824685298,1248.06,2024-07-03T15:19:47,Valladolid,expenses,food,-88.73,-60331.78
buyer_6,Manuel,Díez,1979-02-14,54911168W,manuel.diez@coolcode.digital,606978,ES48209543417824685298,1248.06,2024-07-03T15:41:25,Valladolid,expenses,cash,-100.0,-60431.78
buyer_6,Manuel,Díez,1979-02-14,54911168W,manuel.diez@coolcode.digital,606978,ES48209543417824685298,1248.06,2024-07-05T09:30:32,Valladolid,expenses,mortgage,-1455.09,-61886.87
buyer_6,Manuel,Díez,1979-02-14,54911168W,manuel.diez@coolcode.digital,606978,ES48209543417824685298,1248.06,2024-07-05T21:47:48,Valladolid,expenses,water,-34.68,-61921.55
buyer_6,Manuel,Díez,1979-02-14,54911168W,manuel.diez@coolcode.digital,606978,ES48209543417824685298,1248.06,2024-07-06T09:43:12,Valladolid,expenses,internet,-56.48,-61978.03
buyer_6,Manuel,Díez,1979-02-14,54911168W,manuel.diez@coolcode.digital,606978,ES48209543417824685298,1248.06,2024-07-06T09:09:23,Valladolid,expenses,food,-117.2,-62095.23
buyer_6,Manuel,Díez,1979-02-14,54911168W,manuel.diez@coolcode.digital,606978,ES48209543417824685298,1248.06,2024-07-07T16:37:57,Valladolid,expenses,repairs,-148.57,-62243.8
buyer_6,Manuel,Díez,1979-02-14,54911168W,manuel.diez@coolcode.digital,606978,ES48209543417824685298,1248.06,2024-07-08T18:39:08,Valladolid,expenses,gas,-103.86,-62347.66
buyer_6,Manuel,Díez,1979-02-14,54911168W,manuel.diez@coolcode.digital,606978,ES48209543417824685298,1248.06,2024-07-08T09:40:32,Valladolid,expenses,education,-57.46,-62405.12
buyer_6,Manuel,Díez,1979-02-14,54911168W,manuel.diez@coolcode.digital,606978,ES48209543417824685298,1248.06,2024-07-11T12:04:34,Valladolid,expenses,food,-116.63,-62521.75
buyer_6,Manuel,Díez,1979-02-14,54911168W,manuel.diez@coolcode.digital,606978,ES48209543417824685298,1248.06,2024-07-12T17:01:10,Valladolid,expenses,transport,-79.73,-62601.48
buyer_6,Manuel,Díez,1979-02-14,54911168W,manuel.diez@coolcode.digital,606978,ES48209543417824685298,1248.06,2024-07-12T14:53:14,Valladolid,expenses,clothing,-131.88,-62733.36
buyer_6,Manuel,Díez,1979-02-14,54911168W,manuel.diez@coolcode.digital,606978,ES48209543417824685298,1248.06,2024-07-14T20:16:32,Valladolid,expenses,transport,-72.18,-62805.54
buyer_6,Manuel,Díez,1979-02-14,54911168W,manuel.diez@coolcode.digital,606978,ES48209543417824685298,1248.06,2024-07-15T11:43:18,Valladolid,expenses,leisure,-67.53,-62873.07
buyer_6,Manuel,Díez,1979-02-14,54911168W,manuel.diez@coolcode.digital,606978,ES48209543417824685298,1248.06,2024-07-16T21:28:51,Valladolid,expenses,travel,-352.21,-63225.28
buyer_6,Manuel,Díez,1979-02-14,54911168W,manuel.diez@coolcode.digital,606978,ES48209543417824685298,1248.06,2024-07-16T13:27:48,Valladolid,expenses,appliances,-280.28,-63505.56
buyer_6,Manuel,Díez,1979-02-14,54911168W,manuel.diez@coolcode.digital,606978,ES48209543417824685298,1248.06,2024-07-16T15:23:41,Valladolid,expenses,gifts,-184.46,-63690.02
buyer_6,Manuel,Díez,1979-02-14,54911168W,manuel.diez@coolcode.digital,606978,ES48209543417824685298,1248.06,2024-07-19T15:52:02,Valladolid,expenses,repairs,-329.84,-64019.86
buyer_6,Manuel,Díez,1979-02-14,54911168W,manuel.diez@coolcode.digital,606978,ES48209543417824685298,1248.06,2024-07-20T20:08:36,Valladolid,expenses,cash,-100.0,-64119.86
buyer_6,Manuel,Díez,1979-02-14,54911168W,manuel.diez@coolcode.digital,606978,ES48209543417824685298,1248.06,2024-07-21T10:40:49,Valladolid,expenses,food,-69.88,-64189.74
buyer_6,Manuel,Díez,1979-02-14,54911168W,manuel.diez@coolcode.digital,606978,ES48209543417824685298,1248.06,2024-07-21T10:44:39,Valladolid,expenses,cash,-100.0,-64289.74
buyer_6,Manuel,Díez,1979-02-14,54911168W,manuel.diez@coolcode.digital,606978,ES48209543417824685298,1248.06,2024-07-22T20:29:20,Valladolid,expenses,food,-115.93,-64405.67
buyer_6,Manuel,Díez,1979-02-14,54911168W,manuel.diez@coolcode.digital,606978,ES48209543417824685298,1248.06,2024-07-23T09:04:11,Valladolid,expenses,food,-68.07,-64473.74
buyer_6,Manuel,Díez,1979-02-14,54911168W,manuel.diez@coolcode.digital,606978,ES48209543417824685298,1248.06,2024-07-23T18:25:11,Valladolid,expenses,cash,-100.0,-64573.74
buyer_6,Manuel,Díez,1979-02-14,54911168W,manuel.diez@coolcode.digital,606978,ES48209543417824685298,1248.06,2024-07-24T20:52:02,Valladolid,expenses,transport,-44.44,-64618.18
buyer_6,Manuel,Díez,1979-02-14,54911168W,manuel.diez@coolcode.digital,606978,ES48209543417824685298,1248.06,2024-07-24T17:08:11,Valladolid,expenses,leisure,-64.19,-64682.37
buyer_6,Manuel,Díez,1979-02-14,54911168W,manuel.diez@coolcode.digital,606978,ES48209543417824685298,1248.06,2024-07-25T16:57:07,Valladolid,expenses,food,-102.71,-64785.08
buyer_6,Manuel,Díez,1979-02-14,54911168W,manuel.diez@coolcode.digital,606978,ES48209543417824685298,1248.06,2024-07-25T10:49:57,Valladolid,expenses,cash,-100.0,-64885.08
buyer_6,Manuel,Díez,1979-02-14,54911168W,manuel.diez@coolcode.digital,606978,ES48209543417824685298,1248.06,2024-07-26T18:09:04,Valladolid,expenses,transport,-89.68,-64974.76
buyer_6,Manuel,Díez,1979-02-14,54911168W,manuel.diez@coolcode.digital,606978,ES48209543417824685298,1248.06,2024-07-26T19:18:32,Valladolid,expenses,cash,-100.0,-65074.76
buyer_6,Manuel,Díez,1979-02-14,54911168W,manuel.diez@coolcode.digital,606978,ES48209543417824685298,1248.06,2024-07-27T11:07:24,Valladolid,expenses,leisure,-74.19,-65148.95
buyer_6,Manuel,Díez,1979-02-14,54911168W,manuel.diez@coolcode.digital,606978,ES48209543417824685298,1248.06,2024-07-27T08:33:01,Valladolid,expenses,repairs,-209.56,-65358.51
buyer_6,Manuel,Díez,1979-02-14,54911168W,manuel.diez@coolcode.digital,606978,ES48209543417824685298,1248.06,2024-07-30T16:38:32,Valladolid,expenses,cash,-100.0,-65458.51
buyer_6,Manuel,Díez,1979-02-14,54911168W,manuel.diez@coolcode.digital,606978,ES48209543417824685298,1248.06,2024-07-30T13:45:25,Valladolid,expenses,repairs,-72.57,-65531.08
buyer_6,Manuel,Díez,1979-02-14,54911168W,manuel.diez@coolcode.digital,606978,ES48209543417824685298,1248.06,2024-07-31T08:06:48,Valladolid,expenses,leisure,-77.76,-65608.84
buyer_6,Manuel,Díez,1979-02-14,54911168W,manuel.diez@coolcode.digital,606978,ES48209543417824685298,1248.06,2024-07-31T16:57:13,Valladolid,expenses,cash,-100.0,-65708.84
buyer_6,Manuel,Díez,1979-02-14,54911168W,manuel.diez@coolcode.digital,606978,ES48209543417824685298,1248.06,2024-08-01T15:24:01,Valladolid,incomes,salary,2689.51,-63019.33
buyer_6,Manuel,Díez,1979-02-14,54911168W,manuel.diez@coolcode.digital,606978,ES48209543417824685298,1248.06,2024-08-01T06:23:25,Valladolid,expenses,clothing,-49.18,-63068.51
buyer_6,Manuel,Díez,1979-02-14,54911168W,manuel.diez@coolcode.digital,606978,ES48209543417824685298,1248.06,2024-08-03T10:11:59,Valladolid,expenses,leisure,-84.7,-63153.21
buyer_6,Manuel,Díez,1979-02-14,54911168W,manuel.diez@coolcode.digital,606978,ES48209543417824685298,1248.06,2024-08-04T19:09:35,Valladolid,expenses,clothing,-70.32,-63223.53
buyer_6,Manuel,Díez,1979-02-14,54911168W,manuel.diez@coolcode.digital,606978,ES48209543417824685298,1248.06,2024-08-05T02:07:41,Valladolid,expenses,mortgage,-1455.09,-64678.62
buyer_6,Manuel,Díez,1979-02-14,54911168W,manuel.diez@coolcode.digital,606978,ES48209543417824685298,1248.06,2024-08-05T08:30:29,Valladolid,expenses,electricity,-39.14,-64717.76
buyer_6,Manuel,Díez,1979-02-14,54911168W,manuel.diez@coolcode.digital,606978,ES48209543417824685298,1248.06,2024-08-05T19:10:52,Valladolid,expenses,gas,-138.64,-64856.4
buyer_6,Manuel,Díez,1979-02-14,54911168W,manuel.diez@coolcode.digital,606978,ES48209543417824685298,1248.06,2024-08-05T18:06:54,Valladolid,expenses,gifts,-206.87,-65063.27
buyer_6,Manuel,Díez,1979-02-14,54911168W,manuel.diez@coolcode.digital,606978,ES48209543417824685298,1248.06,2024-08-07T15:43:52,Valladolid,expenses,gas,-103.65,-65166.92
buyer_6,Manuel,Díez,1979-02-14,54911168W,manuel.diez@coolcode.digital,606978,ES48209543417824685298,1248.06,2024-08-08T17:43:42,Valladolid,expenses,transport,-71.34,-65238.26
buyer_6,Manuel,Díez,1979-02-14,54911168W,manuel.diez@coolcode.digital,606978,ES48209543417824685298,1248.06,2024-08-08T11:19:41,Valladolid,expenses,clothing,-100.04,-65338.3
buyer_6,Manuel,Díez,1979-02-14,54911168W,manuel.diez@coolcode.digital,606978,ES48209543417824685298,1248.06,2024-08-08T21:55:50,Valladolid,expenses,cash,-100.0,-65438.3
buyer_6,Manuel,Díez,1979-02-14,54911168W,manuel.diez@coolcode.digital,606978,ES48209543417824685298,1248.06,2024-08-09T09:17:34,Valladolid,expenses,gifts,-70.38,-65508.68
buyer_6,Manuel,Díez,1979-02-14,54911168W,manuel.diez@coolcode.digital,606978,ES48209543417824685298,1248.06,2024-08-10T15:22:52,Valladolid,expenses,gifts,-798.25,-66306.93
buyer_6,Manuel,Díez,1979-02-14,54911168W,manuel.diez@coolcode.digital,606978,ES48209543417824685298,1248.06,2024-08-11T14:55:12,Valladolid,expenses,clothing,-156.29,-66463.22
buyer_6,Manuel,Díez,1979-02-14,54911168W,manuel.diez@coolcode.digital,606978,ES48209543417824685298,1248.06,2024-08-13T10:36:53,Valladolid,expenses,transport,-48.42,-66511.64
buyer_6,Manuel,Díez,1979-02-14,54911168W,manuel.diez@coolcode.digital,606978,ES48209543417824685298,1248.06,2024-08-14T20:16:10,Valladolid,expenses,transport,-76.18,-66587.82
buyer_6,Manuel,Díez,1979-02-14,54911168W,manuel.diez@coolcode.digital,606978,ES48209543417824685298,1248.06,2024-08-15T16:34:55,Valladolid,expenses,transport,-47.11,-66634.93
buyer_6,Manuel,Díez,1979-02-14,54911168W,manuel.diez@coolcode.digital,606978,ES48209543417824685298,1248.06,2024-08-15T10:57:42,Valladolid,expenses,leisure,-22.91,-66657.84
buyer_6,Manuel,Díez,1979-02-14,54911168W,manuel.diez@coolcode.digital,606978,ES48209543417824685298,1248.06,2024-08-16T11:03:18,Valladolid,expenses,leisure,-35.05,-66692.89
buyer_6,Manuel,Díez,1979-02-14,54911168W,manuel.diez@coolcode.digital,606978,ES48209543417824685298,1248.06,2024-08-16T13:55:22,Valladolid,expenses,clothing,-120.92,-66813.81
buyer_6,Manuel,Díez,1979-02-14,54911168W,manuel.diez@coolcode.digital,606978,ES48209543417824685298,1248.06,2024-08-17T08:10:45,Valladolid,expenses,education,-73.3,-66887.11
buyer_6,Manuel,Díez,1979-02-14,54911168W,manuel.diez@coolcode.digital,606978,ES48209543417824685298,1248.06,2024-08-18T13:39:57,Valladolid,expenses,food,-72.7,-66959.81
buyer_6,Manuel,Díez,1979-02-14,54911168W,manuel.diez@coolcode.digital,606978,ES48209543417824685298,1248.06,2024-08-18T16:13:26,Valladolid,expenses,transport,-75.92,-67035.73
buyer_6,Manuel,Díez,1979-02-14,54911168W,manuel.diez@coolcode.digital,606978,ES48209543417824685298,1248.06,2024-08-18T12:19:26,Valladolid,expenses,education,-73.49,-67109.22
buyer_6,Manuel,Díez,1979-02-14,54911168W,manuel.diez@coolcode.digital,606978,ES48209543417824685298,1248.06,2024-08-19T09:58:43,Valladolid,expenses,cash,-100.0,-67209.22
buyer_6,Manuel,Díez,1979-02-14,54911168W,manuel.diez@coolcode.digital,606978,ES48209543417824685298,1248.06,2024-08-21T13:43:48,Valladolid,expenses,food,-86.68,-67295.9
buyer_6,Manuel,Díez,1979-02-14,54911168W,manuel.diez@coolcode.digital,606978,ES48209543417824685298,1248.06,2024-08-21T12:17:25,Valladolid,expenses,leisure,-75.07,-67370.97
buyer_6,Manuel,Díez,1979-02-14,54911168W,manuel.diez@coolcode.digital,606978,ES48209543417824685298,1248.06,2024-08-21T13:46:11,Valladolid,expenses,cash,-100.0,-67470.97
buyer_6,Manuel,Díez,1979-02-14,54911168W,manuel.diez@coolcode.digital,606978,ES48209543417824685298,1248.06,2024-08-23T10:25:25,Valladolid,expenses,food,-66.74,-67537.71
buyer_6,Manuel,Díez,1979-02-14,54911168W,manuel.diez@coolcode.digital,606978,ES48209543417824685298,1248.06,2024-08-24T12:35:36,Valladolid,expenses,appliances,-226.84,-67764.55
buyer_6,Manuel,Díez,1979-02-14,54911168W,manuel.diez@coolcode.digital,606978,ES48209543417824685298,1248.06,2024-08-25T12:22:49,Valladolid,expenses,transport,-81.18,-67845.73
buyer_6,Manuel,Díez,1979-02-14,54911168W,manuel.diez@coolcode.digital,606978,ES48209543417824685298,1248.06,2024-08-27T20:43:33,Valladolid,expenses,transport,-57.55,-67903.28
buyer_6,Manuel,Díez,1979-02-14,54911168W,manuel.diez@coolcode.digital,606978,ES48209543417824685298,1248.06,2024-08-28T17:01:52,Valladolid,expenses,repairs,-136.67,-68039.95
buyer_6,Manuel,Díez,1979-02-14,54911168W,manuel.diez@coolcode.digital,606978,ES48209543417824685298,1248.06,2024-08-29T11:24:22,Valladolid,expenses,travel,-507.64,-68547.59
buyer_6,Manuel,Díez,1979-02-14,54911168W,manuel.diez@coolcode.digital,606978,ES48209543417824685298,1248.06,2024-08-30T11:18:21,Valladolid,expenses,cash,-100.0,-68647.59
buyer_6,Manuel,Díez,1979-02-14,54911168W,manuel.diez@coolcode.digital,606978,ES48209543417824685298,1248.06,2024-09-01T23:26:46,Valladolid,incomes,salary,2689.51,-65958.08
buyer_6,Manuel,Díez,1979-02-14,54911168W,manuel.diez@coolcode.digital,606978,ES48209543417824685298,1248.06,2024-09-01T23:26:46,Valladolid,incomes,extra_income,387.19,-65570.89
buyer_6,Manuel,Díez,1979-02-14,54911168W,manuel.diez@coolcode.digital,606978,ES48209543417824685298,1248.06,2024-09-02T20:27:33,Valladolid,expenses,appliances,-175.68,-65746.57
buyer_6,Manuel,Díez,1979-02-14,54911168W,manuel.diez@coolcode.digital,606978,ES48209543417824685298,1248.06,2024-09-04T13:19:21,Valladolid,expenses,cash,-100.0,-65846.57
buyer_6,Manuel,Díez,1979-02-14,54911168W,manuel.diez@coolcode.digital,606978,ES48209543417824685298,1248.06,2024-09-05T17:26:23,Valladolid,expenses,mortgage,-1455.09,-67301.66
buyer_6,Manuel,Díez,1979-02-14,54911168W,manuel.diez@coolcode.digital,606978,ES48209543417824685298,1248.06,2024-09-05T16:15:40,Valladolid,expenses,electricity,-85.31,-67386.97
buyer_6,Manuel,Díez,1979-02-14,54911168W,manuel.diez@coolcode.digital,606978,ES48209543417824685298,1248.06,2024-09-05T15:06:45,Valladolid,expenses,gas,-50.69,-67437.66
buyer_6,Manuel,Díez,1979-02-14,54911168W,manuel.diez@coolcode.digital,606978,ES48209543417824685298,1248.06,2024-09-05T20:22:13,Valladolid,expenses,phone,-48.39,-67486.05
buyer_6,Manuel,Díez,1979-02-14,54911168W,manuel.diez@coolcode.digital,606978,ES48209543417824685298,1248.06,2024-09-05T09:09:16,Valladolid,expenses,cash,-100.0,-67586.05
buyer_6,Manuel,Díez,1979-02-14,54911168W,manuel.diez@coolcode.digital,606978,ES48209543417824685298,1248.06,2024-09-06T09:44:21,Valladolid,expenses,water,-38.3,-67624.35
buyer_6,Manuel,Díez,1979-02-14,54911168W,manuel.diez@coolcode.digital,606978,ES48209543417824685298,1248.06,2024-09-06T15:07:14,Valladolid,expenses,electricity,-37.68,-67662.03
buyer_6,Manuel,Díez,1979-02-14,54911168W,manuel.diez@coolcode.digital,606978,ES48209543417824685298,1248.06,2024-09-06T20:00:12,Valladolid,expenses,gas,-85.37,-67747.4
buyer_6,Manuel,Díez,1979-02-14,54911168W,manuel.diez@coolcode.digital,606978,ES48209543417824685298,1248.06,2024-09-07T17:42:43,Valladolid,expenses,food,-86.57,-67833.97
buyer_6,Manuel,Díez,1979-02-14,54911168W,manuel.diez@coolcode.digital,606978,ES48209543417824685298,1248.06,2024-09-07T19:07:52,Valladolid,expenses,transport,-47.14,-67881.11
buyer_6,Manuel,Díez,1979-02-14,54911168W,manuel.diez@coolcode.digital,606978,ES48209543417824685298,1248.06,2024-09-08T10:39:46,Valladolid,expenses,internet,-56.48,-67937.59
buyer_6,Manuel,Díez,1979-02-14,54911168W,manuel.diez@coolcode.digital,606978,ES48209543417824685298,1248.06,2024-09-08T15:43:06,Valladolid,expenses,phone,-55.65,-67993.24
buyer_6,Manuel,Díez,1979-02-14,54911168W,manuel.diez@coolcode.digital,606978,ES48209543417824685298,1248.06,2024-09-08T03:36:54,Valladolid,expenses,healthcare,-140.47,-68133.71
buyer_6,Manuel,Díez,1979-02-14,54911168W,manuel.diez@coolcode.digital,606978,ES48209543417824685298,1248.06,2024-09-08T19:17:18,Valladolid,expenses,repairs,-60.3,-68194.01
buyer_6,Manuel,Díez,1979-02-14,54911168W,manuel.diez@coolcode.digital,606978,ES48209543417824685298,1248.06,2024-09-10T15:41:55,Valladolid,expenses,clothing,-124.93,-68318.94
buyer_6,Manuel,Díez,1979-02-14,54911168W,manuel.diez@coolcode.digital,606978,ES48209543417824685298,1248.06,2024-09-11T19:36:35,Valladolid,expenses,food,-117.04,-68435.98
buyer_6,Manuel,Díez,1979-02-14,54911168W,manuel.diez@coolcode.digital,606978,ES48209543417824685298,1248.06,2024-09-15T20:00:37,Valladolid,expenses,leisure,-67.2,-68503.18
buyer_6,Manuel,Díez,1979-02-14,54911168W,manuel.diez@coolcode.digital,606978,ES48209543417824685298,1248.06,2024-09-15T17:40:52,Valladolid,expenses,cash,-100.0,-68603.18
buyer_6,Manuel,Díez,1979-02-14,54911168W,manuel.diez@coolcode.digital,606978,ES48209543417824685298,1248.06,2024-09-17T09:48:20,Valladolid,expenses,leisure,-19.96,-68623.14
buyer_6,Manuel,Díez,1979-02-14,54911168W,manuel.diez@coolcode.digital,606978,ES48209543417824685298,1248.06,2024-09-20T16:17:10,Valladolid,expenses,transport,-46.75,-68669.89
buyer_6,Manuel,Díez,1979-02-14,54911168W,manuel.diez@coolcode.digital,606978,ES48209543417824685298,1248.06,2024-09-20T12:06:52,Valladolid,expenses,cash,-100.0,-68769.89
buyer_6,Manuel,Díez,1979-02-14,54911168W,manuel.diez@coolcode.digital,606978,ES48209543417824685298,1248.06,2024-09-27T16:56:57,Valladolid,expenses,cash,-100.0,-68869.89
buyer_6,Manuel,Díez,1979-02-14,54911168W,manuel.diez@coolcode.digital,606978,ES48209543417824685298,1248.06,2024-09-29T08:56:21,Valladolid,expenses,leisure,-74.61,-68944.5
buyer_6,Manuel,Díez,1979-02-14,54911168W,manuel.diez@coolcode.digital,606978,ES48209543417824685298,1248.06,2024-09-29T10:43:22,Valladolid,expenses,cash,-100.0,-69044.5
buyer_6,Manuel,Díez,1979-02-14,54911168W,manuel.diez@coolcode.digital,606978,ES48209543417824685298,1248.06,2024-10-01T00:03:21,Valladolid,incomes,salary,2689.51,-66354.99
buyer_6,Manuel,Díez,1979-02-14,54911168W,manuel.diez@coolcode.digital,606978,ES48209543417824685298,1248.06,2024-10-01T12:43:11,Valladolid,expenses,cash,-100.0,-66454.99
buyer_6,Manuel,Díez,1979-02-14,54911168W,manuel.diez@coolcode.digital,606978,ES48209543417824685298,1248.06,2024-10-02T22:35:48,Valladolid,expenses,cash,-100.0,-66554.99
buyer_6,Manuel,Díez,1979-02-14,54911168W,manuel.diez@coolcode.digital,606978,ES48209543417824685298,1248.06,2024-10-04T20:08:40,Valladolid,expenses,cash,-100.0,-66654.99
buyer_6,Manuel,Díez,1979-02-14,54911168W,manuel.diez@coolcode.digital,606978,ES48209543417824685298,1248.06,2024-10-05T18:40:16,Valladolid,expenses,mortgage,-1455.09,-68110.08
buyer_6,Manuel,Díez,1979-02-14,54911168W,manuel.diez@coolcode.digital,606978,ES48209543417824685298,1248.06,2024-10-05T13:27:22,Valladolid,expenses,electricity,-116.17,-68226.25
buyer_6,Manuel,Díez,1979-02-14,54911168W,manuel.diez@coolcode.digital,606978,ES48209543417824685298,1248.06,2024-10-05T19:45:48,Valladolid,expenses,leisure,-24.31,-68250.56
buyer_6,Manuel,Díez,1979-02-14,54911168W,manuel.diez@coolcode.digital,606978,ES48209543417824685298,1248.06,2024-10-06T22:03:32,Valladolid,expenses,electricity,-57.59,-68308.15
buyer_6,Manuel,Díez,1979-02-14,54911168W,manuel.diez@coolcode.digital,606978,ES48209543417824685298,1248.06,2024-10-06T17:30:02,Valladolid,expenses,phone,-41.44,-68349.59
buyer_6,Manuel,Díez,1979-02-14,54911168W,manuel.diez@coolcode.digital,606978,ES48209543417824685298,1248.06,2024-10-06T08:28:26,Valladolid,expenses,food,-73.13,-68422.72
buyer_6,Manuel,Díez,1979-02-14,54911168W,manuel.diez@coolcode.digital,606978,ES48209543417824685298,1248.06,2024-10-07T15:53:01,Valladolid,expenses,internet,-56.48,-68479.2
buyer_6,Manuel,Díez,1979-02-14,54911168W,manuel.diez@coolcode.digital,606978,ES48209543417824685298,1248.06,2024-10-07T20:22:33,Valladolid,expenses,food,-117.62,-68596.82
buyer_6,Manuel,Díez,1979-02-14,54911168W,manuel.diez@coolcode.digital,606978,ES48209543417824685298,1248.06,2024-10-07T12:42:51,Valladolid,expenses,cash,-100.0,-68696.82
buyer_6,Manuel,Díez,1979-02-14,54911168W,manuel.diez@coolcode.digital,606978,ES48209543417824685298,1248.06,2024-10-08T10:39:30,Valladolid,expenses,gas,-76.25,-68773.07
buyer_6,Manuel,Díez,1979-02-14,54911168W,manuel.diez@coolcode.digital,606978,ES48209543417824685298,1248.06,2024-10-08T22:21:29,Valladolid,expenses,internet,-56.48,-68829.55
buyer_6,Manuel,Díez,1979-02-14,54911168W,manuel.diez@coolcode.digital,606978,ES48209543417824685298,1248.06,2024-10-08T17:59:12,Valladolid,expenses,phone,-51.27,-68880.82
buyer_6,Manuel,Díez,1979-02-14,54911168W,manuel.diez@coolcode.digital,606978,ES48209543417824685298,1248.06,2024-10-08T08:46:14,Valladolid,expenses,cash,-100.0,-68980.82
buyer_6,Manuel,Díez,1979-02-14,54911168W,manuel.diez@coolcode.digital,606978,ES48209543417824685298,1248.06,2024-10-10T19:26:13,Valladolid,expenses,cash,-100.0,-69080.82
buyer_6,Manuel,Díez,1979-02-14,54911168W,manuel.diez@coolcode.digital,606978,ES48209543417824685298,1248.06,2024-10-11T13:41:17,Valladolid,expenses,cash,-100.0,-69180.82
buyer_7,Agurtzane,Laka,1968-12-31,32779298C,agurtzane.laka@cleverdev.app,035088,ES90209568654031467919,7789.48,2022-01-01T15:03:07,Bilbao,incomes,salary,1383.48,9172.96
buyer_7,Agurtzane,Laka,1968-12-31,32779298C,agurtzane.laka@cleverdev.app,035088,ES90209568654031467919,7789.48,2022-01-01T17:05:21,Bilbao,expenses,appliances,-372.63,8800.33
buyer_7,Agurtzane,Laka,1968-12-31,32779298C,agurtzane.laka@cleverdev.app,035088,ES90209568654031467919,7789.48,2022-01-02T23:00:12,Bilbao,expenses,clothing,-117.17,8683.16
buyer_7,Agurtzane,Laka,1968-12-31,32779298C,agurtzane.laka@cleverdev.app,035088,ES90209568654031467919,7789.48,2022-01-05T16:19:26,Bilbao,expenses,mortgage,-538.08,8145.08
buyer_7,Agurtzane,Laka,1968-12-31,32779298C,agurtzane.laka@cleverdev.app,035088,ES90209568654031467919,7789.48,2022-01-05T02:07:54,Bilbao,expenses,cash,-100.0,8045.08
buyer_7,Agurtzane,Laka,1968-12-31,32779298C,agurtzane.laka@cleverdev.app,035088,ES90209568654031467919,7789.48,2022-01-06T04:42:10,Bilbao,expenses,internet,-29.05,8016.03
buyer_7,Agurtzane,Laka,1968-12-31,32779298C,agurtzane.laka@cleverdev.app,035088,ES90209568654031467919,7789.48,2022-01-06T14:56:00,Bilbao,expenses,phone,-28.09,7987.94
buyer_7,Agurtzane,Laka,1968-12-31,32779298C,agurtzane.laka@cleverdev.app,035088,ES90209568654031467919,7789.48,2022-01-06T15:16:42,Bilbao,expenses,travel,-377.59,7610.35
buyer_7,Agurtzane,Laka,1968-12-31,32779298C,agurtzane.laka@cleverdev.app,035088,ES90209568654031467919,7789.48,2022-01-07T10:36:16,Bilbao,expenses,food,-117.93,7492.42
buyer_7,Agurtzane,Laka,1968-12-31,32779298C,agurtzane.laka@cleverdev.app,035088,ES90209568654031467919,7789.48,2022-01-08T16:23:32,Bilbao,expenses,water,-27.98,7464.44
buyer_7,Agurtzane,Laka,1968-12-31,32779298C,agurtzane.laka@cleverdev.app,035088,ES90209568654031467919,7789.48,2022-01-08T09:58:46,Bilbao,expenses,phone,-25.01,7439.43
buyer_7,Agurtzane,Laka,1968-12-31,32779298C,agurtzane.laka@cleverdev.app,035088,ES90209568654031467919,7789.48,2022-01-09T20:13:02,Bilbao,expenses,cash,-100.0,7339.43
buyer_7,Agurtzane,Laka,1968-12-31,32779298C,agurtzane.laka@cleverdev.app,035088,ES90209568654031467919,7789.48,2022-01-10T16:09:38,Bilbao,expenses,food,-62.06,7277.37
buyer_7,Agurtzane,Laka,1968-12-31,32779298C,agurtzane.laka@cleverdev.app,035088,ES90209568654031467919,7789.48,2022-01-11T12:45:18,Bilbao,expenses,cash,-100.0,7177.37
buyer_7,Agurtzane,Laka,1968-12-31,32779298C,agurtzane.laka@cleverdev.app,035088,ES90209568654031467919,7789.48,2022-01-12T22:45:30,Bilbao,expenses,clothing,-85.15,7092.22
buyer_7,Agurtzane,Laka,1968-12-31,32779298C,agurtzane.laka@cleverdev.app,035088,ES90209568654031467919,7789.48,2022-01-13T12:34:09,Bilbao,expenses,food,-121.34,6970.88
buyer_7,Agurtzane,Laka,1968-12-31,32779298C,agurtzane.laka@cleverdev.app,035088,ES90209568654031467919,7789.48,2022-01-14T13:15:51,Bilbao,expenses,cash,-100.0,6870.88
buyer_7,Agurtzane,Laka,1968-12-31,32779298C,agurtzane.laka@cleverdev.app,035088,ES90209568654031467919,7789.48,2022-01-15T13:16:22,Bilbao,expenses,cash,-100.0,6770.88
buyer_7,Agurtzane,Laka,1968-12-31,32779298C,agurtzane.laka@cleverdev.app,035088,ES90209568654031467919,7789.48,2022-01-16T14:16:49,Bilbao,expenses,travel,-398.69,6372.19
buyer_7,Agurtzane,Laka,1968-12-31,32779298C,agurtzane.laka@cleverdev.app,035088,ES90209568654031467919,7789.48,2022-01-17T17:02:35,Bilbao,expenses,food,-102.62,6269.57
buyer_7,Agurtzane,Laka,1968-12-31,32779298C,agurtzane.laka@cleverdev.app,035088,ES90209568654031467919,7789.48,2022-01-17T11:02:21,Bilbao,expenses,gifts,-170.01,6099.56
buyer_7,Agurtzane,Laka,1968-12-31,32779298C,agurtzane.laka@cleverdev.app,035088,ES90209568654031467919,7789.48,2022-01-18T10:48:30,Bilbao,expenses,food,-73.03,6026.53
buyer_7,Agurtzane,Laka,1968-12-31,32779298C,agurtzane.laka@cleverdev.app,035088,ES90209568654031467919,7789.48,2022-01-18T03:57:11,Bilbao,expenses,travel,-298.52,5728.01
buyer_7,Agurtzane,Laka,1968-12-31,32779298C,agurtzane.laka@cleverdev.app,035088,ES90209568654031467919,7789.48,2022-01-20T15:47:51,Bilbao,expenses,cash,-100.0,5628.01
buyer_7,Agurtzane,Laka,1968-12-31,32779298C,agurtzane.laka@cleverdev.app,035088,ES90209568654031467919,7789.48,2022-01-21T11:33:32,Bilbao,expenses,food,-63.53,5564.48
buyer_7,Agurtzane,Laka,1968-12-31,32779298C,agurtzane.laka@cleverdev.app,035088,ES90209568654031467919,7789.48,2022-01-24T13:36:12,Bilbao,expenses,transport,-47.16,5517.32
buyer_7,Agurtzane,Laka,1968-12-31,32779298C,agurtzane.laka@cleverdev.app,035088,ES90209568654031467919,7789.48,2022-01-24T15:16:16,Bilbao,expenses,cash,-100.0,5417.32
buyer_7,Agurtzane,Laka,1968-12-31,32779298C,agurtzane.laka@cleverdev.app,035088,ES90209568654031467919,7789.48,2022-01-25T22:28:15,Bilbao,expenses,food,-74.24,5343.08
buyer_7,Agurtzane,Laka,1968-12-31,32779298C,agurtzane.laka@cleverdev.app,035088,ES90209568654031467919,7789.48,2022-01-26T20:41:27,Bilbao,expenses,healthcare,-127.96,5215.12
buyer_7,Agurtzane,Laka,1968-12-31,32779298C,agurtzane.laka@cleverdev.app,035088,ES90209568654031467919,7789.48,2022-01-27T05:22:38,Bilbao,expenses,cash,-100.0,5115.12
buyer_7,Agurtzane,Laka,1968-12-31,32779298C,agurtzane.laka@cleverdev.app,035088,ES90209568654031467919,7789.48,2022-01-30T17:52:15,Bilbao,expenses,gifts,-335.76,4779.36
buyer_7,Agurtzane,Laka,1968-12-31,32779298C,agurtzane.laka@cleverdev.app,035088,ES90209568654031467919,7789.48,2022-02-01T23:00:53,Bilbao,incomes,salary,1383.48,6162.84
buyer_7,Agurtzane,Laka,1968-12-31,32779298C,agurtzane.laka@cleverdev.app,035088,ES90209568654031467919,7789.48,2022-02-03T13:25:51,Bilbao,expenses,food,-114.87,6047.97
buyer_7,Agurtzane,Laka,1968-12-31,32779298C,agurtzane.laka@cleverdev.app,035088,ES90209568654031467919,7789.48,2022-02-03T22:07:01,Bilbao,expenses,leisure,-71.99,5975.98
buyer_7,Agurtzane,Laka,1968-12-31,32779298C,agurtzane.laka@cleverdev.app,035088,ES90209568654031467919,7789.48,2022-02-04T22:13:29,Bilbao,expenses,cash,-100.0,5875.98
buyer_7,Agurtzane,Laka,1968-12-31,32779298C,agurtzane.laka@cleverdev.app,035088,ES90209568654031467919,7789.48,2022-02-05T21:38:18,Bilbao,expenses,mortgage,-538.08,5337.9
buyer_7,Agurtzane,Laka,1968-12-31,32779298C,agurtzane.laka@cleverdev.app,035088,ES90209568654031467919,7789.48,2022-02-05T16:01:28,Bilbao,expenses,gas,-31.8,5306.1
buyer_7,Agurtzane,Laka,1968-12-31,32779298C,agurtzane.laka@cleverdev.app,035088,ES90209568654031467919,7789.48,2022-02-05T13:54:13,Bilbao,expenses,phone,-25.07,5281.03
buyer_7,Agurtzane,Laka,1968-12-31,32779298C,agurtzane.laka@cleverdev.app,035088,ES90209568654031467919,7789.48,2022-02-06T18:12:24,Bilbao,expenses,water,-25.56,5255.47
buyer_7,Agurtzane,Laka,1968-12-31,32779298C,agurtzane.laka@cleverdev.app,035088,ES90209568654031467919,7789.48,2022-02-07T01:58:53,Bilbao,expenses,gas,-41.57,5213.9
buyer_7,Agurtzane,Laka,1968-12-31,32779298C,agurtzane.laka@cleverdev.app,035088,ES90209568654031467919,7789.48,2022-02-07T17:17:23,Bilbao,expenses,clothing,-82.81,5131.09
buyer_7,Agurtzane,Laka,1968-12-31,32779298C,agurtzane.laka@cleverdev.app,035088,ES90209568654031467919,7789.48,2022-02-08T13:18:47,Bilbao,expenses,food,-99.84,5031.25
buyer_7,Agurtzane,Laka,1968-12-31,32779298C,agurtzane.laka@cleverdev.app,035088,ES90209568654031467919,7789.48,2022-02-08T11:56:30,Bilbao,expenses,appliances,-293.03,4738.22
buyer_7,Agurtzane,Laka,1968-12-31,32779298C,agurtzane.laka@cleverdev.app,035088,ES90209568654031467919,7789.48,2022-02-09T17:46:54,Bilbao,expenses,leisure,-23.3,4714.92
buyer_7,Agurtzane,Laka,1968-12-31,32779298C,agurtzane.laka@cleverdev.app,035088,ES90209568654031467919,7789.48,2022-02-09T22:04:55,Bilbao,expenses,cash,-100.0,4614.92
buyer_7,Agurtzane,Laka,1968-12-31,32779298C,agurtzane.laka@cleverdev.app,035088,ES90209568654031467919,7789.48,2022-02-10T04:52:51,Bilbao,expenses,healthcare,-71.53,4543.39
buyer_7,Agurtzane,Laka,1968-12-31,32779298C,agurtzane.laka@cleverdev.app,035088,ES90209568654031467919,7789.48,2022-02-10T11:20:11,Bilbao,expenses,gifts,-191.32,4352.07
buyer_7,Agurtzane,Laka,1968-12-31,32779298C,agurtzane.laka@cleverdev.app,035088,ES90209568654031467919,7789.48,2022-02-13T20:58:59,Bilbao,expenses,cash,-100.0,4252.07
buyer_7,Agurtzane,Laka,1968-12-31,32779298C,agurtzane.laka@cleverdev.app,035088,ES90209568654031467919,7789.48,2022-02-14T19:56:29,Bilbao,expenses,cash,-100.0,4152.07
buyer_7,Agurtzane,Laka,1968-12-31,32779298C,agurtzane.laka@cleverdev.app,035088,ES90209568654031467919,7789.48,2022-02-14T23:30:16,Bilbao,expenses,travel,-301.89,3850.18
buyer_7,Agurtzane,Laka,1968-12-31,32779298C,agurtzane.laka@cleverdev.app,035088,ES90209568654031467919,7789.48,2022-02-15T06:03:00,Bilbao,expenses,food,-110.94,3739.24
buyer_7,Agurtzane,Laka,1968-12-31,32779298C,agurtzane.laka@cleverdev.app,035088,ES90209568654031467919,7789.48,2022-02-17T12:25:01,Bilbao,expenses,gifts,-57.54,3681.7
buyer_7,Agurtzane,Laka,1968-12-31,32779298C,agurtzane.laka@cleverdev.app,035088,ES90209568654031467919,7789.48,2022-02-18T19:47:33,Bilbao,expenses,education,-75.84,3605.86
buyer_7,Agurtzane,Laka,1968-12-31,32779298C,agurtzane.laka@cleverdev.app,035088,ES90209568654031467919,7789.48,2022-02-20T22:13:58,Bilbao,expenses,transport,-86.68,3519.18
buyer_7,Agurtzane,Laka,1968-12-31,32779298C,agurtzane.laka@cleverdev.app,035088,ES90209568654031467919,7789.48,2022-02-21T14:59:47,Bilbao,expenses,transport,-80.77,3438.41
buyer_7,Agurtzane,Laka,1968-12-31,32779298C,agurtzane.laka@cleverdev.app,035088,ES90209568654031467919,7789.48,2022-02-21T15:26:16,Bilbao,expenses,leisure,-45.49,3392.92
buyer_7,Agurtzane,Laka,1968-12-31,32779298C,agurtzane.laka@cleverdev.app,035088,ES90209568654031467919,7789.48,2022-02-23T17:16:32,Bilbao,expenses,gifts,-26.47,3366.45
buyer_7,Agurtzane,Laka,1968-12-31,32779298C,agurtzane.laka@cleverdev.app,035088,ES90209568654031467919,7789.48,2022-02-24T09:58:15,Bilbao,expenses,cash,-100.0,3266.45
buyer_7,Agurtzane,Laka,1968-12-31,32779298C,agurtzane.laka@cleverdev.app,035088,ES90209568654031467919,7789.48,2022-02-25T00:03:49,Bilbao,expenses,leisure,-68.05,3198.4
buyer_7,Agurtzane,Laka,1968-12-31,32779298C,agurtzane.laka@cleverdev.app,035088,ES90209568654031467919,7789.48,2022-02-26T16:27:12,Bilbao,expenses,transport,-78.13,3120.27
buyer_7,Agurtzane,Laka,1968-12-31,32779298C,agurtzane.laka@cleverdev.app,035088,ES90209568654031467919,7789.48,2022-02-26T14:19:36,Bilbao,expenses,clothing,-127.24,2993.03
buyer_7,Agurtzane,Laka,1968-12-31,32779298C,agurtzane.laka@cleverdev.app,035088,ES90209568654031467919,7789.48,2022-03-01T18:55:22,Bilbao,incomes,salary,1383.48,4376.51
buyer_7,Agurtzane,Laka,1968-12-31,32779298C,agurtzane.laka@cleverdev.app,035088,ES90209568654031467919,7789.48,2022-03-01T18:55:22,Bilbao,incomes,extra_income,242.27,4618.78
buyer_7,Agurtzane,Laka,1968-12-31,32779298C,agurtzane.laka@cleverdev.app,035088,ES90209568654031467919,7789.48,2022-03-02T18:33:55,Bilbao,expenses,healthcare,-181.83,4436.95
buyer_7,Agurtzane,Laka,1968-12-31,32779298C,agurtzane.laka@cleverdev.app,035088,ES90209568654031467919,7789.48,2022-03-03T17:54:37,Bilbao,expenses,food,-100.29,4336.66
buyer_7,Agurtzane,Laka,1968-12-31,32779298C,agurtzane.laka@cleverdev.app,035088,ES90209568654031467919,7789.48,2022-03-03T08:32:26,Bilbao,expenses,leisure,-44.49,4292.17
buyer_7,Agurtzane,Laka,1968-12-31,32779298C,agurtzane.laka@cleverdev.app,035088,ES90209568654031467919,7789.48,2022-03-04T13:23:10,Bilbao,expenses,leisure,-79.38,4212.79
buyer_7,Agurtzane,Laka,1968-12-31,32779298C,agurtzane.laka@cleverdev.app,035088,ES90209568654031467919,7789.48,2022-03-05T06:24:58,Bilbao,expenses,mortgage,-538.08,3674.71
buyer_7,Agurtzane,Laka,1968-12-31,32779298C,agurtzane.laka@cleverdev.app,035088,ES90209568654031467919,7789.48,2022-03-06T10:14:35,Bilbao,expenses,phone,-21.63,3653.08
buyer_7,Agurtzane,Laka,1968-12-31,32779298C,agurtzane.laka@cleverdev.app,035088,ES90209568654031467919,7789.48,2022-03-07T08:54:36,Bilbao,expenses,electricity,-61.51,3591.57
buyer_7,Agurtzane,Laka,1968-12-31,32779298C,agurtzane.laka@cleverdev.app,035088,ES90209568654031467919,7789.48,2022-03-07T15:28:22,Bilbao,expenses,phone,-25.04,3566.53
buyer_7,Agurtzane,Laka,1968-12-31,32779298C,agurtzane.laka@cleverdev.app,035088,ES90209568654031467919,7789.48,2022-03-07T15:19:09,Bilbao,expenses,food,-113.96,3452.57
buyer_7,Agurtzane,Laka,1968-12-31,32779298C,agurtzane.laka@cleverdev.app,035088,ES90209568654031467919,7789.48,2022-03-08T12:19:21,Bilbao,expenses,electricity,-28.76,3423.81
buyer_7,Agurtzane,Laka,1968-12-31,32779298C,agurtzane.laka@cleverdev.app,035088,ES90209568654031467919,7789.48,2022-03-08T21:31:08,Bilbao,expenses,gifts,-257.85,3165.96
buyer_7,Agurtzane,Laka,1968-12-31,32779298C,agurtzane.laka@cleverdev.app,035088,ES90209568654031467919,7789.48,2022-03-09T14:30:01,Bilbao,expenses,food,-91.93,3074.03
buyer_7,Agurtzane,Laka,1968-12-31,32779298C,agurtzane.laka@cleverdev.app,035088,ES90209568654031467919,7789.48,2022-03-12T11:23:50,Bilbao,expenses,cash,-100.0,2974.03
buyer_7,Agurtzane,Laka,1968-12-31,32779298C,agurtzane.laka@cleverdev.app,035088,ES90209568654031467919,7789.48,2022-03-13T10:51:49,Bilbao,expenses,cash,-100.0,2874.03
buyer_7,Agurtzane,Laka,1968-12-31,32779298C,agurtzane.laka@cleverdev.app,035088,ES90209568654031467919,7789.48,2022-03-14T17:40:41,Bilbao,expenses,cash,-100.0,2774.03
buyer_7,Agurtzane,Laka,1968-12-31,32779298C,agurtzane.laka@cleverdev.app,035088,ES90209568654031467919,7789.48,2022-03-14T16:09:32,Bilbao,expenses,repairs,-210.14,2563.89
buyer_7,Agurtzane,Laka,1968-12-31,32779298C,agurtzane.laka@cleverdev.app,035088,ES90209568654031467919,7789.48,2022-03-14T18:10:39,Bilbao,expenses,gifts,-73.86,2490.03
buyer_7,Agurtzane,Laka,1968-12-31,32779298C,agurtzane.laka@cleverdev.app,035088,ES90209568654031467919,7789.48,2022-03-16T12:43:58,Bilbao,expenses,cash,-100.0,2390.03
buyer_7,Agurtzane,Laka,1968-12-31,32779298C,agurtzane.laka@cleverdev.app,035088,ES90209568654031467919,7789.48,2022-03-17T13:24:47,Bilbao,expenses,food,-84.25,2305.78
buyer_7,Agurtzane,Laka,1968-12-31,32779298C,agurtzane.laka@cleverdev.app,035088,ES90209568654031467919,7789.48,2022-03-19T01:39:55,Bilbao,expenses,cash,-100.0,2205.78
buyer_7,Agurtzane,Laka,1968-12-31,32779298C,agurtzane.laka@cleverdev.app,035088,ES90209568654031467919,7789.48,2022-03-21T20:29:53,Bilbao,expenses,food,-76.37,2129.41
buyer_7,Agurtzane,Laka,1968-12-31,32779298C,agurtzane.laka@cleverdev.app,035088,ES90209568654031467919,7789.48,2022-03-21T15:25:18,Bilbao,expenses,children,-220.51,1908.9
buyer_7,Agurtzane,Laka,1968-12-31,32779298C,agurtzane.laka@cleverdev.app,035088,ES90209568654031467919,7789.48,2022-03-22T18:52:11,Bilbao,expenses,cash,-100.0,1808.9
buyer_7,Agurtzane,Laka,1968-12-31,32779298C,agurtzane.laka@cleverdev.app,035088,ES90209568654031467919,7789.48,2022-03-23T10:27:06,Bilbao,expenses,leisure,-74.88,1734.02
buyer_7,Agurtzane,Laka,1968-12-31,32779298C,agurtzane.laka@cleverdev.app,035088,ES90209568654031467919,7789.48,2022-03-24T08:32:04,Bilbao,expenses,transport,-61.32,1672.7
buyer_7,Agurtzane,Laka,1968-12-31,32779298C,agurtzane.laka@cleverdev.app,035088,ES90209568654031467919,7789.48,2022-03-26T18:59:45,Bilbao,expenses,transport,-80.46,1592.24
buyer_7,Agurtzane,Laka,1968-12-31,32779298C,agurtzane.laka@cleverdev.app,035088,ES90209568654031467919,7789.48,2022-03-26T09:45:09,Bilbao,expenses,leisure,-52.1,1540.14
buyer_7,Agurtzane,Laka,1968-12-31,32779298C,agurtzane.laka@cleverdev.app,035088,ES90209568654031467919,7789.48,2022-03-28T18:47:56,Bilbao,expenses,leisure,-63.35,1476.79
buyer_7,Agurtzane,Laka,1968-12-31,32779298C,agurtzane.laka@cleverdev.app,035088,ES90209568654031467919,7789.48,2022-03-28T20:42:30,Bilbao,expenses,healthcare,-158.49,1318.3
buyer_7,Agurtzane,Laka,1968-12-31,32779298C,agurtzane.laka@cleverdev.app,035088,ES90209568654031467919,7789.48,2022-03-29T11:55:28,Bilbao,expenses,repairs,-223.59,1094.71
buyer_7,Agurtzane,Laka,1968-12-31,32779298C,agurtzane.laka@cleverdev.app,035088,ES90209568654031467919,7789.48,2022-04-01T12:44:41,Bilbao,incomes,salary,1383.48,2478.19
buyer_7,Agurtzane,Laka,1968-12-31,32779298C,agurtzane.laka@cleverdev.app,035088,ES90209568654031467919,7789.48,2022-04-01T20:37:11,Bilbao,expenses,cash,-100.0,2378.19
buyer_7,Agurtzane,Laka,1968-12-31,32779298C,agurtzane.laka@cleverdev.app,035088,ES90209568654031467919,7789.48,2022-04-03T17:02:33,Bilbao,expenses,food,-103.39,2274.8
buyer_7,Agurtzane,Laka,1968-12-31,32779298C,agurtzane.laka@cleverdev.app,035088,ES90209568654031467919,7789.48,2022-04-04T13:57:23,Bilbao,expenses,leisure,-47.54,2227.26
buyer_7,Agurtzane,Laka,1968-12-31,32779298C,agurtzane.laka@cleverdev.app,035088,ES90209568654031467919,7789.48,2022-04-04T18:09:25,Bilbao,expenses,education,-78.73,2148.53
buyer_7,Agurtzane,Laka,1968-12-31,32779298C,agurtzane.laka@cleverdev.app,035088,ES90209568654031467919,7789.48,2022-04-04T13:28:41,Bilbao,expenses,repairs,-92.51,2056.02
buyer_7,Agurtzane,Laka,1968-12-31,32779298C,agurtzane.laka@cleverdev.app,035088,ES90209568654031467919,7789.48,2022-04-05T15:34:08,Bilbao,expenses,mortgage,-538.08,1517.94
buyer_7,Agurtzane,Laka,1968-12-31,32779298C,agurtzane.laka@cleverdev.app,035088,ES90209568654031467919,7789.48,2022-04-06T13:23:46,Bilbao,expenses,internet,-29.05,1488.89
buyer_7,Agurtzane,Laka,1968-12-31,32779298C,agurtzane.laka@cleverdev.app,035088,ES90209568654031467919,7789.48,2022-04-07T16:57:44,Bilbao,expenses,electricity,-15.37,1473.52
buyer_7,Agurtzane,Laka,1968-12-31,32779298C,agurtzane.laka@cleverdev.app,035088,ES90209568654031467919,7789.48,2022-04-07T14:33:54,Bilbao,expenses,phone,-23.9,1449.62
buyer_7,Agurtzane,Laka,1968-12-31,32779298C,agurtzane.laka@cleverdev.app,035088,ES90209568654031467919,7789.48,2022-04-07T16:31:07,Bilbao,expenses,clothing,-82.47,1367.15
buyer_7,Agurtzane,Laka,1968-12-31,32779298C,agurtzane.laka@cleverdev.app,035088,ES90209568654031467919,7789.48,2022-04-08T09:33:04,Bilbao,expenses,electricity,-22.95,1344.2
buyer_7,Agurtzane,Laka,1968-12-31,32779298C,agurtzane.laka@cleverdev.app,035088,ES90209568654031467919,7789.48,2022-04-08T15:18:53,Bilbao,expenses,gas,-29.55,1314.65
buyer_7,Agurtzane,Laka,1968-12-31,32779298C,agurtzane.laka@cleverdev.app,035088,ES90209568654031467919,7789.48,2022-04-10T08:57:45,Bilbao,expenses,cash,-100.0,1214.65
buyer_7,Agurtzane,Laka,1968-12-31,32779298C,agurtzane.laka@cleverdev.app,035088,ES90209568654031467919,7789.48,2022-04-14T13:21:36,Bilbao,expenses,food,-106.69,1107.96
buyer_7,Agurtzane,Laka,1968-12-31,32779298C,agurtzane.laka@cleverdev.app,035088,ES90209568654031467919,7789.48,2022-04-14T16:18:37,Bilbao,expenses,gifts,-140.15,967.81
buyer_7,Agurtzane,Laka,1968-12-31,32779298C,agurtzane.laka@cleverdev.app,035088,ES90209568654031467919,7789.48,2022-04-15T14:54:57,Bilbao,expenses,cash,-100.0,867.81
buyer_7,Agurtzane,Laka,1968-12-31,32779298C,agurtzane.laka@cleverdev.app,035088,ES90209568654031467919,7789.48,2022-04-19T11:42:03,Bilbao,expenses,food,-78.76,789.05
buyer_7,Agurtzane,Laka,1968-12-31,32779298C,agurtzane.laka@cleverdev.app,035088,ES90209568654031467919,7789.48,2022-04-21T02:14:17,Bilbao,expenses,children,-241.31,547.74
buyer_7,Agurtzane,Laka,1968-12-31,32779298C,agurtzane.laka@cleverdev.app,035088,ES90209568654031467919,7789.48,2022-04-25T20:10:11,Bilbao,expenses,cash,-100.0,447.74
buyer_7,Agurtzane,Laka,1968-12-31,32779298C,agurtzane.laka@cleverdev.app,035088,ES90209568654031467919,7789.48,2022-04-29T17:07:22,Bilbao,expenses,food,-79.54,368.2
buyer_7,Agurtzane,Laka,1968-12-31,32779298C,agurtzane.laka@cleverdev.app,035088,ES90209568654031467919,7789.48,2022-04-29T15:47:08,Bilbao,expenses,healthcare,-109.1,259.1
buyer_7,Agurtzane,Laka,1968-12-31,32779298C,agurtzane.laka@cleverdev.app,035088,ES90209568654031467919,7789.48,2022-04-29T17:54:07,Bilbao,expenses,repairs,-81.88,177.22
buyer_7,Agurtzane,Laka,1968-12-31,32779298C,agurtzane.laka@cleverdev.app,035088,ES90209568654031467919,7789.48,2022-05-01T20:01:45,Bilbao,incomes,salary,1383.48,1560.7
buyer_7,Agurtzane,Laka,1968-12-31,32779298C,agurtzane.laka@cleverdev.app,035088,ES90209568654031467919,7789.48,2022-05-01T11:56:20,Bilbao,expenses,food,-106.64,1454.06
buyer_7,Agurtzane,Laka,1968-12-31,32779298C,agurtzane.laka@cleverdev.app,035088,ES90209568654031467919,7789.48,2022-05-03T03:30:46,Bilbao,expenses,food,-119.11,1334.95
buyer_7,Agurtzane,Laka,1968-12-31,32779298C,agurtzane.laka@cleverdev.app,035088,ES90209568654031467919,7789.48,2022-05-04T13:51:34,Bilbao,expenses,clothing,-111.76,1223.19
buyer_7,Agurtzane,Laka,1968-12-31,32779298C,agurtzane.laka@cleverdev.app,035088,ES90209568654031467919,7789.48,2022-05-05T09:35:44,Bilbao,expenses,mortgage,-538.08,685.11
buyer_7,Agurtzane,Laka,1968-12-31,32779298C,agurtzane.laka@cleverdev.app,035088,ES90209568654031467919,7789.48,2022-05-05T09:11:59,Bilbao,expenses,water,-14.84,670.27
buyer_7,Agurtzane,Laka,1968-12-31,32779298C,agurtzane.laka@cleverdev.app,035088,ES90209568654031467919,7789.48,2022-05-05T15:41:55,Bilbao,expenses,internet,-29.05,641.22
buyer_7,Agurtzane,Laka,1968-12-31,32779298C,agurtzane.laka@cleverdev.app,035088,ES90209568654031467919,7789.48,2022-05-05T18:20:06,Bilbao,expenses,gifts,-285.36,355.86
buyer_7,Agurtzane,Laka,1968-12-31,32779298C,agurtzane.laka@cleverdev.app,035088,ES90209568654031467919,7789.48,2022-05-05T23:02:32,Bilbao,expenses,children,-117.76824999999997,238.09
buyer_7,Agurtzane,Laka,1968-12-31,32779298C,agurtzane.laka@cleverdev.app,035088,ES90209568654031467919,7789.48,2022-05-06T10:34:50,Bilbao,expenses,water,-15.9,222.19
buyer_7,Agurtzane,Laka,1968-12-31,32779298C,agurtzane.laka@cleverdev.app,035088,ES90209568654031467919,7789.48,2022-05-06T03:11:03,Bilbao,expenses,internet,-29.05,193.14
buyer_7,Agurtzane,Laka,1968-12-31,32779298C,agurtzane.laka@cleverdev.app,035088,ES90209568654031467919,7789.48,2022-05-07T21:00:06,Bilbao,expenses,gas,-47.45,145.69
buyer_7,Agurtzane,Laka,1968-12-31,32779298C,agurtzane.laka@cleverdev.app,035088,ES90209568654031467919,7789.48,2022-05-07T10:15:55,Bilbao,expenses,internet,-29.05,116.64
buyer_7,Agurtzane,Laka,1968-12-31,32779298C,agurtzane.laka@cleverdev.app,035088,ES90209568654031467919,7789.48,2022-05-07T17:10:33,Bilbao,expenses,children,-253.86,-137.22
buyer_7,Agurtzane,Laka,1968-12-31,32779298C,agurtzane.laka@cleverdev.app,035088,ES90209568654031467919,7789.48,2022-05-08T18:34:19,Bilbao,expenses,internet,-29.05,-166.27
buyer_7,Agurtzane,Laka,1968-12-31,32779298C,agurtzane.laka@cleverdev.app,035088,ES90209568654031467919,7789.48,2022-05-08T08:51:04,Bilbao,expenses,phone,-23.65,-189.92
buyer_7,Agurtzane,Laka,1968-12-31,32779298C,agurtzane.laka@cleverdev.app,035088,ES90209568654031467919,7789.48,2022-05-08T17:36:54,Bilbao,expenses,healthcare,-130.27,-320.19
buyer_7,Agurtzane,Laka,1968-12-31,32779298C,agurtzane.laka@cleverdev.app,035088,ES90209568654031467919,7789.48,2022-05-08T11:57:05,Bilbao,expenses,gifts,-234.36,-554.55
buyer_7,Agurtzane,Laka,1968-12-31,32779298C,agurtzane.laka@cleverdev.app,035088,ES90209568654031467919,7789.48,2022-05-09T17:28:52,Bilbao,expenses,healthcare,-161.47,-716.02
buyer_7,Agurtzane,Laka,1968-12-31,32779298C,agurtzane.laka@cleverdev.app,035088,ES90209568654031467919,7789.48,2022-05-10T05:10:16,Bilbao,expenses,leisure,-45.3,-761.32
buyer_7,Agurtzane,Laka,1968-12-31,32779298C,agurtzane.laka@cleverdev.app,035088,ES90209568654031467919,7789.48,2022-05-10T18:11:03,Bilbao,expenses,healthcare,-94.33,-855.65
buyer_7,Agurtzane,Laka,1968-12-31,32779298C,agurtzane.laka@cleverdev.app,035088,ES90209568654031467919,7789.48,2022-05-11T09:47:19,Bilbao,expenses,cash,-100.0,-955.65
buyer_7,Agurtzane,Laka,1968-12-31,32779298C,agurtzane.laka@cleverdev.app,035088,ES90209568654031467919,7789.48,2022-05-14T20:57:01,Bilbao,expenses,cash,-100.0,-1055.65
buyer_7,Agurtzane,Laka,1968-12-31,32779298C,agurtzane.laka@cleverdev.app,035088,ES90209568654031467919,7789.48,2022-05-14T13:54:27,Bilbao,expenses,repairs,-63.66,-1119.31
buyer_7,Agurtzane,Laka,1968-12-31,32779298C,agurtzane.laka@cleverdev.app,035088,ES90209568654031467919,7789.48,2022-05-17T10:27:40,Bilbao,expenses,leisure,-64.2,-1183.51
buyer_7,Agurtzane,Laka,1968-12-31,32779298C,agurtzane.laka@cleverdev.app,035088,ES90209568654031467919,7789.48,2022-05-18T23:45:49,Bilbao,expenses,clothing,-146.86,-1330.37
buyer_7,Agurtzane,Laka,1968-12-31,32779298C,agurtzane.laka@cleverdev.app,035088,ES90209568654031467919,7789.48,2022-05-18T11:15:17,Bilbao,expenses,education,-72.53,-1402.9
buyer_7,Agurtzane,Laka,1968-12-31,32779298C,agurtzane.laka@cleverdev.app,035088,ES90209568654031467919,7789.48,2022-05-19T17:32:32,Bilbao,expenses,education,-72.29,-1475.19
buyer_7,Agurtzane,Laka,1968-12-31,32779298C,agurtzane.laka@cleverdev.app,035088,ES90209568654031467919,7789.48,2022-05-20T12:35:01,Bilbao,expenses,leisure,-50.68,-1525.87
buyer_7,Agurtzane,Laka,1968-12-31,32779298C,agurtzane.laka@cleverdev.app,035088,ES90209568654031467919,7789.48,2022-05-21T12:24:38,Bilbao,expenses,food,-99.88,-1625.75
buyer_7,Agurtzane,Laka,1968-12-31,32779298C,agurtzane.laka@cleverdev.app,035088,ES90209568654031467919,7789.48,2022-05-21T11:32:14,Bilbao,expenses,transport,-65.82,-1691.57
buyer_7,Agurtzane,Laka,1968-12-31,32779298C,agurtzane.laka@cleverdev.app,035088,ES90209568654031467919,7789.48,2022-05-24T11:36:58,Bilbao,expenses,food,-88.45,-1780.02
buyer_7,Agurtzane,Laka,1968-12-31,32779298C,agurtzane.laka@cleverdev.app,035088,ES90209568654031467919,7789.48,2022-05-27T19:13:16,Bilbao,expenses,food,-98.75,-1878.77
buyer_7,Agurtzane,Laka,1968-12-31,32779298C,agurtzane.laka@cleverdev.app,035088,ES90209568654031467919,7789.48,2022-05-28T11:40:28,Bilbao,expenses,leisure,-78.33,-1957.1
buyer_7,Agurtzane,Laka,1968-12-31,32779298C,agurtzane.laka@cleverdev.app,035088,ES90209568654031467919,7789.48,2022-05-28T09:15:25,Bilbao,expenses,clothing,-65.26,-2022.36
buyer_7,Agurtzane,Laka,1968-12-31,32779298C,agurtzane.laka@cleverdev.app,035088,ES90209568654031467919,7789.48,2022-05-28T16:13:12,Bilbao,expenses,cash,-100.0,-2122.36
buyer_7,Agurtzane,Laka,1968-12-31,32779298C,agurtzane.laka@cleverdev.app,035088,ES90209568654031467919,7789.48,2022-05-30T19:12:05,Bilbao,expenses,food,-104.1,-2226.46
buyer_7,Agurtzane,Laka,1968-12-31,32779298C,agurtzane.laka@cleverdev.app,035088,ES90209568654031467919,7789.48,2022-05-30T10:18:37,Bilbao,expenses,appliances,-187.66,-2414.12
buyer_7,Agurtzane,Laka,1968-12-31,32779298C,agurtzane.laka@cleverdev.app,035088,ES90209568654031467919,7789.48,2022-05-31T17:12:16,Bilbao,expenses,leisure,-78.32,-2492.44
buyer_7,Agurtzane,Laka,1968-12-31,32779298C,agurtzane.laka@cleverdev.app,035088,ES90209568654031467919,7789.48,2022-05-31T17:35:35,Bilbao,expenses,appliances,-196.56,-2689.0
buyer_7,Agurtzane,Laka,1968-12-31,32779298C,agurtzane.laka@cleverdev.app,035088,ES90209568654031467919,7789.48,2022-06-01T18:42:42,Bilbao,incomes,salary,1383.48,-1305.52
buyer_7,Agurtzane,Laka,1968-12-31,32779298C,agurtzane.laka@cleverdev.app,035088,ES90209568654031467919,7789.48,2022-06-01T18:42:42,Bilbao,incomes,extra_income,242.27,-1063.25
buyer_7,Agurtzane,Laka,1968-12-31,32779298C,agurtzane.laka@cleverdev.app,035088,ES90209568654031467919,7789.48,2022-06-01T18:42:42,Bilbao,incomes,salary_bonus,983.42,-79.83
buyer_7,Agurtzane,Laka,1968-12-31,32779298C,agurtzane.laka@cleverdev.app,035088,ES90209568654031467919,7789.48,2022-06-01T15:35:43,Bilbao,expenses,children,-112.16,-191.99
buyer_7,Agurtzane,Laka,1968-12-31,32779298C,agurtzane.laka@cleverdev.app,035088,ES90209568654031467919,7789.48,2022-06-02T23:47:11,Bilbao,expenses,taxes,-870.99,-1062.98
buyer_7,Agurtzane,Laka,1968-12-31,32779298C,agurtzane.laka@cleverdev.app,035088,ES90209568654031467919,7789.48,2022-06-02T21:12:13,Bilbao,expenses,insurance,-267.95,-1330.93
buyer_7,Agurtzane,Laka,1968-12-31,32779298C,agurtzane.laka@cleverdev.app,035088,ES90209568654031467919,7789.48,2022-06-02T18:16:52,Bilbao,expenses,cash,-100.0,-1430.93
buyer_7,Agurtzane,Laka,1968-12-31,32779298C,agurtzane.laka@cleverdev.app,035088,ES90209568654031467919,7789.48,2022-06-03T21:28:56,Bilbao,expenses,transport,-73.82,-1504.75
buyer_7,Agurtzane,Laka,1968-12-31,32779298C,agurtzane.laka@cleverdev.app,035088,ES90209568654031467919,7789.48,2022-06-04T11:50:48,Bilbao,expenses,cash,-100.0,-1604.75
buyer_7,Agurtzane,Laka,1968-12-31,32779298C,agurtzane.laka@cleverdev.app,035088,ES90209568654031467919,7789.48,2022-06-05T14:58:04,Bilbao,expenses,mortgage,-538.08,-2142.83
buyer_7,Agurtzane,Laka,1968-12-31,32779298C,agurtzane.laka@cleverdev.app,035088,ES90209568654031467919,7789.48,2022-06-05T14:53:54,Bilbao,expenses,transport,-46.78,-2189.61
buyer_7,Agurtzane,Laka,1968-12-31,32779298C,agurtzane.laka@cleverdev.app,035088,ES90209568654031467919,7789.48,2022-06-05T17:55:59,Bilbao,expenses,cash,-100.0,-2289.61
buyer_7,Agurtzane,Laka,1968-12-31,32779298C,agurtzane.laka@cleverdev.app,035088,ES90209568654031467919,7789.48,2022-06-06T13:20:51,Bilbao,expenses,water,-18.06,-2307.67
buyer_7,Agurtzane,Laka,1968-12-31,32779298C,agurtzane.laka@cleverdev.app,035088,ES90209568654031467919,7789.48,2022-06-06T09:19:31,Bilbao,expenses,gas,-68.34,-2376.01
buyer_7,Agurtzane,Laka,1968-12-31,32779298C,agurtzane.laka@cleverdev.app,035088,ES90209568654031467919,7789.48,2022-06-07T20:53:55,Bilbao,expenses,water,-14.28,-2390.29
buyer_7,Agurtzane,Laka,1968-12-31,32779298C,agurtzane.laka@cleverdev.app,035088,ES90209568654031467919,7789.48,2022-06-07T14:56:25,Bilbao,expenses,gas,-61.51,-2451.8
buyer_7,Agurtzane,Laka,1968-12-31,32779298C,agurtzane.laka@cleverdev.app,035088,ES90209568654031467919,7789.48,2022-06-07T11:21:16,Bilbao,expenses,food,-87.21,-2539.01
buyer_7,Agurtzane,Laka,1968-12-31,32779298C,agurtzane.laka@cleverdev.app,035088,ES90209568654031467919,7789.48,2022-06-08T19:15:02,Bilbao,expenses,gas,-59.87,-2598.88
buyer_7,Agurtzane,Laka,1968-12-31,32779298C,agurtzane.laka@cleverdev.app,035088,ES90209568654031467919,7789.48,2022-06-08T06:08:21,Bilbao,expenses,food,-91.8,-2690.68
buyer_7,Agurtzane,Laka,1968-12-31,32779298C,agurtzane.laka@cleverdev.app,035088,ES90209568654031467919,7789.48,2022-06-10T21:18:15,Bilbao,expenses,repairs,-230.67,-2921.35
buyer_7,Agurtzane,Laka,1968-12-31,32779298C,agurtzane.laka@cleverdev.app,035088,ES90209568654031467919,7789.48,2022-06-10T21:53:30,Bilbao,expenses,children,-172.45825,-3093.81
buyer_7,Agurtzane,Laka,1968-12-31,32779298C,agurtzane.laka@cleverdev.app,035088,ES90209568654031467919,7789.48,2022-06-11T14:08:19,Bilbao,expenses,transport,-65.6,-3159.41
buyer_7,Agurtzane,Laka,1968-12-31,32779298C,agurtzane.laka@cleverdev.app,035088,ES90209568654031467919,7789.48,2022-06-13T17:12:45,Bilbao,expenses,leisure,-26.32,-3185.73
buyer_7,Agurtzane,Laka,1968-12-31,32779298C,agurtzane.laka@cleverdev.app,035088,ES90209568654031467919,7789.48,2022-06-13T08:35:12,Bilbao,expenses,gifts,-41.38,-3227.11
buyer_7,Agurtzane,Laka,1968-12-31,32779298C,agurtzane.laka@cleverdev.app,035088,ES90209568654031467919,7789.48,2022-06-14T08:23:31,Bilbao,expenses,food,-96.3,-3323.41
buyer_7,Agurtzane,Laka,1968-12-31,32779298C,agurtzane.laka@cleverdev.app,035088,ES90209568654031467919,7789.48,2022-06-14T21:15:05,Bilbao,expenses,cash,-100.0,-3423.41
buyer_7,Agurtzane,Laka,1968-12-31,32779298C,agurtzane.laka@cleverdev.app,035088,ES90209568654031467919,7789.48,2022-06-16T14:35:14,Bilbao,expenses,leisure,-23.66,-3447.07
buyer_7,Agurtzane,Laka,1968-12-31,32779298C,agurtzane.laka@cleverdev.app,035088,ES90209568654031467919,7789.48,2022-06-17T14:48:06,Bilbao,expenses,food,-100.82,-3547.89
buyer_7,Agurtzane,Laka,1968-12-31,32779298C,agurtzane.laka@cleverdev.app,035088,ES90209568654031467919,7789.48,2022-06-18T23:53:50,Bilbao,expenses,cash,-100.0,-3647.89
buyer_7,Agurtzane,Laka,1968-12-31,32779298C,agurtzane.laka@cleverdev.app,035088,ES90209568654031467919,7789.48,2022-06-19T18:21:08,Bilbao,expenses,food,-119.1,-3766.99
buyer_7,Agurtzane,Laka,1968-12-31,32779298C,agurtzane.laka@cleverdev.app,035088,ES90209568654031467919,7789.48,2022-06-19T13:30:34,Bilbao,expenses,leisure,-37.58,-3804.57
buyer_7,Agurtzane,Laka,1968-12-31,32779298C,agurtzane.laka@cleverdev.app,035088,ES90209568654031467919,7789.48,2022-06-20T19:20:23,Bilbao,expenses,food,-100.94,-3905.51
buyer_7,Agurtzane,Laka,1968-12-31,32779298C,agurtzane.laka@cleverdev.app,035088,ES90209568654031467919,7789.48,2022-06-20T15:14:30,Bilbao,expenses,leisure,-48.96,-3954.47
buyer_7,Agurtzane,Laka,1968-12-31,32779298C,agurtzane.laka@cleverdev.app,035088,ES90209568654031467919,7789.48,2022-06-20T14:03:07,Bilbao,expenses,education,-60.52,-4014.99
buyer_7,Agurtzane,Laka,1968-12-31,32779298C,agurtzane.laka@cleverdev.app,035088,ES90209568654031467919,7789.48,2022-06-22T11:22:55,Bilbao,expenses,transport,-62.37,-4077.36
buyer_7,Agurtzane,Laka,1968-12-31,32779298C,agurtzane.laka@cleverdev.app,035088,ES90209568654031467919,7789.48,2022-06-22T09:32:38,Bilbao,expenses,clothing,-59.76,-4137.12
buyer_7,Agurtzane,Laka,1968-12-31,32779298C,agurtzane.laka@cleverdev.app,035088,ES90209568654031467919,7789.48,2022-06-22T11:09:05,Bilbao,expenses,cash,-100.0,-4237.12
buyer_7,Agurtzane,Laka,1968-12-31,32779298C,agurtzane.laka@cleverdev.app,035088,ES90209568654031467919,7789.48,2022-06-22T09:52:10,Bilbao,expenses,gifts,-172.64,-4409.76
buyer_7,Agurtzane,Laka,1968-12-31,32779298C,agurtzane.laka@cleverdev.app,035088,ES90209568654031467919,7789.48,2022-06-24T14:53:18,Bilbao,expenses,leisure,-27.53,-4437.29
buyer_7,Agurtzane,Laka,1968-12-31,32779298C,agurtzane.laka@cleverdev.app,035088,ES90209568654031467919,7789.48,2022-06-29T19:21:45,Bilbao,expenses,food,-104.92,-4542.21
buyer_7,Agurtzane,Laka,1968-12-31,32779298C,agurtzane.laka@cleverdev.app,035088,ES90209568654031467919,7789.48,2022-06-29T08:03:14,Bilbao,expenses,gifts,-134.86,-4677.07
buyer_7,Agurtzane,Laka,1968-12-31,32779298C,agurtzane.laka@cleverdev.app,035088,ES90209568654031467919,7789.48,2022-06-30T05:47:22,Bilbao,expenses,gifts,-215.24,-4892.31
buyer_7,Agurtzane,Laka,1968-12-31,32779298C,agurtzane.laka@cleverdev.app,035088,ES90209568654031467919,7789.48,2022-07-01T16:29:46,Bilbao,incomes,salary,1383.48,-3508.83
buyer_7,Agurtzane,Laka,1968-12-31,32779298C,agurtzane.laka@cleverdev.app,035088,ES90209568654031467919,7789.48,2022-07-01T12:21:08,Bilbao,expenses,food,-103.17,-3612.0
buyer_7,Agurtzane,Laka,1968-12-31,32779298C,agurtzane.laka@cleverdev.app,035088,ES90209568654031467919,7789.48,2022-07-01T17:50:17,Bilbao,expenses,cash,-100.0,-3712.0
buyer_7,Agurtzane,Laka,1968-12-31,32779298C,agurtzane.laka@cleverdev.app,035088,ES90209568654031467919,7789.48,2022-07-02T10:51:52,Bilbao,expenses,leisure,-49.25,-3761.25
buyer_7,Agurtzane,Laka,1968-12-31,32779298C,agurtzane.laka@cleverdev.app,035088,ES90209568654031467919,7789.48,2022-07-03T17:26:51,Bilbao,expenses,cash,-100.0,-3861.25
buyer_7,Agurtzane,Laka,1968-12-31,32779298C,agurtzane.laka@cleverdev.app,035088,ES90209568654031467919,7789.48,2022-07-03T20:14:03,Bilbao,expenses,travel,-288.62,-4149.87
buyer_7,Agurtzane,Laka,1968-12-31,32779298C,agurtzane.laka@cleverdev.app,035088,ES90209568654031467919,7789.48,2022-07-04T11:59:25,Bilbao,expenses,transport,-49.01,-4198.88
buyer_7,Agurtzane,Laka,1968-12-31,32779298C,agurtzane.laka@cleverdev.app,035088,ES90209568654031467919,7789.48,2022-07-04T16:44:56,Bilbao,expenses,cash,-100.0,-4298.88
buyer_7,Agurtzane,Laka,1968-12-31,32779298C,agurtzane.laka@cleverdev.app,035088,ES90209568654031467919,7789.48,2022-07-05T13:06:01,Bilbao,expenses,mortgage,-538.08,-4836.96
buyer_7,Agurtzane,Laka,1968-12-31,32779298C,agurtzane.laka@cleverdev.app,035088,ES90209568654031467919,7789.48,2022-07-05T08:27:10,Bilbao,expenses,gas,-34.97,-4871.93
buyer_7,Agurtzane,Laka,1968-12-31,32779298C,agurtzane.laka@cleverdev.app,035088,ES90209568654031467919,7789.48,2022-07-05T12:22:54,Bilbao,expenses,internet,-29.05,-4900.98
buyer_7,Agurtzane,Laka,1968-12-31,32779298C,agurtzane.laka@cleverdev.app,035088,ES90209568654031467919,7789.48,2022-07-05T11:28:24,Bilbao,expenses,phone,-23.04,-4924.02
buyer_7,Agurtzane,Laka,1968-12-31,32779298C,agurtzane.laka@cleverdev.app,035088,ES90209568654031467919,7789.48,2022-07-05T12:48:50,Bilbao,expenses,cash,-100.0,-5024.02
buyer_7,Agurtzane,Laka,1968-12-31,32779298C,agurtzane.laka@cleverdev.app,035088,ES90209568654031467919,7789.48,2022-07-06T11:57:55,Bilbao,expenses,gas,-48.43,-5072.45
buyer_7,Agurtzane,Laka,1968-12-31,32779298C,agurtzane.laka@cleverdev.app,035088,ES90209568654031467919,7789.48,2022-07-06T12:18:10,Bilbao,expenses,internet,-29.05,-5101.5
buyer_7,Agurtzane,Laka,1968-12-31,32779298C,agurtzane.laka@cleverdev.app,035088,ES90209568654031467919,7789.48,2022-07-07T14:00:42,Bilbao,expenses,gas,-42.9,-5144.4
buyer_7,Agurtzane,Laka,1968-12-31,32779298C,agurtzane.laka@cleverdev.app,035088,ES90209568654031467919,7789.48,2022-07-08T15:38:41,Bilbao,expenses,water,-29.81,-5174.21
buyer_7,Agurtzane,Laka,1968-12-31,32779298C,agurtzane.laka@cleverdev.app,035088,ES90209568654031467919,7789.48,2022-07-09T11:14:55,Bilbao,expenses,travel,-314.97,-5489.18
buyer_7,Agurtzane,Laka,1968-12-31,32779298C,agurtzane.laka@cleverdev.app,035088,ES90209568654031467919,7789.48,2022-07-10T09:17:47,Bilbao,expenses,car,-77.08,-5566.26
buyer_7,Agurtzane,Laka,1968-12-31,32779298C,agurtzane.laka@cleverdev.app,035088,ES90209568654031467919,7789.48,2022-07-12T08:45:33,Bilbao,expenses,leisure,-79.27,-5645.53
buyer_7,Agurtzane,Laka,1968-12-31,32779298C,agurtzane.laka@cleverdev.app,035088,ES90209568654031467919,7789.48,2022-07-12T20:28:29,Bilbao,expenses,cash,-100.0,-5745.53
buyer_7,Agurtzane,Laka,1968-12-31,32779298C,agurtzane.laka@cleverdev.app,035088,ES90209568654031467919,7789.48,2022-07-13T10:12:27,Bilbao,expenses,leisure,-51.27,-5796.8
buyer_7,Agurtzane,Laka,1968-12-31,32779298C,agurtzane.laka@cleverdev.app,035088,ES90209568654031467919,7789.48,2022-07-13T10:41:28,Bilbao,expenses,clothing,-48.59,-5845.39
buyer_7,Agurtzane,Laka,1968-12-31,32779298C,agurtzane.laka@cleverdev.app,035088,ES90209568654031467919,7789.48,2022-07-14T09:35:32,Bilbao,expenses,cash,-100.0,-5945.39
buyer_7,Agurtzane,Laka,1968-12-31,32779298C,agurtzane.laka@cleverdev.app,035088,ES90209568654031467919,7789.48,2022-07-19T22:44:34,Bilbao,expenses,food,-76.64,-6022.03
buyer_7,Agurtzane,Laka,1968-12-31,32779298C,agurtzane.laka@cleverdev.app,035088,ES90209568654031467919,7789.48,2022-07-20T09:27:43,Bilbao,expenses,food,-96.27,-6118.3
buyer_7,Agurtzane,Laka,1968-12-31,32779298C,agurtzane.laka@cleverdev.app,035088,ES90209568654031467919,7789.48,2022-07-20T16:45:33,Bilbao,expenses,repairs,-91.21,-6209.51
buyer_7,Agurtzane,Laka,1968-12-31,32779298C,agurtzane.laka@cleverdev.app,035088,ES90209568654031467919,7789.48,2022-07-21T20:23:13,Bilbao,expenses,clothing,-46.9,-6256.41
buyer_7,Agurtzane,Laka,1968-12-31,32779298C,agurtzane.laka@cleverdev.app,035088,ES90209568654031467919,7789.48,2022-07-21T22:35:16,Bilbao,expenses,children,-118.85,-6375.26
buyer_7,Agurtzane,Laka,1968-12-31,32779298C,agurtzane.laka@cleverdev.app,035088,ES90209568654031467919,7789.48,2022-07-22T18:03:39,Bilbao,expenses,appliances,-333.61,-6708.87
buyer_7,Agurtzane,Laka,1968-12-31,32779298C,agurtzane.laka@cleverdev.app,035088,ES90209568654031467919,7789.48,2022-07-23T19:00:48,Bilbao,expenses,healthcare,-144.14,-6853.01
buyer_7,Agurtzane,Laka,1968-12-31,32779298C,agurtzane.laka@cleverdev.app,035088,ES90209568654031467919,7789.48,2022-07-24T19:12:29,Bilbao,expenses,transport,-76.91,-6929.92
buyer_7,Agurtzane,Laka,1968-12-31,32779298C,agurtzane.laka@cleverdev.app,035088,ES90209568654031467919,7789.48,2022-07-30T09:45:11,Bilbao,expenses,leisure,-65.87,-6995.79
buyer_7,Agurtzane,Laka,1968-12-31,32779298C,agurtzane.laka@cleverdev.app,035088,ES90209568654031467919,7789.48,2022-07-31T01:02:36,Bilbao,expenses,leisure,-69.4,-7065.19
buyer_7,Agurtzane,Laka,1968-12-31,32779298C,agurtzane.laka@cleverdev.app,035088,ES90209568654031467919,7789.48,2022-07-31T13:27:38,Bilbao,expenses,cash,-100.0,-7165.19
buyer_7,Agurtzane,Laka,1968-12-31,32779298C,agurtzane.laka@cleverdev.app,035088,ES90209568654031467919,7789.48,2022-08-01T06:19:54,Bilbao,incomes,salary,1383.48,-5781.71
buyer_7,Agurtzane,Laka,1968-12-31,32779298C,agurtzane.laka@cleverdev.app,035088,ES90209568654031467919,7789.48,2022-08-01T14:00:03,Bilbao,expenses,food,-94.1,-5875.81
buyer_7,Agurtzane,Laka,1968-12-31,32779298C,agurtzane.laka@cleverdev.app,035088,ES90209568654031467919,7789.48,2022-08-01T15:14:05,Bilbao,expenses,leisure,-22.59,-5898.4
buyer_7,Agurtzane,Laka,1968-12-31,32779298C,agurtzane.laka@cleverdev.app,035088,ES90209568654031467919,7789.48,2022-08-01T08:07:29,Bilbao,expenses,cash,-100.0,-5998.4
buyer_7,Agurtzane,Laka,1968-12-31,32779298C,agurtzane.laka@cleverdev.app,035088,ES90209568654031467919,7789.48,2022-08-02T21:46:58,Bilbao,expenses,food,-79.2,-6077.6
buyer_7,Agurtzane,Laka,1968-12-31,32779298C,agurtzane.laka@cleverdev.app,035088,ES90209568654031467919,7789.48,2022-08-02T11:44:07,Bilbao,expenses,repairs,-164.39,-6241.99
buyer_7,Agurtzane,Laka,1968-12-31,32779298C,agurtzane.laka@cleverdev.app,035088,ES90209568654031467919,7789.48,2022-08-03T01:36:20,Bilbao,expenses,leisure,-56.83,-6298.82
buyer_7,Agurtzane,Laka,1968-12-31,32779298C,agurtzane.laka@cleverdev.app,035088,ES90209568654031467919,7789.48,2022-08-03T18:57:35,Bilbao,expenses,children,-328.85,-6627.67
buyer_7,Agurtzane,Laka,1968-12-31,32779298C,agurtzane.laka@cleverdev.app,035088,ES90209568654031467919,7789.48,2022-08-04T15:44:39,Bilbao,expenses,leisure,-37.31,-6664.98
buyer_7,Agurtzane,Laka,1968-12-31,32779298C,agurtzane.laka@cleverdev.app,035088,ES90209568654031467919,7789.48,2022-08-05T07:18:50,Bilbao,expenses,mortgage,-538.08,-7203.06
buyer_7,Agurtzane,Laka,1968-12-31,32779298C,agurtzane.laka@cleverdev.app,035088,ES90209568654031467919,7789.48,2022-08-05T01:41:34,Bilbao,expenses,clothing,-119.84,-7322.9
buyer_7,Agurtzane,Laka,1968-12-31,32779298C,agurtzane.laka@cleverdev.app,035088,ES90209568654031467919,7789.48,2022-08-05T22:34:55,Bilbao,expenses,children,-283.28824999999995,-7606.19
buyer_7,Agurtzane,Laka,1968-12-31,32779298C,agurtzane.laka@cleverdev.app,035088,ES90209568654031467919,7789.48,2022-08-06T15:18:34,Bilbao,expenses,gas,-60.49,-7666.68
buyer_7,Agurtzane,Laka,1968-12-31,32779298C,agurtzane.laka@cleverdev.app,035088,ES90209568654031467919,7789.48,2022-08-06T21:31:47,Bilbao,expenses,internet,-29.05,-7695.73
buyer_7,Agurtzane,Laka,1968-12-31,32779298C,agurtzane.laka@cleverdev.app,035088,ES90209568654031467919,7789.48,2022-08-06T13:21:21,Bilbao,expenses,transport,-53.94,-7749.67
buyer_7,Agurtzane,Laka,1968-12-31,32779298C,agurtzane.laka@cleverdev.app,035088,ES90209568654031467919,7789.48,2022-08-07T11:11:17,Bilbao,expenses,internet,-29.05,-7778.72
buyer_7,Agurtzane,Laka,1968-12-31,32779298C,agurtzane.laka@cleverdev.app,035088,ES90209568654031467919,7789.48,2022-08-07T18:13:51,Bilbao,expenses,phone,-24.22,-7802.94
buyer_7,Agurtzane,Laka,1968-12-31,32779298C,agurtzane.laka@cleverdev.app,035088,ES90209568654031467919,7789.48,2022-08-08T14:40:08,Bilbao,expenses,electricity,-46.84,-7849.78
buyer_7,Agurtzane,Laka,1968-12-31,32779298C,agurtzane.laka@cleverdev.app,035088,ES90209568654031467919,7789.48,2022-08-08T13:17:58,Bilbao,expenses,food,-62.48,-7912.26
buyer_7,Agurtzane,Laka,1968-12-31,32779298C,agurtzane.laka@cleverdev.app,035088,ES90209568654031467919,7789.48,2022-08-08T20:16:32,Bilbao,expenses,cash,-100.0,-8012.26
buyer_7,Agurtzane,Laka,1968-12-31,32779298C,agurtzane.laka@cleverdev.app,035088,ES90209568654031467919,7789.48,2022-08-08T17:33:59,Bilbao,expenses,repairs,-144.44,-8156.7
buyer_7,Agurtzane,Laka,1968-12-31,32779298C,agurtzane.laka@cleverdev.app,035088,ES90209568654031467919,7789.48,2022-08-09T15:10:05,Bilbao,expenses,leisure,-62.57,-8219.27
buyer_7,Agurtzane,Laka,1968-12-31,32779298C,agurtzane.laka@cleverdev.app,035088,ES90209568654031467919,7789.48,2022-08-09T15:13:09,Bilbao,expenses,cash,-100.0,-8319.27
buyer_7,Agurtzane,Laka,1968-12-31,32779298C,agurtzane.laka@cleverdev.app,035088,ES90209568654031467919,7789.48,2022-08-10T19:29:19,Bilbao,expenses,appliances,-285.69,-8604.96
buyer_7,Agurtzane,Laka,1968-12-31,32779298C,agurtzane.laka@cleverdev.app,035088,ES90209568654031467919,7789.48,2022-08-12T11:58:28,Bilbao,expenses,children,-327.21,-8932.17
buyer_7,Agurtzane,Laka,1968-12-31,32779298C,agurtzane.laka@cleverdev.app,035088,ES90209568654031467919,7789.48,2022-08-15T06:51:41,Bilbao,expenses,gifts,-284.68,-9216.85
buyer_7,Agurtzane,Laka,1968-12-31,32779298C,agurtzane.laka@cleverdev.app,035088,ES90209568654031467919,7789.48,2022-08-17T20:08:14,Bilbao,expenses,cash,-100.0,-9316.85
buyer_7,Agurtzane,Laka,1968-12-31,32779298C,agurtzane.laka@cleverdev.app,035088,ES90209568654031467919,7789.48,2022-08-18T20:12:33,Bilbao,expenses,appliances,-119.94,-9436.79
buyer_7,Agurtzane,Laka,1968-12-31,32779298C,agurtzane.laka@cleverdev.app,035088,ES90209568654031467919,7789.48,2022-08-19T10:28:56,Bilbao,expenses,cash,-100.0,-9536.79
buyer_7,Agurtzane,Laka,1968-12-31,32779298C,agurtzane.laka@cleverdev.app,035088,ES90209568654031467919,7789.48,2022-08-19T11:12:50,Bilbao,expenses,repairs,-66.1,-9602.89
buyer_7,Agurtzane,Laka,1968-12-31,32779298C,agurtzane.laka@cleverdev.app,035088,ES90209568654031467919,7789.48,2022-08-22T20:54:27,Bilbao,expenses,food,-69.26,-9672.15
buyer_7,Agurtzane,Laka,1968-12-31,32779298C,agurtzane.laka@cleverdev.app,035088,ES90209568654031467919,7789.48,2022-08-25T20:44:19,Bilbao,expenses,cash,-100.0,-9772.15
buyer_7,Agurtzane,Laka,1968-12-31,32779298C,agurtzane.laka@cleverdev.app,035088,ES90209568654031467919,7789.48,2022-08-27T08:11:07,Bilbao,expenses,food,-122.72,-9894.87
buyer_7,Agurtzane,Laka,1968-12-31,32779298C,agurtzane.laka@cleverdev.app,035088,ES90209568654031467919,7789.48,2022-08-29T11:24:06,Bilbao,expenses,food,-115.8,-10010.67
buyer_7,Agurtzane,Laka,1968-12-31,32779298C,agurtzane.laka@cleverdev.app,035088,ES90209568654031467919,7789.48,2022-08-29T16:11:14,Bilbao,expenses,cash,-100.0,-10110.67
buyer_7,Agurtzane,Laka,1968-12-31,32779298C,agurtzane.laka@cleverdev.app,035088,ES90209568654031467919,7789.48,2022-08-30T08:06:39,Bilbao,expenses,repairs,-169.1,-10279.77
buyer_7,Agurtzane,Laka,1968-12-31,32779298C,agurtzane.laka@cleverdev.app,035088,ES90209568654031467919,7789.48,2022-08-30T09:11:27,Bilbao,expenses,gifts,-161.44,-10441.21
buyer_7,Agurtzane,Laka,1968-12-31,32779298C,agurtzane.laka@cleverdev.app,035088,ES90209568654031467919,7789.48,2022-09-01T13:00:12,Bilbao,incomes,salary,1383.48,-9057.73
buyer_7,Agurtzane,Laka,1968-12-31,32779298C,agurtzane.laka@cleverdev.app,035088,ES90209568654031467919,7789.48,2022-09-02T06:55:45,Bilbao,expenses,leisure,-53.91,-9111.64
buyer_7,Agurtzane,Laka,1968-12-31,32779298C,agurtzane.laka@cleverdev.app,035088,ES90209568654031467919,7789.48,2022-09-03T12:15:21,Bilbao,expenses,food,-121.22,-9232.86
buyer_7,Agurtzane,Laka,1968-12-31,32779298C,agurtzane.laka@cleverdev.app,035088,ES90209568654031467919,7789.48,2022-09-04T15:56:41,Bilbao,expenses,repairs,-29.33,-9262.19
buyer_7,Agurtzane,Laka,1968-12-31,32779298C,agurtzane.laka@cleverdev.app,035088,ES90209568654031467919,7789.48,2022-09-05T15:29:24,Bilbao,expenses,mortgage,-538.08,-9800.27
buyer_7,Agurtzane,Laka,1968-12-31,32779298C,agurtzane.laka@cleverdev.app,035088,ES90209568654031467919,7789.48,2022-09-05T20:18:39,Bilbao,expenses,phone,-21.33,-9821.6
buyer_7,Agurtzane,Laka,1968-12-31,32779298C,agurtzane.laka@cleverdev.app,035088,ES90209568654031467919,7789.48,2022-09-06T23:22:46,Bilbao,expenses,gas,-47.33,-9868.93
buyer_7,Agurtzane,Laka,1968-12-31,32779298C,agurtzane.laka@cleverdev.app,035088,ES90209568654031467919,7789.48,2022-09-06T23:21:03,Bilbao,expenses,leisure,-63.74,-9932.67
buyer_7,Agurtzane,Laka,1968-12-31,32779298C,agurtzane.laka@cleverdev.app,035088,ES90209568654031467919,7789.48,2022-09-07T08:35:53,Bilbao,expenses,water,-19.56,-9952.23
buyer_7,Agurtzane,Laka,1968-12-31,32779298C,agurtzane.laka@cleverdev.app,035088,ES90209568654031467919,7789.48,2022-09-07T11:57:52,Bilbao,expenses,electricity,-55.49,-10007.72
buyer_7,Agurtzane,Laka,1968-12-31,32779298C,agurtzane.laka@cleverdev.app,035088,ES90209568654031467919,7789.48,2022-09-07T06:55:39,Bilbao,expenses,transport,-80.56,-10088.28
buyer_7,Agurtzane,Laka,1968-12-31,32779298C,agurtzane.laka@cleverdev.app,035088,ES90209568654031467919,7789.48,2022-09-07T20:30:53,Bilbao,expenses,leisure,-55.91,-10144.19
buyer_7,Agurtzane,Laka,1968-12-31,32779298C,agurtzane.laka@cleverdev.app,035088,ES90209568654031467919,7789.48,2022-09-07T09:39:42,Bilbao,expenses,children,-175.37,-10319.56
buyer_7,Agurtzane,Laka,1968-12-31,32779298C,agurtzane.laka@cleverdev.app,035088,ES90209568654031467919,7789.48,2022-09-08T13:15:00,Bilbao,expenses,water,-21.29,-10340.85
buyer_7,Agurtzane,Laka,1968-12-31,32779298C,agurtzane.laka@cleverdev.app,035088,ES90209568654031467919,7789.48,2022-09-08T09:57:15,Bilbao,expenses,internet,-29.05,-10369.9
buyer_7,Agurtzane,Laka,1968-12-31,32779298C,agurtzane.laka@cleverdev.app,035088,ES90209568654031467919,7789.48,2022-09-08T20:09:45,Bilbao,expenses,transport,-83.11,-10453.01
buyer_7,Agurtzane,Laka,1968-12-31,32779298C,agurtzane.laka@cleverdev.app,035088,ES90209568654031467919,7789.48,2022-09-08T14:49:24,Bilbao,expenses,repairs,-102.97,-10555.98
buyer_7,Agurtzane,Laka,1968-12-31,32779298C,agurtzane.laka@cleverdev.app,035088,ES90209568654031467919,7789.48,2022-09-11T20:08:36,Bilbao,expenses,food,-114.51,-10670.49
buyer_7,Agurtzane,Laka,1968-12-31,32779298C,agurtzane.laka@cleverdev.app,035088,ES90209568654031467919,7789.48,2022-09-12T20:03:16,Bilbao,expenses,leisure,-60.46,-10730.95
buyer_7,Agurtzane,Laka,1968-12-31,32779298C,agurtzane.laka@cleverdev.app,035088,ES90209568654031467919,7789.48,2022-09-14T12:39:24,Bilbao,expenses,food,-65.12,-10796.07
buyer_7,Agurtzane,Laka,1968-12-31,32779298C,agurtzane.laka@cleverdev.app,035088,ES90209568654031467919,7789.48,2022-09-14T17:04:08,Bilbao,expenses,transport,-83.93,-10880.0
buyer_7,Agurtzane,Laka,1968-12-31,32779298C,agurtzane.laka@cleverdev.app,035088,ES90209568654031467919,7789.48,2022-09-14T09:23:39,Bilbao,expenses,appliances,-97.47,-10977.47
buyer_7,Agurtzane,Laka,1968-12-31,32779298C,agurtzane.laka@cleverdev.app,035088,ES90209568654031467919,7789.48,2022-09-15T08:22:37,Bilbao,expenses,food,-87.1,-11064.57
buyer_7,Agurtzane,Laka,1968-12-31,32779298C,agurtzane.laka@cleverdev.app,035088,ES90209568654031467919,7789.48,2022-09-18T12:06:09,Bilbao,expenses,transport,-62.0,-11126.57
buyer_7,Agurtzane,Laka,1968-12-31,32779298C,agurtzane.laka@cleverdev.app,035088,ES90209568654031467919,7789.48,2022-09-20T10:57:42,Bilbao,expenses,food,-83.55,-11210.12
buyer_7,Agurtzane,Laka,1968-12-31,32779298C,agurtzane.laka@cleverdev.app,035088,ES90209568654031467919,7789.48,2022-09-25T02:38:07,Bilbao,expenses,travel,-334.35,-11544.47
buyer_7,Agurtzane,Laka,1968-12-31,32779298C,agurtzane.laka@cleverdev.app,035088,ES90209568654031467919,7789.48,2022-09-27T15:17:09,Bilbao,expenses,appliances,-297.55,-11842.02
buyer_7,Agurtzane,Laka,1968-12-31,32779298C,agurtzane.laka@cleverdev.app,035088,ES90209568654031467919,7789.48,2022-09-28T19:27:44,Bilbao,expenses,food,-64.36,-11906.38
buyer_7,Agurtzane,Laka,1968-12-31,32779298C,agurtzane.laka@cleverdev.app,035088,ES90209568654031467919,7789.48,2022-09-29T11:27:01,Bilbao,expenses,cash,-100.0,-12006.38
buyer_7,Agurtzane,Laka,1968-12-31,32779298C,agurtzane.laka@cleverdev.app,035088,ES90209568654031467919,7789.48,2022-10-01T13:38:33,Bilbao,incomes,salary,1383.48,-10622.9
buyer_7,Agurtzane,Laka,1968-12-31,32779298C,agurtzane.laka@cleverdev.app,035088,ES90209568654031467919,7789.48,2022-10-01T13:38:33,Bilbao,incomes,extra_income,242.27,-10380.63
buyer_7,Agurtzane,Laka,1968-12-31,32779298C,agurtzane.laka@cleverdev.app,035088,ES90209568654031467919,7789.48,2022-10-01T04:27:57,Bilbao,expenses,repairs,-265.98,-10646.61
buyer_7,Agurtzane,Laka,1968-12-31,32779298C,agurtzane.laka@cleverdev.app,035088,ES90209568654031467919,7789.48,2022-10-02T08:04:36,Bilbao,expenses,leisure,-83.42,-10730.03
buyer_7,Agurtzane,Laka,1968-12-31,32779298C,agurtzane.laka@cleverdev.app,035088,ES90209568654031467919,7789.48,2022-10-02T22:45:31,Bilbao,expenses,car,-85.86,-10815.89
buyer_7,Agurtzane,Laka,1968-12-31,32779298C,agurtzane.laka@cleverdev.app,035088,ES90209568654031467919,7789.48,2022-10-03T23:46:58,Bilbao,expenses,cash,-100.0,-10915.89
buyer_7,Agurtzane,Laka,1968-12-31,32779298C,agurtzane.laka@cleverdev.app,035088,ES90209568654031467919,7789.48,2022-10-05T17:08:05,Bilbao,expenses,mortgage,-538.08,-11453.97
buyer_7,Agurtzane,Laka,1968-12-31,32779298C,agurtzane.laka@cleverdev.app,035088,ES90209568654031467919,7789.48,2022-10-05T18:52:47,Bilbao,expenses,electricity,-43.87,-11497.84
buyer_7,Agurtzane,Laka,1968-12-31,32779298C,agurtzane.laka@cleverdev.app,035088,ES90209568654031467919,7789.48,2022-10-09T15:30:13,Bilbao,expenses,food,-69.91,-11567.75
buyer_7,Agurtzane,Laka,1968-12-31,32779298C,agurtzane.laka@cleverdev.app,035088,ES90209568654031467919,7789.48,2022-10-10T14:21:02,Bilbao,expenses,gifts,-244.99,-11812.74
buyer_7,Agurtzane,Laka,1968-12-31,32779298C,agurtzane.laka@cleverdev.app,035088,ES90209568654031467919,7789.48,2022-10-11T15:52:17,Bilbao,expenses,food,-90.46,-11903.2
buyer_7,Agurtzane,Laka,1968-12-31,32779298C,agurtzane.laka@cleverdev.app,035088,ES90209568654031467919,7789.48,2022-10-11T11:58:16,Bilbao,expenses,cash,-100.0,-12003.2
buyer_7,Agurtzane,Laka,1968-12-31,32779298C,agurtzane.laka@cleverdev.app,035088,ES90209568654031467919,7789.48,2022-10-12T17:47:44,Bilbao,expenses,food,-97.44,-12100.64
buyer_7,Agurtzane,Laka,1968-12-31,32779298C,agurtzane.laka@cleverdev.app,035088,ES90209568654031467919,7789.48,2022-10-12T09:29:13,Bilbao,expenses,education,-62.73,-12163.37
buyer_7,Agurtzane,Laka,1968-12-31,32779298C,agurtzane.laka@cleverdev.app,035088,ES90209568654031467919,7789.48,2022-10-16T10:18:53,Bilbao,expenses,food,-79.48,-12242.85
buyer_7,Agurtzane,Laka,1968-12-31,32779298C,agurtzane.laka@cleverdev.app,035088,ES90209568654031467919,7789.48,2022-10-17T10:38:44,Bilbao,expenses,food,-72.25,-12315.1
buyer_7,Agurtzane,Laka,1968-12-31,32779298C,agurtzane.laka@cleverdev.app,035088,ES90209568654031467919,7789.48,2022-10-17T11:41:35,Bilbao,expenses,leisure,-48.26,-12363.36
buyer_7,Agurtzane,Laka,1968-12-31,32779298C,agurtzane.laka@cleverdev.app,035088,ES90209568654031467919,7789.48,2022-10-17T08:49:11,Bilbao,expenses,children,-242.37,-12605.73
buyer_7,Agurtzane,Laka,1968-12-31,32779298C,agurtzane.laka@cleverdev.app,035088,ES90209568654031467919,7789.48,2022-10-18T18:12:21,Bilbao,expenses,clothing,-121.2,-12726.93
buyer_7,Agurtzane,Laka,1968-12-31,32779298C,agurtzane.laka@cleverdev.app,035088,ES90209568654031467919,7789.48,2022-10-18T10:16:41,Bilbao,expenses,repairs,-260.84,-12987.77
buyer_7,Agurtzane,Laka,1968-12-31,32779298C,agurtzane.laka@cleverdev.app,035088,ES90209568654031467919,7789.48,2022-10-18T18:05:20,Bilbao,expenses,gifts,-24.43,-13012.2
buyer_7,Agurtzane,Laka,1968-12-31,32779298C,agurtzane.laka@cleverdev.app,035088,ES90209568654031467919,7789.48,2022-10-19T20:25:15,Bilbao,expenses,food,-70.4,-13082.6
buyer_7,Agurtzane,Laka,1968-12-31,32779298C,agurtzane.laka@cleverdev.app,035088,ES90209568654031467919,7789.48,2022-10-19T09:21:30,Bilbao,expenses,children,-206.21,-13288.81
buyer_7,Agurtzane,Laka,1968-12-31,32779298C,agurtzane.laka@cleverdev.app,035088,ES90209568654031467919,7789.48,2022-10-21T15:54:20,Bilbao,expenses,leisure,-82.52,-13371.33
buyer_7,Agurtzane,Laka,1968-12-31,32779298C,agurtzane.laka@cleverdev.app,035088,ES90209568654031467919,7789.48,2022-10-22T17:24:03,Bilbao,expenses,gifts,-101.15,-13472.48
buyer_7,Agurtzane,Laka,1968-12-31,32779298C,agurtzane.laka@cleverdev.app,035088,ES90209568654031467919,7789.48,2022-10-23T17:21:27,Bilbao,expenses,transport,-78.55,-13551.03
buyer_7,Agurtzane,Laka,1968-12-31,32779298C,agurtzane.laka@cleverdev.app,035088,ES90209568654031467919,7789.48,2022-10-24T23:24:32,Bilbao,expenses,repairs,-54.08,-13605.11
buyer_7,Agurtzane,Laka,1968-12-31,32779298C,agurtzane.laka@cleverdev.app,035088,ES90209568654031467919,7789.48,2022-10-29T11:53:09,Bilbao,expenses,food,-104.49,-13709.6
buyer_7,Agurtzane,Laka,1968-12-31,32779298C,agurtzane.laka@cleverdev.app,035088,ES90209568654031467919,7789.48,2022-10-30T20:57:02,Bilbao,expenses,gifts,-303.75,-14013.35
buyer_7,Agurtzane,Laka,1968-12-31,32779298C,agurtzane.laka@cleverdev.app,035088,ES90209568654031467919,7789.48,2022-10-31T13:13:48,Bilbao,expenses,education,-56.49,-14069.84
buyer_7,Agurtzane,Laka,1968-12-31,32779298C,agurtzane.laka@cleverdev.app,035088,ES90209568654031467919,7789.48,2022-11-01T22:50:54,Bilbao,incomes,salary,1383.48,-12686.36
buyer_7,Agurtzane,Laka,1968-12-31,32779298C,agurtzane.laka@cleverdev.app,035088,ES90209568654031467919,7789.48,2022-11-01T12:37:35,Bilbao,expenses,gifts,-302.5,-12988.86
buyer_7,Agurtzane,Laka,1968-12-31,32779298C,agurtzane.laka@cleverdev.app,035088,ES90209568654031467919,7789.48,2022-11-02T11:57:11,Bilbao,expenses,leisure,-54.05,-13042.91
buyer_7,Agurtzane,Laka,1968-12-31,32779298C,agurtzane.laka@cleverdev.app,035088,ES90209568654031467919,7789.48,2022-11-04T10:50:22,Bilbao,expenses,food,-119.03,-13161.94
buyer_7,Agurtzane,Laka,1968-12-31,32779298C,agurtzane.laka@cleverdev.app,035088,ES90209568654031467919,7789.48,2022-11-04T08:36:19,Bilbao,expenses,leisure,-50.07,-13212.01
buyer_7,Agurtzane,Laka,1968-12-31,32779298C,agurtzane.laka@cleverdev.app,035088,ES90209568654031467919,7789.48,2022-11-05T03:43:29,Bilbao,expenses,mortgage,-538.08,-13750.09
buyer_7,Agurtzane,Laka,1968-12-31,32779298C,agurtzane.laka@cleverdev.app,035088,ES90209568654031467919,7789.48,2022-11-05T14:28:50,Bilbao,expenses,water,-30.95,-13781.04
buyer_7,Agurtzane,Laka,1968-12-31,32779298C,agurtzane.laka@cleverdev.app,035088,ES90209568654031467919,7789.48,2022-11-06T20:05:20,Bilbao,expenses,phone,-20.76,-13801.8
buyer_7,Agurtzane,Laka,1968-12-31,32779298C,agurtzane.laka@cleverdev.app,035088,ES90209568654031467919,7789.48,2022-11-08T19:09:03,Bilbao,expenses,internet,-29.05,-13830.85
buyer_7,Agurtzane,Laka,1968-12-31,32779298C,agurtzane.laka@cleverdev.app,035088,ES90209568654031467919,7789.48,2022-11-08T15:07:39,Bilbao,expenses,children,-142.32,-13973.17
buyer_7,Agurtzane,Laka,1968-12-31,32779298C,agurtzane.laka@cleverdev.app,035088,ES90209568654031467919,7789.48,2022-11-09T09:21:49,Bilbao,expenses,food,-111.56,-14084.73
buyer_7,Agurtzane,Laka,1968-12-31,32779298C,agurtzane.laka@cleverdev.app,035088,ES90209568654031467919,7789.48,2022-11-09T18:11:50,Bilbao,expenses,repairs,-179.76,-14264.49
buyer_7,Agurtzane,Laka,1968-12-31,32779298C,agurtzane.laka@cleverdev.app,035088,ES90209568654031467919,7789.48,2022-11-11T12:14:44,Bilbao,expenses,cash,-100.0,-14364.49
buyer_7,Agurtzane,Laka,1968-12-31,32779298C,agurtzane.laka@cleverdev.app,035088,ES90209568654031467919,7789.48,2022-11-12T12:30:10,Bilbao,expenses,cash,-100.0,-14464.49
buyer_7,Agurtzane,Laka,1968-12-31,32779298C,agurtzane.laka@cleverdev.app,035088,ES90209568654031467919,7789.48,2022-11-13T09:55:53,Bilbao,expenses,transport,-54.08,-14518.57
buyer_7,Agurtzane,Laka,1968-12-31,32779298C,agurtzane.laka@cleverdev.app,035088,ES90209568654031467919,7789.48,2022-11-14T11:24:27,Bilbao,expenses,children,-249.5,-14768.07
buyer_7,Agurtzane,Laka,1968-12-31,32779298C,agurtzane.laka@cleverdev.app,035088,ES90209568654031467919,7789.48,2022-11-15T09:52:26,Bilbao,expenses,appliances,-185.63,-14953.7
buyer_7,Agurtzane,Laka,1968-12-31,32779298C,agurtzane.laka@cleverdev.app,035088,ES90209568654031467919,7789.48,2022-11-16T18:47:02,Bilbao,expenses,transport,-73.97,-15027.67
buyer_7,Agurtzane,Laka,1968-12-31,32779298C,agurtzane.laka@cleverdev.app,035088,ES90209568654031467919,7789.48,2022-11-16T16:22:53,Bilbao,expenses,leisure,-53.25,-15080.92
buyer_7,Agurtzane,Laka,1968-12-31,32779298C,agurtzane.laka@cleverdev.app,035088,ES90209568654031467919,7789.48,2022-11-17T10:57:45,Bilbao,expenses,cash,-100.0,-15180.92
buyer_7,Agurtzane,Laka,1968-12-31,32779298C,agurtzane.laka@cleverdev.app,035088,ES90209568654031467919,7789.48,2022-11-18T14:51:12,Bilbao,expenses,transport,-80.76,-15261.68
buyer_7,Agurtzane,Laka,1968-12-31,32779298C,agurtzane.laka@cleverdev.app,035088,ES90209568654031467919,7789.48,2022-11-19T15:23:15,Bilbao,expenses,education,-59.5,-15321.18
buyer_7,Agurtzane,Laka,1968-12-31,32779298C,agurtzane.laka@cleverdev.app,035088,ES90209568654031467919,7789.48,2022-11-21T11:54:28,Bilbao,expenses,appliances,-192.76,-15513.94
buyer_7,Agurtzane,Laka,1968-12-31,32779298C,agurtzane.laka@cleverdev.app,035088,ES90209568654031467919,7789.48,2022-11-22T05:46:53,Bilbao,expenses,transport,-48.91,-15562.85
buyer_7,Agurtzane,Laka,1968-12-31,32779298C,agurtzane.laka@cleverdev.app,035088,ES90209568654031467919,7789.48,2022-11-22T14:20:01,Bilbao,expenses,cash,-100.0,-15662.85
buyer_7,Agurtzane,Laka,1968-12-31,32779298C,agurtzane.laka@cleverdev.app,035088,ES90209568654031467919,7789.48,2022-11-24T18:38:02,Bilbao,expenses,cash,-100.0,-15762.85
buyer_7,Agurtzane,Laka,1968-12-31,32779298C,agurtzane.laka@cleverdev.app,035088,ES90209568654031467919,7789.48,2022-11-26T19:57:52,Bilbao,expenses,children,-348.35,-16111.2
buyer_7,Agurtzane,Laka,1968-12-31,32779298C,agurtzane.laka@cleverdev.app,035088,ES90209568654031467919,7789.48,2022-11-27T20:11:25,Bilbao,expenses,leisure,-81.24,-16192.44
buyer_7,Agurtzane,Laka,1968-12-31,32779298C,agurtzane.laka@cleverdev.app,035088,ES90209568654031467919,7789.48,2022-11-27T15:40:32,Bilbao,expenses,cash,-100.0,-16292.44
buyer_7,Agurtzane,Laka,1968-12-31,32779298C,agurtzane.laka@cleverdev.app,035088,ES90209568654031467919,7789.48,2022-11-28T17:37:25,Bilbao,expenses,cash,-100.0,-16392.44
buyer_7,Agurtzane,Laka,1968-12-31,32779298C,agurtzane.laka@cleverdev.app,035088,ES90209568654031467919,7789.48,2022-11-30T10:11:41,Bilbao,expenses,repairs,-40.96,-16433.4
buyer_7,Agurtzane,Laka,1968-12-31,32779298C,agurtzane.laka@cleverdev.app,035088,ES90209568654031467919,7789.48,2022-12-01T15:55:01,Bilbao,incomes,salary,1383.48,-15049.92
buyer_7,Agurtzane,Laka,1968-12-31,32779298C,agurtzane.laka@cleverdev.app,035088,ES90209568654031467919,7789.48,2022-12-01T15:55:01,Bilbao,incomes,salary_bonus,1082.76,-13967.16
buyer_7,Agurtzane,Laka,1968-12-31,32779298C,agurtzane.laka@cleverdev.app,035088,ES90209568654031467919,7789.48,2022-12-01T15:27:07,Bilbao,expenses,appliances,-277.93,-14245.09
buyer_7,Agurtzane,Laka,1968-12-31,32779298C,agurtzane.laka@cleverdev.app,035088,ES90209568654031467919,7789.48,2022-12-02T11:07:46,Bilbao,expenses,leisure,-68.75,-14313.84
buyer_7,Agurtzane,Laka,1968-12-31,32779298C,agurtzane.laka@cleverdev.app,035088,ES90209568654031467919,7789.48,2022-12-03T20:16:45,Bilbao,expenses,children,-72.38,-14386.22
buyer_7,Agurtzane,Laka,1968-12-31,32779298C,agurtzane.laka@cleverdev.app,035088,ES90209568654031467919,7789.48,2022-12-04T19:57:46,Bilbao,expenses,transport,-48.56,-14434.78
buyer_7,Agurtzane,Laka,1968-12-31,32779298C,agurtzane.laka@cleverdev.app,035088,ES90209568654031467919,7789.48,2022-12-04T12:38:10,Bilbao,expenses,children,-316.45,-14751.23
buyer_7,Agurtzane,Laka,1968-12-31,32779298C,agurtzane.laka@cleverdev.app,035088,ES90209568654031467919,7789.48,2022-12-05T18:37:24,Bilbao,expenses,mortgage,-538.08,-15289.31
buyer_7,Agurtzane,Laka,1968-12-31,32779298C,agurtzane.laka@cleverdev.app,035088,ES90209568654031467919,7789.48,2022-12-06T18:49:20,Bilbao,expenses,internet,-29.05,-15318.36
buyer_7,Agurtzane,Laka,1968-12-31,32779298C,agurtzane.laka@cleverdev.app,035088,ES90209568654031467919,7789.48,2022-12-06T11:28:48,Bilbao,expenses,phone,-26.6,-15344.96
buyer_7,Agurtzane,Laka,1968-12-31,32779298C,agurtzane.laka@cleverdev.app,035088,ES90209568654031467919,7789.48,2022-12-08T18:16:51,Bilbao,expenses,water,-30.5,-15375.46
buyer_7,Agurtzane,Laka,1968-12-31,32779298C,agurtzane.laka@cleverdev.app,035088,ES90209568654031467919,7789.48,2022-12-08T00:32:42,Bilbao,expenses,internet,-29.05,-15404.51
buyer_7,Agurtzane,Laka,1968-12-31,32779298C,agurtzane.laka@cleverdev.app,035088,ES90209568654031467919,7789.48,2022-12-08T19:54:24,Bilbao,expenses,food,-67.14,-15471.65
buyer_7,Agurtzane,Laka,1968-12-31,32779298C,agurtzane.laka@cleverdev.app,035088,ES90209568654031467919,7789.48,2022-12-08T22:28:42,Bilbao,expenses,healthcare,-173.88,-15645.53
buyer_7,Agurtzane,Laka,1968-12-31,32779298C,agurtzane.laka@cleverdev.app,035088,ES90209568654031467919,7789.48,2022-12-08T19:24:27,Bilbao,expenses,cash,-100.0,-15745.53
buyer_7,Agurtzane,Laka,1968-12-31,32779298C,agurtzane.laka@cleverdev.app,035088,ES90209568654031467919,7789.48,2022-12-10T11:02:11,Bilbao,expenses,cash,-100.0,-15845.53
buyer_7,Agurtzane,Laka,1968-12-31,32779298C,agurtzane.laka@cleverdev.app,035088,ES90209568654031467919,7789.48,2022-12-10T08:51:49,Bilbao,expenses,repairs,-251.0,-16096.53
buyer_7,Agurtzane,Laka,1968-12-31,32779298C,agurtzane.laka@cleverdev.app,035088,ES90209568654031467919,7789.48,2022-12-11T09:57:53,Bilbao,expenses,transport,-83.05,-16179.58
buyer_7,Agurtzane,Laka,1968-12-31,32779298C,agurtzane.laka@cleverdev.app,035088,ES90209568654031467919,7789.48,2022-12-12T18:12:34,Bilbao,expenses,children,-75.69,-16255.27
buyer_7,Agurtzane,Laka,1968-12-31,32779298C,agurtzane.laka@cleverdev.app,035088,ES90209568654031467919,7789.48,2022-12-18T09:30:05,Bilbao,expenses,cash,-100.0,-16355.27
buyer_7,Agurtzane,Laka,1968-12-31,32779298C,agurtzane.laka@cleverdev.app,035088,ES90209568654031467919,7789.48,2022-12-18T13:32:44,Bilbao,expenses,children,-260.83,-16616.1
buyer_7,Agurtzane,Laka,1968-12-31,32779298C,agurtzane.laka@cleverdev.app,035088,ES90209568654031467919,7789.48,2022-12-21T10:51:59,Bilbao,expenses,food,-79.29,-16695.39
buyer_7,Agurtzane,Laka,1968-12-31,32779298C,agurtzane.laka@cleverdev.app,035088,ES90209568654031467919,7789.48,2022-12-23T17:02:41,Bilbao,expenses,clothing,-103.25,-16798.64
buyer_7,Agurtzane,Laka,1968-12-31,32779298C,agurtzane.laka@cleverdev.app,035088,ES90209568654031467919,7789.48,2022-12-24T18:37:26,Bilbao,expenses,food,-69.83,-16868.47
buyer_7,Agurtzane,Laka,1968-12-31,32779298C,agurtzane.laka@cleverdev.app,035088,ES90209568654031467919,7789.48,2022-12-24T12:20:25,Bilbao,expenses,children,-230.75,-17099.22
buyer_7,Agurtzane,Laka,1968-12-31,32779298C,agurtzane.laka@cleverdev.app,035088,ES90209568654031467919,7789.48,2022-12-27T12:40:59,Bilbao,expenses,food,-109.39,-17208.61
buyer_7,Agurtzane,Laka,1968-12-31,32779298C,agurtzane.laka@cleverdev.app,035088,ES90209568654031467919,7789.48,2022-12-28T23:14:21,Bilbao,expenses,leisure,-60.62,-17269.23
buyer_7,Agurtzane,Laka,1968-12-31,32779298C,agurtzane.laka@cleverdev.app,035088,ES90209568654031467919,7789.48,2022-12-29T11:27:14,Bilbao,expenses,transport,-52.86,-17322.09
buyer_7,Agurtzane,Laka,1968-12-31,32779298C,agurtzane.laka@cleverdev.app,035088,ES90209568654031467919,7789.48,2022-12-29T13:43:33,Bilbao,expenses,cash,-100.0,-17422.09
buyer_7,Agurtzane,Laka,1968-12-31,32779298C,agurtzane.laka@cleverdev.app,035088,ES90209568654031467919,7789.48,2022-12-30T20:09:14,Bilbao,expenses,leisure,-51.73,-17473.82
buyer_7,Agurtzane,Laka,1968-12-31,32779298C,agurtzane.laka@cleverdev.app,035088,ES90209568654031467919,7789.48,2022-12-30T10:10:38,Bilbao,expenses,cash,-100.0,-17573.82
buyer_7,Agurtzane,Laka,1968-12-31,32779298C,agurtzane.laka@cleverdev.app,035088,ES90209568654031467919,7789.48,2022-12-30T20:24:17,Bilbao,expenses,children,-251.39825,-17825.22
buyer_7,Agurtzane,Laka,1968-12-31,32779298C,agurtzane.laka@cleverdev.app,035088,ES90209568654031467919,7789.48,2022-12-31T16:03:20,Bilbao,expenses,gifts,-191.43,-18016.65
buyer_7,Agurtzane,Laka,1968-12-31,32779298C,agurtzane.laka@cleverdev.app,035088,ES90209568654031467919,7789.48,2023-01-01T10:47:43,Bilbao,incomes,salary,1436.92,-16579.73
buyer_7,Agurtzane,Laka,1968-12-31,32779298C,agurtzane.laka@cleverdev.app,035088,ES90209568654031467919,7789.48,2023-01-01T10:47:43,Bilbao,incomes,extra_income,242.27,-16337.46
buyer_7,Agurtzane,Laka,1968-12-31,32779298C,agurtzane.laka@cleverdev.app,035088,ES90209568654031467919,7789.48,2023-01-01T22:39:38,Bilbao,expenses,cash,-100.0,-16437.46
buyer_7,Agurtzane,Laka,1968-12-31,32779298C,agurtzane.laka@cleverdev.app,035088,ES90209568654031467919,7789.48,2023-01-02T18:07:32,Bilbao,expenses,leisure,-24.66,-16462.12
buyer_7,Agurtzane,Laka,1968-12-31,32779298C,agurtzane.laka@cleverdev.app,035088,ES90209568654031467919,7789.48,2023-01-02T12:28:10,Bilbao,expenses,cash,-100.0,-16562.12
buyer_7,Agurtzane,Laka,1968-12-31,32779298C,agurtzane.laka@cleverdev.app,035088,ES90209568654031467919,7789.48,2023-01-05T08:40:13,Bilbao,expenses,mortgage,-582.53,-17144.65
buyer_7,Agurtzane,Laka,1968-12-31,32779298C,agurtzane.laka@cleverdev.app,035088,ES90209568654031467919,7789.48,2023-01-05T18:01:53,Bilbao,expenses,water,-23.5,-17168.15
buyer_7,Agurtzane,Laka,1968-12-31,32779298C,agurtzane.laka@cleverdev.app,035088,ES90209568654031467919,7789.48,2023-01-05T19:42:55,Bilbao,expenses,gas,-40.48,-17208.63
buyer_7,Agurtzane,Laka,1968-12-31,32779298C,agurtzane.laka@cleverdev.app,035088,ES90209568654031467919,7789.48,2023-01-05T21:39:43,Bilbao,expenses,phone,-24.76,-17233.39
buyer_7,Agurtzane,Laka,1968-12-31,32779298C,agurtzane.laka@cleverdev.app,035088,ES90209568654031467919,7789.48,2023-01-05T09:34:43,Bilbao,expenses,food,-75.6,-17308.99
buyer_7,Agurtzane,Laka,1968-12-31,32779298C,agurtzane.laka@cleverdev.app,035088,ES90209568654031467919,7789.48,2023-01-08T19:57:59,Bilbao,expenses,water,-21.93,-17330.92
buyer_7,Agurtzane,Laka,1968-12-31,32779298C,agurtzane.laka@cleverdev.app,035088,ES90209568654031467919,7789.48,2023-01-08T13:14:40,Bilbao,expenses,gas,-67.03,-17397.95
buyer_7,Agurtzane,Laka,1968-12-31,32779298C,agurtzane.laka@cleverdev.app,035088,ES90209568654031467919,7789.48,2023-01-08T14:15:26,Bilbao,expenses,transport,-40.66,-17438.61
buyer_7,Agurtzane,Laka,1968-12-31,32779298C,agurtzane.laka@cleverdev.app,035088,ES90209568654031467919,7789.48,2023-01-08T15:59:53,Bilbao,expenses,leisure,-24.83,-17463.44
buyer_7,Agurtzane,Laka,1968-12-31,32779298C,agurtzane.laka@cleverdev.app,035088,ES90209568654031467919,7789.48,2023-01-10T19:04:32,Bilbao,expenses,food,-82.56,-17546.0
buyer_7,Agurtzane,Laka,1968-12-31,32779298C,agurtzane.laka@cleverdev.app,035088,ES90209568654031467919,7789.48,2023-01-11T21:33:50,Bilbao,expenses,leisure,-54.65,-17600.65
buyer_7,Agurtzane,Laka,1968-12-31,32779298C,agurtzane.laka@cleverdev.app,035088,ES90209568654031467919,7789.48,2023-01-15T15:26:30,Bilbao,expenses,transport,-62.35,-17663.0
buyer_7,Agurtzane,Laka,1968-12-31,32779298C,agurtzane.laka@cleverdev.app,035088,ES90209568654031467919,7789.48,2023-01-15T12:20:21,Bilbao,expenses,cash,-100.0,-17763.0
buyer_7,Agurtzane,Laka,1968-12-31,32779298C,agurtzane.laka@cleverdev.app,035088,ES90209568654031467919,7789.48,2023-01-17T15:49:57,Bilbao,expenses,leisure,-28.1,-17791.1
buyer_7,Agurtzane,Laka,1968-12-31,32779298C,agurtzane.laka@cleverdev.app,035088,ES90209568654031467919,7789.48,2023-01-18T15:13:56,Bilbao,expenses,cash,-100.0,-17891.1
buyer_7,Agurtzane,Laka,1968-12-31,32779298C,agurtzane.laka@cleverdev.app,035088,ES90209568654031467919,7789.48,2023-01-19T13:19:52,Bilbao,expenses,travel,-394.29,-18285.39
buyer_7,Agurtzane,Laka,1968-12-31,32779298C,agurtzane.laka@cleverdev.app,035088,ES90209568654031467919,7789.48,2023-01-20T13:18:47,Bilbao,expenses,appliances,-101.12,-18386.51
buyer_7,Agurtzane,Laka,1968-12-31,32779298C,agurtzane.laka@cleverdev.app,035088,ES90209568654031467919,7789.48,2023-01-20T14:06:54,Bilbao,expenses,children,-127.63,-18514.14
buyer_7,Agurtzane,Laka,1968-12-31,32779298C,agurtzane.laka@cleverdev.app,035088,ES90209568654031467919,7789.48,2023-01-21T08:44:01,Bilbao,expenses,appliances,-206.0,-18720.14
buyer_7,Agurtzane,Laka,1968-12-31,32779298C,agurtzane.laka@cleverdev.app,035088,ES90209568654031467919,7789.48,2023-01-21T14:08:33,Bilbao,expenses,children,-188.94350000000009,-18909.08
buyer_7,Agurtzane,Laka,1968-12-31,32779298C,agurtzane.laka@cleverdev.app,035088,ES90209568654031467919,7789.48,2023-01-23T17:10:00,Bilbao,expenses,transport,-55.68,-18964.76
buyer_7,Agurtzane,Laka,1968-12-31,32779298C,agurtzane.laka@cleverdev.app,035088,ES90209568654031467919,7789.48,2023-01-23T16:17:37,Bilbao,expenses,healthcare,-178.74,-19143.5
buyer_7,Agurtzane,Laka,1968-12-31,32779298C,agurtzane.laka@cleverdev.app,035088,ES90209568654031467919,7789.48,2023-01-29T12:55:38,Bilbao,expenses,education,-78.03,-19221.53
buyer_7,Agurtzane,Laka,1968-12-31,32779298C,agurtzane.laka@cleverdev.app,035088,ES90209568654031467919,7789.48,2023-01-29T17:59:59,Bilbao,expenses,children,-316.9135000000001,-19538.44
buyer_7,Agurtzane,Laka,1968-12-31,32779298C,agurtzane.laka@cleverdev.app,035088,ES90209568654031467919,7789.48,2023-01-30T15:42:59,Bilbao,expenses,leisure,-57.19,-19595.63
buyer_7,Agurtzane,Laka,1968-12-31,32779298C,agurtzane.laka@cleverdev.app,035088,ES90209568654031467919,7789.48,2023-01-31T17:16:04,Bilbao,expenses,food,-124.65,-19720.28
buyer_7,Agurtzane,Laka,1968-12-31,32779298C,agurtzane.laka@cleverdev.app,035088,ES90209568654031467919,7789.48,2023-02-01T16:57:24,Bilbao,incomes,salary,1436.92,-18283.36
buyer_7,Agurtzane,Laka,1968-12-31,32779298C,agurtzane.laka@cleverdev.app,035088,ES90209568654031467919,7789.48,2023-02-01T02:32:29,Bilbao,expenses,gifts,-125.82,-18409.18
buyer_7,Agurtzane,Laka,1968-12-31,32779298C,agurtzane.laka@cleverdev.app,035088,ES90209568654031467919,7789.48,2023-02-02T10:27:49,Bilbao,expenses,food,-92.08,-18501.26
buyer_7,Agurtzane,Laka,1968-12-31,32779298C,agurtzane.laka@cleverdev.app,035088,ES90209568654031467919,7789.48,2023-02-02T01:04:05,Bilbao,expenses,leisure,-84.26,-18585.52
buyer_7,Agurtzane,Laka,1968-12-31,32779298C,agurtzane.laka@cleverdev.app,035088,ES90209568654031467919,7789.48,2023-02-02T03:32:25,Bilbao,expenses,repairs,-33.2,-18618.72
buyer_7,Agurtzane,Laka,1968-12-31,32779298C,agurtzane.laka@cleverdev.app,035088,ES90209568654031467919,7789.48,2023-02-04T13:37:28,Bilbao,expenses,cash,-100.0,-18718.72
buyer_7,Agurtzane,Laka,1968-12-31,32779298C,agurtzane.laka@cleverdev.app,035088,ES90209568654031467919,7789.48,2023-02-05T00:55:39,Bilbao,expenses,mortgage,-582.53,-19301.25
buyer_7,Agurtzane,Laka,1968-12-31,32779298C,agurtzane.laka@cleverdev.app,035088,ES90209568654031467919,7789.48,2023-02-05T17:18:25,Bilbao,expenses,phone,-28.21,-19329.46
buyer_7,Agurtzane,Laka,1968-12-31,32779298C,agurtzane.laka@cleverdev.app,035088,ES90209568654031467919,7789.48,2023-02-06T15:50:41,Bilbao,expenses,water,-23.81,-19353.27
buyer_7,Agurtzane,Laka,1968-12-31,32779298C,agurtzane.laka@cleverdev.app,035088,ES90209568654031467919,7789.48,2023-02-06T20:59:28,Bilbao,expenses,electricity,-45.69,-19398.96
buyer_7,Agurtzane,Laka,1968-12-31,32779298C,agurtzane.laka@cleverdev.app,035088,ES90209568654031467919,7789.48,2023-02-06T11:27:11,Bilbao,expenses,internet,-30.18,-19429.14
buyer_7,Agurtzane,Laka,1968-12-31,32779298C,agurtzane.laka@cleverdev.app,035088,ES90209568654031467919,7789.48,2023-02-07T11:05:10,Bilbao,expenses,repairs,-204.6,-19633.74
buyer_7,Agurtzane,Laka,1968-12-31,32779298C,agurtzane.laka@cleverdev.app,035088,ES90209568654031467919,7789.48,2023-02-08T10:45:58,Bilbao,expenses,electricity,-31.19,-19664.93
buyer_7,Agurtzane,Laka,1968-12-31,32779298C,agurtzane.laka@cleverdev.app,035088,ES90209568654031467919,7789.48,2023-02-08T11:07:47,Bilbao,expenses,leisure,-72.38,-19737.31
buyer_7,Agurtzane,Laka,1968-12-31,32779298C,agurtzane.laka@cleverdev.app,035088,ES90209568654031467919,7789.48,2023-02-08T00:17:46,Bilbao,expenses,healthcare,-185.46,-19922.77
buyer_7,Agurtzane,Laka,1968-12-31,32779298C,agurtzane.laka@cleverdev.app,035088,ES90209568654031467919,7789.48,2023-02-08T12:38:03,Bilbao,expenses,cash,-100.0,-20022.77
buyer_7,Agurtzane,Laka,1968-12-31,32779298C,agurtzane.laka@cleverdev.app,035088,ES90209568654031467919,7789.48,2023-02-10T21:56:47,Bilbao,expenses,food,-120.23,-20143.0
buyer_7,Agurtzane,Laka,1968-12-31,32779298C,agurtzane.laka@cleverdev.app,035088,ES90209568654031467919,7789.48,2023-02-10T16:20:04,Bilbao,expenses,education,-60.59,-20203.59
buyer_7,Agurtzane,Laka,1968-12-31,32779298C,agurtzane.laka@cleverdev.app,035088,ES90209568654031467919,7789.48,2023-02-11T10:52:48,Bilbao,expenses,healthcare,-90.58,-20294.17
buyer_7,Agurtzane,Laka,1968-12-31,32779298C,agurtzane.laka@cleverdev.app,035088,ES90209568654031467919,7789.48,2023-02-11T08:13:19,Bilbao,expenses,appliances,-107.75,-20401.92
buyer_7,Agurtzane,Laka,1968-12-31,32779298C,agurtzane.laka@cleverdev.app,035088,ES90209568654031467919,7789.48,2023-02-11T17:50:44,Bilbao,expenses,repairs,-177.94,-20579.86
buyer_7,Agurtzane,Laka,1968-12-31,32779298C,agurtzane.laka@cleverdev.app,035088,ES90209568654031467919,7789.48,2023-02-17T16:33:03,Bilbao,expenses,repairs,-107.48,-20687.34
buyer_7,Agurtzane,Laka,1968-12-31,32779298C,agurtzane.laka@cleverdev.app,035088,ES90209568654031467919,7789.48,2023-02-18T13:52:23,Bilbao,expenses,appliances,-202.98,-20890.32
buyer_7,Agurtzane,Laka,1968-12-31,32779298C,agurtzane.laka@cleverdev.app,035088,ES90209568654031467919,7789.48,2023-02-19T21:42:06,Bilbao,expenses,food,-123.22,-21013.54
buyer_7,Agurtzane,Laka,1968-12-31,32779298C,agurtzane.laka@cleverdev.app,035088,ES90209568654031467919,7789.48,2023-02-19T10:40:03,Bilbao,expenses,cash,-100.0,-21113.54
buyer_7,Agurtzane,Laka,1968-12-31,32779298C,agurtzane.laka@cleverdev.app,035088,ES90209568654031467919,7789.48,2023-02-19T23:01:16,Bilbao,expenses,repairs,-44.51,-21158.05
buyer_7,Agurtzane,Laka,1968-12-31,32779298C,agurtzane.laka@cleverdev.app,035088,ES90209568654031467919,7789.48,2023-02-20T15:14:38,Bilbao,expenses,leisure,-59.96,-21218.01
buyer_7,Agurtzane,Laka,1968-12-31,32779298C,agurtzane.laka@cleverdev.app,035088,ES90209568654031467919,7789.48,2023-02-23T08:13:39,Bilbao,expenses,healthcare,-56.57,-21274.58
buyer_7,Agurtzane,Laka,1968-12-31,32779298C,agurtzane.laka@cleverdev.app,035088,ES90209568654031467919,7789.48,2023-02-23T15:58:24,Bilbao,expenses,cash,-100.0,-21374.58
buyer_7,Agurtzane,Laka,1968-12-31,32779298C,agurtzane.laka@cleverdev.app,035088,ES90209568654031467919,7789.48,2023-02-24T16:35:55,Bilbao,expenses,transport,-87.87,-21462.45
buyer_7,Agurtzane,Laka,1968-12-31,32779298C,agurtzane.laka@cleverdev.app,035088,ES90209568654031467919,7789.48,2023-02-24T14:23:30,Bilbao,expenses,clothing,-137.17,-21599.62
buyer_7,Agurtzane,Laka,1968-12-31,32779298C,agurtzane.laka@cleverdev.app,035088,ES90209568654031467919,7789.48,2023-02-25T12:44:35,Bilbao,expenses,cash,-100.0,-21699.62
buyer_7,Agurtzane,Laka,1968-12-31,32779298C,agurtzane.laka@cleverdev.app,035088,ES90209568654031467919,7789.48,2023-02-27T18:47:45,Bilbao,expenses,cash,-100.0,-21799.62
buyer_7,Agurtzane,Laka,1968-12-31,32779298C,agurtzane.laka@cleverdev.app,035088,ES90209568654031467919,7789.48,2023-02-28T12:50:42,Bilbao,expenses,transport,-88.64,-21888.26
buyer_7,Agurtzane,Laka,1968-12-31,32779298C,agurtzane.laka@cleverdev.app,035088,ES90209568654031467919,7789.48,2023-03-01T15:33:57,Bilbao,incomes,salary,1436.92,-20451.34
buyer_7,Agurtzane,Laka,1968-12-31,32779298C,agurtzane.laka@cleverdev.app,035088,ES90209568654031467919,7789.48,2023-03-01T20:57:25,Bilbao,expenses,leisure,-55.16,-20506.5
buyer_7,Agurtzane,Laka,1968-12-31,32779298C,agurtzane.laka@cleverdev.app,035088,ES90209568654031467919,7789.48,2023-03-02T13:55:26,Bilbao,expenses,transport,-85.65,-20592.15
buyer_7,Agurtzane,Laka,1968-12-31,32779298C,agurtzane.laka@cleverdev.app,035088,ES90209568654031467919,7789.48,2023-03-02T12:39:33,Bilbao,expenses,appliances,-229.18,-20821.33
buyer_7,Agurtzane,Laka,1968-12-31,32779298C,agurtzane.laka@cleverdev.app,035088,ES90209568654031467919,7789.48,2023-03-03T19:56:22,Bilbao,expenses,food,-96.67,-20918.0
buyer_7,Agurtzane,Laka,1968-12-31,32779298C,agurtzane.laka@cleverdev.app,035088,ES90209568654031467919,7789.48,2023-03-03T08:30:52,Bilbao,expenses,transport,-64.17,-20982.17
buyer_7,Agurtzane,Laka,1968-12-31,32779298C,agurtzane.laka@cleverdev.app,035088,ES90209568654031467919,7789.48,2023-03-04T09:25:25,Bilbao,expenses,repairs,-321.22,-21303.39
buyer_7,Agurtzane,Laka,1968-12-31,32779298C,agurtzane.laka@cleverdev.app,035088,ES90209568654031467919,7789.48,2023-03-05T20:00:31,Bilbao,expenses,mortgage,-582.53,-21885.92
buyer_7,Agurtzane,Laka,1968-12-31,32779298C,agurtzane.laka@cleverdev.app,035088,ES90209568654031467919,7789.48,2023-03-05T11:26:31,Bilbao,expenses,leisure,-58.09,-21944.01
buyer_7,Agurtzane,Laka,1968-12-31,32779298C,agurtzane.laka@cleverdev.app,035088,ES90209568654031467919,7789.48,2023-03-06T19:01:04,Bilbao,expenses,transport,-40.54,-21984.55
buyer_7,Agurtzane,Laka,1968-12-31,32779298C,agurtzane.laka@cleverdev.app,035088,ES90209568654031467919,7789.48,2023-03-06T09:11:34,Bilbao,expenses,travel,-345.09,-22329.64
buyer_7,Agurtzane,Laka,1968-12-31,32779298C,agurtzane.laka@cleverdev.app,035088,ES90209568654031467919,7789.48,2023-03-07T19:30:35,Bilbao,expenses,phone,-29.85,-22359.49
buyer_7,Agurtzane,Laka,1968-12-31,32779298C,agurtzane.laka@cleverdev.app,035088,ES90209568654031467919,7789.48,2023-03-07T19:04:58,Bilbao,expenses,transport,-42.14,-22401.63
buyer_7,Agurtzane,Laka,1968-12-31,32779298C,agurtzane.laka@cleverdev.app,035088,ES90209568654031467919,7789.48,2023-03-07T12:49:29,Bilbao,expenses,healthcare,-90.65,-22492.28
buyer_7,Agurtzane,Laka,1968-12-31,32779298C,agurtzane.laka@cleverdev.app,035088,ES90209568654031467919,7789.48,2023-03-07T18:08:29,Bilbao,expenses,children,-262.15350000000007,-22754.43
buyer_7,Agurtzane,Laka,1968-12-31,32779298C,agurtzane.laka@cleverdev.app,035088,ES90209568654031467919,7789.48,2023-03-08T23:23:14,Bilbao,expenses,internet,-30.18,-22784.61
buyer_7,Agurtzane,Laka,1968-12-31,32779298C,agurtzane.laka@cleverdev.app,035088,ES90209568654031467919,7789.48,2023-03-08T18:09:35,Bilbao,expenses,phone,-30.07,-22814.68
buyer_7,Agurtzane,Laka,1968-12-31,32779298C,agurtzane.laka@cleverdev.app,035088,ES90209568654031467919,7789.48,2023-03-09T04:55:28,Bilbao,expenses,cash,-100.0,-22914.68
buyer_7,Agurtzane,Laka,1968-12-31,32779298C,agurtzane.laka@cleverdev.app,035088,ES90209568654031467919,7789.48,2023-03-11T15:07:28,Bilbao,expenses,education,-64.52,-22979.2
buyer_7,Agurtzane,Laka,1968-12-31,32779298C,agurtzane.laka@cleverdev.app,035088,ES90209568654031467919,7789.48,2023-03-11T12:53:25,Bilbao,expenses,cash,-100.0,-23079.2
buyer_7,Agurtzane,Laka,1968-12-31,32779298C,agurtzane.laka@cleverdev.app,035088,ES90209568654031467919,7789.48,2023-03-12T07:37:17,Bilbao,expenses,healthcare,-161.38,-23240.58
buyer_7,Agurtzane,Laka,1968-12-31,32779298C,agurtzane.laka@cleverdev.app,035088,ES90209568654031467919,7789.48,2023-03-14T10:04:48,Bilbao,expenses,repairs,-35.52,-23276.1
buyer_7,Agurtzane,Laka,1968-12-31,32779298C,agurtzane.laka@cleverdev.app,035088,ES90209568654031467919,7789.48,2023-03-16T23:25:38,Bilbao,expenses,repairs,-292.85,-23568.95
buyer_7,Agurtzane,Laka,1968-12-31,32779298C,agurtzane.laka@cleverdev.app,035088,ES90209568654031467919,7789.48,2023-03-16T20:32:19,Bilbao,expenses,children,-102.09350000000006,-23671.04
buyer_7,Agurtzane,Laka,1968-12-31,32779298C,agurtzane.laka@cleverdev.app,035088,ES90209568654031467919,7789.48,2023-03-17T17:35:33,Bilbao,expenses,children,-231.24,-23902.28
buyer_7,Agurtzane,Laka,1968-12-31,32779298C,agurtzane.laka@cleverdev.app,035088,ES90209568654031467919,7789.48,2023-03-18T09:52:15,Bilbao,expenses,food,-89.41,-23991.69
buyer_7,Agurtzane,Laka,1968-12-31,32779298C,agurtzane.laka@cleverdev.app,035088,ES90209568654031467919,7789.48,2023-03-21T15:43:29,Bilbao,expenses,cash,-100.0,-24091.69
buyer_7,Agurtzane,Laka,1968-12-31,32779298C,agurtzane.laka@cleverdev.app,035088,ES90209568654031467919,7789.48,2023-03-23T17:34:45,Bilbao,expenses,healthcare,-160.24,-24251.93
buyer_7,Agurtzane,Laka,1968-12-31,32779298C,agurtzane.laka@cleverdev.app,035088,ES90209568654031467919,7789.48,2023-03-25T20:14:27,Bilbao,expenses,clothing,-75.07,-24327.0
buyer_7,Agurtzane,Laka,1968-12-31,32779298C,agurtzane.laka@cleverdev.app,035088,ES90209568654031467919,7789.48,2023-03-27T19:44:00,Bilbao,expenses,food,-111.06,-24438.06
buyer_7,Agurtzane,Laka,1968-12-31,32779298C,agurtzane.laka@cleverdev.app,035088,ES90209568654031467919,7789.48,2023-03-27T14:57:35,Bilbao,expenses,education,-64.93,-24502.99
buyer_7,Agurtzane,Laka,1968-12-31,32779298C,agurtzane.laka@cleverdev.app,035088,ES90209568654031467919,7789.48,2023-03-29T16:50:04,Bilbao,expenses,leisure,-48.04,-24551.03
buyer_7,Agurtzane,Laka,1968-12-31,32779298C,agurtzane.laka@cleverdev.app,035088,ES90209568654031467919,7789.48,2023-03-29T11:10:02,Bilbao,expenses,appliances,-311.63,-24862.66
buyer_7,Agurtzane,Laka,1968-12-31,32779298C,agurtzane.laka@cleverdev.app,035088,ES90209568654031467919,7789.48,2023-03-31T14:03:06,Bilbao,expenses,food,-81.89,-24944.55
buyer_7,Agurtzane,Laka,1968-12-31,32779298C,agurtzane.laka@cleverdev.app,035088,ES90209568654031467919,7789.48,2023-04-01T17:58:26,Bilbao,incomes,salary,1436.92,-23507.63
buyer_7,Agurtzane,Laka,1968-12-31,32779298C,agurtzane.laka@cleverdev.app,035088,ES90209568654031467919,7789.48,2023-04-01T00:34:08,Bilbao,expenses,food,-84.39,-23592.02
buyer_7,Agurtzane,Laka,1968-12-31,32779298C,agurtzane.laka@cleverdev.app,035088,ES90209568654031467919,7789.48,2023-04-01T23:27:56,Bilbao,expenses,transport,-68.41,-23660.43
buyer_7,Agurtzane,Laka,1968-12-31,32779298C,agurtzane.laka@cleverdev.app,035088,ES90209568654031467919,7789.48,2023-04-03T11:50:35,Bilbao,expenses,repairs,-38.03,-23698.46
buyer_7,Agurtzane,Laka,1968-12-31,32779298C,agurtzane.laka@cleverdev.app,035088,ES90209568654031467919,7789.48,2023-04-04T20:59:56,Bilbao,expenses,food,-73.73,-23772.19
buyer_7,Agurtzane,Laka,1968-12-31,32779298C,agurtzane.laka@cleverdev.app,035088,ES90209568654031467919,7789.48,2023-04-05T11:12:09,Bilbao,expenses,mortgage,-582.53,-24354.72
buyer_7,Agurtzane,Laka,1968-12-31,32779298C,agurtzane.laka@cleverdev.app,035088,ES90209568654031467919,7789.48,2023-04-05T08:37:04,Bilbao,expenses,water,-17.77,-24372.49
buyer_7,Agurtzane,Laka,1968-12-31,32779298C,agurtzane.laka@cleverdev.app,035088,ES90209568654031467919,7789.48,2023-04-05T18:35:50,Bilbao,expenses,internet,-30.18,-24402.67
buyer_7,Agurtzane,Laka,1968-12-31,32779298C,agurtzane.laka@cleverdev.app,035088,ES90209568654031467919,7789.48,2023-04-05T10:25:17,Bilbao,expenses,phone,-29.66,-24432.33
buyer_7,Agurtzane,Laka,1968-12-31,32779298C,agurtzane.laka@cleverdev.app,035088,ES90209568654031467919,7789.48,2023-04-05T09:16:44,Bilbao,expenses,healthcare,-80.02,-24512.35
buyer_7,Agurtzane,Laka,1968-12-31,32779298C,agurtzane.laka@cleverdev.app,035088,ES90209568654031467919,7789.48,2023-04-05T18:53:49,Bilbao,expenses,cash,-100.0,-24612.35
buyer_7,Agurtzane,Laka,1968-12-31,32779298C,agurtzane.laka@cleverdev.app,035088,ES90209568654031467919,7789.48,2023-04-06T11:02:04,Bilbao,expenses,gas,-63.39,-24675.74
buyer_7,Agurtzane,Laka,1968-12-31,32779298C,agurtzane.laka@cleverdev.app,035088,ES90209568654031467919,7789.48,2023-04-06T10:45:43,Bilbao,expenses,clothing,-93.42,-24769.16
buyer_7,Agurtzane,Laka,1968-12-31,32779298C,agurtzane.laka@cleverdev.app,035088,ES90209568654031467919,7789.48,2023-04-06T06:21:48,Bilbao,expenses,cash,-100.0,-24869.16
buyer_7,Agurtzane,Laka,1968-12-31,32779298C,agurtzane.laka@cleverdev.app,035088,ES90209568654031467919,7789.48,2023-04-07T17:27:05,Bilbao,expenses,food,-72.4,-24941.56
buyer_7,Agurtzane,Laka,1968-12-31,32779298C,agurtzane.laka@cleverdev.app,035088,ES90209568654031467919,7789.48,2023-04-07T14:34:53,Bilbao,expenses,cash,-100.0,-25041.56
buyer_7,Agurtzane,Laka,1968-12-31,32779298C,agurtzane.laka@cleverdev.app,035088,ES90209568654031467919,7789.48,2023-04-08T20:46:56,Bilbao,expenses,water,-24.44,-25066.0
buyer_7,Agurtzane,Laka,1968-12-31,32779298C,agurtzane.laka@cleverdev.app,035088,ES90209568654031467919,7789.48,2023-04-08T10:42:36,Bilbao,expenses,phone,-24.21,-25090.21
buyer_7,Agurtzane,Laka,1968-12-31,32779298C,agurtzane.laka@cleverdev.app,035088,ES90209568654031467919,7789.48,2023-04-08T13:50:10,Bilbao,expenses,leisure,-71.87,-25162.08
buyer_7,Agurtzane,Laka,1968-12-31,32779298C,agurtzane.laka@cleverdev.app,035088,ES90209568654031467919,7789.48,2023-04-09T10:25:11,Bilbao,expenses,cash,-100.0,-25262.08
buyer_7,Agurtzane,Laka,1968-12-31,32779298C,agurtzane.laka@cleverdev.app,035088,ES90209568654031467919,7789.48,2023-04-10T05:19:56,Bilbao,expenses,transport,-56.22,-25318.3
buyer_7,Agurtzane,Laka,1968-12-31,32779298C,agurtzane.laka@cleverdev.app,035088,ES90209568654031467919,7789.48,2023-04-10T14:06:51,Bilbao,expenses,appliances,-192.19,-25510.49
buyer_7,Agurtzane,Laka,1968-12-31,32779298C,agurtzane.laka@cleverdev.app,035088,ES90209568654031467919,7789.48,2023-04-11T10:24:08,Bilbao,expenses,transport,-48.79,-25559.28
buyer_7,Agurtzane,Laka,1968-12-31,32779298C,agurtzane.laka@cleverdev.app,035088,ES90209568654031467919,7789.48,2023-04-13T18:38:43,Bilbao,expenses,food,-111.61,-25670.89
buyer_7,Agurtzane,Laka,1968-12-31,32779298C,agurtzane.laka@cleverdev.app,035088,ES90209568654031467919,7789.48,2023-04-13T13:28:57,Bilbao,expenses,education,-50.49,-25721.38
buyer_7,Agurtzane,Laka,1968-12-31,32779298C,agurtzane.laka@cleverdev.app,035088,ES90209568654031467919,7789.48,2023-04-13T12:08:32,Bilbao,expenses,repairs,-210.75,-25932.13
buyer_7,Agurtzane,Laka,1968-12-31,32779298C,agurtzane.laka@cleverdev.app,035088,ES90209568654031467919,7789.48,2023-04-14T11:15:39,Bilbao,expenses,healthcare,-43.0,-25975.13
buyer_7,Agurtzane,Laka,1968-12-31,32779298C,agurtzane.laka@cleverdev.app,035088,ES90209568654031467919,7789.48,2023-04-16T10:39:46,Bilbao,expenses,repairs,-288.24,-26263.37
buyer_7,Agurtzane,Laka,1968-12-31,32779298C,agurtzane.laka@cleverdev.app,035088,ES90209568654031467919,7789.48,2023-04-16T14:58:09,Bilbao,expenses,gifts,-101.72,-26365.09
buyer_7,Agurtzane,Laka,1968-12-31,32779298C,agurtzane.laka@cleverdev.app,035088,ES90209568654031467919,7789.48,2023-04-17T08:04:05,Bilbao,expenses,education,-50.01,-26415.1
buyer_7,Agurtzane,Laka,1968-12-31,32779298C,agurtzane.laka@cleverdev.app,035088,ES90209568654031467919,7789.48,2023-04-18T16:18:38,Bilbao,expenses,food,-106.93,-26522.03
buyer_7,Agurtzane,Laka,1968-12-31,32779298C,agurtzane.laka@cleverdev.app,035088,ES90209568654031467919,7789.48,2023-04-18T16:57:35,Bilbao,expenses,transport,-48.23,-26570.26
buyer_7,Agurtzane,Laka,1968-12-31,32779298C,agurtzane.laka@cleverdev.app,035088,ES90209568654031467919,7789.48,2023-04-19T00:02:34,Bilbao,expenses,cash,-100.0,-26670.26
buyer_7,Agurtzane,Laka,1968-12-31,32779298C,agurtzane.laka@cleverdev.app,035088,ES90209568654031467919,7789.48,2023-04-20T11:49:04,Bilbao,expenses,transport,-55.63,-26725.89
buyer_7,Agurtzane,Laka,1968-12-31,32779298C,agurtzane.laka@cleverdev.app,035088,ES90209568654031467919,7789.48,2023-04-21T22:50:44,Bilbao,expenses,food,-69.49,-26795.38
buyer_7,Agurtzane,Laka,1968-12-31,32779298C,agurtzane.laka@cleverdev.app,035088,ES90209568654031467919,7789.48,2023-04-21T15:04:28,Bilbao,expenses,travel,-289.17,-27084.55
buyer_7,Agurtzane,Laka,1968-12-31,32779298C,agurtzane.laka@cleverdev.app,035088,ES90209568654031467919,7789.48,2023-04-22T23:31:14,Bilbao,expenses,transport,-57.19,-27141.74
buyer_7,Agurtzane,Laka,1968-12-31,32779298C,agurtzane.laka@cleverdev.app,035088,ES90209568654031467919,7789.48,2023-04-23T15:49:52,Bilbao,expenses,cash,-100.0,-27241.74
buyer_7,Agurtzane,Laka,1968-12-31,32779298C,agurtzane.laka@cleverdev.app,035088,ES90209568654031467919,7789.48,2023-04-23T17:39:11,Bilbao,expenses,repairs,-168.44,-27410.18
buyer_7,Agurtzane,Laka,1968-12-31,32779298C,agurtzane.laka@cleverdev.app,035088,ES90209568654031467919,7789.48,2023-04-24T16:30:01,Bilbao,expenses,food,-74.54,-27484.72
buyer_7,Agurtzane,Laka,1968-12-31,32779298C,agurtzane.laka@cleverdev.app,035088,ES90209568654031467919,7789.48,2023-04-25T14:29:56,Bilbao,expenses,leisure,-61.92,-27546.64
buyer_7,Agurtzane,Laka,1968-12-31,32779298C,agurtzane.laka@cleverdev.app,035088,ES90209568654031467919,7789.48,2023-04-25T10:21:15,Bilbao,expenses,clothing,-54.44,-27601.08
buyer_7,Agurtzane,Laka,1968-12-31,32779298C,agurtzane.laka@cleverdev.app,035088,ES90209568654031467919,7789.48,2023-04-25T17:58:56,Bilbao,expenses,gifts,-64.38,-27665.46
buyer_7,Agurtzane,Laka,1968-12-31,32779298C,agurtzane.laka@cleverdev.app,035088,ES90209568654031467919,7789.48,2023-04-26T11:02:28,Bilbao,expenses,education,-60.4,-27725.86
buyer_7,Agurtzane,Laka,1968-12-31,32779298C,agurtzane.laka@cleverdev.app,035088,ES90209568654031467919,7789.48,2023-04-27T22:15:18,Bilbao,expenses,food,-74.62,-27800.48
buyer_7,Agurtzane,Laka,1968-12-31,32779298C,agurtzane.laka@cleverdev.app,035088,ES90209568654031467919,7789.48,2023-04-27T00:13:38,Bilbao,expenses,leisure,-61.5,-27861.98
buyer_7,Agurtzane,Laka,1968-12-31,32779298C,agurtzane.laka@cleverdev.app,035088,ES90209568654031467919,7789.48,2023-04-29T08:57:02,Bilbao,expenses,education,-52.56,-27914.54
buyer_7,Agurtzane,Laka,1968-12-31,32779298C,agurtzane.laka@cleverdev.app,035088,ES90209568654031467919,7789.48,2023-04-30T12:23:05,Bilbao,expenses,food,-96.79,-28011.33
buyer_7,Agurtzane,Laka,1968-12-31,32779298C,agurtzane.laka@cleverdev.app,035088,ES90209568654031467919,7789.48,2023-04-30T13:56:07,Bilbao,expenses,transport,-77.23,-28088.56
buyer_7,Agurtzane,Laka,1968-12-31,32779298C,agurtzane.laka@cleverdev.app,035088,ES90209568654031467919,7789.48,2023-05-01T07:23:51,Bilbao,incomes,salary,1436.92,-26651.64
buyer_7,Agurtzane,Laka,1968-12-31,32779298C,agurtzane.laka@cleverdev.app,035088,ES90209568654031467919,7789.48,2023-05-01T07:23:51,Bilbao,incomes,extra_income,242.27,-26409.37
buyer_7,Agurtzane,Laka,1968-12-31,32779298C,agurtzane.laka@cleverdev.app,035088,ES90209568654031467919,7789.48,2023-05-02T08:31:19,Bilbao,expenses,leisure,-25.95,-26435.32
buyer_7,Agurtzane,Laka,1968-12-31,32779298C,agurtzane.laka@cleverdev.app,035088,ES90209568654031467919,7789.48,2023-05-03T16:57:30,Bilbao,expenses,cash,-100.0,-26535.32
buyer_7,Agurtzane,Laka,1968-12-31,32779298C,agurtzane.laka@cleverdev.app,035088,ES90209568654031467919,7789.48,2023-05-04T15:32:45,Bilbao,expenses,cash,-100.0,-26635.32
buyer_7,Agurtzane,Laka,1968-12-31,32779298C,agurtzane.laka@cleverdev.app,035088,ES90209568654031467919,7789.48,2023-05-05T13:54:19,Bilbao,expenses,mortgage,-582.53,-27217.85
buyer_7,Agurtzane,Laka,1968-12-31,32779298C,agurtzane.laka@cleverdev.app,035088,ES90209568654031467919,7789.48,2023-05-05T01:22:14,Bilbao,expenses,gas,-60.65,-27278.5
buyer_7,Agurtzane,Laka,1968-12-31,32779298C,agurtzane.laka@cleverdev.app,035088,ES90209568654031467919,7789.48,2023-05-05T11:51:13,Bilbao,expenses,leisure,-34.59,-27313.09
buyer_7,Agurtzane,Laka,1968-12-31,32779298C,agurtzane.laka@cleverdev.app,035088,ES90209568654031467919,7789.48,2023-05-05T00:38:56,Bilbao,expenses,gifts,-165.71,-27478.8
buyer_7,Agurtzane,Laka,1968-12-31,32779298C,agurtzane.laka@cleverdev.app,035088,ES90209568654031467919,7789.48,2023-05-06T17:30:54,Bilbao,expenses,food,-124.77,-27603.57
buyer_7,Agurtzane,Laka,1968-12-31,32779298C,agurtzane.laka@cleverdev.app,035088,ES90209568654031467919,7789.48,2023-05-06T19:22:14,Bilbao,expenses,clothing,-84.31,-27687.88
buyer_7,Agurtzane,Laka,1968-12-31,32779298C,agurtzane.laka@cleverdev.app,035088,ES90209568654031467919,7789.48,2023-05-07T08:16:14,Bilbao,expenses,gas,-79.09,-27766.97
buyer_7,Agurtzane,Laka,1968-12-31,32779298C,agurtzane.laka@cleverdev.app,035088,ES90209568654031467919,7789.48,2023-05-07T09:06:10,Bilbao,expenses,phone,-31.14,-27798.11
buyer_7,Agurtzane,Laka,1968-12-31,32779298C,agurtzane.laka@cleverdev.app,035088,ES90209568654031467919,7789.48,2023-05-07T14:10:38,Bilbao,expenses,food,-68.17,-27866.28
buyer_7,Agurtzane,Laka,1968-12-31,32779298C,agurtzane.laka@cleverdev.app,035088,ES90209568654031467919,7789.48,2023-05-08T13:28:45,Bilbao,expenses,water,-22.77,-27889.05
buyer_7,Agurtzane,Laka,1968-12-31,32779298C,agurtzane.laka@cleverdev.app,035088,ES90209568654031467919,7789.48,2023-05-09T07:49:28,Bilbao,expenses,appliances,-281.35,-28170.4
buyer_7,Agurtzane,Laka,1968-12-31,32779298C,agurtzane.laka@cleverdev.app,035088,ES90209568654031467919,7789.48,2023-05-10T19:38:09,Bilbao,expenses,transport,-68.75,-28239.15
buyer_7,Agurtzane,Laka,1968-12-31,32779298C,agurtzane.laka@cleverdev.app,035088,ES90209568654031467919,7789.48,2023-05-13T09:29:36,Bilbao,expenses,gifts,-55.06,-28294.21
buyer_7,Agurtzane,Laka,1968-12-31,32779298C,agurtzane.laka@cleverdev.app,035088,ES90209568654031467919,7789.48,2023-05-15T14:19:19,Bilbao,expenses,food,-123.59,-28417.8
buyer_7,Agurtzane,Laka,1968-12-31,32779298C,agurtzane.laka@cleverdev.app,035088,ES90209568654031467919,7789.48,2023-05-16T20:07:42,Bilbao,expenses,leisure,-58.85,-28476.65
buyer_7,Agurtzane,Laka,1968-12-31,32779298C,agurtzane.laka@cleverdev.app,035088,ES90209568654031467919,7789.48,2023-05-17T12:15:53,Bilbao,expenses,education,-47.62,-28524.27
buyer_7,Agurtzane,Laka,1968-12-31,32779298C,agurtzane.laka@cleverdev.app,035088,ES90209568654031467919,7789.48,2023-05-19T20:58:31,Bilbao,expenses,food,-117.52,-28641.79
buyer_7,Agurtzane,Laka,1968-12-31,32779298C,agurtzane.laka@cleverdev.app,035088,ES90209568654031467919,7789.48,2023-05-21T14:25:48,Bilbao,expenses,transport,-52.81,-28694.6
buyer_7,Agurtzane,Laka,1968-12-31,32779298C,agurtzane.laka@cleverdev.app,035088,ES90209568654031467919,7789.48,2023-05-23T13:48:36,Bilbao,expenses,healthcare,-124.72,-28819.32
buyer_7,Agurtzane,Laka,1968-12-31,32779298C,agurtzane.laka@cleverdev.app,035088,ES90209568654031467919,7789.48,2023-05-25T10:51:26,Bilbao,expenses,food,-97.64,-28916.96
buyer_7,Agurtzane,Laka,1968-12-31,32779298C,agurtzane.laka@cleverdev.app,035088,ES90209568654031467919,7789.48,2023-05-25T04:57:53,Bilbao,expenses,leisure,-31.39,-28948.35
buyer_7,Agurtzane,Laka,1968-12-31,32779298C,agurtzane.laka@cleverdev.app,035088,ES90209568654031467919,7789.48,2023-05-25T19:04:14,Bilbao,expenses,healthcare,-61.24,-29009.59
buyer_7,Agurtzane,Laka,1968-12-31,32779298C,agurtzane.laka@cleverdev.app,035088,ES90209568654031467919,7789.48,2023-05-25T17:34:25,Bilbao,expenses,gifts,-177.92,-29187.51
buyer_7,Agurtzane,Laka,1968-12-31,32779298C,agurtzane.laka@cleverdev.app,035088,ES90209568654031467919,7789.48,2023-05-27T13:27:26,Bilbao,expenses,cash,-100.0,-29287.51
buyer_7,Agurtzane,Laka,1968-12-31,32779298C,agurtzane.laka@cleverdev.app,035088,ES90209568654031467919,7789.48,2023-05-27T11:23:13,Bilbao,expenses,repairs,-76.67,-29364.18
buyer_7,Agurtzane,Laka,1968-12-31,32779298C,agurtzane.laka@cleverdev.app,035088,ES90209568654031467919,7789.48,2023-05-28T23:56:09,Bilbao,expenses,repairs,-295.4,-29659.58
buyer_7,Agurtzane,Laka,1968-12-31,32779298C,agurtzane.laka@cleverdev.app,035088,ES90209568654031467919,7789.48,2023-05-29T16:19:55,Bilbao,expenses,food,-121.31,-29780.89
buyer_7,Agurtzane,Laka,1968-12-31,32779298C,agurtzane.laka@cleverdev.app,035088,ES90209568654031467919,7789.48,2023-05-29T19:26:01,Bilbao,expenses,cash,-100.0,-29880.89
buyer_7,Agurtzane,Laka,1968-12-31,32779298C,agurtzane.laka@cleverdev.app,035088,ES90209568654031467919,7789.48,2023-05-30T05:44:48,Bilbao,expenses,food,-105.11,-29986.0
buyer_7,Agurtzane,Laka,1968-12-31,32779298C,agurtzane.laka@cleverdev.app,035088,ES90209568654031467919,7789.48,2023-05-30T10:44:35,Bilbao,expenses,transport,-59.66,-30045.66
buyer_7,Agurtzane,Laka,1968-12-31,32779298C,agurtzane.laka@cleverdev.app,035088,ES90209568654031467919,7789.48,2023-05-31T15:09:24,Bilbao,expenses,healthcare,-179.79,-30225.45
buyer_7,Agurtzane,Laka,1968-12-31,32779298C,agurtzane.laka@cleverdev.app,035088,ES90209568654031467919,7789.48,2023-06-01T10:26:18,Bilbao,incomes,salary,1436.92,-28788.53
buyer_7,Agurtzane,Laka,1968-12-31,32779298C,agurtzane.laka@cleverdev.app,035088,ES90209568654031467919,7789.48,2023-06-01T10:26:18,Bilbao,incomes,salary_bonus,1024.85,-27763.68
buyer_7,Agurtzane,Laka,1968-12-31,32779298C,agurtzane.laka@cleverdev.app,035088,ES90209568654031467919,7789.48,2023-06-01T12:28:24,Bilbao,expenses,taxes,-1237.59,-29001.27
buyer_7,Agurtzane,Laka,1968-12-31,32779298C,agurtzane.laka@cleverdev.app,035088,ES90209568654031467919,7789.48,2023-06-01T10:44:14,Bilbao,expenses,insurance,-387.59,-29388.86
buyer_7,Agurtzane,Laka,1968-12-31,32779298C,agurtzane.laka@cleverdev.app,035088,ES90209568654031467919,7789.48,2023-06-02T19:17:15,Bilbao,expenses,healthcare,-79.14,-29468.0
buyer_7,Agurtzane,Laka,1968-12-31,32779298C,agurtzane.laka@cleverdev.app,035088,ES90209568654031467919,7789.48,2023-06-03T17:07:55,Bilbao,expenses,food,-119.09,-29587.09
buyer_7,Agurtzane,Laka,1968-12-31,32779298C,agurtzane.laka@cleverdev.app,035088,ES90209568654031467919,7789.48,2023-06-05T09:18:10,Bilbao,expenses,mortgage,-582.53,-30169.62
buyer_7,Agurtzane,Laka,1968-12-31,32779298C,agurtzane.laka@cleverdev.app,035088,ES90209568654031467919,7789.48,2023-06-05T23:32:25,Bilbao,expenses,internet,-30.18,-30199.8
buyer_7,Agurtzane,Laka,1968-12-31,32779298C,agurtzane.laka@cleverdev.app,035088,ES90209568654031467919,7789.48,2023-06-06T23:02:17,Bilbao,expenses,electricity,-63.15,-30262.95
buyer_7,Agurtzane,Laka,1968-12-31,32779298C,agurtzane.laka@cleverdev.app,035088,ES90209568654031467919,7789.48,2023-06-06T12:34:19,Bilbao,expenses,gas,-26.79,-30289.74
buyer_7,Agurtzane,Laka,1968-12-31,32779298C,agurtzane.laka@cleverdev.app,035088,ES90209568654031467919,7789.48,2023-06-06T19:44:36,Bilbao,expenses,transport,-61.46,-30351.2
buyer_7,Agurtzane,Laka,1968-12-31,32779298C,agurtzane.laka@cleverdev.app,035088,ES90209568654031467919,7789.48,2023-06-07T08:01:04,Bilbao,expenses,gas,-59.4,-30410.6
buyer_7,Agurtzane,Laka,1968-12-31,32779298C,agurtzane.laka@cleverdev.app,035088,ES90209568654031467919,7789.48,2023-06-07T14:32:22,Bilbao,expenses,internet,-30.18,-30440.78
buyer_7,Agurtzane,Laka,1968-12-31,32779298C,agurtzane.laka@cleverdev.app,035088,ES90209568654031467919,7789.48,2023-06-07T11:24:28,Bilbao,expenses,travel,-351.19,-30791.97
buyer_7,Agurtzane,Laka,1968-12-31,32779298C,agurtzane.laka@cleverdev.app,035088,ES90209568654031467919,7789.48,2023-06-08T18:54:49,Bilbao,expenses,water,-18.49,-30810.46
buyer_7,Agurtzane,Laka,1968-12-31,32779298C,agurtzane.laka@cleverdev.app,035088,ES90209568654031467919,7789.48,2023-06-10T13:28:53,Bilbao,expenses,transport,-46.08,-30856.54
buyer_7,Agurtzane,Laka,1968-12-31,32779298C,agurtzane.laka@cleverdev.app,035088,ES90209568654031467919,7789.48,2023-06-11T09:48:20,Bilbao,expenses,transport,-82.25,-30938.79
buyer_7,Agurtzane,Laka,1968-12-31,32779298C,agurtzane.laka@cleverdev.app,035088,ES90209568654031467919,7789.48,2023-06-11T18:11:07,Bilbao,expenses,healthcare,-125.5,-31064.29
buyer_7,Agurtzane,Laka,1968-12-31,32779298C,agurtzane.laka@cleverdev.app,035088,ES90209568654031467919,7789.48,2023-06-12T09:55:29,Bilbao,expenses,transport,-48.42,-31112.71
buyer_7,Agurtzane,Laka,1968-12-31,32779298C,agurtzane.laka@cleverdev.app,035088,ES90209568654031467919,7789.48,2023-06-12T08:08:44,Bilbao,expenses,repairs,-295.65,-31408.36
buyer_7,Agurtzane,Laka,1968-12-31,32779298C,agurtzane.laka@cleverdev.app,035088,ES90209568654031467919,7789.48,2023-06-13T18:18:56,Bilbao,expenses,food,-94.38,-31502.74
buyer_7,Agurtzane,Laka,1968-12-31,32779298C,agurtzane.laka@cleverdev.app,035088,ES90209568654031467919,7789.48,2023-06-14T04:27:43,Bilbao,expenses,gifts,-332.76,-31835.5
buyer_7,Agurtzane,Laka,1968-12-31,32779298C,agurtzane.laka@cleverdev.app,035088,ES90209568654031467919,7789.48,2023-06-15T16:54:59,Bilbao,expenses,healthcare,-115.99,-31951.49
buyer_7,Agurtzane,Laka,1968-12-31,32779298C,agurtzane.laka@cleverdev.app,035088,ES90209568654031467919,7789.48,2023-06-15T13:28:50,Bilbao,expenses,cash,-100.0,-32051.49
buyer_7,Agurtzane,Laka,1968-12-31,32779298C,agurtzane.laka@cleverdev.app,035088,ES90209568654031467919,7789.48,2023-06-16T10:53:39,Bilbao,expenses,food,-63.51,-32115.0
buyer_7,Agurtzane,Laka,1968-12-31,32779298C,agurtzane.laka@cleverdev.app,035088,ES90209568654031467919,7789.48,2023-06-17T08:32:25,Bilbao,expenses,transport,-83.89,-32198.89
buyer_7,Agurtzane,Laka,1968-12-31,32779298C,agurtzane.laka@cleverdev.app,035088,ES90209568654031467919,7789.48,2023-06-19T20:47:39,Bilbao,expenses,clothing,-150.71,-32349.6
buyer_7,Agurtzane,Laka,1968-12-31,32779298C,agurtzane.laka@cleverdev.app,035088,ES90209568654031467919,7789.48,2023-06-22T21:46:10,Bilbao,expenses,transport,-89.92,-32439.52
buyer_7,Agurtzane,Laka,1968-12-31,32779298C,agurtzane.laka@cleverdev.app,035088,ES90209568654031467919,7789.48,2023-06-22T22:38:36,Bilbao,expenses,leisure,-47.97,-32487.49
buyer_7,Agurtzane,Laka,1968-12-31,32779298C,agurtzane.laka@cleverdev.app,035088,ES90209568654031467919,7789.48,2023-06-25T11:50:15,Bilbao,expenses,cash,-100.0,-32587.49
buyer_7,Agurtzane,Laka,1968-12-31,32779298C,agurtzane.laka@cleverdev.app,035088,ES90209568654031467919,7789.48,2023-06-25T10:49:22,Bilbao,expenses,repairs,-242.33,-32829.82
buyer_7,Agurtzane,Laka,1968-12-31,32779298C,agurtzane.laka@cleverdev.app,035088,ES90209568654031467919,7789.48,2023-06-28T05:24:28,Bilbao,expenses,education,-51.31,-32881.13
buyer_7,Agurtzane,Laka,1968-12-31,32779298C,agurtzane.laka@cleverdev.app,035088,ES90209568654031467919,7789.48,2023-06-28T13:33:52,Bilbao,expenses,gifts,-103.9,-32985.03
buyer_7,Agurtzane,Laka,1968-12-31,32779298C,agurtzane.laka@cleverdev.app,035088,ES90209568654031467919,7789.48,2023-06-29T20:47:02,Bilbao,expenses,food,-116.49,-33101.52
buyer_7,Agurtzane,Laka,1968-12-31,32779298C,agurtzane.laka@cleverdev.app,035088,ES90209568654031467919,7789.48,2023-06-30T22:43:02,Bilbao,expenses,transport,-65.92,-33167.44
buyer_7,Agurtzane,Laka,1968-12-31,32779298C,agurtzane.laka@cleverdev.app,035088,ES90209568654031467919,7789.48,2023-06-30T06:10:41,Bilbao,expenses,leisure,-32.01,-33199.45
buyer_7,Agurtzane,Laka,1968-12-31,32779298C,agurtzane.laka@cleverdev.app,035088,ES90209568654031467919,7789.48,2023-07-01T13:40:53,Bilbao,incomes,salary,1436.92,-31762.53
buyer_7,Agurtzane,Laka,1968-12-31,32779298C,agurtzane.laka@cleverdev.app,035088,ES90209568654031467919,7789.48,2023-07-02T16:46:16,Bilbao,expenses,food,-120.1,-31882.63
buyer_7,Agurtzane,Laka,1968-12-31,32779298C,agurtzane.laka@cleverdev.app,035088,ES90209568654031467919,7789.48,2023-07-02T10:40:29,Bilbao,expenses,leisure,-53.4,-31936.03
buyer_7,Agurtzane,Laka,1968-12-31,32779298C,agurtzane.laka@cleverdev.app,035088,ES90209568654031467919,7789.48,2023-07-02T19:43:05,Bilbao,expenses,cash,-100.0,-32036.03
buyer_7,Agurtzane,Laka,1968-12-31,32779298C,agurtzane.laka@cleverdev.app,035088,ES90209568654031467919,7789.48,2023-07-03T19:16:04,Bilbao,expenses,healthcare,-55.93,-32091.96
buyer_7,Agurtzane,Laka,1968-12-31,32779298C,agurtzane.laka@cleverdev.app,035088,ES90209568654031467919,7789.48,2023-07-03T22:20:17,Bilbao,expenses,education,-51.65,-32143.61
buyer_7,Agurtzane,Laka,1968-12-31,32779298C,agurtzane.laka@cleverdev.app,035088,ES90209568654031467919,7789.48,2023-07-05T09:30:15,Bilbao,expenses,mortgage,-582.53,-32726.14
buyer_7,Agurtzane,Laka,1968-12-31,32779298C,agurtzane.laka@cleverdev.app,035088,ES90209568654031467919,7789.48,2023-07-05T09:30:33,Bilbao,expenses,cash,-100.0,-32826.14
buyer_7,Agurtzane,Laka,1968-12-31,32779298C,agurtzane.laka@cleverdev.app,035088,ES90209568654031467919,7789.48,2023-07-06T10:36:57,Bilbao,expenses,water,-21.31,-32847.45
buyer_7,Agurtzane,Laka,1968-12-31,32779298C,agurtzane.laka@cleverdev.app,035088,ES90209568654031467919,7789.48,2023-07-06T19:19:43,Bilbao,expenses,repairs,-149.98,-32997.43
buyer_7,Agurtzane,Laka,1968-12-31,32779298C,agurtzane.laka@cleverdev.app,035088,ES90209568654031467919,7789.48,2023-07-07T18:05:58,Bilbao,expenses,cash,-100.0,-33097.43
buyer_7,Agurtzane,Laka,1968-12-31,32779298C,agurtzane.laka@cleverdev.app,035088,ES90209568654031467919,7789.48,2023-07-08T17:23:50,Bilbao,expenses,gas,-25.22,-33122.65
buyer_7,Agurtzane,Laka,1968-12-31,32779298C,agurtzane.laka@cleverdev.app,035088,ES90209568654031467919,7789.48,2023-07-08T08:25:40,Bilbao,expenses,food,-97.99,-33220.64
buyer_7,Agurtzane,Laka,1968-12-31,32779298C,agurtzane.laka@cleverdev.app,035088,ES90209568654031467919,7789.48,2023-07-09T08:16:30,Bilbao,expenses,transport,-46.4,-33267.04
buyer_7,Agurtzane,Laka,1968-12-31,32779298C,agurtzane.laka@cleverdev.app,035088,ES90209568654031467919,7789.48,2023-07-11T00:29:20,Bilbao,expenses,cash,-100.0,-33367.04
buyer_7,Agurtzane,Laka,1968-12-31,32779298C,agurtzane.laka@cleverdev.app,035088,ES90209568654031467919,7789.48,2023-07-12T11:47:22,Bilbao,expenses,leisure,-18.4,-33385.44
buyer_7,Agurtzane,Laka,1968-12-31,32779298C,agurtzane.laka@cleverdev.app,035088,ES90209568654031467919,7789.48,2023-07-13T19:52:35,Bilbao,expenses,cash,-100.0,-33485.44
buyer_7,Agurtzane,Laka,1968-12-31,32779298C,agurtzane.laka@cleverdev.app,035088,ES90209568654031467919,7789.48,2023-07-14T17:26:35,Bilbao,expenses,transport,-75.93,-33561.37
buyer_7,Agurtzane,Laka,1968-12-31,32779298C,agurtzane.laka@cleverdev.app,035088,ES90209568654031467919,7789.48,2023-07-15T11:21:27,Bilbao,expenses,children,-238.99,-33800.36
buyer_7,Agurtzane,Laka,1968-12-31,32779298C,agurtzane.laka@cleverdev.app,035088,ES90209568654031467919,7789.48,2023-07-16T09:10:09,Bilbao,expenses,leisure,-18.15,-33818.51
buyer_7,Agurtzane,Laka,1968-12-31,32779298C,agurtzane.laka@cleverdev.app,035088,ES90209568654031467919,7789.48,2023-07-17T18:14:44,Bilbao,expenses,gifts,-102.44,-33920.95
buyer_7,Agurtzane,Laka,1968-12-31,32779298C,agurtzane.laka@cleverdev.app,035088,ES90209568654031467919,7789.48,2023-07-19T20:47:27,Bilbao,expenses,food,-85.01,-34005.96
buyer_7,Agurtzane,Laka,1968-12-31,32779298C,agurtzane.laka@cleverdev.app,035088,ES90209568654031467919,7789.48,2023-07-19T19:14:08,Bilbao,expenses,cash,-100.0,-34105.96
buyer_7,Agurtzane,Laka,1968-12-31,32779298C,agurtzane.laka@cleverdev.app,035088,ES90209568654031467919,7789.48,2023-07-19T15:24:18,Bilbao,expenses,appliances,-200.37,-34306.33
buyer_7,Agurtzane,Laka,1968-12-31,32779298C,agurtzane.laka@cleverdev.app,035088,ES90209568654031467919,7789.48,2023-07-22T08:26:59,Bilbao,expenses,food,-115.89,-34422.22
buyer_7,Agurtzane,Laka,1968-12-31,32779298C,agurtzane.laka@cleverdev.app,035088,ES90209568654031467919,7789.48,2023-07-22T21:59:42,Bilbao,expenses,healthcare,-58.49,-34480.71
buyer_7,Agurtzane,Laka,1968-12-31,32779298C,agurtzane.laka@cleverdev.app,035088,ES90209568654031467919,7789.48,2023-07-22T17:03:39,Bilbao,expenses,appliances,-151.78,-34632.49
buyer_7,Agurtzane,Laka,1968-12-31,32779298C,agurtzane.laka@cleverdev.app,035088,ES90209568654031467919,7789.48,2023-07-23T11:47:33,Bilbao,expenses,cash,-100.0,-34732.49
buyer_7,Agurtzane,Laka,1968-12-31,32779298C,agurtzane.laka@cleverdev.app,035088,ES90209568654031467919,7789.48,2023-07-23T01:10:40,Bilbao,expenses,children,-169.34,-34901.83
buyer_7,Agurtzane,Laka,1968-12-31,32779298C,agurtzane.laka@cleverdev.app,035088,ES90209568654031467919,7789.48,2023-07-24T08:01:24,Bilbao,expenses,transport,-87.05,-34988.88
buyer_7,Agurtzane,Laka,1968-12-31,32779298C,agurtzane.laka@cleverdev.app,035088,ES90209568654031467919,7789.48,2023-07-25T16:58:56,Bilbao,expenses,cash,-100.0,-35088.88
buyer_7,Agurtzane,Laka,1968-12-31,32779298C,agurtzane.laka@cleverdev.app,035088,ES90209568654031467919,7789.48,2023-07-26T19:26:04,Bilbao,expenses,transport,-72.39,-35161.27
buyer_7,Agurtzane,Laka,1968-12-31,32779298C,agurtzane.laka@cleverdev.app,035088,ES90209568654031467919,7789.48,2023-07-28T23:52:37,Bilbao,expenses,education,-61.17,-35222.44
buyer_7,Agurtzane,Laka,1968-12-31,32779298C,agurtzane.laka@cleverdev.app,035088,ES90209568654031467919,7789.48,2023-07-28T16:01:11,Bilbao,expenses,children,-87.41,-35309.85
buyer_7,Agurtzane,Laka,1968-12-31,32779298C,agurtzane.laka@cleverdev.app,035088,ES90209568654031467919,7789.48,2023-07-31T20:30:58,Bilbao,expenses,food,-117.26,-35427.11
buyer_7,Agurtzane,Laka,1968-12-31,32779298C,agurtzane.laka@cleverdev.app,035088,ES90209568654031467919,7789.48,2023-07-31T22:10:17,Bilbao,expenses,transport,-61.43,-35488.54
buyer_7,Agurtzane,Laka,1968-12-31,32779298C,agurtzane.laka@cleverdev.app,035088,ES90209568654031467919,7789.48,2023-08-01T12:45:02,Bilbao,incomes,salary,1436.92,-34051.62
buyer_7,Agurtzane,Laka,1968-12-31,32779298C,agurtzane.laka@cleverdev.app,035088,ES90209568654031467919,7789.48,2023-08-01T12:45:02,Bilbao,incomes,extra_income,242.27,-33809.35
buyer_7,Agurtzane,Laka,1968-12-31,32779298C,agurtzane.laka@cleverdev.app,035088,ES90209568654031467919,7789.48,2023-08-02T20:27:01,Bilbao,expenses,transport,-73.24,-33882.59
buyer_7,Agurtzane,Laka,1968-12-31,32779298C,agurtzane.laka@cleverdev.app,035088,ES90209568654031467919,7789.48,2023-08-02T01:24:04,Bilbao,expenses,gifts,-309.47,-34192.06
buyer_7,Agurtzane,Laka,1968-12-31,32779298C,agurtzane.laka@cleverdev.app,035088,ES90209568654031467919,7789.48,2023-08-03T18:09:52,Bilbao,expenses,children,-191.26,-34383.32
buyer_7,Agurtzane,Laka,1968-12-31,32779298C,agurtzane.laka@cleverdev.app,035088,ES90209568654031467919,7789.48,2023-08-04T09:07:04,Bilbao,expenses,healthcare,-169.33,-34552.65
buyer_7,Agurtzane,Laka,1968-12-31,32779298C,agurtzane.laka@cleverdev.app,035088,ES90209568654031467919,7789.48,2023-08-04T12:01:40,Bilbao,expenses,education,-67.46,-34620.11
buyer_7,Agurtzane,Laka,1968-12-31,32779298C,agurtzane.laka@cleverdev.app,035088,ES90209568654031467919,7789.48,2023-08-04T13:06:50,Bilbao,expenses,children,-68.02,-34688.13
buyer_7,Agurtzane,Laka,1968-12-31,32779298C,agurtzane.laka@cleverdev.app,035088,ES90209568654031467919,7789.48,2023-08-05T09:41:33,Bilbao,expenses,mortgage,-582.53,-35270.66
buyer_7,Agurtzane,Laka,1968-12-31,32779298C,agurtzane.laka@cleverdev.app,035088,ES90209568654031467919,7789.48,2023-08-05T15:13:41,Bilbao,expenses,electricity,-28.93,-35299.59
buyer_7,Agurtzane,Laka,1968-12-31,32779298C,agurtzane.laka@cleverdev.app,035088,ES90209568654031467919,7789.48,2023-08-06T22:53:37,Bilbao,expenses,food,-118.99,-35418.58
buyer_7,Agurtzane,Laka,1968-12-31,32779298C,agurtzane.laka@cleverdev.app,035088,ES90209568654031467919,7789.48,2023-08-06T21:15:09,Bilbao,expenses,transport,-68.03,-35486.61
buyer_7,Agurtzane,Laka,1968-12-31,32779298C,agurtzane.laka@cleverdev.app,035088,ES90209568654031467919,7789.48,2023-08-07T14:44:54,Bilbao,expenses,water,-29.29,-35515.9
buyer_7,Agurtzane,Laka,1968-12-31,32779298C,agurtzane.laka@cleverdev.app,035088,ES90209568654031467919,7789.48,2023-08-07T08:58:00,Bilbao,expenses,cash,-100.0,-35615.9
buyer_7,Agurtzane,Laka,1968-12-31,32779298C,agurtzane.laka@cleverdev.app,035088,ES90209568654031467919,7789.48,2023-08-08T12:32:43,Bilbao,expenses,internet,-30.18,-35646.08
buyer_7,Agurtzane,Laka,1968-12-31,32779298C,agurtzane.laka@cleverdev.app,035088,ES90209568654031467919,7789.48,2023-08-08T11:39:17,Bilbao,expenses,food,-92.93,-35739.01
buyer_7,Agurtzane,Laka,1968-12-31,32779298C,agurtzane.laka@cleverdev.app,035088,ES90209568654031467919,7789.48,2023-08-08T05:47:14,Bilbao,expenses,leisure,-21.05,-35760.06
buyer_7,Agurtzane,Laka,1968-12-31,32779298C,agurtzane.laka@cleverdev.app,035088,ES90209568654031467919,7789.48,2023-08-13T13:26:37,Bilbao,expenses,education,-72.76,-35832.82
buyer_7,Agurtzane,Laka,1968-12-31,32779298C,agurtzane.laka@cleverdev.app,035088,ES90209568654031467919,7789.48,2023-08-14T21:06:59,Bilbao,expenses,cash,-100.0,-35932.82
buyer_7,Agurtzane,Laka,1968-12-31,32779298C,agurtzane.laka@cleverdev.app,035088,ES90209568654031467919,7789.48,2023-08-15T16:43:03,Bilbao,expenses,cash,-100.0,-36032.82
buyer_7,Agurtzane,Laka,1968-12-31,32779298C,agurtzane.laka@cleverdev.app,035088,ES90209568654031467919,7789.48,2023-08-20T05:12:33,Bilbao,expenses,food,-83.12,-36115.94
buyer_7,Agurtzane,Laka,1968-12-31,32779298C,agurtzane.laka@cleverdev.app,035088,ES90209568654031467919,7789.48,2023-08-21T13:55:05,Bilbao,expenses,gifts,-99.2,-36215.14
buyer_7,Agurtzane,Laka,1968-12-31,32779298C,agurtzane.laka@cleverdev.app,035088,ES90209568654031467919,7789.48,2023-08-22T11:47:56,Bilbao,expenses,cash,-100.0,-36315.14
buyer_7,Agurtzane,Laka,1968-12-31,32779298C,agurtzane.laka@cleverdev.app,035088,ES90209568654031467919,7789.48,2023-08-23T11:18:35,Bilbao,expenses,food,-86.98,-36402.12
buyer_7,Agurtzane,Laka,1968-12-31,32779298C,agurtzane.laka@cleverdev.app,035088,ES90209568654031467919,7789.48,2023-08-26T08:45:35,Bilbao,expenses,clothing,-136.44,-36538.56
buyer_7,Agurtzane,Laka,1968-12-31,32779298C,agurtzane.laka@cleverdev.app,035088,ES90209568654031467919,7789.48,2023-08-27T12:38:20,Bilbao,expenses,food,-77.45,-36616.01
buyer_7,Agurtzane,Laka,1968-12-31,32779298C,agurtzane.laka@cleverdev.app,035088,ES90209568654031467919,7789.48,2023-08-27T19:59:15,Bilbao,expenses,leisure,-66.55,-36682.56
buyer_7,Agurtzane,Laka,1968-12-31,32779298C,agurtzane.laka@cleverdev.app,035088,ES90209568654031467919,7789.48,2023-08-29T08:44:22,Bilbao,expenses,cash,-100.0,-36782.56
buyer_7,Agurtzane,Laka,1968-12-31,32779298C,agurtzane.laka@cleverdev.app,035088,ES90209568654031467919,7789.48,2023-08-31T10:04:32,Bilbao,expenses,transport,-59.34,-36841.9
buyer_7,Agurtzane,Laka,1968-12-31,32779298C,agurtzane.laka@cleverdev.app,035088,ES90209568654031467919,7789.48,2023-09-01T12:40:59,Bilbao,incomes,salary,1436.92,-35404.98
buyer_7,Agurtzane,Laka,1968-12-31,32779298C,agurtzane.laka@cleverdev.app,035088,ES90209568654031467919,7789.48,2023-09-01T15:42:32,Bilbao,expenses,food,-116.46,-35521.44
buyer_7,Agurtzane,Laka,1968-12-31,32779298C,agurtzane.laka@cleverdev.app,035088,ES90209568654031467919,7789.48,2023-09-03T11:27:33,Bilbao,expenses,food,-68.95,-35590.39
buyer_7,Agurtzane,Laka,1968-12-31,32779298C,agurtzane.laka@cleverdev.app,035088,ES90209568654031467919,7789.48,2023-09-03T12:21:00,Bilbao,expenses,repairs,-223.62,-35814.01
buyer_7,Agurtzane,Laka,1968-12-31,32779298C,agurtzane.laka@cleverdev.app,035088,ES90209568654031467919,7789.48,2023-09-05T19:15:49,Bilbao,expenses,mortgage,-582.53,-36396.54
buyer_7,Agurtzane,Laka,1968-12-31,32779298C,agurtzane.laka@cleverdev.app,035088,ES90209568654031467919,7789.48,2023-09-05T11:05:39,Bilbao,expenses,internet,-30.18,-36426.72
buyer_7,Agurtzane,Laka,1968-12-31,32779298C,agurtzane.laka@cleverdev.app,035088,ES90209568654031467919,7789.48,2023-09-05T01:34:45,Bilbao,expenses,food,-78.7,-36505.42
buyer_7,Agurtzane,Laka,1968-12-31,32779298C,agurtzane.laka@cleverdev.app,035088,ES90209568654031467919,7789.48,2023-09-06T18:04:30,Bilbao,expenses,internet,-30.18,-36535.6
buyer_7,Agurtzane,Laka,1968-12-31,32779298C,agurtzane.laka@cleverdev.app,035088,ES90209568654031467919,7789.48,2023-09-06T09:42:06,Bilbao,expenses,transport,-43.81,-36579.41
buyer_7,Agurtzane,Laka,1968-12-31,32779298C,agurtzane.laka@cleverdev.app,035088,ES90209568654031467919,7789.48,2023-09-07T09:45:53,Bilbao,expenses,gas,-58.55,-36637.96
buyer_7,Agurtzane,Laka,1968-12-31,32779298C,agurtzane.laka@cleverdev.app,035088,ES90209568654031467919,7789.48,2023-09-07T14:26:57,Bilbao,expenses,transport,-55.47,-36693.43
buyer_7,Agurtzane,Laka,1968-12-31,32779298C,agurtzane.laka@cleverdev.app,035088,ES90209568654031467919,7789.48,2023-09-07T05:26:07,Bilbao,expenses,travel,-318.21,-37011.64
buyer_7,Agurtzane,Laka,1968-12-31,32779298C,agurtzane.laka@cleverdev.app,035088,ES90209568654031467919,7789.48,2023-09-08T13:25:56,Bilbao,expenses,water,-17.27,-37028.91
buyer_7,Agurtzane,Laka,1968-12-31,32779298C,agurtzane.laka@cleverdev.app,035088,ES90209568654031467919,7789.48,2023-09-10T12:00:35,Bilbao,expenses,transport,-45.96,-37074.87
buyer_7,Agurtzane,Laka,1968-12-31,32779298C,agurtzane.laka@cleverdev.app,035088,ES90209568654031467919,7789.48,2023-09-11T16:22:28,Bilbao,expenses,cash,-100.0,-37174.87
buyer_7,Agurtzane,Laka,1968-12-31,32779298C,agurtzane.laka@cleverdev.app,035088,ES90209568654031467919,7789.48,2023-09-13T23:49:27,Bilbao,expenses,education,-42.52,-37217.39
buyer_7,Agurtzane,Laka,1968-12-31,32779298C,agurtzane.laka@cleverdev.app,035088,ES90209568654031467919,7789.48,2023-09-15T10:19:13,Bilbao,expenses,cash,-100.0,-37317.39
buyer_7,Agurtzane,Laka,1968-12-31,32779298C,agurtzane.laka@cleverdev.app,035088,ES90209568654031467919,7789.48,2023-09-17T10:31:44,Bilbao,expenses,appliances,-388.83,-37706.22
buyer_7,Agurtzane,Laka,1968-12-31,32779298C,agurtzane.laka@cleverdev.app,035088,ES90209568654031467919,7789.48,2023-09-17T12:01:44,Bilbao,expenses,repairs,-26.52,-37732.74
buyer_7,Agurtzane,Laka,1968-12-31,32779298C,agurtzane.laka@cleverdev.app,035088,ES90209568654031467919,7789.48,2023-09-18T17:34:14,Bilbao,expenses,transport,-45.2,-37777.94
buyer_7,Agurtzane,Laka,1968-12-31,32779298C,agurtzane.laka@cleverdev.app,035088,ES90209568654031467919,7789.48,2023-09-20T12:19:43,Bilbao,expenses,cash,-100.0,-37877.94
buyer_7,Agurtzane,Laka,1968-12-31,32779298C,agurtzane.laka@cleverdev.app,035088,ES90209568654031467919,7789.48,2023-09-22T17:31:54,Bilbao,expenses,leisure,-28.57,-37906.51
buyer_7,Agurtzane,Laka,1968-12-31,32779298C,agurtzane.laka@cleverdev.app,035088,ES90209568654031467919,7789.48,2023-09-23T13:04:56,Bilbao,expenses,repairs,-245.7,-38152.21
buyer_7,Agurtzane,Laka,1968-12-31,32779298C,agurtzane.laka@cleverdev.app,035088,ES90209568654031467919,7789.48,2023-09-24T08:34:27,Bilbao,expenses,transport,-75.12,-38227.33
buyer_7,Agurtzane,Laka,1968-12-31,32779298C,agurtzane.laka@cleverdev.app,035088,ES90209568654031467919,7789.48,2023-09-24T18:09:15,Bilbao,expenses,cash,-100.0,-38327.33
buyer_7,Agurtzane,Laka,1968-12-31,32779298C,agurtzane.laka@cleverdev.app,035088,ES90209568654031467919,7789.48,2023-09-24T18:00:35,Bilbao,expenses,children,-120.82,-38448.15
buyer_7,Agurtzane,Laka,1968-12-31,32779298C,agurtzane.laka@cleverdev.app,035088,ES90209568654031467919,7789.48,2023-09-26T11:43:37,Bilbao,expenses,transport,-74.39,-38522.54
buyer_7,Agurtzane,Laka,1968-12-31,32779298C,agurtzane.laka@cleverdev.app,035088,ES90209568654031467919,7789.48,2023-09-26T12:18:24,Bilbao,expenses,clothing,-62.32,-38584.86
buyer_7,Agurtzane,Laka,1968-12-31,32779298C,agurtzane.laka@cleverdev.app,035088,ES90209568654031467919,7789.48,2023-09-26T14:49:12,Bilbao,expenses,cash,-100.0,-38684.86
buyer_7,Agurtzane,Laka,1968-12-31,32779298C,agurtzane.laka@cleverdev.app,035088,ES90209568654031467919,7789.48,2023-09-27T17:54:05,Bilbao,expenses,transport,-75.93,-38760.79
buyer_7,Agurtzane,Laka,1968-12-31,32779298C,agurtzane.laka@cleverdev.app,035088,ES90209568654031467919,7789.48,2023-09-27T14:54:31,Bilbao,expenses,leisure,-69.63,-38830.42
buyer_7,Agurtzane,Laka,1968-12-31,32779298C,agurtzane.laka@cleverdev.app,035088,ES90209568654031467919,7789.48,2023-09-27T18:49:04,Bilbao,expenses,appliances,-154.6,-38985.02
buyer_7,Agurtzane,Laka,1968-12-31,32779298C,agurtzane.laka@cleverdev.app,035088,ES90209568654031467919,7789.48,2023-10-01T10:57:01,Bilbao,incomes,salary,1436.92,-37548.1
buyer_7,Agurtzane,Laka,1968-12-31,32779298C,agurtzane.laka@cleverdev.app,035088,ES90209568654031467919,7789.48,2023-10-01T14:46:00,Bilbao,expenses,education,-50.58,-37598.68
buyer_7,Agurtzane,Laka,1968-12-31,32779298C,agurtzane.laka@cleverdev.app,035088,ES90209568654031467919,7789.48,2023-10-01T10:58:11,Bilbao,expenses,cash,-100.0,-37698.68
buyer_7,Agurtzane,Laka,1968-12-31,32779298C,agurtzane.laka@cleverdev.app,035088,ES90209568654031467919,7789.48,2023-10-04T08:16:08,Bilbao,expenses,food,-82.13,-37780.81
buyer_7,Agurtzane,Laka,1968-12-31,32779298C,agurtzane.laka@cleverdev.app,035088,ES90209568654031467919,7789.48,2023-10-04T10:32:01,Bilbao,expenses,clothing,-118.69,-37899.5
buyer_7,Agurtzane,Laka,1968-12-31,32779298C,agurtzane.laka@cleverdev.app,035088,ES90209568654031467919,7789.48,2023-10-04T08:22:44,Bilbao,expenses,gifts,-81.54,-37981.04
buyer_7,Agurtzane,Laka,1968-12-31,32779298C,agurtzane.laka@cleverdev.app,035088,ES90209568654031467919,7789.48,2023-10-05T09:52:25,Bilbao,expenses,mortgage,-582.53,-38563.57
buyer_7,Agurtzane,Laka,1968-12-31,32779298C,agurtzane.laka@cleverdev.app,035088,ES90209568654031467919,7789.48,2023-10-05T12:34:54,Bilbao,expenses,phone,-27.5,-38591.07
buyer_7,Agurtzane,Laka,1968-12-31,32779298C,agurtzane.laka@cleverdev.app,035088,ES90209568654031467919,7789.48,2023-10-06T19:14:35,Bilbao,expenses,electricity,-35.67,-38626.74
buyer_7,Agurtzane,Laka,1968-12-31,32779298C,agurtzane.laka@cleverdev.app,035088,ES90209568654031467919,7789.48,2023-10-06T20:19:04,Bilbao,expenses,gas,-80.58,-38707.32
buyer_7,Agurtzane,Laka,1968-12-31,32779298C,agurtzane.laka@cleverdev.app,035088,ES90209568654031467919,7789.48,2023-10-07T16:32:31,Bilbao,expenses,water,-18.34,-38725.66
buyer_7,Agurtzane,Laka,1968-12-31,32779298C,agurtzane.laka@cleverdev.app,035088,ES90209568654031467919,7789.48,2023-10-07T14:19:38,Bilbao,expenses,phone,-31.56,-38757.22
buyer_7,Agurtzane,Laka,1968-12-31,32779298C,agurtzane.laka@cleverdev.app,035088,ES90209568654031467919,7789.48,2023-10-07T09:25:57,Bilbao,expenses,food,-120.8,-38878.02
buyer_7,Agurtzane,Laka,1968-12-31,32779298C,agurtzane.laka@cleverdev.app,035088,ES90209568654031467919,7789.48,2023-10-09T17:03:09,Bilbao,expenses,cash,-100.0,-38978.02
buyer_7,Agurtzane,Laka,1968-12-31,32779298C,agurtzane.laka@cleverdev.app,035088,ES90209568654031467919,7789.48,2023-10-12T07:20:49,Bilbao,expenses,travel,-349.6,-39327.62
buyer_7,Agurtzane,Laka,1968-12-31,32779298C,agurtzane.laka@cleverdev.app,035088,ES90209568654031467919,7789.48,2023-10-16T03:37:15,Bilbao,expenses,food,-81.7,-39409.32
buyer_7,Agurtzane,Laka,1968-12-31,32779298C,agurtzane.laka@cleverdev.app,035088,ES90209568654031467919,7789.48,2023-10-20T13:45:08,Bilbao,expenses,clothing,-60.21,-39469.53
buyer_7,Agurtzane,Laka,1968-12-31,32779298C,agurtzane.laka@cleverdev.app,035088,ES90209568654031467919,7789.48,2023-10-21T11:28:34,Bilbao,expenses,cash,-100.0,-39569.53
buyer_7,Agurtzane,Laka,1968-12-31,32779298C,agurtzane.laka@cleverdev.app,035088,ES90209568654031467919,7789.48,2023-10-23T16:56:03,Bilbao,expenses,education,-59.93,-39629.46
buyer_7,Agurtzane,Laka,1968-12-31,32779298C,agurtzane.laka@cleverdev.app,035088,ES90209568654031467919,7789.48,2023-10-23T10:04:14,Bilbao,expenses,cash,-100.0,-39729.46
buyer_7,Agurtzane,Laka,1968-12-31,32779298C,agurtzane.laka@cleverdev.app,035088,ES90209568654031467919,7789.48,2023-10-23T12:32:00,Bilbao,expenses,appliances,-207.78,-39937.24
buyer_7,Agurtzane,Laka,1968-12-31,32779298C,agurtzane.laka@cleverdev.app,035088,ES90209568654031467919,7789.48,2023-10-27T13:17:52,Bilbao,expenses,transport,-80.94,-40018.18
buyer_7,Agurtzane,Laka,1968-12-31,32779298C,agurtzane.laka@cleverdev.app,035088,ES90209568654031467919,7789.48,2023-10-27T16:24:12,Bilbao,expenses,cash,-100.0,-40118.18
buyer_7,Agurtzane,Laka,1968-12-31,32779298C,agurtzane.laka@cleverdev.app,035088,ES90209568654031467919,7789.48,2023-10-27T10:53:20,Bilbao,expenses,travel,-228.29,-40346.47
buyer_7,Agurtzane,Laka,1968-12-31,32779298C,agurtzane.laka@cleverdev.app,035088,ES90209568654031467919,7789.48,2023-10-28T08:04:37,Bilbao,expenses,healthcare,-86.97,-40433.44
buyer_7,Agurtzane,Laka,1968-12-31,32779298C,agurtzane.laka@cleverdev.app,035088,ES90209568654031467919,7789.48,2023-10-30T16:52:49,Bilbao,expenses,clothing,-148.39,-40581.83
buyer_7,Agurtzane,Laka,1968-12-31,32779298C,agurtzane.laka@cleverdev.app,035088,ES90209568654031467919,7789.48,2023-11-01T21:41:51,Bilbao,incomes,salary,1436.92,-39144.91
buyer_7,Agurtzane,Laka,1968-12-31,32779298C,agurtzane.laka@cleverdev.app,035088,ES90209568654031467919,7789.48,2023-11-01T19:12:33,Bilbao,expenses,food,-64.36,-39209.27
buyer_7,Agurtzane,Laka,1968-12-31,32779298C,agurtzane.laka@cleverdev.app,035088,ES90209568654031467919,7789.48,2023-11-01T19:03:01,Bilbao,expenses,cash,-100.0,-39309.27
buyer_7,Agurtzane,Laka,1968-12-31,32779298C,agurtzane.laka@cleverdev.app,035088,ES90209568654031467919,7789.48,2023-11-02T16:12:48,Bilbao,expenses,cash,-100.0,-39409.27
buyer_7,Agurtzane,Laka,1968-12-31,32779298C,agurtzane.laka@cleverdev.app,035088,ES90209568654031467919,7789.48,2023-11-03T02:03:22,Bilbao,expenses,healthcare,-140.47,-39549.74
buyer_7,Agurtzane,Laka,1968-12-31,32779298C,agurtzane.laka@cleverdev.app,035088,ES90209568654031467919,7789.48,2023-11-04T12:24:32,Bilbao,expenses,food,-123.15,-39672.89
buyer_7,Agurtzane,Laka,1968-12-31,32779298C,agurtzane.laka@cleverdev.app,035088,ES90209568654031467919,7789.48,2023-11-04T00:41:16,Bilbao,expenses,leisure,-29.38,-39702.27
buyer_7,Agurtzane,Laka,1968-12-31,32779298C,agurtzane.laka@cleverdev.app,035088,ES90209568654031467919,7789.48,2023-11-05T23:45:32,Bilbao,expenses,mortgage,-582.53,-40284.8
buyer_7,Agurtzane,Laka,1968-12-31,32779298C,agurtzane.laka@cleverdev.app,035088,ES90209568654031467919,7789.48,2023-11-05T08:54:56,Bilbao,expenses,leisure,-27.04,-40311.84
buyer_7,Agurtzane,Laka,1968-12-31,32779298C,agurtzane.laka@cleverdev.app,035088,ES90209568654031467919,7789.48,2023-11-06T11:53:15,Bilbao,expenses,gas,-24.17,-40336.01
buyer_7,Agurtzane,Laka,1968-12-31,32779298C,agurtzane.laka@cleverdev.app,035088,ES90209568654031467919,7789.48,2023-11-06T16:54:28,Bilbao,expenses,phone,-22.35,-40358.36
buyer_7,Agurtzane,Laka,1968-12-31,32779298C,agurtzane.laka@cleverdev.app,035088,ES90209568654031467919,7789.48,2023-11-06T15:17:00,Bilbao,expenses,clothing,-120.96,-40479.32
buyer_7,Agurtzane,Laka,1968-12-31,32779298C,agurtzane.laka@cleverdev.app,035088,ES90209568654031467919,7789.48,2023-11-06T08:33:28,Bilbao,expenses,education,-42.16,-40521.48
buyer_7,Agurtzane,Laka,1968-12-31,32779298C,agurtzane.laka@cleverdev.app,035088,ES90209568654031467919,7789.48,2023-11-06T14:58:08,Bilbao,expenses,cash,-100.0,-40621.48
buyer_7,Agurtzane,Laka,1968-12-31,32779298C,agurtzane.laka@cleverdev.app,035088,ES90209568654031467919,7789.48,2023-11-07T19:04:26,Bilbao,expenses,cash,-100.0,-40721.48
buyer_7,Agurtzane,Laka,1968-12-31,32779298C,agurtzane.laka@cleverdev.app,035088,ES90209568654031467919,7789.48,2023-11-08T15:34:05,Bilbao,expenses,gas,-48.84,-40770.32
buyer_7,Agurtzane,Laka,1968-12-31,32779298C,agurtzane.laka@cleverdev.app,035088,ES90209568654031467919,7789.48,2023-11-08T14:19:34,Bilbao,expenses,leisure,-63.81,-40834.13
buyer_7,Agurtzane,Laka,1968-12-31,32779298C,agurtzane.laka@cleverdev.app,035088,ES90209568654031467919,7789.48,2023-11-08T20:51:09,Bilbao,expenses,clothing,-152.26,-40986.39
buyer_7,Agurtzane,Laka,1968-12-31,32779298C,agurtzane.laka@cleverdev.app,035088,ES90209568654031467919,7789.48,2023-11-08T13:32:53,Bilbao,expenses,children,-178.8735000000001,-41165.26
buyer_7,Agurtzane,Laka,1968-12-31,32779298C,agurtzane.laka@cleverdev.app,035088,ES90209568654031467919,7789.48,2023-11-09T09:00:28,Bilbao,expenses,clothing,-67.28,-41232.54
buyer_7,Agurtzane,Laka,1968-12-31,32779298C,agurtzane.laka@cleverdev.app,035088,ES90209568654031467919,7789.48,2023-11-11T17:13:01,Bilbao,expenses,cash,-100.0,-41332.54
buyer_7,Agurtzane,Laka,1968-12-31,32779298C,agurtzane.laka@cleverdev.app,035088,ES90209568654031467919,7789.48,2023-11-14T18:23:56,Bilbao,expenses,food,-98.45,-41430.99
buyer_7,Agurtzane,Laka,1968-12-31,32779298C,agurtzane.laka@cleverdev.app,035088,ES90209568654031467919,7789.48,2023-11-15T15:16:09,Bilbao,expenses,leisure,-44.81,-41475.8
buyer_7,Agurtzane,Laka,1968-12-31,32779298C,agurtzane.laka@cleverdev.app,035088,ES90209568654031467919,7789.48,2023-11-15T14:43:39,Bilbao,expenses,cash,-100.0,-41575.8
buyer_7,Agurtzane,Laka,1968-12-31,32779298C,agurtzane.laka@cleverdev.app,035088,ES90209568654031467919,7789.48,2023-11-15T13:11:32,Bilbao,expenses,children,-250.13350000000008,-41825.93
buyer_7,Agurtzane,Laka,1968-12-31,32779298C,agurtzane.laka@cleverdev.app,035088,ES90209568654031467919,7789.48,2023-11-16T19:09:53,Bilbao,expenses,food,-69.41,-41895.34
buyer_7,Agurtzane,Laka,1968-12-31,32779298C,agurtzane.laka@cleverdev.app,035088,ES90209568654031467919,7789.48,2023-11-17T08:30:54,Bilbao,expenses,children,-177.74,-42073.08
buyer_7,Agurtzane,Laka,1968-12-31,32779298C,agurtzane.laka@cleverdev.app,035088,ES90209568654031467919,7789.48,2023-11-18T12:10:32,Bilbao,expenses,cash,-100.0,-42173.08
buyer_7,Agurtzane,Laka,1968-12-31,32779298C,agurtzane.laka@cleverdev.app,035088,ES90209568654031467919,7789.48,2023-11-19T11:38:00,Bilbao,expenses,transport,-74.53,-42247.61
buyer_7,Agurtzane,Laka,1968-12-31,32779298C,agurtzane.laka@cleverdev.app,035088,ES90209568654031467919,7789.48,2023-11-20T22:56:26,Bilbao,expenses,leisure,-81.63,-42329.24
buyer_7,Agurtzane,Laka,1968-12-31,32779298C,agurtzane.laka@cleverdev.app,035088,ES90209568654031467919,7789.48,2023-11-21T10:57:30,Bilbao,expenses,cash,-100.0,-42429.24
buyer_7,Agurtzane,Laka,1968-12-31,32779298C,agurtzane.laka@cleverdev.app,035088,ES90209568654031467919,7789.48,2023-11-21T12:47:32,Bilbao,expenses,repairs,-78.71,-42507.95
buyer_7,Agurtzane,Laka,1968-12-31,32779298C,agurtzane.laka@cleverdev.app,035088,ES90209568654031467919,7789.48,2023-11-22T20:52:57,Bilbao,expenses,clothing,-103.98,-42611.93
buyer_7,Agurtzane,Laka,1968-12-31,32779298C,agurtzane.laka@cleverdev.app,035088,ES90209568654031467919,7789.48,2023-11-22T10:25:45,Bilbao,expenses,cash,-100.0,-42711.93
buyer_7,Agurtzane,Laka,1968-12-31,32779298C,agurtzane.laka@cleverdev.app,035088,ES90209568654031467919,7789.48,2023-11-23T20:49:10,Bilbao,expenses,transport,-62.08,-42774.01
buyer_7,Agurtzane,Laka,1968-12-31,32779298C,agurtzane.laka@cleverdev.app,035088,ES90209568654031467919,7789.48,2023-11-24T02:25:09,Bilbao,expenses,repairs,-198.55,-42972.56
buyer_7,Agurtzane,Laka,1968-12-31,32779298C,agurtzane.laka@cleverdev.app,035088,ES90209568654031467919,7789.48,2023-11-25T12:58:00,Bilbao,expenses,gifts,-352.19,-43324.75
buyer_7,Agurtzane,Laka,1968-12-31,32779298C,agurtzane.laka@cleverdev.app,035088,ES90209568654031467919,7789.48,2023-11-26T10:56:25,Bilbao,expenses,food,-64.62,-43389.37
buyer_7,Agurtzane,Laka,1968-12-31,32779298C,agurtzane.laka@cleverdev.app,035088,ES90209568654031467919,7789.48,2023-11-27T13:53:10,Bilbao,expenses,food,-121.21,-43510.58
buyer_7,Agurtzane,Laka,1968-12-31,32779298C,agurtzane.laka@cleverdev.app,035088,ES90209568654031467919,7789.48,2023-11-28T08:32:01,Bilbao,expenses,cash,-100.0,-43610.58
buyer_7,Agurtzane,Laka,1968-12-31,32779298C,agurtzane.laka@cleverdev.app,035088,ES90209568654031467919,7789.48,2023-11-29T12:52:14,Bilbao,expenses,food,-83.45,-43694.03
buyer_7,Agurtzane,Laka,1968-12-31,32779298C,agurtzane.laka@cleverdev.app,035088,ES90209568654031467919,7789.48,2023-11-30T08:07:56,Bilbao,expenses,repairs,-132.76,-43826.79
buyer_7,Agurtzane,Laka,1968-12-31,32779298C,agurtzane.laka@cleverdev.app,035088,ES90209568654031467919,7789.48,2023-12-01T21:13:25,Bilbao,incomes,salary,1436.92,-42389.87
buyer_7,Agurtzane,Laka,1968-12-31,32779298C,agurtzane.laka@cleverdev.app,035088,ES90209568654031467919,7789.48,2023-12-01T21:13:25,Bilbao,incomes,extra_income,242.27,-42147.6
buyer_7,Agurtzane,Laka,1968-12-31,32779298C,agurtzane.laka@cleverdev.app,035088,ES90209568654031467919,7789.48,2023-12-01T21:13:25,Bilbao,incomes,salary_bonus,1007.3,-41140.3
buyer_7,Agurtzane,Laka,1968-12-31,32779298C,agurtzane.laka@cleverdev.app,035088,ES90209568654031467919,7789.48,2023-12-01T14:40:27,Bilbao,expenses,transport,-57.82,-41198.12
buyer_7,Agurtzane,Laka,1968-12-31,32779298C,agurtzane.laka@cleverdev.app,035088,ES90209568654031467919,7789.48,2023-12-05T09:23:35,Bilbao,expenses,mortgage,-582.53,-41780.65
buyer_7,Agurtzane,Laka,1968-12-31,32779298C,agurtzane.laka@cleverdev.app,035088,ES90209568654031467919,7789.48,2023-12-05T19:13:06,Bilbao,expenses,internet,-30.18,-41810.83
buyer_7,Agurtzane,Laka,1968-12-31,32779298C,agurtzane.laka@cleverdev.app,035088,ES90209568654031467919,7789.48,2023-12-05T03:43:20,Bilbao,expenses,food,-113.77,-41924.6
buyer_7,Agurtzane,Laka,1968-12-31,32779298C,agurtzane.laka@cleverdev.app,035088,ES90209568654031467919,7789.48,2023-12-06T03:00:09,Bilbao,expenses,electricity,-52.29,-41976.89
buyer_7,Agurtzane,Laka,1968-12-31,32779298C,agurtzane.laka@cleverdev.app,035088,ES90209568654031467919,7789.48,2023-12-06T09:46:01,Bilbao,expenses,internet,-30.18,-42007.07
buyer_7,Agurtzane,Laka,1968-12-31,32779298C,agurtzane.laka@cleverdev.app,035088,ES90209568654031467919,7789.48,2023-12-06T19:08:18,Bilbao,expenses,phone,-26.89,-42033.96
buyer_7,Agurtzane,Laka,1968-12-31,32779298C,agurtzane.laka@cleverdev.app,035088,ES90209568654031467919,7789.48,2023-12-07T16:02:19,Bilbao,expenses,gas,-61.01,-42094.97
buyer_7,Agurtzane,Laka,1968-12-31,32779298C,agurtzane.laka@cleverdev.app,035088,ES90209568654031467919,7789.48,2023-12-07T19:11:32,Bilbao,expenses,cash,-100.0,-42194.97
buyer_7,Agurtzane,Laka,1968-12-31,32779298C,agurtzane.laka@cleverdev.app,035088,ES90209568654031467919,7789.48,2023-12-07T15:27:34,Bilbao,expenses,appliances,-283.8,-42478.77
buyer_7,Agurtzane,Laka,1968-12-31,32779298C,agurtzane.laka@cleverdev.app,035088,ES90209568654031467919,7789.48,2023-12-08T16:04:03,Bilbao,expenses,electricity,-40.62,-42519.39
buyer_7,Agurtzane,Laka,1968-12-31,32779298C,agurtzane.laka@cleverdev.app,035088,ES90209568654031467919,7789.48,2023-12-09T12:10:00,Bilbao,expenses,cash,-100.0,-42619.39
buyer_7,Agurtzane,Laka,1968-12-31,32779298C,agurtzane.laka@cleverdev.app,035088,ES90209568654031467919,7789.48,2023-12-11T12:33:06,Bilbao,expenses,transport,-72.72,-42692.11
buyer_7,Agurtzane,Laka,1968-12-31,32779298C,agurtzane.laka@cleverdev.app,035088,ES90209568654031467919,7789.48,2023-12-12T15:19:18,Bilbao,expenses,transport,-88.77,-42780.88
buyer_7,Agurtzane,Laka,1968-12-31,32779298C,agurtzane.laka@cleverdev.app,035088,ES90209568654031467919,7789.48,2023-12-12T10:10:02,Bilbao,expenses,clothing,-56.16,-42837.04
buyer_7,Agurtzane,Laka,1968-12-31,32779298C,agurtzane.laka@cleverdev.app,035088,ES90209568654031467919,7789.48,2023-12-12T23:35:03,Bilbao,expenses,gifts,-171.66,-43008.7
buyer_7,Agurtzane,Laka,1968-12-31,32779298C,agurtzane.laka@cleverdev.app,035088,ES90209568654031467919,7789.48,2023-12-15T20:05:46,Bilbao,expenses,transport,-74.76,-43083.46
buyer_7,Agurtzane,Laka,1968-12-31,32779298C,agurtzane.laka@cleverdev.app,035088,ES90209568654031467919,7789.48,2023-12-17T12:43:52,Bilbao,expenses,food,-96.2,-43179.66
buyer_7,Agurtzane,Laka,1968-12-31,32779298C,agurtzane.laka@cleverdev.app,035088,ES90209568654031467919,7789.48,2023-12-18T08:26:32,Bilbao,expenses,gifts,-254.38,-43434.04
buyer_7,Agurtzane,Laka,1968-12-31,32779298C,agurtzane.laka@cleverdev.app,035088,ES90209568654031467919,7789.48,2023-12-20T17:51:56,Bilbao,expenses,cash,-100.0,-43534.04
buyer_7,Agurtzane,Laka,1968-12-31,32779298C,agurtzane.laka@cleverdev.app,035088,ES90209568654031467919,7789.48,2023-12-22T16:16:27,Bilbao,expenses,cash,-100.0,-43634.04
buyer_7,Agurtzane,Laka,1968-12-31,32779298C,agurtzane.laka@cleverdev.app,035088,ES90209568654031467919,7789.48,2023-12-23T15:49:00,Bilbao,expenses,clothing,-157.24,-43791.28
buyer_7,Agurtzane,Laka,1968-12-31,32779298C,agurtzane.laka@cleverdev.app,035088,ES90209568654031467919,7789.48,2023-12-24T19:25:24,Bilbao,expenses,leisure,-56.83,-43848.11
buyer_7,Agurtzane,Laka,1968-12-31,32779298C,agurtzane.laka@cleverdev.app,035088,ES90209568654031467919,7789.48,2023-12-27T23:57:34,Bilbao,expenses,education,-45.33,-43893.44
buyer_7,Agurtzane,Laka,1968-12-31,32779298C,agurtzane.laka@cleverdev.app,035088,ES90209568654031467919,7789.48,2023-12-27T17:52:11,Bilbao,expenses,cash,-100.0,-43993.44
buyer_7,Agurtzane,Laka,1968-12-31,32779298C,agurtzane.laka@cleverdev.app,035088,ES90209568654031467919,7789.48,2023-12-28T11:18:16,Bilbao,expenses,food,-95.39,-44088.83
buyer_7,Agurtzane,Laka,1968-12-31,32779298C,agurtzane.laka@cleverdev.app,035088,ES90209568654031467919,7789.48,2023-12-28T16:03:03,Bilbao,expenses,clothing,-55.99,-44144.82
buyer_7,Agurtzane,Laka,1968-12-31,32779298C,agurtzane.laka@cleverdev.app,035088,ES90209568654031467919,7789.48,2023-12-29T10:16:32,Bilbao,expenses,cash,-100.0,-44244.82
buyer_7,Agurtzane,Laka,1968-12-31,32779298C,agurtzane.laka@cleverdev.app,035088,ES90209568654031467919,7789.48,2023-12-31T15:47:44,Bilbao,expenses,repairs,-165.56,-44410.38
buyer_7,Agurtzane,Laka,1968-12-31,32779298C,agurtzane.laka@cleverdev.app,035088,ES90209568654031467919,7789.48,2024-01-01T16:30:12,Bilbao,incomes,salary,1470.78,-42939.6
buyer_7,Agurtzane,Laka,1968-12-31,32779298C,agurtzane.laka@cleverdev.app,035088,ES90209568654031467919,7789.48,2024-01-05T18:01:05,Bilbao,expenses,mortgage,-756.26,-43695.86
buyer_7,Agurtzane,Laka,1968-12-31,32779298C,agurtzane.laka@cleverdev.app,035088,ES90209568654031467919,7789.48,2024-01-05T08:38:25,Bilbao,expenses,children,-271.52766666666673,-43967.39
buyer_7,Agurtzane,Laka,1968-12-31,32779298C,agurtzane.laka@cleverdev.app,035088,ES90209568654031467919,7789.48,2024-01-06T09:31:04,Bilbao,expenses,electricity,-59.12,-44026.51
buyer_7,Agurtzane,Laka,1968-12-31,32779298C,agurtzane.laka@cleverdev.app,035088,ES90209568654031467919,7789.48,2024-01-06T14:26:39,Bilbao,expenses,gas,-36.11,-44062.62
buyer_7,Agurtzane,Laka,1968-12-31,32779298C,agurtzane.laka@cleverdev.app,035088,ES90209568654031467919,7789.48,2024-01-06T13:38:30,Bilbao,expenses,phone,-26.12,-44088.74
buyer_7,Agurtzane,Laka,1968-12-31,32779298C,agurtzane.laka@cleverdev.app,035088,ES90209568654031467919,7789.48,2024-01-07T09:51:26,Bilbao,expenses,food,-98.85,-44187.59
buyer_7,Agurtzane,Laka,1968-12-31,32779298C,agurtzane.laka@cleverdev.app,035088,ES90209568654031467919,7789.48,2024-01-08T22:31:09,Bilbao,expenses,phone,-24.52,-44212.11
buyer_7,Agurtzane,Laka,1968-12-31,32779298C,agurtzane.laka@cleverdev.app,035088,ES90209568654031467919,7789.48,2024-01-08T13:30:01,Bilbao,expenses,cash,-100.0,-44312.11
buyer_7,Agurtzane,Laka,1968-12-31,32779298C,agurtzane.laka@cleverdev.app,035088,ES90209568654031467919,7789.48,2024-01-08T18:17:30,Bilbao,expenses,gifts,-107.49,-44419.6
buyer_7,Agurtzane,Laka,1968-12-31,32779298C,agurtzane.laka@cleverdev.app,035088,ES90209568654031467919,7789.48,2024-01-09T01:25:17,Bilbao,expenses,food,-106.45,-44526.05
buyer_7,Agurtzane,Laka,1968-12-31,32779298C,agurtzane.laka@cleverdev.app,035088,ES90209568654031467919,7789.48,2024-01-10T12:11:47,Bilbao,expenses,food,-115.6,-44641.65
buyer_7,Agurtzane,Laka,1968-12-31,32779298C,agurtzane.laka@cleverdev.app,035088,ES90209568654031467919,7789.48,2024-01-10T09:00:30,Bilbao,expenses,gifts,-68.31,-44709.96
buyer_7,Agurtzane,Laka,1968-12-31,32779298C,agurtzane.laka@cleverdev.app,035088,ES90209568654031467919,7789.48,2024-01-11T16:33:33,Bilbao,expenses,repairs,-217.31,-44927.27
buyer_7,Agurtzane,Laka,1968-12-31,32779298C,agurtzane.laka@cleverdev.app,035088,ES90209568654031467919,7789.48,2024-01-12T19:52:56,Bilbao,expenses,food,-96.86,-45024.13
buyer_7,Agurtzane,Laka,1968-12-31,32779298C,agurtzane.laka@cleverdev.app,035088,ES90209568654031467919,7789.48,2024-01-12T22:00:32,Bilbao,expenses,appliances,-141.1,-45165.23
buyer_7,Agurtzane,Laka,1968-12-31,32779298C,agurtzane.laka@cleverdev.app,035088,ES90209568654031467919,7789.48,2024-01-12T17:30:48,Bilbao,expenses,repairs,-27.24,-45192.47
buyer_7,Agurtzane,Laka,1968-12-31,32779298C,agurtzane.laka@cleverdev.app,035088,ES90209568654031467919,7789.48,2024-01-13T11:23:44,Bilbao,expenses,transport,-43.17,-45235.64
buyer_7,Agurtzane,Laka,1968-12-31,32779298C,agurtzane.laka@cleverdev.app,035088,ES90209568654031467919,7789.48,2024-01-14T11:53:11,Bilbao,expenses,food,-68.43,-45304.07
buyer_7,Agurtzane,Laka,1968-12-31,32779298C,agurtzane.laka@cleverdev.app,035088,ES90209568654031467919,7789.48,2024-01-15T16:02:28,Bilbao,expenses,food,-68.49,-45372.56
buyer_7,Agurtzane,Laka,1968-12-31,32779298C,agurtzane.laka@cleverdev.app,035088,ES90209568654031467919,7789.48,2024-01-15T17:49:38,Bilbao,expenses,healthcare,-47.4,-45419.96
buyer_7,Agurtzane,Laka,1968-12-31,32779298C,agurtzane.laka@cleverdev.app,035088,ES90209568654031467919,7789.48,2024-01-16T14:55:25,Bilbao,expenses,repairs,-168.72,-45588.68
buyer_7,Agurtzane,Laka,1968-12-31,32779298C,agurtzane.laka@cleverdev.app,035088,ES90209568654031467919,7789.48,2024-01-17T11:04:00,Bilbao,expenses,healthcare,-180.29,-45768.97
buyer_7,Agurtzane,Laka,1968-12-31,32779298C,agurtzane.laka@cleverdev.app,035088,ES90209568654031467919,7789.48,2024-01-20T17:55:53,Bilbao,expenses,repairs,-48.25,-45817.22
buyer_7,Agurtzane,Laka,1968-12-31,32779298C,agurtzane.laka@cleverdev.app,035088,ES90209568654031467919,7789.48,2024-01-22T22:53:49,Bilbao,expenses,cash,-100.0,-45917.22
buyer_7,Agurtzane,Laka,1968-12-31,32779298C,agurtzane.laka@cleverdev.app,035088,ES90209568654031467919,7789.48,2024-01-23T13:58:22,Bilbao,expenses,food,-60.53,-45977.75
buyer_7,Agurtzane,Laka,1968-12-31,32779298C,agurtzane.laka@cleverdev.app,035088,ES90209568654031467919,7789.48,2024-01-23T22:07:42,Bilbao,expenses,healthcare,-142.19,-46119.94
buyer_7,Agurtzane,Laka,1968-12-31,32779298C,agurtzane.laka@cleverdev.app,035088,ES90209568654031467919,7789.48,2024-01-24T09:01:46,Bilbao,expenses,cash,-100.0,-46219.94
buyer_7,Agurtzane,Laka,1968-12-31,32779298C,agurtzane.laka@cleverdev.app,035088,ES90209568654031467919,7789.48,2024-01-26T15:50:30,Bilbao,expenses,clothing,-102.0,-46321.94
buyer_7,Agurtzane,Laka,1968-12-31,32779298C,agurtzane.laka@cleverdev.app,035088,ES90209568654031467919,7789.48,2024-01-27T16:23:34,Bilbao,expenses,food,-120.42,-46442.36
buyer_7,Agurtzane,Laka,1968-12-31,32779298C,agurtzane.laka@cleverdev.app,035088,ES90209568654031467919,7789.48,2024-01-28T15:41:10,Bilbao,expenses,food,-106.68,-46549.04
buyer_7,Agurtzane,Laka,1968-12-31,32779298C,agurtzane.laka@cleverdev.app,035088,ES90209568654031467919,7789.48,2024-01-30T11:58:35,Bilbao,expenses,food,-69.05,-46618.09
buyer_7,Agurtzane,Laka,1968-12-31,32779298C,agurtzane.laka@cleverdev.app,035088,ES90209568654031467919,7789.48,2024-02-01T11:24:15,Bilbao,incomes,salary,1470.78,-45147.31
buyer_7,Agurtzane,Laka,1968-12-31,32779298C,agurtzane.laka@cleverdev.app,035088,ES90209568654031467919,7789.48,2024-02-02T16:59:19,Bilbao,expenses,education,-62.41,-45209.72
buyer_7,Agurtzane,Laka,1968-12-31,32779298C,agurtzane.laka@cleverdev.app,035088,ES90209568654031467919,7789.48,2024-02-03T09:29:51,Bilbao,expenses,leisure,-61.51,-45271.23
buyer_7,Agurtzane,Laka,1968-12-31,32779298C,agurtzane.laka@cleverdev.app,035088,ES90209568654031467919,7789.48,2024-02-04T20:21:19,Bilbao,expenses,cash,-100.0,-45371.23
buyer_7,Agurtzane,Laka,1968-12-31,32779298C,agurtzane.laka@cleverdev.app,035088,ES90209568654031467919,7789.48,2024-02-05T18:31:18,Bilbao,expenses,mortgage,-756.26,-46127.49
buyer_7,Agurtzane,Laka,1968-12-31,32779298C,agurtzane.laka@cleverdev.app,035088,ES90209568654031467919,7789.48,2024-02-05T13:32:54,Bilbao,expenses,water,-18.46,-46145.95
buyer_7,Agurtzane,Laka,1968-12-31,32779298C,agurtzane.laka@cleverdev.app,035088,ES90209568654031467919,7789.48,2024-02-05T13:57:11,Bilbao,expenses,phone,-22.38,-46168.33
buyer_7,Agurtzane,Laka,1968-12-31,32779298C,agurtzane.laka@cleverdev.app,035088,ES90209568654031467919,7789.48,2024-02-05T21:18:12,Bilbao,expenses,travel,-272.58,-46440.91
buyer_7,Agurtzane,Laka,1968-12-31,32779298C,agurtzane.laka@cleverdev.app,035088,ES90209568654031467919,7789.48,2024-02-06T16:50:08,Bilbao,expenses,phone,-30.78,-46471.69
buyer_7,Agurtzane,Laka,1968-12-31,32779298C,agurtzane.laka@cleverdev.app,035088,ES90209568654031467919,7789.48,2024-02-06T12:12:32,Bilbao,expenses,gifts,-96.07,-46567.76
buyer_7,Agurtzane,Laka,1968-12-31,32779298C,agurtzane.laka@cleverdev.app,035088,ES90209568654031467919,7789.48,2024-02-07T10:08:21,Bilbao,expenses,water,-26.69,-46594.45
buyer_7,Agurtzane,Laka,1968-12-31,32779298C,agurtzane.laka@cleverdev.app,035088,ES90209568654031467919,7789.48,2024-02-07T12:23:01,Bilbao,expenses,internet,-30.89,-46625.34
buyer_7,Agurtzane,Laka,1968-12-31,32779298C,agurtzane.laka@cleverdev.app,035088,ES90209568654031467919,7789.48,2024-02-07T13:26:23,Bilbao,expenses,transport,-81.7,-46707.04
buyer_7,Agurtzane,Laka,1968-12-31,32779298C,agurtzane.laka@cleverdev.app,035088,ES90209568654031467919,7789.48,2024-02-08T19:41:14,Bilbao,expenses,internet,-30.89,-46737.93
buyer_7,Agurtzane,Laka,1968-12-31,32779298C,agurtzane.laka@cleverdev.app,035088,ES90209568654031467919,7789.48,2024-02-11T12:29:31,Bilbao,expenses,leisure,-23.74,-46761.67
buyer_7,Agurtzane,Laka,1968-12-31,32779298C,agurtzane.laka@cleverdev.app,035088,ES90209568654031467919,7789.48,2024-02-11T16:14:05,Bilbao,expenses,appliances,-219.55,-46981.22
buyer_7,Agurtzane,Laka,1968-12-31,32779298C,agurtzane.laka@cleverdev.app,035088,ES90209568654031467919,7789.48,2024-02-13T00:10:54,Bilbao,expenses,leisure,-37.28,-47018.5
buyer_7,Agurtzane,Laka,1968-12-31,32779298C,agurtzane.laka@cleverdev.app,035088,ES90209568654031467919,7789.48,2024-02-14T10:19:16,Bilbao,expenses,food,-93.36,-47111.86
buyer_7,Agurtzane,Laka,1968-12-31,32779298C,agurtzane.laka@cleverdev.app,035088,ES90209568654031467919,7789.48,2024-02-14T13:23:40,Bilbao,expenses,gifts,-35.35,-47147.21
buyer_7,Agurtzane,Laka,1968-12-31,32779298C,agurtzane.laka@cleverdev.app,035088,ES90209568654031467919,7789.48,2024-02-15T08:32:45,Bilbao,expenses,food,-66.55,-47213.76
buyer_7,Agurtzane,Laka,1968-12-31,32779298C,agurtzane.laka@cleverdev.app,035088,ES90209568654031467919,7789.48,2024-02-15T13:13:09,Bilbao,expenses,cash,-100.0,-47313.76
buyer_7,Agurtzane,Laka,1968-12-31,32779298C,agurtzane.laka@cleverdev.app,035088,ES90209568654031467919,7789.48,2024-02-16T23:49:16,Bilbao,expenses,food,-107.09,-47420.85
buyer_7,Agurtzane,Laka,1968-12-31,32779298C,agurtzane.laka@cleverdev.app,035088,ES90209568654031467919,7789.48,2024-02-17T14:11:52,Bilbao,expenses,appliances,-133.08,-47553.93
buyer_7,Agurtzane,Laka,1968-12-31,32779298C,agurtzane.laka@cleverdev.app,035088,ES90209568654031467919,7789.48,2024-02-19T20:16:41,Bilbao,expenses,transport,-43.28,-47597.21
buyer_7,Agurtzane,Laka,1968-12-31,32779298C,agurtzane.laka@cleverdev.app,035088,ES90209568654031467919,7789.48,2024-02-21T08:55:05,Bilbao,expenses,repairs,-200.58,-47797.79
buyer_7,Agurtzane,Laka,1968-12-31,32779298C,agurtzane.laka@cleverdev.app,035088,ES90209568654031467919,7789.48,2024-02-23T00:24:11,Bilbao,expenses,food,-93.4,-47891.19
buyer_7,Agurtzane,Laka,1968-12-31,32779298C,agurtzane.laka@cleverdev.app,035088,ES90209568654031467919,7789.48,2024-02-23T13:54:15,Bilbao,expenses,gifts,-76.57,-47967.76
buyer_7,Agurtzane,Laka,1968-12-31,32779298C,agurtzane.laka@cleverdev.app,035088,ES90209568654031467919,7789.48,2024-02-25T09:15:19,Bilbao,expenses,leisure,-45.18,-48012.94
buyer_7,Agurtzane,Laka,1968-12-31,32779298C,agurtzane.laka@cleverdev.app,035088,ES90209568654031467919,7789.48,2024-02-25T14:16:26,Bilbao,expenses,clothing,-151.09,-48164.03
buyer_7,Agurtzane,Laka,1968-12-31,32779298C,agurtzane.laka@cleverdev.app,035088,ES90209568654031467919,7789.48,2024-02-25T20:11:11,Bilbao,expenses,cash,-94.83,-48258.86
buyer_7,Agurtzane,Laka,1968-12-31,32779298C,agurtzane.laka@cleverdev.app,035088,ES90209568654031467919,7789.48,2024-02-29T13:59:58,Bilbao,expenses,repairs,-93.42,-48352.28
buyer_7,Agurtzane,Laka,1968-12-31,32779298C,agurtzane.laka@cleverdev.app,035088,ES90209568654031467919,7789.48,2024-03-01T11:17:34,Bilbao,incomes,salary,1470.78,-46881.5
buyer_7,Agurtzane,Laka,1968-12-31,32779298C,agurtzane.laka@cleverdev.app,035088,ES90209568654031467919,7789.48,2024-03-01T11:17:34,Bilbao,incomes,extra_income,242.27,-46639.23
buyer_7,Agurtzane,Laka,1968-12-31,32779298C,agurtzane.laka@cleverdev.app,035088,ES90209568654031467919,7789.48,2024-03-03T12:46:56,Bilbao,expenses,cash,-100.0,-46739.23
buyer_7,Agurtzane,Laka,1968-12-31,32779298C,agurtzane.laka@cleverdev.app,035088,ES90209568654031467919,7789.48,2024-03-05T11:32:37,Bilbao,expenses,mortgage,-756.26,-47495.49
buyer_7,Agurtzane,Laka,1968-12-31,32779298C,agurtzane.laka@cleverdev.app,035088,ES90209568654031467919,7789.48,2024-03-05T12:17:25,Bilbao,expenses,travel,-272.32,-47767.81
buyer_7,Agurtzane,Laka,1968-12-31,32779298C,agurtzane.laka@cleverdev.app,035088,ES90209568654031467919,7789.48,2024-03-06T16:04:02,Bilbao,expenses,electricity,-21.96,-47789.77
buyer_7,Agurtzane,Laka,1968-12-31,32779298C,agurtzane.laka@cleverdev.app,035088,ES90209568654031467919,7789.48,2024-03-06T03:52:27,Bilbao,expenses,phone,-29.96,-47819.73
buyer_7,Agurtzane,Laka,1968-12-31,32779298C,agurtzane.laka@cleverdev.app,035088,ES90209568654031467919,7789.48,2024-03-07T15:48:12,Bilbao,expenses,food,-72.89,-47892.62
buyer_7,Agurtzane,Laka,1968-12-31,32779298C,agurtzane.laka@cleverdev.app,035088,ES90209568654031467919,7789.48,2024-03-08T17:38:32,Bilbao,expenses,electricity,-41.1,-47933.72
buyer_7,Agurtzane,Laka,1968-12-31,32779298C,agurtzane.laka@cleverdev.app,035088,ES90209568654031467919,7789.48,2024-03-08T14:17:08,Bilbao,expenses,food,-88.62,-48022.34
buyer_7,Agurtzane,Laka,1968-12-31,32779298C,agurtzane.laka@cleverdev.app,035088,ES90209568654031467919,7789.48,2024-03-08T09:05:13,Bilbao,expenses,leisure,-73.55,-48095.89
buyer_7,Agurtzane,Laka,1968-12-31,32779298C,agurtzane.laka@cleverdev.app,035088,ES90209568654031467919,7789.48,2024-03-09T11:58:29,Bilbao,expenses,leisure,-39.39,-48135.28
buyer_7,Agurtzane,Laka,1968-12-31,32779298C,agurtzane.laka@cleverdev.app,035088,ES90209568654031467919,7789.48,2024-03-09T18:40:26,Bilbao,expenses,cash,-100.0,-48235.28
buyer_7,Agurtzane,Laka,1968-12-31,32779298C,agurtzane.laka@cleverdev.app,035088,ES90209568654031467919,7789.48,2024-03-10T16:27:52,Bilbao,expenses,cash,-100.0,-48335.28
buyer_7,Agurtzane,Laka,1968-12-31,32779298C,agurtzane.laka@cleverdev.app,035088,ES90209568654031467919,7789.48,2024-03-11T13:47:57,Bilbao,expenses,cash,-100.0,-48435.28
buyer_7,Agurtzane,Laka,1968-12-31,32779298C,agurtzane.laka@cleverdev.app,035088,ES90209568654031467919,7789.48,2024-03-11T20:51:44,Bilbao,expenses,children,-171.52766666666673,-48606.81
buyer_7,Agurtzane,Laka,1968-12-31,32779298C,agurtzane.laka@cleverdev.app,035088,ES90209568654031467919,7789.48,2024-03-12T15:05:01,Bilbao,expenses,education,-56.34,-48663.15
buyer_7,Agurtzane,Laka,1968-12-31,32779298C,agurtzane.laka@cleverdev.app,035088,ES90209568654031467919,7789.48,2024-03-13T17:00:08,Bilbao,expenses,cash,-100.0,-48763.15
buyer_7,Agurtzane,Laka,1968-12-31,32779298C,agurtzane.laka@cleverdev.app,035088,ES90209568654031467919,7789.48,2024-03-14T20:49:16,Bilbao,expenses,clothing,-94.65,-48857.8
buyer_7,Agurtzane,Laka,1968-12-31,32779298C,agurtzane.laka@cleverdev.app,035088,ES90209568654031467919,7789.48,2024-03-15T11:41:58,Bilbao,expenses,transport,-54.2,-48912.0
buyer_7,Agurtzane,Laka,1968-12-31,32779298C,agurtzane.laka@cleverdev.app,035088,ES90209568654031467919,7789.48,2024-03-16T23:47:58,Bilbao,expenses,food,-103.27,-49015.27
buyer_7,Agurtzane,Laka,1968-12-31,32779298C,agurtzane.laka@cleverdev.app,035088,ES90209568654031467919,7789.48,2024-03-16T12:18:52,Bilbao,expenses,healthcare,-153.81,-49169.08
buyer_7,Agurtzane,Laka,1968-12-31,32779298C,agurtzane.laka@cleverdev.app,035088,ES90209568654031467919,7789.48,2024-03-16T18:22:59,Bilbao,expenses,cash,-91.49,-49260.57
buyer_7,Agurtzane,Laka,1968-12-31,32779298C,agurtzane.laka@cleverdev.app,035088,ES90209568654031467919,7789.48,2024-03-17T04:02:32,Bilbao,expenses,children,-271.52766666666673,-49532.1
buyer_7,Agurtzane,Laka,1968-12-31,32779298C,agurtzane.laka@cleverdev.app,035088,ES90209568654031467919,7789.48,2024-03-18T11:43:34,Bilbao,expenses,cash,-100.0,-49632.1
buyer_7,Agurtzane,Laka,1968-12-31,32779298C,agurtzane.laka@cleverdev.app,035088,ES90209568654031467919,7789.48,2024-03-19T12:10:23,Bilbao,expenses,appliances,-181.98,-49814.08
buyer_7,Agurtzane,Laka,1968-12-31,32779298C,agurtzane.laka@cleverdev.app,035088,ES90209568654031467919,7789.48,2024-03-20T20:45:09,Bilbao,expenses,leisure,-29.55,-49843.63
buyer_7,Agurtzane,Laka,1968-12-31,32779298C,agurtzane.laka@cleverdev.app,035088,ES90209568654031467919,7789.48,2024-03-21T06:07:48,Bilbao,expenses,food,-61.25,-49904.88
buyer_7,Agurtzane,Laka,1968-12-31,32779298C,agurtzane.laka@cleverdev.app,035088,ES90209568654031467919,7789.48,2024-03-23T20:13:33,Bilbao,expenses,transport,-49.32,-49954.2
buyer_7,Agurtzane,Laka,1968-12-31,32779298C,agurtzane.laka@cleverdev.app,035088,ES90209568654031467919,7789.48,2024-03-23T18:15:24,Bilbao,expenses,education,-42.31,-49996.51
buyer_7,Agurtzane,Laka,1968-12-31,32779298C,agurtzane.laka@cleverdev.app,035088,ES90209568654031467919,7789.48,2024-03-24T11:55:17,Bilbao,expenses,children,-184.81,-50181.32
buyer_7,Agurtzane,Laka,1968-12-31,32779298C,agurtzane.laka@cleverdev.app,035088,ES90209568654031467919,7789.48,2024-03-25T11:06:52,Bilbao,expenses,leisure,-18.39,-50199.71
buyer_7,Agurtzane,Laka,1968-12-31,32779298C,agurtzane.laka@cleverdev.app,035088,ES90209568654031467919,7789.48,2024-03-25T09:22:28,Bilbao,expenses,cash,-100.0,-50299.71
buyer_7,Agurtzane,Laka,1968-12-31,32779298C,agurtzane.laka@cleverdev.app,035088,ES90209568654031467919,7789.48,2024-03-26T18:42:34,Bilbao,expenses,cash,-100.0,-50399.71
buyer_7,Agurtzane,Laka,1968-12-31,32779298C,agurtzane.laka@cleverdev.app,035088,ES90209568654031467919,7789.48,2024-03-27T06:34:20,Bilbao,expenses,cash,-100.0,-50499.71
buyer_7,Agurtzane,Laka,1968-12-31,32779298C,agurtzane.laka@cleverdev.app,035088,ES90209568654031467919,7789.48,2024-03-28T09:13:35,Bilbao,expenses,clothing,-80.54,-50580.25
buyer_7,Agurtzane,Laka,1968-12-31,32779298C,agurtzane.laka@cleverdev.app,035088,ES90209568654031467919,7789.48,2024-03-30T15:41:14,Bilbao,expenses,leisure,-45.18,-50625.43
buyer_7,Agurtzane,Laka,1968-12-31,32779298C,agurtzane.laka@cleverdev.app,035088,ES90209568654031467919,7789.48,2024-03-30T14:57:15,Bilbao,expenses,cash,-100.0,-50725.43
buyer_7,Agurtzane,Laka,1968-12-31,32779298C,agurtzane.laka@cleverdev.app,035088,ES90209568654031467919,7789.48,2024-03-31T14:52:52,Bilbao,expenses,leisure,-30.03,-50755.46
buyer_7,Agurtzane,Laka,1968-12-31,32779298C,agurtzane.laka@cleverdev.app,035088,ES90209568654031467919,7789.48,2024-03-31T18:17:12,Bilbao,expenses,repairs,-146.21,-50901.67
buyer_7,Agurtzane,Laka,1968-12-31,32779298C,agurtzane.laka@cleverdev.app,035088,ES90209568654031467919,7789.48,2024-04-01T13:30:15,Bilbao,incomes,salary,1470.78,-49430.89
buyer_7,Agurtzane,Laka,1968-12-31,32779298C,agurtzane.laka@cleverdev.app,035088,ES90209568654031467919,7789.48,2024-04-04T01:41:14,Bilbao,expenses,repairs,-250.2,-49681.09
buyer_7,Agurtzane,Laka,1968-12-31,32779298C,agurtzane.laka@cleverdev.app,035088,ES90209568654031467919,7789.48,2024-04-05T10:49:56,Bilbao,expenses,mortgage,-756.26,-50437.35
buyer_7,Agurtzane,Laka,1968-12-31,32779298C,agurtzane.laka@cleverdev.app,035088,ES90209568654031467919,7789.48,2024-04-06T15:30:10,Bilbao,expenses,internet,-30.89,-50468.24
buyer_7,Agurtzane,Laka,1968-12-31,32779298C,agurtzane.laka@cleverdev.app,035088,ES90209568654031467919,7789.48,2024-04-06T09:19:04,Bilbao,expenses,leisure,-76.68,-50544.92
buyer_7,Agurtzane,Laka,1968-12-31,32779298C,agurtzane.laka@cleverdev.app,035088,ES90209568654031467919,7789.48,2024-04-06T05:28:18,Bilbao,expenses,repairs,-135.24,-50680.16
buyer_7,Agurtzane,Laka,1968-12-31,32779298C,agurtzane.laka@cleverdev.app,035088,ES90209568654031467919,7789.48,2024-04-07T20:05:13,Bilbao,expenses,food,-84.6,-50764.76
buyer_7,Agurtzane,Laka,1968-12-31,32779298C,agurtzane.laka@cleverdev.app,035088,ES90209568654031467919,7789.48,2024-04-07T11:12:11,Bilbao,expenses,cash,-100.0,-50864.76
buyer_7,Agurtzane,Laka,1968-12-31,32779298C,agurtzane.laka@cleverdev.app,035088,ES90209568654031467919,7789.48,2024-04-09T16:27:10,Bilbao,expenses,transport,-66.79,-50931.55
buyer_7,Agurtzane,Laka,1968-12-31,32779298C,agurtzane.laka@cleverdev.app,035088,ES90209568654031467919,7789.48,2024-04-09T17:17:12,Bilbao,expenses,children,-170.69,-51102.24
buyer_7,Agurtzane,Laka,1968-12-31,32779298C,agurtzane.laka@cleverdev.app,035088,ES90209568654031467919,7789.48,2024-04-10T18:11:17,Bilbao,expenses,education,-53.25,-51155.49
buyer_7,Agurtzane,Laka,1968-12-31,32779298C,agurtzane.laka@cleverdev.app,035088,ES90209568654031467919,7789.48,2024-04-12T14:50:03,Bilbao,expenses,leisure,-56.42,-51211.91
buyer_7,Agurtzane,Laka,1968-12-31,32779298C,agurtzane.laka@cleverdev.app,035088,ES90209568654031467919,7789.48,2024-04-12T07:17:51,Bilbao,expenses,cash,-100.0,-51311.91
buyer_7,Agurtzane,Laka,1968-12-31,32779298C,agurtzane.laka@cleverdev.app,035088,ES90209568654031467919,7789.48,2024-04-13T09:47:50,Bilbao,expenses,cash,-100.0,-51411.91
buyer_7,Agurtzane,Laka,1968-12-31,32779298C,agurtzane.laka@cleverdev.app,035088,ES90209568654031467919,7789.48,2024-04-14T10:19:19,Bilbao,expenses,cash,-100.0,-51511.91
buyer_7,Agurtzane,Laka,1968-12-31,32779298C,agurtzane.laka@cleverdev.app,035088,ES90209568654031467919,7789.48,2024-04-15T13:29:32,Bilbao,expenses,repairs,-59.79,-51571.7
buyer_7,Agurtzane,Laka,1968-12-31,32779298C,agurtzane.laka@cleverdev.app,035088,ES90209568654031467919,7789.48,2024-04-19T10:50:49,Bilbao,expenses,cash,-100.0,-51671.7
buyer_7,Agurtzane,Laka,1968-12-31,32779298C,agurtzane.laka@cleverdev.app,035088,ES90209568654031467919,7789.48,2024-04-20T14:56:44,Bilbao,expenses,food,-85.33,-51757.03
buyer_7,Agurtzane,Laka,1968-12-31,32779298C,agurtzane.laka@cleverdev.app,035088,ES90209568654031467919,7789.48,2024-04-23T15:06:15,Bilbao,expenses,cash,-100.0,-51857.03
buyer_7,Agurtzane,Laka,1968-12-31,32779298C,agurtzane.laka@cleverdev.app,035088,ES90209568654031467919,7789.48,2024-04-25T09:38:20,Bilbao,expenses,food,-60.79,-51917.82
buyer_7,Agurtzane,Laka,1968-12-31,32779298C,agurtzane.laka@cleverdev.app,035088,ES90209568654031467919,7789.48,2024-04-26T20:35:00,Bilbao,expenses,leisure,-84.3,-52002.12
buyer_7,Agurtzane,Laka,1968-12-31,32779298C,agurtzane.laka@cleverdev.app,035088,ES90209568654031467919,7789.48,2024-04-26T11:07:19,Bilbao,expenses,cash,-100.0,-52102.12
buyer_7,Agurtzane,Laka,1968-12-31,32779298C,agurtzane.laka@cleverdev.app,035088,ES90209568654031467919,7789.48,2024-04-28T11:44:32,Bilbao,expenses,transport,-52.41,-52154.53
buyer_7,Agurtzane,Laka,1968-12-31,32779298C,agurtzane.laka@cleverdev.app,035088,ES90209568654031467919,7789.48,2024-04-28T06:22:45,Bilbao,expenses,leisure,-20.49,-52175.02
buyer_7,Agurtzane,Laka,1968-12-31,32779298C,agurtzane.laka@cleverdev.app,035088,ES90209568654031467919,7789.48,2024-04-28T12:11:53,Bilbao,expenses,children,-106.29,-52281.31
buyer_7,Agurtzane,Laka,1968-12-31,32779298C,agurtzane.laka@cleverdev.app,035088,ES90209568654031467919,7789.48,2024-04-29T20:22:23,Bilbao,expenses,transport,-62.19,-52343.5
buyer_7,Agurtzane,Laka,1968-12-31,32779298C,agurtzane.laka@cleverdev.app,035088,ES90209568654031467919,7789.48,2024-04-29T17:12:05,Bilbao,expenses,appliances,-146.55,-52490.05
buyer_7,Agurtzane,Laka,1968-12-31,32779298C,agurtzane.laka@cleverdev.app,035088,ES90209568654031467919,7789.48,2024-05-01T13:42:31,Bilbao,incomes,salary,1470.78,-51019.27
buyer_7,Agurtzane,Laka,1968-12-31,32779298C,agurtzane.laka@cleverdev.app,035088,ES90209568654031467919,7789.48,2024-05-05T15:02:32,Bilbao,expenses,mortgage,-756.26,-51775.53
buyer_7,Agurtzane,Laka,1968-12-31,32779298C,agurtzane.laka@cleverdev.app,035088,ES90209568654031467919,7789.48,2024-05-05T12:19:43,Bilbao,expenses,internet,-30.89,-51806.42
buyer_7,Agurtzane,Laka,1968-12-31,32779298C,agurtzane.laka@cleverdev.app,035088,ES90209568654031467919,7789.48,2024-05-05T16:30:12,Bilbao,expenses,repairs,-91.37,-51897.79
buyer_7,Agurtzane,Laka,1968-12-31,32779298C,agurtzane.laka@cleverdev.app,035088,ES90209568654031467919,7789.48,2024-05-06T19:31:39,Bilbao,expenses,water,-30.63,-51928.42
buyer_7,Agurtzane,Laka,1968-12-31,32779298C,agurtzane.laka@cleverdev.app,035088,ES90209568654031467919,7789.48,2024-05-06T17:53:01,Bilbao,expenses,electricity,-35.3,-51963.72
buyer_7,Agurtzane,Laka,1968-12-31,32779298C,agurtzane.laka@cleverdev.app,035088,ES90209568654031467919,7789.48,2024-05-06T14:36:11,Bilbao,expenses,internet,-30.89,-51994.61
buyer_7,Agurtzane,Laka,1968-12-31,32779298C,agurtzane.laka@cleverdev.app,035088,ES90209568654031467919,7789.48,2024-05-06T12:14:43,Bilbao,expenses,leisure,-30.16,-52024.77
buyer_7,Agurtzane,Laka,1968-12-31,32779298C,agurtzane.laka@cleverdev.app,035088,ES90209568654031467919,7789.48,2024-05-06T11:54:19,Bilbao,expenses,cash,-100.0,-52124.77
buyer_7,Agurtzane,Laka,1968-12-31,32779298C,agurtzane.laka@cleverdev.app,035088,ES90209568654031467919,7789.48,2024-05-06T18:52:06,Bilbao,expenses,gifts,-41.82,-52166.59
buyer_7,Agurtzane,Laka,1968-12-31,32779298C,agurtzane.laka@cleverdev.app,035088,ES90209568654031467919,7789.48,2024-05-06T09:54:06,Bilbao,expenses,children,-96.46,-52263.05
buyer_7,Agurtzane,Laka,1968-12-31,32779298C,agurtzane.laka@cleverdev.app,035088,ES90209568654031467919,7789.48,2024-05-07T11:21:38,Bilbao,expenses,water,-20.61,-52283.66
buyer_7,Agurtzane,Laka,1968-12-31,32779298C,agurtzane.laka@cleverdev.app,035088,ES90209568654031467919,7789.48,2024-05-07T15:30:18,Bilbao,expenses,electricity,-50.47,-52334.13
buyer_7,Agurtzane,Laka,1968-12-31,32779298C,agurtzane.laka@cleverdev.app,035088,ES90209568654031467919,7789.48,2024-05-07T14:19:38,Bilbao,expenses,food,-94.34,-52428.47
buyer_7,Agurtzane,Laka,1968-12-31,32779298C,agurtzane.laka@cleverdev.app,035088,ES90209568654031467919,7789.48,2024-05-09T09:03:55,Bilbao,expenses,food,-115.88,-52544.35
buyer_7,Agurtzane,Laka,1968-12-31,32779298C,agurtzane.laka@cleverdev.app,035088,ES90209568654031467919,7789.48,2024-05-10T15:49:23,Bilbao,expenses,appliances,-155.22,-52699.57
buyer_7,Agurtzane,Laka,1968-12-31,32779298C,agurtzane.laka@cleverdev.app,035088,ES90209568654031467919,7789.48,2024-05-10T14:22:24,Bilbao,expenses,repairs,-30.07,-52729.64
buyer_7,Agurtzane,Laka,1968-12-31,32779298C,agurtzane.laka@cleverdev.app,035088,ES90209568654031467919,7789.48,2024-05-14T16:07:29,Bilbao,expenses,cash,-100.0,-52829.64
buyer_7,Agurtzane,Laka,1968-12-31,32779298C,agurtzane.laka@cleverdev.app,035088,ES90209568654031467919,7789.48,2024-05-17T09:45:15,Bilbao,expenses,cash,-100.0,-52929.64
buyer_7,Agurtzane,Laka,1968-12-31,32779298C,agurtzane.laka@cleverdev.app,035088,ES90209568654031467919,7789.48,2024-05-18T13:53:05,Bilbao,expenses,transport,-78.28,-53007.92
buyer_7,Agurtzane,Laka,1968-12-31,32779298C,agurtzane.laka@cleverdev.app,035088,ES90209568654031467919,7789.48,2024-05-19T18:16:51,Bilbao,expenses,leisure,-66.98,-53074.9
buyer_7,Agurtzane,Laka,1968-12-31,32779298C,agurtzane.laka@cleverdev.app,035088,ES90209568654031467919,7789.48,2024-05-20T20:26:53,Bilbao,expenses,cash,-100.0,-53174.9
buyer_7,Agurtzane,Laka,1968-12-31,32779298C,agurtzane.laka@cleverdev.app,035088,ES90209568654031467919,7789.48,2024-05-20T19:48:17,Bilbao,expenses,repairs,-158.34,-53333.24
buyer_7,Agurtzane,Laka,1968-12-31,32779298C,agurtzane.laka@cleverdev.app,035088,ES90209568654031467919,7789.48,2024-05-21T15:59:13,Bilbao,expenses,cash,-100.0,-53433.24
buyer_7,Agurtzane,Laka,1968-12-31,32779298C,agurtzane.laka@cleverdev.app,035088,ES90209568654031467919,7789.48,2024-05-22T17:46:51,Bilbao,expenses,education,-43.12,-53476.36
buyer_7,Agurtzane,Laka,1968-12-31,32779298C,agurtzane.laka@cleverdev.app,035088,ES90209568654031467919,7789.48,2024-05-22T12:47:39,Bilbao,expenses,cash,-100.0,-53576.36
buyer_7,Agurtzane,Laka,1968-12-31,32779298C,agurtzane.laka@cleverdev.app,035088,ES90209568654031467919,7789.48,2024-05-25T23:29:10,Bilbao,expenses,cash,-100.0,-53676.36
buyer_7,Agurtzane,Laka,1968-12-31,32779298C,agurtzane.laka@cleverdev.app,035088,ES90209568654031467919,7789.48,2024-05-26T03:23:41,Bilbao,expenses,transport,-53.62,-53729.98
buyer_7,Agurtzane,Laka,1968-12-31,32779298C,agurtzane.laka@cleverdev.app,035088,ES90209568654031467919,7789.48,2024-05-29T20:28:28,Bilbao,expenses,food,-87.1,-53817.08
buyer_7,Agurtzane,Laka,1968-12-31,32779298C,agurtzane.laka@cleverdev.app,035088,ES90209568654031467919,7789.48,2024-06-01T08:35:54,Bilbao,incomes,salary,1470.78,-52346.3
buyer_7,Agurtzane,Laka,1968-12-31,32779298C,agurtzane.laka@cleverdev.app,035088,ES90209568654031467919,7789.48,2024-06-01T08:35:54,Bilbao,incomes,extra_income,242.27,-52104.03
buyer_7,Agurtzane,Laka,1968-12-31,32779298C,agurtzane.laka@cleverdev.app,035088,ES90209568654031467919,7789.48,2024-06-01T08:35:54,Bilbao,incomes,salary_bonus,1033.55,-51070.48
buyer_7,Agurtzane,Laka,1968-12-31,32779298C,agurtzane.laka@cleverdev.app,035088,ES90209568654031467919,7789.48,2024-06-01T22:53:28,Bilbao,expenses,transport,-75.39,-51145.87
buyer_7,Agurtzane,Laka,1968-12-31,32779298C,agurtzane.laka@cleverdev.app,035088,ES90209568654031467919,7789.48,2024-06-02T08:58:24,Bilbao,expenses,taxes,-1178.81,-52324.68
buyer_7,Agurtzane,Laka,1968-12-31,32779298C,agurtzane.laka@cleverdev.app,035088,ES90209568654031467919,7789.48,2024-06-02T19:49:11,Bilbao,expenses,insurance,-370.75,-52695.43
buyer_7,Agurtzane,Laka,1968-12-31,32779298C,agurtzane.laka@cleverdev.app,035088,ES90209568654031467919,7789.48,2024-06-03T19:25:19,Bilbao,expenses,food,-90.72,-52786.15
buyer_7,Agurtzane,Laka,1968-12-31,32779298C,agurtzane.laka@cleverdev.app,035088,ES90209568654031467919,7789.48,2024-06-04T09:42:19,Bilbao,expenses,education,-68.45,-52854.6
buyer_7,Agurtzane,Laka,1968-12-31,32779298C,agurtzane.laka@cleverdev.app,035088,ES90209568654031467919,7789.48,2024-06-04T08:42:32,Bilbao,expenses,gifts,-37.82,-52892.42
buyer_7,Agurtzane,Laka,1968-12-31,32779298C,agurtzane.laka@cleverdev.app,035088,ES90209568654031467919,7789.48,2024-06-05T08:05:29,Bilbao,expenses,mortgage,-756.26,-53648.68
buyer_7,Agurtzane,Laka,1968-12-31,32779298C,agurtzane.laka@cleverdev.app,035088,ES90209568654031467919,7789.48,2024-06-05T09:58:00,Bilbao,expenses,phone,-32.46,-53681.14
buyer_7,Agurtzane,Laka,1968-12-31,32779298C,agurtzane.laka@cleverdev.app,035088,ES90209568654031467919,7789.48,2024-06-06T08:48:57,Bilbao,expenses,clothing,-89.13,-53770.27
buyer_7,Agurtzane,Laka,1968-12-31,32779298C,agurtzane.laka@cleverdev.app,035088,ES90209568654031467919,7789.48,2024-06-07T20:18:20,Bilbao,expenses,water,-27.38,-53797.65
buyer_7,Agurtzane,Laka,1968-12-31,32779298C,agurtzane.laka@cleverdev.app,035088,ES90209568654031467919,7789.48,2024-06-07T12:36:17,Bilbao,expenses,gas,-82.98,-53880.63
buyer_7,Agurtzane,Laka,1968-12-31,32779298C,agurtzane.laka@cleverdev.app,035088,ES90209568654031467919,7789.48,2024-06-08T16:00:21,Bilbao,expenses,food,-108.43,-53989.06
buyer_7,Agurtzane,Laka,1968-12-31,32779298C,agurtzane.laka@cleverdev.app,035088,ES90209568654031467919,7789.48,2024-06-11T09:56:23,Bilbao,expenses,leisure,-67.73,-54056.79
buyer_7,Agurtzane,Laka,1968-12-31,32779298C,agurtzane.laka@cleverdev.app,035088,ES90209568654031467919,7789.48,2024-06-12T19:12:14,Bilbao,expenses,clothing,-89.92,-54146.71
buyer_7,Agurtzane,Laka,1968-12-31,32779298C,agurtzane.laka@cleverdev.app,035088,ES90209568654031467919,7789.48,2024-06-14T08:49:29,Bilbao,expenses,travel,-271.62,-54418.33
buyer_7,Agurtzane,Laka,1968-12-31,32779298C,agurtzane.laka@cleverdev.app,035088,ES90209568654031467919,7789.48,2024-06-15T15:55:55,Bilbao,expenses,transport,-89.47,-54507.8
buyer_7,Agurtzane,Laka,1968-12-31,32779298C,agurtzane.laka@cleverdev.app,035088,ES90209568654031467919,7789.48,2024-06-16T09:14:04,Bilbao,expenses,transport,-88.42,-54596.22
buyer_7,Agurtzane,Laka,1968-12-31,32779298C,agurtzane.laka@cleverdev.app,035088,ES90209568654031467919,7789.48,2024-06-16T12:31:04,Bilbao,expenses,cash,-100.0,-54696.22
buyer_7,Agurtzane,Laka,1968-12-31,32779298C,agurtzane.laka@cleverdev.app,035088,ES90209568654031467919,7789.48,2024-06-18T08:54:11,Bilbao,expenses,appliances,-235.89,-54932.11
buyer_7,Agurtzane,Laka,1968-12-31,32779298C,agurtzane.laka@cleverdev.app,035088,ES90209568654031467919,7789.48,2024-06-21T15:11:35,Bilbao,expenses,transport,-42.3,-54974.41
buyer_7,Agurtzane,Laka,1968-12-31,32779298C,agurtzane.laka@cleverdev.app,035088,ES90209568654031467919,7789.48,2024-06-22T03:10:35,Bilbao,expenses,healthcare,-55.19,-55029.6
buyer_7,Agurtzane,Laka,1968-12-31,32779298C,agurtzane.laka@cleverdev.app,035088,ES90209568654031467919,7789.48,2024-06-23T09:54:17,Bilbao,expenses,appliances,-216.38,-55245.98
buyer_7,Agurtzane,Laka,1968-12-31,32779298C,agurtzane.laka@cleverdev.app,035088,ES90209568654031467919,7789.48,2024-06-25T15:38:34,Bilbao,expenses,transport,-75.85,-55321.83
buyer_7,Agurtzane,Laka,1968-12-31,32779298C,agurtzane.laka@cleverdev.app,035088,ES90209568654031467919,7789.48,2024-06-26T20:54:48,Bilbao,expenses,transport,-65.42,-55387.25
buyer_7,Agurtzane,Laka,1968-12-31,32779298C,agurtzane.laka@cleverdev.app,035088,ES90209568654031467919,7789.48,2024-06-26T13:58:23,Bilbao,expenses,gifts,-28.94,-55416.19
buyer_7,Agurtzane,Laka,1968-12-31,32779298C,agurtzane.laka@cleverdev.app,035088,ES90209568654031467919,7789.48,2024-06-27T15:19:34,Bilbao,expenses,leisure,-80.24,-55496.43
buyer_7,Agurtzane,Laka,1968-12-31,32779298C,agurtzane.laka@cleverdev.app,035088,ES90209568654031467919,7789.48,2024-06-28T07:34:31,Bilbao,expenses,appliances,-190.12,-55686.55
buyer_7,Agurtzane,Laka,1968-12-31,32779298C,agurtzane.laka@cleverdev.app,035088,ES90209568654031467919,7789.48,2024-07-01T10:31:35,Bilbao,incomes,salary,1470.78,-54215.77
buyer_7,Agurtzane,Laka,1968-12-31,32779298C,agurtzane.laka@cleverdev.app,035088,ES90209568654031467919,7789.48,2024-07-01T14:59:14,Bilbao,expenses,clothing,-135.95,-54351.72
buyer_7,Agurtzane,Laka,1968-12-31,32779298C,agurtzane.laka@cleverdev.app,035088,ES90209568654031467919,7789.48,2024-07-04T19:31:17,Bilbao,expenses,leisure,-40.76,-54392.48
buyer_7,Agurtzane,Laka,1968-12-31,32779298C,agurtzane.laka@cleverdev.app,035088,ES90209568654031467919,7789.48,2024-07-04T14:18:07,Bilbao,expenses,cash,-100.0,-54492.48
buyer_7,Agurtzane,Laka,1968-12-31,32779298C,agurtzane.laka@cleverdev.app,035088,ES90209568654031467919,7789.48,2024-07-05T16:24:22,Bilbao,expenses,mortgage,-756.26,-55248.74
buyer_7,Agurtzane,Laka,1968-12-31,32779298C,agurtzane.laka@cleverdev.app,035088,ES90209568654031467919,7789.48,2024-07-05T00:16:47,Bilbao,expenses,gas,-48.56,-55297.3
buyer_7,Agurtzane,Laka,1968-12-31,32779298C,agurtzane.laka@cleverdev.app,035088,ES90209568654031467919,7789.48,2024-07-05T08:35:56,Bilbao,expenses,children,-217.59,-55514.89
buyer_7,Agurtzane,Laka,1968-12-31,32779298C,agurtzane.laka@cleverdev.app,035088,ES90209568654031467919,7789.48,2024-07-06T13:59:00,Bilbao,expenses,gas,-50.02,-55564.91
buyer_7,Agurtzane,Laka,1968-12-31,32779298C,agurtzane.laka@cleverdev.app,035088,ES90209568654031467919,7789.48,2024-07-06T23:07:49,Bilbao,expenses,internet,-30.89,-55595.8
buyer_7,Agurtzane,Laka,1968-12-31,32779298C,agurtzane.laka@cleverdev.app,035088,ES90209568654031467919,7789.48,2024-07-06T09:24:07,Bilbao,expenses,cash,-100.0,-55695.8
buyer_7,Agurtzane,Laka,1968-12-31,32779298C,agurtzane.laka@cleverdev.app,035088,ES90209568654031467919,7789.48,2024-07-07T08:55:03,Bilbao,expenses,food,-74.36,-55770.16
buyer_7,Agurtzane,Laka,1968-12-31,32779298C,agurtzane.laka@cleverdev.app,035088,ES90209568654031467919,7789.48,2024-07-07T08:42:11,Bilbao,expenses,transport,-74.23,-55844.39
buyer_7,Agurtzane,Laka,1968-12-31,32779298C,agurtzane.laka@cleverdev.app,035088,ES90209568654031467919,7789.48,2024-07-08T00:14:16,Bilbao,expenses,water,-24.45,-55868.84
buyer_7,Agurtzane,Laka,1968-12-31,32779298C,agurtzane.laka@cleverdev.app,035088,ES90209568654031467919,7789.48,2024-07-09T19:44:11,Bilbao,expenses,transport,-80.88,-55949.72
buyer_7,Agurtzane,Laka,1968-12-31,32779298C,agurtzane.laka@cleverdev.app,035088,ES90209568654031467919,7789.48,2024-07-09T13:54:18,Bilbao,expenses,repairs,-129.2,-56078.92
buyer_7,Agurtzane,Laka,1968-12-31,32779298C,agurtzane.laka@cleverdev.app,035088,ES90209568654031467919,7789.48,2024-07-10T16:40:49,Bilbao,expenses,food,-100.56,-56179.48
buyer_7,Agurtzane,Laka,1968-12-31,32779298C,agurtzane.laka@cleverdev.app,035088,ES90209568654031467919,7789.48,2024-07-10T13:11:31,Bilbao,expenses,leisure,-22.11,-56201.59
buyer_7,Agurtzane,Laka,1968-12-31,32779298C,agurtzane.laka@cleverdev.app,035088,ES90209568654031467919,7789.48,2024-07-11T12:51:30,Bilbao,expenses,cash,-100.0,-56301.59
buyer_7,Agurtzane,Laka,1968-12-31,32779298C,agurtzane.laka@cleverdev.app,035088,ES90209568654031467919,7789.48,2024-07-12T17:32:57,Bilbao,expenses,cash,-100.0,-56401.59
buyer_7,Agurtzane,Laka,1968-12-31,32779298C,agurtzane.laka@cleverdev.app,035088,ES90209568654031467919,7789.48,2024-07-13T21:03:54,Bilbao,expenses,gifts,-30.61,-56432.2
buyer_7,Agurtzane,Laka,1968-12-31,32779298C,agurtzane.laka@cleverdev.app,035088,ES90209568654031467919,7789.48,2024-07-14T16:21:21,Bilbao,expenses,appliances,-245.26,-56677.46
buyer_7,Agurtzane,Laka,1968-12-31,32779298C,agurtzane.laka@cleverdev.app,035088,ES90209568654031467919,7789.48,2024-07-20T18:15:34,Bilbao,expenses,transport,-56.52,-56733.98
buyer_7,Agurtzane,Laka,1968-12-31,32779298C,agurtzane.laka@cleverdev.app,035088,ES90209568654031467919,7789.48,2024-07-21T09:54:59,Bilbao,expenses,clothing,-59.69,-56793.67
buyer_7,Agurtzane,Laka,1968-12-31,32779298C,agurtzane.laka@cleverdev.app,035088,ES90209568654031467919,7789.48,2024-07-21T18:19:45,Bilbao,expenses,repairs,-124.59,-56918.26
buyer_7,Agurtzane,Laka,1968-12-31,32779298C,agurtzane.laka@cleverdev.app,035088,ES90209568654031467919,7789.48,2024-07-23T11:08:23,Bilbao,expenses,food,-77.0,-56995.26
buyer_7,Agurtzane,Laka,1968-12-31,32779298C,agurtzane.laka@cleverdev.app,035088,ES90209568654031467919,7789.48,2024-07-23T16:40:50,Bilbao,expenses,leisure,-84.56,-57079.82
buyer_7,Agurtzane,Laka,1968-12-31,32779298C,agurtzane.laka@cleverdev.app,035088,ES90209568654031467919,7789.48,2024-07-23T10:09:32,Bilbao,expenses,cash,-100.0,-57179.82
buyer_7,Agurtzane,Laka,1968-12-31,32779298C,agurtzane.laka@cleverdev.app,035088,ES90209568654031467919,7789.48,2024-07-25T19:27:20,Bilbao,expenses,education,-51.33,-57231.15
buyer_7,Agurtzane,Laka,1968-12-31,32779298C,agurtzane.laka@cleverdev.app,035088,ES90209568654031467919,7789.48,2024-07-28T17:11:35,Bilbao,expenses,food,-96.91,-57328.06
buyer_7,Agurtzane,Laka,1968-12-31,32779298C,agurtzane.laka@cleverdev.app,035088,ES90209568654031467919,7789.48,2024-07-29T14:24:49,Bilbao,expenses,transport,-62.24,-57390.3
buyer_7,Agurtzane,Laka,1968-12-31,32779298C,agurtzane.laka@cleverdev.app,035088,ES90209568654031467919,7789.48,2024-07-30T09:35:55,Bilbao,expenses,transport,-74.89,-57465.19
buyer_7,Agurtzane,Laka,1968-12-31,32779298C,agurtzane.laka@cleverdev.app,035088,ES90209568654031467919,7789.48,2024-07-30T17:11:43,Bilbao,expenses,leisure,-68.6,-57533.79
buyer_7,Agurtzane,Laka,1968-12-31,32779298C,agurtzane.laka@cleverdev.app,035088,ES90209568654031467919,7789.48,2024-07-30T09:35:03,Bilbao,expenses,education,-78.94,-57612.73
buyer_7,Agurtzane,Laka,1968-12-31,32779298C,agurtzane.laka@cleverdev.app,035088,ES90209568654031467919,7789.48,2024-08-01T15:02:55,Bilbao,incomes,salary,1470.78,-56141.95
buyer_7,Agurtzane,Laka,1968-12-31,32779298C,agurtzane.laka@cleverdev.app,035088,ES90209568654031467919,7789.48,2024-08-01T12:04:45,Bilbao,expenses,transport,-65.11,-56207.06
buyer_7,Agurtzane,Laka,1968-12-31,32779298C,agurtzane.laka@cleverdev.app,035088,ES90209568654031467919,7789.48,2024-08-01T13:18:51,Bilbao,expenses,leisure,-20.11,-56227.17
buyer_7,Agurtzane,Laka,1968-12-31,32779298C,agurtzane.laka@cleverdev.app,035088,ES90209568654031467919,7789.48,2024-08-01T10:14:44,Bilbao,expenses,cash,-100.0,-56327.17
buyer_7,Agurtzane,Laka,1968-12-31,32779298C,agurtzane.laka@cleverdev.app,035088,ES90209568654031467919,7789.48,2024-08-01T15:33:50,Bilbao,expenses,gifts,-52.06,-56379.23
buyer_7,Agurtzane,Laka,1968-12-31,32779298C,agurtzane.laka@cleverdev.app,035088,ES90209568654031467919,7789.48,2024-08-02T11:34:33,Bilbao,expenses,food,-107.62,-56486.85
buyer_7,Agurtzane,Laka,1968-12-31,32779298C,agurtzane.laka@cleverdev.app,035088,ES90209568654031467919,7789.48,2024-08-03T19:24:02,Bilbao,expenses,gifts,-174.51,-56661.36
buyer_7,Agurtzane,Laka,1968-12-31,32779298C,agurtzane.laka@cleverdev.app,035088,ES90209568654031467919,7789.48,2024-08-04T18:02:36,Bilbao,expenses,transport,-68.0,-56729.36
buyer_7,Agurtzane,Laka,1968-12-31,32779298C,agurtzane.laka@cleverdev.app,035088,ES90209568654031467919,7789.48,2024-08-04T10:16:05,Bilbao,expenses,leisure,-81.46,-56810.82
buyer_7,Agurtzane,Laka,1968-12-31,32779298C,agurtzane.laka@cleverdev.app,035088,ES90209568654031467919,7789.48,2024-08-05T11:07:26,Bilbao,expenses,mortgage,-756.26,-57567.08
buyer_7,Agurtzane,Laka,1968-12-31,32779298C,agurtzane.laka@cleverdev.app,035088,ES90209568654031467919,7789.48,2024-08-05T20:52:02,Bilbao,expenses,electricity,-63.47,-57630.55
buyer_7,Agurtzane,Laka,1968-12-31,32779298C,agurtzane.laka@cleverdev.app,035088,ES90209568654031467919,7789.48,2024-08-05T22:03:36,Bilbao,expenses,phone,-27.42,-57657.97
buyer_7,Agurtzane,Laka,1968-12-31,32779298C,agurtzane.laka@cleverdev.app,035088,ES90209568654031467919,7789.48,2024-08-05T06:28:37,Bilbao,expenses,leisure,-40.85,-57698.82
buyer_7,Agurtzane,Laka,1968-12-31,32779298C,agurtzane.laka@cleverdev.app,035088,ES90209568654031467919,7789.48,2024-08-05T09:20:12,Bilbao,expenses,cash,-100.0,-57798.82
buyer_7,Agurtzane,Laka,1968-12-31,32779298C,agurtzane.laka@cleverdev.app,035088,ES90209568654031467919,7789.48,2024-08-06T16:43:17,Bilbao,expenses,transport,-52.01,-57850.83
buyer_7,Agurtzane,Laka,1968-12-31,32779298C,agurtzane.laka@cleverdev.app,035088,ES90209568654031467919,7789.48,2024-08-07T18:56:45,Bilbao,expenses,repairs,-199.88,-58050.71
buyer_7,Agurtzane,Laka,1968-12-31,32779298C,agurtzane.laka@cleverdev.app,035088,ES90209568654031467919,7789.48,2024-08-08T10:16:59,Bilbao,expenses,food,-108.6,-58159.31
buyer_7,Agurtzane,Laka,1968-12-31,32779298C,agurtzane.laka@cleverdev.app,035088,ES90209568654031467919,7789.48,2024-08-08T14:04:16,Bilbao,expenses,cash,-100.0,-58259.31
buyer_7,Agurtzane,Laka,1968-12-31,32779298C,agurtzane.laka@cleverdev.app,035088,ES90209568654031467919,7789.48,2024-08-10T18:03:12,Bilbao,expenses,repairs,-148.88,-58408.19
buyer_7,Agurtzane,Laka,1968-12-31,32779298C,agurtzane.laka@cleverdev.app,035088,ES90209568654031467919,7789.48,2024-08-11T13:12:50,Bilbao,expenses,repairs,-47.26,-58455.45
buyer_7,Agurtzane,Laka,1968-12-31,32779298C,agurtzane.laka@cleverdev.app,035088,ES90209568654031467919,7789.48,2024-08-13T13:14:43,Bilbao,expenses,food,-90.66,-58546.11
buyer_7,Agurtzane,Laka,1968-12-31,32779298C,agurtzane.laka@cleverdev.app,035088,ES90209568654031467919,7789.48,2024-08-14T14:57:44,Bilbao,expenses,healthcare,-88.01,-58634.12
buyer_7,Agurtzane,Laka,1968-12-31,32779298C,agurtzane.laka@cleverdev.app,035088,ES90209568654031467919,7789.48,2024-08-16T17:57:55,Bilbao,expenses,cash,-100.0,-58734.12
buyer_7,Agurtzane,Laka,1968-12-31,32779298C,agurtzane.laka@cleverdev.app,035088,ES90209568654031467919,7789.48,2024-08-16T08:49:10,Bilbao,expenses,gifts,-135.62,-58869.74
buyer_7,Agurtzane,Laka,1968-12-31,32779298C,agurtzane.laka@cleverdev.app,035088,ES90209568654031467919,7789.48,2024-08-17T13:28:40,Bilbao,expenses,food,-81.69,-58951.43
buyer_7,Agurtzane,Laka,1968-12-31,32779298C,agurtzane.laka@cleverdev.app,035088,ES90209568654031467919,7789.48,2024-08-18T10:19:05,Bilbao,expenses,clothing,-123.24,-59074.67
buyer_7,Agurtzane,Laka,1968-12-31,32779298C,agurtzane.laka@cleverdev.app,035088,ES90209568654031467919,7789.48,2024-08-19T13:55:16,Bilbao,expenses,cash,-100.0,-59174.67
buyer_7,Agurtzane,Laka,1968-12-31,32779298C,agurtzane.laka@cleverdev.app,035088,ES90209568654031467919,7789.48,2024-08-21T16:07:32,Bilbao,expenses,cash,-100.0,-59274.67
buyer_7,Agurtzane,Laka,1968-12-31,32779298C,agurtzane.laka@cleverdev.app,035088,ES90209568654031467919,7789.48,2024-08-23T22:04:04,Bilbao,expenses,food,-109.05,-59383.72
buyer_7,Agurtzane,Laka,1968-12-31,32779298C,agurtzane.laka@cleverdev.app,035088,ES90209568654031467919,7789.48,2024-08-26T19:34:39,Bilbao,expenses,clothing,-46.27,-59429.99
buyer_7,Agurtzane,Laka,1968-12-31,32779298C,agurtzane.laka@cleverdev.app,035088,ES90209568654031467919,7789.48,2024-08-26T08:56:21,Bilbao,expenses,appliances,-113.07,-59543.06
buyer_7,Agurtzane,Laka,1968-12-31,32779298C,agurtzane.laka@cleverdev.app,035088,ES90209568654031467919,7789.48,2024-08-28T17:31:15,Bilbao,expenses,food,-76.68,-59619.74
buyer_7,Agurtzane,Laka,1968-12-31,32779298C,agurtzane.laka@cleverdev.app,035088,ES90209568654031467919,7789.48,2024-08-28T13:37:35,Bilbao,expenses,healthcare,-83.02,-59702.76
buyer_7,Agurtzane,Laka,1968-12-31,32779298C,agurtzane.laka@cleverdev.app,035088,ES90209568654031467919,7789.48,2024-08-30T12:32:05,Bilbao,expenses,cash,-100.0,-59802.76
buyer_7,Agurtzane,Laka,1968-12-31,32779298C,agurtzane.laka@cleverdev.app,035088,ES90209568654031467919,7789.48,2024-09-01T07:34:55,Bilbao,incomes,salary,1470.78,-58331.98
buyer_7,Agurtzane,Laka,1968-12-31,32779298C,agurtzane.laka@cleverdev.app,035088,ES90209568654031467919,7789.48,2024-09-02T16:03:42,Bilbao,expenses,transport,-83.08,-58415.06
buyer_7,Agurtzane,Laka,1968-12-31,32779298C,agurtzane.laka@cleverdev.app,035088,ES90209568654031467919,7789.48,2024-09-03T14:16:12,Bilbao,expenses,transport,-83.72,-58498.78
buyer_7,Agurtzane,Laka,1968-12-31,32779298C,agurtzane.laka@cleverdev.app,035088,ES90209568654031467919,7789.48,2024-09-03T20:43:40,Bilbao,expenses,children,-74.33,-58573.11
buyer_7,Agurtzane,Laka,1968-12-31,32779298C,agurtzane.laka@cleverdev.app,035088,ES90209568654031467919,7789.48,2024-09-05T15:56:06,Bilbao,expenses,mortgage,-756.26,-59329.37
buyer_7,Agurtzane,Laka,1968-12-31,32779298C,agurtzane.laka@cleverdev.app,035088,ES90209568654031467919,7789.48,2024-09-05T14:18:08,Bilbao,expenses,water,-18.69,-59348.06
buyer_7,Agurtzane,Laka,1968-12-31,32779298C,agurtzane.laka@cleverdev.app,035088,ES90209568654031467919,7789.48,2024-09-05T10:21:07,Bilbao,expenses,gifts,-201.74,-59549.8
buyer_7,Agurtzane,Laka,1968-12-31,32779298C,agurtzane.laka@cleverdev.app,035088,ES90209568654031467919,7789.48,2024-09-06T11:17:11,Bilbao,expenses,phone,-31.12,-59580.92
buyer_7,Agurtzane,Laka,1968-12-31,32779298C,agurtzane.laka@cleverdev.app,035088,ES90209568654031467919,7789.48,2024-09-06T12:36:41,Bilbao,expenses,transport,-43.15,-59624.07
buyer_7,Agurtzane,Laka,1968-12-31,32779298C,agurtzane.laka@cleverdev.app,035088,ES90209568654031467919,7789.48,2024-09-07T12:56:06,Bilbao,expenses,gas,-61.59,-59685.66
buyer_7,Agurtzane,Laka,1968-12-31,32779298C,agurtzane.laka@cleverdev.app,035088,ES90209568654031467919,7789.48,2024-09-07T14:27:18,Bilbao,expenses,internet,-30.89,-59716.55
buyer_7,Agurtzane,Laka,1968-12-31,32779298C,agurtzane.laka@cleverdev.app,035088,ES90209568654031467919,7789.48,2024-09-08T04:34:27,Bilbao,expenses,water,-29.7,-59746.25
buyer_7,Agurtzane,Laka,1968-12-31,32779298C,agurtzane.laka@cleverdev.app,035088,ES90209568654031467919,7789.48,2024-09-08T11:14:06,Bilbao,expenses,food,-111.73,-59857.98
buyer_7,Agurtzane,Laka,1968-12-31,32779298C,agurtzane.laka@cleverdev.app,035088,ES90209568654031467919,7789.48,2024-09-09T09:26:10,Bilbao,expenses,cash,-100.0,-59957.98
buyer_7,Agurtzane,Laka,1968-12-31,32779298C,agurtzane.laka@cleverdev.app,035088,ES90209568654031467919,7789.48,2024-09-11T17:01:43,Bilbao,expenses,food,-72.56,-60030.54
buyer_7,Agurtzane,Laka,1968-12-31,32779298C,agurtzane.laka@cleverdev.app,035088,ES90209568654031467919,7789.48,2024-09-12T11:39:30,Bilbao,expenses,leisure,-37.24,-60067.78
buyer_7,Agurtzane,Laka,1968-12-31,32779298C,agurtzane.laka@cleverdev.app,035088,ES90209568654031467919,7789.48,2024-09-12T11:56:08,Bilbao,expenses,healthcare,-47.23,-60115.01
buyer_7,Agurtzane,Laka,1968-12-31,32779298C,agurtzane.laka@cleverdev.app,035088,ES90209568654031467919,7789.48,2024-09-13T11:20:20,Bilbao,expenses,leisure,-80.31,-60195.32
buyer_7,Agurtzane,Laka,1968-12-31,32779298C,agurtzane.laka@cleverdev.app,035088,ES90209568654031467919,7789.48,2024-09-14T18:14:38,Bilbao,expenses,healthcare,-173.81,-60369.13
buyer_7,Agurtzane,Laka,1968-12-31,32779298C,agurtzane.laka@cleverdev.app,035088,ES90209568654031467919,7789.48,2024-09-16T10:21:06,Bilbao,expenses,leisure,-62.18,-60431.31
buyer_7,Agurtzane,Laka,1968-12-31,32779298C,agurtzane.laka@cleverdev.app,035088,ES90209568654031467919,7789.48,2024-09-18T20:23:34,Bilbao,expenses,repairs,-64.35,-60495.66
buyer_7,Agurtzane,Laka,1968-12-31,32779298C,agurtzane.laka@cleverdev.app,035088,ES90209568654031467919,7789.48,2024-09-19T20:19:46,Bilbao,expenses,transport,-54.72,-60550.38
buyer_7,Agurtzane,Laka,1968-12-31,32779298C,agurtzane.laka@cleverdev.app,035088,ES90209568654031467919,7789.48,2024-09-21T08:05:20,Bilbao,expenses,children,-97.47,-60647.85
buyer_7,Agurtzane,Laka,1968-12-31,32779298C,agurtzane.laka@cleverdev.app,035088,ES90209568654031467919,7789.48,2024-09-23T13:04:56,Bilbao,expenses,food,-66.64,-60714.49
buyer_7,Agurtzane,Laka,1968-12-31,32779298C,agurtzane.laka@cleverdev.app,035088,ES90209568654031467919,7789.48,2024-09-24T23:05:22,Bilbao,expenses,transport,-50.33,-60764.82
buyer_7,Agurtzane,Laka,1968-12-31,32779298C,agurtzane.laka@cleverdev.app,035088,ES90209568654031467919,7789.48,2024-09-25T14:02:27,Bilbao,expenses,food,-119.79,-60884.61
buyer_7,Agurtzane,Laka,1968-12-31,32779298C,agurtzane.laka@cleverdev.app,035088,ES90209568654031467919,7789.48,2024-09-29T16:08:10,Bilbao,expenses,transport,-42.05,-60926.66
buyer_7,Agurtzane,Laka,1968-12-31,32779298C,agurtzane.laka@cleverdev.app,035088,ES90209568654031467919,7789.48,2024-09-29T09:56:56,Bilbao,expenses,cash,-100.0,-61026.66
buyer_7,Agurtzane,Laka,1968-12-31,32779298C,agurtzane.laka@cleverdev.app,035088,ES90209568654031467919,7789.48,2024-09-30T12:07:33,Bilbao,expenses,cash,-100.0,-61126.66
buyer_7,Agurtzane,Laka,1968-12-31,32779298C,agurtzane.laka@cleverdev.app,035088,ES90209568654031467919,7789.48,2024-10-01T17:21:01,Bilbao,incomes,salary,1470.78,-59655.88
buyer_7,Agurtzane,Laka,1968-12-31,32779298C,agurtzane.laka@cleverdev.app,035088,ES90209568654031467919,7789.48,2024-10-01T17:21:01,Bilbao,incomes,extra_income,242.27,-59413.61
buyer_7,Agurtzane,Laka,1968-12-31,32779298C,agurtzane.laka@cleverdev.app,035088,ES90209568654031467919,7789.48,2024-10-01T09:49:34,Bilbao,expenses,gifts,-259.39,-59673.0
buyer_7,Agurtzane,Laka,1968-12-31,32779298C,agurtzane.laka@cleverdev.app,035088,ES90209568654031467919,7789.48,2024-10-02T22:18:14,Bilbao,expenses,food,-115.39,-59788.39
buyer_7,Agurtzane,Laka,1968-12-31,32779298C,agurtzane.laka@cleverdev.app,035088,ES90209568654031467919,7789.48,2024-10-02T15:35:36,Bilbao,expenses,travel,-251.81,-60040.2
buyer_7,Agurtzane,Laka,1968-12-31,32779298C,agurtzane.laka@cleverdev.app,035088,ES90209568654031467919,7789.48,2024-10-05T17:41:50,Bilbao,expenses,mortgage,-756.26,-60796.46
buyer_7,Agurtzane,Laka,1968-12-31,32779298C,agurtzane.laka@cleverdev.app,035088,ES90209568654031467919,7789.48,2024-10-06T06:06:19,Bilbao,expenses,internet,-30.89,-60827.35
buyer_7,Agurtzane,Laka,1968-12-31,32779298C,agurtzane.laka@cleverdev.app,035088,ES90209568654031467919,7789.48,2024-10-06T18:39:28,Bilbao,expenses,phone,-32.27,-60859.62
buyer_7,Agurtzane,Laka,1968-12-31,32779298C,agurtzane.laka@cleverdev.app,035088,ES90209568654031467919,7789.48,2024-10-06T08:03:56,Bilbao,expenses,transport,-68.98,-60928.6
buyer_7,Agurtzane,Laka,1968-12-31,32779298C,agurtzane.laka@cleverdev.app,035088,ES90209568654031467919,7789.48,2024-10-06T22:06:53,Bilbao,expenses,clothing,-47.24,-60975.84
buyer_7,Agurtzane,Laka,1968-12-31,32779298C,agurtzane.laka@cleverdev.app,035088,ES90209568654031467919,7789.48,2024-10-06T11:13:50,Bilbao,expenses,cash,-100.0,-61075.84
buyer_7,Agurtzane,Laka,1968-12-31,32779298C,agurtzane.laka@cleverdev.app,035088,ES90209568654031467919,7789.48,2024-10-07T10:14:23,Bilbao,expenses,water,-19.36,-61095.2
buyer_7,Agurtzane,Laka,1968-12-31,32779298C,agurtzane.laka@cleverdev.app,035088,ES90209568654031467919,7789.48,2024-10-07T12:39:27,Bilbao,expenses,gas,-79.21,-61174.41
buyer_7,Agurtzane,Laka,1968-12-31,32779298C,agurtzane.laka@cleverdev.app,035088,ES90209568654031467919,7789.48,2024-10-08T14:48:22,Bilbao,expenses,repairs,-228.3,-61402.71
buyer_7,Agurtzane,Laka,1968-12-31,32779298C,agurtzane.laka@cleverdev.app,035088,ES90209568654031467919,7789.48,2024-10-09T14:29:19,Bilbao,expenses,children,-136.73,-61539.44
buyer_7,Agurtzane,Laka,1968-12-31,32779298C,agurtzane.laka@cleverdev.app,035088,ES90209568654031467919,7789.48,2024-10-11T06:17:41,Bilbao,expenses,clothing,-135.58,-61675.02
buyer_8,Patxi,Urrutia,1979-04-04,44624658N,patxi.urrutia@megaapp.net,322320,ES17209589367889501335,1423.95,2022-01-01T08:45:13,Durango,incomes,salary,4021.74,5445.69
buyer_8,Patxi,Urrutia,1979-04-04,44624658N,patxi.urrutia@megaapp.net,322320,ES17209589367889501335,1423.95,2022-01-01T20:04:12,Durango,expenses,transport,-58.03,5387.66
buyer_8,Patxi,Urrutia,1979-04-04,44624658N,patxi.urrutia@megaapp.net,322320,ES17209589367889501335,1423.95,2022-01-01T15:02:40,Durango,expenses,leisure,-68.92,5318.74
buyer_8,Patxi,Urrutia,1979-04-04,44624658N,patxi.urrutia@megaapp.net,322320,ES17209589367889501335,1423.95,2022-01-02T15:48:54,Durango,expenses,education,-77.43,5241.31
buyer_8,Patxi,Urrutia,1979-04-04,44624658N,patxi.urrutia@megaapp.net,322320,ES17209589367889501335,1423.95,2022-01-04T19:35:26,Durango,expenses,cash,-100.0,5141.31
buyer_8,Patxi,Urrutia,1979-04-04,44624658N,patxi.urrutia@megaapp.net,322320,ES17209589367889501335,1423.95,2022-01-05T12:45:58,Durango,expenses,mortgage,-2234.07,2907.24
buyer_8,Patxi,Urrutia,1979-04-04,44624658N,patxi.urrutia@megaapp.net,322320,ES17209589367889501335,1423.95,2022-01-05T09:08:36,Durango,expenses,water,-78.6,2828.64
buyer_8,Patxi,Urrutia,1979-04-04,44624658N,patxi.urrutia@megaapp.net,322320,ES17209589367889501335,1423.95,2022-01-05T23:02:55,Durango,expenses,food,-83.61,2745.03
buyer_8,Patxi,Urrutia,1979-04-04,44624658N,patxi.urrutia@megaapp.net,322320,ES17209589367889501335,1423.95,2022-01-05T10:12:33,Durango,expenses,leisure,-26.12,2718.91
buyer_8,Patxi,Urrutia,1979-04-04,44624658N,patxi.urrutia@megaapp.net,322320,ES17209589367889501335,1423.95,2022-01-05T11:07:57,Durango,expenses,cash,-100.0,2618.91
buyer_8,Patxi,Urrutia,1979-04-04,44624658N,patxi.urrutia@megaapp.net,322320,ES17209589367889501335,1423.95,2022-01-05T17:43:56,Durango,expenses,appliances,-375.71,2243.2
buyer_8,Patxi,Urrutia,1979-04-04,44624658N,patxi.urrutia@megaapp.net,322320,ES17209589367889501335,1423.95,2022-01-06T16:18:03,Durango,expenses,gas,-162.6,2080.6
buyer_8,Patxi,Urrutia,1979-04-04,44624658N,patxi.urrutia@megaapp.net,322320,ES17209589367889501335,1423.95,2022-01-06T19:45:14,Durango,expenses,phone,-90.13,1990.47
buyer_8,Patxi,Urrutia,1979-04-04,44624658N,patxi.urrutia@megaapp.net,322320,ES17209589367889501335,1423.95,2022-01-06T16:36:27,Durango,expenses,leisure,-38.7,1951.77
buyer_8,Patxi,Urrutia,1979-04-04,44624658N,patxi.urrutia@megaapp.net,322320,ES17209589367889501335,1423.95,2022-01-07T14:50:39,Durango,expenses,internet,-92.9,1858.87
buyer_8,Patxi,Urrutia,1979-04-04,44624658N,patxi.urrutia@megaapp.net,322320,ES17209589367889501335,1423.95,2022-01-07T16:50:42,Durango,expenses,education,-55.8,1803.07
buyer_8,Patxi,Urrutia,1979-04-04,44624658N,patxi.urrutia@megaapp.net,322320,ES17209589367889501335,1423.95,2022-01-08T15:00:48,Durango,expenses,water,-85.05,1718.02
buyer_8,Patxi,Urrutia,1979-04-04,44624658N,patxi.urrutia@megaapp.net,322320,ES17209589367889501335,1423.95,2022-01-08T10:29:06,Durango,expenses,electricity,-165.73,1552.29
buyer_8,Patxi,Urrutia,1979-04-04,44624658N,patxi.urrutia@megaapp.net,322320,ES17209589367889501335,1423.95,2022-01-08T12:28:48,Durango,expenses,food,-83.37,1468.92
buyer_8,Patxi,Urrutia,1979-04-04,44624658N,patxi.urrutia@megaapp.net,322320,ES17209589367889501335,1423.95,2022-01-08T16:37:27,Durango,expenses,cash,-100.0,1368.92
buyer_8,Patxi,Urrutia,1979-04-04,44624658N,patxi.urrutia@megaapp.net,322320,ES17209589367889501335,1423.95,2022-01-10T13:03:48,Durango,expenses,cash,-100.0,1268.92
buyer_8,Patxi,Urrutia,1979-04-04,44624658N,patxi.urrutia@megaapp.net,322320,ES17209589367889501335,1423.95,2022-01-11T11:14:28,Durango,expenses,food,-102.67,1166.25
buyer_8,Patxi,Urrutia,1979-04-04,44624658N,patxi.urrutia@megaapp.net,322320,ES17209589367889501335,1423.95,2022-01-12T19:19:43,Durango,expenses,transport,-67.3,1098.95
buyer_8,Patxi,Urrutia,1979-04-04,44624658N,patxi.urrutia@megaapp.net,322320,ES17209589367889501335,1423.95,2022-01-12T14:58:42,Durango,expenses,repairs,-116.61,982.34
buyer_8,Patxi,Urrutia,1979-04-04,44624658N,patxi.urrutia@megaapp.net,322320,ES17209589367889501335,1423.95,2022-01-13T19:43:34,Durango,expenses,cash,-100.0,882.34
buyer_8,Patxi,Urrutia,1979-04-04,44624658N,patxi.urrutia@megaapp.net,322320,ES17209589367889501335,1423.95,2022-01-15T20:36:03,Durango,expenses,leisure,-28.64,853.7
buyer_8,Patxi,Urrutia,1979-04-04,44624658N,patxi.urrutia@megaapp.net,322320,ES17209589367889501335,1423.95,2022-01-17T13:54:31,Durango,expenses,repairs,-75.53,778.17
buyer_8,Patxi,Urrutia,1979-04-04,44624658N,patxi.urrutia@megaapp.net,322320,ES17209589367889501335,1423.95,2022-01-19T12:25:17,Durango,expenses,leisure,-35.78,742.39
buyer_8,Patxi,Urrutia,1979-04-04,44624658N,patxi.urrutia@megaapp.net,322320,ES17209589367889501335,1423.95,2022-01-20T14:58:53,Durango,expenses,food,-99.76,642.63
buyer_8,Patxi,Urrutia,1979-04-04,44624658N,patxi.urrutia@megaapp.net,322320,ES17209589367889501335,1423.95,2022-01-20T19:01:55,Durango,expenses,repairs,-84.67,557.96
buyer_8,Patxi,Urrutia,1979-04-04,44624658N,patxi.urrutia@megaapp.net,322320,ES17209589367889501335,1423.95,2022-01-22T14:54:51,Durango,expenses,transport,-61.99,495.97
buyer_8,Patxi,Urrutia,1979-04-04,44624658N,patxi.urrutia@megaapp.net,322320,ES17209589367889501335,1423.95,2022-01-22T16:06:38,Durango,expenses,education,-72.51,423.46
buyer_8,Patxi,Urrutia,1979-04-04,44624658N,patxi.urrutia@megaapp.net,322320,ES17209589367889501335,1423.95,2022-01-24T02:24:57,Durango,expenses,healthcare,-152.44,271.02
buyer_8,Patxi,Urrutia,1979-04-04,44624658N,patxi.urrutia@megaapp.net,322320,ES17209589367889501335,1423.95,2022-01-25T10:27:22,Durango,expenses,cash,-100.0,171.02
buyer_8,Patxi,Urrutia,1979-04-04,44624658N,patxi.urrutia@megaapp.net,322320,ES17209589367889501335,1423.95,2022-01-28T18:25:57,Durango,expenses,cash,-100.0,71.02
buyer_8,Patxi,Urrutia,1979-04-04,44624658N,patxi.urrutia@megaapp.net,322320,ES17209589367889501335,1423.95,2022-01-30T09:27:23,Durango,expenses,cash,-100.0,-28.98
buyer_8,Patxi,Urrutia,1979-04-04,44624658N,patxi.urrutia@megaapp.net,322320,ES17209589367889501335,1423.95,2022-02-01T08:47:17,Durango,incomes,salary,4021.74,3992.76
buyer_8,Patxi,Urrutia,1979-04-04,44624658N,patxi.urrutia@megaapp.net,322320,ES17209589367889501335,1423.95,2022-02-01T22:26:05,Durango,expenses,leisure,-31.8,3960.96
buyer_8,Patxi,Urrutia,1979-04-04,44624658N,patxi.urrutia@megaapp.net,322320,ES17209589367889501335,1423.95,2022-02-02T13:12:41,Durango,expenses,clothing,-103.57,3857.39
buyer_8,Patxi,Urrutia,1979-04-04,44624658N,patxi.urrutia@megaapp.net,322320,ES17209589367889501335,1423.95,2022-02-02T12:15:24,Durango,expenses,repairs,-282.51,3574.88
buyer_8,Patxi,Urrutia,1979-04-04,44624658N,patxi.urrutia@megaapp.net,322320,ES17209589367889501335,1423.95,2022-02-04T20:28:17,Durango,expenses,food,-97.96,3476.92
buyer_8,Patxi,Urrutia,1979-04-04,44624658N,patxi.urrutia@megaapp.net,322320,ES17209589367889501335,1423.95,2022-02-05T16:12:37,Durango,expenses,mortgage,-2234.07,1242.85
buyer_8,Patxi,Urrutia,1979-04-04,44624658N,patxi.urrutia@megaapp.net,322320,ES17209589367889501335,1423.95,2022-02-05T11:41:59,Durango,expenses,phone,-99.11,1143.74
buyer_8,Patxi,Urrutia,1979-04-04,44624658N,patxi.urrutia@megaapp.net,322320,ES17209589367889501335,1423.95,2022-02-05T03:45:10,Durango,expenses,food,-72.56,1071.18
buyer_8,Patxi,Urrutia,1979-04-04,44624658N,patxi.urrutia@megaapp.net,322320,ES17209589367889501335,1423.95,2022-02-06T11:25:52,Durango,expenses,internet,-92.9,978.28
buyer_8,Patxi,Urrutia,1979-04-04,44624658N,patxi.urrutia@megaapp.net,322320,ES17209589367889501335,1423.95,2022-02-06T19:02:13,Durango,expenses,clothing,-89.08,889.2
buyer_8,Patxi,Urrutia,1979-04-04,44624658N,patxi.urrutia@megaapp.net,322320,ES17209589367889501335,1423.95,2022-02-07T08:27:37,Durango,expenses,water,-58.68,830.52
buyer_8,Patxi,Urrutia,1979-04-04,44624658N,patxi.urrutia@megaapp.net,322320,ES17209589367889501335,1423.95,2022-02-08T20:53:05,Durango,expenses,water,-72.52,758.0
buyer_8,Patxi,Urrutia,1979-04-04,44624658N,patxi.urrutia@megaapp.net,322320,ES17209589367889501335,1423.95,2022-02-08T15:41:21,Durango,expenses,clothing,-69.44,688.56
buyer_8,Patxi,Urrutia,1979-04-04,44624658N,patxi.urrutia@megaapp.net,322320,ES17209589367889501335,1423.95,2022-02-08T20:03:12,Durango,expenses,cash,-100.0,588.56
buyer_8,Patxi,Urrutia,1979-04-04,44624658N,patxi.urrutia@megaapp.net,322320,ES17209589367889501335,1423.95,2022-02-09T14:22:13,Durango,expenses,clothing,-155.87,432.69
buyer_8,Patxi,Urrutia,1979-04-04,44624658N,patxi.urrutia@megaapp.net,322320,ES17209589367889501335,1423.95,2022-02-14T10:03:14,Durango,expenses,food,-85.06,347.63
buyer_8,Patxi,Urrutia,1979-04-04,44624658N,patxi.urrutia@megaapp.net,322320,ES17209589367889501335,1423.95,2022-02-14T14:17:30,Durango,expenses,transport,-80.56,267.07
buyer_8,Patxi,Urrutia,1979-04-04,44624658N,patxi.urrutia@megaapp.net,322320,ES17209589367889501335,1423.95,2022-02-14T08:52:26,Durango,expenses,repairs,-73.14,193.93
buyer_8,Patxi,Urrutia,1979-04-04,44624658N,patxi.urrutia@megaapp.net,322320,ES17209589367889501335,1423.95,2022-02-15T13:36:13,Durango,expenses,transport,-53.81,140.12
buyer_8,Patxi,Urrutia,1979-04-04,44624658N,patxi.urrutia@megaapp.net,322320,ES17209589367889501335,1423.95,2022-02-15T14:39:10,Durango,expenses,clothing,-108.75,31.37
buyer_8,Patxi,Urrutia,1979-04-04,44624658N,patxi.urrutia@megaapp.net,322320,ES17209589367889501335,1423.95,2022-02-17T20:16:51,Durango,expenses,food,-106.87,-75.5
buyer_8,Patxi,Urrutia,1979-04-04,44624658N,patxi.urrutia@megaapp.net,322320,ES17209589367889501335,1423.95,2022-02-17T17:58:30,Durango,expenses,transport,-71.52,-147.02
buyer_8,Patxi,Urrutia,1979-04-04,44624658N,patxi.urrutia@megaapp.net,322320,ES17209589367889501335,1423.95,2022-02-18T17:41:28,Durango,expenses,cash,-100.0,-247.02
buyer_8,Patxi,Urrutia,1979-04-04,44624658N,patxi.urrutia@megaapp.net,322320,ES17209589367889501335,1423.95,2022-02-19T16:24:31,Durango,expenses,cash,-100.0,-347.02
buyer_8,Patxi,Urrutia,1979-04-04,44624658N,patxi.urrutia@megaapp.net,322320,ES17209589367889501335,1423.95,2022-02-20T18:38:53,Durango,expenses,food,-89.7,-436.72
buyer_8,Patxi,Urrutia,1979-04-04,44624658N,patxi.urrutia@megaapp.net,322320,ES17209589367889501335,1423.95,2022-02-21T15:47:11,Durango,expenses,food,-112.36,-549.08
buyer_8,Patxi,Urrutia,1979-04-04,44624658N,patxi.urrutia@megaapp.net,322320,ES17209589367889501335,1423.95,2022-02-21T16:29:20,Durango,expenses,leisure,-60.33,-609.41
buyer_8,Patxi,Urrutia,1979-04-04,44624658N,patxi.urrutia@megaapp.net,322320,ES17209589367889501335,1423.95,2022-02-21T19:09:00,Durango,expenses,cash,-100.0,-709.41
buyer_8,Patxi,Urrutia,1979-04-04,44624658N,patxi.urrutia@megaapp.net,322320,ES17209589367889501335,1423.95,2022-02-25T10:17:43,Durango,expenses,food,-61.67,-771.08
buyer_8,Patxi,Urrutia,1979-04-04,44624658N,patxi.urrutia@megaapp.net,322320,ES17209589367889501335,1423.95,2022-02-25T12:08:26,Durango,expenses,transport,-53.62,-824.7
buyer_8,Patxi,Urrutia,1979-04-04,44624658N,patxi.urrutia@megaapp.net,322320,ES17209589367889501335,1423.95,2022-02-25T09:37:45,Durango,expenses,leisure,-68.56,-893.26
buyer_8,Patxi,Urrutia,1979-04-04,44624658N,patxi.urrutia@megaapp.net,322320,ES17209589367889501335,1423.95,2022-02-25T16:46:00,Durango,expenses,gifts,-385.99,-1279.25
buyer_8,Patxi,Urrutia,1979-04-04,44624658N,patxi.urrutia@megaapp.net,322320,ES17209589367889501335,1423.95,2022-03-01T23:16:14,Durango,incomes,salary,4021.74,2742.49
buyer_8,Patxi,Urrutia,1979-04-04,44624658N,patxi.urrutia@megaapp.net,322320,ES17209589367889501335,1423.95,2022-03-01T11:47:48,Durango,expenses,cash,-100.0,2642.49
buyer_8,Patxi,Urrutia,1979-04-04,44624658N,patxi.urrutia@megaapp.net,322320,ES17209589367889501335,1423.95,2022-03-01T17:37:39,Durango,expenses,repairs,-160.68,2481.81
buyer_8,Patxi,Urrutia,1979-04-04,44624658N,patxi.urrutia@megaapp.net,322320,ES17209589367889501335,1423.95,2022-03-02T00:52:17,Durango,expenses,transport,-79.46,2402.35
buyer_8,Patxi,Urrutia,1979-04-04,44624658N,patxi.urrutia@megaapp.net,322320,ES17209589367889501335,1423.95,2022-03-03T09:52:51,Durango,expenses,clothing,-129.13,2273.22
buyer_8,Patxi,Urrutia,1979-04-04,44624658N,patxi.urrutia@megaapp.net,322320,ES17209589367889501335,1423.95,2022-03-03T08:26:59,Durango,expenses,repairs,-237.0,2036.22
buyer_8,Patxi,Urrutia,1979-04-04,44624658N,patxi.urrutia@megaapp.net,322320,ES17209589367889501335,1423.95,2022-03-05T08:50:47,Durango,expenses,mortgage,-2234.07,-197.85
buyer_8,Patxi,Urrutia,1979-04-04,44624658N,patxi.urrutia@megaapp.net,322320,ES17209589367889501335,1423.95,2022-03-05T18:31:54,Durango,expenses,electricity,-98.75,-296.6
buyer_8,Patxi,Urrutia,1979-04-04,44624658N,patxi.urrutia@megaapp.net,322320,ES17209589367889501335,1423.95,2022-03-06T14:22:13,Durango,expenses,water,-97.61,-394.21
buyer_8,Patxi,Urrutia,1979-04-04,44624658N,patxi.urrutia@megaapp.net,322320,ES17209589367889501335,1423.95,2022-03-06T19:56:30,Durango,expenses,cash,-100.0,-494.21
buyer_8,Patxi,Urrutia,1979-04-04,44624658N,patxi.urrutia@megaapp.net,322320,ES17209589367889501335,1423.95,2022-03-07T11:46:53,Durango,expenses,internet,-92.9,-587.11
buyer_8,Patxi,Urrutia,1979-04-04,44624658N,patxi.urrutia@megaapp.net,322320,ES17209589367889501335,1423.95,2022-03-07T20:32:19,Durango,expenses,clothing,-52.63,-639.74
buyer_8,Patxi,Urrutia,1979-04-04,44624658N,patxi.urrutia@megaapp.net,322320,ES17209589367889501335,1423.95,2022-03-08T08:44:58,Durango,expenses,electricity,-46.55,-686.29
buyer_8,Patxi,Urrutia,1979-04-04,44624658N,patxi.urrutia@megaapp.net,322320,ES17209589367889501335,1423.95,2022-03-08T11:59:55,Durango,expenses,internet,-92.9,-779.19
buyer_8,Patxi,Urrutia,1979-04-04,44624658N,patxi.urrutia@megaapp.net,322320,ES17209589367889501335,1423.95,2022-03-08T17:48:28,Durango,expenses,education,-73.1,-852.29
buyer_8,Patxi,Urrutia,1979-04-04,44624658N,patxi.urrutia@megaapp.net,322320,ES17209589367889501335,1423.95,2022-03-13T22:03:00,Durango,expenses,cash,-100.0,-952.29
buyer_8,Patxi,Urrutia,1979-04-04,44624658N,patxi.urrutia@megaapp.net,322320,ES17209589367889501335,1423.95,2022-03-14T21:37:04,Durango,expenses,leisure,-22.55,-974.84
buyer_8,Patxi,Urrutia,1979-04-04,44624658N,patxi.urrutia@megaapp.net,322320,ES17209589367889501335,1423.95,2022-03-14T11:48:05,Durango,expenses,cash,-100.0,-1074.84
buyer_8,Patxi,Urrutia,1979-04-04,44624658N,patxi.urrutia@megaapp.net,322320,ES17209589367889501335,1423.95,2022-03-15T13:37:52,Durango,expenses,cash,-100.0,-1174.84
buyer_8,Patxi,Urrutia,1979-04-04,44624658N,patxi.urrutia@megaapp.net,322320,ES17209589367889501335,1423.95,2022-03-16T10:08:16,Durango,expenses,travel,-629.09,-1803.93
buyer_8,Patxi,Urrutia,1979-04-04,44624658N,patxi.urrutia@megaapp.net,322320,ES17209589367889501335,1423.95,2022-03-18T12:19:28,Durango,expenses,cash,-100.0,-1903.93
buyer_8,Patxi,Urrutia,1979-04-04,44624658N,patxi.urrutia@megaapp.net,322320,ES17209589367889501335,1423.95,2022-03-23T08:13:02,Durango,expenses,leisure,-82.52,-1986.45
buyer_8,Patxi,Urrutia,1979-04-04,44624658N,patxi.urrutia@megaapp.net,322320,ES17209589367889501335,1423.95,2022-03-23T20:09:50,Durango,expenses,cash,-100.0,-2086.45
buyer_8,Patxi,Urrutia,1979-04-04,44624658N,patxi.urrutia@megaapp.net,322320,ES17209589367889501335,1423.95,2022-03-24T18:30:59,Durango,expenses,leisure,-81.78,-2168.23
buyer_8,Patxi,Urrutia,1979-04-04,44624658N,patxi.urrutia@megaapp.net,322320,ES17209589367889501335,1423.95,2022-03-26T15:04:18,Durango,expenses,education,-44.06,-2212.29
buyer_8,Patxi,Urrutia,1979-04-04,44624658N,patxi.urrutia@megaapp.net,322320,ES17209589367889501335,1423.95,2022-03-27T15:50:47,Durango,expenses,cash,-100.0,-2312.29
buyer_8,Patxi,Urrutia,1979-04-04,44624658N,patxi.urrutia@megaapp.net,322320,ES17209589367889501335,1423.95,2022-03-29T16:51:19,Durango,expenses,travel,-377.09,-2689.38
buyer_8,Patxi,Urrutia,1979-04-04,44624658N,patxi.urrutia@megaapp.net,322320,ES17209589367889501335,1423.95,2022-03-31T09:22:21,Durango,expenses,leisure,-49.45,-2738.83
buyer_8,Patxi,Urrutia,1979-04-04,44624658N,patxi.urrutia@megaapp.net,322320,ES17209589367889501335,1423.95,2022-04-01T22:29:38,Durango,incomes,salary,4021.74,1282.91
buyer_8,Patxi,Urrutia,1979-04-04,44624658N,patxi.urrutia@megaapp.net,322320,ES17209589367889501335,1423.95,2022-04-01T22:29:38,Durango,incomes,extra_income,572.97,1855.88
buyer_8,Patxi,Urrutia,1979-04-04,44624658N,patxi.urrutia@megaapp.net,322320,ES17209589367889501335,1423.95,2022-04-01T00:27:52,Durango,expenses,education,-47.69,1808.19
buyer_8,Patxi,Urrutia,1979-04-04,44624658N,patxi.urrutia@megaapp.net,322320,ES17209589367889501335,1423.95,2022-04-02T11:36:01,Durango,expenses,repairs,-117.33,1690.86
buyer_8,Patxi,Urrutia,1979-04-04,44624658N,patxi.urrutia@megaapp.net,322320,ES17209589367889501335,1423.95,2022-04-03T14:23:24,Durango,expenses,clothing,-53.38,1637.48
buyer_8,Patxi,Urrutia,1979-04-04,44624658N,patxi.urrutia@megaapp.net,322320,ES17209589367889501335,1423.95,2022-04-05T15:12:13,Durango,expenses,mortgage,-2234.07,-596.59
buyer_8,Patxi,Urrutia,1979-04-04,44624658N,patxi.urrutia@megaapp.net,322320,ES17209589367889501335,1423.95,2022-04-05T21:01:16,Durango,expenses,electricity,-98.92,-695.51
buyer_8,Patxi,Urrutia,1979-04-04,44624658N,patxi.urrutia@megaapp.net,322320,ES17209589367889501335,1423.95,2022-04-05T11:22:18,Durango,expenses,internet,-92.9,-788.41
buyer_8,Patxi,Urrutia,1979-04-04,44624658N,patxi.urrutia@megaapp.net,322320,ES17209589367889501335,1423.95,2022-04-05T18:57:45,Durango,expenses,leisure,-30.87,-819.28
buyer_8,Patxi,Urrutia,1979-04-04,44624658N,patxi.urrutia@megaapp.net,322320,ES17209589367889501335,1423.95,2022-04-06T19:02:44,Durango,expenses,water,-71.81,-891.09
buyer_8,Patxi,Urrutia,1979-04-04,44624658N,patxi.urrutia@megaapp.net,322320,ES17209589367889501335,1423.95,2022-04-06T19:06:26,Durango,expenses,food,-122.15,-1013.24
buyer_8,Patxi,Urrutia,1979-04-04,44624658N,patxi.urrutia@megaapp.net,322320,ES17209589367889501335,1423.95,2022-04-07T17:38:08,Durango,expenses,repairs,-175.04,-1188.28
buyer_8,Patxi,Urrutia,1979-04-04,44624658N,patxi.urrutia@megaapp.net,322320,ES17209589367889501335,1423.95,2022-04-08T10:38:27,Durango,expenses,gas,-249.75,-1438.03
buyer_8,Patxi,Urrutia,1979-04-04,44624658N,patxi.urrutia@megaapp.net,322320,ES17209589367889501335,1423.95,2022-04-11T22:03:06,Durango,expenses,leisure,-33.66,-1471.69
buyer_8,Patxi,Urrutia,1979-04-04,44624658N,patxi.urrutia@megaapp.net,322320,ES17209589367889501335,1423.95,2022-04-14T17:23:46,Durango,expenses,education,-43.19,-1514.88
buyer_8,Patxi,Urrutia,1979-04-04,44624658N,patxi.urrutia@megaapp.net,322320,ES17209589367889501335,1423.95,2022-04-15T21:10:58,Durango,expenses,appliances,-136.42,-1651.3
buyer_8,Patxi,Urrutia,1979-04-04,44624658N,patxi.urrutia@megaapp.net,322320,ES17209589367889501335,1423.95,2022-04-20T10:34:51,Durango,expenses,leisure,-71.11,-1722.41
buyer_8,Patxi,Urrutia,1979-04-04,44624658N,patxi.urrutia@megaapp.net,322320,ES17209589367889501335,1423.95,2022-04-26T10:46:34,Durango,expenses,food,-96.63,-1819.04
buyer_8,Patxi,Urrutia,1979-04-04,44624658N,patxi.urrutia@megaapp.net,322320,ES17209589367889501335,1423.95,2022-04-26T16:47:38,Durango,expenses,transport,-40.21,-1859.25
buyer_8,Patxi,Urrutia,1979-04-04,44624658N,patxi.urrutia@megaapp.net,322320,ES17209589367889501335,1423.95,2022-04-28T10:43:45,Durango,expenses,transport,-41.02,-1900.27
buyer_8,Patxi,Urrutia,1979-04-04,44624658N,patxi.urrutia@megaapp.net,322320,ES17209589367889501335,1423.95,2022-04-30T23:58:13,Durango,expenses,education,-74.38,-1974.65
buyer_8,Patxi,Urrutia,1979-04-04,44624658N,patxi.urrutia@megaapp.net,322320,ES17209589367889501335,1423.95,2022-05-01T13:52:59,Durango,incomes,salary,4021.74,2047.09
buyer_8,Patxi,Urrutia,1979-04-04,44624658N,patxi.urrutia@megaapp.net,322320,ES17209589367889501335,1423.95,2022-05-02T08:57:27,Durango,expenses,transport,-67.87,1979.22
buyer_8,Patxi,Urrutia,1979-04-04,44624658N,patxi.urrutia@megaapp.net,322320,ES17209589367889501335,1423.95,2022-05-03T23:22:32,Durango,expenses,cash,-100.0,1879.22
buyer_8,Patxi,Urrutia,1979-04-04,44624658N,patxi.urrutia@megaapp.net,322320,ES17209589367889501335,1423.95,2022-05-03T12:40:42,Durango,expenses,appliances,-141.67,1737.55
buyer_8,Patxi,Urrutia,1979-04-04,44624658N,patxi.urrutia@megaapp.net,322320,ES17209589367889501335,1423.95,2022-05-05T14:18:47,Durango,expenses,mortgage,-2234.07,-496.52
buyer_8,Patxi,Urrutia,1979-04-04,44624658N,patxi.urrutia@megaapp.net,322320,ES17209589367889501335,1423.95,2022-05-05T12:40:49,Durango,expenses,water,-47.18,-543.7
buyer_8,Patxi,Urrutia,1979-04-04,44624658N,patxi.urrutia@megaapp.net,322320,ES17209589367889501335,1423.95,2022-05-05T09:47:09,Durango,expenses,internet,-92.9,-636.6
buyer_8,Patxi,Urrutia,1979-04-04,44624658N,patxi.urrutia@megaapp.net,322320,ES17209589367889501335,1423.95,2022-05-05T11:03:35,Durango,expenses,phone,-70.17,-706.77
buyer_8,Patxi,Urrutia,1979-04-04,44624658N,patxi.urrutia@megaapp.net,322320,ES17209589367889501335,1423.95,2022-05-05T12:58:13,Durango,expenses,cash,-100.0,-806.77
buyer_8,Patxi,Urrutia,1979-04-04,44624658N,patxi.urrutia@megaapp.net,322320,ES17209589367889501335,1423.95,2022-05-05T19:02:19,Durango,expenses,travel,-895.62,-1702.39
buyer_8,Patxi,Urrutia,1979-04-04,44624658N,patxi.urrutia@megaapp.net,322320,ES17209589367889501335,1423.95,2022-05-06T10:15:25,Durango,expenses,electricity,-167.8,-1870.19
buyer_8,Patxi,Urrutia,1979-04-04,44624658N,patxi.urrutia@megaapp.net,322320,ES17209589367889501335,1423.95,2022-05-06T08:44:39,Durango,expenses,gas,-153.95,-2024.14
buyer_8,Patxi,Urrutia,1979-04-04,44624658N,patxi.urrutia@megaapp.net,322320,ES17209589367889501335,1423.95,2022-05-07T17:57:17,Durango,expenses,electricity,-117.67,-2141.81
buyer_8,Patxi,Urrutia,1979-04-04,44624658N,patxi.urrutia@megaapp.net,322320,ES17209589367889501335,1423.95,2022-05-07T10:41:31,Durango,expenses,internet,-92.9,-2234.71
buyer_8,Patxi,Urrutia,1979-04-04,44624658N,patxi.urrutia@megaapp.net,322320,ES17209589367889501335,1423.95,2022-05-07T00:09:47,Durango,expenses,phone,-95.45,-2330.16
buyer_8,Patxi,Urrutia,1979-04-04,44624658N,patxi.urrutia@megaapp.net,322320,ES17209589367889501335,1423.95,2022-05-08T17:07:31,Durango,expenses,electricity,-141.56,-2471.72
buyer_8,Patxi,Urrutia,1979-04-04,44624658N,patxi.urrutia@megaapp.net,322320,ES17209589367889501335,1423.95,2022-05-08T15:40:51,Durango,expenses,cash,-100.0,-2571.72
buyer_8,Patxi,Urrutia,1979-04-04,44624658N,patxi.urrutia@megaapp.net,322320,ES17209589367889501335,1423.95,2022-05-09T07:14:08,Durango,expenses,education,-56.7,-2628.42
buyer_8,Patxi,Urrutia,1979-04-04,44624658N,patxi.urrutia@megaapp.net,322320,ES17209589367889501335,1423.95,2022-05-09T22:06:00,Durango,expenses,appliances,-139.43,-2767.85
buyer_8,Patxi,Urrutia,1979-04-04,44624658N,patxi.urrutia@megaapp.net,322320,ES17209589367889501335,1423.95,2022-05-11T16:16:55,Durango,expenses,cash,-100.0,-2867.85
buyer_8,Patxi,Urrutia,1979-04-04,44624658N,patxi.urrutia@megaapp.net,322320,ES17209589367889501335,1423.95,2022-05-12T19:05:06,Durango,expenses,transport,-51.87,-2919.72
buyer_8,Patxi,Urrutia,1979-04-04,44624658N,patxi.urrutia@megaapp.net,322320,ES17209589367889501335,1423.95,2022-05-15T20:27:32,Durango,expenses,cash,-100.0,-3019.72
buyer_8,Patxi,Urrutia,1979-04-04,44624658N,patxi.urrutia@megaapp.net,322320,ES17209589367889501335,1423.95,2022-05-17T10:51:31,Durango,expenses,transport,-40.03,-3059.75
buyer_8,Patxi,Urrutia,1979-04-04,44624658N,patxi.urrutia@megaapp.net,322320,ES17209589367889501335,1423.95,2022-05-17T13:41:42,Durango,expenses,gifts,-595.44,-3655.19
buyer_8,Patxi,Urrutia,1979-04-04,44624658N,patxi.urrutia@megaapp.net,322320,ES17209589367889501335,1423.95,2022-05-18T18:29:54,Durango,expenses,transport,-48.94,-3704.13
buyer_8,Patxi,Urrutia,1979-04-04,44624658N,patxi.urrutia@megaapp.net,322320,ES17209589367889501335,1423.95,2022-05-18T21:54:14,Durango,expenses,leisure,-51.66,-3755.79
buyer_8,Patxi,Urrutia,1979-04-04,44624658N,patxi.urrutia@megaapp.net,322320,ES17209589367889501335,1423.95,2022-05-18T13:34:29,Durango,expenses,clothing,-55.15,-3810.94
buyer_8,Patxi,Urrutia,1979-04-04,44624658N,patxi.urrutia@megaapp.net,322320,ES17209589367889501335,1423.95,2022-05-18T14:13:35,Durango,expenses,cash,-100.0,-3910.94
buyer_8,Patxi,Urrutia,1979-04-04,44624658N,patxi.urrutia@megaapp.net,322320,ES17209589367889501335,1423.95,2022-05-18T12:18:43,Durango,expenses,gifts,-157.76,-4068.7
buyer_8,Patxi,Urrutia,1979-04-04,44624658N,patxi.urrutia@megaapp.net,322320,ES17209589367889501335,1423.95,2022-05-21T13:12:07,Durango,expenses,cash,-100.0,-4168.7
buyer_8,Patxi,Urrutia,1979-04-04,44624658N,patxi.urrutia@megaapp.net,322320,ES17209589367889501335,1423.95,2022-05-22T16:29:42,Durango,expenses,transport,-80.65,-4249.35
buyer_8,Patxi,Urrutia,1979-04-04,44624658N,patxi.urrutia@megaapp.net,322320,ES17209589367889501335,1423.95,2022-05-23T18:29:16,Durango,expenses,repairs,-309.0,-4558.35
buyer_8,Patxi,Urrutia,1979-04-04,44624658N,patxi.urrutia@megaapp.net,322320,ES17209589367889501335,1423.95,2022-05-24T15:30:13,Durango,expenses,cash,-100.0,-4658.35
buyer_8,Patxi,Urrutia,1979-04-04,44624658N,patxi.urrutia@megaapp.net,322320,ES17209589367889501335,1423.95,2022-05-26T11:50:23,Durango,expenses,leisure,-36.76,-4695.11
buyer_8,Patxi,Urrutia,1979-04-04,44624658N,patxi.urrutia@megaapp.net,322320,ES17209589367889501335,1423.95,2022-05-28T14:56:21,Durango,expenses,gifts,-624.15,-5319.26
buyer_8,Patxi,Urrutia,1979-04-04,44624658N,patxi.urrutia@megaapp.net,322320,ES17209589367889501335,1423.95,2022-05-29T16:46:46,Durango,expenses,clothing,-79.07,-5398.33
buyer_8,Patxi,Urrutia,1979-04-04,44624658N,patxi.urrutia@megaapp.net,322320,ES17209589367889501335,1423.95,2022-05-30T18:06:13,Durango,expenses,transport,-50.66,-5448.99
buyer_8,Patxi,Urrutia,1979-04-04,44624658N,patxi.urrutia@megaapp.net,322320,ES17209589367889501335,1423.95,2022-05-31T12:14:18,Durango,expenses,transport,-71.79,-5520.78
buyer_8,Patxi,Urrutia,1979-04-04,44624658N,patxi.urrutia@megaapp.net,322320,ES17209589367889501335,1423.95,2022-06-01T18:15:00,Durango,incomes,salary,4021.74,-1499.04
buyer_8,Patxi,Urrutia,1979-04-04,44624658N,patxi.urrutia@megaapp.net,322320,ES17209589367889501335,1423.95,2022-06-01T18:15:00,Durango,incomes,salary_bonus,2933.55,1434.51
buyer_8,Patxi,Urrutia,1979-04-04,44624658N,patxi.urrutia@megaapp.net,322320,ES17209589367889501335,1423.95,2022-06-03T13:09:19,Durango,expenses,taxes,-3371.98,-1937.47
buyer_8,Patxi,Urrutia,1979-04-04,44624658N,patxi.urrutia@megaapp.net,322320,ES17209589367889501335,1423.95,2022-06-03T19:32:30,Durango,expenses,insurance,-1243.22,-3180.69
buyer_8,Patxi,Urrutia,1979-04-04,44624658N,patxi.urrutia@megaapp.net,322320,ES17209589367889501335,1423.95,2022-06-05T15:04:52,Durango,expenses,mortgage,-2234.07,-5414.76
buyer_8,Patxi,Urrutia,1979-04-04,44624658N,patxi.urrutia@megaapp.net,322320,ES17209589367889501335,1423.95,2022-06-05T14:24:41,Durango,expenses,water,-82.73,-5497.49
buyer_8,Patxi,Urrutia,1979-04-04,44624658N,patxi.urrutia@megaapp.net,322320,ES17209589367889501335,1423.95,2022-06-05T16:57:20,Durango,expenses,phone,-79.24,-5576.73
buyer_8,Patxi,Urrutia,1979-04-04,44624658N,patxi.urrutia@megaapp.net,322320,ES17209589367889501335,1423.95,2022-06-05T18:04:44,Durango,expenses,leisure,-57.1,-5633.83
buyer_8,Patxi,Urrutia,1979-04-04,44624658N,patxi.urrutia@megaapp.net,322320,ES17209589367889501335,1423.95,2022-06-05T16:26:10,Durango,expenses,healthcare,-52.43,-5686.26
buyer_8,Patxi,Urrutia,1979-04-04,44624658N,patxi.urrutia@megaapp.net,322320,ES17209589367889501335,1423.95,2022-06-07T20:41:24,Durango,expenses,water,-81.57,-5767.83
buyer_8,Patxi,Urrutia,1979-04-04,44624658N,patxi.urrutia@megaapp.net,322320,ES17209589367889501335,1423.95,2022-06-07T21:12:36,Durango,expenses,gas,-218.98,-5986.81
buyer_8,Patxi,Urrutia,1979-04-04,44624658N,patxi.urrutia@megaapp.net,322320,ES17209589367889501335,1423.95,2022-06-08T05:55:46,Durango,expenses,electricity,-58.82,-6045.63
buyer_8,Patxi,Urrutia,1979-04-04,44624658N,patxi.urrutia@megaapp.net,322320,ES17209589367889501335,1423.95,2022-06-08T22:46:05,Durango,expenses,internet,-92.9,-6138.53
buyer_8,Patxi,Urrutia,1979-04-04,44624658N,patxi.urrutia@megaapp.net,322320,ES17209589367889501335,1423.95,2022-06-11T17:01:19,Durango,expenses,clothing,-102.88,-6241.41
buyer_8,Patxi,Urrutia,1979-04-04,44624658N,patxi.urrutia@megaapp.net,322320,ES17209589367889501335,1423.95,2022-06-13T11:47:32,Durango,expenses,food,-106.31,-6347.72
buyer_8,Patxi,Urrutia,1979-04-04,44624658N,patxi.urrutia@megaapp.net,322320,ES17209589367889501335,1423.95,2022-06-14T19:01:03,Durango,expenses,food,-97.57,-6445.29
buyer_8,Patxi,Urrutia,1979-04-04,44624658N,patxi.urrutia@megaapp.net,322320,ES17209589367889501335,1423.95,2022-06-15T12:14:13,Durango,expenses,food,-92.58,-6537.87
buyer_8,Patxi,Urrutia,1979-04-04,44624658N,patxi.urrutia@megaapp.net,322320,ES17209589367889501335,1423.95,2022-06-16T18:43:09,Durango,expenses,gifts,-414.2,-6952.07
buyer_8,Patxi,Urrutia,1979-04-04,44624658N,patxi.urrutia@megaapp.net,322320,ES17209589367889501335,1423.95,2022-06-17T23:51:48,Durango,expenses,food,-69.26,-7021.33
buyer_8,Patxi,Urrutia,1979-04-04,44624658N,patxi.urrutia@megaapp.net,322320,ES17209589367889501335,1423.95,2022-06-17T20:09:37,Durango,expenses,cash,-100.0,-7121.33
buyer_8,Patxi,Urrutia,1979-04-04,44624658N,patxi.urrutia@megaapp.net,322320,ES17209589367889501335,1423.95,2022-06-17T00:22:34,Durango,expenses,car,-370.04,-7491.37
buyer_8,Patxi,Urrutia,1979-04-04,44624658N,patxi.urrutia@megaapp.net,322320,ES17209589367889501335,1423.95,2022-06-18T20:46:27,Durango,expenses,repairs,-300.93,-7792.3
buyer_8,Patxi,Urrutia,1979-04-04,44624658N,patxi.urrutia@megaapp.net,322320,ES17209589367889501335,1423.95,2022-06-20T16:02:36,Durango,expenses,cash,-100.0,-7892.3
buyer_8,Patxi,Urrutia,1979-04-04,44624658N,patxi.urrutia@megaapp.net,322320,ES17209589367889501335,1423.95,2022-06-21T11:20:57,Durango,expenses,travel,-1001.06,-8893.36
buyer_8,Patxi,Urrutia,1979-04-04,44624658N,patxi.urrutia@megaapp.net,322320,ES17209589367889501335,1423.95,2022-06-24T15:03:54,Durango,expenses,food,-69.89,-8963.25
buyer_8,Patxi,Urrutia,1979-04-04,44624658N,patxi.urrutia@megaapp.net,322320,ES17209589367889501335,1423.95,2022-06-24T12:32:07,Durango,expenses,cash,-100.0,-9063.25
buyer_8,Patxi,Urrutia,1979-04-04,44624658N,patxi.urrutia@megaapp.net,322320,ES17209589367889501335,1423.95,2022-06-26T21:18:31,Durango,expenses,education,-61.04,-9124.29
buyer_8,Patxi,Urrutia,1979-04-04,44624658N,patxi.urrutia@megaapp.net,322320,ES17209589367889501335,1423.95,2022-06-26T03:43:13,Durango,expenses,appliances,-91.77,-9216.06
buyer_8,Patxi,Urrutia,1979-04-04,44624658N,patxi.urrutia@megaapp.net,322320,ES17209589367889501335,1423.95,2022-06-27T02:45:00,Durango,expenses,food,-63.8,-9279.86
buyer_8,Patxi,Urrutia,1979-04-04,44624658N,patxi.urrutia@megaapp.net,322320,ES17209589367889501335,1423.95,2022-06-29T09:47:27,Durango,expenses,healthcare,-69.99,-9349.85
buyer_8,Patxi,Urrutia,1979-04-04,44624658N,patxi.urrutia@megaapp.net,322320,ES17209589367889501335,1423.95,2022-07-01T15:27:37,Durango,incomes,salary,4021.74,-5328.11
buyer_8,Patxi,Urrutia,1979-04-04,44624658N,patxi.urrutia@megaapp.net,322320,ES17209589367889501335,1423.95,2022-07-02T10:38:04,Durango,expenses,leisure,-80.3,-5408.41
buyer_8,Patxi,Urrutia,1979-04-04,44624658N,patxi.urrutia@megaapp.net,322320,ES17209589367889501335,1423.95,2022-07-02T09:49:31,Durango,expenses,repairs,-114.96,-5523.37
buyer_8,Patxi,Urrutia,1979-04-04,44624658N,patxi.urrutia@megaapp.net,322320,ES17209589367889501335,1423.95,2022-07-03T19:58:43,Durango,expenses,food,-92.0,-5615.37
buyer_8,Patxi,Urrutia,1979-04-04,44624658N,patxi.urrutia@megaapp.net,322320,ES17209589367889501335,1423.95,2022-07-03T16:39:03,Durango,expenses,transport,-55.26,-5670.63
buyer_8,Patxi,Urrutia,1979-04-04,44624658N,patxi.urrutia@megaapp.net,322320,ES17209589367889501335,1423.95,2022-07-03T16:52:22,Durango,expenses,clothing,-98.65,-5769.28
buyer_8,Patxi,Urrutia,1979-04-04,44624658N,patxi.urrutia@megaapp.net,322320,ES17209589367889501335,1423.95,2022-07-05T11:38:17,Durango,expenses,mortgage,-2234.07,-8003.35
buyer_8,Patxi,Urrutia,1979-04-04,44624658N,patxi.urrutia@megaapp.net,322320,ES17209589367889501335,1423.95,2022-07-05T17:20:49,Durango,expenses,transport,-86.59,-8089.94
buyer_8,Patxi,Urrutia,1979-04-04,44624658N,patxi.urrutia@megaapp.net,322320,ES17209589367889501335,1423.95,2022-07-06T20:39:04,Durango,expenses,electricity,-108.8,-8198.74
buyer_8,Patxi,Urrutia,1979-04-04,44624658N,patxi.urrutia@megaapp.net,322320,ES17209589367889501335,1423.95,2022-07-06T10:27:14,Durango,expenses,internet,-92.9,-8291.64
buyer_8,Patxi,Urrutia,1979-04-04,44624658N,patxi.urrutia@megaapp.net,322320,ES17209589367889501335,1423.95,2022-07-06T11:15:56,Durango,expenses,clothing,-126.3,-8417.94
buyer_8,Patxi,Urrutia,1979-04-04,44624658N,patxi.urrutia@megaapp.net,322320,ES17209589367889501335,1423.95,2022-07-07T18:33:26,Durango,expenses,food,-104.49,-8522.43
buyer_8,Patxi,Urrutia,1979-04-04,44624658N,patxi.urrutia@megaapp.net,322320,ES17209589367889501335,1423.95,2022-07-08T02:18:54,Durango,expenses,gas,-112.61,-8635.04
buyer_8,Patxi,Urrutia,1979-04-04,44624658N,patxi.urrutia@megaapp.net,322320,ES17209589367889501335,1423.95,2022-07-09T20:03:09,Durango,expenses,food,-110.57,-8745.61
buyer_8,Patxi,Urrutia,1979-04-04,44624658N,patxi.urrutia@megaapp.net,322320,ES17209589367889501335,1423.95,2022-07-12T20:57:52,Durango,expenses,leisure,-42.43,-8788.04
buyer_8,Patxi,Urrutia,1979-04-04,44624658N,patxi.urrutia@megaapp.net,322320,ES17209589367889501335,1423.95,2022-07-12T10:46:29,Durango,expenses,cash,-100.0,-8888.04
buyer_8,Patxi,Urrutia,1979-04-04,44624658N,patxi.urrutia@megaapp.net,322320,ES17209589367889501335,1423.95,2022-07-14T15:07:13,Durango,expenses,repairs,-294.66,-9182.7
buyer_8,Patxi,Urrutia,1979-04-04,44624658N,patxi.urrutia@megaapp.net,322320,ES17209589367889501335,1423.95,2022-07-16T20:09:28,Durango,expenses,leisure,-19.33,-9202.03
buyer_8,Patxi,Urrutia,1979-04-04,44624658N,patxi.urrutia@megaapp.net,322320,ES17209589367889501335,1423.95,2022-07-18T19:38:56,Durango,expenses,food,-88.76,-9290.79
buyer_8,Patxi,Urrutia,1979-04-04,44624658N,patxi.urrutia@megaapp.net,322320,ES17209589367889501335,1423.95,2022-07-20T16:45:03,Durango,expenses,cash,-100.0,-9390.79
buyer_8,Patxi,Urrutia,1979-04-04,44624658N,patxi.urrutia@megaapp.net,322320,ES17209589367889501335,1423.95,2022-07-21T11:02:07,Durango,expenses,food,-82.9,-9473.69
buyer_8,Patxi,Urrutia,1979-04-04,44624658N,patxi.urrutia@megaapp.net,322320,ES17209589367889501335,1423.95,2022-07-21T23:02:25,Durango,expenses,cash,-100.0,-9573.69
buyer_8,Patxi,Urrutia,1979-04-04,44624658N,patxi.urrutia@megaapp.net,322320,ES17209589367889501335,1423.95,2022-07-22T15:39:20,Durango,expenses,education,-66.22,-9639.91
buyer_8,Patxi,Urrutia,1979-04-04,44624658N,patxi.urrutia@megaapp.net,322320,ES17209589367889501335,1423.95,2022-07-23T17:32:44,Durango,expenses,clothing,-112.01,-9751.92
buyer_8,Patxi,Urrutia,1979-04-04,44624658N,patxi.urrutia@megaapp.net,322320,ES17209589367889501335,1423.95,2022-07-24T16:57:06,Durango,expenses,food,-74.74,-9826.66
buyer_8,Patxi,Urrutia,1979-04-04,44624658N,patxi.urrutia@megaapp.net,322320,ES17209589367889501335,1423.95,2022-07-28T06:51:24,Durango,expenses,food,-120.79,-9947.45
buyer_8,Patxi,Urrutia,1979-04-04,44624658N,patxi.urrutia@megaapp.net,322320,ES17209589367889501335,1423.95,2022-07-30T11:08:53,Durango,expenses,cash,-100.0,-10047.45
buyer_8,Patxi,Urrutia,1979-04-04,44624658N,patxi.urrutia@megaapp.net,322320,ES17209589367889501335,1423.95,2022-08-01T08:48:07,Durango,incomes,salary,4021.74,-6025.71
buyer_8,Patxi,Urrutia,1979-04-04,44624658N,patxi.urrutia@megaapp.net,322320,ES17209589367889501335,1423.95,2022-08-01T08:48:07,Durango,incomes,extra_income,572.97,-5452.74
buyer_8,Patxi,Urrutia,1979-04-04,44624658N,patxi.urrutia@megaapp.net,322320,ES17209589367889501335,1423.95,2022-08-02T18:48:14,Durango,expenses,food,-60.15,-5512.89
buyer_8,Patxi,Urrutia,1979-04-04,44624658N,patxi.urrutia@megaapp.net,322320,ES17209589367889501335,1423.95,2022-08-02T09:25:45,Durango,expenses,cash,-100.0,-5612.89
buyer_8,Patxi,Urrutia,1979-04-04,44624658N,patxi.urrutia@megaapp.net,322320,ES17209589367889501335,1423.95,2022-08-02T19:52:25,Durango,expenses,repairs,-212.16,-5825.05
buyer_8,Patxi,Urrutia,1979-04-04,44624658N,patxi.urrutia@megaapp.net,322320,ES17209589367889501335,1423.95,2022-08-03T20:07:15,Durango,expenses,appliances,-210.77,-6035.82
buyer_8,Patxi,Urrutia,1979-04-04,44624658N,patxi.urrutia@megaapp.net,322320,ES17209589367889501335,1423.95,2022-08-05T20:26:34,Durango,expenses,mortgage,-2234.07,-8269.89
buyer_8,Patxi,Urrutia,1979-04-04,44624658N,patxi.urrutia@megaapp.net,322320,ES17209589367889501335,1423.95,2022-08-05T19:30:19,Durango,expenses,internet,-92.9,-8362.79
buyer_8,Patxi,Urrutia,1979-04-04,44624658N,patxi.urrutia@megaapp.net,322320,ES17209589367889501335,1423.95,2022-08-05T15:11:41,Durango,expenses,phone,-77.58,-8440.37
buyer_8,Patxi,Urrutia,1979-04-04,44624658N,patxi.urrutia@megaapp.net,322320,ES17209589367889501335,1423.95,2022-08-06T09:24:54,Durango,expenses,water,-53.27,-8493.64
buyer_8,Patxi,Urrutia,1979-04-04,44624658N,patxi.urrutia@megaapp.net,322320,ES17209589367889501335,1423.95,2022-08-06T08:06:45,Durango,expenses,gas,-145.73,-8639.37
buyer_8,Patxi,Urrutia,1979-04-04,44624658N,patxi.urrutia@megaapp.net,322320,ES17209589367889501335,1423.95,2022-08-06T05:34:08,Durango,expenses,leisure,-63.59,-8702.96
buyer_8,Patxi,Urrutia,1979-04-04,44624658N,patxi.urrutia@megaapp.net,322320,ES17209589367889501335,1423.95,2022-08-07T19:27:20,Durango,expenses,phone,-86.66,-8789.62
buyer_8,Patxi,Urrutia,1979-04-04,44624658N,patxi.urrutia@megaapp.net,322320,ES17209589367889501335,1423.95,2022-08-09T14:38:28,Durango,expenses,cash,-100.0,-8889.62
buyer_8,Patxi,Urrutia,1979-04-04,44624658N,patxi.urrutia@megaapp.net,322320,ES17209589367889501335,1423.95,2022-08-10T10:13:35,Durango,expenses,food,-62.68,-8952.3
buyer_8,Patxi,Urrutia,1979-04-04,44624658N,patxi.urrutia@megaapp.net,322320,ES17209589367889501335,1423.95,2022-08-10T16:28:38,Durango,expenses,travel,-879.89,-9832.19
buyer_8,Patxi,Urrutia,1979-04-04,44624658N,patxi.urrutia@megaapp.net,322320,ES17209589367889501335,1423.95,2022-08-11T11:26:10,Durango,expenses,leisure,-72.37,-9904.56
buyer_8,Patxi,Urrutia,1979-04-04,44624658N,patxi.urrutia@megaapp.net,322320,ES17209589367889501335,1423.95,2022-08-13T14:16:28,Durango,expenses,food,-95.5,-10000.06
buyer_8,Patxi,Urrutia,1979-04-04,44624658N,patxi.urrutia@megaapp.net,322320,ES17209589367889501335,1423.95,2022-08-13T07:57:42,Durango,expenses,cash,-100.0,-10100.06
buyer_8,Patxi,Urrutia,1979-04-04,44624658N,patxi.urrutia@megaapp.net,322320,ES17209589367889501335,1423.95,2022-08-13T15:08:03,Durango,expenses,repairs,-112.98,-10213.04
buyer_8,Patxi,Urrutia,1979-04-04,44624658N,patxi.urrutia@megaapp.net,322320,ES17209589367889501335,1423.95,2022-08-14T16:14:33,Durango,expenses,cash,-100.0,-10313.04
buyer_8,Patxi,Urrutia,1979-04-04,44624658N,patxi.urrutia@megaapp.net,322320,ES17209589367889501335,1423.95,2022-08-15T01:41:44,Durango,expenses,appliances,-418.6,-10731.64
buyer_8,Patxi,Urrutia,1979-04-04,44624658N,patxi.urrutia@megaapp.net,322320,ES17209589367889501335,1423.95,2022-08-16T16:35:19,Durango,expenses,food,-90.64,-10822.28
buyer_8,Patxi,Urrutia,1979-04-04,44624658N,patxi.urrutia@megaapp.net,322320,ES17209589367889501335,1423.95,2022-08-17T15:47:41,Durango,expenses,cash,-100.0,-10922.28
buyer_8,Patxi,Urrutia,1979-04-04,44624658N,patxi.urrutia@megaapp.net,322320,ES17209589367889501335,1423.95,2022-08-20T18:33:45,Durango,expenses,leisure,-33.12,-10955.4
buyer_8,Patxi,Urrutia,1979-04-04,44624658N,patxi.urrutia@megaapp.net,322320,ES17209589367889501335,1423.95,2022-08-21T23:52:33,Durango,expenses,repairs,-101.18,-11056.58
buyer_8,Patxi,Urrutia,1979-04-04,44624658N,patxi.urrutia@megaapp.net,322320,ES17209589367889501335,1423.95,2022-08-22T16:08:22,Durango,expenses,leisure,-52.2,-11108.78
buyer_8,Patxi,Urrutia,1979-04-04,44624658N,patxi.urrutia@megaapp.net,322320,ES17209589367889501335,1423.95,2022-08-24T10:50:53,Durango,expenses,healthcare,-66.89,-11175.67
buyer_8,Patxi,Urrutia,1979-04-04,44624658N,patxi.urrutia@megaapp.net,322320,ES17209589367889501335,1423.95,2022-08-25T21:50:51,Durango,expenses,transport,-42.98,-11218.65
buyer_8,Patxi,Urrutia,1979-04-04,44624658N,patxi.urrutia@megaapp.net,322320,ES17209589367889501335,1423.95,2022-08-25T09:38:44,Durango,expenses,repairs,-242.54,-11461.19
buyer_8,Patxi,Urrutia,1979-04-04,44624658N,patxi.urrutia@megaapp.net,322320,ES17209589367889501335,1423.95,2022-08-26T16:51:35,Durango,expenses,cash,-100.0,-11561.19
buyer_8,Patxi,Urrutia,1979-04-04,44624658N,patxi.urrutia@megaapp.net,322320,ES17209589367889501335,1423.95,2022-08-26T13:26:26,Durango,expenses,repairs,-92.88,-11654.07
buyer_8,Patxi,Urrutia,1979-04-04,44624658N,patxi.urrutia@megaapp.net,322320,ES17209589367889501335,1423.95,2022-08-27T12:42:29,Durango,expenses,transport,-69.34,-11723.41
buyer_8,Patxi,Urrutia,1979-04-04,44624658N,patxi.urrutia@megaapp.net,322320,ES17209589367889501335,1423.95,2022-08-27T10:30:44,Durango,expenses,repairs,-74.02,-11797.43
buyer_8,Patxi,Urrutia,1979-04-04,44624658N,patxi.urrutia@megaapp.net,322320,ES17209589367889501335,1423.95,2022-08-28T19:51:23,Durango,expenses,transport,-75.36,-11872.79
buyer_8,Patxi,Urrutia,1979-04-04,44624658N,patxi.urrutia@megaapp.net,322320,ES17209589367889501335,1423.95,2022-08-29T12:12:33,Durango,expenses,repairs,-241.97,-12114.76
buyer_8,Patxi,Urrutia,1979-04-04,44624658N,patxi.urrutia@megaapp.net,322320,ES17209589367889501335,1423.95,2022-09-01T08:36:46,Durango,incomes,salary,4021.74,-8093.02
buyer_8,Patxi,Urrutia,1979-04-04,44624658N,patxi.urrutia@megaapp.net,322320,ES17209589367889501335,1423.95,2022-09-03T09:01:30,Durango,expenses,cash,-100.0,-8193.02
buyer_8,Patxi,Urrutia,1979-04-04,44624658N,patxi.urrutia@megaapp.net,322320,ES17209589367889501335,1423.95,2022-09-05T16:12:27,Durango,expenses,mortgage,-2234.07,-10427.09
buyer_8,Patxi,Urrutia,1979-04-04,44624658N,patxi.urrutia@megaapp.net,322320,ES17209589367889501335,1423.95,2022-09-05T16:06:50,Durango,expenses,electricity,-79.27,-10506.36
buyer_8,Patxi,Urrutia,1979-04-04,44624658N,patxi.urrutia@megaapp.net,322320,ES17209589367889501335,1423.95,2022-09-05T17:46:11,Durango,expenses,phone,-76.15,-10582.51
buyer_8,Patxi,Urrutia,1979-04-04,44624658N,patxi.urrutia@megaapp.net,322320,ES17209589367889501335,1423.95,2022-09-06T10:39:44,Durango,expenses,internet,-92.9,-10675.41
buyer_8,Patxi,Urrutia,1979-04-04,44624658N,patxi.urrutia@megaapp.net,322320,ES17209589367889501335,1423.95,2022-09-07T22:50:28,Durango,expenses,food,-102.71,-10778.12
buyer_8,Patxi,Urrutia,1979-04-04,44624658N,patxi.urrutia@megaapp.net,322320,ES17209589367889501335,1423.95,2022-09-08T20:48:30,Durango,expenses,electricity,-93.73,-10871.85
buyer_8,Patxi,Urrutia,1979-04-04,44624658N,patxi.urrutia@megaapp.net,322320,ES17209589367889501335,1423.95,2022-09-08T17:55:11,Durango,expenses,leisure,-36.19,-10908.04
buyer_8,Patxi,Urrutia,1979-04-04,44624658N,patxi.urrutia@megaapp.net,322320,ES17209589367889501335,1423.95,2022-09-10T02:51:24,Durango,expenses,leisure,-73.86,-10981.9
buyer_8,Patxi,Urrutia,1979-04-04,44624658N,patxi.urrutia@megaapp.net,322320,ES17209589367889501335,1423.95,2022-09-10T12:38:13,Durango,expenses,cash,-100.0,-11081.9
buyer_8,Patxi,Urrutia,1979-04-04,44624658N,patxi.urrutia@megaapp.net,322320,ES17209589367889501335,1423.95,2022-09-12T20:41:07,Durango,expenses,gifts,-755.91,-11837.81
buyer_8,Patxi,Urrutia,1979-04-04,44624658N,patxi.urrutia@megaapp.net,322320,ES17209589367889501335,1423.95,2022-09-14T20:51:41,Durango,expenses,education,-74.48,-11912.29
buyer_8,Patxi,Urrutia,1979-04-04,44624658N,patxi.urrutia@megaapp.net,322320,ES17209589367889501335,1423.95,2022-09-16T09:54:39,Durango,expenses,cash,-100.0,-12012.29
buyer_8,Patxi,Urrutia,1979-04-04,44624658N,patxi.urrutia@megaapp.net,322320,ES17209589367889501335,1423.95,2022-09-17T10:36:04,Durango,expenses,cash,-100.0,-12112.29
buyer_8,Patxi,Urrutia,1979-04-04,44624658N,patxi.urrutia@megaapp.net,322320,ES17209589367889501335,1423.95,2022-09-22T21:15:15,Durango,expenses,food,-66.77,-12179.06
buyer_8,Patxi,Urrutia,1979-04-04,44624658N,patxi.urrutia@megaapp.net,322320,ES17209589367889501335,1423.95,2022-09-24T06:04:45,Durango,expenses,food,-65.78,-12244.84
buyer_8,Patxi,Urrutia,1979-04-04,44624658N,patxi.urrutia@megaapp.net,322320,ES17209589367889501335,1423.95,2022-09-25T12:20:50,Durango,expenses,education,-60.65,-12305.49
buyer_8,Patxi,Urrutia,1979-04-04,44624658N,patxi.urrutia@megaapp.net,322320,ES17209589367889501335,1423.95,2022-09-27T23:09:57,Durango,expenses,transport,-40.94,-12346.43
buyer_8,Patxi,Urrutia,1979-04-04,44624658N,patxi.urrutia@megaapp.net,322320,ES17209589367889501335,1423.95,2022-09-28T20:17:30,Durango,expenses,cash,-100.0,-12446.43
buyer_8,Patxi,Urrutia,1979-04-04,44624658N,patxi.urrutia@megaapp.net,322320,ES17209589367889501335,1423.95,2022-09-30T16:41:02,Durango,expenses,transport,-59.26,-12505.69
buyer_8,Patxi,Urrutia,1979-04-04,44624658N,patxi.urrutia@megaapp.net,322320,ES17209589367889501335,1423.95,2022-10-01T16:03:46,Durango,incomes,salary,4021.74,-8483.95
buyer_8,Patxi,Urrutia,1979-04-04,44624658N,patxi.urrutia@megaapp.net,322320,ES17209589367889501335,1423.95,2022-10-04T10:50:32,Durango,expenses,cash,-100.0,-8583.95
buyer_8,Patxi,Urrutia,1979-04-04,44624658N,patxi.urrutia@megaapp.net,322320,ES17209589367889501335,1423.95,2022-10-05T09:24:59,Durango,expenses,mortgage,-2234.07,-10818.02
buyer_8,Patxi,Urrutia,1979-04-04,44624658N,patxi.urrutia@megaapp.net,322320,ES17209589367889501335,1423.95,2022-10-05T22:39:53,Durango,expenses,water,-90.42,-10908.44
buyer_8,Patxi,Urrutia,1979-04-04,44624658N,patxi.urrutia@megaapp.net,322320,ES17209589367889501335,1423.95,2022-10-05T16:40:28,Durango,expenses,internet,-92.9,-11001.34
buyer_8,Patxi,Urrutia,1979-04-04,44624658N,patxi.urrutia@megaapp.net,322320,ES17209589367889501335,1423.95,2022-10-06T23:50:01,Durango,expenses,water,-87.1,-11088.44
buyer_8,Patxi,Urrutia,1979-04-04,44624658N,patxi.urrutia@megaapp.net,322320,ES17209589367889501335,1423.95,2022-10-07T09:03:53,Durango,expenses,gas,-198.83,-11287.27
buyer_8,Patxi,Urrutia,1979-04-04,44624658N,patxi.urrutia@megaapp.net,322320,ES17209589367889501335,1423.95,2022-10-08T00:43:22,Durango,expenses,phone,-70.82,-11358.09
buyer_8,Patxi,Urrutia,1979-04-04,44624658N,patxi.urrutia@megaapp.net,322320,ES17209589367889501335,1423.95,2022-10-11T17:42:33,Durango,expenses,leisure,-67.34,-11425.43
buyer_8,Patxi,Urrutia,1979-04-04,44624658N,patxi.urrutia@megaapp.net,322320,ES17209589367889501335,1423.95,2022-10-11T20:06:53,Durango,expenses,cash,-100.0,-11525.43
buyer_8,Patxi,Urrutia,1979-04-04,44624658N,patxi.urrutia@megaapp.net,322320,ES17209589367889501335,1423.95,2022-10-12T08:36:58,Durango,expenses,cash,-100.0,-11625.43
buyer_8,Patxi,Urrutia,1979-04-04,44624658N,patxi.urrutia@megaapp.net,322320,ES17209589367889501335,1423.95,2022-10-13T15:57:27,Durango,expenses,education,-53.03,-11678.46
buyer_8,Patxi,Urrutia,1979-04-04,44624658N,patxi.urrutia@megaapp.net,322320,ES17209589367889501335,1423.95,2022-10-14T19:28:47,Durango,expenses,food,-96.15,-11774.61
buyer_8,Patxi,Urrutia,1979-04-04,44624658N,patxi.urrutia@megaapp.net,322320,ES17209589367889501335,1423.95,2022-10-14T09:19:37,Durango,expenses,cash,-100.0,-11874.61
buyer_8,Patxi,Urrutia,1979-04-04,44624658N,patxi.urrutia@megaapp.net,322320,ES17209589367889501335,1423.95,2022-10-15T15:37:53,Durango,expenses,cash,-100.0,-11974.61
buyer_8,Patxi,Urrutia,1979-04-04,44624658N,patxi.urrutia@megaapp.net,322320,ES17209589367889501335,1423.95,2022-10-15T20:43:44,Durango,expenses,appliances,-293.08,-12267.69
buyer_8,Patxi,Urrutia,1979-04-04,44624658N,patxi.urrutia@megaapp.net,322320,ES17209589367889501335,1423.95,2022-10-16T15:26:34,Durango,expenses,cash,-100.0,-12367.69
buyer_8,Patxi,Urrutia,1979-04-04,44624658N,patxi.urrutia@megaapp.net,322320,ES17209589367889501335,1423.95,2022-10-17T21:05:56,Durango,expenses,cash,-100.0,-12467.69
buyer_8,Patxi,Urrutia,1979-04-04,44624658N,patxi.urrutia@megaapp.net,322320,ES17209589367889501335,1423.95,2022-10-20T17:02:28,Durango,expenses,transport,-42.42,-12510.11
buyer_8,Patxi,Urrutia,1979-04-04,44624658N,patxi.urrutia@megaapp.net,322320,ES17209589367889501335,1423.95,2022-10-20T22:18:23,Durango,expenses,cash,-100.0,-12610.11
buyer_8,Patxi,Urrutia,1979-04-04,44624658N,patxi.urrutia@megaapp.net,322320,ES17209589367889501335,1423.95,2022-10-22T11:59:57,Durango,expenses,food,-70.86,-12680.97
buyer_8,Patxi,Urrutia,1979-04-04,44624658N,patxi.urrutia@megaapp.net,322320,ES17209589367889501335,1423.95,2022-10-23T04:53:51,Durango,expenses,clothing,-126.69,-12807.66
buyer_8,Patxi,Urrutia,1979-04-04,44624658N,patxi.urrutia@megaapp.net,322320,ES17209589367889501335,1423.95,2022-10-23T14:22:46,Durango,expenses,gifts,-243.52,-13051.18
buyer_8,Patxi,Urrutia,1979-04-04,44624658N,patxi.urrutia@megaapp.net,322320,ES17209589367889501335,1423.95,2022-10-24T09:45:55,Durango,expenses,healthcare,-111.47,-13162.65
buyer_8,Patxi,Urrutia,1979-04-04,44624658N,patxi.urrutia@megaapp.net,322320,ES17209589367889501335,1423.95,2022-10-27T19:13:50,Durango,expenses,gifts,-266.4,-13429.05
buyer_8,Patxi,Urrutia,1979-04-04,44624658N,patxi.urrutia@megaapp.net,322320,ES17209589367889501335,1423.95,2022-10-30T10:52:43,Durango,expenses,leisure,-63.78,-13492.83
buyer_8,Patxi,Urrutia,1979-04-04,44624658N,patxi.urrutia@megaapp.net,322320,ES17209589367889501335,1423.95,2022-10-31T21:12:39,Durango,expenses,food,-76.48,-13569.31
buyer_8,Patxi,Urrutia,1979-04-04,44624658N,patxi.urrutia@megaapp.net,322320,ES17209589367889501335,1423.95,2022-11-01T12:51:17,Durango,incomes,salary,4021.74,-9547.57
buyer_8,Patxi,Urrutia,1979-04-04,44624658N,patxi.urrutia@megaapp.net,322320,ES17209589367889501335,1423.95,2022-11-03T17:54:31,Durango,expenses,cash,-100.0,-9647.57
buyer_8,Patxi,Urrutia,1979-04-04,44624658N,patxi.urrutia@megaapp.net,322320,ES17209589367889501335,1423.95,2022-11-05T12:33:41,Durango,expenses,mortgage,-2234.07,-11881.64
buyer_8,Patxi,Urrutia,1979-04-04,44624658N,patxi.urrutia@megaapp.net,322320,ES17209589367889501335,1423.95,2022-11-06T17:36:17,Durango,expenses,water,-63.66,-11945.3
buyer_8,Patxi,Urrutia,1979-04-04,44624658N,patxi.urrutia@megaapp.net,322320,ES17209589367889501335,1423.95,2022-11-06T10:17:28,Durango,expenses,internet,-92.9,-12038.2
buyer_8,Patxi,Urrutia,1979-04-04,44624658N,patxi.urrutia@megaapp.net,322320,ES17209589367889501335,1423.95,2022-11-07T13:49:09,Durango,expenses,water,-70.89,-12109.09
buyer_8,Patxi,Urrutia,1979-04-04,44624658N,patxi.urrutia@megaapp.net,322320,ES17209589367889501335,1423.95,2022-11-07T13:00:26,Durango,expenses,healthcare,-65.33,-12174.42
buyer_8,Patxi,Urrutia,1979-04-04,44624658N,patxi.urrutia@megaapp.net,322320,ES17209589367889501335,1423.95,2022-11-07T11:26:23,Durango,expenses,education,-49.74,-12224.16
buyer_8,Patxi,Urrutia,1979-04-04,44624658N,patxi.urrutia@megaapp.net,322320,ES17209589367889501335,1423.95,2022-11-08T10:19:54,Durango,expenses,water,-64.74,-12288.9
buyer_8,Patxi,Urrutia,1979-04-04,44624658N,patxi.urrutia@megaapp.net,322320,ES17209589367889501335,1423.95,2022-11-08T17:22:00,Durango,expenses,electricity,-125.76,-12414.66
buyer_8,Patxi,Urrutia,1979-04-04,44624658N,patxi.urrutia@megaapp.net,322320,ES17209589367889501335,1423.95,2022-11-09T13:46:35,Durango,expenses,transport,-66.51,-12481.17
buyer_8,Patxi,Urrutia,1979-04-04,44624658N,patxi.urrutia@megaapp.net,322320,ES17209589367889501335,1423.95,2022-11-10T17:48:36,Durango,expenses,food,-83.25,-12564.42
buyer_8,Patxi,Urrutia,1979-04-04,44624658N,patxi.urrutia@megaapp.net,322320,ES17209589367889501335,1423.95,2022-11-11T17:42:14,Durango,expenses,repairs,-224.81,-12789.23
buyer_8,Patxi,Urrutia,1979-04-04,44624658N,patxi.urrutia@megaapp.net,322320,ES17209589367889501335,1423.95,2022-11-12T16:46:05,Durango,expenses,clothing,-92.63,-12881.86
buyer_8,Patxi,Urrutia,1979-04-04,44624658N,patxi.urrutia@megaapp.net,322320,ES17209589367889501335,1423.95,2022-11-15T08:17:46,Durango,expenses,transport,-53.12,-12934.98
buyer_8,Patxi,Urrutia,1979-04-04,44624658N,patxi.urrutia@megaapp.net,322320,ES17209589367889501335,1423.95,2022-11-15T17:42:23,Durango,expenses,cash,-100.0,-13034.98
buyer_8,Patxi,Urrutia,1979-04-04,44624658N,patxi.urrutia@megaapp.net,322320,ES17209589367889501335,1423.95,2022-11-18T19:38:29,Durango,expenses,food,-85.99,-13120.97
buyer_8,Patxi,Urrutia,1979-04-04,44624658N,patxi.urrutia@megaapp.net,322320,ES17209589367889501335,1423.95,2022-11-19T13:25:01,Durango,expenses,repairs,-63.67,-13184.64
buyer_8,Patxi,Urrutia,1979-04-04,44624658N,patxi.urrutia@megaapp.net,322320,ES17209589367889501335,1423.95,2022-11-20T17:36:42,Durango,expenses,transport,-69.72,-13254.36
buyer_8,Patxi,Urrutia,1979-04-04,44624658N,patxi.urrutia@megaapp.net,322320,ES17209589367889501335,1423.95,2022-11-24T04:42:57,Durango,expenses,food,-121.84,-13376.2
buyer_8,Patxi,Urrutia,1979-04-04,44624658N,patxi.urrutia@megaapp.net,322320,ES17209589367889501335,1423.95,2022-11-24T01:22:43,Durango,expenses,leisure,-21.63,-13397.83
buyer_8,Patxi,Urrutia,1979-04-04,44624658N,patxi.urrutia@megaapp.net,322320,ES17209589367889501335,1423.95,2022-11-26T16:58:15,Durango,expenses,cash,-100.0,-13497.83
buyer_8,Patxi,Urrutia,1979-04-04,44624658N,patxi.urrutia@megaapp.net,322320,ES17209589367889501335,1423.95,2022-11-27T06:59:33,Durango,expenses,cash,-100.0,-13597.83
buyer_8,Patxi,Urrutia,1979-04-04,44624658N,patxi.urrutia@megaapp.net,322320,ES17209589367889501335,1423.95,2022-11-30T20:46:49,Durango,expenses,leisure,-56.53,-13654.36
buyer_8,Patxi,Urrutia,1979-04-04,44624658N,patxi.urrutia@megaapp.net,322320,ES17209589367889501335,1423.95,2022-11-30T17:22:23,Durango,expenses,gifts,-504.58,-14158.94
buyer_8,Patxi,Urrutia,1979-04-04,44624658N,patxi.urrutia@megaapp.net,322320,ES17209589367889501335,1423.95,2022-12-01T15:08:58,Durango,incomes,salary,4021.74,-10137.2
buyer_8,Patxi,Urrutia,1979-04-04,44624658N,patxi.urrutia@megaapp.net,322320,ES17209589367889501335,1423.95,2022-12-01T15:08:58,Durango,incomes,extra_income,572.97,-9564.23
buyer_8,Patxi,Urrutia,1979-04-04,44624658N,patxi.urrutia@megaapp.net,322320,ES17209589367889501335,1423.95,2022-12-01T15:08:58,Durango,incomes,salary_bonus,2903.24,-6660.99
buyer_8,Patxi,Urrutia,1979-04-04,44624658N,patxi.urrutia@megaapp.net,322320,ES17209589367889501335,1423.95,2022-12-02T14:10:08,Durango,expenses,clothing,-138.52,-6799.51
buyer_8,Patxi,Urrutia,1979-04-04,44624658N,patxi.urrutia@megaapp.net,322320,ES17209589367889501335,1423.95,2022-12-04T21:36:58,Durango,expenses,leisure,-25.7,-6825.21
buyer_8,Patxi,Urrutia,1979-04-04,44624658N,patxi.urrutia@megaapp.net,322320,ES17209589367889501335,1423.95,2022-12-04T20:38:16,Durango,expenses,healthcare,-146.93,-6972.14
buyer_8,Patxi,Urrutia,1979-04-04,44624658N,patxi.urrutia@megaapp.net,322320,ES17209589367889501335,1423.95,2022-12-05T19:44:22,Durango,expenses,mortgage,-2234.07,-9206.21
buyer_8,Patxi,Urrutia,1979-04-04,44624658N,patxi.urrutia@megaapp.net,322320,ES17209589367889501335,1423.95,2022-12-05T14:04:52,Durango,expenses,internet,-92.9,-9299.11
buyer_8,Patxi,Urrutia,1979-04-04,44624658N,patxi.urrutia@megaapp.net,322320,ES17209589367889501335,1423.95,2022-12-05T12:37:10,Durango,expenses,phone,-75.28,-9374.39
buyer_8,Patxi,Urrutia,1979-04-04,44624658N,patxi.urrutia@megaapp.net,322320,ES17209589367889501335,1423.95,2022-12-06T10:37:42,Durango,expenses,internet,-92.9,-9467.29
buyer_8,Patxi,Urrutia,1979-04-04,44624658N,patxi.urrutia@megaapp.net,322320,ES17209589367889501335,1423.95,2022-12-07T09:47:03,Durango,expenses,water,-61.09,-9528.38
buyer_8,Patxi,Urrutia,1979-04-04,44624658N,patxi.urrutia@megaapp.net,322320,ES17209589367889501335,1423.95,2022-12-07T09:32:20,Durango,expenses,internet,-92.9,-9621.28
buyer_8,Patxi,Urrutia,1979-04-04,44624658N,patxi.urrutia@megaapp.net,322320,ES17209589367889501335,1423.95,2022-12-07T17:32:35,Durango,expenses,food,-94.45,-9715.73
buyer_8,Patxi,Urrutia,1979-04-04,44624658N,patxi.urrutia@megaapp.net,322320,ES17209589367889501335,1423.95,2022-12-07T18:55:45,Durango,expenses,appliances,-256.0,-9971.73
buyer_8,Patxi,Urrutia,1979-04-04,44624658N,patxi.urrutia@megaapp.net,322320,ES17209589367889501335,1423.95,2022-12-08T09:36:09,Durango,expenses,internet,-92.9,-10064.63
buyer_8,Patxi,Urrutia,1979-04-04,44624658N,patxi.urrutia@megaapp.net,322320,ES17209589367889501335,1423.95,2022-12-08T13:58:24,Durango,expenses,phone,-95.66,-10160.29
buyer_8,Patxi,Urrutia,1979-04-04,44624658N,patxi.urrutia@megaapp.net,322320,ES17209589367889501335,1423.95,2022-12-10T17:07:52,Durango,expenses,food,-85.37,-10245.66
buyer_8,Patxi,Urrutia,1979-04-04,44624658N,patxi.urrutia@megaapp.net,322320,ES17209589367889501335,1423.95,2022-12-13T08:09:49,Durango,expenses,travel,-1029.92,-11275.58
buyer_8,Patxi,Urrutia,1979-04-04,44624658N,patxi.urrutia@megaapp.net,322320,ES17209589367889501335,1423.95,2022-12-14T16:01:16,Durango,expenses,cash,-100.0,-11375.58
buyer_8,Patxi,Urrutia,1979-04-04,44624658N,patxi.urrutia@megaapp.net,322320,ES17209589367889501335,1423.95,2022-12-17T19:48:43,Durango,expenses,clothing,-127.46,-11503.04
buyer_8,Patxi,Urrutia,1979-04-04,44624658N,patxi.urrutia@megaapp.net,322320,ES17209589367889501335,1423.95,2022-12-18T17:06:48,Durango,expenses,food,-94.78,-11597.82
buyer_8,Patxi,Urrutia,1979-04-04,44624658N,patxi.urrutia@megaapp.net,322320,ES17209589367889501335,1423.95,2022-12-18T07:22:50,Durango,expenses,gifts,-758.1,-12355.92
buyer_8,Patxi,Urrutia,1979-04-04,44624658N,patxi.urrutia@megaapp.net,322320,ES17209589367889501335,1423.95,2022-12-20T18:37:37,Durango,expenses,healthcare,-75.37,-12431.29
buyer_8,Patxi,Urrutia,1979-04-04,44624658N,patxi.urrutia@megaapp.net,322320,ES17209589367889501335,1423.95,2022-12-20T11:20:35,Durango,expenses,cash,-100.0,-12531.29
buyer_8,Patxi,Urrutia,1979-04-04,44624658N,patxi.urrutia@megaapp.net,322320,ES17209589367889501335,1423.95,2022-12-21T19:53:25,Durango,expenses,transport,-48.98,-12580.27
buyer_8,Patxi,Urrutia,1979-04-04,44624658N,patxi.urrutia@megaapp.net,322320,ES17209589367889501335,1423.95,2022-12-22T14:20:47,Durango,expenses,food,-111.42,-12691.69
buyer_8,Patxi,Urrutia,1979-04-04,44624658N,patxi.urrutia@megaapp.net,322320,ES17209589367889501335,1423.95,2022-12-22T10:08:15,Durango,expenses,leisure,-33.99,-12725.68
buyer_8,Patxi,Urrutia,1979-04-04,44624658N,patxi.urrutia@megaapp.net,322320,ES17209589367889501335,1423.95,2022-12-22T20:19:39,Durango,expenses,gifts,-225.34,-12951.02
buyer_8,Patxi,Urrutia,1979-04-04,44624658N,patxi.urrutia@megaapp.net,322320,ES17209589367889501335,1423.95,2022-12-23T13:00:05,Durango,expenses,leisure,-74.81,-13025.83
buyer_8,Patxi,Urrutia,1979-04-04,44624658N,patxi.urrutia@megaapp.net,322320,ES17209589367889501335,1423.95,2022-12-24T21:40:48,Durango,expenses,food,-109.4,-13135.23
buyer_8,Patxi,Urrutia,1979-04-04,44624658N,patxi.urrutia@megaapp.net,322320,ES17209589367889501335,1423.95,2022-12-26T05:58:18,Durango,expenses,transport,-88.17,-13223.4
buyer_8,Patxi,Urrutia,1979-04-04,44624658N,patxi.urrutia@megaapp.net,322320,ES17209589367889501335,1423.95,2022-12-26T09:30:45,Durango,expenses,leisure,-28.04,-13251.44
buyer_8,Patxi,Urrutia,1979-04-04,44624658N,patxi.urrutia@megaapp.net,322320,ES17209589367889501335,1423.95,2022-12-27T14:48:25,Durango,expenses,food,-123.43,-13374.87
buyer_8,Patxi,Urrutia,1979-04-04,44624658N,patxi.urrutia@megaapp.net,322320,ES17209589367889501335,1423.95,2022-12-27T19:58:00,Durango,expenses,transport,-42.82,-13417.69
buyer_8,Patxi,Urrutia,1979-04-04,44624658N,patxi.urrutia@megaapp.net,322320,ES17209589367889501335,1423.95,2022-12-27T20:48:24,Durango,expenses,leisure,-54.42,-13472.11
buyer_8,Patxi,Urrutia,1979-04-04,44624658N,patxi.urrutia@megaapp.net,322320,ES17209589367889501335,1423.95,2022-12-28T23:06:56,Durango,expenses,food,-101.33,-13573.44
buyer_8,Patxi,Urrutia,1979-04-04,44624658N,patxi.urrutia@megaapp.net,322320,ES17209589367889501335,1423.95,2022-12-30T09:26:14,Durango,expenses,gifts,-175.74,-13749.18
buyer_8,Patxi,Urrutia,1979-04-04,44624658N,patxi.urrutia@megaapp.net,322320,ES17209589367889501335,1423.95,2022-12-31T21:28:40,Durango,expenses,repairs,-205.03,-13954.21
buyer_8,Patxi,Urrutia,1979-04-04,44624658N,patxi.urrutia@megaapp.net,322320,ES17209589367889501335,1423.95,2023-01-01T13:35:53,Durango,incomes,salary,4151.68,-9802.53
buyer_8,Patxi,Urrutia,1979-04-04,44624658N,patxi.urrutia@megaapp.net,322320,ES17209589367889501335,1423.95,2023-01-01T17:53:53,Durango,expenses,food,-116.0,-9918.53
buyer_8,Patxi,Urrutia,1979-04-04,44624658N,patxi.urrutia@megaapp.net,322320,ES17209589367889501335,1423.95,2023-01-02T20:12:40,Durango,expenses,food,-76.58,-9995.11
buyer_8,Patxi,Urrutia,1979-04-04,44624658N,patxi.urrutia@megaapp.net,322320,ES17209589367889501335,1423.95,2023-01-05T15:58:13,Durango,expenses,mortgage,-2340.31,-12335.42
buyer_8,Patxi,Urrutia,1979-04-04,44624658N,patxi.urrutia@megaapp.net,322320,ES17209589367889501335,1423.95,2023-01-05T08:51:24,Durango,expenses,electricity,-71.08,-12406.5
buyer_8,Patxi,Urrutia,1979-04-04,44624658N,patxi.urrutia@megaapp.net,322320,ES17209589367889501335,1423.95,2023-01-05T09:23:18,Durango,expenses,internet,-95.9,-12502.4
buyer_8,Patxi,Urrutia,1979-04-04,44624658N,patxi.urrutia@megaapp.net,322320,ES17209589367889501335,1423.95,2023-01-06T17:39:11,Durango,expenses,cash,-100.0,-12602.4
buyer_8,Patxi,Urrutia,1979-04-04,44624658N,patxi.urrutia@megaapp.net,322320,ES17209589367889501335,1423.95,2023-01-07T18:14:03,Durango,expenses,water,-89.39,-12691.79
buyer_8,Patxi,Urrutia,1979-04-04,44624658N,patxi.urrutia@megaapp.net,322320,ES17209589367889501335,1423.95,2023-01-07T12:12:11,Durango,expenses,food,-84.77,-12776.56
buyer_8,Patxi,Urrutia,1979-04-04,44624658N,patxi.urrutia@megaapp.net,322320,ES17209589367889501335,1423.95,2023-01-08T11:39:32,Durango,expenses,phone,-76.43,-12852.99
buyer_8,Patxi,Urrutia,1979-04-04,44624658N,patxi.urrutia@megaapp.net,322320,ES17209589367889501335,1423.95,2023-01-08T17:14:40,Durango,expenses,cash,-100.0,-12952.99
buyer_8,Patxi,Urrutia,1979-04-04,44624658N,patxi.urrutia@megaapp.net,322320,ES17209589367889501335,1423.95,2023-01-11T20:00:42,Durango,expenses,cash,-100.0,-13052.99
buyer_8,Patxi,Urrutia,1979-04-04,44624658N,patxi.urrutia@megaapp.net,322320,ES17209589367889501335,1423.95,2023-01-12T20:24:47,Durango,expenses,leisure,-60.97,-13113.96
buyer_8,Patxi,Urrutia,1979-04-04,44624658N,patxi.urrutia@megaapp.net,322320,ES17209589367889501335,1423.95,2023-01-14T11:26:05,Durango,expenses,food,-99.64,-13213.6
buyer_8,Patxi,Urrutia,1979-04-04,44624658N,patxi.urrutia@megaapp.net,322320,ES17209589367889501335,1423.95,2023-01-15T01:21:53,Durango,expenses,travel,-469.32,-13682.92
buyer_8,Patxi,Urrutia,1979-04-04,44624658N,patxi.urrutia@megaapp.net,322320,ES17209589367889501335,1423.95,2023-01-16T06:47:45,Durango,expenses,food,-62.79,-13745.71
buyer_8,Patxi,Urrutia,1979-04-04,44624658N,patxi.urrutia@megaapp.net,322320,ES17209589367889501335,1423.95,2023-01-16T23:12:45,Durango,expenses,cash,-100.0,-13845.71
buyer_8,Patxi,Urrutia,1979-04-04,44624658N,patxi.urrutia@megaapp.net,322320,ES17209589367889501335,1423.95,2023-01-19T11:43:12,Durango,expenses,leisure,-27.52,-13873.23
buyer_8,Patxi,Urrutia,1979-04-04,44624658N,patxi.urrutia@megaapp.net,322320,ES17209589367889501335,1423.95,2023-01-19T17:08:34,Durango,expenses,cash,-100.0,-13973.23
buyer_8,Patxi,Urrutia,1979-04-04,44624658N,patxi.urrutia@megaapp.net,322320,ES17209589367889501335,1423.95,2023-01-20T21:38:12,Durango,expenses,clothing,-58.35,-14031.58
buyer_8,Patxi,Urrutia,1979-04-04,44624658N,patxi.urrutia@megaapp.net,322320,ES17209589367889501335,1423.95,2023-01-24T09:12:03,Durango,expenses,clothing,-109.51,-14141.09
buyer_8,Patxi,Urrutia,1979-04-04,44624658N,patxi.urrutia@megaapp.net,322320,ES17209589367889501335,1423.95,2023-01-25T08:10:14,Durango,expenses,transport,-69.05,-14210.14
buyer_8,Patxi,Urrutia,1979-04-04,44624658N,patxi.urrutia@megaapp.net,322320,ES17209589367889501335,1423.95,2023-01-25T22:50:31,Durango,expenses,leisure,-65.92,-14276.06
buyer_8,Patxi,Urrutia,1979-04-04,44624658N,patxi.urrutia@megaapp.net,322320,ES17209589367889501335,1423.95,2023-01-26T13:59:42,Durango,expenses,cash,-100.0,-14376.06
buyer_8,Patxi,Urrutia,1979-04-04,44624658N,patxi.urrutia@megaapp.net,322320,ES17209589367889501335,1423.95,2023-01-27T04:19:36,Durango,expenses,clothing,-96.04,-14472.1
buyer_8,Patxi,Urrutia,1979-04-04,44624658N,patxi.urrutia@megaapp.net,322320,ES17209589367889501335,1423.95,2023-01-28T12:20:31,Durango,expenses,leisure,-35.02,-14507.12
buyer_8,Patxi,Urrutia,1979-04-04,44624658N,patxi.urrutia@megaapp.net,322320,ES17209589367889501335,1423.95,2023-01-30T14:12:21,Durango,expenses,food,-65.01,-14572.13
buyer_8,Patxi,Urrutia,1979-04-04,44624658N,patxi.urrutia@megaapp.net,322320,ES17209589367889501335,1423.95,2023-02-01T13:43:00,Durango,incomes,salary,4151.68,-10420.45
buyer_8,Patxi,Urrutia,1979-04-04,44624658N,patxi.urrutia@megaapp.net,322320,ES17209589367889501335,1423.95,2023-02-02T08:37:44,Durango,expenses,food,-102.16,-10522.61
buyer_8,Patxi,Urrutia,1979-04-04,44624658N,patxi.urrutia@megaapp.net,322320,ES17209589367889501335,1423.95,2023-02-02T09:41:37,Durango,expenses,transport,-88.28,-10610.89
buyer_8,Patxi,Urrutia,1979-04-04,44624658N,patxi.urrutia@megaapp.net,322320,ES17209589367889501335,1423.95,2023-02-04T10:57:45,Durango,expenses,cash,-100.0,-10710.89
buyer_8,Patxi,Urrutia,1979-04-04,44624658N,patxi.urrutia@megaapp.net,322320,ES17209589367889501335,1423.95,2023-02-05T10:02:49,Durango,expenses,mortgage,-2340.31,-13051.2
buyer_8,Patxi,Urrutia,1979-04-04,44624658N,patxi.urrutia@megaapp.net,322320,ES17209589367889501335,1423.95,2023-02-05T22:46:20,Durango,expenses,internet,-95.9,-13147.1
buyer_8,Patxi,Urrutia,1979-04-04,44624658N,patxi.urrutia@megaapp.net,322320,ES17209589367889501335,1423.95,2023-02-06T19:10:09,Durango,expenses,water,-53.36,-13200.46
buyer_8,Patxi,Urrutia,1979-04-04,44624658N,patxi.urrutia@megaapp.net,322320,ES17209589367889501335,1423.95,2023-02-06T19:15:05,Durango,expenses,internet,-95.9,-13296.36
buyer_8,Patxi,Urrutia,1979-04-04,44624658N,patxi.urrutia@megaapp.net,322320,ES17209589367889501335,1423.95,2023-02-06T14:23:35,Durango,expenses,phone,-99.51,-13395.87
buyer_8,Patxi,Urrutia,1979-04-04,44624658N,patxi.urrutia@megaapp.net,322320,ES17209589367889501335,1423.95,2023-02-06T19:23:53,Durango,expenses,healthcare,-171.35,-13567.22
buyer_8,Patxi,Urrutia,1979-04-04,44624658N,patxi.urrutia@megaapp.net,322320,ES17209589367889501335,1423.95,2023-02-07T11:00:10,Durango,expenses,food,-97.45,-13664.67
buyer_8,Patxi,Urrutia,1979-04-04,44624658N,patxi.urrutia@megaapp.net,322320,ES17209589367889501335,1423.95,2023-02-08T11:47:23,Durango,expenses,food,-103.28,-13767.95
buyer_8,Patxi,Urrutia,1979-04-04,44624658N,patxi.urrutia@megaapp.net,322320,ES17209589367889501335,1423.95,2023-02-08T20:58:22,Durango,expenses,leisure,-68.12,-13836.07
buyer_8,Patxi,Urrutia,1979-04-04,44624658N,patxi.urrutia@megaapp.net,322320,ES17209589367889501335,1423.95,2023-02-10T22:26:39,Durango,expenses,cash,-100.0,-13936.07
buyer_8,Patxi,Urrutia,1979-04-04,44624658N,patxi.urrutia@megaapp.net,322320,ES17209589367889501335,1423.95,2023-02-11T09:09:28,Durango,expenses,leisure,-52.13,-13988.2
buyer_8,Patxi,Urrutia,1979-04-04,44624658N,patxi.urrutia@megaapp.net,322320,ES17209589367889501335,1423.95,2023-02-14T15:05:02,Durango,expenses,food,-86.84,-14075.04
buyer_8,Patxi,Urrutia,1979-04-04,44624658N,patxi.urrutia@megaapp.net,322320,ES17209589367889501335,1423.95,2023-02-14T08:46:19,Durango,expenses,gifts,-52.21,-14127.25
buyer_8,Patxi,Urrutia,1979-04-04,44624658N,patxi.urrutia@megaapp.net,322320,ES17209589367889501335,1423.95,2023-02-15T18:06:38,Durango,expenses,cash,-100.0,-14227.25
buyer_8,Patxi,Urrutia,1979-04-04,44624658N,patxi.urrutia@megaapp.net,322320,ES17209589367889501335,1423.95,2023-02-15T19:34:13,Durango,expenses,repairs,-189.85,-14417.1
buyer_8,Patxi,Urrutia,1979-04-04,44624658N,patxi.urrutia@megaapp.net,322320,ES17209589367889501335,1423.95,2023-02-16T22:23:10,Durango,expenses,food,-102.98,-14520.08
buyer_8,Patxi,Urrutia,1979-04-04,44624658N,patxi.urrutia@megaapp.net,322320,ES17209589367889501335,1423.95,2023-02-17T08:40:32,Durango,expenses,cash,-100.0,-14620.08
buyer_8,Patxi,Urrutia,1979-04-04,44624658N,patxi.urrutia@megaapp.net,322320,ES17209589367889501335,1423.95,2023-02-18T18:33:51,Durango,expenses,cash,-100.0,-14720.08
buyer_8,Patxi,Urrutia,1979-04-04,44624658N,patxi.urrutia@megaapp.net,322320,ES17209589367889501335,1423.95,2023-02-20T12:20:02,Durango,expenses,transport,-62.65,-14782.73
buyer_8,Patxi,Urrutia,1979-04-04,44624658N,patxi.urrutia@megaapp.net,322320,ES17209589367889501335,1423.95,2023-02-20T12:44:10,Durango,expenses,repairs,-180.91,-14963.64
buyer_8,Patxi,Urrutia,1979-04-04,44624658N,patxi.urrutia@megaapp.net,322320,ES17209589367889501335,1423.95,2023-02-23T15:35:33,Durango,expenses,leisure,-41.03,-15004.67
buyer_8,Patxi,Urrutia,1979-04-04,44624658N,patxi.urrutia@megaapp.net,322320,ES17209589367889501335,1423.95,2023-02-25T09:58:41,Durango,expenses,leisure,-37.23,-15041.9
buyer_8,Patxi,Urrutia,1979-04-04,44624658N,patxi.urrutia@megaapp.net,322320,ES17209589367889501335,1423.95,2023-02-25T09:39:08,Durango,expenses,cash,-100.0,-15141.9
buyer_8,Patxi,Urrutia,1979-04-04,44624658N,patxi.urrutia@megaapp.net,322320,ES17209589367889501335,1423.95,2023-02-28T11:27:09,Durango,expenses,cash,-100.0,-15241.9
buyer_8,Patxi,Urrutia,1979-04-04,44624658N,patxi.urrutia@megaapp.net,322320,ES17209589367889501335,1423.95,2023-03-01T19:11:37,Durango,incomes,salary,4151.68,-11090.22
buyer_8,Patxi,Urrutia,1979-04-04,44624658N,patxi.urrutia@megaapp.net,322320,ES17209589367889501335,1423.95,2023-03-01T19:11:37,Durango,incomes,extra_income,572.97,-10517.25
buyer_8,Patxi,Urrutia,1979-04-04,44624658N,patxi.urrutia@megaapp.net,322320,ES17209589367889501335,1423.95,2023-03-02T13:19:48,Durango,expenses,leisure,-20.49,-10537.74
buyer_8,Patxi,Urrutia,1979-04-04,44624658N,patxi.urrutia@megaapp.net,322320,ES17209589367889501335,1423.95,2023-03-02T12:50:46,Durango,expenses,gifts,-383.25,-10920.99
buyer_8,Patxi,Urrutia,1979-04-04,44624658N,patxi.urrutia@megaapp.net,322320,ES17209589367889501335,1423.95,2023-03-03T13:23:35,Durango,expenses,education,-66.36,-10987.35
buyer_8,Patxi,Urrutia,1979-04-04,44624658N,patxi.urrutia@megaapp.net,322320,ES17209589367889501335,1423.95,2023-03-05T09:57:04,Durango,expenses,mortgage,-2340.31,-13327.66
buyer_8,Patxi,Urrutia,1979-04-04,44624658N,patxi.urrutia@megaapp.net,322320,ES17209589367889501335,1423.95,2023-03-05T17:10:17,Durango,expenses,water,-83.09,-13410.75
buyer_8,Patxi,Urrutia,1979-04-04,44624658N,patxi.urrutia@megaapp.net,322320,ES17209589367889501335,1423.95,2023-03-05T08:17:25,Durango,expenses,gas,-231.7,-13642.45
buyer_8,Patxi,Urrutia,1979-04-04,44624658N,patxi.urrutia@megaapp.net,322320,ES17209589367889501335,1423.95,2023-03-05T09:00:18,Durango,expenses,gifts,-299.41,-13941.86
buyer_8,Patxi,Urrutia,1979-04-04,44624658N,patxi.urrutia@megaapp.net,322320,ES17209589367889501335,1423.95,2023-03-06T16:38:49,Durango,expenses,internet,-95.9,-14037.76
buyer_8,Patxi,Urrutia,1979-04-04,44624658N,patxi.urrutia@megaapp.net,322320,ES17209589367889501335,1423.95,2023-03-07T07:04:51,Durango,expenses,water,-98.47,-14136.23
buyer_8,Patxi,Urrutia,1979-04-04,44624658N,patxi.urrutia@megaapp.net,322320,ES17209589367889501335,1423.95,2023-03-07T15:25:31,Durango,expenses,electricity,-130.68,-14266.91
buyer_8,Patxi,Urrutia,1979-04-04,44624658N,patxi.urrutia@megaapp.net,322320,ES17209589367889501335,1423.95,2023-03-07T17:43:53,Durango,expenses,internet,-95.9,-14362.81
buyer_8,Patxi,Urrutia,1979-04-04,44624658N,patxi.urrutia@megaapp.net,322320,ES17209589367889501335,1423.95,2023-03-07T12:37:40,Durango,expenses,cash,-100.0,-14462.81
buyer_8,Patxi,Urrutia,1979-04-04,44624658N,patxi.urrutia@megaapp.net,322320,ES17209589367889501335,1423.95,2023-03-07T13:03:36,Durango,expenses,travel,-380.88,-14843.69
buyer_8,Patxi,Urrutia,1979-04-04,44624658N,patxi.urrutia@megaapp.net,322320,ES17209589367889501335,1423.95,2023-03-07T16:51:14,Durango,expenses,gifts,-155.15,-14998.84
buyer_8,Patxi,Urrutia,1979-04-04,44624658N,patxi.urrutia@megaapp.net,322320,ES17209589367889501335,1423.95,2023-03-08T18:19:36,Durango,expenses,internet,-95.9,-15094.74
buyer_8,Patxi,Urrutia,1979-04-04,44624658N,patxi.urrutia@megaapp.net,322320,ES17209589367889501335,1423.95,2023-03-08T14:26:14,Durango,expenses,phone,-95.15,-15189.89
buyer_8,Patxi,Urrutia,1979-04-04,44624658N,patxi.urrutia@megaapp.net,322320,ES17209589367889501335,1423.95,2023-03-08T09:30:31,Durango,expenses,cash,-100.0,-15289.89
buyer_8,Patxi,Urrutia,1979-04-04,44624658N,patxi.urrutia@megaapp.net,322320,ES17209589367889501335,1423.95,2023-03-11T13:59:42,Durango,expenses,cash,-100.0,-15389.89
buyer_8,Patxi,Urrutia,1979-04-04,44624658N,patxi.urrutia@megaapp.net,322320,ES17209589367889501335,1423.95,2023-03-12T19:45:46,Durango,expenses,food,-67.44,-15457.33
buyer_8,Patxi,Urrutia,1979-04-04,44624658N,patxi.urrutia@megaapp.net,322320,ES17209589367889501335,1423.95,2023-03-12T15:13:34,Durango,expenses,leisure,-22.37,-15479.7
buyer_8,Patxi,Urrutia,1979-04-04,44624658N,patxi.urrutia@megaapp.net,322320,ES17209589367889501335,1423.95,2023-03-13T14:23:44,Durango,expenses,food,-72.63,-15552.33
buyer_8,Patxi,Urrutia,1979-04-04,44624658N,patxi.urrutia@megaapp.net,322320,ES17209589367889501335,1423.95,2023-03-13T13:01:11,Durango,expenses,cash,-100.0,-15652.33
buyer_8,Patxi,Urrutia,1979-04-04,44624658N,patxi.urrutia@megaapp.net,322320,ES17209589367889501335,1423.95,2023-03-15T18:37:43,Durango,expenses,food,-66.91,-15719.24
buyer_8,Patxi,Urrutia,1979-04-04,44624658N,patxi.urrutia@megaapp.net,322320,ES17209589367889501335,1423.95,2023-03-19T14:55:01,Durango,expenses,clothing,-133.8,-15853.04
buyer_8,Patxi,Urrutia,1979-04-04,44624658N,patxi.urrutia@megaapp.net,322320,ES17209589367889501335,1423.95,2023-03-20T13:54:20,Durango,expenses,travel,-391.56,-16244.6
buyer_8,Patxi,Urrutia,1979-04-04,44624658N,patxi.urrutia@megaapp.net,322320,ES17209589367889501335,1423.95,2023-03-22T16:56:36,Durango,expenses,transport,-56.46,-16301.06
buyer_8,Patxi,Urrutia,1979-04-04,44624658N,patxi.urrutia@megaapp.net,322320,ES17209589367889501335,1423.95,2023-03-23T18:08:05,Durango,expenses,leisure,-55.57,-16356.63
buyer_8,Patxi,Urrutia,1979-04-04,44624658N,patxi.urrutia@megaapp.net,322320,ES17209589367889501335,1423.95,2023-03-24T08:12:08,Durango,expenses,transport,-47.41,-16404.04
buyer_8,Patxi,Urrutia,1979-04-04,44624658N,patxi.urrutia@megaapp.net,322320,ES17209589367889501335,1423.95,2023-03-24T12:11:45,Durango,expenses,education,-75.57,-16479.61
buyer_8,Patxi,Urrutia,1979-04-04,44624658N,patxi.urrutia@megaapp.net,322320,ES17209589367889501335,1423.95,2023-03-25T12:49:20,Durango,expenses,leisure,-84.54,-16564.15
buyer_8,Patxi,Urrutia,1979-04-04,44624658N,patxi.urrutia@megaapp.net,322320,ES17209589367889501335,1423.95,2023-03-27T16:40:04,Durango,expenses,cash,-100.0,-16664.15
buyer_8,Patxi,Urrutia,1979-04-04,44624658N,patxi.urrutia@megaapp.net,322320,ES17209589367889501335,1423.95,2023-03-29T10:44:55,Durango,expenses,cash,-100.0,-16764.15
buyer_8,Patxi,Urrutia,1979-04-04,44624658N,patxi.urrutia@megaapp.net,322320,ES17209589367889501335,1423.95,2023-04-01T14:37:46,Durango,incomes,salary,4151.68,-12612.47
buyer_8,Patxi,Urrutia,1979-04-04,44624658N,patxi.urrutia@megaapp.net,322320,ES17209589367889501335,1423.95,2023-04-01T08:18:52,Durango,expenses,food,-63.05,-12675.52
buyer_8,Patxi,Urrutia,1979-04-04,44624658N,patxi.urrutia@megaapp.net,322320,ES17209589367889501335,1423.95,2023-04-03T18:53:43,Durango,expenses,leisure,-62.08,-12737.6
buyer_8,Patxi,Urrutia,1979-04-04,44624658N,patxi.urrutia@megaapp.net,322320,ES17209589367889501335,1423.95,2023-04-05T11:04:16,Durango,expenses,mortgage,-2340.31,-15077.91
buyer_8,Patxi,Urrutia,1979-04-04,44624658N,patxi.urrutia@megaapp.net,322320,ES17209589367889501335,1423.95,2023-04-05T00:55:33,Durango,expenses,gas,-131.97,-15209.88
buyer_8,Patxi,Urrutia,1979-04-04,44624658N,patxi.urrutia@megaapp.net,322320,ES17209589367889501335,1423.95,2023-04-06T00:25:09,Durango,expenses,phone,-79.81,-15289.69
buyer_8,Patxi,Urrutia,1979-04-04,44624658N,patxi.urrutia@megaapp.net,322320,ES17209589367889501335,1423.95,2023-04-07T11:09:05,Durango,expenses,electricity,-77.96,-15367.65
buyer_8,Patxi,Urrutia,1979-04-04,44624658N,patxi.urrutia@megaapp.net,322320,ES17209589367889501335,1423.95,2023-04-08T10:53:30,Durango,expenses,phone,-97.18,-15464.83
buyer_8,Patxi,Urrutia,1979-04-04,44624658N,patxi.urrutia@megaapp.net,322320,ES17209589367889501335,1423.95,2023-04-08T14:35:58,Durango,expenses,transport,-62.86,-15527.69
buyer_8,Patxi,Urrutia,1979-04-04,44624658N,patxi.urrutia@megaapp.net,322320,ES17209589367889501335,1423.95,2023-04-08T11:57:50,Durango,expenses,clothing,-73.82,-15601.51
buyer_8,Patxi,Urrutia,1979-04-04,44624658N,patxi.urrutia@megaapp.net,322320,ES17209589367889501335,1423.95,2023-04-09T19:09:50,Durango,expenses,appliances,-317.66,-15919.17
buyer_8,Patxi,Urrutia,1979-04-04,44624658N,patxi.urrutia@megaapp.net,322320,ES17209589367889501335,1423.95,2023-04-10T16:15:40,Durango,expenses,clothing,-84.88,-16004.05
buyer_8,Patxi,Urrutia,1979-04-04,44624658N,patxi.urrutia@megaapp.net,322320,ES17209589367889501335,1423.95,2023-04-10T23:29:37,Durango,expenses,cash,-100.0,-16104.05
buyer_8,Patxi,Urrutia,1979-04-04,44624658N,patxi.urrutia@megaapp.net,322320,ES17209589367889501335,1423.95,2023-04-10T10:47:11,Durango,expenses,gifts,-121.95,-16226.0
buyer_8,Patxi,Urrutia,1979-04-04,44624658N,patxi.urrutia@megaapp.net,322320,ES17209589367889501335,1423.95,2023-04-10T11:31:14,Durango,expenses,car,-698.2010000000002,-16924.2
buyer_8,Patxi,Urrutia,1979-04-04,44624658N,patxi.urrutia@megaapp.net,322320,ES17209589367889501335,1423.95,2023-04-11T19:43:21,Durango,expenses,cash,-100.0,-17024.2
buyer_8,Patxi,Urrutia,1979-04-04,44624658N,patxi.urrutia@megaapp.net,322320,ES17209589367889501335,1423.95,2023-04-14T17:18:56,Durango,expenses,food,-67.51,-17091.71
buyer_8,Patxi,Urrutia,1979-04-04,44624658N,patxi.urrutia@megaapp.net,322320,ES17209589367889501335,1423.95,2023-04-15T10:05:59,Durango,expenses,clothing,-71.8,-17163.51
buyer_8,Patxi,Urrutia,1979-04-04,44624658N,patxi.urrutia@megaapp.net,322320,ES17209589367889501335,1423.95,2023-04-16T00:32:11,Durango,expenses,cash,-100.0,-17263.51
buyer_8,Patxi,Urrutia,1979-04-04,44624658N,patxi.urrutia@megaapp.net,322320,ES17209589367889501335,1423.95,2023-04-17T23:15:48,Durango,expenses,clothing,-140.28,-17403.79
buyer_8,Patxi,Urrutia,1979-04-04,44624658N,patxi.urrutia@megaapp.net,322320,ES17209589367889501335,1423.95,2023-04-18T22:15:49,Durango,expenses,clothing,-98.76,-17502.55
buyer_8,Patxi,Urrutia,1979-04-04,44624658N,patxi.urrutia@megaapp.net,322320,ES17209589367889501335,1423.95,2023-04-20T10:53:35,Durango,expenses,food,-104.46,-17607.01
buyer_8,Patxi,Urrutia,1979-04-04,44624658N,patxi.urrutia@megaapp.net,322320,ES17209589367889501335,1423.95,2023-04-22T13:03:33,Durango,expenses,leisure,-38.77,-17645.78
buyer_8,Patxi,Urrutia,1979-04-04,44624658N,patxi.urrutia@megaapp.net,322320,ES17209589367889501335,1423.95,2023-04-22T14:59:07,Durango,expenses,cash,-100.0,-17745.78
buyer_8,Patxi,Urrutia,1979-04-04,44624658N,patxi.urrutia@megaapp.net,322320,ES17209589367889501335,1423.95,2023-04-24T05:48:34,Durango,expenses,clothing,-115.86,-17861.64
buyer_8,Patxi,Urrutia,1979-04-04,44624658N,patxi.urrutia@megaapp.net,322320,ES17209589367889501335,1423.95,2023-04-24T09:28:42,Durango,expenses,cash,-100.0,-17961.64
buyer_8,Patxi,Urrutia,1979-04-04,44624658N,patxi.urrutia@megaapp.net,322320,ES17209589367889501335,1423.95,2023-04-26T11:24:21,Durango,expenses,leisure,-24.97,-17986.61
buyer_8,Patxi,Urrutia,1979-04-04,44624658N,patxi.urrutia@megaapp.net,322320,ES17209589367889501335,1423.95,2023-04-26T12:16:11,Durango,expenses,travel,-741.83,-18728.44
buyer_8,Patxi,Urrutia,1979-04-04,44624658N,patxi.urrutia@megaapp.net,322320,ES17209589367889501335,1423.95,2023-04-29T19:39:11,Durango,expenses,gifts,-376.45,-19104.89
buyer_8,Patxi,Urrutia,1979-04-04,44624658N,patxi.urrutia@megaapp.net,322320,ES17209589367889501335,1423.95,2023-04-30T20:26:19,Durango,expenses,cash,-100.0,-19204.89
buyer_8,Patxi,Urrutia,1979-04-04,44624658N,patxi.urrutia@megaapp.net,322320,ES17209589367889501335,1423.95,2023-05-01T19:49:23,Durango,incomes,salary,4151.68,-15053.21
buyer_8,Patxi,Urrutia,1979-04-04,44624658N,patxi.urrutia@megaapp.net,322320,ES17209589367889501335,1423.95,2023-05-01T15:27:41,Durango,expenses,clothing,-120.3,-15173.51
buyer_8,Patxi,Urrutia,1979-04-04,44624658N,patxi.urrutia@megaapp.net,322320,ES17209589367889501335,1423.95,2023-05-01T20:14:51,Durango,expenses,healthcare,-94.96,-15268.47
buyer_8,Patxi,Urrutia,1979-04-04,44624658N,patxi.urrutia@megaapp.net,322320,ES17209589367889501335,1423.95,2023-05-03T14:43:37,Durango,expenses,cash,-100.0,-15368.47
buyer_8,Patxi,Urrutia,1979-04-04,44624658N,patxi.urrutia@megaapp.net,322320,ES17209589367889501335,1423.95,2023-05-04T14:04:24,Durango,expenses,gifts,-835.36,-16203.83
buyer_8,Patxi,Urrutia,1979-04-04,44624658N,patxi.urrutia@megaapp.net,322320,ES17209589367889501335,1423.95,2023-05-05T17:08:10,Durango,expenses,mortgage,-2340.31,-18544.14
buyer_8,Patxi,Urrutia,1979-04-04,44624658N,patxi.urrutia@megaapp.net,322320,ES17209589367889501335,1423.95,2023-05-05T01:09:53,Durango,expenses,internet,-95.9,-18640.04
buyer_8,Patxi,Urrutia,1979-04-04,44624658N,patxi.urrutia@megaapp.net,322320,ES17209589367889501335,1423.95,2023-05-05T05:21:53,Durango,expenses,education,-65.29,-18705.33
buyer_8,Patxi,Urrutia,1979-04-04,44624658N,patxi.urrutia@megaapp.net,322320,ES17209589367889501335,1423.95,2023-05-06T19:41:26,Durango,expenses,gas,-122.92,-18828.25
buyer_8,Patxi,Urrutia,1979-04-04,44624658N,patxi.urrutia@megaapp.net,322320,ES17209589367889501335,1423.95,2023-05-07T12:11:24,Durango,expenses,water,-67.88,-18896.13
buyer_8,Patxi,Urrutia,1979-04-04,44624658N,patxi.urrutia@megaapp.net,322320,ES17209589367889501335,1423.95,2023-05-08T10:14:30,Durango,expenses,electricity,-119.1,-19015.23
buyer_8,Patxi,Urrutia,1979-04-04,44624658N,patxi.urrutia@megaapp.net,322320,ES17209589367889501335,1423.95,2023-05-08T16:25:14,Durango,expenses,phone,-97.82,-19113.05
buyer_8,Patxi,Urrutia,1979-04-04,44624658N,patxi.urrutia@megaapp.net,322320,ES17209589367889501335,1423.95,2023-05-08T19:09:31,Durango,expenses,leisure,-64.17,-19177.22
buyer_8,Patxi,Urrutia,1979-04-04,44624658N,patxi.urrutia@megaapp.net,322320,ES17209589367889501335,1423.95,2023-05-11T16:15:02,Durango,expenses,food,-65.84,-19243.06
buyer_8,Patxi,Urrutia,1979-04-04,44624658N,patxi.urrutia@megaapp.net,322320,ES17209589367889501335,1423.95,2023-05-12T00:09:58,Durango,expenses,food,-118.5,-19361.56
buyer_8,Patxi,Urrutia,1979-04-04,44624658N,patxi.urrutia@megaapp.net,322320,ES17209589367889501335,1423.95,2023-05-12T12:36:09,Durango,expenses,healthcare,-159.85,-19521.41
buyer_8,Patxi,Urrutia,1979-04-04,44624658N,patxi.urrutia@megaapp.net,322320,ES17209589367889501335,1423.95,2023-05-12T19:05:45,Durango,expenses,cash,-100.0,-19621.41
buyer_8,Patxi,Urrutia,1979-04-04,44624658N,patxi.urrutia@megaapp.net,322320,ES17209589367889501335,1423.95,2023-05-14T10:02:26,Durango,expenses,transport,-79.35,-19700.76
buyer_8,Patxi,Urrutia,1979-04-04,44624658N,patxi.urrutia@megaapp.net,322320,ES17209589367889501335,1423.95,2023-05-14T08:34:39,Durango,expenses,gifts,-494.82,-20195.58
buyer_8,Patxi,Urrutia,1979-04-04,44624658N,patxi.urrutia@megaapp.net,322320,ES17209589367889501335,1423.95,2023-05-15T14:16:07,Durango,expenses,food,-112.56,-20308.14
buyer_8,Patxi,Urrutia,1979-04-04,44624658N,patxi.urrutia@megaapp.net,322320,ES17209589367889501335,1423.95,2023-05-16T23:47:52,Durango,expenses,repairs,-148.37,-20456.51
buyer_8,Patxi,Urrutia,1979-04-04,44624658N,patxi.urrutia@megaapp.net,322320,ES17209589367889501335,1423.95,2023-05-18T19:24:39,Durango,expenses,food,-67.04,-20523.55
buyer_8,Patxi,Urrutia,1979-04-04,44624658N,patxi.urrutia@megaapp.net,322320,ES17209589367889501335,1423.95,2023-05-18T15:47:49,Durango,expenses,leisure,-27.61,-20551.16
buyer_8,Patxi,Urrutia,1979-04-04,44624658N,patxi.urrutia@megaapp.net,322320,ES17209589367889501335,1423.95,2023-05-18T15:45:34,Durango,expenses,cash,-100.0,-20651.16
buyer_8,Patxi,Urrutia,1979-04-04,44624658N,patxi.urrutia@megaapp.net,322320,ES17209589367889501335,1423.95,2023-05-18T21:41:16,Durango,expenses,gifts,-452.18,-21103.34
buyer_8,Patxi,Urrutia,1979-04-04,44624658N,patxi.urrutia@megaapp.net,322320,ES17209589367889501335,1423.95,2023-05-19T08:50:36,Durango,expenses,transport,-71.7,-21175.04
buyer_8,Patxi,Urrutia,1979-04-04,44624658N,patxi.urrutia@megaapp.net,322320,ES17209589367889501335,1423.95,2023-05-20T10:43:16,Durango,expenses,transport,-49.69,-21224.73
buyer_8,Patxi,Urrutia,1979-04-04,44624658N,patxi.urrutia@megaapp.net,322320,ES17209589367889501335,1423.95,2023-05-20T13:28:19,Durango,expenses,leisure,-69.61,-21294.34
buyer_8,Patxi,Urrutia,1979-04-04,44624658N,patxi.urrutia@megaapp.net,322320,ES17209589367889501335,1423.95,2023-05-25T08:28:40,Durango,expenses,repairs,-65.29,-21359.63
buyer_8,Patxi,Urrutia,1979-04-04,44624658N,patxi.urrutia@megaapp.net,322320,ES17209589367889501335,1423.95,2023-05-27T19:30:09,Durango,expenses,cash,-100.0,-21459.63
buyer_8,Patxi,Urrutia,1979-04-04,44624658N,patxi.urrutia@megaapp.net,322320,ES17209589367889501335,1423.95,2023-05-29T23:34:05,Durango,expenses,transport,-57.73,-21517.36
buyer_8,Patxi,Urrutia,1979-04-04,44624658N,patxi.urrutia@megaapp.net,322320,ES17209589367889501335,1423.95,2023-05-29T21:50:17,Durango,expenses,cash,-100.0,-21617.36
buyer_8,Patxi,Urrutia,1979-04-04,44624658N,patxi.urrutia@megaapp.net,322320,ES17209589367889501335,1423.95,2023-05-29T23:14:19,Durango,expenses,repairs,-156.96,-21774.32
buyer_8,Patxi,Urrutia,1979-04-04,44624658N,patxi.urrutia@megaapp.net,322320,ES17209589367889501335,1423.95,2023-06-01T20:30:45,Durango,incomes,salary,4151.68,-17622.64
buyer_8,Patxi,Urrutia,1979-04-04,44624658N,patxi.urrutia@megaapp.net,322320,ES17209589367889501335,1423.95,2023-06-01T20:30:45,Durango,incomes,salary_bonus,3265.51,-14357.13
buyer_8,Patxi,Urrutia,1979-04-04,44624658N,patxi.urrutia@megaapp.net,322320,ES17209589367889501335,1423.95,2023-06-02T13:55:10,Durango,expenses,food,-87.37,-14444.5
buyer_8,Patxi,Urrutia,1979-04-04,44624658N,patxi.urrutia@megaapp.net,322320,ES17209589367889501335,1423.95,2023-06-02T20:37:35,Durango,expenses,cash,-100.0,-14544.5
buyer_8,Patxi,Urrutia,1979-04-04,44624658N,patxi.urrutia@megaapp.net,322320,ES17209589367889501335,1423.95,2023-06-03T07:16:50,Durango,expenses,gifts,-204.62,-14749.12
buyer_8,Patxi,Urrutia,1979-04-04,44624658N,patxi.urrutia@megaapp.net,322320,ES17209589367889501335,1423.95,2023-06-04T08:14:35,Durango,expenses,taxes,-3274.93,-18024.05
buyer_8,Patxi,Urrutia,1979-04-04,44624658N,patxi.urrutia@megaapp.net,322320,ES17209589367889501335,1423.95,2023-06-04T21:33:24,Durango,expenses,insurance,-1333.73,-19357.78
buyer_8,Patxi,Urrutia,1979-04-04,44624658N,patxi.urrutia@megaapp.net,322320,ES17209589367889501335,1423.95,2023-06-05T15:05:16,Durango,expenses,mortgage,-2340.31,-21698.09
buyer_8,Patxi,Urrutia,1979-04-04,44624658N,patxi.urrutia@megaapp.net,322320,ES17209589367889501335,1423.95,2023-06-05T09:02:12,Durango,expenses,electricity,-167.52,-21865.61
buyer_8,Patxi,Urrutia,1979-04-04,44624658N,patxi.urrutia@megaapp.net,322320,ES17209589367889501335,1423.95,2023-06-06T23:56:22,Durango,expenses,water,-62.3,-21927.91
buyer_8,Patxi,Urrutia,1979-04-04,44624658N,patxi.urrutia@megaapp.net,322320,ES17209589367889501335,1423.95,2023-06-06T11:25:48,Durango,expenses,electricity,-61.15,-21989.06
buyer_8,Patxi,Urrutia,1979-04-04,44624658N,patxi.urrutia@megaapp.net,322320,ES17209589367889501335,1423.95,2023-06-06T18:41:37,Durango,expenses,gas,-189.04,-22178.1
buyer_8,Patxi,Urrutia,1979-04-04,44624658N,patxi.urrutia@megaapp.net,322320,ES17209589367889501335,1423.95,2023-06-06T11:45:39,Durango,expenses,gifts,-286.88,-22464.98
buyer_8,Patxi,Urrutia,1979-04-04,44624658N,patxi.urrutia@megaapp.net,322320,ES17209589367889501335,1423.95,2023-06-07T21:38:50,Durango,expenses,water,-90.7,-22555.68
buyer_8,Patxi,Urrutia,1979-04-04,44624658N,patxi.urrutia@megaapp.net,322320,ES17209589367889501335,1423.95,2023-06-07T08:36:15,Durango,expenses,gas,-224.8,-22780.48
buyer_8,Patxi,Urrutia,1979-04-04,44624658N,patxi.urrutia@megaapp.net,322320,ES17209589367889501335,1423.95,2023-06-07T20:11:53,Durango,expenses,internet,-95.9,-22876.38
buyer_8,Patxi,Urrutia,1979-04-04,44624658N,patxi.urrutia@megaapp.net,322320,ES17209589367889501335,1423.95,2023-06-07T19:51:51,Durango,expenses,cash,-100.0,-22976.38
buyer_8,Patxi,Urrutia,1979-04-04,44624658N,patxi.urrutia@megaapp.net,322320,ES17209589367889501335,1423.95,2023-06-07T16:05:31,Durango,expenses,gifts,-482.3,-23458.68
buyer_8,Patxi,Urrutia,1979-04-04,44624658N,patxi.urrutia@megaapp.net,322320,ES17209589367889501335,1423.95,2023-06-08T13:40:11,Durango,expenses,food,-82.84,-23541.52
buyer_8,Patxi,Urrutia,1979-04-04,44624658N,patxi.urrutia@megaapp.net,322320,ES17209589367889501335,1423.95,2023-06-12T09:27:03,Durango,expenses,appliances,-206.71,-23748.23
buyer_8,Patxi,Urrutia,1979-04-04,44624658N,patxi.urrutia@megaapp.net,322320,ES17209589367889501335,1423.95,2023-06-13T09:57:01,Durango,expenses,food,-118.13,-23866.36
buyer_8,Patxi,Urrutia,1979-04-04,44624658N,patxi.urrutia@megaapp.net,322320,ES17209589367889501335,1423.95,2023-06-13T17:50:01,Durango,expenses,leisure,-24.12,-23890.48
buyer_8,Patxi,Urrutia,1979-04-04,44624658N,patxi.urrutia@megaapp.net,322320,ES17209589367889501335,1423.95,2023-06-17T14:04:54,Durango,expenses,clothing,-70.44,-23960.92
buyer_8,Patxi,Urrutia,1979-04-04,44624658N,patxi.urrutia@megaapp.net,322320,ES17209589367889501335,1423.95,2023-06-17T13:43:55,Durango,expenses,cash,-100.0,-24060.92
buyer_8,Patxi,Urrutia,1979-04-04,44624658N,patxi.urrutia@megaapp.net,322320,ES17209589367889501335,1423.95,2023-06-19T14:20:14,Durango,expenses,appliances,-404.62,-24465.54
buyer_8,Patxi,Urrutia,1979-04-04,44624658N,patxi.urrutia@megaapp.net,322320,ES17209589367889501335,1423.95,2023-06-21T10:12:40,Durango,expenses,food,-71.15,-24536.69
buyer_8,Patxi,Urrutia,1979-04-04,44624658N,patxi.urrutia@megaapp.net,322320,ES17209589367889501335,1423.95,2023-06-21T10:16:12,Durango,expenses,clothing,-58.71,-24595.4
buyer_8,Patxi,Urrutia,1979-04-04,44624658N,patxi.urrutia@megaapp.net,322320,ES17209589367889501335,1423.95,2023-06-22T05:02:23,Durango,expenses,leisure,-26.09,-24621.49
buyer_8,Patxi,Urrutia,1979-04-04,44624658N,patxi.urrutia@megaapp.net,322320,ES17209589367889501335,1423.95,2023-06-23T14:15:51,Durango,expenses,clothing,-82.66,-24704.15
buyer_8,Patxi,Urrutia,1979-04-04,44624658N,patxi.urrutia@megaapp.net,322320,ES17209589367889501335,1423.95,2023-06-25T10:18:23,Durango,expenses,leisure,-77.96,-24782.11
buyer_8,Patxi,Urrutia,1979-04-04,44624658N,patxi.urrutia@megaapp.net,322320,ES17209589367889501335,1423.95,2023-06-28T11:32:07,Durango,expenses,transport,-75.64,-24857.75
buyer_8,Patxi,Urrutia,1979-04-04,44624658N,patxi.urrutia@megaapp.net,322320,ES17209589367889501335,1423.95,2023-06-30T14:13:35,Durango,expenses,clothing,-89.42,-24947.17
buyer_8,Patxi,Urrutia,1979-04-04,44624658N,patxi.urrutia@megaapp.net,322320,ES17209589367889501335,1423.95,2023-07-01T18:25:57,Durango,incomes,salary,4151.68,-20795.49
buyer_8,Patxi,Urrutia,1979-04-04,44624658N,patxi.urrutia@megaapp.net,322320,ES17209589367889501335,1423.95,2023-07-01T18:25:57,Durango,incomes,extra_income,572.97,-20222.52
buyer_8,Patxi,Urrutia,1979-04-04,44624658N,patxi.urrutia@megaapp.net,322320,ES17209589367889501335,1423.95,2023-07-01T15:48:28,Durango,expenses,education,-42.12,-20264.64
buyer_8,Patxi,Urrutia,1979-04-04,44624658N,patxi.urrutia@megaapp.net,322320,ES17209589367889501335,1423.95,2023-07-02T20:14:23,Durango,expenses,food,-124.09,-20388.73
buyer_8,Patxi,Urrutia,1979-04-04,44624658N,patxi.urrutia@megaapp.net,322320,ES17209589367889501335,1423.95,2023-07-04T10:26:51,Durango,expenses,leisure,-24.34,-20413.07
buyer_8,Patxi,Urrutia,1979-04-04,44624658N,patxi.urrutia@megaapp.net,322320,ES17209589367889501335,1423.95,2023-07-05T10:07:43,Durango,expenses,mortgage,-2340.31,-22753.38
buyer_8,Patxi,Urrutia,1979-04-04,44624658N,patxi.urrutia@megaapp.net,322320,ES17209589367889501335,1423.95,2023-07-05T16:04:22,Durango,expenses,water,-102.4,-22855.78
buyer_8,Patxi,Urrutia,1979-04-04,44624658N,patxi.urrutia@megaapp.net,322320,ES17209589367889501335,1423.95,2023-07-05T11:12:02,Durango,expenses,electricity,-187.28,-23043.06
buyer_8,Patxi,Urrutia,1979-04-04,44624658N,patxi.urrutia@megaapp.net,322320,ES17209589367889501335,1423.95,2023-07-05T17:37:06,Durango,expenses,transport,-52.6,-23095.66
buyer_8,Patxi,Urrutia,1979-04-04,44624658N,patxi.urrutia@megaapp.net,322320,ES17209589367889501335,1423.95,2023-07-07T19:15:40,Durango,expenses,water,-87.95,-23183.61
buyer_8,Patxi,Urrutia,1979-04-04,44624658N,patxi.urrutia@megaapp.net,322320,ES17209589367889501335,1423.95,2023-07-07T18:32:05,Durango,expenses,food,-95.6,-23279.21
buyer_8,Patxi,Urrutia,1979-04-04,44624658N,patxi.urrutia@megaapp.net,322320,ES17209589367889501335,1423.95,2023-07-08T23:42:09,Durango,expenses,water,-52.83,-23332.04
buyer_8,Patxi,Urrutia,1979-04-04,44624658N,patxi.urrutia@megaapp.net,322320,ES17209589367889501335,1423.95,2023-07-09T22:19:21,Durango,expenses,clothing,-101.58,-23433.62
buyer_8,Patxi,Urrutia,1979-04-04,44624658N,patxi.urrutia@megaapp.net,322320,ES17209589367889501335,1423.95,2023-07-09T13:45:35,Durango,expenses,gifts,-426.08,-23859.7
buyer_8,Patxi,Urrutia,1979-04-04,44624658N,patxi.urrutia@megaapp.net,322320,ES17209589367889501335,1423.95,2023-07-11T16:33:37,Durango,expenses,leisure,-62.75,-23922.45
buyer_8,Patxi,Urrutia,1979-04-04,44624658N,patxi.urrutia@megaapp.net,322320,ES17209589367889501335,1423.95,2023-07-12T12:22:08,Durango,expenses,food,-87.76,-24010.21
buyer_8,Patxi,Urrutia,1979-04-04,44624658N,patxi.urrutia@megaapp.net,322320,ES17209589367889501335,1423.95,2023-07-12T18:43:39,Durango,expenses,leisure,-60.74,-24070.95
buyer_8,Patxi,Urrutia,1979-04-04,44624658N,patxi.urrutia@megaapp.net,322320,ES17209589367889501335,1423.95,2023-07-13T17:29:05,Durango,expenses,food,-108.73,-24179.68
buyer_8,Patxi,Urrutia,1979-04-04,44624658N,patxi.urrutia@megaapp.net,322320,ES17209589367889501335,1423.95,2023-07-13T15:00:48,Durango,expenses,repairs,-88.9,-24268.58
buyer_8,Patxi,Urrutia,1979-04-04,44624658N,patxi.urrutia@megaapp.net,322320,ES17209589367889501335,1423.95,2023-07-14T12:45:09,Durango,expenses,transport,-53.05,-24321.63
buyer_8,Patxi,Urrutia,1979-04-04,44624658N,patxi.urrutia@megaapp.net,322320,ES17209589367889501335,1423.95,2023-07-14T18:25:44,Durango,expenses,education,-78.14,-24399.77
buyer_8,Patxi,Urrutia,1979-04-04,44624658N,patxi.urrutia@megaapp.net,322320,ES17209589367889501335,1423.95,2023-07-15T22:15:59,Durango,expenses,cash,-100.0,-24499.77
buyer_8,Patxi,Urrutia,1979-04-04,44624658N,patxi.urrutia@megaapp.net,322320,ES17209589367889501335,1423.95,2023-07-16T13:31:17,Durango,expenses,clothing,-98.35,-24598.12
buyer_8,Patxi,Urrutia,1979-04-04,44624658N,patxi.urrutia@megaapp.net,322320,ES17209589367889501335,1423.95,2023-07-16T20:36:41,Durango,expenses,appliances,-288.89,-24887.01
buyer_8,Patxi,Urrutia,1979-04-04,44624658N,patxi.urrutia@megaapp.net,322320,ES17209589367889501335,1423.95,2023-07-16T22:55:06,Durango,expenses,gifts,-243.81,-25130.82
buyer_8,Patxi,Urrutia,1979-04-04,44624658N,patxi.urrutia@megaapp.net,322320,ES17209589367889501335,1423.95,2023-07-18T09:11:46,Durango,expenses,food,-75.6,-25206.42
buyer_8,Patxi,Urrutia,1979-04-04,44624658N,patxi.urrutia@megaapp.net,322320,ES17209589367889501335,1423.95,2023-07-20T19:16:35,Durango,expenses,cash,-100.0,-25306.42
buyer_8,Patxi,Urrutia,1979-04-04,44624658N,patxi.urrutia@megaapp.net,322320,ES17209589367889501335,1423.95,2023-07-28T04:06:51,Durango,expenses,clothing,-64.1,-25370.52
buyer_8,Patxi,Urrutia,1979-04-04,44624658N,patxi.urrutia@megaapp.net,322320,ES17209589367889501335,1423.95,2023-07-29T09:20:42,Durango,expenses,food,-77.94,-25448.46
buyer_8,Patxi,Urrutia,1979-04-04,44624658N,patxi.urrutia@megaapp.net,322320,ES17209589367889501335,1423.95,2023-07-31T10:16:13,Durango,expenses,food,-101.41,-25549.87
buyer_8,Patxi,Urrutia,1979-04-04,44624658N,patxi.urrutia@megaapp.net,322320,ES17209589367889501335,1423.95,2023-07-31T09:43:59,Durango,expenses,leisure,-18.97,-25568.84
buyer_8,Patxi,Urrutia,1979-04-04,44624658N,patxi.urrutia@megaapp.net,322320,ES17209589367889501335,1423.95,2023-08-01T23:51:12,Durango,incomes,salary,4151.68,-21417.16
buyer_8,Patxi,Urrutia,1979-04-04,44624658N,patxi.urrutia@megaapp.net,322320,ES17209589367889501335,1423.95,2023-08-05T18:06:18,Durango,expenses,mortgage,-2340.31,-23757.47
buyer_8,Patxi,Urrutia,1979-04-04,44624658N,patxi.urrutia@megaapp.net,322320,ES17209589367889501335,1423.95,2023-08-05T08:17:04,Durango,expenses,water,-51.84,-23809.31
buyer_8,Patxi,Urrutia,1979-04-04,44624658N,patxi.urrutia@megaapp.net,322320,ES17209589367889501335,1423.95,2023-08-05T14:43:32,Durango,expenses,electricity,-115.36,-23924.67
buyer_8,Patxi,Urrutia,1979-04-04,44624658N,patxi.urrutia@megaapp.net,322320,ES17209589367889501335,1423.95,2023-08-05T17:01:02,Durango,expenses,education,-71.45,-23996.12
buyer_8,Patxi,Urrutia,1979-04-04,44624658N,patxi.urrutia@megaapp.net,322320,ES17209589367889501335,1423.95,2023-08-07T18:24:58,Durango,expenses,phone,-88.08,-24084.2
buyer_8,Patxi,Urrutia,1979-04-04,44624658N,patxi.urrutia@megaapp.net,322320,ES17209589367889501335,1423.95,2023-08-07T12:56:01,Durango,expenses,appliances,-127.91,-24212.11
buyer_8,Patxi,Urrutia,1979-04-04,44624658N,patxi.urrutia@megaapp.net,322320,ES17209589367889501335,1423.95,2023-08-09T15:33:20,Durango,expenses,food,-107.51,-24319.62
buyer_8,Patxi,Urrutia,1979-04-04,44624658N,patxi.urrutia@megaapp.net,322320,ES17209589367889501335,1423.95,2023-08-11T16:40:43,Durango,expenses,cash,-100.0,-24419.62
buyer_8,Patxi,Urrutia,1979-04-04,44624658N,patxi.urrutia@megaapp.net,322320,ES17209589367889501335,1423.95,2023-08-12T10:46:11,Durango,expenses,transport,-53.75,-24473.37
buyer_8,Patxi,Urrutia,1979-04-04,44624658N,patxi.urrutia@megaapp.net,322320,ES17209589367889501335,1423.95,2023-08-13T12:09:07,Durango,expenses,leisure,-84.99,-24558.36
buyer_8,Patxi,Urrutia,1979-04-04,44624658N,patxi.urrutia@megaapp.net,322320,ES17209589367889501335,1423.95,2023-08-13T20:11:00,Durango,expenses,gifts,-467.04,-25025.4
buyer_8,Patxi,Urrutia,1979-04-04,44624658N,patxi.urrutia@megaapp.net,322320,ES17209589367889501335,1423.95,2023-08-16T09:42:57,Durango,expenses,leisure,-30.04,-25055.44
buyer_8,Patxi,Urrutia,1979-04-04,44624658N,patxi.urrutia@megaapp.net,322320,ES17209589367889501335,1423.95,2023-08-17T13:23:29,Durango,expenses,food,-92.88,-25148.32
buyer_8,Patxi,Urrutia,1979-04-04,44624658N,patxi.urrutia@megaapp.net,322320,ES17209589367889501335,1423.95,2023-08-17T20:21:07,Durango,expenses,clothing,-150.64,-25298.96
buyer_8,Patxi,Urrutia,1979-04-04,44624658N,patxi.urrutia@megaapp.net,322320,ES17209589367889501335,1423.95,2023-08-18T01:55:49,Durango,expenses,food,-95.47,-25394.43
buyer_8,Patxi,Urrutia,1979-04-04,44624658N,patxi.urrutia@megaapp.net,322320,ES17209589367889501335,1423.95,2023-08-19T08:59:45,Durango,expenses,food,-70.57,-25465.0
buyer_8,Patxi,Urrutia,1979-04-04,44624658N,patxi.urrutia@megaapp.net,322320,ES17209589367889501335,1423.95,2023-08-22T18:46:47,Durango,expenses,cash,-100.0,-25565.0
buyer_8,Patxi,Urrutia,1979-04-04,44624658N,patxi.urrutia@megaapp.net,322320,ES17209589367889501335,1423.95,2023-08-23T16:25:00,Durango,expenses,leisure,-59.72,-25624.72
buyer_8,Patxi,Urrutia,1979-04-04,44624658N,patxi.urrutia@megaapp.net,322320,ES17209589367889501335,1423.95,2023-08-24T18:00:15,Durango,expenses,travel,-809.08,-26433.8
buyer_8,Patxi,Urrutia,1979-04-04,44624658N,patxi.urrutia@megaapp.net,322320,ES17209589367889501335,1423.95,2023-08-25T11:14:47,Durango,expenses,food,-75.42,-26509.22
buyer_8,Patxi,Urrutia,1979-04-04,44624658N,patxi.urrutia@megaapp.net,322320,ES17209589367889501335,1423.95,2023-08-25T15:03:04,Durango,expenses,cash,-100.0,-26609.22
buyer_8,Patxi,Urrutia,1979-04-04,44624658N,patxi.urrutia@megaapp.net,322320,ES17209589367889501335,1423.95,2023-08-29T16:28:37,Durango,expenses,transport,-47.83,-26657.05
buyer_8,Patxi,Urrutia,1979-04-04,44624658N,patxi.urrutia@megaapp.net,322320,ES17209589367889501335,1423.95,2023-08-30T11:32:14,Durango,expenses,transport,-76.03,-26733.08
buyer_8,Patxi,Urrutia,1979-04-04,44624658N,patxi.urrutia@megaapp.net,322320,ES17209589367889501335,1423.95,2023-08-31T13:14:50,Durango,expenses,leisure,-41.93,-26775.01
buyer_8,Patxi,Urrutia,1979-04-04,44624658N,patxi.urrutia@megaapp.net,322320,ES17209589367889501335,1423.95,2023-08-31T22:42:23,Durango,expenses,cash,-100.0,-26875.01
buyer_8,Patxi,Urrutia,1979-04-04,44624658N,patxi.urrutia@megaapp.net,322320,ES17209589367889501335,1423.95,2023-09-01T20:24:03,Durango,incomes,salary,4151.68,-22723.33
buyer_8,Patxi,Urrutia,1979-04-04,44624658N,patxi.urrutia@megaapp.net,322320,ES17209589367889501335,1423.95,2023-09-04T15:19:16,Durango,expenses,food,-87.98,-22811.31
buyer_8,Patxi,Urrutia,1979-04-04,44624658N,patxi.urrutia@megaapp.net,322320,ES17209589367889501335,1423.95,2023-09-04T17:46:15,Durango,expenses,clothing,-149.59,-22960.9
buyer_8,Patxi,Urrutia,1979-04-04,44624658N,patxi.urrutia@megaapp.net,322320,ES17209589367889501335,1423.95,2023-09-04T05:48:00,Durango,expenses,cash,-100.0,-23060.9
buyer_8,Patxi,Urrutia,1979-04-04,44624658N,patxi.urrutia@megaapp.net,322320,ES17209589367889501335,1423.95,2023-09-05T23:33:48,Durango,expenses,mortgage,-2340.31,-25401.21
buyer_8,Patxi,Urrutia,1979-04-04,44624658N,patxi.urrutia@megaapp.net,322320,ES17209589367889501335,1423.95,2023-09-05T19:57:01,Durango,expenses,gas,-147.13,-25548.34
buyer_8,Patxi,Urrutia,1979-04-04,44624658N,patxi.urrutia@megaapp.net,322320,ES17209589367889501335,1423.95,2023-09-06T14:23:34,Durango,expenses,phone,-77.48,-25625.82
buyer_8,Patxi,Urrutia,1979-04-04,44624658N,patxi.urrutia@megaapp.net,322320,ES17209589367889501335,1423.95,2023-09-06T19:32:54,Durango,expenses,food,-118.37,-25744.19
buyer_8,Patxi,Urrutia,1979-04-04,44624658N,patxi.urrutia@megaapp.net,322320,ES17209589367889501335,1423.95,2023-09-06T11:19:04,Durango,expenses,transport,-78.96,-25823.15
buyer_8,Patxi,Urrutia,1979-04-04,44624658N,patxi.urrutia@megaapp.net,322320,ES17209589367889501335,1423.95,2023-09-07T13:39:42,Durango,expenses,food,-70.9,-25894.05
buyer_8,Patxi,Urrutia,1979-04-04,44624658N,patxi.urrutia@megaapp.net,322320,ES17209589367889501335,1423.95,2023-09-08T23:56:00,Durango,expenses,water,-46.18,-25940.23
buyer_8,Patxi,Urrutia,1979-04-04,44624658N,patxi.urrutia@megaapp.net,322320,ES17209589367889501335,1423.95,2023-09-08T06:17:35,Durango,expenses,electricity,-124.24,-26064.47
buyer_8,Patxi,Urrutia,1979-04-04,44624658N,patxi.urrutia@megaapp.net,322320,ES17209589367889501335,1423.95,2023-09-08T19:38:53,Durango,expenses,leisure,-25.55,-26090.02
buyer_8,Patxi,Urrutia,1979-04-04,44624658N,patxi.urrutia@megaapp.net,322320,ES17209589367889501335,1423.95,2023-09-08T09:26:02,Durango,expenses,clothing,-124.99,-26215.01
buyer_8,Patxi,Urrutia,1979-04-04,44624658N,patxi.urrutia@megaapp.net,322320,ES17209589367889501335,1423.95,2023-09-08T06:00:59,Durango,expenses,gifts,-141.06,-26356.07
buyer_8,Patxi,Urrutia,1979-04-04,44624658N,patxi.urrutia@megaapp.net,322320,ES17209589367889501335,1423.95,2023-09-09T12:43:45,Durango,expenses,food,-124.81,-26480.88
buyer_8,Patxi,Urrutia,1979-04-04,44624658N,patxi.urrutia@megaapp.net,322320,ES17209589367889501335,1423.95,2023-09-09T09:45:35,Durango,expenses,leisure,-62.27,-26543.15
buyer_8,Patxi,Urrutia,1979-04-04,44624658N,patxi.urrutia@megaapp.net,322320,ES17209589367889501335,1423.95,2023-09-10T11:35:49,Durango,expenses,leisure,-71.29,-26614.44
buyer_8,Patxi,Urrutia,1979-04-04,44624658N,patxi.urrutia@megaapp.net,322320,ES17209589367889501335,1423.95,2023-09-10T13:17:35,Durango,expenses,repairs,-232.29,-26846.73
buyer_8,Patxi,Urrutia,1979-04-04,44624658N,patxi.urrutia@megaapp.net,322320,ES17209589367889501335,1423.95,2023-09-12T10:38:30,Durango,expenses,cash,-100.0,-26946.73
buyer_8,Patxi,Urrutia,1979-04-04,44624658N,patxi.urrutia@megaapp.net,322320,ES17209589367889501335,1423.95,2023-09-14T18:25:51,Durango,expenses,gifts,-607.51,-27554.24
buyer_8,Patxi,Urrutia,1979-04-04,44624658N,patxi.urrutia@megaapp.net,322320,ES17209589367889501335,1423.95,2023-09-15T05:16:45,Durango,expenses,food,-62.0,-27616.24
buyer_8,Patxi,Urrutia,1979-04-04,44624658N,patxi.urrutia@megaapp.net,322320,ES17209589367889501335,1423.95,2023-09-16T17:31:55,Durango,expenses,transport,-57.87,-27674.11
buyer_8,Patxi,Urrutia,1979-04-04,44624658N,patxi.urrutia@megaapp.net,322320,ES17209589367889501335,1423.95,2023-09-16T09:41:48,Durango,expenses,gifts,-809.42,-28483.53
buyer_8,Patxi,Urrutia,1979-04-04,44624658N,patxi.urrutia@megaapp.net,322320,ES17209589367889501335,1423.95,2023-09-17T19:12:56,Durango,expenses,food,-96.12,-28579.65
buyer_8,Patxi,Urrutia,1979-04-04,44624658N,patxi.urrutia@megaapp.net,322320,ES17209589367889501335,1423.95,2023-09-17T14:08:28,Durango,expenses,gifts,-101.32,-28680.97
buyer_8,Patxi,Urrutia,1979-04-04,44624658N,patxi.urrutia@megaapp.net,322320,ES17209589367889501335,1423.95,2023-09-18T17:51:36,Durango,expenses,food,-75.6,-28756.57
buyer_8,Patxi,Urrutia,1979-04-04,44624658N,patxi.urrutia@megaapp.net,322320,ES17209589367889501335,1423.95,2023-09-20T13:26:02,Durango,expenses,leisure,-65.34,-28821.91
buyer_8,Patxi,Urrutia,1979-04-04,44624658N,patxi.urrutia@megaapp.net,322320,ES17209589367889501335,1423.95,2023-09-20T10:01:58,Durango,expenses,gifts,-527.95,-29349.86
buyer_8,Patxi,Urrutia,1979-04-04,44624658N,patxi.urrutia@megaapp.net,322320,ES17209589367889501335,1423.95,2023-09-22T04:43:02,Durango,expenses,leisure,-31.5,-29381.36
buyer_8,Patxi,Urrutia,1979-04-04,44624658N,patxi.urrutia@megaapp.net,322320,ES17209589367889501335,1423.95,2023-09-23T19:34:21,Durango,expenses,repairs,-313.19,-29694.55
buyer_8,Patxi,Urrutia,1979-04-04,44624658N,patxi.urrutia@megaapp.net,322320,ES17209589367889501335,1423.95,2023-09-25T12:02:03,Durango,expenses,cash,-100.0,-29794.55
buyer_8,Patxi,Urrutia,1979-04-04,44624658N,patxi.urrutia@megaapp.net,322320,ES17209589367889501335,1423.95,2023-09-26T10:26:47,Durango,expenses,cash,-100.0,-29894.55
buyer_8,Patxi,Urrutia,1979-04-04,44624658N,patxi.urrutia@megaapp.net,322320,ES17209589367889501335,1423.95,2023-09-27T08:22:36,Durango,expenses,leisure,-79.38,-29973.93
buyer_8,Patxi,Urrutia,1979-04-04,44624658N,patxi.urrutia@megaapp.net,322320,ES17209589367889501335,1423.95,2023-09-28T13:19:24,Durango,expenses,food,-60.02,-30033.95
buyer_8,Patxi,Urrutia,1979-04-04,44624658N,patxi.urrutia@megaapp.net,322320,ES17209589367889501335,1423.95,2023-09-28T13:30:26,Durango,expenses,transport,-48.15,-30082.1
buyer_8,Patxi,Urrutia,1979-04-04,44624658N,patxi.urrutia@megaapp.net,322320,ES17209589367889501335,1423.95,2023-09-29T15:40:56,Durango,expenses,repairs,-140.71,-30222.81
buyer_8,Patxi,Urrutia,1979-04-04,44624658N,patxi.urrutia@megaapp.net,322320,ES17209589367889501335,1423.95,2023-09-30T00:31:41,Durango,expenses,gifts,-577.61,-30800.42
buyer_8,Patxi,Urrutia,1979-04-04,44624658N,patxi.urrutia@megaapp.net,322320,ES17209589367889501335,1423.95,2023-10-01T19:47:43,Durango,incomes,salary,4151.68,-26648.74
buyer_8,Patxi,Urrutia,1979-04-04,44624658N,patxi.urrutia@megaapp.net,322320,ES17209589367889501335,1423.95,2023-10-01T19:47:43,Durango,incomes,extra_income,572.97,-26075.77
buyer_8,Patxi,Urrutia,1979-04-04,44624658N,patxi.urrutia@megaapp.net,322320,ES17209589367889501335,1423.95,2023-10-01T20:07:02,Durango,expenses,leisure,-76.29,-26152.06
buyer_8,Patxi,Urrutia,1979-04-04,44624658N,patxi.urrutia@megaapp.net,322320,ES17209589367889501335,1423.95,2023-10-05T19:08:41,Durango,expenses,mortgage,-2340.31,-28492.37
buyer_8,Patxi,Urrutia,1979-04-04,44624658N,patxi.urrutia@megaapp.net,322320,ES17209589367889501335,1423.95,2023-10-05T15:22:46,Durango,expenses,water,-101.57,-28593.94
buyer_8,Patxi,Urrutia,1979-04-04,44624658N,patxi.urrutia@megaapp.net,322320,ES17209589367889501335,1423.95,2023-10-05T10:23:45,Durango,expenses,gas,-141.22,-28735.16
buyer_8,Patxi,Urrutia,1979-04-04,44624658N,patxi.urrutia@megaapp.net,322320,ES17209589367889501335,1423.95,2023-10-05T19:05:47,Durango,expenses,internet,-95.9,-28831.06
buyer_8,Patxi,Urrutia,1979-04-04,44624658N,patxi.urrutia@megaapp.net,322320,ES17209589367889501335,1423.95,2023-10-05T11:37:40,Durango,expenses,transport,-82.14,-28913.2
buyer_8,Patxi,Urrutia,1979-04-04,44624658N,patxi.urrutia@megaapp.net,322320,ES17209589367889501335,1423.95,2023-10-05T09:10:13,Durango,expenses,clothing,-159.32,-29072.52
buyer_8,Patxi,Urrutia,1979-04-04,44624658N,patxi.urrutia@megaapp.net,322320,ES17209589367889501335,1423.95,2023-10-05T19:08:38,Durango,expenses,cash,-100.0,-29172.52
buyer_8,Patxi,Urrutia,1979-04-04,44624658N,patxi.urrutia@megaapp.net,322320,ES17209589367889501335,1423.95,2023-10-06T17:50:45,Durango,expenses,water,-77.1,-29249.62
buyer_8,Patxi,Urrutia,1979-04-04,44624658N,patxi.urrutia@megaapp.net,322320,ES17209589367889501335,1423.95,2023-10-06T11:21:18,Durango,expenses,education,-64.82,-29314.44
buyer_8,Patxi,Urrutia,1979-04-04,44624658N,patxi.urrutia@megaapp.net,322320,ES17209589367889501335,1423.95,2023-10-07T11:25:50,Durango,expenses,repairs,-313.42,-29627.86
buyer_8,Patxi,Urrutia,1979-04-04,44624658N,patxi.urrutia@megaapp.net,322320,ES17209589367889501335,1423.95,2023-10-08T11:36:30,Durango,expenses,phone,-85.31,-29713.17
buyer_8,Patxi,Urrutia,1979-04-04,44624658N,patxi.urrutia@megaapp.net,322320,ES17209589367889501335,1423.95,2023-10-08T16:01:43,Durango,expenses,cash,-100.0,-29813.17
buyer_8,Patxi,Urrutia,1979-04-04,44624658N,patxi.urrutia@megaapp.net,322320,ES17209589367889501335,1423.95,2023-10-10T10:45:18,Durango,expenses,food,-62.77,-29875.94
buyer_8,Patxi,Urrutia,1979-04-04,44624658N,patxi.urrutia@megaapp.net,322320,ES17209589367889501335,1423.95,2023-10-10T13:50:29,Durango,expenses,healthcare,-92.52,-29968.46
buyer_8,Patxi,Urrutia,1979-04-04,44624658N,patxi.urrutia@megaapp.net,322320,ES17209589367889501335,1423.95,2023-10-10T11:48:32,Durango,expenses,cash,-100.0,-30068.46
buyer_8,Patxi,Urrutia,1979-04-04,44624658N,patxi.urrutia@megaapp.net,322320,ES17209589367889501335,1423.95,2023-10-10T09:06:12,Durango,expenses,gifts,-572.2,-30640.66
buyer_8,Patxi,Urrutia,1979-04-04,44624658N,patxi.urrutia@megaapp.net,322320,ES17209589367889501335,1423.95,2023-10-11T08:00:04,Durango,expenses,leisure,-82.06,-30722.72
buyer_8,Patxi,Urrutia,1979-04-04,44624658N,patxi.urrutia@megaapp.net,322320,ES17209589367889501335,1423.95,2023-10-12T12:00:13,Durango,expenses,clothing,-92.18,-30814.9
buyer_8,Patxi,Urrutia,1979-04-04,44624658N,patxi.urrutia@megaapp.net,322320,ES17209589367889501335,1423.95,2023-10-12T20:08:54,Durango,expenses,education,-59.47,-30874.37
buyer_8,Patxi,Urrutia,1979-04-04,44624658N,patxi.urrutia@megaapp.net,322320,ES17209589367889501335,1423.95,2023-10-15T17:52:34,Durango,expenses,food,-103.19,-30977.56
buyer_8,Patxi,Urrutia,1979-04-04,44624658N,patxi.urrutia@megaapp.net,322320,ES17209589367889501335,1423.95,2023-10-15T11:50:20,Durango,expenses,cash,-100.0,-31077.56
buyer_8,Patxi,Urrutia,1979-04-04,44624658N,patxi.urrutia@megaapp.net,322320,ES17209589367889501335,1423.95,2023-10-19T17:45:58,Durango,expenses,cash,-100.0,-31177.56
buyer_8,Patxi,Urrutia,1979-04-04,44624658N,patxi.urrutia@megaapp.net,322320,ES17209589367889501335,1423.95,2023-10-21T18:07:08,Durango,expenses,food,-118.29,-31295.85
buyer_8,Patxi,Urrutia,1979-04-04,44624658N,patxi.urrutia@megaapp.net,322320,ES17209589367889501335,1423.95,2023-10-21T15:34:49,Durango,expenses,repairs,-49.32,-31345.17
buyer_8,Patxi,Urrutia,1979-04-04,44624658N,patxi.urrutia@megaapp.net,322320,ES17209589367889501335,1423.95,2023-10-25T16:10:20,Durango,expenses,repairs,-84.84,-31430.01
buyer_8,Patxi,Urrutia,1979-04-04,44624658N,patxi.urrutia@megaapp.net,322320,ES17209589367889501335,1423.95,2023-10-26T15:27:58,Durango,expenses,transport,-69.1,-31499.11
buyer_8,Patxi,Urrutia,1979-04-04,44624658N,patxi.urrutia@megaapp.net,322320,ES17209589367889501335,1423.95,2023-10-26T20:21:41,Durango,expenses,cash,-100.0,-31599.11
buyer_8,Patxi,Urrutia,1979-04-04,44624658N,patxi.urrutia@megaapp.net,322320,ES17209589367889501335,1423.95,2023-10-30T09:57:29,Durango,expenses,food,-124.36,-31723.47
buyer_8,Patxi,Urrutia,1979-04-04,44624658N,patxi.urrutia@megaapp.net,322320,ES17209589367889501335,1423.95,2023-10-31T11:25:46,Durango,expenses,cash,-100.0,-31823.47
buyer_8,Patxi,Urrutia,1979-04-04,44624658N,patxi.urrutia@megaapp.net,322320,ES17209589367889501335,1423.95,2023-11-01T17:52:16,Durango,incomes,salary,4151.68,-27671.79
buyer_8,Patxi,Urrutia,1979-04-04,44624658N,patxi.urrutia@megaapp.net,322320,ES17209589367889501335,1423.95,2023-11-04T09:53:29,Durango,expenses,leisure,-54.3,-27726.09
buyer_8,Patxi,Urrutia,1979-04-04,44624658N,patxi.urrutia@megaapp.net,322320,ES17209589367889501335,1423.95,2023-11-04T11:07:05,Durango,expenses,repairs,-234.62,-27960.71
buyer_8,Patxi,Urrutia,1979-04-04,44624658N,patxi.urrutia@megaapp.net,322320,ES17209589367889501335,1423.95,2023-11-05T11:17:22,Durango,expenses,mortgage,-2340.31,-30301.02
buyer_8,Patxi,Urrutia,1979-04-04,44624658N,patxi.urrutia@megaapp.net,322320,ES17209589367889501335,1423.95,2023-11-05T19:25:30,Durango,expenses,water,-66.0,-30367.02
buyer_8,Patxi,Urrutia,1979-04-04,44624658N,patxi.urrutia@megaapp.net,322320,ES17209589367889501335,1423.95,2023-11-06T18:10:19,Durango,expenses,electricity,-140.65,-30507.67
buyer_8,Patxi,Urrutia,1979-04-04,44624658N,patxi.urrutia@megaapp.net,322320,ES17209589367889501335,1423.95,2023-11-06T09:59:04,Durango,expenses,food,-90.13,-30597.8
buyer_8,Patxi,Urrutia,1979-04-04,44624658N,patxi.urrutia@megaapp.net,322320,ES17209589367889501335,1423.95,2023-11-06T16:16:07,Durango,expenses,clothing,-45.97,-30643.77
buyer_8,Patxi,Urrutia,1979-04-04,44624658N,patxi.urrutia@megaapp.net,322320,ES17209589367889501335,1423.95,2023-11-06T06:26:47,Durango,expenses,education,-50.92,-30694.69
buyer_8,Patxi,Urrutia,1979-04-04,44624658N,patxi.urrutia@megaapp.net,322320,ES17209589367889501335,1423.95,2023-11-06T08:48:28,Durango,expenses,repairs,-323.1,-31017.79
buyer_8,Patxi,Urrutia,1979-04-04,44624658N,patxi.urrutia@megaapp.net,322320,ES17209589367889501335,1423.95,2023-11-07T13:47:13,Durango,expenses,cash,-100.0,-31117.79
buyer_8,Patxi,Urrutia,1979-04-04,44624658N,patxi.urrutia@megaapp.net,322320,ES17209589367889501335,1423.95,2023-11-08T12:35:12,Durango,expenses,electricity,-70.98,-31188.77
buyer_8,Patxi,Urrutia,1979-04-04,44624658N,patxi.urrutia@megaapp.net,322320,ES17209589367889501335,1423.95,2023-11-09T23:37:32,Durango,expenses,leisure,-84.01,-31272.78
buyer_8,Patxi,Urrutia,1979-04-04,44624658N,patxi.urrutia@megaapp.net,322320,ES17209589367889501335,1423.95,2023-11-09T10:27:18,Durango,expenses,travel,-492.95,-31765.73
buyer_8,Patxi,Urrutia,1979-04-04,44624658N,patxi.urrutia@megaapp.net,322320,ES17209589367889501335,1423.95,2023-11-10T02:07:30,Durango,expenses,education,-56.51,-31822.24
buyer_8,Patxi,Urrutia,1979-04-04,44624658N,patxi.urrutia@megaapp.net,322320,ES17209589367889501335,1423.95,2023-11-10T18:19:34,Durango,expenses,travel,-735.53,-32557.77
buyer_8,Patxi,Urrutia,1979-04-04,44624658N,patxi.urrutia@megaapp.net,322320,ES17209589367889501335,1423.95,2023-11-11T20:52:07,Durango,expenses,education,-67.9,-32625.67
buyer_8,Patxi,Urrutia,1979-04-04,44624658N,patxi.urrutia@megaapp.net,322320,ES17209589367889501335,1423.95,2023-11-12T08:32:24,Durango,expenses,cash,-100.0,-32725.67
buyer_8,Patxi,Urrutia,1979-04-04,44624658N,patxi.urrutia@megaapp.net,322320,ES17209589367889501335,1423.95,2023-11-13T18:08:59,Durango,expenses,transport,-51.43,-32777.1
buyer_8,Patxi,Urrutia,1979-04-04,44624658N,patxi.urrutia@megaapp.net,322320,ES17209589367889501335,1423.95,2023-11-13T18:59:46,Durango,expenses,leisure,-80.4,-32857.5
buyer_8,Patxi,Urrutia,1979-04-04,44624658N,patxi.urrutia@megaapp.net,322320,ES17209589367889501335,1423.95,2023-11-16T09:28:20,Durango,expenses,leisure,-70.17,-32927.67
buyer_8,Patxi,Urrutia,1979-04-04,44624658N,patxi.urrutia@megaapp.net,322320,ES17209589367889501335,1423.95,2023-11-16T13:35:23,Durango,expenses,gifts,-58.63,-32986.3
buyer_8,Patxi,Urrutia,1979-04-04,44624658N,patxi.urrutia@megaapp.net,322320,ES17209589367889501335,1423.95,2023-11-17T15:56:58,Durango,expenses,cash,-100.0,-33086.3
buyer_8,Patxi,Urrutia,1979-04-04,44624658N,patxi.urrutia@megaapp.net,322320,ES17209589367889501335,1423.95,2023-11-19T18:27:53,Durango,expenses,repairs,-134.72,-33221.02
buyer_8,Patxi,Urrutia,1979-04-04,44624658N,patxi.urrutia@megaapp.net,322320,ES17209589367889501335,1423.95,2023-11-27T09:58:49,Durango,expenses,leisure,-70.31,-33291.33
buyer_8,Patxi,Urrutia,1979-04-04,44624658N,patxi.urrutia@megaapp.net,322320,ES17209589367889501335,1423.95,2023-11-27T16:12:38,Durango,expenses,clothing,-148.69,-33440.02
buyer_8,Patxi,Urrutia,1979-04-04,44624658N,patxi.urrutia@megaapp.net,322320,ES17209589367889501335,1423.95,2023-11-29T08:26:03,Durango,expenses,clothing,-125.68,-33565.7
buyer_8,Patxi,Urrutia,1979-04-04,44624658N,patxi.urrutia@megaapp.net,322320,ES17209589367889501335,1423.95,2023-12-01T14:04:18,Durango,incomes,salary,4151.68,-29414.02
buyer_8,Patxi,Urrutia,1979-04-04,44624658N,patxi.urrutia@megaapp.net,322320,ES17209589367889501335,1423.95,2023-12-01T14:04:18,Durango,incomes,salary_bonus,3120.19,-26293.83
buyer_8,Patxi,Urrutia,1979-04-04,44624658N,patxi.urrutia@megaapp.net,322320,ES17209589367889501335,1423.95,2023-12-02T01:18:12,Durango,expenses,appliances,-104.76,-26398.59
buyer_8,Patxi,Urrutia,1979-04-04,44624658N,patxi.urrutia@megaapp.net,322320,ES17209589367889501335,1423.95,2023-12-05T14:10:24,Durango,expenses,mortgage,-2340.31,-28738.9
buyer_8,Patxi,Urrutia,1979-04-04,44624658N,patxi.urrutia@megaapp.net,322320,ES17209589367889501335,1423.95,2023-12-05T17:08:06,Durango,expenses,water,-77.94,-28816.84
buyer_8,Patxi,Urrutia,1979-04-04,44624658N,patxi.urrutia@megaapp.net,322320,ES17209589367889501335,1423.95,2023-12-05T20:44:15,Durango,expenses,phone,-74.33,-28891.17
buyer_8,Patxi,Urrutia,1979-04-04,44624658N,patxi.urrutia@megaapp.net,322320,ES17209589367889501335,1423.95,2023-12-05T14:43:13,Durango,expenses,leisure,-77.19,-28968.36
buyer_8,Patxi,Urrutia,1979-04-04,44624658N,patxi.urrutia@megaapp.net,322320,ES17209589367889501335,1423.95,2023-12-06T15:00:06,Durango,expenses,internet,-95.9,-29064.26
buyer_8,Patxi,Urrutia,1979-04-04,44624658N,patxi.urrutia@megaapp.net,322320,ES17209589367889501335,1423.95,2023-12-06T10:00:36,Durango,expenses,phone,-87.94,-29152.2
buyer_8,Patxi,Urrutia,1979-04-04,44624658N,patxi.urrutia@megaapp.net,322320,ES17209589367889501335,1423.95,2023-12-07T09:45:29,Durango,expenses,electricity,-191.06,-29343.26
buyer_8,Patxi,Urrutia,1979-04-04,44624658N,patxi.urrutia@megaapp.net,322320,ES17209589367889501335,1423.95,2023-12-07T15:41:09,Durango,expenses,gas,-197.58,-29540.84
buyer_8,Patxi,Urrutia,1979-04-04,44624658N,patxi.urrutia@megaapp.net,322320,ES17209589367889501335,1423.95,2023-12-07T19:12:28,Durango,expenses,cash,-100.0,-29640.84
buyer_8,Patxi,Urrutia,1979-04-04,44624658N,patxi.urrutia@megaapp.net,322320,ES17209589367889501335,1423.95,2023-12-08T11:07:33,Durango,expenses,phone,-69.84,-29710.68
buyer_8,Patxi,Urrutia,1979-04-04,44624658N,patxi.urrutia@megaapp.net,322320,ES17209589367889501335,1423.95,2023-12-08T10:26:49,Durango,expenses,transport,-66.45,-29777.13
buyer_8,Patxi,Urrutia,1979-04-04,44624658N,patxi.urrutia@megaapp.net,322320,ES17209589367889501335,1423.95,2023-12-09T23:31:30,Durango,expenses,food,-60.63,-29837.76
buyer_8,Patxi,Urrutia,1979-04-04,44624658N,patxi.urrutia@megaapp.net,322320,ES17209589367889501335,1423.95,2023-12-09T18:22:28,Durango,expenses,leisure,-69.22,-29906.98
buyer_8,Patxi,Urrutia,1979-04-04,44624658N,patxi.urrutia@megaapp.net,322320,ES17209589367889501335,1423.95,2023-12-10T22:21:05,Durango,expenses,food,-73.39,-29980.37
buyer_8,Patxi,Urrutia,1979-04-04,44624658N,patxi.urrutia@megaapp.net,322320,ES17209589367889501335,1423.95,2023-12-11T14:12:42,Durango,expenses,food,-103.69,-30084.06
buyer_8,Patxi,Urrutia,1979-04-04,44624658N,patxi.urrutia@megaapp.net,322320,ES17209589367889501335,1423.95,2023-12-12T09:14:12,Durango,expenses,leisure,-31.01,-30115.07
buyer_8,Patxi,Urrutia,1979-04-04,44624658N,patxi.urrutia@megaapp.net,322320,ES17209589367889501335,1423.95,2023-12-13T08:14:19,Durango,expenses,food,-87.8,-30202.87
buyer_8,Patxi,Urrutia,1979-04-04,44624658N,patxi.urrutia@megaapp.net,322320,ES17209589367889501335,1423.95,2023-12-14T09:48:10,Durango,expenses,cash,-100.0,-30302.87
buyer_8,Patxi,Urrutia,1979-04-04,44624658N,patxi.urrutia@megaapp.net,322320,ES17209589367889501335,1423.95,2023-12-15T17:34:52,Durango,expenses,healthcare,-150.65,-30453.52
buyer_8,Patxi,Urrutia,1979-04-04,44624658N,patxi.urrutia@megaapp.net,322320,ES17209589367889501335,1423.95,2023-12-15T05:24:18,Durango,expenses,cash,-100.0,-30553.52
buyer_8,Patxi,Urrutia,1979-04-04,44624658N,patxi.urrutia@megaapp.net,322320,ES17209589367889501335,1423.95,2023-12-21T18:23:36,Durango,expenses,cash,-100.0,-30653.52
buyer_8,Patxi,Urrutia,1979-04-04,44624658N,patxi.urrutia@megaapp.net,322320,ES17209589367889501335,1423.95,2023-12-22T17:38:21,Durango,expenses,leisure,-77.0,-30730.52
buyer_8,Patxi,Urrutia,1979-04-04,44624658N,patxi.urrutia@megaapp.net,322320,ES17209589367889501335,1423.95,2023-12-23T09:36:14,Durango,expenses,healthcare,-81.73,-30812.25
buyer_8,Patxi,Urrutia,1979-04-04,44624658N,patxi.urrutia@megaapp.net,322320,ES17209589367889501335,1423.95,2023-12-23T12:26:49,Durango,expenses,education,-56.36,-30868.61
buyer_8,Patxi,Urrutia,1979-04-04,44624658N,patxi.urrutia@megaapp.net,322320,ES17209589367889501335,1423.95,2023-12-25T10:52:37,Durango,expenses,leisure,-51.82,-30920.43
buyer_8,Patxi,Urrutia,1979-04-04,44624658N,patxi.urrutia@megaapp.net,322320,ES17209589367889501335,1423.95,2023-12-26T23:59:43,Durango,expenses,repairs,-113.7,-31034.13
buyer_8,Patxi,Urrutia,1979-04-04,44624658N,patxi.urrutia@megaapp.net,322320,ES17209589367889501335,1423.95,2023-12-27T12:15:35,Durango,expenses,repairs,-284.5,-31318.63
buyer_8,Patxi,Urrutia,1979-04-04,44624658N,patxi.urrutia@megaapp.net,322320,ES17209589367889501335,1423.95,2023-12-28T16:23:16,Durango,expenses,gifts,-296.73,-31615.36
buyer_8,Patxi,Urrutia,1979-04-04,44624658N,patxi.urrutia@megaapp.net,322320,ES17209589367889501335,1423.95,2024-01-01T09:00:28,Durango,incomes,salary,4283.75,-27331.61
buyer_8,Patxi,Urrutia,1979-04-04,44624658N,patxi.urrutia@megaapp.net,322320,ES17209589367889501335,1423.95,2024-01-01T15:22:51,Durango,expenses,food,-117.98,-27449.59
buyer_8,Patxi,Urrutia,1979-04-04,44624658N,patxi.urrutia@megaapp.net,322320,ES17209589367889501335,1423.95,2024-01-01T13:48:39,Durango,expenses,clothing,-116.88,-27566.47
buyer_8,Patxi,Urrutia,1979-04-04,44624658N,patxi.urrutia@megaapp.net,322320,ES17209589367889501335,1423.95,2024-01-03T13:53:23,Durango,expenses,leisure,-83.57,-27650.04
buyer_8,Patxi,Urrutia,1979-04-04,44624658N,patxi.urrutia@megaapp.net,322320,ES17209589367889501335,1423.95,2024-01-04T08:29:24,Durango,expenses,cash,-100.0,-27750.04
buyer_8,Patxi,Urrutia,1979-04-04,44624658N,patxi.urrutia@megaapp.net,322320,ES17209589367889501335,1423.95,2024-01-05T13:47:05,Durango,expenses,mortgage,-2368.29,-30118.33
buyer_8,Patxi,Urrutia,1979-04-04,44624658N,patxi.urrutia@megaapp.net,322320,ES17209589367889501335,1423.95,2024-01-05T18:42:38,Durango,expenses,phone,-71.34,-30189.67
buyer_8,Patxi,Urrutia,1979-04-04,44624658N,patxi.urrutia@megaapp.net,322320,ES17209589367889501335,1423.95,2024-01-06T21:55:27,Durango,expenses,water,-79.98,-30269.65
buyer_8,Patxi,Urrutia,1979-04-04,44624658N,patxi.urrutia@megaapp.net,322320,ES17209589367889501335,1423.95,2024-01-06T22:39:55,Durango,expenses,gas,-231.24,-30500.89
buyer_8,Patxi,Urrutia,1979-04-04,44624658N,patxi.urrutia@megaapp.net,322320,ES17209589367889501335,1423.95,2024-01-06T19:42:28,Durango,expenses,phone,-104.87,-30605.76
buyer_8,Patxi,Urrutia,1979-04-04,44624658N,patxi.urrutia@megaapp.net,322320,ES17209589367889501335,1423.95,2024-01-07T16:02:19,Durango,expenses,water,-96.07,-30701.83
buyer_8,Patxi,Urrutia,1979-04-04,44624658N,patxi.urrutia@megaapp.net,322320,ES17209589367889501335,1423.95,2024-01-08T00:00:33,Durango,expenses,gas,-135.68,-30837.51
buyer_8,Patxi,Urrutia,1979-04-04,44624658N,patxi.urrutia@megaapp.net,322320,ES17209589367889501335,1423.95,2024-01-08T18:19:48,Durango,expenses,transport,-69.5,-30907.01
buyer_8,Patxi,Urrutia,1979-04-04,44624658N,patxi.urrutia@megaapp.net,322320,ES17209589367889501335,1423.95,2024-01-09T03:30:46,Durango,expenses,food,-104.86,-31011.87
buyer_8,Patxi,Urrutia,1979-04-04,44624658N,patxi.urrutia@megaapp.net,322320,ES17209589367889501335,1423.95,2024-01-10T15:28:26,Durango,expenses,leisure,-40.01,-31051.88
buyer_8,Patxi,Urrutia,1979-04-04,44624658N,patxi.urrutia@megaapp.net,322320,ES17209589367889501335,1423.95,2024-01-11T08:04:06,Durango,expenses,cash,-100.0,-31151.88
buyer_8,Patxi,Urrutia,1979-04-04,44624658N,patxi.urrutia@megaapp.net,322320,ES17209589367889501335,1423.95,2024-01-11T18:16:12,Durango,expenses,car,-834.08,-31985.96
buyer_8,Patxi,Urrutia,1979-04-04,44624658N,patxi.urrutia@megaapp.net,322320,ES17209589367889501335,1423.95,2024-01-13T11:13:37,Durango,expenses,clothing,-92.04,-32078.0
buyer_8,Patxi,Urrutia,1979-04-04,44624658N,patxi.urrutia@megaapp.net,322320,ES17209589367889501335,1423.95,2024-01-13T06:34:14,Durango,expenses,cash,-100.0,-32178.0
buyer_8,Patxi,Urrutia,1979-04-04,44624658N,patxi.urrutia@megaapp.net,322320,ES17209589367889501335,1423.95,2024-01-13T15:10:12,Durango,expenses,repairs,-143.9,-32321.9
buyer_8,Patxi,Urrutia,1979-04-04,44624658N,patxi.urrutia@megaapp.net,322320,ES17209589367889501335,1423.95,2024-01-15T14:09:59,Durango,expenses,clothing,-114.34,-32436.24
buyer_8,Patxi,Urrutia,1979-04-04,44624658N,patxi.urrutia@megaapp.net,322320,ES17209589367889501335,1423.95,2024-01-17T13:00:57,Durango,expenses,education,-53.21,-32489.45
buyer_8,Patxi,Urrutia,1979-04-04,44624658N,patxi.urrutia@megaapp.net,322320,ES17209589367889501335,1423.95,2024-01-17T11:11:40,Durango,expenses,cash,-100.0,-32589.45
buyer_8,Patxi,Urrutia,1979-04-04,44624658N,patxi.urrutia@megaapp.net,322320,ES17209589367889501335,1423.95,2024-01-19T16:11:27,Durango,expenses,leisure,-77.28,-32666.73
buyer_8,Patxi,Urrutia,1979-04-04,44624658N,patxi.urrutia@megaapp.net,322320,ES17209589367889501335,1423.95,2024-01-19T10:30:24,Durango,expenses,gifts,-81.32,-32748.05
buyer_8,Patxi,Urrutia,1979-04-04,44624658N,patxi.urrutia@megaapp.net,322320,ES17209589367889501335,1423.95,2024-01-20T17:48:28,Durango,expenses,cash,-100.0,-32848.05
buyer_8,Patxi,Urrutia,1979-04-04,44624658N,patxi.urrutia@megaapp.net,322320,ES17209589367889501335,1423.95,2024-01-21T11:11:25,Durango,expenses,food,-120.55,-32968.6
buyer_8,Patxi,Urrutia,1979-04-04,44624658N,patxi.urrutia@megaapp.net,322320,ES17209589367889501335,1423.95,2024-01-22T13:56:12,Durango,expenses,appliances,-161.97,-33130.57
buyer_8,Patxi,Urrutia,1979-04-04,44624658N,patxi.urrutia@megaapp.net,322320,ES17209589367889501335,1423.95,2024-01-23T19:05:58,Durango,expenses,clothing,-79.52,-33210.09
buyer_8,Patxi,Urrutia,1979-04-04,44624658N,patxi.urrutia@megaapp.net,322320,ES17209589367889501335,1423.95,2024-01-23T18:33:44,Durango,expenses,appliances,-149.31,-33359.4
buyer_8,Patxi,Urrutia,1979-04-04,44624658N,patxi.urrutia@megaapp.net,322320,ES17209589367889501335,1423.95,2024-01-26T11:22:39,Durango,expenses,food,-119.02,-33478.42
buyer_8,Patxi,Urrutia,1979-04-04,44624658N,patxi.urrutia@megaapp.net,322320,ES17209589367889501335,1423.95,2024-01-27T19:08:17,Durango,expenses,food,-65.87,-33544.29
buyer_8,Patxi,Urrutia,1979-04-04,44624658N,patxi.urrutia@megaapp.net,322320,ES17209589367889501335,1423.95,2024-01-28T17:49:10,Durango,expenses,transport,-56.1,-33600.39
buyer_8,Patxi,Urrutia,1979-04-04,44624658N,patxi.urrutia@megaapp.net,322320,ES17209589367889501335,1423.95,2024-01-28T23:09:53,Durango,expenses,cash,-100.0,-33700.39
buyer_8,Patxi,Urrutia,1979-04-04,44624658N,patxi.urrutia@megaapp.net,322320,ES17209589367889501335,1423.95,2024-01-28T08:19:33,Durango,expenses,gifts,-87.15,-33787.54
buyer_8,Patxi,Urrutia,1979-04-04,44624658N,patxi.urrutia@megaapp.net,322320,ES17209589367889501335,1423.95,2024-01-29T20:54:50,Durango,expenses,transport,-52.85,-33840.39
buyer_8,Patxi,Urrutia,1979-04-04,44624658N,patxi.urrutia@megaapp.net,322320,ES17209589367889501335,1423.95,2024-01-30T20:30:21,Durango,expenses,repairs,-321.96,-34162.35
buyer_8,Patxi,Urrutia,1979-04-04,44624658N,patxi.urrutia@megaapp.net,322320,ES17209589367889501335,1423.95,2024-02-01T15:43:15,Durango,incomes,salary,4283.75,-29878.6
buyer_8,Patxi,Urrutia,1979-04-04,44624658N,patxi.urrutia@megaapp.net,322320,ES17209589367889501335,1423.95,2024-02-01T15:43:15,Durango,incomes,extra_income,572.97,-29305.63
buyer_8,Patxi,Urrutia,1979-04-04,44624658N,patxi.urrutia@megaapp.net,322320,ES17209589367889501335,1423.95,2024-02-01T17:11:32,Durango,expenses,repairs,-58.48,-29364.11
buyer_8,Patxi,Urrutia,1979-04-04,44624658N,patxi.urrutia@megaapp.net,322320,ES17209589367889501335,1423.95,2024-02-05T13:15:13,Durango,expenses,mortgage,-2368.29,-31732.4
buyer_8,Patxi,Urrutia,1979-04-04,44624658N,patxi.urrutia@megaapp.net,322320,ES17209589367889501335,1423.95,2024-02-05T13:02:47,Durango,expenses,water,-55.82,-31788.22
buyer_8,Patxi,Urrutia,1979-04-04,44624658N,patxi.urrutia@megaapp.net,322320,ES17209589367889501335,1423.95,2024-02-05T17:59:30,Durango,expenses,gas,-235.01,-32023.23
buyer_8,Patxi,Urrutia,1979-04-04,44624658N,patxi.urrutia@megaapp.net,322320,ES17209589367889501335,1423.95,2024-02-05T16:59:04,Durango,expenses,transport,-43.85,-32067.08
buyer_8,Patxi,Urrutia,1979-04-04,44624658N,patxi.urrutia@megaapp.net,322320,ES17209589367889501335,1423.95,2024-02-05T18:59:23,Durango,expenses,gifts,-570.99,-32638.07
buyer_8,Patxi,Urrutia,1979-04-04,44624658N,patxi.urrutia@megaapp.net,322320,ES17209589367889501335,1423.95,2024-02-06T10:26:20,Durango,expenses,water,-90.58,-32728.65
buyer_8,Patxi,Urrutia,1979-04-04,44624658N,patxi.urrutia@megaapp.net,322320,ES17209589367889501335,1423.95,2024-02-06T11:06:28,Durango,expenses,cash,-100.0,-32828.65
buyer_8,Patxi,Urrutia,1979-04-04,44624658N,patxi.urrutia@megaapp.net,322320,ES17209589367889501335,1423.95,2024-02-07T03:04:46,Durango,expenses,healthcare,-126.83,-32955.48
buyer_8,Patxi,Urrutia,1979-04-04,44624658N,patxi.urrutia@megaapp.net,322320,ES17209589367889501335,1423.95,2024-02-08T11:10:39,Durango,expenses,water,-59.83,-33015.31
buyer_8,Patxi,Urrutia,1979-04-04,44624658N,patxi.urrutia@megaapp.net,322320,ES17209589367889501335,1423.95,2024-02-09T09:35:11,Durango,expenses,clothing,-67.97,-33083.28
buyer_8,Patxi,Urrutia,1979-04-04,44624658N,patxi.urrutia@megaapp.net,322320,ES17209589367889501335,1423.95,2024-02-09T15:39:57,Durango,expenses,cash,-100.0,-33183.28
buyer_8,Patxi,Urrutia,1979-04-04,44624658N,patxi.urrutia@megaapp.net,322320,ES17209589367889501335,1423.95,2024-02-10T10:00:36,Durango,expenses,education,-46.05,-33229.33
buyer_8,Patxi,Urrutia,1979-04-04,44624658N,patxi.urrutia@megaapp.net,322320,ES17209589367889501335,1423.95,2024-02-12T22:49:01,Durango,expenses,food,-85.15,-33314.48
buyer_8,Patxi,Urrutia,1979-04-04,44624658N,patxi.urrutia@megaapp.net,322320,ES17209589367889501335,1423.95,2024-02-12T08:54:22,Durango,expenses,leisure,-80.12,-33394.6
buyer_8,Patxi,Urrutia,1979-04-04,44624658N,patxi.urrutia@megaapp.net,322320,ES17209589367889501335,1423.95,2024-02-14T09:37:21,Durango,expenses,cash,-100.0,-33494.6
buyer_8,Patxi,Urrutia,1979-04-04,44624658N,patxi.urrutia@megaapp.net,322320,ES17209589367889501335,1423.95,2024-02-15T17:13:38,Durango,expenses,cash,-100.0,-33594.6
buyer_8,Patxi,Urrutia,1979-04-04,44624658N,patxi.urrutia@megaapp.net,322320,ES17209589367889501335,1423.95,2024-02-17T12:01:24,Durango,expenses,food,-116.88,-33711.48
buyer_8,Patxi,Urrutia,1979-04-04,44624658N,patxi.urrutia@megaapp.net,322320,ES17209589367889501335,1423.95,2024-02-17T14:54:44,Durango,expenses,leisure,-55.81,-33767.29
buyer_8,Patxi,Urrutia,1979-04-04,44624658N,patxi.urrutia@megaapp.net,322320,ES17209589367889501335,1423.95,2024-02-21T23:49:13,Durango,expenses,food,-67.31,-33834.6
buyer_8,Patxi,Urrutia,1979-04-04,44624658N,patxi.urrutia@megaapp.net,322320,ES17209589367889501335,1423.95,2024-02-25T11:38:57,Durango,expenses,food,-92.57,-33927.17
buyer_8,Patxi,Urrutia,1979-04-04,44624658N,patxi.urrutia@megaapp.net,322320,ES17209589367889501335,1423.95,2024-02-26T22:43:07,Durango,expenses,leisure,-25.36,-33952.53
buyer_8,Patxi,Urrutia,1979-04-04,44624658N,patxi.urrutia@megaapp.net,322320,ES17209589367889501335,1423.95,2024-02-27T19:17:12,Durango,expenses,leisure,-54.19,-34006.72
buyer_8,Patxi,Urrutia,1979-04-04,44624658N,patxi.urrutia@megaapp.net,322320,ES17209589367889501335,1423.95,2024-02-28T12:12:26,Durango,expenses,food,-112.12,-34118.84
buyer_8,Patxi,Urrutia,1979-04-04,44624658N,patxi.urrutia@megaapp.net,322320,ES17209589367889501335,1423.95,2024-02-29T23:10:04,Durango,expenses,leisure,-62.52,-34181.36
buyer_8,Patxi,Urrutia,1979-04-04,44624658N,patxi.urrutia@megaapp.net,322320,ES17209589367889501335,1423.95,2024-03-01T14:05:56,Durango,incomes,salary,4283.75,-29897.61
buyer_8,Patxi,Urrutia,1979-04-04,44624658N,patxi.urrutia@megaapp.net,322320,ES17209589367889501335,1423.95,2024-03-03T19:46:03,Durango,expenses,clothing,-96.6,-29994.21
buyer_8,Patxi,Urrutia,1979-04-04,44624658N,patxi.urrutia@megaapp.net,322320,ES17209589367889501335,1423.95,2024-03-04T18:28:52,Durango,expenses,transport,-45.64,-30039.85
buyer_8,Patxi,Urrutia,1979-04-04,44624658N,patxi.urrutia@megaapp.net,322320,ES17209589367889501335,1423.95,2024-03-05T19:27:11,Durango,expenses,mortgage,-2368.29,-32408.14
buyer_8,Patxi,Urrutia,1979-04-04,44624658N,patxi.urrutia@megaapp.net,322320,ES17209589367889501335,1423.95,2024-03-05T17:41:06,Durango,expenses,internet,-98.95,-32507.09
buyer_8,Patxi,Urrutia,1979-04-04,44624658N,patxi.urrutia@megaapp.net,322320,ES17209589367889501335,1423.95,2024-03-05T14:32:10,Durango,expenses,clothing,-58.14,-32565.23
buyer_8,Patxi,Urrutia,1979-04-04,44624658N,patxi.urrutia@megaapp.net,322320,ES17209589367889501335,1423.95,2024-03-06T11:44:16,Durango,expenses,food,-115.01,-32680.24
buyer_8,Patxi,Urrutia,1979-04-04,44624658N,patxi.urrutia@megaapp.net,322320,ES17209589367889501335,1423.95,2024-03-06T10:51:38,Durango,expenses,cash,-100.0,-32780.24
buyer_8,Patxi,Urrutia,1979-04-04,44624658N,patxi.urrutia@megaapp.net,322320,ES17209589367889501335,1423.95,2024-03-06T09:57:52,Durango,expenses,repairs,-70.45,-32850.69
buyer_8,Patxi,Urrutia,1979-04-04,44624658N,patxi.urrutia@megaapp.net,322320,ES17209589367889501335,1423.95,2024-03-07T16:58:48,Durango,expenses,food,-93.54,-32944.23
buyer_8,Patxi,Urrutia,1979-04-04,44624658N,patxi.urrutia@megaapp.net,322320,ES17209589367889501335,1423.95,2024-03-08T10:14:31,Durango,expenses,phone,-71.53,-33015.76
buyer_8,Patxi,Urrutia,1979-04-04,44624658N,patxi.urrutia@megaapp.net,322320,ES17209589367889501335,1423.95,2024-03-10T13:36:39,Durango,expenses,cash,-100.0,-33115.76
buyer_8,Patxi,Urrutia,1979-04-04,44624658N,patxi.urrutia@megaapp.net,322320,ES17209589367889501335,1423.95,2024-03-11T14:12:33,Durango,expenses,leisure,-18.91,-33134.67
buyer_8,Patxi,Urrutia,1979-04-04,44624658N,patxi.urrutia@megaapp.net,322320,ES17209589367889501335,1423.95,2024-03-13T08:00:20,Durango,expenses,food,-95.62,-33230.29
buyer_8,Patxi,Urrutia,1979-04-04,44624658N,patxi.urrutia@megaapp.net,322320,ES17209589367889501335,1423.95,2024-03-13T13:01:54,Durango,expenses,leisure,-70.42,-33300.71
buyer_8,Patxi,Urrutia,1979-04-04,44624658N,patxi.urrutia@megaapp.net,322320,ES17209589367889501335,1423.95,2024-03-13T12:50:53,Durango,expenses,cash,-100.0,-33400.71
buyer_8,Patxi,Urrutia,1979-04-04,44624658N,patxi.urrutia@megaapp.net,322320,ES17209589367889501335,1423.95,2024-03-18T09:16:52,Durango,expenses,repairs,-199.2,-33599.91
buyer_8,Patxi,Urrutia,1979-04-04,44624658N,patxi.urrutia@megaapp.net,322320,ES17209589367889501335,1423.95,2024-03-19T20:54:23,Durango,expenses,cash,-100.0,-33699.91
buyer_8,Patxi,Urrutia,1979-04-04,44624658N,patxi.urrutia@megaapp.net,322320,ES17209589367889501335,1423.95,2024-03-20T09:09:53,Durango,expenses,cash,-100.0,-33799.91
buyer_8,Patxi,Urrutia,1979-04-04,44624658N,patxi.urrutia@megaapp.net,322320,ES17209589367889501335,1423.95,2024-03-23T18:02:47,Durango,expenses,cash,-100.0,-33899.91
buyer_8,Patxi,Urrutia,1979-04-04,44624658N,patxi.urrutia@megaapp.net,322320,ES17209589367889501335,1423.95,2024-03-25T16:38:16,Durango,expenses,food,-101.75,-34001.66
buyer_8,Patxi,Urrutia,1979-04-04,44624658N,patxi.urrutia@megaapp.net,322320,ES17209589367889501335,1423.95,2024-03-27T11:06:28,Durango,expenses,leisure,-82.14,-34083.8
buyer_8,Patxi,Urrutia,1979-04-04,44624658N,patxi.urrutia@megaapp.net,322320,ES17209589367889501335,1423.95,2024-03-27T15:47:26,Durango,expenses,clothing,-104.12,-34187.92
buyer_8,Patxi,Urrutia,1979-04-04,44624658N,patxi.urrutia@megaapp.net,322320,ES17209589367889501335,1423.95,2024-03-28T07:43:38,Durango,expenses,transport,-49.16,-34237.08
buyer_8,Patxi,Urrutia,1979-04-04,44624658N,patxi.urrutia@megaapp.net,322320,ES17209589367889501335,1423.95,2024-03-29T05:50:41,Durango,expenses,leisure,-60.38,-34297.46
buyer_8,Patxi,Urrutia,1979-04-04,44624658N,patxi.urrutia@megaapp.net,322320,ES17209589367889501335,1423.95,2024-03-30T10:07:46,Durango,expenses,education,-74.32,-34371.78
buyer_8,Patxi,Urrutia,1979-04-04,44624658N,patxi.urrutia@megaapp.net,322320,ES17209589367889501335,1423.95,2024-03-31T13:22:02,Durango,expenses,food,-95.52,-34467.3
buyer_8,Patxi,Urrutia,1979-04-04,44624658N,patxi.urrutia@megaapp.net,322320,ES17209589367889501335,1423.95,2024-04-01T19:18:11,Durango,incomes,salary,4283.75,-30183.55
buyer_8,Patxi,Urrutia,1979-04-04,44624658N,patxi.urrutia@megaapp.net,322320,ES17209589367889501335,1423.95,2024-04-01T18:01:24,Durango,expenses,leisure,-81.27,-30264.82
buyer_8,Patxi,Urrutia,1979-04-04,44624658N,patxi.urrutia@megaapp.net,322320,ES17209589367889501335,1423.95,2024-04-01T09:38:14,Durango,expenses,cash,-100.0,-30364.82
buyer_8,Patxi,Urrutia,1979-04-04,44624658N,patxi.urrutia@megaapp.net,322320,ES17209589367889501335,1423.95,2024-04-01T10:57:45,Durango,expenses,appliances,-186.79,-30551.61
buyer_8,Patxi,Urrutia,1979-04-04,44624658N,patxi.urrutia@megaapp.net,322320,ES17209589367889501335,1423.95,2024-04-02T20:57:42,Durango,expenses,cash,-100.0,-30651.61
buyer_8,Patxi,Urrutia,1979-04-04,44624658N,patxi.urrutia@megaapp.net,322320,ES17209589367889501335,1423.95,2024-04-03T04:37:25,Durango,expenses,education,-54.65,-30706.26
buyer_8,Patxi,Urrutia,1979-04-04,44624658N,patxi.urrutia@megaapp.net,322320,ES17209589367889501335,1423.95,2024-04-05T14:58:31,Durango,expenses,mortgage,-2368.29,-33074.55
buyer_8,Patxi,Urrutia,1979-04-04,44624658N,patxi.urrutia@megaapp.net,322320,ES17209589367889501335,1423.95,2024-04-05T09:00:11,Durango,expenses,electricity,-158.4,-33232.95
buyer_8,Patxi,Urrutia,1979-04-04,44624658N,patxi.urrutia@megaapp.net,322320,ES17209589367889501335,1423.95,2024-04-05T20:00:27,Durango,expenses,internet,-98.95,-33331.9
buyer_8,Patxi,Urrutia,1979-04-04,44624658N,patxi.urrutia@megaapp.net,322320,ES17209589367889501335,1423.95,2024-04-06T09:10:53,Durango,expenses,phone,-105.93,-33437.83
buyer_8,Patxi,Urrutia,1979-04-04,44624658N,patxi.urrutia@megaapp.net,322320,ES17209589367889501335,1423.95,2024-04-06T03:39:11,Durango,expenses,appliances,-264.06,-33701.89
buyer_8,Patxi,Urrutia,1979-04-04,44624658N,patxi.urrutia@megaapp.net,322320,ES17209589367889501335,1423.95,2024-04-08T12:32:03,Durango,expenses,internet,-98.95,-33800.84
buyer_8,Patxi,Urrutia,1979-04-04,44624658N,patxi.urrutia@megaapp.net,322320,ES17209589367889501335,1423.95,2024-04-08T20:31:12,Durango,expenses,phone,-95.5,-33896.34
buyer_8,Patxi,Urrutia,1979-04-04,44624658N,patxi.urrutia@megaapp.net,322320,ES17209589367889501335,1423.95,2024-04-09T22:55:44,Durango,expenses,repairs,-147.92,-34044.26
buyer_8,Patxi,Urrutia,1979-04-04,44624658N,patxi.urrutia@megaapp.net,322320,ES17209589367889501335,1423.95,2024-04-10T15:31:17,Durango,expenses,clothing,-121.15,-34165.41
buyer_8,Patxi,Urrutia,1979-04-04,44624658N,patxi.urrutia@megaapp.net,322320,ES17209589367889501335,1423.95,2024-04-10T08:35:56,Durango,expenses,education,-43.52,-34208.93
buyer_8,Patxi,Urrutia,1979-04-04,44624658N,patxi.urrutia@megaapp.net,322320,ES17209589367889501335,1423.95,2024-04-14T16:57:42,Durango,expenses,food,-124.54,-34333.47
buyer_8,Patxi,Urrutia,1979-04-04,44624658N,patxi.urrutia@megaapp.net,322320,ES17209589367889501335,1423.95,2024-04-15T23:07:55,Durango,expenses,cash,-100.0,-34433.47
buyer_8,Patxi,Urrutia,1979-04-04,44624658N,patxi.urrutia@megaapp.net,322320,ES17209589367889501335,1423.95,2024-04-15T07:20:58,Durango,expenses,appliances,-379.03,-34812.5
buyer_8,Patxi,Urrutia,1979-04-04,44624658N,patxi.urrutia@megaapp.net,322320,ES17209589367889501335,1423.95,2024-04-16T06:09:18,Durango,expenses,transport,-59.74,-34872.24
buyer_8,Patxi,Urrutia,1979-04-04,44624658N,patxi.urrutia@megaapp.net,322320,ES17209589367889501335,1423.95,2024-04-19T14:47:03,Durango,expenses,gifts,-163.94,-35036.18
buyer_8,Patxi,Urrutia,1979-04-04,44624658N,patxi.urrutia@megaapp.net,322320,ES17209589367889501335,1423.95,2024-04-20T12:35:57,Durango,expenses,travel,-735.2,-35771.38
buyer_8,Patxi,Urrutia,1979-04-04,44624658N,patxi.urrutia@megaapp.net,322320,ES17209589367889501335,1423.95,2024-04-21T20:11:55,Durango,expenses,leisure,-52.47,-35823.85
buyer_8,Patxi,Urrutia,1979-04-04,44624658N,patxi.urrutia@megaapp.net,322320,ES17209589367889501335,1423.95,2024-04-23T13:56:25,Durango,expenses,transport,-60.19,-35884.04
buyer_8,Patxi,Urrutia,1979-04-04,44624658N,patxi.urrutia@megaapp.net,322320,ES17209589367889501335,1423.95,2024-04-25T10:05:53,Durango,expenses,food,-100.89,-35984.93
buyer_8,Patxi,Urrutia,1979-04-04,44624658N,patxi.urrutia@megaapp.net,322320,ES17209589367889501335,1423.95,2024-04-25T18:56:30,Durango,expenses,clothing,-115.45,-36100.38
buyer_8,Patxi,Urrutia,1979-04-04,44624658N,patxi.urrutia@megaapp.net,322320,ES17209589367889501335,1423.95,2024-04-28T18:43:19,Durango,expenses,food,-98.46,-36198.84
buyer_8,Patxi,Urrutia,1979-04-04,44624658N,patxi.urrutia@megaapp.net,322320,ES17209589367889501335,1423.95,2024-04-28T11:49:37,Durango,expenses,transport,-58.2,-36257.04
buyer_8,Patxi,Urrutia,1979-04-04,44624658N,patxi.urrutia@megaapp.net,322320,ES17209589367889501335,1423.95,2024-04-28T09:31:58,Durango,expenses,clothing,-112.23,-36369.27
buyer_8,Patxi,Urrutia,1979-04-04,44624658N,patxi.urrutia@megaapp.net,322320,ES17209589367889501335,1423.95,2024-04-30T08:53:36,Durango,expenses,transport,-73.37,-36442.64
buyer_8,Patxi,Urrutia,1979-04-04,44624658N,patxi.urrutia@megaapp.net,322320,ES17209589367889501335,1423.95,2024-04-30T14:06:39,Durango,expenses,gifts,-555.35,-36997.99
buyer_8,Patxi,Urrutia,1979-04-04,44624658N,patxi.urrutia@megaapp.net,322320,ES17209589367889501335,1423.95,2024-05-01T14:12:36,Durango,incomes,salary,4283.75,-32714.24
buyer_8,Patxi,Urrutia,1979-04-04,44624658N,patxi.urrutia@megaapp.net,322320,ES17209589367889501335,1423.95,2024-05-01T14:12:36,Durango,incomes,extra_income,572.97,-32141.27
buyer_8,Patxi,Urrutia,1979-04-04,44624658N,patxi.urrutia@megaapp.net,322320,ES17209589367889501335,1423.95,2024-05-05T15:21:52,Durango,expenses,mortgage,-2368.29,-34509.56
buyer_8,Patxi,Urrutia,1979-04-04,44624658N,patxi.urrutia@megaapp.net,322320,ES17209589367889501335,1423.95,2024-05-05T12:33:38,Durango,expenses,water,-70.7,-34580.26
buyer_8,Patxi,Urrutia,1979-04-04,44624658N,patxi.urrutia@megaapp.net,322320,ES17209589367889501335,1423.95,2024-05-05T20:26:20,Durango,expenses,electricity,-140.94,-34721.2
buyer_8,Patxi,Urrutia,1979-04-04,44624658N,patxi.urrutia@megaapp.net,322320,ES17209589367889501335,1423.95,2024-05-05T15:24:42,Durango,expenses,gas,-266.51,-34987.71
buyer_8,Patxi,Urrutia,1979-04-04,44624658N,patxi.urrutia@megaapp.net,322320,ES17209589367889501335,1423.95,2024-05-06T17:47:54,Durango,expenses,electricity,-126.43,-35114.14
buyer_8,Patxi,Urrutia,1979-04-04,44624658N,patxi.urrutia@megaapp.net,322320,ES17209589367889501335,1423.95,2024-05-07T10:35:31,Durango,expenses,water,-104.97,-35219.11
buyer_8,Patxi,Urrutia,1979-04-04,44624658N,patxi.urrutia@megaapp.net,322320,ES17209589367889501335,1423.95,2024-05-07T19:24:09,Durango,expenses,phone,-95.87,-35314.98
buyer_8,Patxi,Urrutia,1979-04-04,44624658N,patxi.urrutia@megaapp.net,322320,ES17209589367889501335,1423.95,2024-05-08T11:31:26,Durango,expenses,gas,-261.04,-35576.02
buyer_8,Patxi,Urrutia,1979-04-04,44624658N,patxi.urrutia@megaapp.net,322320,ES17209589367889501335,1423.95,2024-05-08T04:50:14,Durango,expenses,internet,-98.95,-35674.97
buyer_8,Patxi,Urrutia,1979-04-04,44624658N,patxi.urrutia@megaapp.net,322320,ES17209589367889501335,1423.95,2024-05-08T17:12:16,Durango,expenses,phone,-87.72,-35762.69
buyer_8,Patxi,Urrutia,1979-04-04,44624658N,patxi.urrutia@megaapp.net,322320,ES17209589367889501335,1423.95,2024-05-08T13:42:55,Durango,expenses,transport,-54.86,-35817.55
buyer_8,Patxi,Urrutia,1979-04-04,44624658N,patxi.urrutia@megaapp.net,322320,ES17209589367889501335,1423.95,2024-05-08T13:17:33,Durango,expenses,clothing,-67.14,-35884.69
buyer_8,Patxi,Urrutia,1979-04-04,44624658N,patxi.urrutia@megaapp.net,322320,ES17209589367889501335,1423.95,2024-05-09T20:10:18,Durango,expenses,food,-72.77,-35957.46
buyer_8,Patxi,Urrutia,1979-04-04,44624658N,patxi.urrutia@megaapp.net,322320,ES17209589367889501335,1423.95,2024-05-09T10:39:34,Durango,expenses,transport,-51.04,-36008.5
buyer_8,Patxi,Urrutia,1979-04-04,44624658N,patxi.urrutia@megaapp.net,322320,ES17209589367889501335,1423.95,2024-05-10T09:16:52,Durango,expenses,appliances,-339.0,-36347.5
buyer_8,Patxi,Urrutia,1979-04-04,44624658N,patxi.urrutia@megaapp.net,322320,ES17209589367889501335,1423.95,2024-05-12T12:47:44,Durango,expenses,transport,-74.03,-36421.53
buyer_8,Patxi,Urrutia,1979-04-04,44624658N,patxi.urrutia@megaapp.net,322320,ES17209589367889501335,1423.95,2024-05-12T10:43:54,Durango,expenses,gifts,-616.34,-37037.87
buyer_8,Patxi,Urrutia,1979-04-04,44624658N,patxi.urrutia@megaapp.net,322320,ES17209589367889501335,1423.95,2024-05-15T19:47:10,Durango,expenses,cash,-100.0,-37137.87
buyer_8,Patxi,Urrutia,1979-04-04,44624658N,patxi.urrutia@megaapp.net,322320,ES17209589367889501335,1423.95,2024-05-19T16:40:42,Durango,expenses,cash,-100.0,-37237.87
buyer_8,Patxi,Urrutia,1979-04-04,44624658N,patxi.urrutia@megaapp.net,322320,ES17209589367889501335,1423.95,2024-05-21T23:59:47,Durango,expenses,cash,-100.0,-37337.87
buyer_8,Patxi,Urrutia,1979-04-04,44624658N,patxi.urrutia@megaapp.net,322320,ES17209589367889501335,1423.95,2024-05-22T10:40:22,Durango,expenses,food,-82.53,-37420.4
buyer_8,Patxi,Urrutia,1979-04-04,44624658N,patxi.urrutia@megaapp.net,322320,ES17209589367889501335,1423.95,2024-05-23T18:34:36,Durango,expenses,repairs,-195.03,-37615.43
buyer_8,Patxi,Urrutia,1979-04-04,44624658N,patxi.urrutia@megaapp.net,322320,ES17209589367889501335,1423.95,2024-05-23T22:27:39,Durango,expenses,car,-481.55,-38096.98
buyer_8,Patxi,Urrutia,1979-04-04,44624658N,patxi.urrutia@megaapp.net,322320,ES17209589367889501335,1423.95,2024-05-25T17:08:25,Durango,expenses,food,-106.96,-38203.94
buyer_8,Patxi,Urrutia,1979-04-04,44624658N,patxi.urrutia@megaapp.net,322320,ES17209589367889501335,1423.95,2024-05-25T19:41:05,Durango,expenses,leisure,-73.36,-38277.3
buyer_8,Patxi,Urrutia,1979-04-04,44624658N,patxi.urrutia@megaapp.net,322320,ES17209589367889501335,1423.95,2024-05-29T15:07:42,Durango,expenses,food,-64.47,-38341.77
buyer_8,Patxi,Urrutia,1979-04-04,44624658N,patxi.urrutia@megaapp.net,322320,ES17209589367889501335,1423.95,2024-06-01T12:13:52,Durango,incomes,salary,4283.75,-34058.02
buyer_8,Patxi,Urrutia,1979-04-04,44624658N,patxi.urrutia@megaapp.net,322320,ES17209589367889501335,1423.95,2024-06-01T12:13:52,Durango,incomes,salary_bonus,3045.41,-31012.61
buyer_8,Patxi,Urrutia,1979-04-04,44624658N,patxi.urrutia@megaapp.net,322320,ES17209589367889501335,1423.95,2024-06-01T19:09:50,Durango,expenses,taxes,-3157.85,-34170.46
buyer_8,Patxi,Urrutia,1979-04-04,44624658N,patxi.urrutia@megaapp.net,322320,ES17209589367889501335,1423.95,2024-06-01T16:07:58,Durango,expenses,insurance,-1334.54,-35505.0
buyer_8,Patxi,Urrutia,1979-04-04,44624658N,patxi.urrutia@megaapp.net,322320,ES17209589367889501335,1423.95,2024-06-01T22:48:38,Durango,expenses,leisure,-28.47,-35533.47
buyer_8,Patxi,Urrutia,1979-04-04,44624658N,patxi.urrutia@megaapp.net,322320,ES17209589367889501335,1423.95,2024-06-01T20:06:28,Durango,expenses,education,-65.29,-35598.76
buyer_8,Patxi,Urrutia,1979-04-04,44624658N,patxi.urrutia@megaapp.net,322320,ES17209589367889501335,1423.95,2024-06-03T10:57:25,Durango,expenses,clothing,-64.46,-35663.22
buyer_8,Patxi,Urrutia,1979-04-04,44624658N,patxi.urrutia@megaapp.net,322320,ES17209589367889501335,1423.95,2024-06-03T10:58:02,Durango,expenses,cash,-100.0,-35763.22
buyer_8,Patxi,Urrutia,1979-04-04,44624658N,patxi.urrutia@megaapp.net,322320,ES17209589367889501335,1423.95,2024-06-03T12:30:42,Durango,expenses,repairs,-149.33,-35912.55
buyer_8,Patxi,Urrutia,1979-04-04,44624658N,patxi.urrutia@megaapp.net,322320,ES17209589367889501335,1423.95,2024-06-04T15:28:49,Durango,expenses,transport,-87.9,-36000.45
buyer_8,Patxi,Urrutia,1979-04-04,44624658N,patxi.urrutia@megaapp.net,322320,ES17209589367889501335,1423.95,2024-06-05T17:01:19,Durango,expenses,mortgage,-2368.29,-38368.74
buyer_8,Patxi,Urrutia,1979-04-04,44624658N,patxi.urrutia@megaapp.net,322320,ES17209589367889501335,1423.95,2024-06-05T09:32:23,Durango,expenses,water,-78.59,-38447.33
buyer_8,Patxi,Urrutia,1979-04-04,44624658N,patxi.urrutia@megaapp.net,322320,ES17209589367889501335,1423.95,2024-06-05T10:11:16,Durango,expenses,electricity,-188.11,-38635.44
buyer_8,Patxi,Urrutia,1979-04-04,44624658N,patxi.urrutia@megaapp.net,322320,ES17209589367889501335,1423.95,2024-06-05T21:06:30,Durango,expenses,gas,-265.42,-38900.86
buyer_8,Patxi,Urrutia,1979-04-04,44624658N,patxi.urrutia@megaapp.net,322320,ES17209589367889501335,1423.95,2024-06-05T16:30:15,Durango,expenses,phone,-73.65,-38974.51
buyer_8,Patxi,Urrutia,1979-04-04,44624658N,patxi.urrutia@megaapp.net,322320,ES17209589367889501335,1423.95,2024-06-05T14:23:07,Durango,expenses,cash,-100.0,-39074.51
buyer_8,Patxi,Urrutia,1979-04-04,44624658N,patxi.urrutia@megaapp.net,322320,ES17209589367889501335,1423.95,2024-06-06T11:26:07,Durango,expenses,water,-100.27,-39174.78
buyer_8,Patxi,Urrutia,1979-04-04,44624658N,patxi.urrutia@megaapp.net,322320,ES17209589367889501335,1423.95,2024-06-06T12:10:59,Durango,expenses,electricity,-104.87,-39279.65
buyer_8,Patxi,Urrutia,1979-04-04,44624658N,patxi.urrutia@megaapp.net,322320,ES17209589367889501335,1423.95,2024-06-06T12:43:24,Durango,expenses,internet,-98.95,-39378.6
buyer_8,Patxi,Urrutia,1979-04-04,44624658N,patxi.urrutia@megaapp.net,322320,ES17209589367889501335,1423.95,2024-06-07T06:35:10,Durango,expenses,cash,-100.0,-39478.6
buyer_8,Patxi,Urrutia,1979-04-04,44624658N,patxi.urrutia@megaapp.net,322320,ES17209589367889501335,1423.95,2024-06-07T12:55:23,Durango,expenses,gifts,-836.68,-40315.28
buyer_8,Patxi,Urrutia,1979-04-04,44624658N,patxi.urrutia@megaapp.net,322320,ES17209589367889501335,1423.95,2024-06-08T01:50:14,Durango,expenses,internet,-98.95,-40414.23
buyer_8,Patxi,Urrutia,1979-04-04,44624658N,patxi.urrutia@megaapp.net,322320,ES17209589367889501335,1423.95,2024-06-10T20:12:11,Durango,expenses,leisure,-41.68,-40455.91
buyer_8,Patxi,Urrutia,1979-04-04,44624658N,patxi.urrutia@megaapp.net,322320,ES17209589367889501335,1423.95,2024-06-13T17:54:36,Durango,expenses,cash,-100.0,-40555.91
buyer_8,Patxi,Urrutia,1979-04-04,44624658N,patxi.urrutia@megaapp.net,322320,ES17209589367889501335,1423.95,2024-06-13T16:42:27,Durango,expenses,car,-763.07,-41318.98
buyer_8,Patxi,Urrutia,1979-04-04,44624658N,patxi.urrutia@megaapp.net,322320,ES17209589367889501335,1423.95,2024-06-14T19:46:39,Durango,expenses,food,-64.68,-41383.66
buyer_8,Patxi,Urrutia,1979-04-04,44624658N,patxi.urrutia@megaapp.net,322320,ES17209589367889501335,1423.95,2024-06-14T23:04:29,Durango,expenses,clothing,-157.63,-41541.29
buyer_8,Patxi,Urrutia,1979-04-04,44624658N,patxi.urrutia@megaapp.net,322320,ES17209589367889501335,1423.95,2024-06-15T19:40:01,Durango,expenses,healthcare,-150.5,-41691.79
buyer_8,Patxi,Urrutia,1979-04-04,44624658N,patxi.urrutia@megaapp.net,322320,ES17209589367889501335,1423.95,2024-06-15T20:05:39,Durango,expenses,repairs,-30.77,-41722.56
buyer_8,Patxi,Urrutia,1979-04-04,44624658N,patxi.urrutia@megaapp.net,322320,ES17209589367889501335,1423.95,2024-06-16T20:55:44,Durango,expenses,leisure,-38.75,-41761.31
buyer_8,Patxi,Urrutia,1979-04-04,44624658N,patxi.urrutia@megaapp.net,322320,ES17209589367889501335,1423.95,2024-06-16T19:02:34,Durango,expenses,healthcare,-78.17,-41839.48
buyer_8,Patxi,Urrutia,1979-04-04,44624658N,patxi.urrutia@megaapp.net,322320,ES17209589367889501335,1423.95,2024-06-16T20:02:50,Durango,expenses,cash,-100.0,-41939.48
buyer_8,Patxi,Urrutia,1979-04-04,44624658N,patxi.urrutia@megaapp.net,322320,ES17209589367889501335,1423.95,2024-06-17T09:55:26,Durango,expenses,travel,-376.18,-42315.66
buyer_8,Patxi,Urrutia,1979-04-04,44624658N,patxi.urrutia@megaapp.net,322320,ES17209589367889501335,1423.95,2024-06-18T18:52:49,Durango,expenses,cash,-100.0,-42415.66
buyer_8,Patxi,Urrutia,1979-04-04,44624658N,patxi.urrutia@megaapp.net,322320,ES17209589367889501335,1423.95,2024-06-19T10:02:11,Durango,expenses,gifts,-241.62,-42657.28
buyer_8,Patxi,Urrutia,1979-04-04,44624658N,patxi.urrutia@megaapp.net,322320,ES17209589367889501335,1423.95,2024-06-19T17:32:59,Durango,expenses,car,-361.21,-43018.49
buyer_8,Patxi,Urrutia,1979-04-04,44624658N,patxi.urrutia@megaapp.net,322320,ES17209589367889501335,1423.95,2024-06-22T15:48:50,Durango,expenses,appliances,-394.45,-43412.94
buyer_8,Patxi,Urrutia,1979-04-04,44624658N,patxi.urrutia@megaapp.net,322320,ES17209589367889501335,1423.95,2024-06-23T19:50:41,Durango,expenses,food,-96.6,-43509.54
buyer_8,Patxi,Urrutia,1979-04-04,44624658N,patxi.urrutia@megaapp.net,322320,ES17209589367889501335,1423.95,2024-06-24T09:29:06,Durango,expenses,food,-121.61,-43631.15
buyer_8,Patxi,Urrutia,1979-04-04,44624658N,patxi.urrutia@megaapp.net,322320,ES17209589367889501335,1423.95,2024-06-25T11:00:15,Durango,expenses,leisure,-35.44,-43666.59
buyer_8,Patxi,Urrutia,1979-04-04,44624658N,patxi.urrutia@megaapp.net,322320,ES17209589367889501335,1423.95,2024-06-26T14:09:05,Durango,expenses,food,-97.0,-43763.59
buyer_8,Patxi,Urrutia,1979-04-04,44624658N,patxi.urrutia@megaapp.net,322320,ES17209589367889501335,1423.95,2024-06-26T06:18:21,Durango,expenses,repairs,-58.09,-43821.68
buyer_8,Patxi,Urrutia,1979-04-04,44624658N,patxi.urrutia@megaapp.net,322320,ES17209589367889501335,1423.95,2024-06-27T18:20:07,Durango,expenses,food,-119.68,-43941.36
buyer_8,Patxi,Urrutia,1979-04-04,44624658N,patxi.urrutia@megaapp.net,322320,ES17209589367889501335,1423.95,2024-06-27T20:55:49,Durango,expenses,transport,-87.46,-44028.82
buyer_8,Patxi,Urrutia,1979-04-04,44624658N,patxi.urrutia@megaapp.net,322320,ES17209589367889501335,1423.95,2024-06-27T18:20:36,Durango,expenses,appliances,-155.81,-44184.63
buyer_8,Patxi,Urrutia,1979-04-04,44624658N,patxi.urrutia@megaapp.net,322320,ES17209589367889501335,1423.95,2024-06-29T12:06:36,Durango,expenses,clothing,-124.31,-44308.94
buyer_8,Patxi,Urrutia,1979-04-04,44624658N,patxi.urrutia@megaapp.net,322320,ES17209589367889501335,1423.95,2024-06-30T06:04:51,Durango,expenses,cash,-100.0,-44408.94
buyer_8,Patxi,Urrutia,1979-04-04,44624658N,patxi.urrutia@megaapp.net,322320,ES17209589367889501335,1423.95,2024-07-01T10:55:08,Durango,incomes,salary,4283.75,-40125.19
buyer_8,Patxi,Urrutia,1979-04-04,44624658N,patxi.urrutia@megaapp.net,322320,ES17209589367889501335,1423.95,2024-07-01T08:16:45,Durango,expenses,gifts,-250.47,-40375.66
buyer_8,Patxi,Urrutia,1979-04-04,44624658N,patxi.urrutia@megaapp.net,322320,ES17209589367889501335,1423.95,2024-07-02T04:52:03,Durango,expenses,cash,-100.0,-40475.66
buyer_8,Patxi,Urrutia,1979-04-04,44624658N,patxi.urrutia@megaapp.net,322320,ES17209589367889501335,1423.95,2024-07-04T22:26:12,Durango,expenses,repairs,-283.32,-40758.98
buyer_8,Patxi,Urrutia,1979-04-04,44624658N,patxi.urrutia@megaapp.net,322320,ES17209589367889501335,1423.95,2024-07-05T20:10:27,Durango,expenses,mortgage,-2368.29,-43127.27
buyer_8,Patxi,Urrutia,1979-04-04,44624658N,patxi.urrutia@megaapp.net,322320,ES17209589367889501335,1423.95,2024-07-05T18:20:08,Durango,expenses,gas,-227.0,-43354.27
buyer_8,Patxi,Urrutia,1979-04-04,44624658N,patxi.urrutia@megaapp.net,322320,ES17209589367889501335,1423.95,2024-07-06T18:27:52,Durango,expenses,gas,-118.33,-43472.6
buyer_8,Patxi,Urrutia,1979-04-04,44624658N,patxi.urrutia@megaapp.net,322320,ES17209589367889501335,1423.95,2024-07-06T10:03:10,Durango,expenses,phone,-81.06,-43553.66
buyer_8,Patxi,Urrutia,1979-04-04,44624658N,patxi.urrutia@megaapp.net,322320,ES17209589367889501335,1423.95,2024-07-06T09:48:10,Durango,expenses,cash,-100.0,-43653.66
buyer_8,Patxi,Urrutia,1979-04-04,44624658N,patxi.urrutia@megaapp.net,322320,ES17209589367889501335,1423.95,2024-07-07T08:33:10,Durango,expenses,water,-63.71,-43717.37
buyer_8,Patxi,Urrutia,1979-04-04,44624658N,patxi.urrutia@megaapp.net,322320,ES17209589367889501335,1423.95,2024-07-07T13:43:50,Durango,expenses,cash,-100.0,-43817.37
buyer_8,Patxi,Urrutia,1979-04-04,44624658N,patxi.urrutia@megaapp.net,322320,ES17209589367889501335,1423.95,2024-07-08T11:36:13,Durango,expenses,electricity,-119.87,-43937.24
buyer_8,Patxi,Urrutia,1979-04-04,44624658N,patxi.urrutia@megaapp.net,322320,ES17209589367889501335,1423.95,2024-07-08T12:38:42,Durango,expenses,internet,-98.95,-44036.19
buyer_8,Patxi,Urrutia,1979-04-04,44624658N,patxi.urrutia@megaapp.net,322320,ES17209589367889501335,1423.95,2024-07-08T18:23:25,Durango,expenses,food,-66.17,-44102.36
buyer_8,Patxi,Urrutia,1979-04-04,44624658N,patxi.urrutia@megaapp.net,322320,ES17209589367889501335,1423.95,2024-07-10T19:56:44,Durango,expenses,leisure,-53.76,-44156.12
buyer_8,Patxi,Urrutia,1979-04-04,44624658N,patxi.urrutia@megaapp.net,322320,ES17209589367889501335,1423.95,2024-07-10T17:10:53,Durango,expenses,cash,-100.0,-44256.12
buyer_8,Patxi,Urrutia,1979-04-04,44624658N,patxi.urrutia@megaapp.net,322320,ES17209589367889501335,1423.95,2024-07-11T20:43:30,Durango,expenses,food,-64.93,-44321.05
buyer_8,Patxi,Urrutia,1979-04-04,44624658N,patxi.urrutia@megaapp.net,322320,ES17209589367889501335,1423.95,2024-07-14T15:15:32,Durango,expenses,food,-121.07,-44442.12
buyer_8,Patxi,Urrutia,1979-04-04,44624658N,patxi.urrutia@megaapp.net,322320,ES17209589367889501335,1423.95,2024-07-16T12:23:58,Durango,expenses,transport,-53.12,-44495.24
buyer_8,Patxi,Urrutia,1979-04-04,44624658N,patxi.urrutia@megaapp.net,322320,ES17209589367889501335,1423.95,2024-07-16T15:20:51,Durango,expenses,cash,-100.0,-44595.24
buyer_8,Patxi,Urrutia,1979-04-04,44624658N,patxi.urrutia@megaapp.net,322320,ES17209589367889501335,1423.95,2024-07-16T09:48:16,Durango,expenses,repairs,-114.01,-44709.25
buyer_8,Patxi,Urrutia,1979-04-04,44624658N,patxi.urrutia@megaapp.net,322320,ES17209589367889501335,1423.95,2024-07-18T00:09:20,Durango,expenses,clothing,-79.59,-44788.84
buyer_8,Patxi,Urrutia,1979-04-04,44624658N,patxi.urrutia@megaapp.net,322320,ES17209589367889501335,1423.95,2024-07-18T18:47:50,Durango,expenses,cash,-100.0,-44888.84
buyer_8,Patxi,Urrutia,1979-04-04,44624658N,patxi.urrutia@megaapp.net,322320,ES17209589367889501335,1423.95,2024-07-19T12:55:01,Durango,expenses,transport,-68.31,-44957.15
buyer_8,Patxi,Urrutia,1979-04-04,44624658N,patxi.urrutia@megaapp.net,322320,ES17209589367889501335,1423.95,2024-07-19T16:34:35,Durango,expenses,education,-75.31,-45032.46
buyer_8,Patxi,Urrutia,1979-04-04,44624658N,patxi.urrutia@megaapp.net,322320,ES17209589367889501335,1423.95,2024-07-19T22:58:34,Durango,expenses,cash,-100.0,-45132.46
buyer_8,Patxi,Urrutia,1979-04-04,44624658N,patxi.urrutia@megaapp.net,322320,ES17209589367889501335,1423.95,2024-07-22T03:49:57,Durango,expenses,education,-76.95,-45209.41
buyer_8,Patxi,Urrutia,1979-04-04,44624658N,patxi.urrutia@megaapp.net,322320,ES17209589367889501335,1423.95,2024-07-22T20:43:44,Durango,expenses,cash,-100.0,-45309.41
buyer_8,Patxi,Urrutia,1979-04-04,44624658N,patxi.urrutia@megaapp.net,322320,ES17209589367889501335,1423.95,2024-07-27T09:24:10,Durango,expenses,cash,-100.0,-45409.41
buyer_8,Patxi,Urrutia,1979-04-04,44624658N,patxi.urrutia@megaapp.net,322320,ES17209589367889501335,1423.95,2024-07-30T11:21:01,Durango,expenses,gifts,-756.31,-46165.72
buyer_8,Patxi,Urrutia,1979-04-04,44624658N,patxi.urrutia@megaapp.net,322320,ES17209589367889501335,1423.95,2024-07-31T20:46:07,Durango,expenses,food,-89.85,-46255.57
buyer_8,Patxi,Urrutia,1979-04-04,44624658N,patxi.urrutia@megaapp.net,322320,ES17209589367889501335,1423.95,2024-07-31T20:02:31,Durango,expenses,leisure,-68.17,-46323.74
buyer_8,Patxi,Urrutia,1979-04-04,44624658N,patxi.urrutia@megaapp.net,322320,ES17209589367889501335,1423.95,2024-08-01T14:01:48,Durango,incomes,salary,4283.75,-42039.99
buyer_8,Patxi,Urrutia,1979-04-04,44624658N,patxi.urrutia@megaapp.net,322320,ES17209589367889501335,1423.95,2024-08-01T08:40:13,Durango,expenses,food,-77.77,-42117.76
buyer_8,Patxi,Urrutia,1979-04-04,44624658N,patxi.urrutia@megaapp.net,322320,ES17209589367889501335,1423.95,2024-08-01T14:00:55,Durango,expenses,clothing,-80.15,-42197.91
buyer_8,Patxi,Urrutia,1979-04-04,44624658N,patxi.urrutia@megaapp.net,322320,ES17209589367889501335,1423.95,2024-08-02T18:05:53,Durango,expenses,education,-49.73,-42247.64
buyer_8,Patxi,Urrutia,1979-04-04,44624658N,patxi.urrutia@megaapp.net,322320,ES17209589367889501335,1423.95,2024-08-03T13:27:17,Durango,expenses,cash,-100.0,-42347.64
buyer_8,Patxi,Urrutia,1979-04-04,44624658N,patxi.urrutia@megaapp.net,322320,ES17209589367889501335,1423.95,2024-08-03T12:53:48,Durango,expenses,gifts,-67.01,-42414.65
buyer_8,Patxi,Urrutia,1979-04-04,44624658N,patxi.urrutia@megaapp.net,322320,ES17209589367889501335,1423.95,2024-08-04T19:30:58,Durango,expenses,clothing,-131.44,-42546.09
buyer_8,Patxi,Urrutia,1979-04-04,44624658N,patxi.urrutia@megaapp.net,322320,ES17209589367889501335,1423.95,2024-08-05T23:56:59,Durango,expenses,mortgage,-2368.29,-44914.38
buyer_8,Patxi,Urrutia,1979-04-04,44624658N,patxi.urrutia@megaapp.net,322320,ES17209589367889501335,1423.95,2024-08-05T02:39:15,Durango,expenses,gas,-184.17,-45098.55
buyer_8,Patxi,Urrutia,1979-04-04,44624658N,patxi.urrutia@megaapp.net,322320,ES17209589367889501335,1423.95,2024-08-05T09:50:10,Durango,expenses,education,-69.85,-45168.4
buyer_8,Patxi,Urrutia,1979-04-04,44624658N,patxi.urrutia@megaapp.net,322320,ES17209589367889501335,1423.95,2024-08-06T09:14:46,Durango,expenses,electricity,-147.81,-45316.21
buyer_8,Patxi,Urrutia,1979-04-04,44624658N,patxi.urrutia@megaapp.net,322320,ES17209589367889501335,1423.95,2024-08-06T17:10:21,Durango,expenses,gas,-245.74,-45561.95
buyer_8,Patxi,Urrutia,1979-04-04,44624658N,patxi.urrutia@megaapp.net,322320,ES17209589367889501335,1423.95,2024-08-06T14:56:08,Durango,expenses,transport,-62.79,-45624.74
buyer_8,Patxi,Urrutia,1979-04-04,44624658N,patxi.urrutia@megaapp.net,322320,ES17209589367889501335,1423.95,2024-08-06T11:23:01,Durango,expenses,cash,-100.0,-45724.74
buyer_8,Patxi,Urrutia,1979-04-04,44624658N,patxi.urrutia@megaapp.net,322320,ES17209589367889501335,1423.95,2024-08-06T13:50:24,Durango,expenses,travel,-405.73,-46130.47
buyer_8,Patxi,Urrutia,1979-04-04,44624658N,patxi.urrutia@megaapp.net,322320,ES17209589367889501335,1423.95,2024-08-07T08:53:50,Durango,expenses,water,-102.4,-46232.87
buyer_8,Patxi,Urrutia,1979-04-04,44624658N,patxi.urrutia@megaapp.net,322320,ES17209589367889501335,1423.95,2024-08-08T18:36:56,Durango,expenses,gas,-259.97,-46492.84
buyer_8,Patxi,Urrutia,1979-04-04,44624658N,patxi.urrutia@megaapp.net,322320,ES17209589367889501335,1423.95,2024-08-08T14:19:44,Durango,expenses,cash,-100.0,-46592.84
buyer_8,Patxi,Urrutia,1979-04-04,44624658N,patxi.urrutia@megaapp.net,322320,ES17209589367889501335,1423.95,2024-08-09T17:18:42,Durango,expenses,transport,-72.71,-46665.55
buyer_8,Patxi,Urrutia,1979-04-04,44624658N,patxi.urrutia@megaapp.net,322320,ES17209589367889501335,1423.95,2024-08-09T11:38:49,Durango,expenses,education,-59.43,-46724.98
buyer_8,Patxi,Urrutia,1979-04-04,44624658N,patxi.urrutia@megaapp.net,322320,ES17209589367889501335,1423.95,2024-08-09T14:55:04,Durango,expenses,repairs,-215.1,-46940.08
buyer_8,Patxi,Urrutia,1979-04-04,44624658N,patxi.urrutia@megaapp.net,322320,ES17209589367889501335,1423.95,2024-08-10T16:02:42,Durango,expenses,cash,-100.0,-47040.08
buyer_8,Patxi,Urrutia,1979-04-04,44624658N,patxi.urrutia@megaapp.net,322320,ES17209589367889501335,1423.95,2024-08-11T18:27:35,Durango,expenses,leisure,-55.69,-47095.77
buyer_8,Patxi,Urrutia,1979-04-04,44624658N,patxi.urrutia@megaapp.net,322320,ES17209589367889501335,1423.95,2024-08-11T20:50:18,Durango,expenses,car,-411.17,-47506.94
buyer_8,Patxi,Urrutia,1979-04-04,44624658N,patxi.urrutia@megaapp.net,322320,ES17209589367889501335,1423.95,2024-08-14T17:45:49,Durango,expenses,food,-89.03,-47595.97
buyer_8,Patxi,Urrutia,1979-04-04,44624658N,patxi.urrutia@megaapp.net,322320,ES17209589367889501335,1423.95,2024-08-14T12:59:26,Durango,expenses,leisure,-43.56,-47639.53
buyer_8,Patxi,Urrutia,1979-04-04,44624658N,patxi.urrutia@megaapp.net,322320,ES17209589367889501335,1423.95,2024-08-15T19:56:54,Durango,expenses,repairs,-216.93,-47856.46
buyer_8,Patxi,Urrutia,1979-04-04,44624658N,patxi.urrutia@megaapp.net,322320,ES17209589367889501335,1423.95,2024-08-16T11:33:28,Durango,expenses,transport,-88.31,-47944.77
buyer_8,Patxi,Urrutia,1979-04-04,44624658N,patxi.urrutia@megaapp.net,322320,ES17209589367889501335,1423.95,2024-08-17T12:38:18,Durango,expenses,transport,-56.8,-48001.57
buyer_8,Patxi,Urrutia,1979-04-04,44624658N,patxi.urrutia@megaapp.net,322320,ES17209589367889501335,1423.95,2024-08-17T13:26:52,Durango,expenses,cash,-100.0,-48101.57
buyer_8,Patxi,Urrutia,1979-04-04,44624658N,patxi.urrutia@megaapp.net,322320,ES17209589367889501335,1423.95,2024-08-20T06:56:27,Durango,expenses,gifts,-290.38,-48391.95
buyer_8,Patxi,Urrutia,1979-04-04,44624658N,patxi.urrutia@megaapp.net,322320,ES17209589367889501335,1423.95,2024-08-22T17:12:48,Durango,expenses,cash,-100.0,-48491.95
buyer_8,Patxi,Urrutia,1979-04-04,44624658N,patxi.urrutia@megaapp.net,322320,ES17209589367889501335,1423.95,2024-08-24T08:28:22,Durango,expenses,leisure,-45.45,-48537.4
buyer_8,Patxi,Urrutia,1979-04-04,44624658N,patxi.urrutia@megaapp.net,322320,ES17209589367889501335,1423.95,2024-08-25T12:03:35,Durango,expenses,leisure,-47.58,-48584.98
buyer_8,Patxi,Urrutia,1979-04-04,44624658N,patxi.urrutia@megaapp.net,322320,ES17209589367889501335,1423.95,2024-08-25T12:44:07,Durango,expenses,cash,-100.0,-48684.98
buyer_8,Patxi,Urrutia,1979-04-04,44624658N,patxi.urrutia@megaapp.net,322320,ES17209589367889501335,1423.95,2024-08-28T22:12:26,Durango,expenses,food,-73.13,-48758.11
buyer_8,Patxi,Urrutia,1979-04-04,44624658N,patxi.urrutia@megaapp.net,322320,ES17209589367889501335,1423.95,2024-08-29T08:40:09,Durango,expenses,education,-46.64,-48804.75
buyer_8,Patxi,Urrutia,1979-04-04,44624658N,patxi.urrutia@megaapp.net,322320,ES17209589367889501335,1423.95,2024-08-29T18:47:37,Durango,expenses,appliances,-252.6,-49057.35
buyer_8,Patxi,Urrutia,1979-04-04,44624658N,patxi.urrutia@megaapp.net,322320,ES17209589367889501335,1423.95,2024-08-29T09:41:49,Durango,expenses,gifts,-553.23,-49610.58
buyer_8,Patxi,Urrutia,1979-04-04,44624658N,patxi.urrutia@megaapp.net,322320,ES17209589367889501335,1423.95,2024-08-30T12:16:32,Durango,expenses,healthcare,-55.98,-49666.56
buyer_8,Patxi,Urrutia,1979-04-04,44624658N,patxi.urrutia@megaapp.net,322320,ES17209589367889501335,1423.95,2024-09-01T07:50:49,Durango,incomes,salary,4283.75,-45382.81
buyer_8,Patxi,Urrutia,1979-04-04,44624658N,patxi.urrutia@megaapp.net,322320,ES17209589367889501335,1423.95,2024-09-01T07:50:49,Durango,incomes,extra_income,572.97,-44809.84
buyer_8,Patxi,Urrutia,1979-04-04,44624658N,patxi.urrutia@megaapp.net,322320,ES17209589367889501335,1423.95,2024-09-01T11:38:11,Durango,expenses,cash,-100.0,-44909.84
buyer_8,Patxi,Urrutia,1979-04-04,44624658N,patxi.urrutia@megaapp.net,322320,ES17209589367889501335,1423.95,2024-09-01T19:49:15,Durango,expenses,repairs,-49.12,-44958.96
buyer_8,Patxi,Urrutia,1979-04-04,44624658N,patxi.urrutia@megaapp.net,322320,ES17209589367889501335,1423.95,2024-09-02T20:36:31,Durango,expenses,clothing,-127.58,-45086.54
buyer_8,Patxi,Urrutia,1979-04-04,44624658N,patxi.urrutia@megaapp.net,322320,ES17209589367889501335,1423.95,2024-09-02T22:56:24,Durango,expenses,education,-65.1,-45151.64
buyer_8,Patxi,Urrutia,1979-04-04,44624658N,patxi.urrutia@megaapp.net,322320,ES17209589367889501335,1423.95,2024-09-02T12:33:56,Durango,expenses,appliances,-89.12,-45240.76
buyer_8,Patxi,Urrutia,1979-04-04,44624658N,patxi.urrutia@megaapp.net,322320,ES17209589367889501335,1423.95,2024-09-03T15:21:30,Durango,expenses,clothing,-154.52,-45395.28
buyer_8,Patxi,Urrutia,1979-04-04,44624658N,patxi.urrutia@megaapp.net,322320,ES17209589367889501335,1423.95,2024-09-05T00:58:13,Durango,expenses,mortgage,-2368.29,-47763.57
buyer_8,Patxi,Urrutia,1979-04-04,44624658N,patxi.urrutia@megaapp.net,322320,ES17209589367889501335,1423.95,2024-09-05T08:39:48,Durango,expenses,water,-103.08,-47866.65
buyer_8,Patxi,Urrutia,1979-04-04,44624658N,patxi.urrutia@megaapp.net,322320,ES17209589367889501335,1423.95,2024-09-05T15:35:55,Durango,expenses,food,-98.9,-47965.55
buyer_8,Patxi,Urrutia,1979-04-04,44624658N,patxi.urrutia@megaapp.net,322320,ES17209589367889501335,1423.95,2024-09-05T15:29:08,Durango,expenses,transport,-71.67,-48037.22
buyer_8,Patxi,Urrutia,1979-04-04,44624658N,patxi.urrutia@megaapp.net,322320,ES17209589367889501335,1423.95,2024-09-07T19:55:57,Durango,expenses,internet,-98.95,-48136.17
buyer_8,Patxi,Urrutia,1979-04-04,44624658N,patxi.urrutia@megaapp.net,322320,ES17209589367889501335,1423.95,2024-09-07T00:22:22,Durango,expenses,food,-124.65,-48260.82
buyer_8,Patxi,Urrutia,1979-04-04,44624658N,patxi.urrutia@megaapp.net,322320,ES17209589367889501335,1423.95,2024-09-07T14:12:15,Durango,expenses,cash,-100.0,-48360.82
buyer_8,Patxi,Urrutia,1979-04-04,44624658N,patxi.urrutia@megaapp.net,322320,ES17209589367889501335,1423.95,2024-09-07T20:43:47,Durango,expenses,gifts,-154.78,-48515.6
buyer_8,Patxi,Urrutia,1979-04-04,44624658N,patxi.urrutia@megaapp.net,322320,ES17209589367889501335,1423.95,2024-09-08T17:10:17,Durango,expenses,gas,-166.7,-48682.3
buyer_8,Patxi,Urrutia,1979-04-04,44624658N,patxi.urrutia@megaapp.net,322320,ES17209589367889501335,1423.95,2024-09-08T09:41:01,Durango,expenses,phone,-81.48,-48763.78
buyer_8,Patxi,Urrutia,1979-04-04,44624658N,patxi.urrutia@megaapp.net,322320,ES17209589367889501335,1423.95,2024-09-09T10:05:49,Durango,expenses,cash,-100.0,-48863.78
buyer_8,Patxi,Urrutia,1979-04-04,44624658N,patxi.urrutia@megaapp.net,322320,ES17209589367889501335,1423.95,2024-09-10T18:10:06,Durango,expenses,clothing,-124.11,-48987.89
buyer_8,Patxi,Urrutia,1979-04-04,44624658N,patxi.urrutia@megaapp.net,322320,ES17209589367889501335,1423.95,2024-09-12T20:52:12,Durango,expenses,food,-123.6,-49111.49
buyer_8,Patxi,Urrutia,1979-04-04,44624658N,patxi.urrutia@megaapp.net,322320,ES17209589367889501335,1423.95,2024-09-13T14:19:50,Durango,expenses,food,-95.46,-49206.95
buyer_8,Patxi,Urrutia,1979-04-04,44624658N,patxi.urrutia@megaapp.net,322320,ES17209589367889501335,1423.95,2024-09-14T19:27:26,Durango,expenses,food,-109.05,-49316.0
buyer_8,Patxi,Urrutia,1979-04-04,44624658N,patxi.urrutia@megaapp.net,322320,ES17209589367889501335,1423.95,2024-09-14T11:25:16,Durango,expenses,leisure,-70.05,-49386.05
buyer_8,Patxi,Urrutia,1979-04-04,44624658N,patxi.urrutia@megaapp.net,322320,ES17209589367889501335,1423.95,2024-09-15T19:59:34,Durango,expenses,travel,-545.88,-49931.93
buyer_8,Patxi,Urrutia,1979-04-04,44624658N,patxi.urrutia@megaapp.net,322320,ES17209589367889501335,1423.95,2024-09-16T12:09:21,Durango,expenses,food,-61.65,-49993.58
buyer_8,Patxi,Urrutia,1979-04-04,44624658N,patxi.urrutia@megaapp.net,322320,ES17209589367889501335,1423.95,2024-09-17T02:41:33,Durango,expenses,leisure,-20.86,-50014.44
buyer_8,Patxi,Urrutia,1979-04-04,44624658N,patxi.urrutia@megaapp.net,322320,ES17209589367889501335,1423.95,2024-09-17T08:41:34,Durango,expenses,cash,-100.0,-50114.44
buyer_8,Patxi,Urrutia,1979-04-04,44624658N,patxi.urrutia@megaapp.net,322320,ES17209589367889501335,1423.95,2024-09-18T18:53:59,Durango,expenses,food,-94.46,-50208.9
buyer_8,Patxi,Urrutia,1979-04-04,44624658N,patxi.urrutia@megaapp.net,322320,ES17209589367889501335,1423.95,2024-09-18T16:26:23,Durango,expenses,cash,-100.0,-50308.9
buyer_8,Patxi,Urrutia,1979-04-04,44624658N,patxi.urrutia@megaapp.net,322320,ES17209589367889501335,1423.95,2024-09-18T15:28:21,Durango,expenses,gifts,-126.91,-50435.81
buyer_8,Patxi,Urrutia,1979-04-04,44624658N,patxi.urrutia@megaapp.net,322320,ES17209589367889501335,1423.95,2024-09-20T08:22:24,Durango,expenses,transport,-88.45,-50524.26
buyer_8,Patxi,Urrutia,1979-04-04,44624658N,patxi.urrutia@megaapp.net,322320,ES17209589367889501335,1423.95,2024-09-20T23:23:47,Durango,expenses,leisure,-50.81,-50575.07
buyer_8,Patxi,Urrutia,1979-04-04,44624658N,patxi.urrutia@megaapp.net,322320,ES17209589367889501335,1423.95,2024-09-22T08:18:02,Durango,expenses,cash,-100.0,-50675.07
buyer_8,Patxi,Urrutia,1979-04-04,44624658N,patxi.urrutia@megaapp.net,322320,ES17209589367889501335,1423.95,2024-09-23T19:14:49,Durango,expenses,cash,-100.0,-50775.07
buyer_8,Patxi,Urrutia,1979-04-04,44624658N,patxi.urrutia@megaapp.net,322320,ES17209589367889501335,1423.95,2024-09-25T10:28:22,Durango,expenses,food,-69.88,-50844.95
buyer_8,Patxi,Urrutia,1979-04-04,44624658N,patxi.urrutia@megaapp.net,322320,ES17209589367889501335,1423.95,2024-09-26T08:09:55,Durango,expenses,cash,-100.0,-50944.95
buyer_8,Patxi,Urrutia,1979-04-04,44624658N,patxi.urrutia@megaapp.net,322320,ES17209589367889501335,1423.95,2024-09-26T08:40:10,Durango,expenses,car,-843.31,-51788.26
buyer_8,Patxi,Urrutia,1979-04-04,44624658N,patxi.urrutia@megaapp.net,322320,ES17209589367889501335,1423.95,2024-09-27T15:20:14,Durango,expenses,repairs,-49.27,-51837.53
buyer_8,Patxi,Urrutia,1979-04-04,44624658N,patxi.urrutia@megaapp.net,322320,ES17209589367889501335,1423.95,2024-09-28T17:04:49,Durango,expenses,food,-119.49,-51957.02
buyer_8,Patxi,Urrutia,1979-04-04,44624658N,patxi.urrutia@megaapp.net,322320,ES17209589367889501335,1423.95,2024-09-28T14:46:23,Durango,expenses,cash,-100.0,-52057.02
buyer_8,Patxi,Urrutia,1979-04-04,44624658N,patxi.urrutia@megaapp.net,322320,ES17209589367889501335,1423.95,2024-09-29T16:56:57,Durango,expenses,cash,-100.0,-52157.02
buyer_8,Patxi,Urrutia,1979-04-04,44624658N,patxi.urrutia@megaapp.net,322320,ES17209589367889501335,1423.95,2024-10-01T12:55:44,Durango,incomes,salary,4283.75,-47873.27
buyer_8,Patxi,Urrutia,1979-04-04,44624658N,patxi.urrutia@megaapp.net,322320,ES17209589367889501335,1423.95,2024-10-01T18:47:14,Durango,expenses,cash,-100.0,-47973.27
buyer_8,Patxi,Urrutia,1979-04-04,44624658N,patxi.urrutia@megaapp.net,322320,ES17209589367889501335,1423.95,2024-10-01T09:29:25,Durango,expenses,repairs,-182.66,-48155.93
buyer_8,Patxi,Urrutia,1979-04-04,44624658N,patxi.urrutia@megaapp.net,322320,ES17209589367889501335,1423.95,2024-10-02T17:29:13,Durango,expenses,cash,-100.0,-48255.93
buyer_8,Patxi,Urrutia,1979-04-04,44624658N,patxi.urrutia@megaapp.net,322320,ES17209589367889501335,1423.95,2024-10-04T18:47:42,Durango,expenses,food,-108.26,-48364.19
buyer_8,Patxi,Urrutia,1979-04-04,44624658N,patxi.urrutia@megaapp.net,322320,ES17209589367889501335,1423.95,2024-10-05T11:00:25,Durango,expenses,mortgage,-2368.29,-50732.48
buyer_8,Patxi,Urrutia,1979-04-04,44624658N,patxi.urrutia@megaapp.net,322320,ES17209589367889501335,1423.95,2024-10-05T17:57:07,Durango,expenses,phone,-77.35,-50809.83
buyer_8,Patxi,Urrutia,1979-04-04,44624658N,patxi.urrutia@megaapp.net,322320,ES17209589367889501335,1423.95,2024-10-05T04:46:56,Durango,expenses,food,-92.27,-50902.1
buyer_8,Patxi,Urrutia,1979-04-04,44624658N,patxi.urrutia@megaapp.net,322320,ES17209589367889501335,1423.95,2024-10-05T14:57:57,Durango,expenses,leisure,-58.54,-50960.64
buyer_8,Patxi,Urrutia,1979-04-04,44624658N,patxi.urrutia@megaapp.net,322320,ES17209589367889501335,1423.95,2024-10-07T17:41:59,Durango,expenses,gas,-194.64,-51155.28
buyer_8,Patxi,Urrutia,1979-04-04,44624658N,patxi.urrutia@megaapp.net,322320,ES17209589367889501335,1423.95,2024-10-07T10:21:03,Durango,expenses,leisure,-59.76,-51215.04
buyer_8,Patxi,Urrutia,1979-04-04,44624658N,patxi.urrutia@megaapp.net,322320,ES17209589367889501335,1423.95,2024-10-08T15:15:28,Durango,expenses,gas,-83.26,-51298.3
buyer_8,Patxi,Urrutia,1979-04-04,44624658N,patxi.urrutia@megaapp.net,322320,ES17209589367889501335,1423.95,2024-10-10T14:00:51,Durango,expenses,cash,-100.0,-51398.3
buyer_8,Patxi,Urrutia,1979-04-04,44624658N,patxi.urrutia@megaapp.net,322320,ES17209589367889501335,1423.95,2024-10-11T03:20:57,Durango,expenses,food,-76.57,-51474.87
buyer_8,Patxi,Urrutia,1979-04-04,44624658N,patxi.urrutia@megaapp.net,322320,ES17209589367889501335,1423.95,2024-10-11T08:58:28,Durango,expenses,leisure,-82.41,-51557.28
buyer_8,Patxi,Urrutia,1979-04-04,44624658N,patxi.urrutia@megaapp.net,322320,ES17209589367889501335,1423.95,2024-10-11T19:32:01,Durango,expenses,appliances,-189.35,-51746.63
